NODE_1_length_25698_cov_36.651041	315	395	5	28	80	0.3500000
NODE_1_length_25698_cov_36.651041	315	395	6	52	80	0.6500000
NODE_1_length_25698_cov_36.651041	368	403	4	1	35	0.0285714
NODE_1_length_25698_cov_36.651041	368	403	5	33	35	0.9428571
NODE_1_length_25698_cov_36.651041	368	403	6	1	35	0.0285714
NODE_1_length_25698_cov_36.651041	24448	24494	0	9	46	0.1956522
NODE_1_length_25698_cov_36.651041	24448	24494	2	37	46	0.8043478
NODE_2_length_24307_cov_15.119712	2613	2689	0	44	76	0.5789474
NODE_2_length_24307_cov_15.119712	2613	2689	1	19	76	0.2500000
NODE_2_length_24307_cov_15.119712	2613	2689	2	13	76	0.1710526
NODE_2_length_24307_cov_15.119712	2662	2716	0	54	54	1.0000000
NODE_2_length_24307_cov_15.119712	11257	11320	0	63	63	1.0000000
NODE_2_length_24307_cov_15.119712	20621	20701	3	2	80	0.0250000
NODE_2_length_24307_cov_15.119712	20621	20701	4	3	80	0.0375000
NODE_2_length_24307_cov_15.119712	20621	20701	5	30	80	0.3750000
NODE_2_length_24307_cov_15.119712	20621	20701	6	45	80	0.5625000
NODE_2_length_24307_cov_15.119712	20674	20754	0	13	80	0.1625000
NODE_2_length_24307_cov_15.119712	20674	20754	3	13	80	0.1625000
NODE_2_length_24307_cov_15.119712	20674	20754	5	41	80	0.5125000
NODE_2_length_24307_cov_15.119712	20674	20754	6	13	80	0.1625000
NODE_7_length_12349_cov_28.144571	12251	12310	2	10	59	0.1694915
NODE_7_length_12349_cov_28.144571	12251	12310	4	18	59	0.3050847
NODE_7_length_12349_cov_28.144571	12251	12310	6	5	59	0.0847458
NODE_7_length_12349_cov_28.144571	12251	12310	8	1	59	0.0169492
NODE_7_length_12349_cov_28.144571	12251	12310	9	13	59	0.2203390
NODE_7_length_12349_cov_28.144571	12251	12310	10	1	59	0.0169492
NODE_7_length_12349_cov_28.144571	12251	12310	12	2	59	0.0338983
NODE_7_length_12349_cov_28.144571	12251	12310	13	3	59	0.0508475
NODE_7_length_12349_cov_28.144571	12251	12310	15	6	59	0.1016949
NODE_7_length_12349_cov_28.144571	12284	12310	2	10	26	0.3846154
NODE_7_length_12349_cov_28.144571	12284	12310	4	16	26	0.6153846
NODE_10_length_11096_cov_14.154679	6455	6535	0	80	80	1.0000000
NODE_10_length_11096_cov_14.154679	6508	6588	0	80	80	1.0000000
NODE_10_length_11096_cov_14.154679	6584	6664	0	80	80	1.0000000
NODE_10_length_11096_cov_14.154679	6637	6717	0	80	80	1.0000000
NODE_10_length_11096_cov_14.154679	7182	7229	58	4	47	0.0851064
NODE_10_length_11096_cov_14.154679	7182	7229	59	2	47	0.0425532
NODE_10_length_11096_cov_14.154679	7182	7229	60	5	47	0.1063830
NODE_10_length_11096_cov_14.154679	7182	7229	61	1	47	0.0212766
NODE_10_length_11096_cov_14.154679	7182	7229	62	2	47	0.0425532
NODE_10_length_11096_cov_14.154679	7182	7229	63	9	47	0.1914894
NODE_10_length_11096_cov_14.154679	7182	7229	64	11	47	0.2340426
NODE_10_length_11096_cov_14.154679	7182	7229	65	2	47	0.0425532
NODE_10_length_11096_cov_14.154679	7182	7229	66	3	47	0.0638298
NODE_10_length_11096_cov_14.154679	7182	7229	67	2	47	0.0425532
NODE_10_length_11096_cov_14.154679	7182	7229	68	6	47	0.1276596
NODE_10_length_11096_cov_14.154679	7218	7282	55	1	64	0.0156250
NODE_10_length_11096_cov_14.154679	7218	7282	56	7	64	0.1093750
NODE_10_length_11096_cov_14.154679	7218	7282	57	8	64	0.1250000
NODE_10_length_11096_cov_14.154679	7218	7282	58	15	64	0.2343750
NODE_10_length_11096_cov_14.154679	7218	7282	59	4	64	0.0625000
NODE_10_length_11096_cov_14.154679	7218	7282	60	8	64	0.1250000
NODE_10_length_11096_cov_14.154679	7218	7282	61	8	64	0.1250000
NODE_10_length_11096_cov_14.154679	7218	7282	62	5	64	0.0781250
NODE_10_length_11096_cov_14.154679	7218	7282	63	1	64	0.0156250
NODE_10_length_11096_cov_14.154679	7218	7282	64	7	64	0.1093750
NODE_13_length_10749_cov_34.330235	3589	3669	9	33	80	0.4125000
NODE_13_length_10749_cov_34.330235	3589	3669	10	40	80	0.5000000
NODE_13_length_10749_cov_34.330235	3589	3669	11	7	80	0.0875000
NODE_13_length_10749_cov_34.330235	3642	3722	9	10	80	0.1250000
NODE_13_length_10749_cov_34.330235	3642	3722	10	26	80	0.3250000
NODE_13_length_10749_cov_34.330235	3642	3722	11	19	80	0.2375000
NODE_13_length_10749_cov_34.330235	3642	3722	12	20	80	0.2500000
NODE_13_length_10749_cov_34.330235	3642	3722	14	5	80	0.0625000
NODE_13_length_10749_cov_34.330235	3718	3798	7	10	80	0.1250000
NODE_13_length_10749_cov_34.330235	3718	3798	8	42	80	0.5250000
NODE_13_length_10749_cov_34.330235	3718	3798	9	15	80	0.1875000
NODE_13_length_10749_cov_34.330235	3718	3798	10	12	80	0.1500000
NODE_13_length_10749_cov_34.330235	3718	3798	11	1	80	0.0125000
NODE_13_length_10749_cov_34.330235	3771	3851	4	23	80	0.2875000
NODE_13_length_10749_cov_34.330235	3771	3851	5	3	80	0.0375000
NODE_13_length_10749_cov_34.330235	3771	3851	6	11	80	0.1375000
NODE_13_length_10749_cov_34.330235	3771	3851	7	1	80	0.0125000
NODE_13_length_10749_cov_34.330235	3771	3851	8	42	80	0.5250000
NODE_14_length_10557_cov_50.055938	423	503	0	20	80	0.2500000
NODE_14_length_10557_cov_50.055938	423	503	2	2	80	0.0250000
NODE_14_length_10557_cov_50.055938	423	503	3	58	80	0.7250000
NODE_14_length_10557_cov_50.055938	476	556	2	13	80	0.1625000
NODE_14_length_10557_cov_50.055938	476	556	3	30	80	0.3750000
NODE_14_length_10557_cov_50.055938	476	556	4	37	80	0.4625000
NODE_14_length_10557_cov_50.055938	1625	1696	3	71	71	1.0000000
NODE_14_length_10557_cov_50.055938	1678	1733	0	1	55	0.0181818
NODE_14_length_10557_cov_50.055938	1678	1733	2	28	55	0.5090909
NODE_14_length_10557_cov_50.055938	1678	1733	3	26	55	0.4727273
NODE_14_length_10557_cov_50.055938	2428	2488	0	53	60	0.8833333
NODE_14_length_10557_cov_50.055938	2428	2488	1	7	60	0.1166667
NODE_17_length_10101_cov_12.236253	923	966	0	43	43	1.0000000
NODE_17_length_10101_cov_12.236253	943	1007	0	64	64	1.0000000
NODE_17_length_10101_cov_12.236253	1715	1795	0	80	80	1.0000000
NODE_17_length_10101_cov_12.236253	1768	1820	0	51	52	0.9807692
NODE_17_length_10101_cov_12.236253	1768	1820	3	1	52	0.0192308
NODE_20_length_9442_cov_109.961147	2108	2188	6	7	80	0.0875000
NODE_20_length_9442_cov_109.961147	2108	2188	7	13	80	0.1625000
NODE_20_length_9442_cov_109.961147	2108	2188	8	3	80	0.0375000
NODE_20_length_9442_cov_109.961147	2108	2188	10	13	80	0.1625000
NODE_20_length_9442_cov_109.961147	2108	2188	11	6	80	0.0750000
NODE_20_length_9442_cov_109.961147	2108	2188	12	22	80	0.2750000
NODE_20_length_9442_cov_109.961147	2108	2188	13	16	80	0.2000000
NODE_20_length_9442_cov_109.961147	2161	2241	8	14	80	0.1750000
NODE_20_length_9442_cov_109.961147	2161	2241	9	25	80	0.3125000
NODE_20_length_9442_cov_109.961147	2161	2241	10	8	80	0.1000000
NODE_20_length_9442_cov_109.961147	2161	2241	11	12	80	0.1500000
NODE_20_length_9442_cov_109.961147	2161	2241	12	5	80	0.0625000
NODE_20_length_9442_cov_109.961147	2161	2241	13	16	80	0.2000000
NODE_21_length_9414_cov_34.165217	2363	2443	12	4	80	0.0500000
NODE_21_length_9414_cov_34.165217	2363	2443	13	12	80	0.1500000
NODE_21_length_9414_cov_34.165217	2363	2443	14	16	80	0.2000000
NODE_21_length_9414_cov_34.165217	2363	2443	15	5	80	0.0625000
NODE_21_length_9414_cov_34.165217	2363	2443	16	11	80	0.1375000
NODE_21_length_9414_cov_34.165217	2363	2443	17	6	80	0.0750000
NODE_21_length_9414_cov_34.165217	2363	2443	18	26	80	0.3250000
NODE_21_length_9414_cov_34.165217	2416	2484	6	5	68	0.0735294
NODE_21_length_9414_cov_34.165217	2416	2484	7	17	68	0.2500000
NODE_21_length_9414_cov_34.165217	2416	2484	8	7	68	0.1029412
NODE_21_length_9414_cov_34.165217	2416	2484	9	1	68	0.0147059
NODE_21_length_9414_cov_34.165217	2416	2484	10	1	68	0.0147059
NODE_21_length_9414_cov_34.165217	2416	2484	11	6	68	0.0882353
NODE_21_length_9414_cov_34.165217	2416	2484	12	8	68	0.1176471
NODE_21_length_9414_cov_34.165217	2416	2484	13	12	68	0.1764706
NODE_21_length_9414_cov_34.165217	2416	2484	14	11	68	0.1617647
NODE_21_length_9414_cov_34.165217	5899	5975	18	5	76	0.0657895
NODE_21_length_9414_cov_34.165217	5899	5975	19	12	76	0.1578947
NODE_21_length_9414_cov_34.165217	5899	5975	20	14	76	0.1842105
NODE_21_length_9414_cov_34.165217	5899	5975	21	14	76	0.1842105
NODE_21_length_9414_cov_34.165217	5899	5975	22	10	76	0.1315790
NODE_21_length_9414_cov_34.165217	5899	5975	23	7	76	0.0921053
NODE_21_length_9414_cov_34.165217	5899	5975	24	14	76	0.1842105
NODE_24_length_9168_cov_47.407542	470	550	31	4	80	0.0500000
NODE_24_length_9168_cov_47.407542	470	550	32	2	80	0.0250000
NODE_24_length_9168_cov_47.407542	470	550	33	1	80	0.0125000
NODE_24_length_9168_cov_47.407542	470	550	34	1	80	0.0125000
NODE_24_length_9168_cov_47.407542	470	550	38	4	80	0.0500000
NODE_24_length_9168_cov_47.407542	470	550	39	6	80	0.0750000
NODE_24_length_9168_cov_47.407542	470	550	40	2	80	0.0250000
NODE_24_length_9168_cov_47.407542	470	550	41	5	80	0.0625000
NODE_24_length_9168_cov_47.407542	470	550	42	1	80	0.0125000
NODE_24_length_9168_cov_47.407542	470	550	43	10	80	0.1250000
NODE_24_length_9168_cov_47.407542	470	550	45	2	80	0.0250000
NODE_24_length_9168_cov_47.407542	470	550	46	1	80	0.0125000
NODE_24_length_9168_cov_47.407542	470	550	48	2	80	0.0250000
NODE_24_length_9168_cov_47.407542	470	550	50	6	80	0.0750000
NODE_24_length_9168_cov_47.407542	470	550	51	3	80	0.0375000
NODE_24_length_9168_cov_47.407542	470	550	52	5	80	0.0625000
NODE_24_length_9168_cov_47.407542	470	550	53	5	80	0.0625000
NODE_24_length_9168_cov_47.407542	470	550	54	3	80	0.0375000
NODE_24_length_9168_cov_47.407542	470	550	55	4	80	0.0500000
NODE_24_length_9168_cov_47.407542	470	550	57	3	80	0.0375000
NODE_24_length_9168_cov_47.407542	470	550	58	3	80	0.0375000
NODE_24_length_9168_cov_47.407542	470	550	59	3	80	0.0375000
NODE_24_length_9168_cov_47.407542	470	550	60	4	80	0.0500000
NODE_24_length_9168_cov_47.407542	523	603	49	3	80	0.0375000
NODE_24_length_9168_cov_47.407542	523	603	50	2	80	0.0250000
NODE_24_length_9168_cov_47.407542	523	603	51	2	80	0.0250000
NODE_24_length_9168_cov_47.407542	523	603	52	5	80	0.0625000
NODE_24_length_9168_cov_47.407542	523	603	53	6	80	0.0750000
NODE_24_length_9168_cov_47.407542	523	603	54	12	80	0.1500000
NODE_24_length_9168_cov_47.407542	523	603	55	5	80	0.0625000
NODE_24_length_9168_cov_47.407542	523	603	56	6	80	0.0750000
NODE_24_length_9168_cov_47.407542	523	603	57	6	80	0.0750000
NODE_24_length_9168_cov_47.407542	523	603	58	8	80	0.1000000
NODE_24_length_9168_cov_47.407542	523	603	59	8	80	0.1000000
NODE_24_length_9168_cov_47.407542	523	603	60	16	80	0.2000000
NODE_24_length_9168_cov_47.407542	523	603	61	1	80	0.0125000
NODE_27_length_9108_cov_47.430347	4786	4866	52	16	80	0.2000000
NODE_27_length_9108_cov_47.430347	4786	4866	53	5	80	0.0625000
NODE_27_length_9108_cov_47.430347	4786	4866	54	1	80	0.0125000
NODE_27_length_9108_cov_47.430347	4786	4866	55	3	80	0.0375000
NODE_27_length_9108_cov_47.430347	4786	4866	56	1	80	0.0125000
NODE_27_length_9108_cov_47.430347	4786	4866	57	8	80	0.1000000
NODE_27_length_9108_cov_47.430347	4786	4866	58	5	80	0.0625000
NODE_27_length_9108_cov_47.430347	4786	4866	59	7	80	0.0875000
NODE_27_length_9108_cov_47.430347	4786	4866	60	2	80	0.0250000
NODE_27_length_9108_cov_47.430347	4786	4866	61	12	80	0.1500000
NODE_27_length_9108_cov_47.430347	4786	4866	62	3	80	0.0375000
NODE_27_length_9108_cov_47.430347	4786	4866	63	5	80	0.0625000
NODE_27_length_9108_cov_47.430347	4786	4866	64	1	80	0.0125000
NODE_27_length_9108_cov_47.430347	4786	4866	65	1	80	0.0125000
NODE_27_length_9108_cov_47.430347	4786	4866	66	1	80	0.0125000
NODE_27_length_9108_cov_47.430347	4786	4866	67	3	80	0.0375000
NODE_27_length_9108_cov_47.430347	4786	4866	68	2	80	0.0250000
NODE_27_length_9108_cov_47.430347	4786	4866	69	4	80	0.0500000
NODE_27_length_9108_cov_47.430347	4839	4902	47	1	63	0.0158730
NODE_27_length_9108_cov_47.430347	4839	4902	48	3	63	0.0476190
NODE_27_length_9108_cov_47.430347	4839	4902	49	3	63	0.0476190
NODE_27_length_9108_cov_47.430347	4839	4902	50	4	63	0.0634921
NODE_27_length_9108_cov_47.430347	4839	4902	51	3	63	0.0476190
NODE_27_length_9108_cov_47.430347	4839	4902	52	25	63	0.3968254
NODE_27_length_9108_cov_47.430347	4839	4902	53	6	63	0.0952381
NODE_27_length_9108_cov_47.430347	4839	4902	54	2	63	0.0317460
NODE_27_length_9108_cov_47.430347	4839	4902	55	10	63	0.1587302
NODE_27_length_9108_cov_47.430347	4839	4902	56	4	63	0.0634921
NODE_27_length_9108_cov_47.430347	4839	4902	57	2	63	0.0317460
NODE_27_length_9108_cov_47.430347	4895	4963	24	1	68	0.0147059
NODE_27_length_9108_cov_47.430347	4895	4963	25	6	68	0.0882353
NODE_27_length_9108_cov_47.430347	4895	4963	27	5	68	0.0735294
NODE_27_length_9108_cov_47.430347	4895	4963	29	1	68	0.0147059
NODE_27_length_9108_cov_47.430347	4895	4963	31	1	68	0.0147059
NODE_27_length_9108_cov_47.430347	4895	4963	32	6	68	0.0882353
NODE_27_length_9108_cov_47.430347	4895	4963	33	2	68	0.0294118
NODE_27_length_9108_cov_47.430347	4895	4963	34	7	68	0.1029412
NODE_27_length_9108_cov_47.430347	4895	4963	35	5	68	0.0735294
NODE_27_length_9108_cov_47.430347	4895	4963	38	10	68	0.1470588
NODE_27_length_9108_cov_47.430347	4895	4963	39	5	68	0.0735294
NODE_27_length_9108_cov_47.430347	4895	4963	40	1	68	0.0147059
NODE_27_length_9108_cov_47.430347	4895	4963	41	1	68	0.0147059
NODE_27_length_9108_cov_47.430347	4895	4963	43	3	68	0.0441176
NODE_27_length_9108_cov_47.430347	4895	4963	44	4	68	0.0588235
NODE_27_length_9108_cov_47.430347	4895	4963	45	1	68	0.0147059
NODE_27_length_9108_cov_47.430347	4895	4963	47	3	68	0.0441176
NODE_27_length_9108_cov_47.430347	4895	4963	49	3	68	0.0441176
NODE_27_length_9108_cov_47.430347	4895	4963	51	1	68	0.0147059
NODE_27_length_9108_cov_47.430347	4895	4963	52	2	68	0.0294118
NODE_27_length_9108_cov_47.430347	4936	5016	3	3	80	0.0375000
NODE_27_length_9108_cov_47.430347	4936	5016	5	8	80	0.1000000
NODE_27_length_9108_cov_47.430347	4936	5016	7	1	80	0.0125000
NODE_27_length_9108_cov_47.430347	4936	5016	9	5	80	0.0625000
NODE_27_length_9108_cov_47.430347	4936	5016	10	5	80	0.0625000
NODE_27_length_9108_cov_47.430347	4936	5016	11	4	80	0.0500000
NODE_27_length_9108_cov_47.430347	4936	5016	12	1	80	0.0125000
NODE_27_length_9108_cov_47.430347	4936	5016	13	2	80	0.0250000
NODE_27_length_9108_cov_47.430347	4936	5016	14	3	80	0.0375000
NODE_27_length_9108_cov_47.430347	4936	5016	15	1	80	0.0125000
NODE_27_length_9108_cov_47.430347	4936	5016	17	5	80	0.0625000
NODE_27_length_9108_cov_47.430347	4936	5016	18	2	80	0.0250000
NODE_27_length_9108_cov_47.430347	4936	5016	20	5	80	0.0625000
NODE_27_length_9108_cov_47.430347	4936	5016	21	3	80	0.0375000
NODE_27_length_9108_cov_47.430347	4936	5016	24	6	80	0.0750000
NODE_27_length_9108_cov_47.430347	4936	5016	25	6	80	0.0750000
NODE_27_length_9108_cov_47.430347	4936	5016	27	5	80	0.0625000
NODE_27_length_9108_cov_47.430347	4936	5016	29	1	80	0.0125000
NODE_27_length_9108_cov_47.430347	4936	5016	31	1	80	0.0125000
NODE_27_length_9108_cov_47.430347	4936	5016	32	6	80	0.0750000
NODE_27_length_9108_cov_47.430347	4936	5016	33	2	80	0.0250000
NODE_27_length_9108_cov_47.430347	4936	5016	34	5	80	0.0625000
NODE_28_length_9108_cov_26.469974	44	120	0	31	76	0.4078947
NODE_28_length_9108_cov_26.469974	44	120	2	45	76	0.5921053
NODE_28_length_9108_cov_26.469974	7711	7791	3	1	80	0.0125000
NODE_28_length_9108_cov_26.469974	7711	7791	10	2	80	0.0250000
NODE_28_length_9108_cov_26.469974	7711	7791	14	2	80	0.0250000
NODE_28_length_9108_cov_26.469974	7711	7791	15	1	80	0.0125000
NODE_28_length_9108_cov_26.469974	7711	7791	16	2	80	0.0250000
NODE_28_length_9108_cov_26.469974	7711	7791	17	10	80	0.1250000
NODE_28_length_9108_cov_26.469974	7711	7791	18	2	80	0.0250000
NODE_28_length_9108_cov_26.469974	7711	7791	19	1	80	0.0125000
NODE_28_length_9108_cov_26.469974	7711	7791	20	2	80	0.0250000
NODE_28_length_9108_cov_26.469974	7711	7791	22	1	80	0.0125000
NODE_28_length_9108_cov_26.469974	7711	7791	23	3	80	0.0375000
NODE_28_length_9108_cov_26.469974	7711	7791	26	2	80	0.0250000
NODE_28_length_9108_cov_26.469974	7711	7791	27	2	80	0.0250000
NODE_28_length_9108_cov_26.469974	7711	7791	31	1	80	0.0125000
NODE_28_length_9108_cov_26.469974	7711	7791	32	1	80	0.0125000
NODE_28_length_9108_cov_26.469974	7711	7791	34	2	80	0.0250000
NODE_28_length_9108_cov_26.469974	7711	7791	35	4	80	0.0500000
NODE_28_length_9108_cov_26.469974	7711	7791	36	2	80	0.0250000
NODE_28_length_9108_cov_26.469974	7711	7791	37	1	80	0.0125000
NODE_28_length_9108_cov_26.469974	7711	7791	39	1	80	0.0125000
NODE_28_length_9108_cov_26.469974	7711	7791	41	1	80	0.0125000
NODE_28_length_9108_cov_26.469974	7711	7791	42	1	80	0.0125000
NODE_28_length_9108_cov_26.469974	7711	7791	43	2	80	0.0250000
NODE_28_length_9108_cov_26.469974	7711	7791	44	3	80	0.0375000
NODE_28_length_9108_cov_26.469974	7711	7791	45	1	80	0.0125000
NODE_28_length_9108_cov_26.469974	7711	7791	46	2	80	0.0250000
NODE_28_length_9108_cov_26.469974	7711	7791	50	3	80	0.0375000
NODE_28_length_9108_cov_26.469974	7711	7791	52	1	80	0.0125000
NODE_28_length_9108_cov_26.469974	7711	7791	55	1	80	0.0125000
NODE_28_length_9108_cov_26.469974	7711	7791	57	1	80	0.0125000
NODE_28_length_9108_cov_26.469974	7711	7791	59	2	80	0.0250000
NODE_28_length_9108_cov_26.469974	7711	7791	61	1	80	0.0125000
NODE_28_length_9108_cov_26.469974	7711	7791	62	4	80	0.0500000
NODE_28_length_9108_cov_26.469974	7711	7791	64	1	80	0.0125000
NODE_28_length_9108_cov_26.469974	7711	7791	66	1	80	0.0125000
NODE_28_length_9108_cov_26.469974	7711	7791	68	1	80	0.0125000
NODE_28_length_9108_cov_26.469974	7711	7791	69	2	80	0.0250000
NODE_28_length_9108_cov_26.469974	7711	7791	70	1	80	0.0125000
NODE_28_length_9108_cov_26.469974	7711	7791	71	1	80	0.0125000
NODE_28_length_9108_cov_26.469974	7711	7791	72	1	80	0.0125000
NODE_28_length_9108_cov_26.469974	7711	7791	75	1	80	0.0125000
NODE_28_length_9108_cov_26.469974	7711	7791	78	2	80	0.0250000
NODE_28_length_9108_cov_26.469974	7711	7791	81	1	80	0.0125000
NODE_28_length_9108_cov_26.469974	7711	7791	82	2	80	0.0250000
NODE_28_length_9108_cov_26.469974	8144	8224	2	1	80	0.0125000
NODE_28_length_9108_cov_26.469974	8144	8224	4	5	80	0.0625000
NODE_28_length_9108_cov_26.469974	8144	8224	5	2	80	0.0250000
NODE_28_length_9108_cov_26.469974	8144	8224	8	3	80	0.0375000
NODE_28_length_9108_cov_26.469974	8144	8224	9	2	80	0.0250000
NODE_28_length_9108_cov_26.469974	8144	8224	10	4	80	0.0500000
NODE_28_length_9108_cov_26.469974	8144	8224	11	1	80	0.0125000
NODE_28_length_9108_cov_26.469974	8144	8224	12	1	80	0.0125000
NODE_28_length_9108_cov_26.469974	8144	8224	14	6	80	0.0750000
NODE_28_length_9108_cov_26.469974	8144	8224	15	6	80	0.0750000
NODE_28_length_9108_cov_26.469974	8144	8224	17	7	80	0.0875000
NODE_28_length_9108_cov_26.469974	8144	8224	19	2	80	0.0250000
NODE_28_length_9108_cov_26.469974	8144	8224	21	1	80	0.0125000
NODE_28_length_9108_cov_26.469974	8144	8224	23	2	80	0.0250000
NODE_28_length_9108_cov_26.469974	8144	8224	25	2	80	0.0250000
NODE_28_length_9108_cov_26.469974	8144	8224	27	1	80	0.0125000
NODE_28_length_9108_cov_26.469974	8144	8224	29	7	80	0.0875000
NODE_28_length_9108_cov_26.469974	8144	8224	30	7	80	0.0875000
NODE_28_length_9108_cov_26.469974	8144	8224	31	1	80	0.0125000
NODE_28_length_9108_cov_26.469974	8144	8224	35	1	80	0.0125000
NODE_28_length_9108_cov_26.469974	8144	8224	37	1	80	0.0125000
NODE_28_length_9108_cov_26.469974	8144	8224	41	3	80	0.0375000
NODE_28_length_9108_cov_26.469974	8144	8224	43	7	80	0.0875000
NODE_28_length_9108_cov_26.469974	8144	8224	44	3	80	0.0375000
NODE_28_length_9108_cov_26.469974	8144	8224	45	2	80	0.0250000
NODE_28_length_9108_cov_26.469974	8144	8224	46	2	80	0.0250000
NODE_28_length_9108_cov_26.469974	8568	8648	3	2	80	0.0250000
NODE_28_length_9108_cov_26.469974	8568	8648	4	78	80	0.9750000
NODE_28_length_9108_cov_26.469974	8621	8701	2	19	80	0.2375000
NODE_28_length_9108_cov_26.469974	8621	8701	3	27	80	0.3375000
NODE_28_length_9108_cov_26.469974	8621	8701	4	34	80	0.4250000
NODE_30_length_8743_cov_14.172721	7849	7929	2	5	80	0.0625000
NODE_30_length_8743_cov_14.172721	7849	7929	4	18	80	0.2250000
NODE_30_length_8743_cov_14.172721	7849	7929	5	12	80	0.1500000
NODE_30_length_8743_cov_14.172721	7849	7929	6	31	80	0.3875000
NODE_30_length_8743_cov_14.172721	7849	7929	7	14	80	0.1750000
NODE_30_length_8743_cov_14.172721	7902	7964	0	18	62	0.2903226
NODE_30_length_8743_cov_14.172721	7902	7964	1	10	62	0.1612903
NODE_30_length_8743_cov_14.172721	7902	7964	2	12	62	0.1935484
NODE_30_length_8743_cov_14.172721	7902	7964	4	18	62	0.2903226
NODE_30_length_8743_cov_14.172721	7902	7964	5	4	62	0.0645161
NODE_32_length_8707_cov_6.353044	8541	8621	5	47	80	0.5875000
NODE_32_length_8707_cov_6.353044	8541	8621	6	27	80	0.3375000
NODE_32_length_8707_cov_6.353044	8541	8621	7	6	80	0.0750000
NODE_32_length_8707_cov_6.353044	8541	8621	5	47	80	0.5875000
NODE_32_length_8707_cov_6.353044	8541	8621	6	27	80	0.3375000
NODE_32_length_8707_cov_6.353044	8541	8621	7	6	80	0.0750000
NODE_32_length_8707_cov_6.353044	8541	8621	5	47	80	0.5875000
NODE_32_length_8707_cov_6.353044	8541	8621	6	27	80	0.3375000
NODE_32_length_8707_cov_6.353044	8541	8621	7	6	80	0.0750000
NODE_32_length_8707_cov_6.353044	8594	8674	2	32	80	0.4000000
NODE_32_length_8707_cov_6.353044	8594	8674	5	27	80	0.3375000
NODE_32_length_8707_cov_6.353044	8594	8674	6	21	80	0.2625000
NODE_32_length_8707_cov_6.353044	8594	8674	2	32	80	0.4000000
NODE_32_length_8707_cov_6.353044	8594	8674	5	27	80	0.3375000
NODE_32_length_8707_cov_6.353044	8594	8674	6	21	80	0.2625000
NODE_32_length_8707_cov_6.353044	8594	8673	2	31	79	0.3924051
NODE_32_length_8707_cov_6.353044	8594	8673	5	27	79	0.3417721
NODE_32_length_8707_cov_6.353044	8594	8673	6	21	79	0.2658228
NODE_32_length_8707_cov_6.353044	8599	8674	2	32	75	0.4266667
NODE_32_length_8707_cov_6.353044	8599	8674	5	27	75	0.3600000
NODE_32_length_8707_cov_6.353044	8599	8674	6	16	75	0.2133333
NODE_38_length_8281_cov_13.025177	7108	7188	0	13	80	0.1625000
NODE_38_length_8281_cov_13.025177	7108	7188	1	25	80	0.3125000
NODE_38_length_8281_cov_13.025177	7108	7188	3	18	80	0.2250000
NODE_38_length_8281_cov_13.025177	7108	7188	4	3	80	0.0375000
NODE_38_length_8281_cov_13.025177	7108	7188	5	21	80	0.2625000
NODE_38_length_8281_cov_13.025177	7161	7199	3	3	38	0.0789474
NODE_38_length_8281_cov_13.025177	7161	7199	4	3	38	0.0789474
NODE_38_length_8281_cov_13.025177	7161	7199	5	32	38	0.8421053
NODE_38_length_8281_cov_13.025177	7175	7255	5	41	80	0.5125000
NODE_38_length_8281_cov_13.025177	7175	7255	6	12	80	0.1500000
NODE_38_length_8281_cov_13.025177	7175	7255	7	27	80	0.3375000
NODE_38_length_8281_cov_13.025177	7228	7308	3	41	80	0.5125000
NODE_38_length_8281_cov_13.025177	7228	7308	5	3	80	0.0375000
NODE_38_length_8281_cov_13.025177	7228	7308	6	3	80	0.0375000
NODE_38_length_8281_cov_13.025177	7228	7308	7	33	80	0.4125000
NODE_38_length_8281_cov_13.025177	7749	7829	9	38	80	0.4750000
NODE_38_length_8281_cov_13.025177	7749	7829	11	15	80	0.1875000
NODE_38_length_8281_cov_13.025177	7749	7829	12	15	80	0.1875000
NODE_38_length_8281_cov_13.025177	7749	7829	13	12	80	0.1500000
NODE_38_length_8281_cov_13.025177	7802	7882	11	2	80	0.0250000
NODE_38_length_8281_cov_13.025177	7802	7882	12	30	80	0.3750000
NODE_38_length_8281_cov_13.025177	7802	7882	13	30	80	0.3750000
NODE_38_length_8281_cov_13.025177	7802	7882	14	17	80	0.2125000
NODE_38_length_8281_cov_13.025177	7802	7882	15	1	80	0.0125000
NODE_38_length_8281_cov_13.025177	7878	7958	7	6	80	0.0750000
NODE_38_length_8281_cov_13.025177	7878	7958	8	23	80	0.2875000
NODE_38_length_8281_cov_13.025177	7878	7958	9	30	80	0.3750000
NODE_38_length_8281_cov_13.025177	7878	7958	10	13	80	0.1625000
NODE_38_length_8281_cov_13.025177	7878	7958	11	6	80	0.0750000
NODE_38_length_8281_cov_13.025177	7878	7958	12	2	80	0.0250000
NODE_38_length_8281_cov_13.025177	7931	8011	4	11	80	0.1375000
NODE_38_length_8281_cov_13.025177	7931	8011	5	4	80	0.0500000
NODE_38_length_8281_cov_13.025177	7931	8011	6	1	80	0.0125000
NODE_38_length_8281_cov_13.025177	7931	8011	7	34	80	0.4250000
NODE_38_length_8281_cov_13.025177	7931	8011	8	30	80	0.3750000
NODE_39_length_8259_cov_60.011152	1424	1504	21	5	80	0.0625000
NODE_39_length_8259_cov_60.011152	1424	1504	25	4	80	0.0500000
NODE_39_length_8259_cov_60.011152	1424	1504	26	4	80	0.0500000
NODE_39_length_8259_cov_60.011152	1424	1504	28	4	80	0.0500000
NODE_39_length_8259_cov_60.011152	1424	1504	29	33	80	0.4125000
NODE_39_length_8259_cov_60.011152	1424	1504	30	6	80	0.0750000
NODE_39_length_8259_cov_60.011152	1424	1504	31	24	80	0.3000000
NODE_39_length_8259_cov_60.011152	1477	1549	16	2	72	0.0277778
NODE_39_length_8259_cov_60.011152	1477	1549	17	4	72	0.0555556
NODE_39_length_8259_cov_60.011152	1477	1549	20	1	72	0.0138889
NODE_39_length_8259_cov_60.011152	1477	1549	21	2	72	0.0277778
NODE_39_length_8259_cov_60.011152	1477	1549	23	1	72	0.0138889
NODE_39_length_8259_cov_60.011152	1477	1549	24	7	72	0.0972222
NODE_39_length_8259_cov_60.011152	1477	1549	25	3	72	0.0416667
NODE_39_length_8259_cov_60.011152	1477	1549	26	9	72	0.1250000
NODE_39_length_8259_cov_60.011152	1477	1549	27	12	72	0.1666667
NODE_39_length_8259_cov_60.011152	1477	1549	29	28	72	0.3888889
NODE_39_length_8259_cov_60.011152	1477	1549	30	2	72	0.0277778
NODE_39_length_8259_cov_60.011152	1477	1549	31	1	72	0.0138889
NODE_40_length_8228_cov_17.079592	314	394	0	80	80	1.0000000
NODE_40_length_8228_cov_17.079592	367	447	0	80	80	1.0000000
NODE_40_length_8228_cov_17.079592	443	523	0	71	80	0.8875000
NODE_40_length_8228_cov_17.079592	443	523	2	9	80	0.1125000
NODE_40_length_8228_cov_17.079592	496	576	0	18	80	0.2250000
NODE_40_length_8228_cov_17.079592	496	576	2	62	80	0.7750000
NODE_40_length_8228_cov_17.079592	3154	3217	4	1	63	0.0158730
NODE_40_length_8228_cov_17.079592	3154	3217	11	1	63	0.0158730
NODE_40_length_8228_cov_17.079592	3154	3217	13	7	63	0.1111111
NODE_40_length_8228_cov_17.079592	3154	3217	15	16	63	0.2539683
NODE_40_length_8228_cov_17.079592	3154	3217	17	5	63	0.0793651
NODE_40_length_8228_cov_17.079592	3154	3217	19	3	63	0.0476190
NODE_40_length_8228_cov_17.079592	3154	3217	21	30	63	0.4761905
NODE_43_length_8100_cov_32.115236	501	581	11	8	80	0.1000000
NODE_43_length_8100_cov_32.115236	501	581	13	3	80	0.0375000
NODE_43_length_8100_cov_32.115236	501	581	14	4	80	0.0500000
NODE_43_length_8100_cov_32.115236	501	581	15	16	80	0.2000000
NODE_43_length_8100_cov_32.115236	501	581	16	32	80	0.4000000
NODE_43_length_8100_cov_32.115236	501	581	17	14	80	0.1750000
NODE_43_length_8100_cov_32.115236	501	581	18	3	80	0.0375000
NODE_43_length_8100_cov_32.115236	554	634	12	9	80	0.1125000
NODE_43_length_8100_cov_32.115236	554	634	13	16	80	0.2000000
NODE_43_length_8100_cov_32.115236	554	634	14	3	80	0.0375000
NODE_43_length_8100_cov_32.115236	554	634	15	10	80	0.1250000
NODE_43_length_8100_cov_32.115236	554	634	16	25	80	0.3125000
NODE_43_length_8100_cov_32.115236	554	634	17	14	80	0.1750000
NODE_43_length_8100_cov_32.115236	554	634	18	3	80	0.0375000
NODE_43_length_8100_cov_32.115236	1383	1463	0	80	80	1.0000000
NODE_43_length_8100_cov_32.115236	1436	1516	0	80	80	1.0000000
NODE_43_length_8100_cov_32.115236	3391	3462	98	1	71	0.0140845
NODE_43_length_8100_cov_32.115236	3391	3462	100	2	71	0.0281690
NODE_43_length_8100_cov_32.115236	3391	3462	101	2	71	0.0281690
NODE_43_length_8100_cov_32.115236	3391	3462	102	1	71	0.0140845
NODE_43_length_8100_cov_32.115236	3391	3462	104	2	71	0.0281690
NODE_43_length_8100_cov_32.115236	3391	3462	105	1	71	0.0140845
NODE_43_length_8100_cov_32.115236	3391	3462	106	3	71	0.0422535
NODE_43_length_8100_cov_32.115236	3391	3462	107	6	71	0.0845070
NODE_43_length_8100_cov_32.115236	3391	3462	108	2	71	0.0281690
NODE_43_length_8100_cov_32.115236	3391	3462	109	5	71	0.0704225
NODE_43_length_8100_cov_32.115236	3391	3462	110	5	71	0.0704225
NODE_43_length_8100_cov_32.115236	3391	3462	111	2	71	0.0281690
NODE_43_length_8100_cov_32.115236	3391	3462	114	1	71	0.0140845
NODE_43_length_8100_cov_32.115236	3391	3462	115	4	71	0.0563380
NODE_43_length_8100_cov_32.115236	3391	3462	116	10	71	0.1408451
NODE_43_length_8100_cov_32.115236	3391	3462	117	7	71	0.0985916
NODE_43_length_8100_cov_32.115236	3391	3462	118	5	71	0.0704225
NODE_43_length_8100_cov_32.115236	3391	3462	120	2	71	0.0281690
NODE_43_length_8100_cov_32.115236	3391	3462	121	3	71	0.0422535
NODE_43_length_8100_cov_32.115236	3391	3462	122	5	71	0.0704225
NODE_43_length_8100_cov_32.115236	3391	3462	123	2	71	0.0281690
NODE_43_length_8100_cov_32.115236	3435	3483	76	1	48	0.0208333
NODE_43_length_8100_cov_32.115236	3435	3483	77	5	48	0.1041667
NODE_43_length_8100_cov_32.115236	3435	3483	78	3	48	0.0625000
NODE_43_length_8100_cov_32.115236	3435	3483	80	1	48	0.0208333
NODE_43_length_8100_cov_32.115236	3435	3483	82	1	48	0.0208333
NODE_43_length_8100_cov_32.115236	3435	3483	83	2	48	0.0416667
NODE_43_length_8100_cov_32.115236	3435	3483	84	3	48	0.0625000
NODE_43_length_8100_cov_32.115236	3435	3483	90	1	48	0.0208333
NODE_43_length_8100_cov_32.115236	3435	3483	91	1	48	0.0208333
NODE_43_length_8100_cov_32.115236	3435	3483	92	1	48	0.0208333
NODE_43_length_8100_cov_32.115236	3435	3483	94	1	48	0.0208333
NODE_43_length_8100_cov_32.115236	3435	3483	97	1	48	0.0208333
NODE_43_length_8100_cov_32.115236	3435	3483	98	1	48	0.0208333
NODE_43_length_8100_cov_32.115236	3435	3483	100	2	48	0.0416667
NODE_43_length_8100_cov_32.115236	3435	3483	101	2	48	0.0416667
NODE_43_length_8100_cov_32.115236	3435	3483	102	1	48	0.0208333
NODE_43_length_8100_cov_32.115236	3435	3483	104	2	48	0.0416667
NODE_43_length_8100_cov_32.115236	3435	3483	105	1	48	0.0208333
NODE_43_length_8100_cov_32.115236	3435	3483	106	2	48	0.0416667
NODE_43_length_8100_cov_32.115236	3435	3483	107	6	48	0.1250000
NODE_43_length_8100_cov_32.115236	3435	3483	108	1	48	0.0208333
NODE_43_length_8100_cov_32.115236	3435	3483	109	3	48	0.0625000
NODE_43_length_8100_cov_32.115236	3435	3483	110	4	48	0.0833333
NODE_43_length_8100_cov_32.115236	3435	3483	111	2	48	0.0416667
NODE_46_length_7962_cov_31.622790	6281	6363	23	8	82	0.0975610
NODE_46_length_7962_cov_31.622790	6281	6363	24	21	82	0.2560976
NODE_46_length_7962_cov_31.622790	6281	6363	25	25	82	0.3048781
NODE_46_length_7962_cov_31.622790	6281	6363	26	15	82	0.1829268
NODE_46_length_7962_cov_31.622790	6281	6363	27	12	82	0.1463415
NODE_46_length_7962_cov_31.622790	6281	6363	28	1	82	0.0121951
NODE_47_length_7944_cov_12.238496	348	419	0	34	71	0.4788733
NODE_47_length_7944_cov_12.238496	348	419	2	37	71	0.5211267
NODE_48_length_7919_cov_14.554859	2380	2460	12	12	80	0.1500000
NODE_48_length_7919_cov_14.554859	2380	2460	13	6	80	0.0750000
NODE_48_length_7919_cov_14.554859	2380	2460	14	2	80	0.0250000
NODE_48_length_7919_cov_14.554859	2380	2460	15	17	80	0.2125000
NODE_48_length_7919_cov_14.554859	2380	2460	16	1	80	0.0125000
NODE_48_length_7919_cov_14.554859	2380	2460	17	1	80	0.0125000
NODE_48_length_7919_cov_14.554859	2380	2460	18	27	80	0.3375000
NODE_48_length_7919_cov_14.554859	2380	2460	19	5	80	0.0625000
NODE_48_length_7919_cov_14.554859	2380	2460	20	5	80	0.0625000
NODE_48_length_7919_cov_14.554859	2380	2460	21	2	80	0.0250000
NODE_48_length_7919_cov_14.554859	2380	2460	22	2	80	0.0250000
NODE_50_length_7830_cov_4.211098	0	52	0	52	52	1.0000000
NODE_50_length_7830_cov_4.211098	30	105	0	75	75	1.0000000
NODE_52_length_7779_cov_20.230859	7691	7771	0	80	80	1.0000000
NODE_52_length_7779_cov_20.230859	7691	7771	0	80	80	1.0000000
NODE_52_length_7779_cov_20.230859	7691	7761	0	70	70	1.0000000
NODE_52_length_7779_cov_20.230859	7744	7779	0	35	35	1.0000000
NODE_53_length_7765_cov_18.871119	254	322	0	10	68	0.1470588
NODE_53_length_7765_cov_18.871119	254	322	1	40	68	0.5882353
NODE_53_length_7765_cov_18.871119	254	322	4	3	68	0.0441176
NODE_53_length_7765_cov_18.871119	254	322	6	3	68	0.0441176
NODE_53_length_7765_cov_18.871119	254	322	8	7	68	0.1029412
NODE_53_length_7765_cov_18.871119	254	322	11	2	68	0.0294118
NODE_53_length_7765_cov_18.871119	254	322	13	3	68	0.0441176
NODE_53_length_7765_cov_18.871119	353	433	1	80	80	1.0000000
NODE_61_length_7411_cov_74.967314	2283	2347	4	57	64	0.8906250
NODE_61_length_7411_cov_74.967314	2283	2347	5	7	64	0.1093750
NODE_61_length_7411_cov_74.967314	4725	4789	0	64	64	1.0000000
NODE_64_length_7305_cov_3.696087	971	1019	0	15	48	0.3125000
NODE_64_length_7305_cov_3.696087	971	1019	1	25	48	0.5208333
NODE_64_length_7305_cov_3.696087	971	1019	2	8	48	0.1666667
NODE_64_length_7305_cov_3.696087	7142	7190	0	47	48	0.9791667
NODE_64_length_7305_cov_3.696087	7142	7190	4	1	48	0.0208333
NODE_66_length_7261_cov_12.433398	2313	2395	108	1	82	0.0121951
NODE_66_length_7261_cov_12.433398	2313	2395	109	1	82	0.0121951
NODE_66_length_7261_cov_12.433398	2313	2395	110	2	82	0.0243902
NODE_66_length_7261_cov_12.433398	2313	2395	111	5	82	0.0609756
NODE_66_length_7261_cov_12.433398	2313	2395	112	4	82	0.0487805
NODE_66_length_7261_cov_12.433398	2313	2395	113	2	82	0.0243902
NODE_66_length_7261_cov_12.433398	2313	2395	114	5	82	0.0609756
NODE_66_length_7261_cov_12.433398	2313	2395	115	1	82	0.0121951
NODE_66_length_7261_cov_12.433398	2313	2395	116	5	82	0.0609756
NODE_66_length_7261_cov_12.433398	2313	2395	117	4	82	0.0487805
NODE_66_length_7261_cov_12.433398	2313	2395	118	3	82	0.0365854
NODE_66_length_7261_cov_12.433398	2313	2395	119	2	82	0.0243902
NODE_66_length_7261_cov_12.433398	2313	2395	120	2	82	0.0243902
NODE_66_length_7261_cov_12.433398	2313	2395	121	2	82	0.0243902
NODE_66_length_7261_cov_12.433398	2313	2395	123	2	82	0.0243902
NODE_66_length_7261_cov_12.433398	2313	2395	125	1	82	0.0121951
NODE_66_length_7261_cov_12.433398	2313	2395	126	2	82	0.0243902
NODE_66_length_7261_cov_12.433398	2313	2395	127	1	82	0.0121951
NODE_66_length_7261_cov_12.433398	2313	2395	128	3	82	0.0365854
NODE_66_length_7261_cov_12.433398	2313	2395	129	3	82	0.0365854
NODE_66_length_7261_cov_12.433398	2313	2395	130	2	82	0.0243902
NODE_66_length_7261_cov_12.433398	2313	2395	131	4	82	0.0487805
NODE_66_length_7261_cov_12.433398	2313	2395	132	5	82	0.0609756
NODE_66_length_7261_cov_12.433398	2313	2395	133	5	82	0.0609756
NODE_66_length_7261_cov_12.433398	2313	2395	134	4	82	0.0487805
NODE_66_length_7261_cov_12.433398	2313	2395	135	1	82	0.0121951
NODE_66_length_7261_cov_12.433398	2313	2395	136	6	82	0.0731707
NODE_66_length_7261_cov_12.433398	2313	2395	137	3	82	0.0365854
NODE_66_length_7261_cov_12.433398	2313	2395	138	1	82	0.0121951
NODE_73_length_7036_cov_65.961943	4375	4455	0	62	80	0.7750000
NODE_73_length_7036_cov_65.961943	4375	4455	1	18	80	0.2250000
NODE_73_length_7036_cov_65.961943	5538	5618	43	1	80	0.0125000
NODE_73_length_7036_cov_65.961943	5538	5618	44	1	80	0.0125000
NODE_73_length_7036_cov_65.961943	5538	5618	45	2	80	0.0250000
NODE_73_length_7036_cov_65.961943	5538	5618	49	1	80	0.0125000
NODE_73_length_7036_cov_65.961943	5538	5618	53	2	80	0.0250000
NODE_73_length_7036_cov_65.961943	5538	5618	54	1	80	0.0125000
NODE_73_length_7036_cov_65.961943	5538	5618	56	1	80	0.0125000
NODE_73_length_7036_cov_65.961943	5538	5618	62	1	80	0.0125000
NODE_73_length_7036_cov_65.961943	5538	5618	64	2	80	0.0250000
NODE_73_length_7036_cov_65.961943	5538	5618	66	1	80	0.0125000
NODE_73_length_7036_cov_65.961943	5538	5618	71	1	80	0.0125000
NODE_73_length_7036_cov_65.961943	5538	5618	72	1	80	0.0125000
NODE_73_length_7036_cov_65.961943	5538	5618	74	1	80	0.0125000
NODE_73_length_7036_cov_65.961943	5538	5618	75	3	80	0.0375000
NODE_73_length_7036_cov_65.961943	5538	5618	78	2	80	0.0250000
NODE_73_length_7036_cov_65.961943	5538	5618	83	2	80	0.0250000
NODE_73_length_7036_cov_65.961943	5538	5618	87	2	80	0.0250000
NODE_73_length_7036_cov_65.961943	5538	5618	89	2	80	0.0250000
NODE_73_length_7036_cov_65.961943	5538	5618	91	1	80	0.0125000
NODE_73_length_7036_cov_65.961943	5538	5618	92	1	80	0.0125000
NODE_73_length_7036_cov_65.961943	5538	5618	95	1	80	0.0125000
NODE_73_length_7036_cov_65.961943	5538	5618	98	1	80	0.0125000
NODE_73_length_7036_cov_65.961943	5538	5618	99	1	80	0.0125000
NODE_73_length_7036_cov_65.961943	5538	5618	102	1	80	0.0125000
NODE_73_length_7036_cov_65.961943	5538	5618	103	1	80	0.0125000
NODE_73_length_7036_cov_65.961943	5538	5618	105	1	80	0.0125000
NODE_73_length_7036_cov_65.961943	5538	5618	110	1	80	0.0125000
NODE_73_length_7036_cov_65.961943	5538	5618	111	2	80	0.0250000
NODE_73_length_7036_cov_65.961943	5538	5618	112	1	80	0.0125000
NODE_73_length_7036_cov_65.961943	5538	5618	114	1	80	0.0125000
NODE_73_length_7036_cov_65.961943	5538	5618	117	1	80	0.0125000
NODE_73_length_7036_cov_65.961943	5538	5618	118	2	80	0.0250000
NODE_73_length_7036_cov_65.961943	5538	5618	120	1	80	0.0125000
NODE_73_length_7036_cov_65.961943	5538	5618	121	1	80	0.0125000
NODE_73_length_7036_cov_65.961943	5538	5618	122	2	80	0.0250000
NODE_73_length_7036_cov_65.961943	5538	5618	128	1	80	0.0125000
NODE_73_length_7036_cov_65.961943	5538	5618	129	2	80	0.0250000
NODE_73_length_7036_cov_65.961943	5538	5618	132	1	80	0.0125000
NODE_73_length_7036_cov_65.961943	5538	5618	133	1	80	0.0125000
NODE_73_length_7036_cov_65.961943	5538	5618	137	2	80	0.0250000
NODE_73_length_7036_cov_65.961943	5538	5618	138	1	80	0.0125000
NODE_73_length_7036_cov_65.961943	5538	5618	142	1	80	0.0125000
NODE_73_length_7036_cov_65.961943	5538	5618	144	1	80	0.0125000
NODE_73_length_7036_cov_65.961943	5538	5618	148	1	80	0.0125000
NODE_73_length_7036_cov_65.961943	5538	5618	151	2	80	0.0250000
NODE_73_length_7036_cov_65.961943	5538	5618	152	1	80	0.0125000
NODE_73_length_7036_cov_65.961943	5538	5618	154	1	80	0.0125000
NODE_73_length_7036_cov_65.961943	5538	5618	156	1	80	0.0125000
NODE_73_length_7036_cov_65.961943	5538	5618	158	1	80	0.0125000
NODE_73_length_7036_cov_65.961943	5538	5618	162	1	80	0.0125000
NODE_73_length_7036_cov_65.961943	5538	5618	165	1	80	0.0125000
NODE_73_length_7036_cov_65.961943	5538	5618	170	1	80	0.0125000
NODE_73_length_7036_cov_65.961943	5538	5618	172	1	80	0.0125000
NODE_73_length_7036_cov_65.961943	5538	5618	173	1	80	0.0125000
NODE_73_length_7036_cov_65.961943	5538	5618	175	2	80	0.0250000
NODE_73_length_7036_cov_65.961943	5538	5618	177	2	80	0.0250000
NODE_73_length_7036_cov_65.961943	5538	5618	178	1	80	0.0125000
NODE_73_length_7036_cov_65.961943	5538	5618	180	2	80	0.0250000
NODE_73_length_7036_cov_65.961943	5538	5618	184	1	80	0.0125000
NODE_73_length_7036_cov_65.961943	5538	5618	186	1	80	0.0125000
NODE_73_length_7036_cov_65.961943	5538	5618	187	1	80	0.0125000
NODE_73_length_7036_cov_65.961943	5538	5618	188	1	80	0.0125000
NODE_73_length_7036_cov_65.961943	5591	5666	137	2	75	0.0266667
NODE_73_length_7036_cov_65.961943	5591	5666	142	1	75	0.0133333
NODE_73_length_7036_cov_65.961943	5591	5666	144	1	75	0.0133333
NODE_73_length_7036_cov_65.961943	5591	5666	148	1	75	0.0133333
NODE_73_length_7036_cov_65.961943	5591	5666	151	2	75	0.0266667
NODE_73_length_7036_cov_65.961943	5591	5666	152	1	75	0.0133333
NODE_73_length_7036_cov_65.961943	5591	5666	154	1	75	0.0133333
NODE_73_length_7036_cov_65.961943	5591	5666	156	1	75	0.0133333
NODE_73_length_7036_cov_65.961943	5591	5666	158	1	75	0.0133333
NODE_73_length_7036_cov_65.961943	5591	5666	162	1	75	0.0133333
NODE_73_length_7036_cov_65.961943	5591	5666	165	1	75	0.0133333
NODE_73_length_7036_cov_65.961943	5591	5666	170	1	75	0.0133333
NODE_73_length_7036_cov_65.961943	5591	5666	172	1	75	0.0133333
NODE_73_length_7036_cov_65.961943	5591	5666	173	1	75	0.0133333
NODE_73_length_7036_cov_65.961943	5591	5666	175	2	75	0.0266667
NODE_73_length_7036_cov_65.961943	5591	5666	177	2	75	0.0266667
NODE_73_length_7036_cov_65.961943	5591	5666	178	1	75	0.0133333
NODE_73_length_7036_cov_65.961943	5591	5666	180	2	75	0.0266667
NODE_73_length_7036_cov_65.961943	5591	5666	184	1	75	0.0133333
NODE_73_length_7036_cov_65.961943	5591	5666	186	1	75	0.0133333
NODE_73_length_7036_cov_65.961943	5591	5666	187	1	75	0.0133333
NODE_73_length_7036_cov_65.961943	5591	5666	188	1	75	0.0133333
NODE_73_length_7036_cov_65.961943	5591	5666	189	1	75	0.0133333
NODE_73_length_7036_cov_65.961943	5591	5666	191	1	75	0.0133333
NODE_73_length_7036_cov_65.961943	5591	5666	196	1	75	0.0133333
NODE_73_length_7036_cov_65.961943	5591	5666	198	2	75	0.0266667
NODE_73_length_7036_cov_65.961943	5591	5666	199	1	75	0.0133333
NODE_73_length_7036_cov_65.961943	5591	5666	203	1	75	0.0133333
NODE_73_length_7036_cov_65.961943	5591	5666	204	2	75	0.0266667
NODE_73_length_7036_cov_65.961943	5591	5666	206	4	75	0.0533333
NODE_73_length_7036_cov_65.961943	5591	5666	209	1	75	0.0133333
NODE_73_length_7036_cov_65.961943	5591	5666	211	1	75	0.0133333
NODE_73_length_7036_cov_65.961943	5591	5666	216	3	75	0.0400000
NODE_73_length_7036_cov_65.961943	5591	5666	217	1	75	0.0133333
NODE_73_length_7036_cov_65.961943	5591	5666	221	1	75	0.0133333
NODE_73_length_7036_cov_65.961943	5591	5666	222	1	75	0.0133333
NODE_73_length_7036_cov_65.961943	5591	5666	236	1	75	0.0133333
NODE_73_length_7036_cov_65.961943	5591	5666	238	2	75	0.0266667
NODE_73_length_7036_cov_65.961943	5591	5666	239	2	75	0.0266667
NODE_73_length_7036_cov_65.961943	5591	5666	240	1	75	0.0133333
NODE_73_length_7036_cov_65.961943	5591	5666	241	2	75	0.0266667
NODE_73_length_7036_cov_65.961943	5591	5666	243	1	75	0.0133333
NODE_73_length_7036_cov_65.961943	5591	5666	245	2	75	0.0266667
NODE_73_length_7036_cov_65.961943	5591	5666	249	2	75	0.0266667
NODE_73_length_7036_cov_65.961943	5591	5666	256	1	75	0.0133333
NODE_73_length_7036_cov_65.961943	5591	5666	260	1	75	0.0133333
NODE_73_length_7036_cov_65.961943	5591	5666	261	1	75	0.0133333
NODE_73_length_7036_cov_65.961943	5591	5666	262	1	75	0.0133333
NODE_73_length_7036_cov_65.961943	5591	5666	265	1	75	0.0133333
NODE_73_length_7036_cov_65.961943	5591	5666	266	1	75	0.0133333
NODE_73_length_7036_cov_65.961943	5591	5666	270	3	75	0.0400000
NODE_73_length_7036_cov_65.961943	5591	5666	271	1	75	0.0133333
NODE_73_length_7036_cov_65.961943	5591	5666	272	2	75	0.0266667
NODE_73_length_7036_cov_65.961943	5591	5666	276	1	75	0.0133333
NODE_73_length_7036_cov_65.961943	5591	5666	279	1	75	0.0133333
NODE_73_length_7036_cov_65.961943	5690	5746	292	2	56	0.0357143
NODE_73_length_7036_cov_65.961943	5690	5746	293	1	56	0.0178571
NODE_73_length_7036_cov_65.961943	5690	5746	294	1	56	0.0178571
NODE_73_length_7036_cov_65.961943	5690	5746	295	2	56	0.0357143
NODE_73_length_7036_cov_65.961943	5690	5746	296	2	56	0.0357143
NODE_73_length_7036_cov_65.961943	5690	5746	297	3	56	0.0535714
NODE_73_length_7036_cov_65.961943	5690	5746	298	4	56	0.0714286
NODE_73_length_7036_cov_65.961943	5690	5746	299	3	56	0.0535714
NODE_73_length_7036_cov_65.961943	5690	5746	300	3	56	0.0535714
NODE_73_length_7036_cov_65.961943	5690	5746	301	3	56	0.0535714
NODE_73_length_7036_cov_65.961943	5690	5746	302	5	56	0.0892857
NODE_73_length_7036_cov_65.961943	5690	5746	303	4	56	0.0714286
NODE_73_length_7036_cov_65.961943	5690	5746	304	3	56	0.0535714
NODE_73_length_7036_cov_65.961943	5690	5746	305	2	56	0.0357143
NODE_73_length_7036_cov_65.961943	5690	5746	307	1	56	0.0178571
NODE_73_length_7036_cov_65.961943	5690	5746	308	1	56	0.0178571
NODE_73_length_7036_cov_65.961943	5690	5746	309	1	56	0.0178571
NODE_73_length_7036_cov_65.961943	5690	5746	310	2	56	0.0357143
NODE_73_length_7036_cov_65.961943	5690	5746	311	1	56	0.0178571
NODE_73_length_7036_cov_65.961943	5690	5746	313	1	56	0.0178571
NODE_73_length_7036_cov_65.961943	5690	5746	315	4	56	0.0714286
NODE_73_length_7036_cov_65.961943	5690	5746	317	5	56	0.0892857
NODE_73_length_7036_cov_65.961943	5690	5746	318	2	56	0.0357143
NODE_73_length_7036_cov_65.961943	6373	6453	0	80	80	1.0000000
NODE_73_length_7036_cov_65.961943	6426	6506	0	80	80	1.0000000
NODE_74_length_6974_cov_16.058327	976	1056	7	40	80	0.5000000
NODE_74_length_6974_cov_16.058327	976	1056	8	3	80	0.0375000
NODE_74_length_6974_cov_16.058327	976	1056	9	8	80	0.1000000
NODE_74_length_6974_cov_16.058327	976	1056	10	10	80	0.1250000
NODE_74_length_6974_cov_16.058327	976	1056	11	5	80	0.0625000
NODE_74_length_6974_cov_16.058327	976	1056	13	3	80	0.0375000
NODE_74_length_6974_cov_16.058327	976	1056	14	4	80	0.0500000
NODE_74_length_6974_cov_16.058327	976	1056	24	1	80	0.0125000
NODE_74_length_6974_cov_16.058327	976	1056	25	1	80	0.0125000
NODE_74_length_6974_cov_16.058327	976	1056	26	5	80	0.0625000
NODE_74_length_6974_cov_16.058327	1029	1109	10	8	80	0.1000000
NODE_74_length_6974_cov_16.058327	1029	1109	11	5	80	0.0625000
NODE_74_length_6974_cov_16.058327	1029	1109	13	3	80	0.0375000
NODE_74_length_6974_cov_16.058327	1029	1109	14	4	80	0.0500000
NODE_74_length_6974_cov_16.058327	1029	1109	24	1	80	0.0125000
NODE_74_length_6974_cov_16.058327	1029	1109	25	6	80	0.0750000
NODE_74_length_6974_cov_16.058327	1029	1109	26	7	80	0.0875000
NODE_74_length_6974_cov_16.058327	1029	1109	27	17	80	0.2125000
NODE_74_length_6974_cov_16.058327	1029	1109	28	11	80	0.1375000
NODE_74_length_6974_cov_16.058327	1029	1109	29	3	80	0.0375000
NODE_74_length_6974_cov_16.058327	1029	1109	30	11	80	0.1375000
NODE_74_length_6974_cov_16.058327	1029	1109	31	4	80	0.0500000
NODE_80_length_6826_cov_10.483574	4462	4542	0	10	80	0.1250000
NODE_80_length_6826_cov_10.483574	4462	4542	4	3	80	0.0375000
NODE_80_length_6826_cov_10.483574	4462	4542	8	26	80	0.3250000
NODE_80_length_6826_cov_10.483574	4462	4542	9	1	80	0.0125000
NODE_80_length_6826_cov_10.483574	4462	4542	13	21	80	0.2625000
NODE_80_length_6826_cov_10.483574	4462	4542	14	1	80	0.0125000
NODE_80_length_6826_cov_10.483574	4462	4542	15	2	80	0.0250000
NODE_80_length_6826_cov_10.483574	4462	4542	16	13	80	0.1625000
NODE_80_length_6826_cov_10.483574	4462	4542	18	3	80	0.0375000
NODE_80_length_6826_cov_10.483574	4515	4595	13	8	80	0.1000000
NODE_80_length_6826_cov_10.483574	4515	4595	14	1	80	0.0125000
NODE_80_length_6826_cov_10.483574	4515	4595	15	2	80	0.0250000
NODE_80_length_6826_cov_10.483574	4515	4595	16	13	80	0.1625000
NODE_80_length_6826_cov_10.483574	4515	4595	18	5	80	0.0625000
NODE_80_length_6826_cov_10.483574	4515	4595	20	31	80	0.3875000
NODE_80_length_6826_cov_10.483574	4515	4595	21	20	80	0.2500000
NODE_81_length_6816_cov_2.820753	6726	6801	0	75	75	1.0000000
NODE_81_length_6816_cov_2.820753	6774	6816	0	42	42	1.0000000
NODE_84_length_6744_cov_6.222272	5	85	3	42	80	0.5250000
NODE_84_length_6744_cov_6.222272	5	85	4	38	80	0.4750000
NODE_84_length_6744_cov_6.222272	58	138	2	4	80	0.0500000
NODE_84_length_6744_cov_6.222272	58	138	3	8	80	0.1000000
NODE_84_length_6744_cov_6.222272	58	138	4	68	80	0.8500000
NODE_84_length_6744_cov_6.222272	6650	6730	2	16	80	0.2000000
NODE_84_length_6744_cov_6.222272	6650	6730	3	64	80	0.8000000
NODE_84_length_6744_cov_6.222272	6703	6744	2	30	41	0.7317073
NODE_84_length_6744_cov_6.222272	6703	6744	3	11	41	0.2682927
NODE_86_length_6733_cov_88.965029	3141	3221	2	28	80	0.3500000
NODE_86_length_6733_cov_88.965029	3141	3221	3	8	80	0.1000000
NODE_86_length_6733_cov_88.965029	3141	3221	4	16	80	0.2000000
NODE_86_length_6733_cov_88.965029	3141	3221	5	28	80	0.3500000
NODE_86_length_6733_cov_88.965029	3194	3274	5	35	80	0.4375000
NODE_86_length_6733_cov_88.965029	3194	3274	6	30	80	0.3750000
NODE_86_length_6733_cov_88.965029	3194	3274	7	15	80	0.1875000
NODE_86_length_6733_cov_88.965029	3270	3350	6	7	80	0.0875000
NODE_86_length_6733_cov_88.965029	3270	3350	7	27	80	0.3375000
NODE_86_length_6733_cov_88.965029	3270	3350	8	15	80	0.1875000
NODE_86_length_6733_cov_88.965029	3270	3350	9	31	80	0.3875000
NODE_86_length_6733_cov_88.965029	3323	3403	4	4	80	0.0500000
NODE_86_length_6733_cov_88.965029	3323	3403	5	20	80	0.2500000
NODE_86_length_6733_cov_88.965029	3323	3403	6	36	80	0.4500000
NODE_86_length_6733_cov_88.965029	3323	3403	7	16	80	0.2000000
NODE_86_length_6733_cov_88.965029	3323	3403	8	4	80	0.0500000
NODE_90_length_6627_cov_9.440564	350	430	2	12	80	0.1500000
NODE_90_length_6627_cov_9.440564	350	430	3	27	80	0.3375000
NODE_90_length_6627_cov_9.440564	350	430	4	28	80	0.3500000
NODE_90_length_6627_cov_9.440564	350	430	5	13	80	0.1625000
NODE_90_length_6627_cov_9.440564	403	483	4	18	80	0.2250000
NODE_90_length_6627_cov_9.440564	403	483	5	62	80	0.7750000
NODE_95_length_6507_cov_95.786049	171	247	1	16	76	0.2105263
NODE_95_length_6507_cov_95.786049	171	247	2	56	76	0.7368421
NODE_95_length_6507_cov_95.786049	171	247	3	4	76	0.0526316
NODE_96_length_6497_cov_2.677399	366	436	4	70	70	1.0000000
NODE_96_length_6497_cov_2.677399	409	444	4	35	35	1.0000000
NODE_97_length_6450_cov_26.108172	5024	5104	19	47	80	0.5875000
NODE_97_length_6450_cov_26.108172	5024	5104	20	29	80	0.3625000
NODE_97_length_6450_cov_26.108172	5024	5104	21	3	80	0.0375000
NODE_97_length_6450_cov_26.108172	5024	5104	22	1	80	0.0125000
NODE_109_length_6171_cov_36.061100	3743	3813	7	6	70	0.0857143
NODE_109_length_6171_cov_36.061100	3743	3813	8	16	70	0.2285714
NODE_109_length_6171_cov_36.061100	3743	3813	9	24	70	0.3428572
NODE_109_length_6171_cov_36.061100	3743	3813	10	1	70	0.0142857
NODE_109_length_6171_cov_36.061100	3743	3813	12	23	70	0.3285714
NODE_109_length_6171_cov_36.061100	3798	3851	11	7	53	0.1320755
NODE_109_length_6171_cov_36.061100	3798	3851	12	45	53	0.8490566
NODE_109_length_6171_cov_36.061100	3798	3851	13	1	53	0.0188679
NODE_109_length_6171_cov_36.061100	4552	4596	96	1	44	0.0227273
NODE_109_length_6171_cov_36.061100	4552	4596	97	3	44	0.0681818
NODE_109_length_6171_cov_36.061100	4552	4596	98	10	44	0.2272727
NODE_109_length_6171_cov_36.061100	4552	4596	99	6	44	0.1363636
NODE_109_length_6171_cov_36.061100	4552	4596	100	9	44	0.2045455
NODE_109_length_6171_cov_36.061100	4552	4596	101	5	44	0.1136364
NODE_109_length_6171_cov_36.061100	4552	4596	102	5	44	0.1136364
NODE_109_length_6171_cov_36.061100	4552	4596	104	2	44	0.0454545
NODE_109_length_6171_cov_36.061100	4552	4596	107	1	44	0.0227273
NODE_109_length_6171_cov_36.061100	4552	4596	108	2	44	0.0454545
NODE_109_length_6171_cov_36.061100	4569	4649	84	1	80	0.0125000
NODE_109_length_6171_cov_36.061100	4569	4649	85	1	80	0.0125000
NODE_109_length_6171_cov_36.061100	4569	4649	86	1	80	0.0125000
NODE_109_length_6171_cov_36.061100	4569	4649	88	2	80	0.0250000
NODE_109_length_6171_cov_36.061100	4569	4649	90	1	80	0.0125000
NODE_109_length_6171_cov_36.061100	4569	4649	91	2	80	0.0250000
NODE_109_length_6171_cov_36.061100	4569	4649	92	10	80	0.1250000
NODE_109_length_6171_cov_36.061100	4569	4649	93	5	80	0.0625000
NODE_109_length_6171_cov_36.061100	4569	4649	94	10	80	0.1250000
NODE_109_length_6171_cov_36.061100	4569	4649	95	4	80	0.0500000
NODE_109_length_6171_cov_36.061100	4569	4649	96	3	80	0.0375000
NODE_109_length_6171_cov_36.061100	4569	4649	97	8	80	0.1000000
NODE_109_length_6171_cov_36.061100	4569	4649	98	10	80	0.1250000
NODE_109_length_6171_cov_36.061100	4569	4649	99	9	80	0.1125000
NODE_109_length_6171_cov_36.061100	4569	4649	100	6	80	0.0750000
NODE_109_length_6171_cov_36.061100	4569	4649	101	3	80	0.0375000
NODE_109_length_6171_cov_36.061100	4569	4649	102	4	80	0.0500000
NODE_109_length_6171_cov_36.061100	5742	5788	0	46	46	1.0000000
NODE_109_length_6171_cov_36.061100	5761	5841	0	80	80	1.0000000
NODE_110_length_6148_cov_58.915358	5602	5682	0	80	80	1.0000000
NODE_110_length_6148_cov_58.915358	5655	5735	0	80	80	1.0000000
NODE_112_length_6026_cov_17.775772	4124	4204	7	27	80	0.3375000
NODE_112_length_6026_cov_17.775772	4124	4204	9	49	80	0.6125000
NODE_112_length_6026_cov_17.775772	4124	4204	10	4	80	0.0500000
NODE_112_length_6026_cov_17.775772	4177	4257	7	2	80	0.0250000
NODE_112_length_6026_cov_17.775772	4177	4257	9	28	80	0.3500000
NODE_112_length_6026_cov_17.775772	4177	4257	10	14	80	0.1750000
NODE_112_length_6026_cov_17.775772	4177	4257	11	5	80	0.0625000
NODE_112_length_6026_cov_17.775772	4177	4257	12	2	80	0.0250000
NODE_112_length_6026_cov_17.775772	4177	4257	13	28	80	0.3500000
NODE_112_length_6026_cov_17.775772	4177	4257	14	1	80	0.0125000
NODE_112_length_6026_cov_17.775772	4253	4333	9	16	80	0.2000000
NODE_112_length_6026_cov_17.775772	4253	4333	10	5	80	0.0625000
NODE_112_length_6026_cov_17.775772	4253	4333	11	16	80	0.2000000
NODE_112_length_6026_cov_17.775772	4253	4333	12	16	80	0.2000000
NODE_112_length_6026_cov_17.775772	4253	4333	14	16	80	0.2000000
NODE_112_length_6026_cov_17.775772	4253	4333	16	11	80	0.1375000
NODE_112_length_6026_cov_17.775772	4306	4386	12	18	80	0.2250000
NODE_112_length_6026_cov_17.775772	4306	4386	13	18	80	0.2250000
NODE_112_length_6026_cov_17.775772	4306	4386	14	33	80	0.4125000
NODE_112_length_6026_cov_17.775772	4306	4386	16	11	80	0.1375000
NODE_124_length_5810_cov_24.750657	2064	2144	5	3	80	0.0375000
NODE_124_length_5810_cov_24.750657	2064	2144	6	4	80	0.0500000
NODE_124_length_5810_cov_24.750657	2064	2144	7	7	80	0.0875000
NODE_124_length_5810_cov_24.750657	2064	2144	8	2	80	0.0250000
NODE_124_length_5810_cov_24.750657	2064	2144	9	1	80	0.0125000
NODE_124_length_5810_cov_24.750657	2064	2144	10	3	80	0.0375000
NODE_124_length_5810_cov_24.750657	2064	2144	12	8	80	0.1000000
NODE_124_length_5810_cov_24.750657	2064	2144	13	1	80	0.0125000
NODE_124_length_5810_cov_24.750657	2064	2144	14	3	80	0.0375000
NODE_124_length_5810_cov_24.750657	2064	2144	15	6	80	0.0750000
NODE_124_length_5810_cov_24.750657	2064	2144	19	12	80	0.1500000
NODE_124_length_5810_cov_24.750657	2064	2144	20	2	80	0.0250000
NODE_124_length_5810_cov_24.750657	2064	2144	21	9	80	0.1125000
NODE_124_length_5810_cov_24.750657	2064	2144	22	2	80	0.0250000
NODE_124_length_5810_cov_24.750657	2064	2144	23	11	80	0.1375000
NODE_124_length_5810_cov_24.750657	2064	2144	24	5	80	0.0625000
NODE_124_length_5810_cov_24.750657	2064	2144	25	1	80	0.0125000
NODE_124_length_5810_cov_24.750657	2117	2194	3	8	77	0.1038961
NODE_124_length_5810_cov_24.750657	2117	2194	4	13	77	0.1688312
NODE_124_length_5810_cov_24.750657	2117	2194	5	32	77	0.4155844
NODE_124_length_5810_cov_24.750657	2117	2194	6	4	77	0.0519481
NODE_124_length_5810_cov_24.750657	2117	2194	7	7	77	0.0909091
NODE_124_length_5810_cov_24.750657	2117	2194	8	2	77	0.0259740
NODE_124_length_5810_cov_24.750657	2117	2194	9	1	77	0.0129870
NODE_124_length_5810_cov_24.750657	2117	2194	10	3	77	0.0389610
NODE_124_length_5810_cov_24.750657	2117	2194	12	7	77	0.0909091
NODE_127_length_5771_cov_10.854549	2814	2883	5	37	69	0.5362319
NODE_127_length_5771_cov_10.854549	2814	2883	7	26	69	0.3768116
NODE_127_length_5771_cov_10.854549	2814	2883	8	2	69	0.0289855
NODE_127_length_5771_cov_10.854549	2814	2883	9	4	69	0.0579710
NODE_128_length_5769_cov_6.878483	5701	5731	0	30	30	1.0000000
NODE_133_length_5728_cov_16.351039	63	134	2	71	71	1.0000000
NODE_133_length_5728_cov_16.351039	2960	3040	0	35	80	0.4375000
NODE_133_length_5728_cov_16.351039	2960	3040	1	25	80	0.3125000
NODE_133_length_5728_cov_16.351039	2960	3040	2	20	80	0.2500000
NODE_133_length_5728_cov_16.351039	5106	5172	10	4	66	0.0606061
NODE_133_length_5728_cov_16.351039	5106	5172	11	11	66	0.1666667
NODE_133_length_5728_cov_16.351039	5106	5172	12	6	66	0.0909091
NODE_133_length_5728_cov_16.351039	5106	5172	13	8	66	0.1212121
NODE_133_length_5728_cov_16.351039	5106	5172	14	1	66	0.0151515
NODE_133_length_5728_cov_16.351039	5106	5172	16	7	66	0.1060606
NODE_133_length_5728_cov_16.351039	5106	5172	18	17	66	0.2575758
NODE_133_length_5728_cov_16.351039	5106	5172	19	1	66	0.0151515
NODE_133_length_5728_cov_16.351039	5106	5172	21	1	66	0.0151515
NODE_133_length_5728_cov_16.351039	5106	5172	22	3	66	0.0454545
NODE_133_length_5728_cov_16.351039	5106	5172	23	7	66	0.1060606
NODE_133_length_5728_cov_16.351039	5145	5225	18	15	80	0.1875000
NODE_133_length_5728_cov_16.351039	5145	5225	19	2	80	0.0250000
NODE_133_length_5728_cov_16.351039	5145	5225	20	2	80	0.0250000
NODE_133_length_5728_cov_16.351039	5145	5225	21	11	80	0.1375000
NODE_133_length_5728_cov_16.351039	5145	5225	22	14	80	0.1750000
NODE_133_length_5728_cov_16.351039	5145	5225	23	33	80	0.4125000
NODE_133_length_5728_cov_16.351039	5145	5225	24	3	80	0.0375000
NODE_137_length_5696_cov_20.656244	179	258	0	53	79	0.6708861
NODE_137_length_5696_cov_20.656244	179	258	1	20	79	0.2531646
NODE_137_length_5696_cov_20.656244	179	258	2	6	79	0.0759494
NODE_137_length_5696_cov_20.656244	231	311	0	36	80	0.4500000
NODE_137_length_5696_cov_20.656244	231	311	2	21	80	0.2625000
NODE_137_length_5696_cov_20.656244	231	311	4	2	80	0.0250000
NODE_137_length_5696_cov_20.656244	231	311	5	21	80	0.2625000
NODE_137_length_5696_cov_20.656244	307	387	5	4	80	0.0500000
NODE_137_length_5696_cov_20.656244	307	387	6	34	80	0.4250000
NODE_137_length_5696_cov_20.656244	307	387	7	13	80	0.1625000
NODE_137_length_5696_cov_20.656244	307	387	8	29	80	0.3625000
NODE_137_length_5696_cov_20.656244	360	440	4	50	80	0.6250000
NODE_137_length_5696_cov_20.656244	360	440	6	18	80	0.2250000
NODE_137_length_5696_cov_20.656244	360	440	8	12	80	0.1500000
NODE_137_length_5696_cov_20.656244	5100	5180	11	2	80	0.0250000
NODE_137_length_5696_cov_20.656244	5100	5180	12	12	80	0.1500000
NODE_137_length_5696_cov_20.656244	5100	5180	13	7	80	0.0875000
NODE_137_length_5696_cov_20.656244	5100	5180	15	24	80	0.3000000
NODE_137_length_5696_cov_20.656244	5100	5180	16	16	80	0.2000000
NODE_137_length_5696_cov_20.656244	5100	5180	17	7	80	0.0875000
NODE_137_length_5696_cov_20.656244	5100	5180	18	12	80	0.1500000
NODE_137_length_5696_cov_20.656244	5153	5233	8	17	80	0.2125000
NODE_137_length_5696_cov_20.656244	5153	5233	9	4	80	0.0500000
NODE_137_length_5696_cov_20.656244	5153	5233	12	11	80	0.1375000
NODE_137_length_5696_cov_20.656244	5153	5233	13	8	80	0.1000000
NODE_137_length_5696_cov_20.656244	5153	5233	15	7	80	0.0875000
NODE_137_length_5696_cov_20.656244	5153	5233	16	14	80	0.1750000
NODE_137_length_5696_cov_20.656244	5153	5233	17	7	80	0.0875000
NODE_137_length_5696_cov_20.656244	5153	5233	18	12	80	0.1500000
NODE_137_length_5696_cov_20.656244	5280	5360	4	53	80	0.6625000
NODE_137_length_5696_cov_20.656244	5280	5360	5	15	80	0.1875000
NODE_137_length_5696_cov_20.656244	5280	5360	6	12	80	0.1500000
NODE_137_length_5696_cov_20.656244	5333	5413	2	28	80	0.3500000
NODE_137_length_5696_cov_20.656244	5333	5413	3	7	80	0.0875000
NODE_137_length_5696_cov_20.656244	5333	5413	4	45	80	0.5625000
NODE_139_length_5681_cov_68.065030	253	333	4	7	80	0.0875000
NODE_139_length_5681_cov_68.065030	253	333	6	35	80	0.4375000
NODE_139_length_5681_cov_68.065030	253	333	7	16	80	0.2000000
NODE_139_length_5681_cov_68.065030	253	333	8	22	80	0.2750000
NODE_139_length_5681_cov_68.065030	306	386	1	5	80	0.0625000
NODE_139_length_5681_cov_68.065030	306	386	3	7	80	0.0875000
NODE_139_length_5681_cov_68.065030	306	386	4	48	80	0.6000000
NODE_139_length_5681_cov_68.065030	306	386	6	20	80	0.2500000
NODE_139_length_5681_cov_68.065030	4762	4842	10	5	80	0.0625000
NODE_139_length_5681_cov_68.065030	4762	4842	11	1	80	0.0125000
NODE_139_length_5681_cov_68.065030	4762	4842	12	1	80	0.0125000
NODE_139_length_5681_cov_68.065030	4762	4842	13	2	80	0.0250000
NODE_139_length_5681_cov_68.065030	4762	4842	14	5	80	0.0625000
NODE_139_length_5681_cov_68.065030	4762	4842	16	6	80	0.0750000
NODE_139_length_5681_cov_68.065030	4762	4842	18	9	80	0.1125000
NODE_139_length_5681_cov_68.065030	4762	4842	19	1	80	0.0125000
NODE_139_length_5681_cov_68.065030	4762	4842	20	4	80	0.0500000
NODE_139_length_5681_cov_68.065030	4762	4842	21	23	80	0.2875000
NODE_139_length_5681_cov_68.065030	4762	4842	22	23	80	0.2875000
NODE_139_length_5681_cov_68.065030	4762	4842	10	5	80	0.0625000
NODE_139_length_5681_cov_68.065030	4762	4842	11	1	80	0.0125000
NODE_139_length_5681_cov_68.065030	4762	4842	12	1	80	0.0125000
NODE_139_length_5681_cov_68.065030	4762	4842	13	2	80	0.0250000
NODE_139_length_5681_cov_68.065030	4762	4842	14	5	80	0.0625000
NODE_139_length_5681_cov_68.065030	4762	4842	16	6	80	0.0750000
NODE_139_length_5681_cov_68.065030	4762	4842	18	9	80	0.1125000
NODE_139_length_5681_cov_68.065030	4762	4842	19	1	80	0.0125000
NODE_139_length_5681_cov_68.065030	4762	4842	20	4	80	0.0500000
NODE_139_length_5681_cov_68.065030	4762	4842	21	23	80	0.2875000
NODE_139_length_5681_cov_68.065030	4762	4842	22	23	80	0.2875000
NODE_139_length_5681_cov_68.065030	4762	4842	10	5	80	0.0625000
NODE_139_length_5681_cov_68.065030	4762	4842	11	1	80	0.0125000
NODE_139_length_5681_cov_68.065030	4762	4842	12	1	80	0.0125000
NODE_139_length_5681_cov_68.065030	4762	4842	13	2	80	0.0250000
NODE_139_length_5681_cov_68.065030	4762	4842	14	5	80	0.0625000
NODE_139_length_5681_cov_68.065030	4762	4842	16	6	80	0.0750000
NODE_139_length_5681_cov_68.065030	4762	4842	18	9	80	0.1125000
NODE_139_length_5681_cov_68.065030	4762	4842	19	1	80	0.0125000
NODE_139_length_5681_cov_68.065030	4762	4842	20	4	80	0.0500000
NODE_139_length_5681_cov_68.065030	4762	4842	21	23	80	0.2875000
NODE_139_length_5681_cov_68.065030	4762	4842	22	23	80	0.2875000
NODE_139_length_5681_cov_68.065030	4762	4842	10	5	80	0.0625000
NODE_139_length_5681_cov_68.065030	4762	4842	11	1	80	0.0125000
NODE_139_length_5681_cov_68.065030	4762	4842	12	1	80	0.0125000
NODE_139_length_5681_cov_68.065030	4762	4842	13	2	80	0.0250000
NODE_139_length_5681_cov_68.065030	4762	4842	14	5	80	0.0625000
NODE_139_length_5681_cov_68.065030	4762	4842	16	6	80	0.0750000
NODE_139_length_5681_cov_68.065030	4762	4842	18	9	80	0.1125000
NODE_139_length_5681_cov_68.065030	4762	4842	19	1	80	0.0125000
NODE_139_length_5681_cov_68.065030	4762	4842	20	4	80	0.0500000
NODE_139_length_5681_cov_68.065030	4762	4842	21	23	80	0.2875000
NODE_139_length_5681_cov_68.065030	4762	4842	22	23	80	0.2875000
NODE_139_length_5681_cov_68.065030	4762	4842	10	5	80	0.0625000
NODE_139_length_5681_cov_68.065030	4762	4842	11	1	80	0.0125000
NODE_139_length_5681_cov_68.065030	4762	4842	12	1	80	0.0125000
NODE_139_length_5681_cov_68.065030	4762	4842	13	2	80	0.0250000
NODE_139_length_5681_cov_68.065030	4762	4842	14	5	80	0.0625000
NODE_139_length_5681_cov_68.065030	4762	4842	16	6	80	0.0750000
NODE_139_length_5681_cov_68.065030	4762	4842	18	9	80	0.1125000
NODE_139_length_5681_cov_68.065030	4762	4842	19	1	80	0.0125000
NODE_139_length_5681_cov_68.065030	4762	4842	20	4	80	0.0500000
NODE_139_length_5681_cov_68.065030	4762	4842	21	23	80	0.2875000
NODE_139_length_5681_cov_68.065030	4762	4842	22	23	80	0.2875000
NODE_139_length_5681_cov_68.065030	4762	4842	10	5	80	0.0625000
NODE_139_length_5681_cov_68.065030	4762	4842	11	1	80	0.0125000
NODE_139_length_5681_cov_68.065030	4762	4842	12	1	80	0.0125000
NODE_139_length_5681_cov_68.065030	4762	4842	13	2	80	0.0250000
NODE_139_length_5681_cov_68.065030	4762	4842	14	5	80	0.0625000
NODE_139_length_5681_cov_68.065030	4762	4842	16	6	80	0.0750000
NODE_139_length_5681_cov_68.065030	4762	4842	18	9	80	0.1125000
NODE_139_length_5681_cov_68.065030	4762	4842	19	1	80	0.0125000
NODE_139_length_5681_cov_68.065030	4762	4842	20	4	80	0.0500000
NODE_139_length_5681_cov_68.065030	4762	4842	21	23	80	0.2875000
NODE_139_length_5681_cov_68.065030	4762	4842	22	23	80	0.2875000
NODE_139_length_5681_cov_68.065030	4769	4839	13	2	70	0.0285714
NODE_139_length_5681_cov_68.065030	4769	4839	14	5	70	0.0714286
NODE_139_length_5681_cov_68.065030	4769	4839	16	6	70	0.0857143
NODE_139_length_5681_cov_68.065030	4769	4839	18	9	70	0.1285714
NODE_139_length_5681_cov_68.065030	4769	4839	20	4	70	0.0571429
NODE_139_length_5681_cov_68.065030	4769	4839	21	21	70	0.3000000
NODE_139_length_5681_cov_68.065030	4769	4839	22	23	70	0.3285714
NODE_139_length_5681_cov_68.065030	4771	4842	14	5	71	0.0704225
NODE_139_length_5681_cov_68.065030	4771	4842	16	6	71	0.0845070
NODE_139_length_5681_cov_68.065030	4771	4842	18	9	71	0.1267606
NODE_139_length_5681_cov_68.065030	4771	4842	19	1	71	0.0140845
NODE_139_length_5681_cov_68.065030	4771	4842	20	4	71	0.0563380
NODE_139_length_5681_cov_68.065030	4771	4842	21	23	71	0.3239437
NODE_139_length_5681_cov_68.065030	4771	4842	22	23	71	0.3239437
NODE_139_length_5681_cov_68.065030	4815	4895	16	2	80	0.0250000
NODE_139_length_5681_cov_68.065030	4815	4895	17	7	80	0.0875000
NODE_139_length_5681_cov_68.065030	4815	4895	18	1	80	0.0125000
NODE_139_length_5681_cov_68.065030	4815	4895	19	16	80	0.2000000
NODE_139_length_5681_cov_68.065030	4815	4895	20	28	80	0.3500000
NODE_139_length_5681_cov_68.065030	4815	4895	21	8	80	0.1000000
NODE_139_length_5681_cov_68.065030	4815	4895	22	18	80	0.2250000
NODE_139_length_5681_cov_68.065030	4815	4895	16	2	80	0.0250000
NODE_139_length_5681_cov_68.065030	4815	4895	17	7	80	0.0875000
NODE_139_length_5681_cov_68.065030	4815	4895	18	1	80	0.0125000
NODE_139_length_5681_cov_68.065030	4815	4895	19	16	80	0.2000000
NODE_139_length_5681_cov_68.065030	4815	4895	20	28	80	0.3500000
NODE_139_length_5681_cov_68.065030	4815	4895	21	8	80	0.1000000
NODE_139_length_5681_cov_68.065030	4815	4895	22	18	80	0.2250000
NODE_139_length_5681_cov_68.065030	4815	4895	16	2	80	0.0250000
NODE_139_length_5681_cov_68.065030	4815	4895	17	7	80	0.0875000
NODE_139_length_5681_cov_68.065030	4815	4895	18	1	80	0.0125000
NODE_139_length_5681_cov_68.065030	4815	4895	19	16	80	0.2000000
NODE_139_length_5681_cov_68.065030	4815	4895	20	28	80	0.3500000
NODE_139_length_5681_cov_68.065030	4815	4895	21	8	80	0.1000000
NODE_139_length_5681_cov_68.065030	4815	4895	22	18	80	0.2250000
NODE_139_length_5681_cov_68.065030	4815	4895	16	2	80	0.0250000
NODE_139_length_5681_cov_68.065030	4815	4895	17	7	80	0.0875000
NODE_139_length_5681_cov_68.065030	4815	4895	18	1	80	0.0125000
NODE_139_length_5681_cov_68.065030	4815	4895	19	16	80	0.2000000
NODE_139_length_5681_cov_68.065030	4815	4895	20	28	80	0.3500000
NODE_139_length_5681_cov_68.065030	4815	4895	21	8	80	0.1000000
NODE_139_length_5681_cov_68.065030	4815	4895	22	18	80	0.2250000
NODE_139_length_5681_cov_68.065030	4815	4895	16	2	80	0.0250000
NODE_139_length_5681_cov_68.065030	4815	4895	17	7	80	0.0875000
NODE_139_length_5681_cov_68.065030	4815	4895	18	1	80	0.0125000
NODE_139_length_5681_cov_68.065030	4815	4895	19	16	80	0.2000000
NODE_139_length_5681_cov_68.065030	4815	4895	20	28	80	0.3500000
NODE_139_length_5681_cov_68.065030	4815	4895	21	8	80	0.1000000
NODE_139_length_5681_cov_68.065030	4815	4895	22	18	80	0.2250000
NODE_139_length_5681_cov_68.065030	4815	4895	16	2	80	0.0250000
NODE_139_length_5681_cov_68.065030	4815	4895	17	7	80	0.0875000
NODE_139_length_5681_cov_68.065030	4815	4895	18	1	80	0.0125000
NODE_139_length_5681_cov_68.065030	4815	4895	19	16	80	0.2000000
NODE_139_length_5681_cov_68.065030	4815	4895	20	28	80	0.3500000
NODE_139_length_5681_cov_68.065030	4815	4895	21	8	80	0.1000000
NODE_139_length_5681_cov_68.065030	4815	4895	22	18	80	0.2250000
NODE_139_length_5681_cov_68.065030	4891	4971	2	4	80	0.0500000
NODE_139_length_5681_cov_68.065030	4891	4971	3	46	80	0.5750000
NODE_139_length_5681_cov_68.065030	4891	4971	4	3	80	0.0375000
NODE_139_length_5681_cov_68.065030	4891	4971	5	1	80	0.0125000
NODE_139_length_5681_cov_68.065030	4891	4971	6	3	80	0.0375000
NODE_139_length_5681_cov_68.065030	4891	4971	7	8	80	0.1000000
NODE_139_length_5681_cov_68.065030	4891	4971	9	1	80	0.0125000
NODE_139_length_5681_cov_68.065030	4891	4971	11	1	80	0.0125000
NODE_139_length_5681_cov_68.065030	4891	4971	13	2	80	0.0250000
NODE_139_length_5681_cov_68.065030	4891	4971	15	3	80	0.0375000
NODE_139_length_5681_cov_68.065030	4891	4971	16	6	80	0.0750000
NODE_139_length_5681_cov_68.065030	4891	4971	17	2	80	0.0250000
NODE_139_length_5681_cov_68.065030	4944	5007	2	4	63	0.0634921
NODE_139_length_5681_cov_68.065030	4944	5007	3	59	63	0.9365079
NODE_139_length_5681_cov_68.065030	4944	5024	2	4	80	0.0500000
NODE_139_length_5681_cov_68.065030	4944	5024	3	76	80	0.9500000
NODE_140_length_5677_cov_21.613482	1792	1863	14	14	71	0.1971831
NODE_140_length_5677_cov_21.613482	1792	1863	15	22	71	0.3098592
NODE_140_length_5677_cov_21.613482	1792	1863	16	22	71	0.3098592
NODE_140_length_5677_cov_21.613482	1792	1863	17	13	71	0.1830986
NODE_140_length_5677_cov_21.613482	1845	1916	10	2	71	0.0281690
NODE_140_length_5677_cov_21.613482	1845	1916	12	7	71	0.0985916
NODE_140_length_5677_cov_21.613482	1845	1916	14	5	71	0.0704225
NODE_140_length_5677_cov_21.613482	1845	1916	15	27	71	0.3802817
NODE_140_length_5677_cov_21.613482	1845	1916	16	26	71	0.3661972
NODE_140_length_5677_cov_21.613482	1845	1916	17	4	71	0.0563380
NODE_142_length_5631_cov_25.927332	96	176	2	1	80	0.0125000
NODE_142_length_5631_cov_25.927332	96	176	3	8	80	0.1000000
NODE_142_length_5631_cov_25.927332	96	176	5	2	80	0.0250000
NODE_142_length_5631_cov_25.927332	96	176	6	13	80	0.1625000
NODE_142_length_5631_cov_25.927332	96	176	7	41	80	0.5125000
NODE_142_length_5631_cov_25.927332	96	176	8	15	80	0.1875000
NODE_142_length_5631_cov_25.927332	149	229	1	11	80	0.1375000
NODE_142_length_5631_cov_25.927332	149	229	2	43	80	0.5375000
NODE_142_length_5631_cov_25.927332	149	229	3	8	80	0.1000000
NODE_142_length_5631_cov_25.927332	149	229	5	2	80	0.0250000
NODE_142_length_5631_cov_25.927332	149	229	6	13	80	0.1625000
NODE_142_length_5631_cov_25.927332	149	229	7	3	80	0.0375000
NODE_146_length_5588_cov_40.961377	2793	2873	0	2	80	0.0250000
NODE_146_length_5588_cov_40.961377	2793	2873	1	36	80	0.4500000
NODE_146_length_5588_cov_40.961377	2793	2873	2	11	80	0.1375000
NODE_146_length_5588_cov_40.961377	2793	2873	3	10	80	0.1250000
NODE_146_length_5588_cov_40.961377	2793	2873	4	21	80	0.2625000
NODE_146_length_5588_cov_40.961377	2846	2926	0	55	80	0.6875000
NODE_146_length_5588_cov_40.961377	2846	2926	1	25	80	0.3125000
NODE_146_length_5588_cov_40.961377	2922	3002	0	23	80	0.2875000
NODE_146_length_5588_cov_40.961377	2922	3002	2	39	80	0.4875000
NODE_146_length_5588_cov_40.961377	2922	3002	4	18	80	0.2250000
NODE_146_length_5588_cov_40.961377	2975	3055	2	34	80	0.4250000
NODE_146_length_5588_cov_40.961377	2975	3055	4	46	80	0.5750000
NODE_149_length_5578_cov_5.173389	331	411	4	53	80	0.6625000
NODE_149_length_5578_cov_5.173389	331	411	5	27	80	0.3375000
NODE_149_length_5578_cov_5.173389	388	464	3	15	76	0.1973684
NODE_149_length_5578_cov_5.173389	388	464	4	37	76	0.4868421
NODE_149_length_5578_cov_5.173389	388	464	5	24	76	0.3157895
NODE_150_length_5572_cov_79.124246	1555	1627	19	2	72	0.0277778
NODE_150_length_5572_cov_79.124246	1555	1627	20	21	72	0.2916667
NODE_150_length_5572_cov_79.124246	1555	1627	22	3	72	0.0416667
NODE_150_length_5572_cov_79.124246	1555	1627	23	5	72	0.0694444
NODE_150_length_5572_cov_79.124246	1555	1627	24	8	72	0.1111111
NODE_150_length_5572_cov_79.124246	1555	1627	26	3	72	0.0416667
NODE_150_length_5572_cov_79.124246	1555	1627	28	8	72	0.1111111
NODE_150_length_5572_cov_79.124246	1555	1627	31	2	72	0.0277778
NODE_150_length_5572_cov_79.124246	1555	1627	33	1	72	0.0138889
NODE_150_length_5572_cov_79.124246	1555	1627	35	2	72	0.0277778
NODE_150_length_5572_cov_79.124246	1555	1627	36	8	72	0.1111111
NODE_150_length_5572_cov_79.124246	1555	1627	37	2	72	0.0277778
NODE_150_length_5572_cov_79.124246	1555	1627	38	7	72	0.0972222
NODE_150_length_5572_cov_79.124246	1603	1680	28	2	77	0.0259740
NODE_150_length_5572_cov_79.124246	1603	1680	31	2	77	0.0259740
NODE_150_length_5572_cov_79.124246	1603	1680	33	1	77	0.0129870
NODE_150_length_5572_cov_79.124246	1603	1680	35	2	77	0.0259740
NODE_150_length_5572_cov_79.124246	1603	1680	36	8	77	0.1038961
NODE_150_length_5572_cov_79.124246	1603	1680	37	8	77	0.1038961
NODE_150_length_5572_cov_79.124246	1603	1680	38	7	77	0.0909091
NODE_150_length_5572_cov_79.124246	1603	1680	39	2	77	0.0259740
NODE_150_length_5572_cov_79.124246	1603	1680	40	3	77	0.0389610
NODE_150_length_5572_cov_79.124246	1603	1680	42	1	77	0.0129870
NODE_150_length_5572_cov_79.124246	1603	1680	45	1	77	0.0129870
NODE_150_length_5572_cov_79.124246	1603	1680	46	2	77	0.0259740
NODE_150_length_5572_cov_79.124246	1603	1680	47	4	77	0.0519481
NODE_150_length_5572_cov_79.124246	1603	1680	49	1	77	0.0129870
NODE_150_length_5572_cov_79.124246	1603	1680	50	3	77	0.0389610
NODE_150_length_5572_cov_79.124246	1603	1680	51	1	77	0.0129870
NODE_150_length_5572_cov_79.124246	1603	1680	52	1	77	0.0129870
NODE_150_length_5572_cov_79.124246	1603	1680	54	1	77	0.0129870
NODE_150_length_5572_cov_79.124246	1603	1680	55	2	77	0.0259740
NODE_150_length_5572_cov_79.124246	1603	1680	57	1	77	0.0129870
NODE_150_length_5572_cov_79.124246	1603	1680	58	1	77	0.0129870
NODE_150_length_5572_cov_79.124246	1603	1680	59	3	77	0.0389610
NODE_150_length_5572_cov_79.124246	1603	1680	60	1	77	0.0129870
NODE_150_length_5572_cov_79.124246	1603	1680	61	1	77	0.0129870
NODE_150_length_5572_cov_79.124246	1603	1680	63	2	77	0.0259740
NODE_150_length_5572_cov_79.124246	1603	1680	64	2	77	0.0259740
NODE_150_length_5572_cov_79.124246	1603	1680	65	2	77	0.0259740
NODE_150_length_5572_cov_79.124246	1603	1680	66	8	77	0.1038961
NODE_150_length_5572_cov_79.124246	1603	1680	71	1	77	0.0129870
NODE_150_length_5572_cov_79.124246	1603	1680	72	1	77	0.0129870
NODE_150_length_5572_cov_79.124246	1603	1680	76	1	77	0.0129870
NODE_150_length_5572_cov_79.124246	1603	1680	78	1	77	0.0129870
NODE_150_length_5572_cov_79.124246	1637	1717	40	1	80	0.0125000
NODE_150_length_5572_cov_79.124246	1637	1717	42	1	80	0.0125000
NODE_150_length_5572_cov_79.124246	1637	1717	45	1	80	0.0125000
NODE_150_length_5572_cov_79.124246	1637	1717	46	2	80	0.0250000
NODE_150_length_5572_cov_79.124246	1637	1717	47	4	80	0.0500000
NODE_150_length_5572_cov_79.124246	1637	1717	49	1	80	0.0125000
NODE_150_length_5572_cov_79.124246	1637	1717	50	3	80	0.0375000
NODE_150_length_5572_cov_79.124246	1637	1717	51	1	80	0.0125000
NODE_150_length_5572_cov_79.124246	1637	1717	52	1	80	0.0125000
NODE_150_length_5572_cov_79.124246	1637	1717	54	1	80	0.0125000
NODE_150_length_5572_cov_79.124246	1637	1717	55	2	80	0.0250000
NODE_150_length_5572_cov_79.124246	1637	1717	57	1	80	0.0125000
NODE_150_length_5572_cov_79.124246	1637	1717	58	1	80	0.0125000
NODE_150_length_5572_cov_79.124246	1637	1717	59	3	80	0.0375000
NODE_150_length_5572_cov_79.124246	1637	1717	60	1	80	0.0125000
NODE_150_length_5572_cov_79.124246	1637	1717	61	1	80	0.0125000
NODE_150_length_5572_cov_79.124246	1637	1717	63	2	80	0.0250000
NODE_150_length_5572_cov_79.124246	1637	1717	64	2	80	0.0250000
NODE_150_length_5572_cov_79.124246	1637	1717	65	2	80	0.0250000
NODE_150_length_5572_cov_79.124246	1637	1717	66	8	80	0.1000000
NODE_150_length_5572_cov_79.124246	1637	1717	71	1	80	0.0125000
NODE_150_length_5572_cov_79.124246	1637	1717	72	1	80	0.0125000
NODE_150_length_5572_cov_79.124246	1637	1717	76	1	80	0.0125000
NODE_150_length_5572_cov_79.124246	1637	1717	78	2	80	0.0250000
NODE_150_length_5572_cov_79.124246	1637	1717	79	2	80	0.0250000
NODE_150_length_5572_cov_79.124246	1637	1717	80	3	80	0.0375000
NODE_150_length_5572_cov_79.124246	1637	1717	81	1	80	0.0125000
NODE_150_length_5572_cov_79.124246	1637	1717	83	1	80	0.0125000
NODE_150_length_5572_cov_79.124246	1637	1717	84	1	80	0.0125000
NODE_150_length_5572_cov_79.124246	1637	1717	87	3	80	0.0375000
NODE_150_length_5572_cov_79.124246	1637	1717	88	1	80	0.0125000
NODE_150_length_5572_cov_79.124246	1637	1717	90	4	80	0.0500000
NODE_150_length_5572_cov_79.124246	1637	1717	91	1	80	0.0125000
NODE_150_length_5572_cov_79.124246	1637	1717	94	9	80	0.1125000
NODE_150_length_5572_cov_79.124246	1637	1717	95	5	80	0.0625000
NODE_150_length_5572_cov_79.124246	1637	1717	96	2	80	0.0250000
NODE_150_length_5572_cov_79.124246	1637	1717	97	3	80	0.0375000
NODE_150_length_5572_cov_79.124246	1690	1770	55	3	80	0.0375000
NODE_150_length_5572_cov_79.124246	1690	1770	58	3	80	0.0375000
NODE_150_length_5572_cov_79.124246	1690	1770	60	2	80	0.0250000
NODE_150_length_5572_cov_79.124246	1690	1770	62	2	80	0.0250000
NODE_150_length_5572_cov_79.124246	1690	1770	63	2	80	0.0250000
NODE_150_length_5572_cov_79.124246	1690	1770	66	3	80	0.0375000
NODE_150_length_5572_cov_79.124246	1690	1770	67	2	80	0.0250000
NODE_150_length_5572_cov_79.124246	1690	1770	68	1	80	0.0125000
NODE_150_length_5572_cov_79.124246	1690	1770	72	5	80	0.0625000
NODE_150_length_5572_cov_79.124246	1690	1770	74	1	80	0.0125000
NODE_150_length_5572_cov_79.124246	1690	1770	76	1	80	0.0125000
NODE_150_length_5572_cov_79.124246	1690	1770	77	3	80	0.0375000
NODE_150_length_5572_cov_79.124246	1690	1770	78	2	80	0.0250000
NODE_150_length_5572_cov_79.124246	1690	1770	80	2	80	0.0250000
NODE_150_length_5572_cov_79.124246	1690	1770	82	1	80	0.0125000
NODE_150_length_5572_cov_79.124246	1690	1770	85	5	80	0.0625000
NODE_150_length_5572_cov_79.124246	1690	1770	86	1	80	0.0125000
NODE_150_length_5572_cov_79.124246	1690	1770	87	2	80	0.0250000
NODE_150_length_5572_cov_79.124246	1690	1770	88	3	80	0.0375000
NODE_150_length_5572_cov_79.124246	1690	1770	90	7	80	0.0875000
NODE_150_length_5572_cov_79.124246	1690	1770	91	1	80	0.0125000
NODE_150_length_5572_cov_79.124246	1690	1770	92	7	80	0.0875000
NODE_150_length_5572_cov_79.124246	1690	1770	94	11	80	0.1375000
NODE_150_length_5572_cov_79.124246	1690	1770	95	5	80	0.0625000
NODE_150_length_5572_cov_79.124246	1690	1770	96	2	80	0.0250000
NODE_150_length_5572_cov_79.124246	1690	1770	97	3	80	0.0375000
NODE_150_length_5572_cov_79.124246	5130	5210	3	5	80	0.0625000
NODE_150_length_5572_cov_79.124246	5130	5210	4	9	80	0.1125000
NODE_150_length_5572_cov_79.124246	5130	5210	5	6	80	0.0750000
NODE_150_length_5572_cov_79.124246	5130	5210	6	5	80	0.0625000
NODE_150_length_5572_cov_79.124246	5130	5210	7	13	80	0.1625000
NODE_150_length_5572_cov_79.124246	5130	5210	8	10	80	0.1250000
NODE_150_length_5572_cov_79.124246	5130	5210	9	5	80	0.0625000
NODE_150_length_5572_cov_79.124246	5130	5210	10	5	80	0.0625000
NODE_150_length_5572_cov_79.124246	5130	5210	12	11	80	0.1375000
NODE_150_length_5572_cov_79.124246	5130	5210	13	11	80	0.1375000
NODE_150_length_5572_cov_79.124246	5183	5263	10	5	80	0.0625000
NODE_150_length_5572_cov_79.124246	5183	5263	11	20	80	0.2500000
NODE_150_length_5572_cov_79.124246	5183	5263	12	13	80	0.1625000
NODE_150_length_5572_cov_79.124246	5183	5263	13	42	80	0.5250000
NODE_151_length_5557_cov_26.198241	341	414	3	23	73	0.3150685
NODE_151_length_5557_cov_26.198241	341	414	4	6	73	0.0821918
NODE_151_length_5557_cov_26.198241	341	414	6	44	73	0.6027398
NODE_151_length_5557_cov_26.198241	394	460	1	4	66	0.0606061
NODE_151_length_5557_cov_26.198241	394	460	2	23	66	0.3484848
NODE_151_length_5557_cov_26.198241	394	460	3	39	66	0.5909091
NODE_156_length_5500_cov_35.832438	81	161	6	2	80	0.0250000
NODE_156_length_5500_cov_35.832438	81	161	10	6	80	0.0750000
NODE_156_length_5500_cov_35.832438	81	161	12	1	80	0.0125000
NODE_156_length_5500_cov_35.832438	81	161	14	71	80	0.8875000
NODE_156_length_5500_cov_35.832438	134	214	7	2	80	0.0250000
NODE_156_length_5500_cov_35.832438	134	214	8	34	80	0.4250000
NODE_156_length_5500_cov_35.832438	134	214	10	1	80	0.0125000
NODE_156_length_5500_cov_35.832438	134	214	11	1	80	0.0125000
NODE_156_length_5500_cov_35.832438	134	214	12	4	80	0.0500000
NODE_156_length_5500_cov_35.832438	134	214	14	38	80	0.4750000
NODE_159_length_5470_cov_5.987526	5180	5249	0	69	69	1.0000000
NODE_160_length_5434_cov_14.997751	541	621	2	4	80	0.0500000
NODE_160_length_5434_cov_14.997751	541	621	4	76	80	0.9500000
NODE_160_length_5434_cov_14.997751	594	674	0	10	80	0.1250000
NODE_160_length_5434_cov_14.997751	594	674	2	10	80	0.1250000
NODE_160_length_5434_cov_14.997751	594	674	4	60	80	0.7500000
NODE_160_length_5434_cov_14.997751	2664	2744	0	63	80	0.7875000
NODE_160_length_5434_cov_14.997751	2664	2744	2	17	80	0.2125000
NODE_160_length_5434_cov_14.997751	2717	2797	0	60	80	0.7500000
NODE_160_length_5434_cov_14.997751	2717	2797	2	20	80	0.2500000
NODE_160_length_5434_cov_14.997751	3041	3093	1	1	52	0.0192308
NODE_160_length_5434_cov_14.997751	3041	3093	3	51	52	0.9807692
NODE_160_length_5434_cov_14.997751	3419	3467	10	14	48	0.2916667
NODE_160_length_5434_cov_14.997751	3419	3467	12	10	48	0.2083333
NODE_160_length_5434_cov_14.997751	3419	3467	13	24	48	0.5000000
NODE_161_length_5425_cov_15.812242	141	218	7	9	77	0.1168831
NODE_161_length_5425_cov_15.812242	141	218	8	7	77	0.0909091
NODE_161_length_5425_cov_15.812242	141	218	9	2	77	0.0259740
NODE_161_length_5425_cov_15.812242	141	218	10	23	77	0.2987013
NODE_161_length_5425_cov_15.812242	141	218	11	3	77	0.0389610
NODE_161_length_5425_cov_15.812242	141	218	13	8	77	0.1038961
NODE_161_length_5425_cov_15.812242	141	218	14	8	77	0.1038961
NODE_161_length_5425_cov_15.812242	141	218	16	2	77	0.0259740
NODE_161_length_5425_cov_15.812242	141	218	17	2	77	0.0259740
NODE_161_length_5425_cov_15.812242	141	218	21	4	77	0.0519481
NODE_161_length_5425_cov_15.812242	141	218	25	1	77	0.0129870
NODE_161_length_5425_cov_15.812242	141	218	26	3	77	0.0389610
NODE_161_length_5425_cov_15.812242	141	218	28	3	77	0.0389610
NODE_161_length_5425_cov_15.812242	141	218	29	2	77	0.0259740
NODE_161_length_5425_cov_15.812242	841	921	0	20	80	0.2500000
NODE_161_length_5425_cov_15.812242	841	921	1	1	80	0.0125000
NODE_161_length_5425_cov_15.812242	841	921	3	4	80	0.0500000
NODE_161_length_5425_cov_15.812242	841	921	4	55	80	0.6875000
NODE_161_length_5425_cov_15.812242	894	974	0	73	80	0.9125000
NODE_161_length_5425_cov_15.812242	894	974	1	1	80	0.0125000
NODE_161_length_5425_cov_15.812242	894	974	3	4	80	0.0500000
NODE_161_length_5425_cov_15.812242	894	974	4	2	80	0.0250000
NODE_163_length_5402_cov_5.397322	191	263	0	72	72	1.0000000
NODE_163_length_5402_cov_5.397322	2305	2385	21	9	80	0.1125000
NODE_163_length_5402_cov_5.397322	2305	2385	22	2	80	0.0250000
NODE_163_length_5402_cov_5.397322	2305	2385	23	4	80	0.0500000
NODE_163_length_5402_cov_5.397322	2305	2385	24	16	80	0.2000000
NODE_163_length_5402_cov_5.397322	2305	2385	25	1	80	0.0125000
NODE_163_length_5402_cov_5.397322	2305	2385	28	7	80	0.0875000
NODE_163_length_5402_cov_5.397322	2305	2385	29	6	80	0.0750000
NODE_163_length_5402_cov_5.397322	2305	2385	30	19	80	0.2375000
NODE_163_length_5402_cov_5.397322	2305	2385	31	1	80	0.0125000
NODE_163_length_5402_cov_5.397322	2305	2385	32	1	80	0.0125000
NODE_163_length_5402_cov_5.397322	2305	2385	34	14	80	0.1750000
NODE_163_length_5402_cov_5.397322	2358	2438	22	1	80	0.0125000
NODE_163_length_5402_cov_5.397322	2358	2438	23	1	80	0.0125000
NODE_163_length_5402_cov_5.397322	2358	2438	24	3	80	0.0375000
NODE_163_length_5402_cov_5.397322	2358	2438	25	11	80	0.1375000
NODE_163_length_5402_cov_5.397322	2358	2438	27	6	80	0.0750000
NODE_163_length_5402_cov_5.397322	2358	2438	28	2	80	0.0250000
NODE_163_length_5402_cov_5.397322	2358	2438	30	16	80	0.2000000
NODE_163_length_5402_cov_5.397322	2358	2438	31	1	80	0.0125000
NODE_163_length_5402_cov_5.397322	2358	2438	32	2	80	0.0250000
NODE_163_length_5402_cov_5.397322	2358	2438	33	13	80	0.1625000
NODE_163_length_5402_cov_5.397322	2358	2438	34	14	80	0.1750000
NODE_163_length_5402_cov_5.397322	2358	2438	35	8	80	0.1000000
NODE_163_length_5402_cov_5.397322	2358	2438	36	2	80	0.0250000
NODE_164_length_5383_cov_15.680545	205	285	4	30	80	0.3750000
NODE_164_length_5383_cov_15.680545	205	285	5	29	80	0.3625000
NODE_164_length_5383_cov_15.680545	205	285	6	21	80	0.2625000
NODE_164_length_5383_cov_15.680545	258	317	3	12	59	0.2033898
NODE_164_length_5383_cov_15.680545	258	317	5	18	59	0.3050847
NODE_164_length_5383_cov_15.680545	258	317	6	29	59	0.4915254
NODE_164_length_5383_cov_15.680545	2042	2122	5	1	80	0.0125000
NODE_164_length_5383_cov_15.680545	2042	2122	6	10	80	0.1250000
NODE_164_length_5383_cov_15.680545	2042	2122	7	1	80	0.0125000
NODE_164_length_5383_cov_15.680545	2042	2122	9	14	80	0.1750000
NODE_164_length_5383_cov_15.680545	2042	2122	10	1	80	0.0125000
NODE_164_length_5383_cov_15.680545	2042	2122	12	24	80	0.3000000
NODE_164_length_5383_cov_15.680545	2042	2122	13	21	80	0.2625000
NODE_164_length_5383_cov_15.680545	2042	2122	14	8	80	0.1000000
NODE_164_length_5383_cov_15.680545	2095	2175	0	19	80	0.2375000
NODE_164_length_5383_cov_15.680545	2095	2175	1	14	80	0.1750000
NODE_164_length_5383_cov_15.680545	2095	2175	2	4	80	0.0500000
NODE_164_length_5383_cov_15.680545	2095	2175	3	3	80	0.0375000
NODE_164_length_5383_cov_15.680545	2095	2175	4	9	80	0.1125000
NODE_164_length_5383_cov_15.680545	2095	2175	5	5	80	0.0625000
NODE_164_length_5383_cov_15.680545	2095	2175	6	10	80	0.1250000
NODE_164_length_5383_cov_15.680545	2095	2175	7	1	80	0.0125000
NODE_164_length_5383_cov_15.680545	2095	2175	9	14	80	0.1750000
NODE_164_length_5383_cov_15.680545	2095	2175	10	1	80	0.0125000
NODE_165_length_5382_cov_16.894378	1301	1347	0	44	46	0.9565217
NODE_165_length_5382_cov_16.894378	1301	1347	2	2	46	0.0434783
NODE_165_length_5382_cov_16.894378	5056	5082	28	4	26	0.1538462
NODE_165_length_5382_cov_16.894378	5056	5082	29	10	26	0.3846154
NODE_165_length_5382_cov_16.894378	5056	5082	30	4	26	0.1538462
NODE_165_length_5382_cov_16.894378	5056	5082	31	4	26	0.1538462
NODE_165_length_5382_cov_16.894378	5056	5082	36	3	26	0.1153846
NODE_165_length_5382_cov_16.894378	5056	5082	37	1	26	0.0384615
NODE_165_length_5382_cov_16.894378	5056	5115	28	4	59	0.0677966
NODE_165_length_5382_cov_16.894378	5056	5115	29	10	59	0.1694915
NODE_165_length_5382_cov_16.894378	5056	5115	30	4	59	0.0677966
NODE_165_length_5382_cov_16.894378	5056	5115	31	4	59	0.0677966
NODE_165_length_5382_cov_16.894378	5056	5115	34	16	59	0.2711864
NODE_165_length_5382_cov_16.894378	5056	5115	35	3	59	0.0508475
NODE_165_length_5382_cov_16.894378	5056	5115	36	7	59	0.1186441
NODE_165_length_5382_cov_16.894378	5056	5115	37	1	59	0.0169492
NODE_165_length_5382_cov_16.894378	5056	5115	40	3	59	0.0508475
NODE_165_length_5382_cov_16.894378	5056	5115	42	7	59	0.1186441
NODE_167_length_5339_cov_28.708969	3375	3455	19	5	80	0.0625000
NODE_167_length_5339_cov_28.708969	3375	3455	20	8	80	0.1000000
NODE_167_length_5339_cov_28.708969	3375	3455	21	1	80	0.0125000
NODE_167_length_5339_cov_28.708969	3375	3455	22	4	80	0.0500000
NODE_167_length_5339_cov_28.708969	3375	3455	23	1	80	0.0125000
NODE_167_length_5339_cov_28.708969	3375	3455	25	4	80	0.0500000
NODE_167_length_5339_cov_28.708969	3375	3455	26	7	80	0.0875000
NODE_167_length_5339_cov_28.708969	3375	3455	28	6	80	0.0750000
NODE_167_length_5339_cov_28.708969	3375	3455	30	1	80	0.0125000
NODE_167_length_5339_cov_28.708969	3375	3455	32	2	80	0.0250000
NODE_167_length_5339_cov_28.708969	3375	3455	33	2	80	0.0250000
NODE_167_length_5339_cov_28.708969	3375	3455	34	1	80	0.0125000
NODE_167_length_5339_cov_28.708969	3375	3455	35	1	80	0.0125000
NODE_167_length_5339_cov_28.708969	3375	3455	36	5	80	0.0625000
NODE_167_length_5339_cov_28.708969	3375	3455	37	5	80	0.0625000
NODE_167_length_5339_cov_28.708969	3375	3455	38	4	80	0.0500000
NODE_167_length_5339_cov_28.708969	3375	3455	40	8	80	0.1000000
NODE_167_length_5339_cov_28.708969	3375	3455	41	7	80	0.0875000
NODE_167_length_5339_cov_28.708969	3375	3455	42	8	80	0.1000000
NODE_167_length_5339_cov_28.708969	3428	3508	36	7	80	0.0875000
NODE_167_length_5339_cov_28.708969	3428	3508	38	8	80	0.1000000
NODE_167_length_5339_cov_28.708969	3428	3508	39	5	80	0.0625000
NODE_167_length_5339_cov_28.708969	3428	3508	40	15	80	0.1875000
NODE_167_length_5339_cov_28.708969	3428	3508	41	8	80	0.1000000
NODE_167_length_5339_cov_28.708969	3428	3508	42	21	80	0.2625000
NODE_167_length_5339_cov_28.708969	3428	3508	43	10	80	0.1250000
NODE_167_length_5339_cov_28.708969	3428	3508	44	3	80	0.0375000
NODE_167_length_5339_cov_28.708969	3428	3508	45	3	80	0.0375000
NODE_168_length_5336_cov_33.036471	3109	3189	36	3	80	0.0375000
NODE_168_length_5336_cov_33.036471	3109	3189	37	14	80	0.1750000
NODE_168_length_5336_cov_33.036471	3109	3189	38	10	80	0.1250000
NODE_168_length_5336_cov_33.036471	3109	3189	39	1	80	0.0125000
NODE_168_length_5336_cov_33.036471	3109	3189	41	3	80	0.0375000
NODE_168_length_5336_cov_33.036471	3109	3189	42	2	80	0.0250000
NODE_168_length_5336_cov_33.036471	3109	3189	45	7	80	0.0875000
NODE_168_length_5336_cov_33.036471	3109	3189	46	2	80	0.0250000
NODE_168_length_5336_cov_33.036471	3109	3189	47	1	80	0.0125000
NODE_168_length_5336_cov_33.036471	3109	3189	49	2	80	0.0250000
NODE_168_length_5336_cov_33.036471	3109	3189	50	3	80	0.0375000
NODE_168_length_5336_cov_33.036471	3109	3189	51	7	80	0.0875000
NODE_168_length_5336_cov_33.036471	3109	3189	53	12	80	0.1500000
NODE_168_length_5336_cov_33.036471	3109	3189	54	13	80	0.1625000
NODE_168_length_5336_cov_33.036471	3162	3242	41	1	80	0.0125000
NODE_168_length_5336_cov_33.036471	3162	3242	42	3	80	0.0375000
NODE_168_length_5336_cov_33.036471	3162	3242	43	1	80	0.0125000
NODE_168_length_5336_cov_33.036471	3162	3242	44	2	80	0.0250000
NODE_168_length_5336_cov_33.036471	3162	3242	46	4	80	0.0500000
NODE_168_length_5336_cov_33.036471	3162	3242	47	6	80	0.0750000
NODE_168_length_5336_cov_33.036471	3162	3242	49	5	80	0.0625000
NODE_168_length_5336_cov_33.036471	3162	3242	50	7	80	0.0875000
NODE_168_length_5336_cov_33.036471	3162	3242	51	15	80	0.1875000
NODE_168_length_5336_cov_33.036471	3162	3242	52	3	80	0.0375000
NODE_168_length_5336_cov_33.036471	3162	3242	53	18	80	0.2250000
NODE_168_length_5336_cov_33.036471	3162	3242	54	15	80	0.1875000
NODE_179_length_5269_cov_23.392650	1905	1985	4	6	80	0.0750000
NODE_179_length_5269_cov_23.392650	1905	1985	6	15	80	0.1875000
NODE_179_length_5269_cov_23.392650	1905	1985	7	11	80	0.1375000
NODE_179_length_5269_cov_23.392650	1905	1985	8	21	80	0.2625000
NODE_179_length_5269_cov_23.392650	1905	1985	9	7	80	0.0875000
NODE_179_length_5269_cov_23.392650	1905	1985	10	6	80	0.0750000
NODE_179_length_5269_cov_23.392650	1905	1985	12	1	80	0.0125000
NODE_179_length_5269_cov_23.392650	1905	1985	13	5	80	0.0625000
NODE_179_length_5269_cov_23.392650	1905	1985	14	8	80	0.1000000
NODE_179_length_5269_cov_23.392650	1958	2038	9	7	80	0.0875000
NODE_179_length_5269_cov_23.392650	1958	2038	10	6	80	0.0750000
NODE_179_length_5269_cov_23.392650	1958	2038	12	1	80	0.0125000
NODE_179_length_5269_cov_23.392650	1958	2038	13	5	80	0.0625000
NODE_179_length_5269_cov_23.392650	1958	2038	14	14	80	0.1750000
NODE_179_length_5269_cov_23.392650	1958	2038	15	1	80	0.0125000
NODE_179_length_5269_cov_23.392650	1958	2038	16	4	80	0.0500000
NODE_179_length_5269_cov_23.392650	1958	2038	17	11	80	0.1375000
NODE_179_length_5269_cov_23.392650	1958	2038	18	26	80	0.3250000
NODE_179_length_5269_cov_23.392650	1958	2038	19	5	80	0.0625000
NODE_181_length_5207_cov_31.352780	4588	4668	6	4	80	0.0500000
NODE_181_length_5207_cov_31.352780	4588	4668	7	8	80	0.1000000
NODE_181_length_5207_cov_31.352780	4588	4668	9	11	80	0.1375000
NODE_181_length_5207_cov_31.352780	4588	4668	10	23	80	0.2875000
NODE_181_length_5207_cov_31.352780	4588	4668	11	2	80	0.0250000
NODE_181_length_5207_cov_31.352780	4588	4668	12	11	80	0.1375000
NODE_181_length_5207_cov_31.352780	4588	4668	13	21	80	0.2625000
NODE_181_length_5207_cov_31.352780	4641	4721	10	25	80	0.3125000
NODE_181_length_5207_cov_31.352780	4641	4721	11	30	80	0.3750000
NODE_181_length_5207_cov_31.352780	4641	4721	12	4	80	0.0500000
NODE_181_length_5207_cov_31.352780	4641	4721	13	21	80	0.2625000
NODE_183_length_5193_cov_14.930506	4659	4739	2	20	80	0.2500000
NODE_183_length_5193_cov_14.930506	4659	4739	4	5	80	0.0625000
NODE_183_length_5193_cov_14.930506	4659	4739	5	2	80	0.0250000
NODE_183_length_5193_cov_14.930506	4659	4739	7	19	80	0.2375000
NODE_183_length_5193_cov_14.930506	4659	4739	8	13	80	0.1625000
NODE_183_length_5193_cov_14.930506	4659	4739	9	14	80	0.1750000
NODE_183_length_5193_cov_14.930506	4659	4739	10	7	80	0.0875000
NODE_183_length_5193_cov_14.930506	4712	4792	8	6	80	0.0750000
NODE_183_length_5193_cov_14.930506	4712	4792	9	18	80	0.2250000
NODE_183_length_5193_cov_14.930506	4712	4792	10	30	80	0.3750000
NODE_183_length_5193_cov_14.930506	4712	4792	12	14	80	0.1750000
NODE_183_length_5193_cov_14.930506	4712	4792	13	12	80	0.1500000
NODE_183_length_5193_cov_14.930506	4788	4868	5	13	80	0.1625000
NODE_183_length_5193_cov_14.930506	4788	4868	6	4	80	0.0500000
NODE_183_length_5193_cov_14.930506	4788	4868	8	40	80	0.5000000
NODE_183_length_5193_cov_14.930506	4788	4868	9	3	80	0.0375000
NODE_183_length_5193_cov_14.930506	4788	4868	10	8	80	0.1000000
NODE_183_length_5193_cov_14.930506	4788	4868	11	7	80	0.0875000
NODE_183_length_5193_cov_14.930506	4788	4868	13	5	80	0.0625000
NODE_183_length_5193_cov_14.930506	4841	4921	3	19	80	0.2375000
NODE_183_length_5193_cov_14.930506	4841	4921	4	34	80	0.4250000
NODE_183_length_5193_cov_14.930506	4841	4921	5	13	80	0.1625000
NODE_183_length_5193_cov_14.930506	4841	4921	6	4	80	0.0500000
NODE_183_length_5193_cov_14.930506	4841	4921	8	10	80	0.1250000
NODE_186_length_5159_cov_261.593676	158	227	35	3	69	0.0434783
NODE_186_length_5159_cov_261.593676	158	227	36	6	69	0.0869565
NODE_186_length_5159_cov_261.593676	158	227	37	9	69	0.1304348
NODE_186_length_5159_cov_261.593676	158	227	38	1	69	0.0144928
NODE_186_length_5159_cov_261.593676	158	227	39	6	69	0.0869565
NODE_186_length_5159_cov_261.593676	158	227	41	4	69	0.0579710
NODE_186_length_5159_cov_261.593676	158	227	43	23	69	0.3333333
NODE_186_length_5159_cov_261.593676	158	227	44	2	69	0.0289855
NODE_186_length_5159_cov_261.593676	158	227	45	4	69	0.0579710
NODE_186_length_5159_cov_261.593676	158	227	46	5	69	0.0724638
NODE_186_length_5159_cov_261.593676	158	227	47	1	69	0.0144928
NODE_186_length_5159_cov_261.593676	158	227	48	5	69	0.0724638
NODE_189_length_5138_cov_31.467355	3004	3075	2	1	71	0.0140845
NODE_189_length_5138_cov_31.467355	3004	3075	3	2	71	0.0281690
NODE_189_length_5138_cov_31.467355	3004	3075	4	1	71	0.0140845
NODE_189_length_5138_cov_31.467355	3004	3075	5	4	71	0.0563380
NODE_189_length_5138_cov_31.467355	3004	3075	6	1	71	0.0140845
NODE_189_length_5138_cov_31.467355	3004	3075	9	7	71	0.0985916
NODE_189_length_5138_cov_31.467355	3004	3075	10	5	71	0.0704225
NODE_189_length_5138_cov_31.467355	3004	3075	12	5	71	0.0704225
NODE_189_length_5138_cov_31.467355	3004	3075	13	3	71	0.0422535
NODE_189_length_5138_cov_31.467355	3004	3075	14	2	71	0.0281690
NODE_189_length_5138_cov_31.467355	3004	3075	16	1	71	0.0140845
NODE_189_length_5138_cov_31.467355	3004	3075	18	1	71	0.0140845
NODE_189_length_5138_cov_31.467355	3004	3075	19	1	71	0.0140845
NODE_189_length_5138_cov_31.467355	3004	3075	20	3	71	0.0422535
NODE_189_length_5138_cov_31.467355	3004	3075	21	6	71	0.0845070
NODE_189_length_5138_cov_31.467355	3004	3075	22	6	71	0.0845070
NODE_189_length_5138_cov_31.467355	3004	3075	24	1	71	0.0140845
NODE_189_length_5138_cov_31.467355	3004	3075	25	5	71	0.0704225
NODE_189_length_5138_cov_31.467355	3004	3075	26	1	71	0.0140845
NODE_189_length_5138_cov_31.467355	3004	3075	27	3	71	0.0422535
NODE_189_length_5138_cov_31.467355	3004	3075	30	2	71	0.0281690
NODE_189_length_5138_cov_31.467355	3004	3075	32	2	71	0.0281690
NODE_189_length_5138_cov_31.467355	3004	3075	34	2	71	0.0281690
NODE_189_length_5138_cov_31.467355	3004	3075	35	1	71	0.0140845
NODE_189_length_5138_cov_31.467355	3004	3075	36	1	71	0.0140845
NODE_189_length_5138_cov_31.467355	3004	3075	38	2	71	0.0281690
NODE_189_length_5138_cov_31.467355	3004	3075	40	1	71	0.0140845
NODE_189_length_5138_cov_31.467355	3004	3075	44	1	71	0.0140845
NODE_191_length_5126_cov_5.900935	731	811	4	28	80	0.3500000
NODE_191_length_5126_cov_5.900935	731	811	5	6	80	0.0750000
NODE_191_length_5126_cov_5.900935	731	811	7	18	80	0.2250000
NODE_191_length_5126_cov_5.900935	731	811	8	15	80	0.1875000
NODE_191_length_5126_cov_5.900935	731	811	9	13	80	0.1625000
NODE_191_length_5126_cov_5.900935	784	864	6	50	80	0.6250000
NODE_191_length_5126_cov_5.900935	784	864	8	14	80	0.1750000
NODE_191_length_5126_cov_5.900935	784	864	9	16	80	0.2000000
NODE_194_length_5102_cov_12.729962	367	447	5	80	80	1.0000000
NODE_194_length_5102_cov_12.729962	420	500	2	33	80	0.4125000
NODE_194_length_5102_cov_12.729962	420	500	3	16	80	0.2000000
NODE_194_length_5102_cov_12.729962	420	500	5	31	80	0.3875000
NODE_194_length_5102_cov_12.729962	496	576	1	16	80	0.2000000
NODE_194_length_5102_cov_12.729962	496	576	2	38	80	0.4750000
NODE_194_length_5102_cov_12.729962	496	576	3	6	80	0.0750000
NODE_194_length_5102_cov_12.729962	496	576	4	20	80	0.2500000
NODE_194_length_5102_cov_12.729962	549	629	2	7	80	0.0875000
NODE_194_length_5102_cov_12.729962	549	629	4	73	80	0.9125000
NODE_196_length_5079_cov_5.580522	875	940	12	1	65	0.0153846
NODE_196_length_5079_cov_5.580522	875	940	16	6	65	0.0923077
NODE_196_length_5079_cov_5.580522	875	940	17	8	65	0.1230769
NODE_196_length_5079_cov_5.580522	875	940	19	3	65	0.0461538
NODE_196_length_5079_cov_5.580522	875	940	20	15	65	0.2307692
NODE_196_length_5079_cov_5.580522	875	940	21	7	65	0.1076923
NODE_196_length_5079_cov_5.580522	875	940	22	16	65	0.2461538
NODE_196_length_5079_cov_5.580522	875	940	24	9	65	0.1384615
NODE_197_length_5057_cov_16.348729	2929	3000	23	1	71	0.0140845
NODE_197_length_5057_cov_16.348729	2929	3000	24	1	71	0.0140845
NODE_197_length_5057_cov_16.348729	2929	3000	26	1	71	0.0140845
NODE_197_length_5057_cov_16.348729	2929	3000	28	3	71	0.0422535
NODE_197_length_5057_cov_16.348729	2929	3000	29	1	71	0.0140845
NODE_197_length_5057_cov_16.348729	2929	3000	31	2	71	0.0281690
NODE_197_length_5057_cov_16.348729	2929	3000	33	1	71	0.0140845
NODE_197_length_5057_cov_16.348729	2929	3000	34	1	71	0.0140845
NODE_197_length_5057_cov_16.348729	2929	3000	36	5	71	0.0704225
NODE_197_length_5057_cov_16.348729	2929	3000	38	1	71	0.0140845
NODE_197_length_5057_cov_16.348729	2929	3000	39	3	71	0.0422535
NODE_197_length_5057_cov_16.348729	2929	3000	41	1	71	0.0140845
NODE_197_length_5057_cov_16.348729	2929	3000	43	4	71	0.0563380
NODE_197_length_5057_cov_16.348729	2929	3000	45	3	71	0.0422535
NODE_197_length_5057_cov_16.348729	2929	3000	47	9	71	0.1267606
NODE_197_length_5057_cov_16.348729	2929	3000	48	7	71	0.0985916
NODE_197_length_5057_cov_16.348729	2929	3000	50	2	71	0.0281690
NODE_197_length_5057_cov_16.348729	2929	3000	52	1	71	0.0140845
NODE_197_length_5057_cov_16.348729	2929	3000	54	1	71	0.0140845
NODE_197_length_5057_cov_16.348729	2929	3000	56	13	71	0.1830986
NODE_197_length_5057_cov_16.348729	2929	3000	57	6	71	0.0845070
NODE_197_length_5057_cov_16.348729	2929	3000	58	2	71	0.0281690
NODE_197_length_5057_cov_16.348729	2929	3000	60	2	71	0.0281690
NODE_197_length_5057_cov_16.348729	2973	3012	50	2	39	0.0512821
NODE_197_length_5057_cov_16.348729	2973	3012	52	1	39	0.0256410
NODE_197_length_5057_cov_16.348729	2973	3012	54	1	39	0.0256410
NODE_197_length_5057_cov_16.348729	2973	3012	56	13	39	0.3333333
NODE_197_length_5057_cov_16.348729	2973	3012	57	6	39	0.1538462
NODE_197_length_5057_cov_16.348729	2973	3012	58	2	39	0.0512821
NODE_197_length_5057_cov_16.348729	2973	3012	60	2	39	0.0512821
NODE_197_length_5057_cov_16.348729	2973	3012	61	6	39	0.1538462
NODE_197_length_5057_cov_16.348729	2973	3012	62	1	39	0.0256410
NODE_197_length_5057_cov_16.348729	2973	3012	63	3	39	0.0769231
NODE_197_length_5057_cov_16.348729	2973	3012	64	2	39	0.0512821
NODE_198_length_5053_cov_11.281994	791	834	1	43	43	1.0000000
NODE_198_length_5053_cov_11.281994	807	887	1	41	80	0.5125000
NODE_198_length_5053_cov_11.281994	807	887	3	28	80	0.3500000
NODE_198_length_5053_cov_11.281994	807	887	4	11	80	0.1375000
NODE_198_length_5053_cov_11.281994	883	963	3	33	80	0.4125000
NODE_198_length_5053_cov_11.281994	883	963	4	47	80	0.5875000
NODE_198_length_5053_cov_11.281994	936	999	1	4	63	0.0634921
NODE_198_length_5053_cov_11.281994	936	999	3	59	63	0.9365079
NODE_204_length_4906_cov_37.988350	3170	3251	2	11	81	0.1358025
NODE_204_length_4906_cov_37.988350	3170	3251	3	5	81	0.0617284
NODE_204_length_4906_cov_37.988350	3170	3251	6	2	81	0.0246914
NODE_204_length_4906_cov_37.988350	3170	3251	7	1	81	0.0123457
NODE_204_length_4906_cov_37.988350	3170	3251	8	1	81	0.0123457
NODE_204_length_4906_cov_37.988350	3170	3251	9	1	81	0.0123457
NODE_204_length_4906_cov_37.988350	3170	3251	11	1	81	0.0123457
NODE_204_length_4906_cov_37.988350	3170	3251	13	3	81	0.0370370
NODE_204_length_4906_cov_37.988350	3170	3251	16	3	81	0.0370370
NODE_204_length_4906_cov_37.988350	3170	3251	18	3	81	0.0370370
NODE_204_length_4906_cov_37.988350	3170	3251	19	3	81	0.0370370
NODE_204_length_4906_cov_37.988350	3170	3251	21	9	81	0.1111111
NODE_204_length_4906_cov_37.988350	3170	3251	22	8	81	0.0987654
NODE_204_length_4906_cov_37.988350	3170	3251	24	2	81	0.0246914
NODE_204_length_4906_cov_37.988350	3170	3251	26	3	81	0.0370370
NODE_204_length_4906_cov_37.988350	3170	3251	27	5	81	0.0617284
NODE_204_length_4906_cov_37.988350	3170	3251	29	1	81	0.0123457
NODE_204_length_4906_cov_37.988350	3170	3251	32	4	81	0.0493827
NODE_204_length_4906_cov_37.988350	3170	3251	34	9	81	0.1111111
NODE_204_length_4906_cov_37.988350	3170	3251	36	1	81	0.0123457
NODE_204_length_4906_cov_37.988350	3170	3251	37	1	81	0.0123457
NODE_204_length_4906_cov_37.988350	3170	3251	38	4	81	0.0493827
NODE_205_length_4888_cov_60.162247	4029	4068	4	7	39	0.1794872
NODE_205_length_4888_cov_60.162247	4029	4068	5	10	39	0.2564103
NODE_205_length_4888_cov_60.162247	4029	4068	7	22	39	0.5641026
NODE_205_length_4888_cov_60.162247	4041	4121	5	5	80	0.0625000
NODE_205_length_4888_cov_60.162247	4041	4121	7	40	80	0.5000000
NODE_205_length_4888_cov_60.162247	4041	4121	8	10	80	0.1250000
NODE_205_length_4888_cov_60.162247	4041	4121	10	18	80	0.2250000
NODE_205_length_4888_cov_60.162247	4041	4121	11	7	80	0.0875000
NODE_207_length_4875_cov_63.035176	2905	2985	0	20	80	0.2500000
NODE_207_length_4875_cov_63.035176	2905	2985	2	60	80	0.7500000
NODE_207_length_4875_cov_63.035176	2958	3038	2	44	80	0.5500000
NODE_207_length_4875_cov_63.035176	2958	3038	3	12	80	0.1500000
NODE_207_length_4875_cov_63.035176	2958	3038	4	1	80	0.0125000
NODE_207_length_4875_cov_63.035176	2958	3038	6	3	80	0.0375000
NODE_207_length_4875_cov_63.035176	2958	3038	8	12	80	0.1500000
NODE_207_length_4875_cov_63.035176	2958	3038	9	6	80	0.0750000
NODE_207_length_4875_cov_63.035176	2958	3038	10	2	80	0.0250000
NODE_208_length_4875_cov_8.996859	4683	4760	1	38	77	0.4935065
NODE_208_length_4875_cov_8.996859	4683	4760	2	39	77	0.5064935
NODE_208_length_4875_cov_8.996859	4736	4813	1	77	77	1.0000000
NODE_211_length_4827_cov_15.364636	1803	1865	15	4	62	0.0645161
NODE_211_length_4827_cov_15.364636	1803	1865	16	16	62	0.2580645
NODE_211_length_4827_cov_15.364636	1803	1865	17	10	62	0.1612903
NODE_211_length_4827_cov_15.364636	1803	1865	18	24	62	0.3870968
NODE_211_length_4827_cov_15.364636	1803	1865	19	8	62	0.1290323
NODE_211_length_4827_cov_15.364636	1899	1979	8	6	80	0.0750000
NODE_211_length_4827_cov_15.364636	1899	1979	9	27	80	0.3375000
NODE_211_length_4827_cov_15.364636	1899	1979	10	9	80	0.1125000
NODE_211_length_4827_cov_15.364636	1899	1979	11	16	80	0.2000000
NODE_211_length_4827_cov_15.364636	1899	1979	12	22	80	0.2750000
NODE_211_length_4827_cov_15.364636	1952	1996	8	8	44	0.1818182
NODE_211_length_4827_cov_15.364636	1952	1996	9	18	44	0.4090909
NODE_211_length_4827_cov_15.364636	1952	1996	10	18	44	0.4090909
NODE_212_length_4821_cov_10.856840	999	1061	1	12	62	0.1935484
NODE_212_length_4821_cov_10.856840	999	1061	2	3	62	0.0483871
NODE_212_length_4821_cov_10.856840	999	1061	3	22	62	0.3548387
NODE_212_length_4821_cov_10.856840	999	1061	5	25	62	0.4032258
NODE_213_length_4819_cov_16.363347	2392	2461	0	9	69	0.1304348
NODE_213_length_4819_cov_16.363347	2392	2461	1	60	69	0.8695652
NODE_217_length_4794_cov_14.912886	657	737	11	4	80	0.0500000
NODE_217_length_4794_cov_14.912886	657	737	13	2	80	0.0250000
NODE_217_length_4794_cov_14.912886	657	737	15	2	80	0.0250000
NODE_217_length_4794_cov_14.912886	657	737	17	6	80	0.0750000
NODE_217_length_4794_cov_14.912886	657	737	18	3	80	0.0375000
NODE_217_length_4794_cov_14.912886	657	737	19	15	80	0.1875000
NODE_217_length_4794_cov_14.912886	657	737	20	9	80	0.1125000
NODE_217_length_4794_cov_14.912886	657	737	22	2	80	0.0250000
NODE_217_length_4794_cov_14.912886	657	737	23	3	80	0.0375000
NODE_217_length_4794_cov_14.912886	657	737	24	5	80	0.0625000
NODE_217_length_4794_cov_14.912886	657	737	25	5	80	0.0625000
NODE_217_length_4794_cov_14.912886	657	737	26	3	80	0.0375000
NODE_217_length_4794_cov_14.912886	657	737	27	6	80	0.0750000
NODE_217_length_4794_cov_14.912886	657	737	28	1	80	0.0125000
NODE_217_length_4794_cov_14.912886	657	737	29	4	80	0.0500000
NODE_217_length_4794_cov_14.912886	657	737	30	2	80	0.0250000
NODE_217_length_4794_cov_14.912886	657	737	31	2	80	0.0250000
NODE_217_length_4794_cov_14.912886	657	737	32	3	80	0.0375000
NODE_217_length_4794_cov_14.912886	657	737	33	2	80	0.0250000
NODE_217_length_4794_cov_14.912886	657	737	38	1	80	0.0125000
NODE_217_length_4794_cov_14.912886	4240	4312	4	28	72	0.3888889
NODE_217_length_4794_cov_14.912886	4240	4312	5	30	72	0.4166667
NODE_217_length_4794_cov_14.912886	4240	4312	6	14	72	0.1944444
NODE_217_length_4794_cov_14.912886	4293	4312	5	19	19	1.0000000
NODE_217_length_4794_cov_14.912886	4345	4408	3	7	63	0.1111111
NODE_217_length_4794_cov_14.912886	4345	4408	5	5	63	0.0793651
NODE_217_length_4794_cov_14.912886	4345	4408	6	26	63	0.4126984
NODE_217_length_4794_cov_14.912886	4345	4408	7	25	63	0.3968254
NODE_218_length_4791_cov_16.126172	2438	2518	0	80	80	1.0000000
NODE_218_length_4791_cov_16.126172	2491	2571	0	80	80	1.0000000
NODE_218_length_4791_cov_16.126172	2567	2647	0	80	80	1.0000000
NODE_218_length_4791_cov_16.126172	2620	2700	0	80	80	1.0000000
NODE_218_length_4791_cov_16.126172	4607	4687	0	80	80	1.0000000
NODE_219_length_4790_cov_9.713494	2159	2239	15	3	80	0.0375000
NODE_219_length_4790_cov_9.713494	2159	2239	17	6	80	0.0750000
NODE_219_length_4790_cov_9.713494	2159	2239	18	3	80	0.0375000
NODE_219_length_4790_cov_9.713494	2159	2239	19	14	80	0.1750000
NODE_219_length_4790_cov_9.713494	2159	2239	20	8	80	0.1000000
NODE_219_length_4790_cov_9.713494	2159	2239	21	28	80	0.3500000
NODE_219_length_4790_cov_9.713494	2159	2239	22	6	80	0.0750000
NODE_219_length_4790_cov_9.713494	2159	2239	23	8	80	0.1000000
NODE_219_length_4790_cov_9.713494	2159	2239	24	4	80	0.0500000
NODE_219_length_4790_cov_9.713494	4273	4353	4	13	80	0.1625000
NODE_219_length_4790_cov_9.713494	4273	4353	5	8	80	0.1000000
NODE_219_length_4790_cov_9.713494	4273	4353	6	29	80	0.3625000
NODE_219_length_4790_cov_9.713494	4273	4353	7	4	80	0.0500000
NODE_219_length_4790_cov_9.713494	4273	4353	8	2	80	0.0250000
NODE_219_length_4790_cov_9.713494	4273	4353	9	8	80	0.1000000
NODE_219_length_4790_cov_9.713494	4273	4353	10	16	80	0.2000000
NODE_219_length_4790_cov_9.713494	4273	4335	4	3	62	0.0483871
NODE_219_length_4790_cov_9.713494	4273	4335	6	29	62	0.4677419
NODE_219_length_4790_cov_9.713494	4273	4335	7	4	62	0.0645161
NODE_219_length_4790_cov_9.713494	4273	4335	8	2	62	0.0322581
NODE_219_length_4790_cov_9.713494	4273	4335	9	8	62	0.1290323
NODE_219_length_4790_cov_9.713494	4273	4335	10	16	62	0.2580645
NODE_219_length_4790_cov_9.713494	4326	4406	4	14	80	0.1750000
NODE_219_length_4790_cov_9.713494	4326	4406	5	20	80	0.2500000
NODE_219_length_4790_cov_9.713494	4326	4406	6	18	80	0.2250000
NODE_219_length_4790_cov_9.713494	4326	4406	7	28	80	0.3500000
NODE_221_length_4772_cov_10.560454	4281	4367	0	86	86	1.0000000
NODE_222_length_4770_cov_106.953543	2778	2858	27	1	80	0.0125000
NODE_222_length_4770_cov_106.953543	2778	2858	28	2	80	0.0250000
NODE_222_length_4770_cov_106.953543	2778	2858	29	4	80	0.0500000
NODE_222_length_4770_cov_106.953543	2778	2858	30	1	80	0.0125000
NODE_222_length_4770_cov_106.953543	2778	2858	31	1	80	0.0125000
NODE_222_length_4770_cov_106.953543	2778	2858	32	2	80	0.0250000
NODE_222_length_4770_cov_106.953543	2778	2858	33	9	80	0.1125000
NODE_222_length_4770_cov_106.953543	2778	2858	34	18	80	0.2250000
NODE_222_length_4770_cov_106.953543	2778	2858	35	4	80	0.0500000
NODE_222_length_4770_cov_106.953543	2778	2858	36	5	80	0.0625000
NODE_222_length_4770_cov_106.953543	2778	2858	37	6	80	0.0750000
NODE_222_length_4770_cov_106.953543	2778	2858	38	4	80	0.0500000
NODE_222_length_4770_cov_106.953543	2778	2858	39	1	80	0.0125000
NODE_222_length_4770_cov_106.953543	2778	2858	40	11	80	0.1375000
NODE_222_length_4770_cov_106.953543	2778	2858	42	4	80	0.0500000
NODE_222_length_4770_cov_106.953543	2778	2858	43	2	80	0.0250000
NODE_222_length_4770_cov_106.953543	2778	2858	44	3	80	0.0375000
NODE_222_length_4770_cov_106.953543	2778	2858	46	2	80	0.0250000
NODE_222_length_4770_cov_106.953543	2831	2911	34	11	80	0.1375000
NODE_222_length_4770_cov_106.953543	2831	2911	35	1	80	0.0125000
NODE_222_length_4770_cov_106.953543	2831	2911	36	3	80	0.0375000
NODE_222_length_4770_cov_106.953543	2831	2911	40	1	80	0.0125000
NODE_222_length_4770_cov_106.953543	2831	2911	42	4	80	0.0500000
NODE_222_length_4770_cov_106.953543	2831	2911	43	2	80	0.0250000
NODE_222_length_4770_cov_106.953543	2831	2911	44	3	80	0.0375000
NODE_222_length_4770_cov_106.953543	2831	2911	45	3	80	0.0375000
NODE_222_length_4770_cov_106.953543	2831	2911	46	12	80	0.1500000
NODE_222_length_4770_cov_106.953543	2831	2911	47	9	80	0.1125000
NODE_222_length_4770_cov_106.953543	2831	2911	48	10	80	0.1250000
NODE_222_length_4770_cov_106.953543	2831	2911	49	1	80	0.0125000
NODE_222_length_4770_cov_106.953543	2831	2911	50	1	80	0.0125000
NODE_222_length_4770_cov_106.953543	2831	2911	52	3	80	0.0375000
NODE_222_length_4770_cov_106.953543	2831	2911	54	2	80	0.0250000
NODE_222_length_4770_cov_106.953543	2831	2911	55	3	80	0.0375000
NODE_222_length_4770_cov_106.953543	2831	2911	57	10	80	0.1250000
NODE_222_length_4770_cov_106.953543	2831	2911	59	1	80	0.0125000
NODE_222_length_4770_cov_106.953543	2907	2987	56	1	80	0.0125000
NODE_222_length_4770_cov_106.953543	2907	2987	57	6	80	0.0750000
NODE_222_length_4770_cov_106.953543	2907	2987	58	2	80	0.0250000
NODE_222_length_4770_cov_106.953543	2907	2987	59	1	80	0.0125000
NODE_222_length_4770_cov_106.953543	2907	2987	61	1	80	0.0125000
NODE_222_length_4770_cov_106.953543	2907	2987	63	2	80	0.0250000
NODE_222_length_4770_cov_106.953543	2907	2987	64	3	80	0.0375000
NODE_222_length_4770_cov_106.953543	2907	2987	68	4	80	0.0500000
NODE_222_length_4770_cov_106.953543	2907	2987	69	1	80	0.0125000
NODE_222_length_4770_cov_106.953543	2907	2987	72	5	80	0.0625000
NODE_222_length_4770_cov_106.953543	2907	2987	73	4	80	0.0500000
NODE_222_length_4770_cov_106.953543	2907	2987	74	4	80	0.0500000
NODE_222_length_4770_cov_106.953543	2907	2987	75	11	80	0.1375000
NODE_222_length_4770_cov_106.953543	2907	2987	76	9	80	0.1125000
NODE_222_length_4770_cov_106.953543	2907	2987	77	3	80	0.0375000
NODE_222_length_4770_cov_106.953543	2907	2987	78	6	80	0.0750000
NODE_222_length_4770_cov_106.953543	2907	2987	79	1	80	0.0125000
NODE_222_length_4770_cov_106.953543	2907	2987	80	9	80	0.1125000
NODE_222_length_4770_cov_106.953543	2907	2987	81	2	80	0.0250000
NODE_222_length_4770_cov_106.953543	2907	2987	82	2	80	0.0250000
NODE_222_length_4770_cov_106.953543	2907	2987	83	3	80	0.0375000
NODE_222_length_4770_cov_106.953543	2960	3040	53	1	80	0.0125000
NODE_222_length_4770_cov_106.953543	2960	3040	54	3	80	0.0375000
NODE_222_length_4770_cov_106.953543	2960	3040	57	3	80	0.0375000
NODE_222_length_4770_cov_106.953543	2960	3040	58	5	80	0.0625000
NODE_222_length_4770_cov_106.953543	2960	3040	59	2	80	0.0250000
NODE_222_length_4770_cov_106.953543	2960	3040	60	1	80	0.0125000
NODE_222_length_4770_cov_106.953543	2960	3040	61	10	80	0.1250000
NODE_222_length_4770_cov_106.953543	2960	3040	63	2	80	0.0250000
NODE_222_length_4770_cov_106.953543	2960	3040	65	1	80	0.0125000
NODE_222_length_4770_cov_106.953543	2960	3040	67	1	80	0.0125000
NODE_222_length_4770_cov_106.953543	2960	3040	70	1	80	0.0125000
NODE_222_length_4770_cov_106.953543	2960	3040	71	7	80	0.0875000
NODE_222_length_4770_cov_106.953543	2960	3040	72	2	80	0.0250000
NODE_222_length_4770_cov_106.953543	2960	3040	73	5	80	0.0625000
NODE_222_length_4770_cov_106.953543	2960	3040	74	8	80	0.1000000
NODE_222_length_4770_cov_106.953543	2960	3040	75	4	80	0.0500000
NODE_222_length_4770_cov_106.953543	2960	3040	76	3	80	0.0375000
NODE_222_length_4770_cov_106.953543	2960	3040	78	4	80	0.0500000
NODE_222_length_4770_cov_106.953543	2960	3040	79	1	80	0.0125000
NODE_222_length_4770_cov_106.953543	2960	3040	80	9	80	0.1125000
NODE_222_length_4770_cov_106.953543	2960	3040	81	2	80	0.0250000
NODE_222_length_4770_cov_106.953543	2960	3040	82	2	80	0.0250000
NODE_222_length_4770_cov_106.953543	2960	3040	83	3	80	0.0375000
NODE_223_length_4768_cov_15.447205	1237	1317	7	21	80	0.2625000
NODE_223_length_4768_cov_15.447205	1237	1317	8	18	80	0.2250000
NODE_223_length_4768_cov_15.447205	1237	1317	9	33	80	0.4125000
NODE_223_length_4768_cov_15.447205	1237	1317	10	8	80	0.1000000
NODE_228_length_4730_cov_30.142734	256	336	5	16	80	0.2000000
NODE_228_length_4730_cov_30.142734	256	336	7	13	80	0.1625000
NODE_228_length_4730_cov_30.142734	256	336	8	1	80	0.0125000
NODE_228_length_4730_cov_30.142734	256	336	9	19	80	0.2375000
NODE_228_length_4730_cov_30.142734	256	336	10	11	80	0.1375000
NODE_228_length_4730_cov_30.142734	256	336	12	2	80	0.0250000
NODE_228_length_4730_cov_30.142734	256	336	14	18	80	0.2250000
NODE_228_length_4730_cov_30.142734	309	389	9	23	80	0.2875000
NODE_228_length_4730_cov_30.142734	309	389	10	16	80	0.2000000
NODE_228_length_4730_cov_30.142734	309	389	12	2	80	0.0250000
NODE_228_length_4730_cov_30.142734	309	389	14	39	80	0.4875000
NODE_228_length_4730_cov_30.142734	4052	4132	4	10	80	0.1250000
NODE_228_length_4730_cov_30.142734	4052	4132	5	6	80	0.0750000
NODE_228_length_4730_cov_30.142734	4052	4132	7	46	80	0.5750000
NODE_228_length_4730_cov_30.142734	4052	4132	9	5	80	0.0625000
NODE_228_length_4730_cov_30.142734	4052	4132	10	2	80	0.0250000
NODE_228_length_4730_cov_30.142734	4052	4132	12	6	80	0.0750000
NODE_228_length_4730_cov_30.142734	4052	4132	13	5	80	0.0625000
NODE_228_length_4730_cov_30.142734	4105	4185	6	2	80	0.0250000
NODE_228_length_4730_cov_30.142734	4105	4185	7	12	80	0.1500000
NODE_228_length_4730_cov_30.142734	4105	4185	9	6	80	0.0750000
NODE_228_length_4730_cov_30.142734	4105	4185	10	32	80	0.4000000
NODE_228_length_4730_cov_30.142734	4105	4185	11	8	80	0.1000000
NODE_228_length_4730_cov_30.142734	4105	4185	12	14	80	0.1750000
NODE_228_length_4730_cov_30.142734	4105	4185	13	6	80	0.0750000
NODE_231_length_4706_cov_25.522683	2181	2261	4	2	80	0.0250000
NODE_231_length_4706_cov_25.522683	2181	2261	5	20	80	0.2500000
NODE_231_length_4706_cov_25.522683	2181	2261	6	12	80	0.1500000
NODE_231_length_4706_cov_25.522683	2181	2261	7	1	80	0.0125000
NODE_231_length_4706_cov_25.522683	2181	2261	8	13	80	0.1625000
NODE_231_length_4706_cov_25.522683	2181	2261	9	1	80	0.0125000
NODE_231_length_4706_cov_25.522683	2181	2261	10	1	80	0.0125000
NODE_231_length_4706_cov_25.522683	2181	2261	11	4	80	0.0500000
NODE_231_length_4706_cov_25.522683	2181	2261	12	5	80	0.0625000
NODE_231_length_4706_cov_25.522683	2181	2261	15	6	80	0.0750000
NODE_231_length_4706_cov_25.522683	2181	2261	16	3	80	0.0375000
NODE_231_length_4706_cov_25.522683	2181	2261	17	9	80	0.1125000
NODE_231_length_4706_cov_25.522683	2181	2261	18	3	80	0.0375000
NODE_231_length_4706_cov_25.522683	2234	2288	1	25	54	0.4629630
NODE_231_length_4706_cov_25.522683	2234	2288	2	1	54	0.0185185
NODE_231_length_4706_cov_25.522683	2234	2288	4	3	54	0.0555556
NODE_231_length_4706_cov_25.522683	2234	2288	5	20	54	0.3703704
NODE_231_length_4706_cov_25.522683	2234	2288	6	5	54	0.0925926
NODE_231_length_4706_cov_25.522683	3943	4026	13	7	83	0.0843373
NODE_231_length_4706_cov_25.522683	3943	4026	14	10	83	0.1204819
NODE_231_length_4706_cov_25.522683	3943	4026	15	11	83	0.1325301
NODE_231_length_4706_cov_25.522683	3943	4026	18	27	83	0.3253012
NODE_231_length_4706_cov_25.522683	3943	4026	19	2	83	0.0240964
NODE_231_length_4706_cov_25.522683	3943	4026	20	10	83	0.1204819
NODE_231_length_4706_cov_25.522683	3943	4026	21	10	83	0.1204819
NODE_231_length_4706_cov_25.522683	3943	4026	22	3	83	0.0361446
NODE_231_length_4706_cov_25.522683	3943	4026	26	1	83	0.0120482
NODE_231_length_4706_cov_25.522683	3943	4026	27	2	83	0.0240964
NODE_235_length_4693_cov_16.973008	374	454	2	6	80	0.0750000
NODE_235_length_4693_cov_16.973008	374	454	3	5	80	0.0625000
NODE_235_length_4693_cov_16.973008	374	454	5	7	80	0.0875000
NODE_235_length_4693_cov_16.973008	374	454	6	22	80	0.2750000
NODE_235_length_4693_cov_16.973008	374	454	8	9	80	0.1125000
NODE_235_length_4693_cov_16.973008	374	454	10	1	80	0.0125000
NODE_235_length_4693_cov_16.973008	374	454	12	2	80	0.0250000
NODE_235_length_4693_cov_16.973008	374	454	13	9	80	0.1125000
NODE_235_length_4693_cov_16.973008	374	454	15	19	80	0.2375000
NODE_235_length_4693_cov_16.973008	427	507	13	8	80	0.1000000
NODE_235_length_4693_cov_16.973008	427	507	14	47	80	0.5875000
NODE_235_length_4693_cov_16.973008	427	507	15	20	80	0.2500000
NODE_235_length_4693_cov_16.973008	427	507	16	5	80	0.0625000
NODE_240_length_4672_cov_39.029084	1391	1470	12	2	79	0.0253165
NODE_240_length_4672_cov_39.029084	1391	1470	14	1	79	0.0126582
NODE_240_length_4672_cov_39.029084	1391	1470	15	6	79	0.0759494
NODE_240_length_4672_cov_39.029084	1391	1470	17	13	79	0.1645570
NODE_240_length_4672_cov_39.029084	1391	1470	18	1	79	0.0126582
NODE_240_length_4672_cov_39.029084	1391	1470	20	18	79	0.2278481
NODE_240_length_4672_cov_39.029084	1391	1470	22	5	79	0.0632911
NODE_240_length_4672_cov_39.029084	1391	1470	24	2	79	0.0253165
NODE_240_length_4672_cov_39.029084	1391	1470	26	10	79	0.1265823
NODE_240_length_4672_cov_39.029084	1391	1470	28	4	79	0.0506329
NODE_240_length_4672_cov_39.029084	1391	1470	34	2	79	0.0253165
NODE_240_length_4672_cov_39.029084	1391	1470	35	12	79	0.1518987
NODE_240_length_4672_cov_39.029084	1391	1470	36	3	79	0.0379747
NODE_240_length_4672_cov_39.029084	1444	1523	23	5	79	0.0632911
NODE_240_length_4672_cov_39.029084	1444	1523	25	2	79	0.0253165
NODE_240_length_4672_cov_39.029084	1444	1523	26	5	79	0.0632911
NODE_240_length_4672_cov_39.029084	1444	1523	28	4	79	0.0506329
NODE_240_length_4672_cov_39.029084	1444	1523	29	6	79	0.0759494
NODE_240_length_4672_cov_39.029084	1444	1523	31	12	79	0.1518987
NODE_240_length_4672_cov_39.029084	1444	1523	33	13	79	0.1645570
NODE_240_length_4672_cov_39.029084	1444	1523	34	2	79	0.0253165
NODE_240_length_4672_cov_39.029084	1444	1523	35	27	79	0.3417721
NODE_240_length_4672_cov_39.029084	1444	1523	36	3	79	0.0379747
NODE_246_length_4602_cov_17.281368	3106	3186	7	19	80	0.2375000
NODE_246_length_4602_cov_17.281368	3106	3186	8	2	80	0.0250000
NODE_246_length_4602_cov_17.281368	3106	3186	10	18	80	0.2250000
NODE_246_length_4602_cov_17.281368	3106	3186	12	9	80	0.1125000
NODE_246_length_4602_cov_17.281368	3106	3186	14	13	80	0.1625000
NODE_246_length_4602_cov_17.281368	3106	3186	15	19	80	0.2375000
NODE_246_length_4602_cov_17.281368	3159	3239	9	3	80	0.0375000
NODE_246_length_4602_cov_17.281368	3159	3239	10	6	80	0.0750000
NODE_246_length_4602_cov_17.281368	3159	3239	11	1	80	0.0125000
NODE_246_length_4602_cov_17.281368	3159	3239	12	8	80	0.1000000
NODE_246_length_4602_cov_17.281368	3159	3239	13	4	80	0.0500000
NODE_246_length_4602_cov_17.281368	3159	3239	14	24	80	0.3000000
NODE_246_length_4602_cov_17.281368	3159	3239	15	34	80	0.4250000
NODE_248_length_4587_cov_14.431150	1294	1370	28	2	76	0.0263158
NODE_248_length_4587_cov_14.431150	1294	1370	30	1	76	0.0131579
NODE_248_length_4587_cov_14.431150	1294	1370	32	7	76	0.0921053
NODE_248_length_4587_cov_14.431150	1294	1370	33	9	76	0.1184211
NODE_248_length_4587_cov_14.431150	1294	1370	34	1	76	0.0131579
NODE_248_length_4587_cov_14.431150	1294	1370	35	15	76	0.1973684
NODE_248_length_4587_cov_14.431150	1294	1370	36	2	76	0.0263158
NODE_248_length_4587_cov_14.431150	1294	1370	37	3	76	0.0394737
NODE_248_length_4587_cov_14.431150	1294	1370	38	13	76	0.1710526
NODE_248_length_4587_cov_14.431150	1294	1370	39	16	76	0.2105263
NODE_248_length_4587_cov_14.431150	1294	1370	40	2	76	0.0263158
NODE_248_length_4587_cov_14.431150	1294	1370	41	5	76	0.0657895
NODE_248_length_4587_cov_14.431150	1347	1427	10	5	80	0.0625000
NODE_248_length_4587_cov_14.431150	1347	1427	11	4	80	0.0500000
NODE_248_length_4587_cov_14.431150	1347	1427	12	8	80	0.1000000
NODE_248_length_4587_cov_14.431150	1347	1427	13	5	80	0.0625000
NODE_248_length_4587_cov_14.431150	1347	1427	14	1	80	0.0125000
NODE_248_length_4587_cov_14.431150	1347	1427	15	2	80	0.0250000
NODE_248_length_4587_cov_14.431150	1347	1427	18	7	80	0.0875000
NODE_248_length_4587_cov_14.431150	1347	1427	19	1	80	0.0125000
NODE_248_length_4587_cov_14.431150	1347	1427	20	5	80	0.0625000
NODE_248_length_4587_cov_14.431150	1347	1427	21	1	80	0.0125000
NODE_248_length_4587_cov_14.431150	1347	1427	26	11	80	0.1375000
NODE_248_length_4587_cov_14.431150	1347	1427	27	3	80	0.0375000
NODE_248_length_4587_cov_14.431150	1347	1427	28	2	80	0.0250000
NODE_248_length_4587_cov_14.431150	1347	1427	29	4	80	0.0500000
NODE_248_length_4587_cov_14.431150	1347	1427	30	1	80	0.0125000
NODE_248_length_4587_cov_14.431150	1347	1427	32	5	80	0.0625000
NODE_248_length_4587_cov_14.431150	1347	1427	33	9	80	0.1125000
NODE_248_length_4587_cov_14.431150	1347	1427	35	6	80	0.0750000
NODE_248_length_4587_cov_14.431150	1466	1533	14	13	67	0.1940299
NODE_248_length_4587_cov_14.431150	1466	1533	15	5	67	0.0746269
NODE_248_length_4587_cov_14.431150	1466	1533	17	3	67	0.0447761
NODE_248_length_4587_cov_14.431150	1466	1533	18	7	67	0.1044776
NODE_248_length_4587_cov_14.431150	1466	1533	19	26	67	0.3880597
NODE_248_length_4587_cov_14.431150	1466	1533	20	13	67	0.1940299
NODE_248_length_4587_cov_14.431150	4316	4382	45	2	66	0.0303030
NODE_248_length_4587_cov_14.431150	4316	4382	50	4	66	0.0606061
NODE_248_length_4587_cov_14.431150	4316	4382	52	1	66	0.0151515
NODE_248_length_4587_cov_14.431150	4316	4382	53	2	66	0.0303030
NODE_248_length_4587_cov_14.431150	4316	4382	54	6	66	0.0909091
NODE_248_length_4587_cov_14.431150	4316	4382	55	6	66	0.0909091
NODE_248_length_4587_cov_14.431150	4316	4382	56	5	66	0.0757576
NODE_248_length_4587_cov_14.431150	4316	4382	57	1	66	0.0151515
NODE_248_length_4587_cov_14.431150	4316	4382	58	4	66	0.0606061
NODE_248_length_4587_cov_14.431150	4316	4382	59	8	66	0.1212121
NODE_248_length_4587_cov_14.431150	4316	4382	60	18	66	0.2727273
NODE_248_length_4587_cov_14.431150	4316	4382	61	9	66	0.1363636
NODE_248_length_4587_cov_14.431150	4355	4435	38	4	80	0.0500000
NODE_248_length_4587_cov_14.431150	4355	4435	40	1	80	0.0125000
NODE_248_length_4587_cov_14.431150	4355	4435	42	2	80	0.0250000
NODE_248_length_4587_cov_14.431150	4355	4435	43	5	80	0.0625000
NODE_248_length_4587_cov_14.431150	4355	4435	45	2	80	0.0250000
NODE_248_length_4587_cov_14.431150	4355	4435	49	2	80	0.0250000
NODE_248_length_4587_cov_14.431150	4355	4435	50	1	80	0.0125000
NODE_248_length_4587_cov_14.431150	4355	4435	51	1	80	0.0125000
NODE_248_length_4587_cov_14.431150	4355	4435	53	1	80	0.0125000
NODE_248_length_4587_cov_14.431150	4355	4435	54	3	80	0.0375000
NODE_248_length_4587_cov_14.431150	4355	4435	55	5	80	0.0625000
NODE_248_length_4587_cov_14.431150	4355	4435	56	4	80	0.0500000
NODE_248_length_4587_cov_14.431150	4355	4435	58	3	80	0.0375000
NODE_248_length_4587_cov_14.431150	4355	4435	59	7	80	0.0875000
NODE_248_length_4587_cov_14.431150	4355	4435	60	16	80	0.2000000
NODE_248_length_4587_cov_14.431150	4355	4435	61	23	80	0.2875000
NODE_249_length_4572_cov_50.244579	2406	2483	0	77	77	1.0000000
NODE_249_length_4572_cov_50.244579	2406	2483	0	77	77	1.0000000
NODE_251_length_4556_cov_14.556652	4229	4288	12	7	59	0.1186441
NODE_251_length_4556_cov_14.556652	4229	4288	13	2	59	0.0338983
NODE_251_length_4556_cov_14.556652	4229	4288	14	17	59	0.2881356
NODE_251_length_4556_cov_14.556652	4229	4288	15	12	59	0.2033898
NODE_251_length_4556_cov_14.556652	4229	4288	17	5	59	0.0847458
NODE_251_length_4556_cov_14.556652	4229	4288	19	4	59	0.0677966
NODE_251_length_4556_cov_14.556652	4229	4288	20	1	59	0.0169492
NODE_251_length_4556_cov_14.556652	4229	4288	21	2	59	0.0338983
NODE_251_length_4556_cov_14.556652	4229	4288	22	1	59	0.0169492
NODE_251_length_4556_cov_14.556652	4229	4288	23	2	59	0.0338983
NODE_251_length_4556_cov_14.556652	4229	4288	24	6	59	0.1016949
NODE_252_length_4550_cov_5.664120	3548	3628	0	80	80	1.0000000
NODE_252_length_4550_cov_5.664120	3601	3681	0	80	80	1.0000000
NODE_253_length_4544_cov_10.690439	353	433	0	80	80	1.0000000
NODE_253_length_4544_cov_10.690439	406	486	0	80	80	1.0000000
NODE_253_length_4544_cov_10.690439	4487	4544	0	55	57	0.9649123
NODE_253_length_4544_cov_10.690439	4487	4544	7	2	57	0.0350877
NODE_255_length_4535_cov_24.849188	675	755	1	13	80	0.1625000
NODE_255_length_4535_cov_24.849188	675	755	3	67	80	0.8375000
NODE_255_length_4535_cov_24.849188	728	809	0	2	81	0.0246914
NODE_255_length_4535_cov_24.849188	728	809	1	27	81	0.3333333
NODE_255_length_4535_cov_24.849188	728	809	3	52	81	0.6419753
NODE_255_length_4535_cov_24.849188	1319	1399	0	80	80	1.0000000
NODE_255_length_4535_cov_24.849188	1372	1452	0	30	80	0.3750000
NODE_255_length_4535_cov_24.849188	1372	1452	1	7	80	0.0875000
NODE_255_length_4535_cov_24.849188	1372	1452	2	2	80	0.0250000
NODE_255_length_4535_cov_24.849188	1372	1452	4	7	80	0.0875000
NODE_255_length_4535_cov_24.849188	1372	1452	12	1	80	0.0125000
NODE_255_length_4535_cov_24.849188	1372	1452	14	8	80	0.1000000
NODE_255_length_4535_cov_24.849188	1372	1452	15	9	80	0.1125000
NODE_255_length_4535_cov_24.849188	1372	1452	17	12	80	0.1500000
NODE_255_length_4535_cov_24.849188	1372	1452	19	3	80	0.0375000
NODE_255_length_4535_cov_24.849188	1372	1452	21	1	80	0.0125000
NODE_258_length_4528_cov_19.736509	4295	4366	0	36	71	0.5070422
NODE_258_length_4528_cov_19.736509	4295	4366	2	33	71	0.4647887
NODE_258_length_4528_cov_19.736509	4295	4366	4	1	71	0.0140845
NODE_258_length_4528_cov_19.736509	4295	4366	9	1	71	0.0140845
NODE_259_length_4505_cov_10.409215	3166	3202	7	9	36	0.2500000
NODE_259_length_4505_cov_10.409215	3166	3202	9	2	36	0.0555556
NODE_259_length_4505_cov_10.409215	3166	3202	11	25	36	0.6944444
NODE_259_length_4505_cov_10.409215	3175	3255	7	44	80	0.5500000
NODE_259_length_4505_cov_10.409215	3175	3255	9	4	80	0.0500000
NODE_259_length_4505_cov_10.409215	3175	3255	10	2	80	0.0250000
NODE_259_length_4505_cov_10.409215	3175	3255	11	30	80	0.3750000
NODE_260_length_4498_cov_8.216185	3161	3219	0	58	58	1.0000000
NODE_260_length_4498_cov_8.216185	4257	4314	0	57	57	1.0000000
NODE_263_length_4476_cov_29.825451	141	215	0	74	74	1.0000000
NODE_263_length_4476_cov_29.825451	1890	1970	29	2	80	0.0250000
NODE_263_length_4476_cov_29.825451	1890	1970	31	6	80	0.0750000
NODE_263_length_4476_cov_29.825451	1890	1970	32	25	80	0.3125000
NODE_263_length_4476_cov_29.825451	1890	1970	33	8	80	0.1000000
NODE_263_length_4476_cov_29.825451	1890	1970	34	1	80	0.0125000
NODE_263_length_4476_cov_29.825451	1890	1970	35	1	80	0.0125000
NODE_263_length_4476_cov_29.825451	1890	1970	36	3	80	0.0375000
NODE_263_length_4476_cov_29.825451	1890	1970	37	11	80	0.1375000
NODE_263_length_4476_cov_29.825451	1890	1970	38	23	80	0.2875000
NODE_263_length_4476_cov_29.825451	1943	2023	36	4	80	0.0500000
NODE_263_length_4476_cov_29.825451	1943	2023	37	6	80	0.0750000
NODE_263_length_4476_cov_29.825451	1943	2023	38	32	80	0.4000000
NODE_263_length_4476_cov_29.825451	1943	2023	39	8	80	0.1000000
NODE_263_length_4476_cov_29.825451	1943	2023	40	8	80	0.1000000
NODE_263_length_4476_cov_29.825451	1943	2023	41	7	80	0.0875000
NODE_263_length_4476_cov_29.825451	1943	2023	42	5	80	0.0625000
NODE_263_length_4476_cov_29.825451	1943	2023	43	10	80	0.1250000
NODE_264_length_4474_cov_17.051886	23	99	0	76	76	1.0000000
NODE_264_length_4474_cov_17.051886	23	98	0	75	75	1.0000000
NODE_264_length_4474_cov_17.051886	23	99	0	76	76	1.0000000
NODE_264_length_4474_cov_17.051886	32	99	0	67	67	1.0000000
NODE_264_length_4474_cov_17.051886	76	140	0	64	64	1.0000000
NODE_264_length_4474_cov_17.051886	1528	1569	8	1	41	0.0243902
NODE_264_length_4474_cov_17.051886	1528	1569	9	4	41	0.0975610
NODE_264_length_4474_cov_17.051886	1528	1569	11	1	41	0.0243902
NODE_264_length_4474_cov_17.051886	1528	1569	15	7	41	0.1707317
NODE_264_length_4474_cov_17.051886	1528	1569	17	7	41	0.1707317
NODE_264_length_4474_cov_17.051886	1528	1569	18	1	41	0.0243902
NODE_264_length_4474_cov_17.051886	1528	1569	20	2	41	0.0487805
NODE_264_length_4474_cov_17.051886	1528	1569	21	8	41	0.1951219
NODE_264_length_4474_cov_17.051886	1528	1569	23	1	41	0.0243902
NODE_264_length_4474_cov_17.051886	1528	1569	25	7	41	0.1707317
NODE_264_length_4474_cov_17.051886	1528	1569	27	2	41	0.0487805
NODE_264_length_4474_cov_17.051886	1536	1609	4	26	73	0.3561644
NODE_264_length_4474_cov_17.051886	1536	1609	5	3	73	0.0410959
NODE_264_length_4474_cov_17.051886	1536	1609	6	6	73	0.0821918
NODE_264_length_4474_cov_17.051886	1536	1609	8	6	73	0.0821918
NODE_264_length_4474_cov_17.051886	1536	1609	9	4	73	0.0547945
NODE_264_length_4474_cov_17.051886	1536	1609	11	1	73	0.0136986
NODE_264_length_4474_cov_17.051886	1536	1609	15	7	73	0.0958904
NODE_264_length_4474_cov_17.051886	1536	1609	17	7	73	0.0958904
NODE_264_length_4474_cov_17.051886	1536	1609	18	1	73	0.0136986
NODE_264_length_4474_cov_17.051886	1536	1609	20	2	73	0.0273973
NODE_264_length_4474_cov_17.051886	1536	1609	21	8	73	0.1095890
NODE_264_length_4474_cov_17.051886	1536	1609	23	1	73	0.0136986
NODE_264_length_4474_cov_17.051886	1536	1609	25	1	73	0.0136986
NODE_264_length_4474_cov_17.051886	1618	1643	0	20	25	0.8000000
NODE_264_length_4474_cov_17.051886	1618	1643	1	5	25	0.2000000
NODE_264_length_4474_cov_17.051886	1618	1696	0	73	78	0.9358974
NODE_264_length_4474_cov_17.051886	1618	1696	1	5	78	0.0641026
NODE_265_length_4474_cov_14.441829	282	362	4	4	80	0.0500000
NODE_265_length_4474_cov_14.441829	282	362	6	8	80	0.1000000
NODE_265_length_4474_cov_14.441829	282	362	7	14	80	0.1750000
NODE_265_length_4474_cov_14.441829	282	362	8	16	80	0.2000000
NODE_265_length_4474_cov_14.441829	282	362	10	33	80	0.4125000
NODE_265_length_4474_cov_14.441829	282	362	11	5	80	0.0625000
NODE_265_length_4474_cov_14.441829	335	415	0	36	80	0.4500000
NODE_265_length_4474_cov_14.441829	335	415	1	1	80	0.0125000
NODE_265_length_4474_cov_14.441829	335	415	2	6	80	0.0750000
NODE_265_length_4474_cov_14.441829	335	415	4	12	80	0.1500000
NODE_265_length_4474_cov_14.441829	335	415	6	8	80	0.1000000
NODE_265_length_4474_cov_14.441829	335	415	7	14	80	0.1750000
NODE_265_length_4474_cov_14.441829	335	415	8	1	80	0.0125000
NODE_265_length_4474_cov_14.441829	335	415	9	1	80	0.0125000
NODE_265_length_4474_cov_14.441829	335	415	15	1	80	0.0125000
NODE_265_length_4474_cov_14.441829	1522	1575	1	41	53	0.7735849
NODE_265_length_4474_cov_14.441829	1522	1575	2	2	53	0.0377358
NODE_265_length_4474_cov_14.441829	1522	1575	3	6	53	0.1132075
NODE_265_length_4474_cov_14.441829	1522	1575	5	3	53	0.0566038
NODE_265_length_4474_cov_14.441829	1522	1575	6	1	53	0.0188679
NODE_265_length_4474_cov_14.441829	1548	1623	1	20	75	0.2666667
NODE_265_length_4474_cov_14.441829	1548	1623	2	2	75	0.0266667
NODE_265_length_4474_cov_14.441829	1548	1623	3	36	75	0.4800000
NODE_265_length_4474_cov_14.441829	1548	1623	4	17	75	0.2266667
NODE_265_length_4474_cov_14.441829	3068	3121	0	51	53	0.9622642
NODE_265_length_4474_cov_14.441829	3068	3121	3	2	53	0.0377358
NODE_268_length_4463_cov_7.023144	119	168	0	44	49	0.8979592
NODE_268_length_4463_cov_7.023144	119	168	2	5	49	0.1020408
NODE_270_length_4453_cov_16.820395	3383	3463	41	1	80	0.0125000
NODE_270_length_4453_cov_16.820395	3383	3463	45	5	80	0.0625000
NODE_270_length_4453_cov_16.820395	3383	3463	47	2	80	0.0250000
NODE_270_length_4453_cov_16.820395	3383	3463	48	8	80	0.1000000
NODE_270_length_4453_cov_16.820395	3383	3463	49	9	80	0.1125000
NODE_270_length_4453_cov_16.820395	3383	3463	51	3	80	0.0375000
NODE_270_length_4453_cov_16.820395	3383	3463	53	2	80	0.0250000
NODE_270_length_4453_cov_16.820395	3383	3463	54	4	80	0.0500000
NODE_270_length_4453_cov_16.820395	3383	3463	56	3	80	0.0375000
NODE_270_length_4453_cov_16.820395	3383	3463	58	17	80	0.2125000
NODE_270_length_4453_cov_16.820395	3383	3463	60	4	80	0.0500000
NODE_270_length_4453_cov_16.820395	3383	3463	61	1	80	0.0125000
NODE_270_length_4453_cov_16.820395	3383	3463	62	12	80	0.1500000
NODE_270_length_4453_cov_16.820395	3383	3463	63	2	80	0.0250000
NODE_270_length_4453_cov_16.820395	3383	3463	64	4	80	0.0500000
NODE_270_length_4453_cov_16.820395	3383	3463	65	1	80	0.0125000
NODE_270_length_4453_cov_16.820395	3383	3463	67	2	80	0.0250000
NODE_270_length_4453_cov_16.820395	3436	3496	27	2	60	0.0333333
NODE_270_length_4453_cov_16.820395	3436	3496	29	5	60	0.0833333
NODE_270_length_4453_cov_16.820395	3436	3496	30	1	60	0.0166667
NODE_270_length_4453_cov_16.820395	3436	3496	32	3	60	0.0500000
NODE_270_length_4453_cov_16.820395	3436	3496	33	5	60	0.0833333
NODE_270_length_4453_cov_16.820395	3436	3496	34	6	60	0.1000000
NODE_270_length_4453_cov_16.820395	3436	3496	35	1	60	0.0166667
NODE_270_length_4453_cov_16.820395	3436	3496	37	5	60	0.0833333
NODE_270_length_4453_cov_16.820395	3436	3496	38	4	60	0.0666667
NODE_270_length_4453_cov_16.820395	3436	3496	40	1	60	0.0166667
NODE_270_length_4453_cov_16.820395	3436	3496	41	1	60	0.0166667
NODE_270_length_4453_cov_16.820395	3436	3496	45	5	60	0.0833333
NODE_270_length_4453_cov_16.820395	3436	3496	47	2	60	0.0333333
NODE_270_length_4453_cov_16.820395	3436	3496	48	8	60	0.1333333
NODE_270_length_4453_cov_16.820395	3436	3496	49	9	60	0.1500000
NODE_270_length_4453_cov_16.820395	3436	3496	51	2	60	0.0333333
NODE_272_length_4436_cov_31.114595	2807	2871	3	19	64	0.2968750
NODE_272_length_4436_cov_31.114595	2807	2871	5	14	64	0.2187500
NODE_272_length_4436_cov_31.114595	2807	2871	7	31	64	0.4843750
NODE_272_length_4436_cov_31.114595	2846	2906	2	3	60	0.0500000
NODE_272_length_4436_cov_31.114595	2846	2906	3	51	60	0.8500000
NODE_272_length_4436_cov_31.114595	2846	2906	5	6	60	0.1000000
NODE_272_length_4436_cov_31.114595	2846	2898	3	46	52	0.8846154
NODE_272_length_4436_cov_31.114595	2846	2898	5	6	52	0.1153846
NODE_278_length_4391_cov_7.711323	66	141	0	75	75	1.0000000
NODE_278_length_4391_cov_7.711323	119	155	0	31	36	0.8611111
NODE_278_length_4391_cov_7.711323	119	155	1	5	36	0.1388889
NODE_279_length_4385_cov_6.067662	1556	1606	0	12	50	0.2400000
NODE_279_length_4385_cov_6.067662	1556	1606	2	11	50	0.2200000
NODE_279_length_4385_cov_6.067662	1556	1606	4	16	50	0.3200000
NODE_279_length_4385_cov_6.067662	1556	1606	6	11	50	0.2200000
NODE_286_length_4331_cov_37.938800	1898	1978	18	8	80	0.1000000
NODE_286_length_4331_cov_37.938800	1898	1978	19	5	80	0.0625000
NODE_286_length_4331_cov_37.938800	1898	1978	20	6	80	0.0750000
NODE_286_length_4331_cov_37.938800	1898	1978	21	2	80	0.0250000
NODE_286_length_4331_cov_37.938800	1898	1978	22	2	80	0.0250000
NODE_286_length_4331_cov_37.938800	1898	1978	23	8	80	0.1000000
NODE_286_length_4331_cov_37.938800	1898	1978	24	1	80	0.0125000
NODE_286_length_4331_cov_37.938800	1898	1978	25	2	80	0.0250000
NODE_286_length_4331_cov_37.938800	1898	1978	27	3	80	0.0375000
NODE_286_length_4331_cov_37.938800	1898	1978	29	2	80	0.0250000
NODE_286_length_4331_cov_37.938800	1898	1978	31	3	80	0.0375000
NODE_286_length_4331_cov_37.938800	1898	1978	34	9	80	0.1125000
NODE_286_length_4331_cov_37.938800	1898	1978	35	4	80	0.0500000
NODE_286_length_4331_cov_37.938800	1898	1978	37	3	80	0.0375000
NODE_286_length_4331_cov_37.938800	1898	1978	39	11	80	0.1375000
NODE_286_length_4331_cov_37.938800	1898	1978	40	1	80	0.0125000
NODE_286_length_4331_cov_37.938800	1898	1978	41	5	80	0.0625000
NODE_286_length_4331_cov_37.938800	1898	1978	42	5	80	0.0625000
NODE_286_length_4331_cov_37.938800	1951	2031	35	2	80	0.0250000
NODE_286_length_4331_cov_37.938800	1951	2031	37	3	80	0.0375000
NODE_286_length_4331_cov_37.938800	1951	2031	39	11	80	0.1375000
NODE_286_length_4331_cov_37.938800	1951	2031	40	1	80	0.0125000
NODE_286_length_4331_cov_37.938800	1951	2031	41	6	80	0.0750000
NODE_286_length_4331_cov_37.938800	1951	2031	42	7	80	0.0875000
NODE_286_length_4331_cov_37.938800	1951	2031	43	2	80	0.0250000
NODE_286_length_4331_cov_37.938800	1951	2031	44	9	80	0.1125000
NODE_286_length_4331_cov_37.938800	1951	2031	45	3	80	0.0375000
NODE_286_length_4331_cov_37.938800	1951	2031	46	4	80	0.0500000
NODE_286_length_4331_cov_37.938800	1951	2031	47	4	80	0.0500000
NODE_286_length_4331_cov_37.938800	1951	2031	49	4	80	0.0500000
NODE_286_length_4331_cov_37.938800	1951	2031	50	6	80	0.0750000
NODE_286_length_4331_cov_37.938800	1951	2031	51	4	80	0.0500000
NODE_286_length_4331_cov_37.938800	1951	2031	52	1	80	0.0125000
NODE_286_length_4331_cov_37.938800	1951	2031	53	1	80	0.0125000
NODE_286_length_4331_cov_37.938800	1951	2031	55	6	80	0.0750000
NODE_286_length_4331_cov_37.938800	1951	2031	56	1	80	0.0125000
NODE_286_length_4331_cov_37.938800	1951	2031	57	5	80	0.0625000
NODE_286_length_4331_cov_37.938800	2027	2107	52	7	80	0.0875000
NODE_286_length_4331_cov_37.938800	2027	2107	53	3	80	0.0375000
NODE_286_length_4331_cov_37.938800	2027	2107	54	14	80	0.1750000
NODE_286_length_4331_cov_37.938800	2027	2107	55	6	80	0.0750000
NODE_286_length_4331_cov_37.938800	2027	2107	56	10	80	0.1250000
NODE_286_length_4331_cov_37.938800	2027	2107	57	9	80	0.1125000
NODE_286_length_4331_cov_37.938800	2027	2107	58	3	80	0.0375000
NODE_286_length_4331_cov_37.938800	2027	2107	59	10	80	0.1250000
NODE_286_length_4331_cov_37.938800	2027	2107	60	15	80	0.1875000
NODE_286_length_4331_cov_37.938800	2027	2107	61	2	80	0.0250000
NODE_286_length_4331_cov_37.938800	2027	2107	62	1	80	0.0125000
NODE_286_length_4331_cov_37.938800	2080	2160	34	1	80	0.0125000
NODE_286_length_4331_cov_37.938800	2080	2160	36	1	80	0.0125000
NODE_286_length_4331_cov_37.938800	2080	2160	37	1	80	0.0125000
NODE_286_length_4331_cov_37.938800	2080	2160	38	4	80	0.0500000
NODE_286_length_4331_cov_37.938800	2080	2160	40	1	80	0.0125000
NODE_286_length_4331_cov_37.938800	2080	2160	44	5	80	0.0625000
NODE_286_length_4331_cov_37.938800	2080	2160	45	4	80	0.0500000
NODE_286_length_4331_cov_37.938800	2080	2160	46	3	80	0.0375000
NODE_286_length_4331_cov_37.938800	2080	2160	47	8	80	0.1000000
NODE_286_length_4331_cov_37.938800	2080	2160	48	3	80	0.0375000
NODE_286_length_4331_cov_37.938800	2080	2160	49	1	80	0.0125000
NODE_286_length_4331_cov_37.938800	2080	2160	50	1	80	0.0125000
NODE_286_length_4331_cov_37.938800	2080	2160	52	1	80	0.0125000
NODE_286_length_4331_cov_37.938800	2080	2160	54	14	80	0.1750000
NODE_286_length_4331_cov_37.938800	2080	2160	55	2	80	0.0250000
NODE_286_length_4331_cov_37.938800	2080	2160	56	11	80	0.1375000
NODE_286_length_4331_cov_37.938800	2080	2160	57	2	80	0.0250000
NODE_286_length_4331_cov_37.938800	2080	2160	59	4	80	0.0500000
NODE_286_length_4331_cov_37.938800	2080	2160	60	11	80	0.1375000
NODE_286_length_4331_cov_37.938800	2080	2160	61	1	80	0.0125000
NODE_286_length_4331_cov_37.938800	2080	2160	62	1	80	0.0125000
NODE_289_length_4320_cov_7.680881	442	522	0	80	80	1.0000000
NODE_289_length_4320_cov_7.680881	495	575	0	80	80	1.0000000
NODE_289_length_4320_cov_7.680881	571	651	0	80	80	1.0000000
NODE_289_length_4320_cov_7.680881	624	704	0	80	80	1.0000000
NODE_290_length_4314_cov_5.311507	1436	1516	0	80	80	1.0000000
NODE_290_length_4314_cov_5.311507	1489	1569	0	80	80	1.0000000
NODE_290_length_4314_cov_5.311507	3331	3400	0	3	69	0.0434783
NODE_290_length_4314_cov_5.311507	3331	3400	1	43	69	0.6231884
NODE_290_length_4314_cov_5.311507	3331	3400	2	9	69	0.1304348
NODE_290_length_4314_cov_5.311507	3331	3400	4	14	69	0.2028985
NODE_290_length_4314_cov_5.311507	3420	3482	2	17	62	0.2741936
NODE_290_length_4314_cov_5.311507	3420	3482	4	45	62	0.7258065
NODE_292_length_4311_cov_8.733381	92	171	5	5	79	0.0632911
NODE_292_length_4311_cov_8.733381	92	171	6	24	79	0.3037975
NODE_292_length_4311_cov_8.733381	92	171	9	50	79	0.6329114
NODE_292_length_4311_cov_8.733381	1925	2005	0	80	80	1.0000000
NODE_292_length_4311_cov_8.733381	1978	2058	0	80	80	1.0000000
NODE_294_length_4293_cov_3.809251	244	326	4	3	82	0.0365854
NODE_294_length_4293_cov_3.809251	244	326	5	5	82	0.0609756
NODE_294_length_4293_cov_3.809251	244	326	6	12	82	0.1463415
NODE_294_length_4293_cov_3.809251	244	326	7	29	82	0.3536585
NODE_294_length_4293_cov_3.809251	244	326	8	33	82	0.4024390
NODE_294_length_4293_cov_3.809251	301	394	1	20	93	0.2150538
NODE_294_length_4293_cov_3.809251	301	394	3	15	93	0.1612903
NODE_294_length_4293_cov_3.809251	301	394	5	4	93	0.0430108
NODE_294_length_4293_cov_3.809251	301	394	6	1	93	0.0107527
NODE_294_length_4293_cov_3.809251	301	394	8	53	93	0.5698925
NODE_295_length_4284_cov_15.940263	3726	3806	2	5	80	0.0625000
NODE_295_length_4284_cov_15.940263	3726	3806	3	5	80	0.0625000
NODE_295_length_4284_cov_15.940263	3726	3806	4	12	80	0.1500000
NODE_295_length_4284_cov_15.940263	3726	3806	5	41	80	0.5125000
NODE_295_length_4284_cov_15.940263	3726	3806	6	17	80	0.2125000
NODE_295_length_4284_cov_15.940263	3779	3858	2	57	79	0.7215190
NODE_295_length_4284_cov_15.940263	3779	3858	3	5	79	0.0632911
NODE_295_length_4284_cov_15.940263	3779	3858	4	5	79	0.0632911
NODE_295_length_4284_cov_15.940263	3779	3858	6	12	79	0.1518987
NODE_299_length_4277_cov_5.451173	3818	3898	1	80	80	1.0000000
NODE_299_length_4277_cov_5.451173	3927	3995	0	40	68	0.5882353
NODE_299_length_4277_cov_5.451173	3927	3995	1	28	68	0.4117647
NODE_299_length_4277_cov_5.451173	3968	4048	0	52	80	0.6500000
NODE_299_length_4277_cov_5.451173	3968	4048	1	28	80	0.3500000
NODE_300_length_4274_cov_18.943234	591	671	8	5	80	0.0625000
NODE_300_length_4274_cov_18.943234	591	671	9	2	80	0.0250000
NODE_300_length_4274_cov_18.943234	591	671	10	27	80	0.3375000
NODE_300_length_4274_cov_18.943234	591	671	11	1	80	0.0125000
NODE_300_length_4274_cov_18.943234	591	671	12	45	80	0.5625000
NODE_300_length_4274_cov_18.943234	644	724	9	7	80	0.0875000
NODE_300_length_4274_cov_18.943234	644	724	10	26	80	0.3250000
NODE_300_length_4274_cov_18.943234	644	724	11	16	80	0.2000000
NODE_300_length_4274_cov_18.943234	644	724	12	20	80	0.2500000
NODE_300_length_4274_cov_18.943234	644	724	13	11	80	0.1375000
NODE_301_length_4274_cov_16.160958	416	496	0	72	80	0.9000000
NODE_301_length_4274_cov_16.160958	416	496	2	8	80	0.1000000
NODE_301_length_4274_cov_16.160958	1034	1114	4	31	80	0.3875000
NODE_301_length_4274_cov_16.160958	1034	1114	6	17	80	0.2125000
NODE_301_length_4274_cov_16.160958	1034	1114	8	32	80	0.4000000
NODE_301_length_4274_cov_16.160958	1087	1167	4	12	80	0.1500000
NODE_301_length_4274_cov_16.160958	1087	1167	5	17	80	0.2125000
NODE_301_length_4274_cov_16.160958	1087	1167	6	10	80	0.1250000
NODE_301_length_4274_cov_16.160958	1087	1167	7	8	80	0.1000000
NODE_301_length_4274_cov_16.160958	1087	1167	8	33	80	0.4125000
NODE_301_length_4274_cov_16.160958	1163	1243	0	40	80	0.5000000
NODE_301_length_4274_cov_16.160958	1163	1243	1	5	80	0.0625000
NODE_301_length_4274_cov_16.160958	1163	1243	2	8	80	0.1000000
NODE_301_length_4274_cov_16.160958	1163	1243	4	27	80	0.3375000
NODE_301_length_4274_cov_16.160958	1216	1296	0	22	80	0.2750000
NODE_301_length_4274_cov_16.160958	1216	1296	1	6	80	0.0750000
NODE_301_length_4274_cov_16.160958	1216	1296	2	52	80	0.6500000
NODE_301_length_4274_cov_16.160958	3411	3491	1	10	80	0.1250000
NODE_301_length_4274_cov_16.160958	3411	3491	2	10	80	0.1250000
NODE_301_length_4274_cov_16.160958	3411	3491	3	16	80	0.2000000
NODE_301_length_4274_cov_16.160958	3411	3491	5	33	80	0.4125000
NODE_301_length_4274_cov_16.160958	3411	3491	7	2	80	0.0250000
NODE_301_length_4274_cov_16.160958	3411	3491	8	9	80	0.1125000
NODE_302_length_4270_cov_14.045792	3835	3915	37	2	80	0.0250000
NODE_302_length_4270_cov_14.045792	3835	3915	38	3	80	0.0375000
NODE_302_length_4270_cov_14.045792	3835	3915	40	4	80	0.0500000
NODE_302_length_4270_cov_14.045792	3835	3915	41	3	80	0.0375000
NODE_302_length_4270_cov_14.045792	3835	3915	42	2	80	0.0250000
NODE_302_length_4270_cov_14.045792	3835	3915	43	5	80	0.0625000
NODE_302_length_4270_cov_14.045792	3835	3915	44	12	80	0.1500000
NODE_302_length_4270_cov_14.045792	3835	3915	45	16	80	0.2000000
NODE_302_length_4270_cov_14.045792	3835	3915	46	7	80	0.0875000
NODE_302_length_4270_cov_14.045792	3835	3915	47	10	80	0.1250000
NODE_302_length_4270_cov_14.045792	3835	3915	48	10	80	0.1250000
NODE_302_length_4270_cov_14.045792	3835	3915	49	5	80	0.0625000
NODE_302_length_4270_cov_14.045792	3835	3915	50	1	80	0.0125000
NODE_302_length_4270_cov_14.045792	3888	3968	38	8	80	0.1000000
NODE_302_length_4270_cov_14.045792	3888	3968	39	1	80	0.0125000
NODE_302_length_4270_cov_14.045792	3888	3968	40	5	80	0.0625000
NODE_302_length_4270_cov_14.045792	3888	3968	41	3	80	0.0375000
NODE_302_length_4270_cov_14.045792	3888	3968	42	4	80	0.0500000
NODE_302_length_4270_cov_14.045792	3888	3968	43	15	80	0.1875000
NODE_302_length_4270_cov_14.045792	3888	3968	44	4	80	0.0500000
NODE_302_length_4270_cov_14.045792	3888	3968	45	15	80	0.1875000
NODE_302_length_4270_cov_14.045792	3888	3968	46	7	80	0.0875000
NODE_302_length_4270_cov_14.045792	3888	3968	47	5	80	0.0625000
NODE_302_length_4270_cov_14.045792	3888	3968	48	7	80	0.0875000
NODE_302_length_4270_cov_14.045792	3888	3968	49	5	80	0.0625000
NODE_302_length_4270_cov_14.045792	3888	3968	50	1	80	0.0125000
NODE_303_length_4260_cov_24.780822	244	311	0	67	67	1.0000000
NODE_303_length_4260_cov_24.780822	244	311	0	67	67	1.0000000
NODE_303_length_4260_cov_24.780822	263	311	0	48	48	1.0000000
NODE_303_length_4260_cov_24.780822	1605	1633	0	26	28	0.9285714
NODE_303_length_4260_cov_24.780822	1605	1633	2	1	28	0.0357143
NODE_303_length_4260_cov_24.780822	1605	1633	11	1	28	0.0357143
NODE_303_length_4260_cov_24.780822	1660	1699	0	4	39	0.1025641
NODE_303_length_4260_cov_24.780822	1660	1699	3	15	39	0.3846154
NODE_303_length_4260_cov_24.780822	1660	1699	5	10	39	0.2564103
NODE_303_length_4260_cov_24.780822	1660	1699	6	7	39	0.1794872
NODE_303_length_4260_cov_24.780822	1660	1699	7	3	39	0.0769231
NODE_310_length_4207_cov_6.923564	3664	3722	7	22	58	0.3793103
NODE_310_length_4207_cov_6.923564	3664	3722	8	12	58	0.2068966
NODE_310_length_4207_cov_6.923564	3664	3722	11	24	58	0.4137931
NODE_310_length_4207_cov_6.923564	3695	3775	6	26	80	0.3250000
NODE_310_length_4207_cov_6.923564	3695	3775	7	48	80	0.6000000
NODE_310_length_4207_cov_6.923564	3695	3775	8	6	80	0.0750000
NODE_311_length_4205_cov_6.121042	592	632	2	40	40	1.0000000
NODE_311_length_4205_cov_6.121042	605	685	2	80	80	1.0000000
NODE_311_length_4205_cov_6.121042	681	745	0	8	64	0.1250000
NODE_311_length_4205_cov_6.121042	681	745	1	40	64	0.6250000
NODE_311_length_4205_cov_6.121042	681	745	2	16	64	0.2500000
NODE_312_length_4196_cov_4.170857	340	420	0	80	80	1.0000000
NODE_312_length_4196_cov_4.170857	393	473	0	80	80	1.0000000
NODE_316_length_4179_cov_6.655882	1	65	2	20	64	0.3125000
NODE_316_length_4179_cov_6.655882	1	65	4	12	64	0.1875000
NODE_316_length_4179_cov_6.655882	1	65	6	32	64	0.5000000
NODE_316_length_4179_cov_6.655882	1087	1140	2	38	53	0.7169811
NODE_316_length_4179_cov_6.655882	1087	1140	3	15	53	0.2830189
NODE_316_length_4179_cov_6.655882	1818	1898	2	1	80	0.0125000
NODE_316_length_4179_cov_6.655882	1818	1898	3	79	80	0.9875000
NODE_319_length_4150_cov_10.600099	2827	2849	3	5	22	0.2272727
NODE_319_length_4150_cov_10.600099	2827	2849	4	17	22	0.7727273
NODE_319_length_4150_cov_10.600099	2973	3053	10	11	80	0.1375000
NODE_319_length_4150_cov_10.600099	2973	3053	11	13	80	0.1625000
NODE_319_length_4150_cov_10.600099	2973	3053	12	9	80	0.1125000
NODE_319_length_4150_cov_10.600099	2973	3053	13	9	80	0.1125000
NODE_319_length_4150_cov_10.600099	2973	3053	14	35	80	0.4375000
NODE_319_length_4150_cov_10.600099	2973	3053	15	3	80	0.0375000
NODE_319_length_4150_cov_10.600099	3026	3106	5	3	80	0.0375000
NODE_319_length_4150_cov_10.600099	3026	3106	6	22	80	0.2750000
NODE_319_length_4150_cov_10.600099	3026	3106	7	21	80	0.2625000
NODE_319_length_4150_cov_10.600099	3026	3106	9	1	80	0.0125000
NODE_319_length_4150_cov_10.600099	3026	3106	10	17	80	0.2125000
NODE_319_length_4150_cov_10.600099	3026	3106	11	13	80	0.1625000
NODE_319_length_4150_cov_10.600099	3026	3106	12	3	80	0.0375000
NODE_324_length_4119_cov_27.984328	2818	2898	25	11	80	0.1375000
NODE_324_length_4119_cov_27.984328	2818	2898	26	17	80	0.2125000
NODE_324_length_4119_cov_27.984328	2818	2898	27	4	80	0.0500000
NODE_324_length_4119_cov_27.984328	2818	2898	28	12	80	0.1500000
NODE_324_length_4119_cov_27.984328	2818	2898	29	14	80	0.1750000
NODE_324_length_4119_cov_27.984328	2818	2898	30	14	80	0.1750000
NODE_324_length_4119_cov_27.984328	2818	2898	31	6	80	0.0750000
NODE_324_length_4119_cov_27.984328	2818	2898	32	1	80	0.0125000
NODE_324_length_4119_cov_27.984328	2818	2898	33	1	80	0.0125000
NODE_325_length_4108_cov_14.755550	378	422	0	5	44	0.1136364
NODE_325_length_4108_cov_14.755550	378	422	2	39	44	0.8863636
NODE_325_length_4108_cov_14.755550	3537	3617	3	2	80	0.0250000
NODE_325_length_4108_cov_14.755550	3537	3617	4	32	80	0.4000000
NODE_325_length_4108_cov_14.755550	3537	3617	5	22	80	0.2750000
NODE_325_length_4108_cov_14.755550	3537	3617	7	3	80	0.0375000
NODE_325_length_4108_cov_14.755550	3537	3617	8	21	80	0.2625000
NODE_325_length_4108_cov_14.755550	3590	3670	5	3	80	0.0375000
NODE_325_length_4108_cov_14.755550	3590	3670	7	16	80	0.2000000
NODE_325_length_4108_cov_14.755550	3590	3670	8	41	80	0.5125000
NODE_325_length_4108_cov_14.755550	3590	3670	9	6	80	0.0750000
NODE_325_length_4108_cov_14.755550	3590	3670	11	14	80	0.1750000
NODE_326_length_4107_cov_1.855539	207	287	0	80	80	1.0000000
NODE_328_length_4096_cov_31.197648	379	459	4	58	80	0.7250000
NODE_328_length_4096_cov_31.197648	379	459	6	19	80	0.2375000
NODE_328_length_4096_cov_31.197648	379	459	7	3	80	0.0375000
NODE_328_length_4096_cov_31.197648	432	512	3	1	80	0.0125000
NODE_328_length_4096_cov_31.197648	432	512	4	33	80	0.4125000
NODE_328_length_4096_cov_31.197648	432	512	5	3	80	0.0375000
NODE_328_length_4096_cov_31.197648	432	512	6	19	80	0.2375000
NODE_328_length_4096_cov_31.197648	432	512	7	24	80	0.3000000
NODE_328_length_4096_cov_31.197648	3305	3385	0	80	80	1.0000000
NODE_328_length_4096_cov_31.197648	3358	3438	0	80	80	1.0000000
NODE_329_length_4081_cov_20.248870	3673	3753	2	1	80	0.0125000
NODE_329_length_4081_cov_20.248870	3673	3753	3	9	80	0.1125000
NODE_329_length_4081_cov_20.248870	3673	3753	5	12	80	0.1500000
NODE_329_length_4081_cov_20.248870	3673	3753	6	58	80	0.7250000
NODE_329_length_4081_cov_20.248870	3726	3806	0	29	80	0.3625000
NODE_329_length_4081_cov_20.248870	3726	3806	1	21	80	0.2625000
NODE_329_length_4081_cov_20.248870	3726	3806	2	4	80	0.0500000
NODE_329_length_4081_cov_20.248870	3726	3806	3	9	80	0.1125000
NODE_329_length_4081_cov_20.248870	3726	3806	5	12	80	0.1500000
NODE_329_length_4081_cov_20.248870	3726	3806	6	5	80	0.0625000
NODE_330_length_4076_cov_15.138044	1062	1142	0	4	80	0.0500000
NODE_330_length_4076_cov_15.138044	1062	1142	1	76	80	0.9500000
NODE_330_length_4076_cov_15.138044	1115	1195	0	4	80	0.0500000
NODE_330_length_4076_cov_15.138044	1115	1195	1	76	80	0.9500000
NODE_331_length_4069_cov_14.261209	3871	3936	0	65	65	1.0000000
NODE_333_length_4050_cov_31.044039	1703	1783	6	4	80	0.0500000
NODE_333_length_4050_cov_31.044039	1703	1783	8	33	80	0.4125000
NODE_333_length_4050_cov_31.044039	1703	1783	10	9	80	0.1125000
NODE_333_length_4050_cov_31.044039	1703	1783	11	4	80	0.0500000
NODE_333_length_4050_cov_31.044039	1703	1783	12	2	80	0.0250000
NODE_333_length_4050_cov_31.044039	1703	1783	13	8	80	0.1000000
NODE_333_length_4050_cov_31.044039	1703	1783	14	3	80	0.0375000
NODE_333_length_4050_cov_31.044039	1703	1783	16	2	80	0.0250000
NODE_333_length_4050_cov_31.044039	1703	1783	19	14	80	0.1750000
NODE_333_length_4050_cov_31.044039	1703	1783	20	1	80	0.0125000
NODE_335_length_4021_cov_34.619072	379	459	5	5	80	0.0625000
NODE_335_length_4021_cov_34.619072	379	459	6	22	80	0.2750000
NODE_335_length_4021_cov_34.619072	379	459	7	53	80	0.6625000
NODE_335_length_4021_cov_34.619072	432	512	4	11	80	0.1375000
NODE_335_length_4021_cov_34.619072	432	512	5	4	80	0.0500000
NODE_335_length_4021_cov_34.619072	432	512	6	1	80	0.0125000
NODE_335_length_4021_cov_34.619072	432	512	7	63	80	0.7875000
NODE_335_length_4021_cov_34.619072	432	512	8	1	80	0.0125000
NODE_336_length_4020_cov_5.130834	3455	3535	5	23	80	0.2875000
NODE_336_length_4020_cov_5.130834	3455	3535	6	3	80	0.0375000
NODE_336_length_4020_cov_5.130834	3455	3535	7	2	80	0.0250000
NODE_336_length_4020_cov_5.130834	3455	3535	8	10	80	0.1250000
NODE_336_length_4020_cov_5.130834	3455	3535	10	4	80	0.0500000
NODE_336_length_4020_cov_5.130834	3455	3535	11	6	80	0.0750000
NODE_336_length_4020_cov_5.130834	3455	3535	13	26	80	0.3250000
NODE_336_length_4020_cov_5.130834	3455	3535	15	6	80	0.0750000
NODE_336_length_4020_cov_5.130834	3508	3588	13	35	80	0.4375000
NODE_336_length_4020_cov_5.130834	3508	3588	14	13	80	0.1625000
NODE_336_length_4020_cov_5.130834	3508	3588	15	13	80	0.1625000
NODE_336_length_4020_cov_5.130834	3508	3588	16	19	80	0.2375000
NODE_339_length_4004_cov_9.718054	387	467	0	80	80	1.0000000
NODE_339_length_4004_cov_9.718054	440	520	0	48	80	0.6000000
NODE_339_length_4004_cov_9.718054	440	520	2	32	80	0.4000000
NODE_339_length_4004_cov_9.718054	516	596	2	13	80	0.1625000
NODE_339_length_4004_cov_9.718054	516	596	4	30	80	0.3750000
NODE_339_length_4004_cov_9.718054	516	596	5	5	80	0.0625000
NODE_339_length_4004_cov_9.718054	516	596	6	32	80	0.4000000
NODE_339_length_4004_cov_9.718054	569	649	4	17	80	0.2125000
NODE_339_length_4004_cov_9.718054	569	649	5	5	80	0.0625000
NODE_339_length_4004_cov_9.718054	569	649	6	58	80	0.7250000
NODE_341_length_3991_cov_18.617934	867	947	0	80	80	1.0000000
NODE_341_length_3991_cov_18.617934	920	1000	0	80	80	1.0000000
NODE_341_length_3991_cov_18.617934	996	1076	0	80	80	1.0000000
NODE_341_length_3991_cov_18.617934	1049	1124	0	75	75	1.0000000
NODE_348_length_3973_cov_6.906298	17	65	0	48	48	1.0000000
NODE_348_length_3973_cov_6.906298	1945	1995	16	4	50	0.0800000
NODE_348_length_3973_cov_6.906298	1945	1995	17	6	50	0.1200000
NODE_348_length_3973_cov_6.906298	1945	1995	18	1	50	0.0200000
NODE_348_length_3973_cov_6.906298	1945	1995	19	13	50	0.2600000
NODE_348_length_3973_cov_6.906298	1945	1995	20	7	50	0.1400000
NODE_348_length_3973_cov_6.906298	1945	1995	21	14	50	0.2800000
NODE_348_length_3973_cov_6.906298	1945	1995	22	5	50	0.1000000
NODE_350_length_3960_cov_6.246827	2673	2761	0	88	88	1.0000000
NODE_350_length_3960_cov_6.246827	3520	3600	0	80	80	1.0000000
NODE_350_length_3960_cov_6.246827	3573	3653	0	80	80	1.0000000
NODE_353_length_3952_cov_8.805346	826	906	7	16	80	0.2000000
NODE_353_length_3952_cov_8.805346	826	906	9	10	80	0.1250000
NODE_353_length_3952_cov_8.805346	826	906	10	17	80	0.2125000
NODE_353_length_3952_cov_8.805346	826	906	11	29	80	0.3625000
NODE_353_length_3952_cov_8.805346	826	906	13	7	80	0.0875000
NODE_353_length_3952_cov_8.805346	826	906	14	1	80	0.0125000
NODE_353_length_3952_cov_8.805346	879	959	9	13	80	0.1625000
NODE_353_length_3952_cov_8.805346	879	959	10	12	80	0.1500000
NODE_353_length_3952_cov_8.805346	879	959	11	23	80	0.2875000
NODE_353_length_3952_cov_8.805346	879	959	12	12	80	0.1500000
NODE_353_length_3952_cov_8.805346	879	959	13	19	80	0.2375000
NODE_353_length_3952_cov_8.805346	879	959	14	1	80	0.0125000
NODE_354_length_3928_cov_5.936798	2440	2521	0	81	81	1.0000000
NODE_354_length_3928_cov_5.936798	2493	2574	0	81	81	1.0000000
NODE_356_length_3923_cov_14.807793	3759	3800	0	41	41	1.0000000
NODE_358_length_3922_cov_7.609731	1493	1573	14	14	80	0.1750000
NODE_358_length_3922_cov_7.609731	1493	1573	15	4	80	0.0500000
NODE_358_length_3922_cov_7.609731	1493	1573	16	11	80	0.1375000
NODE_358_length_3922_cov_7.609731	1493	1573	17	2	80	0.0250000
NODE_358_length_3922_cov_7.609731	1493	1573	18	17	80	0.2125000
NODE_358_length_3922_cov_7.609731	1493	1573	19	21	80	0.2625000
NODE_358_length_3922_cov_7.609731	1493	1573	20	11	80	0.1375000
NODE_358_length_3922_cov_7.609731	1546	1600	11	10	54	0.1851852
NODE_358_length_3922_cov_7.609731	1546	1600	12	1	54	0.0185185
NODE_358_length_3922_cov_7.609731	1546	1600	15	1	54	0.0185185
NODE_358_length_3922_cov_7.609731	1546	1600	17	9	54	0.1666667
NODE_358_length_3922_cov_7.609731	1546	1600	18	12	54	0.2222222
NODE_358_length_3922_cov_7.609731	1546	1600	19	13	54	0.2407407
NODE_358_length_3922_cov_7.609731	1546	1600	20	8	54	0.1481481
NODE_359_length_3921_cov_9.943223	2936	3016	69	3	80	0.0375000
NODE_359_length_3921_cov_9.943223	2936	3016	70	10	80	0.1250000
NODE_359_length_3921_cov_9.943223	2936	3016	71	4	80	0.0500000
NODE_359_length_3921_cov_9.943223	2936	3016	72	2	80	0.0250000
NODE_359_length_3921_cov_9.943223	2936	3016	73	3	80	0.0375000
NODE_359_length_3921_cov_9.943223	2936	3016	74	5	80	0.0625000
NODE_359_length_3921_cov_9.943223	2936	3016	75	6	80	0.0750000
NODE_359_length_3921_cov_9.943223	2936	3016	76	3	80	0.0375000
NODE_359_length_3921_cov_9.943223	2936	3016	77	6	80	0.0750000
NODE_359_length_3921_cov_9.943223	2936	3016	79	4	80	0.0500000
NODE_359_length_3921_cov_9.943223	2936	3016	80	1	80	0.0125000
NODE_359_length_3921_cov_9.943223	2936	3016	81	4	80	0.0500000
NODE_359_length_3921_cov_9.943223	2936	3016	82	9	80	0.1125000
NODE_359_length_3921_cov_9.943223	2936	3016	83	8	80	0.1000000
NODE_359_length_3921_cov_9.943223	2936	3016	85	1	80	0.0125000
NODE_359_length_3921_cov_9.943223	2936	3016	86	4	80	0.0500000
NODE_359_length_3921_cov_9.943223	2936	3016	87	3	80	0.0375000
NODE_359_length_3921_cov_9.943223	2936	3016	88	1	80	0.0125000
NODE_359_length_3921_cov_9.943223	2936	3016	89	3	80	0.0375000
NODE_359_length_3921_cov_9.943223	2989	3057	68	2	68	0.0294118
NODE_359_length_3921_cov_9.943223	2989	3057	69	2	68	0.0294118
NODE_359_length_3921_cov_9.943223	2989	3057	71	5	68	0.0735294
NODE_359_length_3921_cov_9.943223	2989	3057	72	3	68	0.0441176
NODE_359_length_3921_cov_9.943223	2989	3057	73	1	68	0.0147059
NODE_359_length_3921_cov_9.943223	2989	3057	74	3	68	0.0441176
NODE_359_length_3921_cov_9.943223	2989	3057	75	3	68	0.0441176
NODE_359_length_3921_cov_9.943223	2989	3057	76	4	68	0.0588235
NODE_359_length_3921_cov_9.943223	2989	3057	77	1	68	0.0147059
NODE_359_length_3921_cov_9.943223	2989	3057	78	1	68	0.0147059
NODE_359_length_3921_cov_9.943223	2989	3057	79	2	68	0.0294118
NODE_359_length_3921_cov_9.943223	2989	3057	80	6	68	0.0882353
NODE_359_length_3921_cov_9.943223	2989	3057	81	4	68	0.0588235
NODE_359_length_3921_cov_9.943223	2989	3057	82	9	68	0.1323529
NODE_359_length_3921_cov_9.943223	2989	3057	83	15	68	0.2205882
NODE_359_length_3921_cov_9.943223	2989	3057	84	2	68	0.0294118
NODE_359_length_3921_cov_9.943223	2989	3057	86	1	68	0.0147059
NODE_359_length_3921_cov_9.943223	2989	3057	87	2	68	0.0294118
NODE_359_length_3921_cov_9.943223	2989	3057	88	1	68	0.0147059
NODE_359_length_3921_cov_9.943223	2989	3057	89	1	68	0.0147059
NODE_359_length_3921_cov_9.943223	3047	3066	61	1	19	0.0526316
NODE_359_length_3921_cov_9.943223	3047	3066	64	2	19	0.1052632
NODE_359_length_3921_cov_9.943223	3047	3066	65	1	19	0.0526316
NODE_359_length_3921_cov_9.943223	3047	3066	68	2	19	0.1052632
NODE_359_length_3921_cov_9.943223	3047	3066	69	7	19	0.3684210
NODE_359_length_3921_cov_9.943223	3047	3066	71	5	19	0.2631579
NODE_359_length_3921_cov_9.943223	3047	3066	72	1	19	0.0526316
NODE_363_length_3898_cov_40.033167	3296	3370	4	74	74	1.0000000
NODE_363_length_3898_cov_40.033167	3539	3619	1	80	80	1.0000000
NODE_364_length_3898_cov_7.550145	668	748	1	62	80	0.7750000
NODE_364_length_3898_cov_7.550145	668	748	2	18	80	0.2250000
NODE_364_length_3898_cov_7.550145	721	801	0	8	80	0.1000000
NODE_364_length_3898_cov_7.550145	721	801	1	68	80	0.8500000
NODE_364_length_3898_cov_7.550145	721	801	4	3	80	0.0375000
NODE_364_length_3898_cov_7.550145	721	801	6	1	80	0.0125000
NODE_367_length_3882_cov_4.166006	3244	3324	2	40	80	0.5000000
NODE_367_length_3882_cov_4.166006	3244	3324	3	21	80	0.2625000
NODE_367_length_3882_cov_4.166006	3244	3324	4	19	80	0.2375000
NODE_367_length_3882_cov_4.166006	3282	3324	2	2	42	0.0476190
NODE_367_length_3882_cov_4.166006	3282	3324	3	21	42	0.5000000
NODE_367_length_3882_cov_4.166006	3282	3324	4	19	42	0.4523810
NODE_367_length_3882_cov_4.166006	3297	3377	2	18	80	0.2250000
NODE_367_length_3882_cov_4.166006	3297	3377	3	8	80	0.1000000
NODE_367_length_3882_cov_4.166006	3297	3377	4	54	80	0.6750000
NODE_367_length_3882_cov_4.166006	3297	3377	2	18	80	0.2250000
NODE_367_length_3882_cov_4.166006	3297	3377	3	8	80	0.1000000
NODE_367_length_3882_cov_4.166006	3297	3377	4	54	80	0.6750000
NODE_367_length_3882_cov_4.166006	3373	3450	1	21	77	0.2727273
NODE_367_length_3882_cov_4.166006	3373	3450	2	56	77	0.7272727
NODE_374_length_3853_cov_18.816196	524	579	9	41	55	0.7454545
NODE_374_length_3853_cov_18.816196	524	579	10	6	55	0.1090909
NODE_374_length_3853_cov_18.816196	524	579	11	8	55	0.1454545
NODE_374_length_3853_cov_18.816196	559	639	8	10	80	0.1250000
NODE_374_length_3853_cov_18.816196	559	639	9	29	80	0.3625000
NODE_374_length_3853_cov_18.816196	559	639	10	32	80	0.4000000
NODE_374_length_3853_cov_18.816196	559	639	11	9	80	0.1125000
NODE_379_length_3829_cov_12.697319	515	595	0	57	80	0.7125000
NODE_379_length_3829_cov_12.697319	515	595	2	18	80	0.2250000
NODE_379_length_3829_cov_12.697319	515	595	3	5	80	0.0625000
NODE_379_length_3829_cov_12.697319	568	648	0	80	80	1.0000000
NODE_379_length_3829_cov_12.697319	644	724	0	35	80	0.4375000
NODE_379_length_3829_cov_12.697319	644	724	1	45	80	0.5625000
NODE_379_length_3829_cov_12.697319	697	777	1	80	80	1.0000000
NODE_381_length_3815_cov_17.218784	399	479	6	4	80	0.0500000
NODE_381_length_3815_cov_17.218784	399	479	7	41	80	0.5125000
NODE_381_length_3815_cov_17.218784	399	479	8	35	80	0.4375000
NODE_381_length_3815_cov_17.218784	452	532	3	19	80	0.2375000
NODE_381_length_3815_cov_17.218784	452	532	4	12	80	0.1500000
NODE_381_length_3815_cov_17.218784	452	532	5	4	80	0.0500000
NODE_381_length_3815_cov_17.218784	452	532	6	15	80	0.1875000
NODE_381_length_3815_cov_17.218784	452	532	8	30	80	0.3750000
NODE_383_length_3812_cov_65.007272	840	903	3	8	63	0.1269841
NODE_383_length_3812_cov_65.007272	840	903	4	1	63	0.0158730
NODE_383_length_3812_cov_65.007272	840	903	7	3	63	0.0476190
NODE_383_length_3812_cov_65.007272	840	903	11	3	63	0.0476190
NODE_383_length_3812_cov_65.007272	840	903	12	2	63	0.0317460
NODE_383_length_3812_cov_65.007272	840	903	13	6	63	0.0952381
NODE_383_length_3812_cov_65.007272	840	903	14	1	63	0.0158730
NODE_383_length_3812_cov_65.007272	840	903	15	1	63	0.0158730
NODE_383_length_3812_cov_65.007272	840	903	16	2	63	0.0317460
NODE_383_length_3812_cov_65.007272	840	903	17	3	63	0.0476190
NODE_383_length_3812_cov_65.007272	840	903	19	1	63	0.0158730
NODE_383_length_3812_cov_65.007272	840	903	20	2	63	0.0317460
NODE_383_length_3812_cov_65.007272	840	903	21	2	63	0.0317460
NODE_383_length_3812_cov_65.007272	840	903	22	1	63	0.0158730
NODE_383_length_3812_cov_65.007272	840	903	24	5	63	0.0793651
NODE_383_length_3812_cov_65.007272	840	903	26	4	63	0.0634921
NODE_383_length_3812_cov_65.007272	840	903	28	1	63	0.0158730
NODE_383_length_3812_cov_65.007272	840	903	30	2	63	0.0317460
NODE_383_length_3812_cov_65.007272	840	903	32	2	63	0.0317460
NODE_383_length_3812_cov_65.007272	840	903	33	1	63	0.0158730
NODE_383_length_3812_cov_65.007272	840	903	34	1	63	0.0158730
NODE_383_length_3812_cov_65.007272	840	903	35	1	63	0.0158730
NODE_383_length_3812_cov_65.007272	840	903	37	3	63	0.0476190
NODE_383_length_3812_cov_65.007272	840	903	38	1	63	0.0158730
NODE_383_length_3812_cov_65.007272	840	903	40	1	63	0.0158730
NODE_383_length_3812_cov_65.007272	840	903	43	5	63	0.0793651
NODE_384_length_3805_cov_9.533189	145	236	1	38	91	0.4175824
NODE_384_length_3805_cov_9.533189	145	236	2	53	91	0.5824176
NODE_384_length_3805_cov_9.533189	209	279	1	21	70	0.3000000
NODE_384_length_3805_cov_9.533189	209	279	2	49	70	0.7000000
NODE_386_length_3799_cov_10.046486	2944	3024	8	16	80	0.2000000
NODE_386_length_3799_cov_10.046486	2944	3024	10	38	80	0.4750000
NODE_386_length_3799_cov_10.046486	2944	3024	11	20	80	0.2500000
NODE_386_length_3799_cov_10.046486	2944	3024	12	1	80	0.0125000
NODE_386_length_3799_cov_10.046486	2944	3024	13	1	80	0.0125000
NODE_386_length_3799_cov_10.046486	2944	3024	15	4	80	0.0500000
NODE_386_length_3799_cov_10.046486	2997	3077	5	18	80	0.2250000
NODE_386_length_3799_cov_10.046486	2997	3077	6	10	80	0.1250000
NODE_386_length_3799_cov_10.046486	2997	3077	7	2	80	0.0250000
NODE_386_length_3799_cov_10.046486	2997	3077	8	39	80	0.4875000
NODE_386_length_3799_cov_10.046486	2997	3077	10	11	80	0.1375000
NODE_388_length_3795_cov_13.724297	3350	3430	0	80	80	1.0000000
NODE_388_length_3795_cov_13.724297	3403	3483	0	75	80	0.9375000
NODE_388_length_3795_cov_13.724297	3403	3483	1	5	80	0.0625000
NODE_388_length_3795_cov_13.724297	3479	3562	1	83	83	1.0000000
NODE_388_length_3795_cov_13.724297	3479	3562	1	83	83	1.0000000
NODE_388_length_3795_cov_13.724297	3479	3552	1	73	73	1.0000000
NODE_388_length_3795_cov_13.724297	3535	3586	1	51	51	1.0000000
NODE_388_length_3795_cov_13.724297	3535	3584	1	49	49	1.0000000
NODE_388_length_3795_cov_13.724297	3698	3721	7	23	23	1.0000000
NODE_394_length_3774_cov_7.720544	538	595	0	3	57	0.0526316
NODE_394_length_3774_cov_7.720544	538	595	1	2	57	0.0350877
NODE_394_length_3774_cov_7.720544	538	595	3	45	57	0.7894737
NODE_394_length_3774_cov_7.720544	538	595	4	7	57	0.1228070
NODE_404_length_3747_cov_3.328947	2230	2292	4	49	62	0.7903226
NODE_404_length_3747_cov_3.328947	2230	2292	5	13	62	0.2096774
NODE_406_length_3743_cov_38.767014	1354	1434	5	2	80	0.0250000
NODE_406_length_3743_cov_38.767014	1354	1434	6	1	80	0.0125000
NODE_406_length_3743_cov_38.767014	1354	1434	7	8	80	0.1000000
NODE_406_length_3743_cov_38.767014	1354	1434	8	9	80	0.1125000
NODE_406_length_3743_cov_38.767014	1354	1434	9	4	80	0.0500000
NODE_406_length_3743_cov_38.767014	1354	1434	11	2	80	0.0250000
NODE_406_length_3743_cov_38.767014	1354	1434	13	3	80	0.0375000
NODE_406_length_3743_cov_38.767014	1354	1434	14	2	80	0.0250000
NODE_406_length_3743_cov_38.767014	1354	1434	15	13	80	0.1625000
NODE_406_length_3743_cov_38.767014	1354	1434	16	14	80	0.1750000
NODE_406_length_3743_cov_38.767014	1354	1434	17	22	80	0.2750000
NODE_406_length_3743_cov_38.767014	1407	1487	11	2	80	0.0250000
NODE_406_length_3743_cov_38.767014	1407	1487	13	10	80	0.1250000
NODE_406_length_3743_cov_38.767014	1407	1487	15	8	80	0.1000000
NODE_406_length_3743_cov_38.767014	1407	1487	17	60	80	0.7500000
NODE_408_length_3733_cov_16.204458	186	249	0	53	63	0.8412699
NODE_408_length_3733_cov_16.204458	186	249	1	1	63	0.0158730
NODE_408_length_3733_cov_16.204458	186	249	2	2	63	0.0317460
NODE_408_length_3733_cov_16.204458	186	249	3	2	63	0.0317460
NODE_408_length_3733_cov_16.204458	186	249	8	5	63	0.0793651
NODE_413_length_3707_cov_56.575665	2387	2467	3	45	80	0.5625000
NODE_413_length_3707_cov_56.575665	2387	2467	4	18	80	0.2250000
NODE_413_length_3707_cov_56.575665	2387	2467	5	6	80	0.0750000
NODE_413_length_3707_cov_56.575665	2387	2467	6	6	80	0.0750000
NODE_413_length_3707_cov_56.575665	2387	2467	7	5	80	0.0625000
NODE_413_length_3707_cov_56.575665	2440	2520	4	10	80	0.1250000
NODE_413_length_3707_cov_56.575665	2440	2520	5	6	80	0.0750000
NODE_413_length_3707_cov_56.575665	2440	2520	6	6	80	0.0750000
NODE_413_length_3707_cov_56.575665	2440	2520	7	16	80	0.2000000
NODE_413_length_3707_cov_56.575665	2440	2520	8	4	80	0.0500000
NODE_413_length_3707_cov_56.575665	2440	2520	9	1	80	0.0125000
NODE_413_length_3707_cov_56.575665	2440	2520	10	11	80	0.1375000
NODE_413_length_3707_cov_56.575665	2440	2520	11	11	80	0.1375000
NODE_413_length_3707_cov_56.575665	2440	2520	12	6	80	0.0750000
NODE_413_length_3707_cov_56.575665	2440	2520	14	7	80	0.0875000
NODE_413_length_3707_cov_56.575665	2440	2520	15	2	80	0.0250000
NODE_413_length_3707_cov_56.575665	2516	2596	13	1	80	0.0125000
NODE_413_length_3707_cov_56.575665	2516	2596	14	9	80	0.1125000
NODE_413_length_3707_cov_56.575665	2516	2596	15	2	80	0.0250000
NODE_413_length_3707_cov_56.575665	2516	2596	17	2	80	0.0250000
NODE_413_length_3707_cov_56.575665	2516	2596	19	2	80	0.0250000
NODE_413_length_3707_cov_56.575665	2516	2596	20	19	80	0.2375000
NODE_413_length_3707_cov_56.575665	2516	2596	21	23	80	0.2875000
NODE_413_length_3707_cov_56.575665	2516	2596	22	6	80	0.0750000
NODE_413_length_3707_cov_56.575665	2516	2596	23	4	80	0.0500000
NODE_413_length_3707_cov_56.575665	2516	2596	24	12	80	0.1500000
NODE_413_length_3707_cov_56.575665	2569	2649	13	8	80	0.1000000
NODE_413_length_3707_cov_56.575665	2569	2649	15	8	80	0.1000000
NODE_413_length_3707_cov_56.575665	2569	2649	16	1	80	0.0125000
NODE_413_length_3707_cov_56.575665	2569	2649	18	1	80	0.0125000
NODE_413_length_3707_cov_56.575665	2569	2649	20	3	80	0.0375000
NODE_413_length_3707_cov_56.575665	2569	2649	21	7	80	0.0875000
NODE_413_length_3707_cov_56.575665	2569	2649	22	7	80	0.0875000
NODE_413_length_3707_cov_56.575665	2569	2649	23	17	80	0.2125000
NODE_413_length_3707_cov_56.575665	2569	2649	24	23	80	0.2875000
NODE_413_length_3707_cov_56.575665	2569	2649	25	5	80	0.0625000
NODE_416_length_3690_cov_7.476190	723	792	2	49	69	0.7101449
NODE_416_length_3690_cov_7.476190	723	792	4	20	69	0.2898551
NODE_416_length_3690_cov_7.476190	776	855	0	1	79	0.0126582
NODE_416_length_3690_cov_7.476190	776	855	1	57	79	0.7215190
NODE_416_length_3690_cov_7.476190	776	855	2	21	79	0.2658228
NODE_419_length_3685_cov_7.011154	1966	2046	15	1	80	0.0125000
NODE_419_length_3685_cov_7.011154	1966	2046	16	5	80	0.0625000
NODE_419_length_3685_cov_7.011154	1966	2046	17	13	80	0.1625000
NODE_419_length_3685_cov_7.011154	1966	2046	18	19	80	0.2375000
NODE_419_length_3685_cov_7.011154	1966	2046	19	34	80	0.4250000
NODE_419_length_3685_cov_7.011154	1966	2046	20	7	80	0.0875000
NODE_419_length_3685_cov_7.011154	1966	2046	21	1	80	0.0125000
NODE_419_length_3685_cov_7.011154	2019	2086	16	5	67	0.0746269
NODE_419_length_3685_cov_7.011154	2019	2086	17	8	67	0.1194030
NODE_419_length_3685_cov_7.011154	2019	2086	18	9	67	0.1343284
NODE_419_length_3685_cov_7.011154	2019	2086	19	22	67	0.3283582
NODE_419_length_3685_cov_7.011154	2019	2086	21	1	67	0.0149254
NODE_419_length_3685_cov_7.011154	2019	2086	23	1	67	0.0149254
NODE_419_length_3685_cov_7.011154	2019	2086	25	2	67	0.0298507
NODE_419_length_3685_cov_7.011154	2019	2086	26	7	67	0.1044776
NODE_419_length_3685_cov_7.011154	2019	2086	27	4	67	0.0597015
NODE_419_length_3685_cov_7.011154	2019	2086	28	8	67	0.1194030
NODE_426_length_3667_cov_1089.047365	1634	1705	13	7	71	0.0985916
NODE_426_length_3667_cov_1089.047365	1634	1705	14	4	71	0.0563380
NODE_426_length_3667_cov_1089.047365	1634	1705	15	10	71	0.1408451
NODE_426_length_3667_cov_1089.047365	1634	1705	16	3	71	0.0422535
NODE_426_length_3667_cov_1089.047365	1634	1705	18	1	71	0.0140845
NODE_426_length_3667_cov_1089.047365	1634	1705	19	6	71	0.0845070
NODE_426_length_3667_cov_1089.047365	1634	1705	20	9	71	0.1267606
NODE_426_length_3667_cov_1089.047365	1634	1705	24	3	71	0.0422535
NODE_426_length_3667_cov_1089.047365	1634	1705	25	2	71	0.0281690
NODE_426_length_3667_cov_1089.047365	1634	1705	26	11	71	0.1549296
NODE_426_length_3667_cov_1089.047365	1634	1705	28	11	71	0.1549296
NODE_426_length_3667_cov_1089.047365	1634	1705	29	4	71	0.0563380
NODE_426_length_3667_cov_1089.047365	1678	1758	21	1	80	0.0125000
NODE_426_length_3667_cov_1089.047365	1678	1758	23	14	80	0.1750000
NODE_426_length_3667_cov_1089.047365	1678	1758	24	13	80	0.1625000
NODE_426_length_3667_cov_1089.047365	1678	1758	25	2	80	0.0250000
NODE_426_length_3667_cov_1089.047365	1678	1758	26	21	80	0.2625000
NODE_426_length_3667_cov_1089.047365	1678	1758	27	5	80	0.0625000
NODE_426_length_3667_cov_1089.047365	1678	1758	28	13	80	0.1625000
NODE_426_length_3667_cov_1089.047365	1678	1758	29	11	80	0.1375000
NODE_428_length_3660_cov_79.447627	1806	1870	43	5	64	0.0781250
NODE_428_length_3660_cov_79.447627	1806	1870	44	4	64	0.0625000
NODE_428_length_3660_cov_79.447627	1806	1870	45	6	64	0.0937500
NODE_428_length_3660_cov_79.447627	1806	1870	47	4	64	0.0625000
NODE_428_length_3660_cov_79.447627	1806	1870	48	2	64	0.0312500
NODE_428_length_3660_cov_79.447627	1806	1870	49	5	64	0.0781250
NODE_428_length_3660_cov_79.447627	1806	1870	50	2	64	0.0312500
NODE_428_length_3660_cov_79.447627	1806	1870	51	6	64	0.0937500
NODE_428_length_3660_cov_79.447627	1806	1870	52	1	64	0.0156250
NODE_428_length_3660_cov_79.447627	1806	1870	53	6	64	0.0937500
NODE_428_length_3660_cov_79.447627	1806	1870	55	10	64	0.1562500
NODE_428_length_3660_cov_79.447627	1806	1870	56	4	64	0.0625000
NODE_428_length_3660_cov_79.447627	1806	1870	57	1	64	0.0156250
NODE_428_length_3660_cov_79.447627	1806	1870	58	2	64	0.0312500
NODE_428_length_3660_cov_79.447627	1806	1870	59	6	64	0.0937500
NODE_428_length_3660_cov_79.447627	1859	1906	56	2	47	0.0425532
NODE_428_length_3660_cov_79.447627	1859	1906	57	1	47	0.0212766
NODE_428_length_3660_cov_79.447627	1859	1906	58	5	47	0.1063830
NODE_428_length_3660_cov_79.447627	1859	1906	59	9	47	0.1914894
NODE_428_length_3660_cov_79.447627	1859	1906	60	7	47	0.1489362
NODE_428_length_3660_cov_79.447627	1859	1906	61	12	47	0.2553191
NODE_428_length_3660_cov_79.447627	1859	1906	62	8	47	0.1702128
NODE_428_length_3660_cov_79.447627	1859	1906	63	3	47	0.0638298
NODE_428_length_3660_cov_79.447627	2358	2438	0	80	80	1.0000000
NODE_428_length_3660_cov_79.447627	2411	2491	0	80	80	1.0000000
NODE_428_length_3660_cov_79.447627	2487	2567	0	80	80	1.0000000
NODE_428_length_3660_cov_79.447627	2540	2620	0	80	80	1.0000000
NODE_430_length_3634_cov_34.913154	1499	1544	30	1	45	0.0222222
NODE_430_length_3634_cov_34.913154	1499	1544	36	1	45	0.0222222
NODE_430_length_3634_cov_34.913154	1499	1544	41	1	45	0.0222222
NODE_430_length_3634_cov_34.913154	1499	1544	48	1	45	0.0222222
NODE_430_length_3634_cov_34.913154	1499	1544	52	2	45	0.0444444
NODE_430_length_3634_cov_34.913154	1499	1544	53	4	45	0.0888889
NODE_430_length_3634_cov_34.913154	1499	1544	58	1	45	0.0222222
NODE_430_length_3634_cov_34.913154	1499	1544	60	1	45	0.0222222
NODE_430_length_3634_cov_34.913154	1499	1544	62	2	45	0.0444444
NODE_430_length_3634_cov_34.913154	1499	1544	63	4	45	0.0888889
NODE_430_length_3634_cov_34.913154	1499	1544	65	1	45	0.0222222
NODE_430_length_3634_cov_34.913154	1499	1544	70	1	45	0.0222222
NODE_430_length_3634_cov_34.913154	1499	1544	72	2	45	0.0444444
NODE_430_length_3634_cov_34.913154	1499	1544	73	1	45	0.0222222
NODE_430_length_3634_cov_34.913154	1499	1544	74	1	45	0.0222222
NODE_430_length_3634_cov_34.913154	1499	1544	75	1	45	0.0222222
NODE_430_length_3634_cov_34.913154	1499	1544	78	2	45	0.0444444
NODE_430_length_3634_cov_34.913154	1499	1544	79	3	45	0.0666667
NODE_430_length_3634_cov_34.913154	1499	1544	82	1	45	0.0222222
NODE_430_length_3634_cov_34.913154	1499	1544	84	1	45	0.0222222
NODE_430_length_3634_cov_34.913154	1499	1544	85	1	45	0.0222222
NODE_430_length_3634_cov_34.913154	1499	1544	86	2	45	0.0444444
NODE_430_length_3634_cov_34.913154	1499	1544	89	2	45	0.0444444
NODE_430_length_3634_cov_34.913154	1499	1544	93	1	45	0.0222222
NODE_430_length_3634_cov_34.913154	1499	1544	94	1	45	0.0222222
NODE_430_length_3634_cov_34.913154	1499	1544	101	3	45	0.0666667
NODE_430_length_3634_cov_34.913154	1499	1544	103	2	45	0.0444444
NODE_430_length_3634_cov_34.913154	1499	1544	104	1	45	0.0222222
NODE_430_length_3634_cov_34.913154	1517	1597	65	1	80	0.0125000
NODE_430_length_3634_cov_34.913154	1517	1597	70	1	80	0.0125000
NODE_430_length_3634_cov_34.913154	1517	1597	72	2	80	0.0250000
NODE_430_length_3634_cov_34.913154	1517	1597	73	1	80	0.0125000
NODE_430_length_3634_cov_34.913154	1517	1597	74	1	80	0.0125000
NODE_430_length_3634_cov_34.913154	1517	1597	75	1	80	0.0125000
NODE_430_length_3634_cov_34.913154	1517	1597	78	2	80	0.0250000
NODE_430_length_3634_cov_34.913154	1517	1597	79	3	80	0.0375000
NODE_430_length_3634_cov_34.913154	1517	1597	82	1	80	0.0125000
NODE_430_length_3634_cov_34.913154	1517	1597	84	1	80	0.0125000
NODE_430_length_3634_cov_34.913154	1517	1597	85	1	80	0.0125000
NODE_430_length_3634_cov_34.913154	1517	1597	86	2	80	0.0250000
NODE_430_length_3634_cov_34.913154	1517	1597	89	2	80	0.0250000
NODE_430_length_3634_cov_34.913154	1517	1597	93	1	80	0.0125000
NODE_430_length_3634_cov_34.913154	1517	1597	94	1	80	0.0125000
NODE_430_length_3634_cov_34.913154	1517	1597	101	3	80	0.0375000
NODE_430_length_3634_cov_34.913154	1517	1597	102	1	80	0.0125000
NODE_430_length_3634_cov_34.913154	1517	1597	103	2	80	0.0250000
NODE_430_length_3634_cov_34.913154	1517	1597	104	3	80	0.0375000
NODE_430_length_3634_cov_34.913154	1517	1597	107	1	80	0.0125000
NODE_430_length_3634_cov_34.913154	1517	1597	108	3	80	0.0375000
NODE_430_length_3634_cov_34.913154	1517	1597	109	1	80	0.0125000
NODE_430_length_3634_cov_34.913154	1517	1597	112	4	80	0.0500000
NODE_430_length_3634_cov_34.913154	1517	1597	114	1	80	0.0125000
NODE_430_length_3634_cov_34.913154	1517	1597	116	1	80	0.0125000
NODE_430_length_3634_cov_34.913154	1517	1597	119	1	80	0.0125000
NODE_430_length_3634_cov_34.913154	1517	1597	120	1	80	0.0125000
NODE_430_length_3634_cov_34.913154	1517	1597	122	1	80	0.0125000
NODE_430_length_3634_cov_34.913154	1517	1597	124	2	80	0.0250000
NODE_430_length_3634_cov_34.913154	1517	1597	125	2	80	0.0250000
NODE_430_length_3634_cov_34.913154	1517	1597	132	1	80	0.0125000
NODE_430_length_3634_cov_34.913154	1517	1597	134	1	80	0.0125000
NODE_430_length_3634_cov_34.913154	1517	1597	135	1	80	0.0125000
NODE_430_length_3634_cov_34.913154	1517	1597	139	1	80	0.0125000
NODE_430_length_3634_cov_34.913154	1517	1597	140	1	80	0.0125000
NODE_430_length_3634_cov_34.913154	1517	1597	142	3	80	0.0375000
NODE_430_length_3634_cov_34.913154	1517	1597	144	1	80	0.0125000
NODE_430_length_3634_cov_34.913154	1517	1597	150	1	80	0.0125000
NODE_430_length_3634_cov_34.913154	1517	1597	153	1	80	0.0125000
NODE_430_length_3634_cov_34.913154	1517	1597	155	2	80	0.0250000
NODE_430_length_3634_cov_34.913154	1517	1597	157	1	80	0.0125000
NODE_430_length_3634_cov_34.913154	1517	1597	160	1	80	0.0125000
NODE_430_length_3634_cov_34.913154	1517	1597	161	2	80	0.0250000
NODE_430_length_3634_cov_34.913154	1517	1597	163	2	80	0.0250000
NODE_430_length_3634_cov_34.913154	1517	1597	164	2	80	0.0250000
NODE_430_length_3634_cov_34.913154	1517	1597	165	2	80	0.0250000
NODE_430_length_3634_cov_34.913154	1517	1597	166	2	80	0.0250000
NODE_430_length_3634_cov_34.913154	1517	1597	168	1	80	0.0125000
NODE_430_length_3634_cov_34.913154	1517	1597	171	1	80	0.0125000
NODE_430_length_3634_cov_34.913154	1517	1597	173	2	80	0.0250000
NODE_430_length_3634_cov_34.913154	1517	1597	175	1	80	0.0125000
NODE_430_length_3634_cov_34.913154	1517	1597	176	2	80	0.0250000
NODE_430_length_3634_cov_34.913154	1978	2058	43	2	80	0.0250000
NODE_430_length_3634_cov_34.913154	1978	2058	46	2	80	0.0250000
NODE_430_length_3634_cov_34.913154	1978	2058	47	6	80	0.0750000
NODE_430_length_3634_cov_34.913154	1978	2058	53	1	80	0.0125000
NODE_430_length_3634_cov_34.913154	1978	2058	59	1	80	0.0125000
NODE_430_length_3634_cov_34.913154	1978	2058	63	1	80	0.0125000
NODE_430_length_3634_cov_34.913154	1978	2058	64	1	80	0.0125000
NODE_430_length_3634_cov_34.913154	1978	2058	66	1	80	0.0125000
NODE_430_length_3634_cov_34.913154	1978	2058	71	3	80	0.0375000
NODE_430_length_3634_cov_34.913154	1978	2058	73	3	80	0.0375000
NODE_430_length_3634_cov_34.913154	1978	2058	74	1	80	0.0125000
NODE_430_length_3634_cov_34.913154	1978	2058	75	1	80	0.0125000
NODE_430_length_3634_cov_34.913154	1978	2058	78	2	80	0.0250000
NODE_430_length_3634_cov_34.913154	1978	2058	79	1	80	0.0125000
NODE_430_length_3634_cov_34.913154	1978	2058	82	2	80	0.0250000
NODE_430_length_3634_cov_34.913154	1978	2058	83	1	80	0.0125000
NODE_430_length_3634_cov_34.913154	1978	2058	84	1	80	0.0125000
NODE_430_length_3634_cov_34.913154	1978	2058	87	1	80	0.0125000
NODE_430_length_3634_cov_34.913154	1978	2058	90	1	80	0.0125000
NODE_430_length_3634_cov_34.913154	1978	2058	92	2	80	0.0250000
NODE_430_length_3634_cov_34.913154	1978	2058	93	2	80	0.0250000
NODE_430_length_3634_cov_34.913154	1978	2058	95	1	80	0.0125000
NODE_430_length_3634_cov_34.913154	1978	2058	97	1	80	0.0125000
NODE_430_length_3634_cov_34.913154	1978	2058	103	4	80	0.0500000
NODE_430_length_3634_cov_34.913154	1978	2058	110	1	80	0.0125000
NODE_430_length_3634_cov_34.913154	1978	2058	111	1	80	0.0125000
NODE_430_length_3634_cov_34.913154	1978	2058	113	2	80	0.0250000
NODE_430_length_3634_cov_34.913154	1978	2058	114	1	80	0.0125000
NODE_430_length_3634_cov_34.913154	1978	2058	115	1	80	0.0125000
NODE_430_length_3634_cov_34.913154	1978	2058	116	1	80	0.0125000
NODE_430_length_3634_cov_34.913154	1978	2058	117	1	80	0.0125000
NODE_430_length_3634_cov_34.913154	1978	2058	119	2	80	0.0250000
NODE_430_length_3634_cov_34.913154	1978	2058	120	1	80	0.0125000
NODE_430_length_3634_cov_34.913154	1978	2058	121	1	80	0.0125000
NODE_430_length_3634_cov_34.913154	1978	2058	123	1	80	0.0125000
NODE_430_length_3634_cov_34.913154	1978	2058	124	2	80	0.0250000
NODE_430_length_3634_cov_34.913154	1978	2058	126	1	80	0.0125000
NODE_430_length_3634_cov_34.913154	1978	2058	127	1	80	0.0125000
NODE_430_length_3634_cov_34.913154	1978	2058	129	2	80	0.0250000
NODE_430_length_3634_cov_34.913154	1978	2058	130	4	80	0.0500000
NODE_430_length_3634_cov_34.913154	1978	2058	132	1	80	0.0125000
NODE_430_length_3634_cov_34.913154	1978	2058	134	3	80	0.0375000
NODE_430_length_3634_cov_34.913154	1978	2058	135	1	80	0.0125000
NODE_430_length_3634_cov_34.913154	1978	2058	138	1	80	0.0125000
NODE_430_length_3634_cov_34.913154	1978	2058	141	1	80	0.0125000
NODE_430_length_3634_cov_34.913154	1978	2058	143	1	80	0.0125000
NODE_430_length_3634_cov_34.913154	1978	2058	147	1	80	0.0125000
NODE_430_length_3634_cov_34.913154	1978	2058	149	2	80	0.0250000
NODE_430_length_3634_cov_34.913154	1978	2058	150	4	80	0.0500000
NODE_430_length_3634_cov_34.913154	2031	2077	24	1	46	0.0217391
NODE_430_length_3634_cov_34.913154	2031	2077	26	4	46	0.0869565
NODE_430_length_3634_cov_34.913154	2031	2077	28	2	46	0.0434783
NODE_430_length_3634_cov_34.913154	2031	2077	32	2	46	0.0434783
NODE_430_length_3634_cov_34.913154	2031	2077	33	1	46	0.0217391
NODE_430_length_3634_cov_34.913154	2031	2077	35	2	46	0.0434783
NODE_430_length_3634_cov_34.913154	2031	2077	37	2	46	0.0434783
NODE_430_length_3634_cov_34.913154	2031	2077	40	2	46	0.0434783
NODE_430_length_3634_cov_34.913154	2031	2077	41	1	46	0.0217391
NODE_430_length_3634_cov_34.913154	2031	2077	42	1	46	0.0217391
NODE_430_length_3634_cov_34.913154	2031	2077	43	3	46	0.0652174
NODE_430_length_3634_cov_34.913154	2031	2077	46	2	46	0.0434783
NODE_430_length_3634_cov_34.913154	2031	2077	47	6	46	0.1304348
NODE_430_length_3634_cov_34.913154	2031	2077	53	1	46	0.0217391
NODE_430_length_3634_cov_34.913154	2031	2077	59	1	46	0.0217391
NODE_430_length_3634_cov_34.913154	2031	2077	63	1	46	0.0217391
NODE_430_length_3634_cov_34.913154	2031	2077	64	1	46	0.0217391
NODE_430_length_3634_cov_34.913154	2031	2077	66	1	46	0.0217391
NODE_430_length_3634_cov_34.913154	2031	2077	71	3	46	0.0652174
NODE_430_length_3634_cov_34.913154	2031	2077	73	3	46	0.0652174
NODE_430_length_3634_cov_34.913154	2031	2077	74	1	46	0.0217391
NODE_430_length_3634_cov_34.913154	2031	2077	75	1	46	0.0217391
NODE_430_length_3634_cov_34.913154	2031	2077	78	2	46	0.0434783
NODE_430_length_3634_cov_34.913154	2031	2077	79	1	46	0.0217391
NODE_430_length_3634_cov_34.913154	2031	2077	82	1	46	0.0217391
NODE_435_length_3622_cov_29.112120	201	281	0	27	80	0.3375000
NODE_435_length_3622_cov_29.112120	201	281	1	53	80	0.6625000
NODE_435_length_3622_cov_29.112120	254	334	1	80	80	1.0000000
NODE_435_length_3622_cov_29.112120	2310	2390	18	5	80	0.0625000
NODE_435_length_3622_cov_29.112120	2310	2390	19	5	80	0.0625000
NODE_435_length_3622_cov_29.112120	2310	2390	20	1	80	0.0125000
NODE_435_length_3622_cov_29.112120	2310	2390	21	1	80	0.0125000
NODE_435_length_3622_cov_29.112120	2310	2390	22	2	80	0.0250000
NODE_435_length_3622_cov_29.112120	2310	2390	24	2	80	0.0250000
NODE_435_length_3622_cov_29.112120	2310	2390	26	1	80	0.0125000
NODE_435_length_3622_cov_29.112120	2310	2390	27	15	80	0.1875000
NODE_435_length_3622_cov_29.112120	2310	2390	29	3	80	0.0375000
NODE_435_length_3622_cov_29.112120	2310	2390	30	11	80	0.1375000
NODE_435_length_3622_cov_29.112120	2310	2390	31	5	80	0.0625000
NODE_435_length_3622_cov_29.112120	2310	2390	33	2	80	0.0250000
NODE_435_length_3622_cov_29.112120	2310	2390	35	13	80	0.1625000
NODE_435_length_3622_cov_29.112120	2310	2390	37	2	80	0.0250000
NODE_435_length_3622_cov_29.112120	2310	2390	38	4	80	0.0500000
NODE_435_length_3622_cov_29.112120	2310	2390	39	6	80	0.0750000
NODE_435_length_3622_cov_29.112120	2310	2390	40	2	80	0.0250000
NODE_435_length_3622_cov_29.112120	2363	2441	0	2	78	0.0256410
NODE_435_length_3622_cov_29.112120	2363	2441	4	7	78	0.0897436
NODE_435_length_3622_cov_29.112120	2363	2441	7	7	78	0.0897436
NODE_435_length_3622_cov_29.112120	2363	2441	10	9	78	0.1153846
NODE_435_length_3622_cov_29.112120	2363	2441	11	4	78	0.0512821
NODE_435_length_3622_cov_29.112120	2363	2441	12	4	78	0.0512821
NODE_435_length_3622_cov_29.112120	2363	2441	13	13	78	0.1666667
NODE_435_length_3622_cov_29.112120	2363	2441	17	4	78	0.0512821
NODE_435_length_3622_cov_29.112120	2363	2441	18	6	78	0.0769231
NODE_435_length_3622_cov_29.112120	2363	2441	19	5	78	0.0641026
NODE_435_length_3622_cov_29.112120	2363	2441	20	1	78	0.0128205
NODE_435_length_3622_cov_29.112120	2363	2441	21	1	78	0.0128205
NODE_435_length_3622_cov_29.112120	2363	2441	22	2	78	0.0256410
NODE_435_length_3622_cov_29.112120	2363	2441	24	2	78	0.0256410
NODE_435_length_3622_cov_29.112120	2363	2441	26	1	78	0.0128205
NODE_435_length_3622_cov_29.112120	2363	2441	27	10	78	0.1282051
NODE_437_length_3610_cov_8.785816	294	340	6	11	46	0.2391304
NODE_437_length_3610_cov_8.785816	294	340	7	35	46	0.7608696
NODE_437_length_3610_cov_8.785816	313	393	2	3	80	0.0375000
NODE_437_length_3610_cov_8.785816	313	393	4	10	80	0.1250000
NODE_437_length_3610_cov_8.785816	313	393	6	28	80	0.3500000
NODE_437_length_3610_cov_8.785816	313	393	7	39	80	0.4875000
NODE_444_length_3588_cov_16.296360	2421	2501	0	80	80	1.0000000
NODE_444_length_3588_cov_16.296360	2474	2539	0	65	65	1.0000000
NODE_447_length_3585_cov_2.283419	605	668	0	63	63	1.0000000
NODE_451_length_3567_cov_16.283160	410	429	2	18	19	0.9473684
NODE_451_length_3567_cov_16.283160	410	429	3	1	19	0.0526316
NODE_451_length_3567_cov_16.283160	2259	2339	21	1	80	0.0125000
NODE_451_length_3567_cov_16.283160	2259	2339	23	2	80	0.0250000
NODE_451_length_3567_cov_16.283160	2259	2339	25	1	80	0.0125000
NODE_451_length_3567_cov_16.283160	2259	2339	26	1	80	0.0125000
NODE_451_length_3567_cov_16.283160	2259	2339	27	6	80	0.0750000
NODE_451_length_3567_cov_16.283160	2259	2339	29	2	80	0.0250000
NODE_451_length_3567_cov_16.283160	2259	2339	30	2	80	0.0250000
NODE_451_length_3567_cov_16.283160	2259	2339	31	12	80	0.1500000
NODE_451_length_3567_cov_16.283160	2259	2339	32	15	80	0.1875000
NODE_451_length_3567_cov_16.283160	2259	2339	34	4	80	0.0500000
NODE_451_length_3567_cov_16.283160	2259	2339	37	8	80	0.1000000
NODE_451_length_3567_cov_16.283160	2259	2339	38	7	80	0.0875000
NODE_451_length_3567_cov_16.283160	2259	2339	39	5	80	0.0625000
NODE_451_length_3567_cov_16.283160	2259	2339	40	5	80	0.0625000
NODE_451_length_3567_cov_16.283160	2259	2339	41	4	80	0.0500000
NODE_451_length_3567_cov_16.283160	2259	2339	42	5	80	0.0625000
NODE_451_length_3567_cov_16.283160	2312	2379	0	2	67	0.0298507
NODE_451_length_3567_cov_16.283160	2312	2379	3	2	67	0.0298507
NODE_451_length_3567_cov_16.283160	2312	2379	4	1	67	0.0149254
NODE_451_length_3567_cov_16.283160	2312	2379	6	6	67	0.0895522
NODE_451_length_3567_cov_16.283160	2312	2379	9	2	67	0.0298507
NODE_451_length_3567_cov_16.283160	2312	2379	11	1	67	0.0149254
NODE_451_length_3567_cov_16.283160	2312	2379	12	5	67	0.0746269
NODE_451_length_3567_cov_16.283160	2312	2379	13	2	67	0.0298507
NODE_451_length_3567_cov_16.283160	2312	2379	15	2	67	0.0298507
NODE_451_length_3567_cov_16.283160	2312	2379	16	2	67	0.0298507
NODE_451_length_3567_cov_16.283160	2312	2379	17	2	67	0.0298507
NODE_451_length_3567_cov_16.283160	2312	2379	18	6	67	0.0895522
NODE_451_length_3567_cov_16.283160	2312	2379	19	1	67	0.0149254
NODE_451_length_3567_cov_16.283160	2312	2379	21	7	67	0.1044776
NODE_451_length_3567_cov_16.283160	2312	2379	23	2	67	0.0298507
NODE_451_length_3567_cov_16.283160	2312	2379	25	1	67	0.0149254
NODE_451_length_3567_cov_16.283160	2312	2379	26	1	67	0.0149254
NODE_451_length_3567_cov_16.283160	2312	2379	27	6	67	0.0895522
NODE_451_length_3567_cov_16.283160	2312	2379	29	2	67	0.0298507
NODE_451_length_3567_cov_16.283160	2312	2379	30	2	67	0.0298507
NODE_451_length_3567_cov_16.283160	2312	2379	31	12	67	0.1791045
NODE_454_length_3557_cov_12.423077	640	718	0	78	78	1.0000000
NODE_454_length_3557_cov_12.423077	640	688	0	48	48	1.0000000
NODE_454_length_3557_cov_12.423077	640	688	0	48	48	1.0000000
NODE_454_length_3557_cov_12.423077	640	688	0	48	48	1.0000000
NODE_454_length_3557_cov_12.423077	640	688	0	48	48	1.0000000
NODE_454_length_3557_cov_12.423077	693	771	0	78	78	1.0000000
NODE_455_length_3548_cov_7.216295	554	634	2	22	80	0.2750000
NODE_455_length_3548_cov_7.216295	554	634	3	40	80	0.5000000
NODE_455_length_3548_cov_7.216295	554	634	4	2	80	0.0250000
NODE_455_length_3548_cov_7.216295	554	634	5	16	80	0.2000000
NODE_455_length_3548_cov_7.216295	607	687	3	14	80	0.1750000
NODE_455_length_3548_cov_7.216295	607	687	4	33	80	0.4125000
NODE_455_length_3548_cov_7.216295	607	687	5	33	80	0.4125000
NODE_461_length_3518_cov_40.508336	1320	1400	10	28	80	0.3500000
NODE_461_length_3518_cov_40.508336	1320	1400	11	10	80	0.1250000
NODE_461_length_3518_cov_40.508336	1320	1400	13	4	80	0.0500000
NODE_461_length_3518_cov_40.508336	1320	1400	14	3	80	0.0375000
NODE_461_length_3518_cov_40.508336	1320	1400	15	5	80	0.0625000
NODE_461_length_3518_cov_40.508336	1320	1400	16	10	80	0.1250000
NODE_461_length_3518_cov_40.508336	1320	1400	17	1	80	0.0125000
NODE_461_length_3518_cov_40.508336	1320	1400	18	16	80	0.2000000
NODE_461_length_3518_cov_40.508336	1320	1400	19	3	80	0.0375000
NODE_461_length_3518_cov_40.508336	1373	1453	15	5	80	0.0625000
NODE_461_length_3518_cov_40.508336	1373	1453	16	19	80	0.2375000
NODE_461_length_3518_cov_40.508336	1373	1453	17	2	80	0.0250000
NODE_461_length_3518_cov_40.508336	1373	1453	18	37	80	0.4625000
NODE_461_length_3518_cov_40.508336	1373	1453	19	6	80	0.0750000
NODE_461_length_3518_cov_40.508336	1373	1453	20	6	80	0.0750000
NODE_461_length_3518_cov_40.508336	1373	1453	21	5	80	0.0625000
NODE_465_length_3497_cov_65.791348	3062	3142	87	1	80	0.0125000
NODE_465_length_3497_cov_65.791348	3062	3142	89	2	80	0.0250000
NODE_465_length_3497_cov_65.791348	3062	3142	90	2	80	0.0250000
NODE_465_length_3497_cov_65.791348	3062	3142	91	2	80	0.0250000
NODE_465_length_3497_cov_65.791348	3062	3142	92	4	80	0.0500000
NODE_465_length_3497_cov_65.791348	3062	3142	93	5	80	0.0625000
NODE_465_length_3497_cov_65.791348	3062	3142	94	7	80	0.0875000
NODE_465_length_3497_cov_65.791348	3062	3142	95	7	80	0.0875000
NODE_465_length_3497_cov_65.791348	3062	3142	96	7	80	0.0875000
NODE_465_length_3497_cov_65.791348	3062	3142	97	8	80	0.1000000
NODE_465_length_3497_cov_65.791348	3062	3142	98	8	80	0.1000000
NODE_465_length_3497_cov_65.791348	3062	3142	99	10	80	0.1250000
NODE_465_length_3497_cov_65.791348	3062	3142	100	7	80	0.0875000
NODE_465_length_3497_cov_65.791348	3062	3142	101	2	80	0.0250000
NODE_465_length_3497_cov_65.791348	3062	3142	102	2	80	0.0250000
NODE_465_length_3497_cov_65.791348	3062	3142	103	1	80	0.0125000
NODE_465_length_3497_cov_65.791348	3062	3142	104	5	80	0.0625000
NODE_466_length_3488_cov_2.243730	506	529	0	23	23	1.0000000
NODE_470_length_3483_cov_14.759456	360	440	1	80	80	1.0000000
NODE_470_length_3483_cov_14.759456	413	493	0	11	80	0.1375000
NODE_470_length_3483_cov_14.759456	413	493	1	69	80	0.8625000
NODE_474_length_3471_cov_37.887604	2795	2875	2	23	80	0.2875000
NODE_474_length_3471_cov_37.887604	2795	2875	3	4	80	0.0500000
NODE_474_length_3471_cov_37.887604	2795	2875	4	53	80	0.6625000
NODE_474_length_3471_cov_37.887604	2848	2928	4	50	80	0.6250000
NODE_474_length_3471_cov_37.887604	2848	2928	5	30	80	0.3750000
NODE_474_length_3471_cov_37.887604	2924	2943	2	1	19	0.0526316
NODE_474_length_3471_cov_37.887604	2924	2943	4	11	19	0.5789474
NODE_474_length_3471_cov_37.887604	2924	2943	5	7	19	0.3684210
NODE_474_length_3471_cov_37.887604	2924	3004	1	32	80	0.4000000
NODE_474_length_3471_cov_37.887604	2924	3004	2	30	80	0.3750000
NODE_474_length_3471_cov_37.887604	2924	3004	4	11	80	0.1375000
NODE_474_length_3471_cov_37.887604	2924	3004	5	7	80	0.0875000
NODE_474_length_3471_cov_37.887604	2977	3057	0	9	80	0.1125000
NODE_474_length_3471_cov_37.887604	2977	3057	1	71	80	0.8875000
NODE_479_length_3451_cov_29.833234	2973	3053	4	4	80	0.0500000
NODE_479_length_3451_cov_29.833234	2973	3053	5	19	80	0.2375000
NODE_479_length_3451_cov_29.833234	2973	3053	6	57	80	0.7125000
NODE_479_length_3451_cov_29.833234	3026	3106	1	3	80	0.0375000
NODE_479_length_3451_cov_29.833234	3026	3106	3	23	80	0.2875000
NODE_479_length_3451_cov_29.833234	3026	3106	4	31	80	0.3875000
NODE_479_length_3451_cov_29.833234	3026	3106	5	19	80	0.2375000
NODE_479_length_3451_cov_29.833234	3026	3106	6	4	80	0.0500000
NODE_481_length_3446_cov_32.421273	3181	3261	1	80	80	1.0000000
NODE_482_length_3444_cov_29.954858	792	872	12	3	80	0.0375000
NODE_482_length_3444_cov_29.954858	792	872	13	6	80	0.0750000
NODE_482_length_3444_cov_29.954858	792	872	14	13	80	0.1625000
NODE_482_length_3444_cov_29.954858	792	872	15	16	80	0.2000000
NODE_482_length_3444_cov_29.954858	792	872	16	10	80	0.1250000
NODE_482_length_3444_cov_29.954858	792	872	17	6	80	0.0750000
NODE_482_length_3444_cov_29.954858	792	872	18	4	80	0.0500000
NODE_482_length_3444_cov_29.954858	792	872	19	6	80	0.0750000
NODE_482_length_3444_cov_29.954858	792	872	20	5	80	0.0625000
NODE_482_length_3444_cov_29.954858	792	872	21	10	80	0.1250000
NODE_482_length_3444_cov_29.954858	792	872	22	1	80	0.0125000
NODE_482_length_3444_cov_29.954858	845	925	17	1	80	0.0125000
NODE_482_length_3444_cov_29.954858	845	925	18	5	80	0.0625000
NODE_482_length_3444_cov_29.954858	845	925	19	27	80	0.3375000
NODE_482_length_3444_cov_29.954858	845	925	20	34	80	0.4250000
NODE_482_length_3444_cov_29.954858	845	925	21	12	80	0.1500000
NODE_482_length_3444_cov_29.954858	845	925	22	1	80	0.0125000
NODE_483_length_3442_cov_17.799880	3155	3220	3	1	65	0.0153846
NODE_483_length_3442_cov_17.799880	3155	3220	14	1	65	0.0153846
NODE_483_length_3442_cov_17.799880	3155	3220	16	3	65	0.0461538
NODE_483_length_3442_cov_17.799880	3155	3220	17	9	65	0.1384615
NODE_483_length_3442_cov_17.799880	3155	3220	18	8	65	0.1230769
NODE_483_length_3442_cov_17.799880	3155	3220	20	2	65	0.0307692
NODE_483_length_3442_cov_17.799880	3155	3220	21	5	65	0.0769231
NODE_483_length_3442_cov_17.799880	3155	3220	22	2	65	0.0307692
NODE_483_length_3442_cov_17.799880	3155	3220	24	2	65	0.0307692
NODE_483_length_3442_cov_17.799880	3155	3220	27	4	65	0.0615385
NODE_483_length_3442_cov_17.799880	3155	3220	28	3	65	0.0461538
NODE_483_length_3442_cov_17.799880	3155	3220	30	2	65	0.0307692
NODE_483_length_3442_cov_17.799880	3155	3220	31	2	65	0.0307692
NODE_483_length_3442_cov_17.799880	3155	3220	33	5	65	0.0769231
NODE_483_length_3442_cov_17.799880	3155	3220	35	5	65	0.0769231
NODE_483_length_3442_cov_17.799880	3155	3220	36	2	65	0.0307692
NODE_483_length_3442_cov_17.799880	3155	3220	39	2	65	0.0307692
NODE_483_length_3442_cov_17.799880	3155	3220	41	1	65	0.0153846
NODE_483_length_3442_cov_17.799880	3155	3220	44	1	65	0.0153846
NODE_483_length_3442_cov_17.799880	3155	3220	45	3	65	0.0461538
NODE_483_length_3442_cov_17.799880	3155	3220	46	1	65	0.0153846
NODE_483_length_3442_cov_17.799880	3155	3220	49	1	65	0.0153846
NODE_483_length_3442_cov_17.799880	3208	3273	35	1	65	0.0153846
NODE_483_length_3442_cov_17.799880	3208	3273	36	2	65	0.0307692
NODE_483_length_3442_cov_17.799880	3208	3273	39	2	65	0.0307692
NODE_483_length_3442_cov_17.799880	3208	3273	41	1	65	0.0153846
NODE_483_length_3442_cov_17.799880	3208	3273	44	1	65	0.0153846
NODE_483_length_3442_cov_17.799880	3208	3273	45	3	65	0.0461538
NODE_483_length_3442_cov_17.799880	3208	3273	46	1	65	0.0153846
NODE_483_length_3442_cov_17.799880	3208	3273	49	3	65	0.0461538
NODE_483_length_3442_cov_17.799880	3208	3273	51	1	65	0.0153846
NODE_483_length_3442_cov_17.799880	3208	3273	52	1	65	0.0153846
NODE_483_length_3442_cov_17.799880	3208	3273	54	1	65	0.0153846
NODE_483_length_3442_cov_17.799880	3208	3273	58	4	65	0.0615385
NODE_483_length_3442_cov_17.799880	3208	3273	61	1	65	0.0153846
NODE_483_length_3442_cov_17.799880	3208	3273	62	1	65	0.0153846
NODE_483_length_3442_cov_17.799880	3208	3273	65	2	65	0.0307692
NODE_483_length_3442_cov_17.799880	3208	3273	71	2	65	0.0307692
NODE_483_length_3442_cov_17.799880	3208	3273	72	1	65	0.0153846
NODE_483_length_3442_cov_17.799880	3208	3273	73	1	65	0.0153846
NODE_483_length_3442_cov_17.799880	3208	3273	75	1	65	0.0153846
NODE_483_length_3442_cov_17.799880	3208	3273	76	1	65	0.0153846
NODE_483_length_3442_cov_17.799880	3208	3273	77	2	65	0.0307692
NODE_483_length_3442_cov_17.799880	3208	3273	80	1	65	0.0153846
NODE_483_length_3442_cov_17.799880	3208	3273	81	1	65	0.0153846
NODE_483_length_3442_cov_17.799880	3208	3273	82	2	65	0.0307692
NODE_483_length_3442_cov_17.799880	3208	3273	83	3	65	0.0461538
NODE_483_length_3442_cov_17.799880	3208	3273	84	2	65	0.0307692
NODE_483_length_3442_cov_17.799880	3208	3273	87	1	65	0.0153846
NODE_483_length_3442_cov_17.799880	3208	3273	93	4	65	0.0615385
NODE_483_length_3442_cov_17.799880	3208	3273	96	1	65	0.0153846
NODE_483_length_3442_cov_17.799880	3208	3273	97	2	65	0.0307692
NODE_483_length_3442_cov_17.799880	3208	3273	99	1	65	0.0153846
NODE_483_length_3442_cov_17.799880	3208	3273	101	1	65	0.0153846
NODE_483_length_3442_cov_17.799880	3208	3273	104	1	65	0.0153846
NODE_483_length_3442_cov_17.799880	3208	3273	105	3	65	0.0461538
NODE_483_length_3442_cov_17.799880	3208	3273	106	2	65	0.0307692
NODE_483_length_3442_cov_17.799880	3208	3273	107	1	65	0.0153846
NODE_483_length_3442_cov_17.799880	3208	3273	110	1	65	0.0153846
NODE_483_length_3442_cov_17.799880	3208	3273	113	5	65	0.0769231
NODE_486_length_3429_cov_5.070270	125	148	15	17	23	0.7391304
NODE_486_length_3429_cov_5.070270	125	148	17	6	23	0.2608696
NODE_493_length_3408_cov_2.406769	0	45	0	45	45	1.0000000
NODE_495_length_3405_cov_44.930127	2683	2759	3	1	76	0.0131579
NODE_495_length_3405_cov_44.930127	2683	2759	4	75	76	0.9868421
NODE_495_length_3405_cov_44.930127	3116	3164	3	35	48	0.7291667
NODE_495_length_3405_cov_44.930127	3116	3164	4	13	48	0.2708333
NODE_496_length_3402_cov_28.961550	128	183	0	55	55	1.0000000
NODE_496_length_3402_cov_28.961550	3154	3234	23	11	80	0.1375000
NODE_496_length_3402_cov_28.961550	3154	3234	24	3	80	0.0375000
NODE_496_length_3402_cov_28.961550	3154	3234	25	4	80	0.0500000
NODE_496_length_3402_cov_28.961550	3154	3234	26	5	80	0.0625000
NODE_496_length_3402_cov_28.961550	3154	3234	27	9	80	0.1125000
NODE_496_length_3402_cov_28.961550	3154	3234	28	7	80	0.0875000
NODE_496_length_3402_cov_28.961550	3154	3234	29	15	80	0.1875000
NODE_496_length_3402_cov_28.961550	3154	3234	30	1	80	0.0125000
NODE_496_length_3402_cov_28.961550	3154	3234	31	25	80	0.3125000
NODE_496_length_3402_cov_28.961550	3207	3287	3	1	80	0.0125000
NODE_496_length_3402_cov_28.961550	3207	3287	5	1	80	0.0125000
NODE_496_length_3402_cov_28.961550	3207	3287	11	1	80	0.0125000
NODE_496_length_3402_cov_28.961550	3207	3287	12	1	80	0.0125000
NODE_496_length_3402_cov_28.961550	3207	3287	13	1	80	0.0125000
NODE_496_length_3402_cov_28.961550	3207	3287	15	8	80	0.1000000
NODE_496_length_3402_cov_28.961550	3207	3287	16	5	80	0.0625000
NODE_496_length_3402_cov_28.961550	3207	3287	17	2	80	0.0250000
NODE_496_length_3402_cov_28.961550	3207	3287	19	3	80	0.0375000
NODE_496_length_3402_cov_28.961550	3207	3287	20	17	80	0.2125000
NODE_496_length_3402_cov_28.961550	3207	3287	21	8	80	0.1000000
NODE_496_length_3402_cov_28.961550	3207	3287	23	1	80	0.0125000
NODE_496_length_3402_cov_28.961550	3207	3287	24	7	80	0.0875000
NODE_496_length_3402_cov_28.961550	3207	3287	25	1	80	0.0125000
NODE_496_length_3402_cov_28.961550	3207	3287	26	5	80	0.0625000
NODE_496_length_3402_cov_28.961550	3207	3287	27	6	80	0.0750000
NODE_496_length_3402_cov_28.961550	3207	3287	28	5	80	0.0625000
NODE_496_length_3402_cov_28.961550	3207	3287	30	1	80	0.0125000
NODE_496_length_3402_cov_28.961550	3207	3287	31	6	80	0.0750000
NODE_498_length_3393_cov_43.623558	1009	1075	19	8	66	0.1212121
NODE_498_length_3393_cov_43.623558	1009	1075	21	2	66	0.0303030
NODE_498_length_3393_cov_43.623558	1009	1075	22	1	66	0.0151515
NODE_498_length_3393_cov_43.623558	1009	1075	23	2	66	0.0303030
NODE_498_length_3393_cov_43.623558	1009	1075	25	3	66	0.0454545
NODE_498_length_3393_cov_43.623558	1009	1075	27	7	66	0.1060606
NODE_498_length_3393_cov_43.623558	1009	1075	28	14	66	0.2121212
NODE_498_length_3393_cov_43.623558	1009	1075	30	1	66	0.0151515
NODE_498_length_3393_cov_43.623558	1009	1075	31	28	66	0.4242424
NODE_498_length_3393_cov_43.623558	1048	1128	6	9	80	0.1125000
NODE_498_length_3393_cov_43.623558	1048	1128	9	5	80	0.0625000
NODE_498_length_3393_cov_43.623558	1048	1128	10	13	80	0.1625000
NODE_498_length_3393_cov_43.623558	1048	1128	13	4	80	0.0500000
NODE_498_length_3393_cov_43.623558	1048	1128	15	1	80	0.0125000
NODE_498_length_3393_cov_43.623558	1048	1128	16	1	80	0.0125000
NODE_498_length_3393_cov_43.623558	1048	1128	17	2	80	0.0250000
NODE_498_length_3393_cov_43.623558	1048	1128	18	11	80	0.1375000
NODE_498_length_3393_cov_43.623558	1048	1128	19	13	80	0.1625000
NODE_498_length_3393_cov_43.623558	1048	1128	20	2	80	0.0250000
NODE_498_length_3393_cov_43.623558	1048	1128	21	2	80	0.0250000
NODE_498_length_3393_cov_43.623558	1048	1128	22	1	80	0.0125000
NODE_498_length_3393_cov_43.623558	1048	1128	23	2	80	0.0250000
NODE_498_length_3393_cov_43.623558	1048	1128	25	3	80	0.0375000
NODE_498_length_3393_cov_43.623558	1048	1128	27	7	80	0.0875000
NODE_498_length_3393_cov_43.623558	1048	1128	28	4	80	0.0500000
NODE_498_length_3393_cov_43.623558	3086	3128	12	1	42	0.0238095
NODE_498_length_3393_cov_43.623558	3086	3128	22	2	42	0.0476190
NODE_498_length_3393_cov_43.623558	3086	3128	25	1	42	0.0238095
NODE_498_length_3393_cov_43.623558	3086	3128	29	1	42	0.0238095
NODE_498_length_3393_cov_43.623558	3086	3128	32	1	42	0.0238095
NODE_498_length_3393_cov_43.623558	3086	3128	34	1	42	0.0238095
NODE_498_length_3393_cov_43.623558	3086	3128	37	1	42	0.0238095
NODE_498_length_3393_cov_43.623558	3086	3128	39	7	42	0.1666667
NODE_498_length_3393_cov_43.623558	3086	3128	41	1	42	0.0238095
NODE_498_length_3393_cov_43.623558	3086	3128	43	3	42	0.0714286
NODE_498_length_3393_cov_43.623558	3086	3128	44	1	42	0.0238095
NODE_498_length_3393_cov_43.623558	3086	3128	48	4	42	0.0952381
NODE_498_length_3393_cov_43.623558	3086	3128	50	1	42	0.0238095
NODE_498_length_3393_cov_43.623558	3086	3128	51	1	42	0.0238095
NODE_498_length_3393_cov_43.623558	3086	3128	55	3	42	0.0714286
NODE_498_length_3393_cov_43.623558	3086	3128	56	1	42	0.0238095
NODE_498_length_3393_cov_43.623558	3086	3128	58	2	42	0.0476190
NODE_498_length_3393_cov_43.623558	3086	3128	59	3	42	0.0714286
NODE_498_length_3393_cov_43.623558	3086	3128	60	2	42	0.0476190
NODE_498_length_3393_cov_43.623558	3086	3128	61	1	42	0.0238095
NODE_498_length_3393_cov_43.623558	3086	3128	62	2	42	0.0476190
NODE_498_length_3393_cov_43.623558	3086	3128	65	1	42	0.0238095
NODE_498_length_3393_cov_43.623558	3086	3128	66	1	42	0.0238095
NODE_498_length_3393_cov_43.623558	3293	3373	23	3	80	0.0375000
NODE_498_length_3393_cov_43.623558	3293	3373	25	2	80	0.0250000
NODE_498_length_3393_cov_43.623558	3293	3373	27	1	80	0.0125000
NODE_498_length_3393_cov_43.623558	3293	3373	29	4	80	0.0500000
NODE_498_length_3393_cov_43.623558	3293	3373	31	1	80	0.0125000
NODE_498_length_3393_cov_43.623558	3293	3373	33	1	80	0.0125000
NODE_498_length_3393_cov_43.623558	3293	3373	35	1	80	0.0125000
NODE_498_length_3393_cov_43.623558	3293	3373	36	1	80	0.0125000
NODE_498_length_3393_cov_43.623558	3293	3373	39	1	80	0.0125000
NODE_498_length_3393_cov_43.623558	3293	3373	40	1	80	0.0125000
NODE_498_length_3393_cov_43.623558	3293	3373	45	2	80	0.0250000
NODE_498_length_3393_cov_43.623558	3293	3373	46	2	80	0.0250000
NODE_498_length_3393_cov_43.623558	3293	3373	53	1	80	0.0125000
NODE_498_length_3393_cov_43.623558	3293	3373	55	2	80	0.0250000
NODE_498_length_3393_cov_43.623558	3293	3373	61	1	80	0.0125000
NODE_498_length_3393_cov_43.623558	3293	3373	62	1	80	0.0125000
NODE_498_length_3393_cov_43.623558	3293	3373	69	1	80	0.0125000
NODE_498_length_3393_cov_43.623558	3293	3373	70	2	80	0.0250000
NODE_498_length_3393_cov_43.623558	3293	3373	72	1	80	0.0125000
NODE_498_length_3393_cov_43.623558	3293	3373	74	3	80	0.0375000
NODE_498_length_3393_cov_43.623558	3293	3373	75	1	80	0.0125000
NODE_498_length_3393_cov_43.623558	3293	3373	77	1	80	0.0125000
NODE_498_length_3393_cov_43.623558	3293	3373	78	1	80	0.0125000
NODE_498_length_3393_cov_43.623558	3293	3373	82	1	80	0.0125000
NODE_498_length_3393_cov_43.623558	3293	3373	83	2	80	0.0250000
NODE_498_length_3393_cov_43.623558	3293	3373	87	1	80	0.0125000
NODE_498_length_3393_cov_43.623558	3293	3373	92	3	80	0.0375000
NODE_498_length_3393_cov_43.623558	3293	3373	93	4	80	0.0500000
NODE_498_length_3393_cov_43.623558	3293	3373	99	2	80	0.0250000
NODE_498_length_3393_cov_43.623558	3293	3373	100	2	80	0.0250000
NODE_498_length_3393_cov_43.623558	3293	3373	101	1	80	0.0125000
NODE_498_length_3393_cov_43.623558	3293	3373	102	1	80	0.0125000
NODE_498_length_3393_cov_43.623558	3293	3373	105	4	80	0.0500000
NODE_498_length_3393_cov_43.623558	3293	3373	106	2	80	0.0250000
NODE_498_length_3393_cov_43.623558	3293	3373	111	1	80	0.0125000
NODE_498_length_3393_cov_43.623558	3293	3373	115	2	80	0.0250000
NODE_498_length_3393_cov_43.623558	3293	3373	117	1	80	0.0125000
NODE_498_length_3393_cov_43.623558	3293	3373	119	1	80	0.0125000
NODE_498_length_3393_cov_43.623558	3293	3373	122	2	80	0.0250000
NODE_498_length_3393_cov_43.623558	3293	3373	124	1	80	0.0125000
NODE_498_length_3393_cov_43.623558	3293	3373	125	1	80	0.0125000
NODE_498_length_3393_cov_43.623558	3293	3373	127	1	80	0.0125000
NODE_498_length_3393_cov_43.623558	3293	3373	131	1	80	0.0125000
NODE_498_length_3393_cov_43.623558	3293	3373	134	1	80	0.0125000
NODE_498_length_3393_cov_43.623558	3293	3373	136	1	80	0.0125000
NODE_498_length_3393_cov_43.623558	3293	3373	138	1	80	0.0125000
NODE_498_length_3393_cov_43.623558	3293	3373	140	2	80	0.0250000
NODE_498_length_3393_cov_43.623558	3293	3373	142	2	80	0.0250000
NODE_498_length_3393_cov_43.623558	3293	3373	143	2	80	0.0250000
NODE_498_length_3393_cov_43.623558	3293	3373	145	2	80	0.0250000
NODE_499_length_3392_cov_41.514728	255	335	0	80	80	1.0000000
NODE_499_length_3392_cov_41.514728	308	388	0	80	80	1.0000000
NODE_499_length_3392_cov_41.514728	917	997	74	1	80	0.0125000
NODE_499_length_3392_cov_41.514728	917	997	76	1	80	0.0125000
NODE_499_length_3392_cov_41.514728	917	997	78	1	80	0.0125000
NODE_499_length_3392_cov_41.514728	917	997	79	1	80	0.0125000
NODE_499_length_3392_cov_41.514728	917	997	80	6	80	0.0750000
NODE_499_length_3392_cov_41.514728	917	997	81	5	80	0.0625000
NODE_499_length_3392_cov_41.514728	917	997	82	2	80	0.0250000
NODE_499_length_3392_cov_41.514728	917	997	84	1	80	0.0125000
NODE_499_length_3392_cov_41.514728	917	997	86	6	80	0.0750000
NODE_499_length_3392_cov_41.514728	917	997	88	5	80	0.0625000
NODE_499_length_3392_cov_41.514728	917	997	89	1	80	0.0125000
NODE_499_length_3392_cov_41.514728	917	997	90	2	80	0.0250000
NODE_499_length_3392_cov_41.514728	917	997	91	4	80	0.0500000
NODE_499_length_3392_cov_41.514728	917	997	92	2	80	0.0250000
NODE_499_length_3392_cov_41.514728	917	997	94	2	80	0.0250000
NODE_499_length_3392_cov_41.514728	917	997	95	9	80	0.1125000
NODE_499_length_3392_cov_41.514728	917	997	96	5	80	0.0625000
NODE_499_length_3392_cov_41.514728	917	997	97	1	80	0.0125000
NODE_499_length_3392_cov_41.514728	917	997	102	3	80	0.0375000
NODE_499_length_3392_cov_41.514728	917	997	103	9	80	0.1125000
NODE_499_length_3392_cov_41.514728	917	997	104	3	80	0.0375000
NODE_499_length_3392_cov_41.514728	917	997	105	4	80	0.0500000
NODE_499_length_3392_cov_41.514728	917	997	106	2	80	0.0250000
NODE_499_length_3392_cov_41.514728	917	997	107	4	80	0.0500000
NODE_499_length_3392_cov_41.514728	970	1053	49	2	83	0.0240964
NODE_499_length_3392_cov_41.514728	970	1053	50	3	83	0.0361446
NODE_499_length_3392_cov_41.514728	970	1053	52	5	83	0.0602410
NODE_499_length_3392_cov_41.514728	970	1053	53	2	83	0.0240964
NODE_499_length_3392_cov_41.514728	970	1053	54	4	83	0.0481928
NODE_499_length_3392_cov_41.514728	970	1053	55	4	83	0.0481928
NODE_499_length_3392_cov_41.514728	970	1053	56	11	83	0.1325301
NODE_499_length_3392_cov_41.514728	970	1053	57	5	83	0.0602410
NODE_499_length_3392_cov_41.514728	970	1053	58	6	83	0.0722892
NODE_499_length_3392_cov_41.514728	970	1053	60	1	83	0.0120482
NODE_499_length_3392_cov_41.514728	970	1053	61	1	83	0.0120482
NODE_499_length_3392_cov_41.514728	970	1053	62	4	83	0.0481928
NODE_499_length_3392_cov_41.514728	970	1053	63	6	83	0.0722892
NODE_499_length_3392_cov_41.514728	970	1053	71	2	83	0.0240964
NODE_499_length_3392_cov_41.514728	970	1053	74	1	83	0.0120482
NODE_499_length_3392_cov_41.514728	970	1053	76	1	83	0.0120482
NODE_499_length_3392_cov_41.514728	970	1053	78	1	83	0.0120482
NODE_499_length_3392_cov_41.514728	970	1053	79	1	83	0.0120482
NODE_499_length_3392_cov_41.514728	970	1053	80	6	83	0.0722892
NODE_499_length_3392_cov_41.514728	970	1053	81	5	83	0.0602410
NODE_499_length_3392_cov_41.514728	970	1053	82	2	83	0.0240964
NODE_499_length_3392_cov_41.514728	970	1053	86	5	83	0.0602410
NODE_499_length_3392_cov_41.514728	970	1053	88	5	83	0.0602410
NODE_501_length_3389_cov_8.244073	2159	2239	1	1	80	0.0125000
NODE_501_length_3389_cov_8.244073	2159	2239	2	2	80	0.0250000
NODE_501_length_3389_cov_8.244073	2159	2239	3	21	80	0.2625000
NODE_501_length_3389_cov_8.244073	2159	2239	4	28	80	0.3500000
NODE_501_length_3389_cov_8.244073	2159	2239	5	28	80	0.3500000
NODE_501_length_3389_cov_8.244073	2212	2292	4	6	80	0.0750000
NODE_501_length_3389_cov_8.244073	2212	2292	5	74	80	0.9250000
NODE_506_length_3363_cov_4.412684	56	124	2	3	68	0.0441176
NODE_506_length_3363_cov_4.412684	56	124	4	1	68	0.0147059
NODE_506_length_3363_cov_4.412684	56	124	6	6	68	0.0882353
NODE_506_length_3363_cov_4.412684	56	124	8	58	68	0.8529412
NODE_510_length_3353_cov_2.687462	0	61	0	61	61	1.0000000
NODE_510_length_3353_cov_2.687462	0	61	0	61	61	1.0000000
NODE_510_length_3353_cov_2.687462	34	99	0	65	65	1.0000000
NODE_513_length_3348_cov_243.959372	2473	2553	95	4	80	0.0500000
NODE_513_length_3348_cov_243.959372	2473	2553	96	3	80	0.0375000
NODE_513_length_3348_cov_243.959372	2473	2553	97	1	80	0.0125000
NODE_513_length_3348_cov_243.959372	2473	2553	98	17	80	0.2125000
NODE_513_length_3348_cov_243.959372	2473	2553	99	3	80	0.0375000
NODE_513_length_3348_cov_243.959372	2473	2553	100	7	80	0.0875000
NODE_513_length_3348_cov_243.959372	2473	2553	101	2	80	0.0250000
NODE_513_length_3348_cov_243.959372	2473	2553	102	2	80	0.0250000
NODE_513_length_3348_cov_243.959372	2473	2553	103	2	80	0.0250000
NODE_513_length_3348_cov_243.959372	2473	2553	104	3	80	0.0375000
NODE_513_length_3348_cov_243.959372	2473	2553	105	6	80	0.0750000
NODE_513_length_3348_cov_243.959372	2473	2553	106	6	80	0.0750000
NODE_513_length_3348_cov_243.959372	2473	2553	107	5	80	0.0625000
NODE_513_length_3348_cov_243.959372	2473	2553	108	11	80	0.1375000
NODE_513_length_3348_cov_243.959372	2473	2553	109	2	80	0.0250000
NODE_513_length_3348_cov_243.959372	2473	2553	110	5	80	0.0625000
NODE_513_length_3348_cov_243.959372	2473	2553	112	1	80	0.0125000
NODE_513_length_3348_cov_243.959372	2526	2606	95	1	80	0.0125000
NODE_513_length_3348_cov_243.959372	2526	2606	97	1	80	0.0125000
NODE_513_length_3348_cov_243.959372	2526	2606	98	5	80	0.0625000
NODE_513_length_3348_cov_243.959372	2526	2606	100	1	80	0.0125000
NODE_513_length_3348_cov_243.959372	2526	2606	101	1	80	0.0125000
NODE_513_length_3348_cov_243.959372	2526	2606	102	2	80	0.0250000
NODE_513_length_3348_cov_243.959372	2526	2606	103	2	80	0.0250000
NODE_513_length_3348_cov_243.959372	2526	2606	104	2	80	0.0250000
NODE_513_length_3348_cov_243.959372	2526	2606	105	5	80	0.0625000
NODE_513_length_3348_cov_243.959372	2526	2606	106	5	80	0.0625000
NODE_513_length_3348_cov_243.959372	2526	2606	107	6	80	0.0750000
NODE_513_length_3348_cov_243.959372	2526	2606	108	9	80	0.1125000
NODE_513_length_3348_cov_243.959372	2526	2606	109	4	80	0.0500000
NODE_513_length_3348_cov_243.959372	2526	2606	110	12	80	0.1500000
NODE_513_length_3348_cov_243.959372	2526	2606	111	4	80	0.0500000
NODE_513_length_3348_cov_243.959372	2526	2606	112	7	80	0.0875000
NODE_513_length_3348_cov_243.959372	2526	2606	113	4	80	0.0500000
NODE_513_length_3348_cov_243.959372	2526	2606	114	1	80	0.0125000
NODE_513_length_3348_cov_243.959372	2526	2606	115	4	80	0.0500000
NODE_513_length_3348_cov_243.959372	2526	2606	116	4	80	0.0500000
NODE_514_length_3348_cov_31.953216	103	183	2	50	80	0.6250000
NODE_514_length_3348_cov_31.953216	103	183	3	5	80	0.0625000
NODE_514_length_3348_cov_31.953216	103	183	4	25	80	0.3125000
NODE_514_length_3348_cov_31.953216	105	179	2	48	74	0.6486486
NODE_514_length_3348_cov_31.953216	105	179	3	1	74	0.0135135
NODE_514_length_3348_cov_31.953216	105	179	4	25	74	0.3378378
NODE_514_length_3348_cov_31.953216	156	236	2	5	80	0.0625000
NODE_514_length_3348_cov_31.953216	156	236	3	52	80	0.6500000
NODE_514_length_3348_cov_31.953216	156	236	4	23	80	0.2875000
NODE_514_length_3348_cov_31.953216	156	236	2	5	80	0.0625000
NODE_514_length_3348_cov_31.953216	156	236	3	52	80	0.6500000
NODE_514_length_3348_cov_31.953216	156	236	4	23	80	0.2875000
NODE_514_length_3348_cov_31.953216	2405	2476	13	2	71	0.0281690
NODE_514_length_3348_cov_31.953216	2405	2476	14	10	71	0.1408451
NODE_514_length_3348_cov_31.953216	2405	2476	15	1	71	0.0140845
NODE_514_length_3348_cov_31.953216	2405	2476	16	9	71	0.1267606
NODE_514_length_3348_cov_31.953216	2405	2476	17	3	71	0.0422535
NODE_514_length_3348_cov_31.953216	2405	2476	18	1	71	0.0140845
NODE_514_length_3348_cov_31.953216	2405	2476	19	6	71	0.0845070
NODE_514_length_3348_cov_31.953216	2405	2476	20	2	71	0.0281690
NODE_514_length_3348_cov_31.953216	2405	2476	21	12	71	0.1690141
NODE_514_length_3348_cov_31.953216	2405	2476	22	8	71	0.1126761
NODE_514_length_3348_cov_31.953216	2405	2476	23	11	71	0.1549296
NODE_514_length_3348_cov_31.953216	2405	2476	24	6	71	0.0845070
NODE_514_length_3348_cov_31.953216	2458	2529	21	9	71	0.1267606
NODE_514_length_3348_cov_31.953216	2458	2529	23	10	71	0.1408451
NODE_514_length_3348_cov_31.953216	2458	2529	24	7	71	0.0985916
NODE_514_length_3348_cov_31.953216	2458	2529	26	8	71	0.1126761
NODE_514_length_3348_cov_31.953216	2458	2529	27	18	71	0.2535211
NODE_514_length_3348_cov_31.953216	2458	2529	28	16	71	0.2253521
NODE_514_length_3348_cov_31.953216	2458	2529	29	3	71	0.0422535
NODE_517_length_3335_cov_19.649567	2100	2180	16	6	80	0.0750000
NODE_517_length_3335_cov_19.649567	2100	2180	17	4	80	0.0500000
NODE_517_length_3335_cov_19.649567	2100	2180	18	2	80	0.0250000
NODE_517_length_3335_cov_19.649567	2100	2180	21	15	80	0.1875000
NODE_517_length_3335_cov_19.649567	2100	2180	22	2	80	0.0250000
NODE_517_length_3335_cov_19.649567	2100	2180	23	36	80	0.4500000
NODE_517_length_3335_cov_19.649567	2100	2180	24	7	80	0.0875000
NODE_517_length_3335_cov_19.649567	2100	2180	25	8	80	0.1000000
NODE_517_length_3335_cov_19.649567	2153	2233	16	3	80	0.0375000
NODE_517_length_3335_cov_19.649567	2153	2233	17	18	80	0.2250000
NODE_517_length_3335_cov_19.649567	2153	2233	19	11	80	0.1375000
NODE_517_length_3335_cov_19.649567	2153	2233	20	12	80	0.1500000
NODE_517_length_3335_cov_19.649567	2153	2233	21	14	80	0.1750000
NODE_517_length_3335_cov_19.649567	2153	2233	22	5	80	0.0625000
NODE_517_length_3335_cov_19.649567	2153	2233	23	11	80	0.1375000
NODE_517_length_3335_cov_19.649567	2153	2233	24	6	80	0.0750000
NODE_517_length_3335_cov_19.649567	2229	2309	11	47	80	0.5875000
NODE_517_length_3335_cov_19.649567	2229	2309	12	2	80	0.0250000
NODE_517_length_3335_cov_19.649567	2229	2309	13	2	80	0.0250000
NODE_517_length_3335_cov_19.649567	2229	2309	15	2	80	0.0250000
NODE_517_length_3335_cov_19.649567	2229	2309	16	9	80	0.1125000
NODE_517_length_3335_cov_19.649567	2229	2309	17	8	80	0.1000000
NODE_517_length_3335_cov_19.649567	2229	2309	18	10	80	0.1250000
NODE_517_length_3335_cov_19.649567	2282	2362	5	20	80	0.2500000
NODE_517_length_3335_cov_19.649567	2282	2362	6	10	80	0.1250000
NODE_517_length_3335_cov_19.649567	2282	2362	8	5	80	0.0625000
NODE_517_length_3335_cov_19.649567	2282	2362	9	1	80	0.0125000
NODE_517_length_3335_cov_19.649567	2282	2362	10	2	80	0.0250000
NODE_517_length_3335_cov_19.649567	2282	2362	11	42	80	0.5250000
NODE_518_length_3333_cov_24.805504	734	814	6	13	80	0.1625000
NODE_518_length_3333_cov_24.805504	734	814	7	18	80	0.2250000
NODE_518_length_3333_cov_24.805504	734	814	10	25	80	0.3125000
NODE_518_length_3333_cov_24.805504	734	814	11	24	80	0.3000000
NODE_518_length_3333_cov_24.805504	787	867	6	7	80	0.0875000
NODE_518_length_3333_cov_24.805504	787	867	8	6	80	0.0750000
NODE_518_length_3333_cov_24.805504	787	867	9	17	80	0.2125000
NODE_518_length_3333_cov_24.805504	787	867	10	11	80	0.1375000
NODE_518_length_3333_cov_24.805504	787	867	11	39	80	0.4875000
NODE_523_length_3312_cov_6.996576	85	165	2	7	80	0.0875000
NODE_523_length_3312_cov_6.996576	85	165	3	15	80	0.1875000
NODE_523_length_3312_cov_6.996576	85	165	5	12	80	0.1500000
NODE_523_length_3312_cov_6.996576	85	165	6	19	80	0.2375000
NODE_523_length_3312_cov_6.996576	85	165	7	27	80	0.3375000
NODE_523_length_3312_cov_6.996576	138	218	3	17	80	0.2125000
NODE_523_length_3312_cov_6.996576	138	218	4	11	80	0.1375000
NODE_523_length_3312_cov_6.996576	138	218	6	19	80	0.2375000
NODE_523_length_3312_cov_6.996576	138	218	7	33	80	0.4125000
NODE_525_length_3302_cov_3.859195	3184	3262	0	78	78	1.0000000
NODE_525_length_3302_cov_3.859195	3184	3253	0	69	69	1.0000000
NODE_526_length_3299_cov_6.014687	1632	1688	0	56	56	1.0000000
NODE_530_length_3290_cov_17.805390	773	853	16	17	80	0.2125000
NODE_530_length_3290_cov_17.805390	773	853	17	28	80	0.3500000
NODE_530_length_3290_cov_17.805390	773	853	18	1	80	0.0125000
NODE_530_length_3290_cov_17.805390	773	853	19	4	80	0.0500000
NODE_530_length_3290_cov_17.805390	773	853	21	5	80	0.0625000
NODE_530_length_3290_cov_17.805390	773	853	22	1	80	0.0125000
NODE_530_length_3290_cov_17.805390	773	853	23	17	80	0.2125000
NODE_530_length_3290_cov_17.805390	773	853	24	5	80	0.0625000
NODE_530_length_3290_cov_17.805390	773	853	25	2	80	0.0250000
NODE_530_length_3290_cov_17.805390	826	906	11	1	80	0.0125000
NODE_530_length_3290_cov_17.805390	826	906	13	9	80	0.1125000
NODE_530_length_3290_cov_17.805390	826	906	15	7	80	0.0875000
NODE_530_length_3290_cov_17.805390	826	906	16	2	80	0.0250000
NODE_530_length_3290_cov_17.805390	826	906	17	1	80	0.0125000
NODE_530_length_3290_cov_17.805390	826	906	18	11	80	0.1375000
NODE_530_length_3290_cov_17.805390	826	906	19	3	80	0.0375000
NODE_530_length_3290_cov_17.805390	826	906	21	2	80	0.0250000
NODE_530_length_3290_cov_17.805390	826	906	22	2	80	0.0250000
NODE_530_length_3290_cov_17.805390	826	906	23	19	80	0.2375000
NODE_530_length_3290_cov_17.805390	826	906	24	21	80	0.2625000
NODE_530_length_3290_cov_17.805390	826	906	25	2	80	0.0250000
NODE_531_length_3290_cov_12.352554	2749	2829	2	22	80	0.2750000
NODE_531_length_3290_cov_12.352554	2749	2829	3	58	80	0.7250000
NODE_531_length_3290_cov_12.352554	2802	2882	1	13	80	0.1625000
NODE_531_length_3290_cov_12.352554	2802	2882	2	25	80	0.3125000
NODE_531_length_3290_cov_12.352554	2802	2882	3	42	80	0.5250000
NODE_532_length_3286_cov_5.973015	0	50	0	50	50	1.0000000
NODE_532_length_3286_cov_5.973015	0	50	0	50	50	1.0000000
NODE_532_length_3286_cov_5.973015	0	50	0	50	50	1.0000000
NODE_532_length_3286_cov_5.973015	23	89	0	66	66	1.0000000
NODE_532_length_3286_cov_5.973015	23	94	0	71	71	1.0000000
NODE_533_length_3284_cov_6.453689	313	392	1	22	79	0.2784810
NODE_533_length_3284_cov_6.453689	313	392	3	31	79	0.3924051
NODE_533_length_3284_cov_6.453689	313	392	5	9	79	0.1139240
NODE_533_length_3284_cov_6.453689	313	392	6	17	79	0.2151899
NODE_533_length_3284_cov_6.453689	365	445	3	1	80	0.0125000
NODE_533_length_3284_cov_6.453689	365	445	5	12	80	0.1500000
NODE_533_length_3284_cov_6.453689	365	445	6	67	80	0.8375000
NODE_541_length_3267_cov_12.768624	11	91	1	14	80	0.1750000
NODE_541_length_3267_cov_12.768624	11	91	2	2	80	0.0250000
NODE_541_length_3267_cov_12.768624	11	91	3	3	80	0.0375000
NODE_541_length_3267_cov_12.768624	11	91	5	6	80	0.0750000
NODE_541_length_3267_cov_12.768624	11	91	6	5	80	0.0625000
NODE_541_length_3267_cov_12.768624	11	91	7	4	80	0.0500000
NODE_541_length_3267_cov_12.768624	11	91	8	14	80	0.1750000
NODE_541_length_3267_cov_12.768624	11	91	9	32	80	0.4000000
NODE_542_length_3266_cov_14.108304	2620	2684	4	16	64	0.2500000
NODE_542_length_3266_cov_14.108304	2620	2684	5	7	64	0.1093750
NODE_542_length_3266_cov_14.108304	2620	2684	6	1	64	0.0156250
NODE_542_length_3266_cov_14.108304	2620	2684	7	40	64	0.6250000
NODE_542_length_3266_cov_14.108304	2620	2684	4	16	64	0.2500000
NODE_542_length_3266_cov_14.108304	2620	2684	5	7	64	0.1093750
NODE_542_length_3266_cov_14.108304	2620	2684	6	1	64	0.0156250
NODE_542_length_3266_cov_14.108304	2620	2684	7	40	64	0.6250000
NODE_542_length_3266_cov_14.108304	2620	2684	4	16	64	0.2500000
NODE_542_length_3266_cov_14.108304	2620	2684	5	7	64	0.1093750
NODE_542_length_3266_cov_14.108304	2620	2684	6	1	64	0.0156250
NODE_542_length_3266_cov_14.108304	2620	2684	7	40	64	0.6250000
NODE_547_length_3242_cov_12.407891	391	471	3	28	80	0.3500000
NODE_547_length_3242_cov_12.407891	391	471	4	8	80	0.1000000
NODE_547_length_3242_cov_12.407891	391	471	5	32	80	0.4000000
NODE_547_length_3242_cov_12.407891	391	471	7	12	80	0.1500000
NODE_547_length_3242_cov_12.407891	444	524	4	39	80	0.4875000
NODE_547_length_3242_cov_12.407891	444	524	5	15	80	0.1875000
NODE_547_length_3242_cov_12.407891	444	524	6	14	80	0.1750000
NODE_547_length_3242_cov_12.407891	444	524	7	12	80	0.1500000
NODE_550_length_3233_cov_19.903957	411	491	0	80	80	1.0000000
NODE_550_length_3233_cov_19.903957	411	491	0	80	80	1.0000000
NODE_550_length_3233_cov_19.903957	464	544	0	80	80	1.0000000
NODE_552_length_3232_cov_11.378870	2586	2621	0	35	35	1.0000000
NODE_555_length_3214_cov_22.853291	2090	2170	10	7	80	0.0875000
NODE_555_length_3214_cov_22.853291	2090	2170	11	24	80	0.3000000
NODE_555_length_3214_cov_22.853291	2090	2170	12	32	80	0.4000000
NODE_555_length_3214_cov_22.853291	2090	2170	13	6	80	0.0750000
NODE_555_length_3214_cov_22.853291	2090	2170	14	11	80	0.1375000
NODE_555_length_3214_cov_22.853291	2143	2223	9	16	80	0.2000000
NODE_555_length_3214_cov_22.853291	2143	2223	10	3	80	0.0375000
NODE_555_length_3214_cov_22.853291	2143	2223	11	21	80	0.2625000
NODE_555_length_3214_cov_22.853291	2143	2223	12	7	80	0.0875000
NODE_555_length_3214_cov_22.853291	2143	2223	13	22	80	0.2750000
NODE_555_length_3214_cov_22.853291	2143	2223	14	11	80	0.1375000
NODE_555_length_3214_cov_22.853291	3028	3086	7	15	58	0.2586207
NODE_555_length_3214_cov_22.853291	3028	3086	8	3	58	0.0517241
NODE_555_length_3214_cov_22.853291	3028	3086	9	18	58	0.3103448
NODE_555_length_3214_cov_22.853291	3028	3086	10	22	58	0.3793103
NODE_556_length_3211_cov_1.921915	95	175	2	80	80	1.0000000
NODE_556_length_3211_cov_1.921915	148	178	2	30	30	1.0000000
NODE_557_length_3210_cov_7.428480	2040	2111	2	1	71	0.0140845
NODE_557_length_3210_cov_7.428480	2040	2111	4	15	71	0.2112676
NODE_557_length_3210_cov_7.428480	2040	2111	6	36	71	0.5070422
NODE_557_length_3210_cov_7.428480	2040	2111	8	19	71	0.2676056
NODE_557_length_3210_cov_7.428480	2084	2164	2	4	80	0.0500000
NODE_557_length_3210_cov_7.428480	2084	2164	4	11	80	0.1375000
NODE_557_length_3210_cov_7.428480	2084	2164	6	19	80	0.2375000
NODE_557_length_3210_cov_7.428480	2084	2164	8	46	80	0.5750000
NODE_557_length_3210_cov_7.428480	2715	2797	0	7	82	0.0853659
NODE_557_length_3210_cov_7.428480	2715	2797	2	75	82	0.9146342
NODE_557_length_3210_cov_7.428480	2770	2850	0	59	80	0.7375000
NODE_557_length_3210_cov_7.428480	2770	2850	2	21	80	0.2625000
NODE_562_length_3201_cov_3.591231	3120	3200	0	80	80	1.0000000
NODE_566_length_3189_cov_69.446602	137	188	2	51	51	1.0000000
NODE_567_length_3188_cov_7.233085	1663	1743	9	8	80	0.1000000
NODE_567_length_3188_cov_7.233085	1663	1743	11	2	80	0.0250000
NODE_567_length_3188_cov_7.233085	1663	1743	14	19	80	0.2375000
NODE_567_length_3188_cov_7.233085	1663	1743	15	24	80	0.3000000
NODE_567_length_3188_cov_7.233085	1663	1743	16	14	80	0.1750000
NODE_567_length_3188_cov_7.233085	1663	1743	17	13	80	0.1625000
NODE_567_length_3188_cov_7.233085	1716	1796	10	7	80	0.0875000
NODE_567_length_3188_cov_7.233085	1716	1796	11	18	80	0.2250000
NODE_567_length_3188_cov_7.233085	1716	1796	13	18	80	0.2250000
NODE_567_length_3188_cov_7.233085	1716	1796	14	25	80	0.3125000
NODE_567_length_3188_cov_7.233085	1716	1796	15	4	80	0.0500000
NODE_567_length_3188_cov_7.233085	1716	1796	16	8	80	0.1000000
NODE_570_length_3177_cov_2.789474	2021	2042	0	4	21	0.1904762
NODE_570_length_3177_cov_2.789474	2021	2042	2	17	21	0.8095238
NODE_575_length_3158_cov_19.018960	840	920	4	8	80	0.1000000
NODE_575_length_3158_cov_19.018960	840	920	6	44	80	0.5500000
NODE_575_length_3158_cov_19.018960	840	920	8	28	80	0.3500000
NODE_575_length_3158_cov_19.018960	893	973	4	7	80	0.0875000
NODE_575_length_3158_cov_19.018960	893	973	5	4	80	0.0500000
NODE_575_length_3158_cov_19.018960	893	973	6	8	80	0.1000000
NODE_575_length_3158_cov_19.018960	893	973	8	61	80	0.7625000
NODE_575_length_3158_cov_19.018960	2833	2915	0	82	82	1.0000000
NODE_575_length_3158_cov_19.018960	2888	2959	0	71	71	1.0000000
NODE_576_length_3150_cov_26.520813	770	850	15	3	80	0.0375000
NODE_576_length_3150_cov_26.520813	770	850	17	8	80	0.1000000
NODE_576_length_3150_cov_26.520813	770	850	20	1	80	0.0125000
NODE_576_length_3150_cov_26.520813	770	850	21	4	80	0.0500000
NODE_576_length_3150_cov_26.520813	770	850	22	19	80	0.2375000
NODE_576_length_3150_cov_26.520813	770	850	23	9	80	0.1125000
NODE_576_length_3150_cov_26.520813	770	850	24	4	80	0.0500000
NODE_576_length_3150_cov_26.520813	770	850	25	32	80	0.4000000
NODE_576_length_3150_cov_26.520813	823	901	10	3	78	0.0384615
NODE_576_length_3150_cov_26.520813	823	901	13	18	78	0.2307692
NODE_576_length_3150_cov_26.520813	823	901	14	2	78	0.0256410
NODE_576_length_3150_cov_26.520813	823	901	15	1	78	0.0128205
NODE_576_length_3150_cov_26.520813	823	901	17	2	78	0.0256410
NODE_576_length_3150_cov_26.520813	823	901	18	2	78	0.0256410
NODE_576_length_3150_cov_26.520813	823	901	19	15	78	0.1923077
NODE_576_length_3150_cov_26.520813	823	901	21	2	78	0.0256410
NODE_576_length_3150_cov_26.520813	823	901	23	6	78	0.0769231
NODE_576_length_3150_cov_26.520813	823	901	24	3	78	0.0384615
NODE_576_length_3150_cov_26.520813	823	901	25	24	78	0.3076923
NODE_576_length_3150_cov_26.520813	2616	2696	1	61	80	0.7625000
NODE_576_length_3150_cov_26.520813	2616	2696	2	4	80	0.0500000
NODE_576_length_3150_cov_26.520813	2616	2696	3	10	80	0.1250000
NODE_576_length_3150_cov_26.520813	2616	2696	4	5	80	0.0625000
NODE_576_length_3150_cov_26.520813	2669	2749	1	11	80	0.1375000
NODE_576_length_3150_cov_26.520813	2669	2749	2	1	80	0.0125000
NODE_576_length_3150_cov_26.520813	2669	2749	3	10	80	0.1250000
NODE_576_length_3150_cov_26.520813	2669	2749	4	9	80	0.1125000
NODE_576_length_3150_cov_26.520813	2669	2749	5	49	80	0.6125000
NODE_577_length_3150_cov_5.923959	2313	2393	2	16	80	0.2000000
NODE_577_length_3150_cov_5.923959	2313	2393	3	5	80	0.0625000
NODE_577_length_3150_cov_5.923959	2313	2393	5	59	80	0.7375000
NODE_579_length_3148_cov_2.313873	3053	3105	0	52	52	1.0000000
NODE_581_length_3146_cov_18.277322	2418	2498	1	26	80	0.3250000
NODE_581_length_3146_cov_18.277322	2418	2498	3	54	80	0.6750000
NODE_581_length_3146_cov_18.277322	2471	2551	3	40	80	0.5000000
NODE_581_length_3146_cov_18.277322	2471	2551	4	2	80	0.0250000
NODE_581_length_3146_cov_18.277322	2471	2551	6	13	80	0.1625000
NODE_581_length_3146_cov_18.277322	2471	2551	7	9	80	0.1125000
NODE_581_length_3146_cov_18.277322	2471	2551	9	2	80	0.0250000
NODE_581_length_3146_cov_18.277322	2471	2551	11	10	80	0.1250000
NODE_581_length_3146_cov_18.277322	2471	2551	12	1	80	0.0125000
NODE_581_length_3146_cov_18.277322	2471	2551	14	3	80	0.0375000
NODE_581_length_3146_cov_18.277322	2547	2627	11	1	80	0.0125000
NODE_581_length_3146_cov_18.277322	2547	2627	14	8	80	0.1000000
NODE_581_length_3146_cov_18.277322	2547	2627	15	18	80	0.2250000
NODE_581_length_3146_cov_18.277322	2547	2627	16	20	80	0.2500000
NODE_581_length_3146_cov_18.277322	2547	2627	18	17	80	0.2125000
NODE_581_length_3146_cov_18.277322	2547	2627	19	7	80	0.0875000
NODE_581_length_3146_cov_18.277322	2547	2627	20	3	80	0.0375000
NODE_581_length_3146_cov_18.277322	2547	2627	21	5	80	0.0625000
NODE_581_length_3146_cov_18.277322	2547	2627	23	1	80	0.0125000
NODE_581_length_3146_cov_18.277322	2600	2680	18	11	80	0.1375000
NODE_581_length_3146_cov_18.277322	2600	2680	19	7	80	0.0875000
NODE_581_length_3146_cov_18.277322	2600	2680	20	3	80	0.0375000
NODE_581_length_3146_cov_18.277322	2600	2680	21	8	80	0.1000000
NODE_581_length_3146_cov_18.277322	2600	2680	23	5	80	0.0625000
NODE_581_length_3146_cov_18.277322	2600	2680	24	45	80	0.5625000
NODE_581_length_3146_cov_18.277322	2600	2680	25	1	80	0.0125000
NODE_581_length_3146_cov_18.277322	2975	3055	2	13	80	0.1625000
NODE_581_length_3146_cov_18.277322	2975	3055	4	4	80	0.0500000
NODE_581_length_3146_cov_18.277322	2975	3055	6	63	80	0.7875000
NODE_585_length_3134_cov_8.717957	1290	1362	7	12	72	0.1666667
NODE_585_length_3134_cov_8.717957	1290	1362	9	3	72	0.0416667
NODE_585_length_3134_cov_8.717957	1290	1362	10	16	72	0.2222222
NODE_585_length_3134_cov_8.717957	1290	1362	11	27	72	0.3750000
NODE_585_length_3134_cov_8.717957	1290	1362	12	14	72	0.1944444
NODE_585_length_3134_cov_8.717957	1335	1415	7	8	80	0.1000000
NODE_585_length_3134_cov_8.717957	1335	1415	8	13	80	0.1625000
NODE_585_length_3134_cov_8.717957	1335	1415	10	8	80	0.1000000
NODE_585_length_3134_cov_8.717957	1335	1415	11	27	80	0.3375000
NODE_585_length_3134_cov_8.717957	1335	1415	12	24	80	0.3000000
NODE_586_length_3131_cov_26.910620	232	312	9	24	80	0.3000000
NODE_586_length_3131_cov_26.910620	232	312	10	7	80	0.0875000
NODE_586_length_3131_cov_26.910620	232	312	11	49	80	0.6125000
NODE_586_length_3131_cov_26.910620	285	364	3	13	79	0.1645570
NODE_586_length_3131_cov_26.910620	285	364	5	2	79	0.0253165
NODE_586_length_3131_cov_26.910620	285	364	7	2	79	0.0253165
NODE_586_length_3131_cov_26.910620	285	364	8	22	79	0.2784810
NODE_586_length_3131_cov_26.910620	285	364	9	37	79	0.4683544
NODE_586_length_3131_cov_26.910620	285	364	10	3	79	0.0379747
NODE_586_length_3131_cov_26.910620	2151	2231	0	2	80	0.0250000
NODE_586_length_3131_cov_26.910620	2151	2231	2	78	80	0.9750000
NODE_586_length_3131_cov_26.910620	2155	2227	2	72	72	1.0000000
NODE_586_length_3131_cov_26.910620	2204	2284	0	10	80	0.1250000
NODE_586_length_3131_cov_26.910620	2204	2284	1	43	80	0.5375000
NODE_586_length_3131_cov_26.910620	2204	2284	2	27	80	0.3375000
NODE_586_length_3131_cov_26.910620	2208	2284	0	10	76	0.1315790
NODE_586_length_3131_cov_26.910620	2208	2284	1	43	76	0.5657895
NODE_586_length_3131_cov_26.910620	2208	2284	2	23	76	0.3026316
NODE_586_length_3131_cov_26.910620	2280	2360	0	56	80	0.7000000
NODE_586_length_3131_cov_26.910620	2280	2360	1	5	80	0.0625000
NODE_586_length_3131_cov_26.910620	2280	2360	2	6	80	0.0750000
NODE_586_length_3131_cov_26.910620	2280	2360	4	13	80	0.1625000
NODE_586_length_3131_cov_26.910620	2333	2413	0	3	80	0.0375000
NODE_586_length_3131_cov_26.910620	2333	2413	1	5	80	0.0625000
NODE_586_length_3131_cov_26.910620	2333	2413	2	6	80	0.0750000
NODE_586_length_3131_cov_26.910620	2333	2413	4	22	80	0.2750000
NODE_586_length_3131_cov_26.910620	2333	2413	6	44	80	0.5500000
NODE_590_length_3118_cov_5.059622	367	445	2	24	78	0.3076923
NODE_590_length_3118_cov_5.059622	367	445	3	3	78	0.0384615
NODE_590_length_3118_cov_5.059622	367	445	5	51	78	0.6538461
NODE_590_length_3118_cov_5.059622	418	498	1	6	80	0.0750000
NODE_590_length_3118_cov_5.059622	418	498	3	17	80	0.2125000
NODE_590_length_3118_cov_5.059622	418	498	4	3	80	0.0375000
NODE_590_length_3118_cov_5.059622	418	498	5	54	80	0.6750000
NODE_591_length_3117_cov_5.938038	2525	2605	0	29	80	0.3625000
NODE_591_length_3117_cov_5.938038	2525	2605	3	11	80	0.1375000
NODE_591_length_3117_cov_5.938038	2525	2605	4	40	80	0.5000000
NODE_591_length_3117_cov_5.938038	2578	2658	3	25	80	0.3125000
NODE_591_length_3117_cov_5.938038	2578	2658	4	55	80	0.6875000
NODE_595_length_3110_cov_31.733643	2864	2923	0	20	59	0.3389831
NODE_595_length_3110_cov_31.733643	2864	2923	2	39	59	0.6610169
NODE_602_length_3093_cov_54.559786	571	651	1	80	80	1.0000000
NODE_602_length_3093_cov_54.559786	624	704	0	5	80	0.0625000
NODE_602_length_3093_cov_54.559786	624	704	1	75	80	0.9375000
NODE_602_length_3093_cov_54.559786	2901	2981	9	2	80	0.0250000
NODE_602_length_3093_cov_54.559786	2901	2981	10	9	80	0.1125000
NODE_602_length_3093_cov_54.559786	2901	2981	12	2	80	0.0250000
NODE_602_length_3093_cov_54.559786	2901	2981	13	7	80	0.0875000
NODE_602_length_3093_cov_54.559786	2901	2981	14	10	80	0.1250000
NODE_602_length_3093_cov_54.559786	2901	2981	16	50	80	0.6250000
NODE_602_length_3093_cov_54.559786	2954	3034	6	7	80	0.0875000
NODE_602_length_3093_cov_54.559786	2954	3034	8	5	80	0.0625000
NODE_602_length_3093_cov_54.559786	2954	3034	9	7	80	0.0875000
NODE_602_length_3093_cov_54.559786	2954	3034	10	9	80	0.1125000
NODE_602_length_3093_cov_54.559786	2954	3034	12	16	80	0.2000000
NODE_602_length_3093_cov_54.559786	2954	3034	14	1	80	0.0125000
NODE_602_length_3093_cov_54.559786	2954	3034	16	35	80	0.4375000
NODE_603_length_3091_cov_35.895722	1743	1804	0	3	61	0.0491803
NODE_603_length_3091_cov_35.895722	1743	1804	2	17	61	0.2786885
NODE_603_length_3091_cov_35.895722	1743	1804	3	20	61	0.3278688
NODE_603_length_3091_cov_35.895722	1743	1804	4	10	61	0.1639344
NODE_603_length_3091_cov_35.895722	1743	1804	5	11	61	0.1803279
NODE_603_length_3091_cov_35.895722	1777	1857	3	6	80	0.0750000
NODE_603_length_3091_cov_35.895722	1777	1857	4	12	80	0.1500000
NODE_603_length_3091_cov_35.895722	1777	1857	5	62	80	0.7750000
NODE_603_length_3091_cov_35.895722	2472	2535	0	63	63	1.0000000
NODE_603_length_3091_cov_35.895722	2508	2553	0	45	45	1.0000000
NODE_603_length_3091_cov_35.895722	2534	2604	0	21	70	0.3000000
NODE_603_length_3091_cov_35.895722	2534	2604	2	49	70	0.7000000
NODE_603_length_3091_cov_35.895722	2578	2618	2	40	40	1.0000000
NODE_603_length_3091_cov_35.895722	2586	2623	2	37	37	1.0000000
NODE_603_length_3091_cov_35.895722	2626	2671	0	7	45	0.1555556
NODE_603_length_3091_cov_35.895722	2626	2671	2	38	45	0.8444445
NODE_603_length_3091_cov_35.895722	2682	2730	0	2	48	0.0416667
NODE_603_length_3091_cov_35.895722	2682	2730	2	46	48	0.9583333
NODE_603_length_3091_cov_35.895722	2918	2969	0	51	51	1.0000000
NODE_603_length_3091_cov_35.895722	2942	2987	0	45	45	1.0000000
NODE_603_length_3091_cov_35.895722	2994	3039	0	45	45	1.0000000
NODE_607_length_3079_cov_7.081879	2340	2420	2	9	80	0.1125000
NODE_607_length_3079_cov_7.081879	2340	2420	4	7	80	0.0875000
NODE_607_length_3079_cov_7.081879	2340	2420	5	30	80	0.3750000
NODE_607_length_3079_cov_7.081879	2340	2420	6	34	80	0.4250000
NODE_607_length_3079_cov_7.081879	2886	2938	4	2	52	0.0384615
NODE_607_length_3079_cov_7.081879	2886	2938	5	34	52	0.6538461
NODE_607_length_3079_cov_7.081879	2886	2938	6	16	52	0.3076923
NODE_607_length_3079_cov_7.081879	2893	2959	5	29	66	0.4393939
NODE_607_length_3079_cov_7.081879	2893	2959	6	27	66	0.4090909
NODE_607_length_3079_cov_7.081879	2893	2959	7	2	66	0.0303030
NODE_607_length_3079_cov_7.081879	2893	2959	8	8	66	0.1212121
NODE_607_length_3079_cov_7.081879	2932	2993	4	16	61	0.2622951
NODE_607_length_3079_cov_7.081879	2932	2993	6	31	61	0.5081967
NODE_607_length_3079_cov_7.081879	2932	2993	7	6	61	0.0983607
NODE_607_length_3079_cov_7.081879	2932	2993	8	8	61	0.1311475
NODE_607_length_3079_cov_7.081879	2932	2995	4	18	63	0.2857143
NODE_607_length_3079_cov_7.081879	2932	2995	6	31	63	0.4920635
NODE_607_length_3079_cov_7.081879	2932	2995	7	6	63	0.0952381
NODE_607_length_3079_cov_7.081879	2932	2995	8	8	63	0.1269841
NODE_607_length_3079_cov_7.081879	2932	2995	4	18	63	0.2857143
NODE_607_length_3079_cov_7.081879	2932	2995	6	31	63	0.4920635
NODE_607_length_3079_cov_7.081879	2932	2995	7	6	63	0.0952381
NODE_607_length_3079_cov_7.081879	2932	2995	8	8	63	0.1269841
NODE_608_length_3077_cov_23.535259	1244	1321	5	10	77	0.1298701
NODE_608_length_3077_cov_23.535259	1244	1321	7	67	77	0.8701299
NODE_608_length_3077_cov_23.535259	1911	1991	8	31	80	0.3875000
NODE_608_length_3077_cov_23.535259	1911	1991	9	25	80	0.3125000
NODE_608_length_3077_cov_23.535259	1911	1991	10	13	80	0.1625000
NODE_608_length_3077_cov_23.535259	1911	1991	11	3	80	0.0375000
NODE_608_length_3077_cov_23.535259	1911	1991	12	8	80	0.1000000
NODE_608_length_3077_cov_23.535259	1964	2016	8	3	52	0.0576923
NODE_608_length_3077_cov_23.535259	1964	2016	9	11	52	0.2115385
NODE_608_length_3077_cov_23.535259	1964	2016	10	18	52	0.3461539
NODE_608_length_3077_cov_23.535259	1964	2016	11	3	52	0.0576923
NODE_608_length_3077_cov_23.535259	1964	2016	12	12	52	0.2307692
NODE_608_length_3077_cov_23.535259	1964	2016	13	5	52	0.0961538
NODE_608_length_3077_cov_23.535259	2028	2114	9	16	86	0.1860465
NODE_608_length_3077_cov_23.535259	2028	2114	10	23	86	0.2674419
NODE_608_length_3077_cov_23.535259	2028	2114	12	12	86	0.1395349
NODE_608_length_3077_cov_23.535259	2028	2114	13	7	86	0.0813954
NODE_608_length_3077_cov_23.535259	2028	2114	14	3	86	0.0348837
NODE_608_length_3077_cov_23.535259	2028	2114	15	14	86	0.1627907
NODE_608_length_3077_cov_23.535259	2028	2114	16	11	86	0.1279070
NODE_609_length_3077_cov_8.693083	1157	1237	0	58	80	0.7250000
NODE_609_length_3077_cov_8.693083	1157	1237	1	1	80	0.0125000
NODE_609_length_3077_cov_8.693083	1157	1237	2	1	80	0.0125000
NODE_609_length_3077_cov_8.693083	1157	1237	3	16	80	0.2000000
NODE_609_length_3077_cov_8.693083	1157	1237	5	4	80	0.0500000
NODE_609_length_3077_cov_8.693083	1161	1184	0	23	23	1.0000000
NODE_609_length_3077_cov_8.693083	1233	1313	5	16	80	0.2000000
NODE_609_length_3077_cov_8.693083	1233	1313	8	9	80	0.1125000
NODE_609_length_3077_cov_8.693083	1233	1313	9	39	80	0.4875000
NODE_609_length_3077_cov_8.693083	1233	1313	10	5	80	0.0625000
NODE_609_length_3077_cov_8.693083	1233	1313	11	11	80	0.1375000
NODE_609_length_3077_cov_8.693083	1286	1352	9	11	66	0.1666667
NODE_609_length_3077_cov_8.693083	1286	1352	10	13	66	0.1969697
NODE_609_length_3077_cov_8.693083	1286	1352	11	16	66	0.2424242
NODE_609_length_3077_cov_8.693083	1286	1352	12	6	66	0.0909091
NODE_609_length_3077_cov_8.693083	1286	1352	13	4	66	0.0606061
NODE_609_length_3077_cov_8.693083	1286	1352	14	15	66	0.2272727
NODE_609_length_3077_cov_8.693083	1286	1352	15	1	66	0.0151515
NODE_609_length_3077_cov_8.693083	2672	2757	3	27	85	0.3176471
NODE_609_length_3077_cov_8.693083	2672	2757	5	21	85	0.2470588
NODE_609_length_3077_cov_8.693083	2672	2757	6	37	85	0.4352941
NODE_611_length_3074_cov_2.996303	2561	2629	3	14	68	0.2058824
NODE_611_length_3074_cov_2.996303	2561	2629	4	2	68	0.0294118
NODE_611_length_3074_cov_2.996303	2561	2629	5	1	68	0.0147059
NODE_611_length_3074_cov_2.996303	2561	2629	7	3	68	0.0441176
NODE_611_length_3074_cov_2.996303	2561	2629	10	1	68	0.0147059
NODE_611_length_3074_cov_2.996303	2561	2629	13	10	68	0.1470588
NODE_611_length_3074_cov_2.996303	2561	2629	14	10	68	0.1470588
NODE_611_length_3074_cov_2.996303	2561	2629	16	3	68	0.0441176
NODE_611_length_3074_cov_2.996303	2561	2629	17	4	68	0.0588235
NODE_611_length_3074_cov_2.996303	2561	2629	19	1	68	0.0147059
NODE_611_length_3074_cov_2.996303	2561	2629	20	6	68	0.0882353
NODE_611_length_3074_cov_2.996303	2561	2629	22	1	68	0.0147059
NODE_611_length_3074_cov_2.996303	2561	2629	24	3	68	0.0441176
NODE_611_length_3074_cov_2.996303	2561	2629	26	4	68	0.0588235
NODE_611_length_3074_cov_2.996303	2561	2629	27	5	68	0.0735294
NODE_615_length_3069_cov_2.448822	2948	2991	0	43	43	1.0000000
NODE_616_length_3059_cov_20.037500	346	426	13	2	80	0.0250000
NODE_616_length_3059_cov_20.037500	346	426	14	3	80	0.0375000
NODE_616_length_3059_cov_20.037500	346	426	15	7	80	0.0875000
NODE_616_length_3059_cov_20.037500	346	426	17	3	80	0.0375000
NODE_616_length_3059_cov_20.037500	346	426	18	10	80	0.1250000
NODE_616_length_3059_cov_20.037500	346	426	19	9	80	0.1125000
NODE_616_length_3059_cov_20.037500	346	426	20	34	80	0.4250000
NODE_616_length_3059_cov_20.037500	346	426	21	12	80	0.1500000
NODE_616_length_3059_cov_20.037500	399	479	17	13	80	0.1625000
NODE_616_length_3059_cov_20.037500	399	479	18	6	80	0.0750000
NODE_616_length_3059_cov_20.037500	399	479	19	17	80	0.2125000
NODE_616_length_3059_cov_20.037500	399	479	20	21	80	0.2625000
NODE_616_length_3059_cov_20.037500	399	479	21	15	80	0.1875000
NODE_616_length_3059_cov_20.037500	399	479	22	8	80	0.1000000
NODE_616_length_3059_cov_20.037500	1317	1397	4	23	80	0.2875000
NODE_616_length_3059_cov_20.037500	1317	1397	5	24	80	0.3000000
NODE_616_length_3059_cov_20.037500	1317	1397	6	33	80	0.4125000
NODE_616_length_3059_cov_20.037500	1370	1447	4	20	77	0.2597403
NODE_616_length_3059_cov_20.037500	1370	1447	5	53	77	0.6883117
NODE_616_length_3059_cov_20.037500	1370	1447	6	4	77	0.0519481
NODE_616_length_3059_cov_20.037500	2514	2594	0	80	80	1.0000000
NODE_616_length_3059_cov_20.037500	2567	2647	0	80	80	1.0000000
NODE_617_length_3058_cov_21.767489	2802	2882	0	77	80	0.9625000
NODE_617_length_3058_cov_21.767489	2802	2882	1	1	80	0.0125000
NODE_617_length_3058_cov_21.767489	2802	2882	5	2	80	0.0250000
NODE_617_length_3058_cov_21.767489	2855	2930	0	75	75	1.0000000
NODE_621_length_3047_cov_47.232361	418	489	0	71	71	1.0000000
NODE_621_length_3047_cov_47.232361	758	801	4	1	43	0.0232558
NODE_621_length_3047_cov_47.232361	758	801	5	7	43	0.1627907
NODE_621_length_3047_cov_47.232361	758	801	7	1	43	0.0232558
NODE_621_length_3047_cov_47.232361	758	801	9	18	43	0.4186046
NODE_621_length_3047_cov_47.232361	758	801	10	2	43	0.0465116
NODE_621_length_3047_cov_47.232361	758	801	11	9	43	0.2093023
NODE_621_length_3047_cov_47.232361	758	801	13	5	43	0.1162791
NODE_623_length_3044_cov_38.951783	1702	1782	0	80	80	1.0000000
NODE_623_length_3044_cov_38.951783	1755	1835	0	57	80	0.7125000
NODE_623_length_3044_cov_38.951783	1755	1835	2	23	80	0.2875000
NODE_623_length_3044_cov_38.951783	1831	1911	2	80	80	1.0000000
NODE_623_length_3044_cov_38.951783	1884	1964	0	12	80	0.1500000
NODE_623_length_3044_cov_38.951783	1884	1964	2	68	80	0.8500000
NODE_623_length_3044_cov_38.951783	2556	2636	1	68	80	0.8500000
NODE_623_length_3044_cov_38.951783	2556	2636	2	12	80	0.1500000
NODE_623_length_3044_cov_38.951783	2609	2689	1	34	80	0.4250000
NODE_623_length_3044_cov_38.951783	2609	2689	2	46	80	0.5750000
NODE_625_length_3039_cov_3.258163	261	337	0	76	76	1.0000000
NODE_625_length_3039_cov_3.258163	261	336	0	75	75	1.0000000
NODE_625_length_3039_cov_3.258163	261	337	0	76	76	1.0000000
NODE_625_length_3039_cov_3.258163	270	337	0	67	67	1.0000000
NODE_627_length_3036_cov_8.968676	2303	2367	11	3	64	0.0468750
NODE_627_length_3036_cov_8.968676	2303	2367	12	23	64	0.3593750
NODE_627_length_3036_cov_8.968676	2303	2367	13	29	64	0.4531250
NODE_627_length_3036_cov_8.968676	2303	2367	14	9	64	0.1406250
NODE_627_length_3036_cov_8.968676	2340	2420	8	3	80	0.0375000
NODE_627_length_3036_cov_8.968676	2340	2420	9	7	80	0.0875000
NODE_627_length_3036_cov_8.968676	2340	2420	10	9	80	0.1125000
NODE_627_length_3036_cov_8.968676	2340	2420	11	27	80	0.3375000
NODE_627_length_3036_cov_8.968676	2340	2420	12	24	80	0.3000000
NODE_627_length_3036_cov_8.968676	2340	2420	13	10	80	0.1250000
NODE_627_length_3036_cov_8.968676	2416	2496	3	12	80	0.1500000
NODE_627_length_3036_cov_8.968676	2416	2496	4	22	80	0.2750000
NODE_627_length_3036_cov_8.968676	2416	2496	5	7	80	0.0875000
NODE_627_length_3036_cov_8.968676	2416	2496	6	23	80	0.2875000
NODE_627_length_3036_cov_8.968676	2416	2496	7	1	80	0.0125000
NODE_627_length_3036_cov_8.968676	2416	2496	9	15	80	0.1875000
NODE_627_length_3036_cov_8.968676	2469	2549	3	42	80	0.5250000
NODE_627_length_3036_cov_8.968676	2469	2549	4	14	80	0.1750000
NODE_627_length_3036_cov_8.968676	2469	2549	5	24	80	0.3000000
NODE_629_length_3032_cov_7.470849	1026	1068	6	1	42	0.0238095
NODE_629_length_3032_cov_7.470849	1026	1068	7	24	42	0.5714286
NODE_629_length_3032_cov_7.470849	1026	1068	8	17	42	0.4047619
NODE_630_length_3025_cov_11.862611	2371	2451	7	25	80	0.3125000
NODE_630_length_3025_cov_11.862611	2371	2451	9	34	80	0.4250000
NODE_630_length_3025_cov_11.862611	2371	2451	10	18	80	0.2250000
NODE_630_length_3025_cov_11.862611	2371	2451	11	3	80	0.0375000
NODE_630_length_3025_cov_11.862611	2424	2504	6	8	80	0.1000000
NODE_630_length_3025_cov_11.862611	2424	2504	7	51	80	0.6375000
NODE_630_length_3025_cov_11.862611	2424	2504	8	3	80	0.0375000
NODE_630_length_3025_cov_11.862611	2424	2504	9	7	80	0.0875000
NODE_630_length_3025_cov_11.862611	2424	2504	10	6	80	0.0750000
NODE_630_length_3025_cov_11.862611	2424	2504	11	5	80	0.0625000
NODE_630_length_3025_cov_11.862611	2500	2580	6	9	80	0.1125000
NODE_630_length_3025_cov_11.862611	2500	2580	8	3	80	0.0375000
NODE_630_length_3025_cov_11.862611	2500	2580	9	32	80	0.4000000
NODE_630_length_3025_cov_11.862611	2500	2580	11	23	80	0.2875000
NODE_630_length_3025_cov_11.862611	2500	2580	12	1	80	0.0125000
NODE_630_length_3025_cov_11.862611	2500	2580	13	12	80	0.1500000
NODE_630_length_3025_cov_11.862611	2553	2633	10	3	80	0.0375000
NODE_630_length_3025_cov_11.862611	2553	2633	11	19	80	0.2375000
NODE_630_length_3025_cov_11.862611	2553	2633	12	3	80	0.0375000
NODE_630_length_3025_cov_11.862611	2553	2633	13	22	80	0.2750000
NODE_630_length_3025_cov_11.862611	2553	2633	14	9	80	0.1125000
NODE_630_length_3025_cov_11.862611	2553	2633	15	24	80	0.3000000
NODE_635_length_3012_cov_33.100240	2379	2459	13	4	80	0.0500000
NODE_635_length_3012_cov_33.100240	2379	2459	14	10	80	0.1250000
NODE_635_length_3012_cov_33.100240	2379	2459	16	42	80	0.5250000
NODE_635_length_3012_cov_33.100240	2379	2459	17	7	80	0.0875000
NODE_635_length_3012_cov_33.100240	2379	2459	18	17	80	0.2125000
NODE_635_length_3012_cov_33.100240	2432	2512	10	13	80	0.1625000
NODE_635_length_3012_cov_33.100240	2432	2512	11	12	80	0.1500000
NODE_635_length_3012_cov_33.100240	2432	2512	12	6	80	0.0750000
NODE_635_length_3012_cov_33.100240	2432	2512	13	3	80	0.0375000
NODE_635_length_3012_cov_33.100240	2432	2512	14	14	80	0.1750000
NODE_635_length_3012_cov_33.100240	2432	2512	15	5	80	0.0625000
NODE_635_length_3012_cov_33.100240	2432	2512	16	21	80	0.2625000
NODE_635_length_3012_cov_33.100240	2432	2512	17	5	80	0.0625000
NODE_635_length_3012_cov_33.100240	2432	2512	18	1	80	0.0125000
NODE_637_length_3007_cov_11.843535	2641	2721	0	66	80	0.8250000
NODE_637_length_3007_cov_11.843535	2641	2721	2	13	80	0.1625000
NODE_637_length_3007_cov_11.843535	2641	2721	3	1	80	0.0125000
NODE_643_length_2992_cov_2.636709	2032	2112	0	74	80	0.9250000
NODE_643_length_2992_cov_2.636709	2032	2112	2	4	80	0.0500000
NODE_643_length_2992_cov_2.636709	2032	2112	6	2	80	0.0250000
NODE_643_length_2992_cov_2.636709	2085	2165	0	34	80	0.4250000
NODE_643_length_2992_cov_2.636709	2085	2165	1	46	80	0.5750000
NODE_646_length_2978_cov_4.883293	382	452	4	70	70	1.0000000
NODE_646_length_2978_cov_4.883293	1858	1938	0	80	80	1.0000000
NODE_646_length_2978_cov_4.883293	1926	1991	0	65	65	1.0000000
NODE_646_length_2978_cov_4.883293	1987	2066	0	79	79	1.0000000
NODE_646_length_2978_cov_4.883293	2040	2079	0	39	39	1.0000000
NODE_647_length_2976_cov_24.683003	1764	1844	0	80	80	1.0000000
NODE_647_length_2976_cov_24.683003	1817	1897	0	80	80	1.0000000
NODE_647_length_2976_cov_24.683003	1893	1973	0	53	80	0.6625000
NODE_647_length_2976_cov_24.683003	1893	1973	1	21	80	0.2625000
NODE_647_length_2976_cov_24.683003	1893	1973	2	6	80	0.0750000
NODE_647_length_2976_cov_24.683003	1946	2026	1	21	80	0.2625000
NODE_647_length_2976_cov_24.683003	1946	2026	2	59	80	0.7375000
NODE_651_length_2967_cov_16.146095	238	318	0	13	80	0.1625000
NODE_651_length_2967_cov_16.146095	238	318	2	67	80	0.8375000
NODE_651_length_2967_cov_16.146095	291	371	0	46	80	0.5750000
NODE_651_length_2967_cov_16.146095	291	371	1	20	80	0.2500000
NODE_651_length_2967_cov_16.146095	291	371	2	14	80	0.1750000
NODE_651_length_2967_cov_16.146095	367	447	1	14	80	0.1750000
NODE_651_length_2967_cov_16.146095	367	447	2	13	80	0.1625000
NODE_651_length_2967_cov_16.146095	367	447	4	5	80	0.0625000
NODE_651_length_2967_cov_16.146095	367	447	6	10	80	0.1250000
NODE_651_length_2967_cov_16.146095	367	447	8	38	80	0.4750000
NODE_651_length_2967_cov_16.146095	420	500	8	39	80	0.4875000
NODE_651_length_2967_cov_16.146095	420	500	9	13	80	0.1625000
NODE_651_length_2967_cov_16.146095	420	500	10	28	80	0.3500000
NODE_653_length_2965_cov_19.913468	92	134	0	3	42	0.0714286
NODE_653_length_2965_cov_19.913468	92	134	2	3	42	0.0714286
NODE_653_length_2965_cov_19.913468	92	134	4	17	42	0.4047619
NODE_653_length_2965_cov_19.913468	92	134	6	19	42	0.4523810
NODE_653_length_2965_cov_19.913468	109	178	0	47	69	0.6811594
NODE_653_length_2965_cov_19.913468	109	178	2	3	69	0.0434783
NODE_653_length_2965_cov_19.913468	109	178	4	17	69	0.2463768
NODE_653_length_2965_cov_19.913468	109	178	6	2	69	0.0289855
NODE_653_length_2965_cov_19.913468	109	178	0	47	69	0.6811594
NODE_653_length_2965_cov_19.913468	109	178	2	3	69	0.0434783
NODE_653_length_2965_cov_19.913468	109	178	4	17	69	0.2463768
NODE_653_length_2965_cov_19.913468	109	178	6	2	69	0.0289855
NODE_653_length_2965_cov_19.913468	2298	2378	2	80	80	1.0000000
NODE_653_length_2965_cov_19.913468	2351	2431	1	9	80	0.1125000
NODE_653_length_2965_cov_19.913468	2351	2431	2	54	80	0.6750000
NODE_653_length_2965_cov_19.913468	2351	2431	3	17	80	0.2125000
NODE_653_length_2965_cov_19.913468	2427	2507	1	9	80	0.1125000
NODE_653_length_2965_cov_19.913468	2427	2507	2	6	80	0.0750000
NODE_653_length_2965_cov_19.913468	2427	2507	4	19	80	0.2375000
NODE_653_length_2965_cov_19.913468	2427	2507	5	1	80	0.0125000
NODE_653_length_2965_cov_19.913468	2427	2507	6	12	80	0.1500000
NODE_653_length_2965_cov_19.913468	2427	2507	7	7	80	0.0875000
NODE_653_length_2965_cov_19.913468	2427	2507	9	11	80	0.1375000
NODE_653_length_2965_cov_19.913468	2427	2507	10	3	80	0.0375000
NODE_653_length_2965_cov_19.913468	2427	2507	11	12	80	0.1500000
NODE_653_length_2965_cov_19.913468	2480	2560	7	1	80	0.0125000
NODE_653_length_2965_cov_19.913468	2480	2560	8	5	80	0.0625000
NODE_653_length_2965_cov_19.913468	2480	2560	9	37	80	0.4625000
NODE_653_length_2965_cov_19.913468	2480	2560	10	3	80	0.0375000
NODE_653_length_2965_cov_19.913468	2480	2560	11	34	80	0.4250000
NODE_656_length_2960_cov_35.741699	459	539	0	1	80	0.0125000
NODE_656_length_2960_cov_35.741699	459	539	2	33	80	0.4125000
NODE_656_length_2960_cov_35.741699	459	539	4	46	80	0.5750000
NODE_656_length_2960_cov_35.741699	512	592	4	80	80	1.0000000
NODE_659_length_2951_cov_7.195652	1100	1141	78	3	41	0.0731707
NODE_659_length_2951_cov_7.195652	1100	1141	79	1	41	0.0243902
NODE_659_length_2951_cov_7.195652	1100	1141	81	1	41	0.0243902
NODE_659_length_2951_cov_7.195652	1100	1141	84	3	41	0.0731707
NODE_659_length_2951_cov_7.195652	1100	1141	88	5	41	0.1219512
NODE_659_length_2951_cov_7.195652	1100	1141	89	8	41	0.1951219
NODE_659_length_2951_cov_7.195652	1100	1141	90	2	41	0.0487805
NODE_659_length_2951_cov_7.195652	1100	1141	91	3	41	0.0731707
NODE_659_length_2951_cov_7.195652	1100	1141	92	3	41	0.0731707
NODE_659_length_2951_cov_7.195652	1100	1141	93	7	41	0.1707317
NODE_659_length_2951_cov_7.195652	1100	1141	94	4	41	0.0975610
NODE_659_length_2951_cov_7.195652	1100	1141	96	1	41	0.0243902
NODE_665_length_2935_cov_37.693230	1492	1572	2	13	80	0.1625000
NODE_665_length_2935_cov_37.693230	1492	1572	3	67	80	0.8375000
NODE_665_length_2935_cov_37.693230	1534	1589	2	30	55	0.5454546
NODE_665_length_2935_cov_37.693230	1534	1589	3	25	55	0.4545455
NODE_665_length_2935_cov_37.693230	1545	1619	0	11	74	0.1486486
NODE_665_length_2935_cov_37.693230	1545	1619	2	49	74	0.6621622
NODE_665_length_2935_cov_37.693230	1545	1619	3	14	74	0.1891892
NODE_665_length_2935_cov_37.693230	1625	1701	0	76	76	1.0000000
NODE_665_length_2935_cov_37.693230	2863	2906	2	43	43	1.0000000
NODE_675_length_2913_cov_4.376688	2664	2739	0	75	75	1.0000000
NODE_675_length_2913_cov_4.376688	2664	2723	0	59	59	1.0000000
NODE_675_length_2913_cov_4.376688	2664	2739	0	75	75	1.0000000
NODE_675_length_2913_cov_4.376688	2664	2739	0	75	75	1.0000000
NODE_675_length_2913_cov_4.376688	2673	2739	0	66	66	1.0000000
NODE_675_length_2913_cov_4.376688	2717	2780	0	63	63	1.0000000
NODE_675_length_2913_cov_4.376688	2745	2778	0	33	33	1.0000000
NODE_677_length_2909_cov_71.975089	2090	2174	13	3	84	0.0357143
NODE_677_length_2909_cov_71.975089	2090	2174	15	4	84	0.0476190
NODE_677_length_2909_cov_71.975089	2090	2174	16	7	84	0.0833333
NODE_677_length_2909_cov_71.975089	2090	2174	17	2	84	0.0238095
NODE_677_length_2909_cov_71.975089	2090	2174	18	15	84	0.1785714
NODE_677_length_2909_cov_71.975089	2090	2174	19	5	84	0.0595238
NODE_677_length_2909_cov_71.975089	2090	2174	20	2	84	0.0238095
NODE_677_length_2909_cov_71.975089	2090	2174	22	10	84	0.1190476
NODE_677_length_2909_cov_71.975089	2090	2174	23	2	84	0.0238095
NODE_677_length_2909_cov_71.975089	2090	2174	25	1	84	0.0119048
NODE_677_length_2909_cov_71.975089	2090	2174	26	13	84	0.1547619
NODE_677_length_2909_cov_71.975089	2090	2174	27	5	84	0.0595238
NODE_677_length_2909_cov_71.975089	2090	2174	28	4	84	0.0476190
NODE_677_length_2909_cov_71.975089	2090	2174	29	1	84	0.0119048
NODE_677_length_2909_cov_71.975089	2090	2174	30	2	84	0.0238095
NODE_677_length_2909_cov_71.975089	2090	2174	32	8	84	0.0952381
NODE_678_length_2908_cov_5.937344	2495	2575	1	25	80	0.3125000
NODE_678_length_2908_cov_5.937344	2495	2575	2	26	80	0.3250000
NODE_678_length_2908_cov_5.937344	2495	2575	3	4	80	0.0500000
NODE_678_length_2908_cov_5.937344	2495	2575	4	25	80	0.3125000
NODE_678_length_2908_cov_5.937344	2548	2628	3	37	80	0.4625000
NODE_678_length_2908_cov_5.937344	2548	2628	4	43	80	0.5375000
NODE_678_length_2908_cov_5.937344	2624	2704	0	4	80	0.0500000
NODE_678_length_2908_cov_5.937344	2624	2704	1	4	80	0.0500000
NODE_678_length_2908_cov_5.937344	2624	2704	2	26	80	0.3250000
NODE_678_length_2908_cov_5.937344	2624	2704	3	46	80	0.5750000
NODE_678_length_2908_cov_5.937344	2677	2757	0	57	80	0.7125000
NODE_678_length_2908_cov_5.937344	2677	2757	1	4	80	0.0500000
NODE_678_length_2908_cov_5.937344	2677	2757	2	19	80	0.2375000
NODE_679_length_2905_cov_12.777619	2358	2419	0	13	61	0.2131148
NODE_679_length_2905_cov_12.777619	2358	2419	2	48	61	0.7868853
NODE_679_length_2905_cov_12.777619	2358	2419	0	13	61	0.2131148
NODE_679_length_2905_cov_12.777619	2358	2419	2	48	61	0.7868853
NODE_679_length_2905_cov_12.777619	2358	2419	0	13	61	0.2131148
NODE_679_length_2905_cov_12.777619	2358	2419	2	48	61	0.7868853
NODE_679_length_2905_cov_12.777619	2392	2472	0	22	80	0.2750000
NODE_679_length_2905_cov_12.777619	2392	2472	2	58	80	0.7250000
NODE_680_length_2903_cov_5.474322	2423	2464	2	41	41	1.0000000
NODE_684_length_2898_cov_5.786352	0	74	0	74	74	1.0000000
NODE_684_length_2898_cov_5.786352	47	124	0	77	77	1.0000000
NODE_686_length_2895_cov_8.519313	869	949	0	80	80	1.0000000
NODE_686_length_2895_cov_8.519313	922	1002	0	80	80	1.0000000
NODE_688_length_2894_cov_2.036136	2677	2757	6	80	80	1.0000000
NODE_689_length_2891_cov_7.938037	193	275	0	41	82	0.5000000
NODE_689_length_2891_cov_7.938037	193	275	2	16	82	0.1951219
NODE_689_length_2891_cov_7.938037	193	275	4	11	82	0.1341463
NODE_689_length_2891_cov_7.938037	193	275	5	1	82	0.0121951
NODE_689_length_2891_cov_7.938037	193	275	6	13	82	0.1585366
NODE_691_length_2889_cov_11.426882	407	487	3	46	80	0.5750000
NODE_691_length_2889_cov_11.426882	407	487	4	34	80	0.4250000
NODE_691_length_2889_cov_11.426882	460	540	3	73	80	0.9125000
NODE_691_length_2889_cov_11.426882	460	540	4	7	80	0.0875000
NODE_691_length_2889_cov_11.426882	1006	1086	3	12	80	0.1500000
NODE_691_length_2889_cov_11.426882	1006	1086	5	9	80	0.1125000
NODE_691_length_2889_cov_11.426882	1006	1086	6	29	80	0.3625000
NODE_691_length_2889_cov_11.426882	1006	1086	7	1	80	0.0125000
NODE_691_length_2889_cov_11.426882	1006	1086	8	9	80	0.1125000
NODE_691_length_2889_cov_11.426882	1006	1086	9	20	80	0.2500000
NODE_691_length_2889_cov_11.426882	1007	1086	3	12	79	0.1518987
NODE_691_length_2889_cov_11.426882	1007	1086	5	9	79	0.1139240
NODE_691_length_2889_cov_11.426882	1007	1086	6	29	79	0.3670886
NODE_691_length_2889_cov_11.426882	1007	1086	7	1	79	0.0126582
NODE_691_length_2889_cov_11.426882	1007	1086	8	8	79	0.1012658
NODE_691_length_2889_cov_11.426882	1007	1086	9	20	79	0.2531646
NODE_691_length_2889_cov_11.426882	1059	1138	1	47	79	0.5949367
NODE_691_length_2889_cov_11.426882	1059	1138	2	5	79	0.0632911
NODE_691_length_2889_cov_11.426882	1059	1138	3	12	79	0.1518987
NODE_691_length_2889_cov_11.426882	1059	1138	5	9	79	0.1139240
NODE_691_length_2889_cov_11.426882	1059	1138	6	6	79	0.0759494
NODE_691_length_2889_cov_11.426882	1059	1138	1	47	79	0.5949367
NODE_691_length_2889_cov_11.426882	1059	1138	2	5	79	0.0632911
NODE_691_length_2889_cov_11.426882	1059	1138	3	12	79	0.1518987
NODE_691_length_2889_cov_11.426882	1059	1138	5	9	79	0.1139240
NODE_691_length_2889_cov_11.426882	1059	1138	6	6	79	0.0759494
NODE_693_length_2888_cov_3.789172	992	1072	1	22	80	0.2750000
NODE_693_length_2888_cov_3.789172	992	1072	2	12	80	0.1500000
NODE_693_length_2888_cov_3.789172	992	1072	4	35	80	0.4375000
NODE_693_length_2888_cov_3.789172	992	1072	5	11	80	0.1375000
NODE_693_length_2888_cov_3.789172	1045	1087	1	36	42	0.8571429
NODE_693_length_2888_cov_3.789172	1045	1087	2	5	42	0.1190476
NODE_693_length_2888_cov_3.789172	1045	1087	3	1	42	0.0238095
NODE_697_length_2878_cov_6.277798	2712	2781	2	31	69	0.4492754
NODE_697_length_2878_cov_6.277798	2712	2781	4	29	69	0.4202898
NODE_697_length_2878_cov_6.277798	2712	2781	6	9	69	0.1304348
NODE_703_length_2862_cov_9.060803	2409	2489	4	33	80	0.4125000
NODE_703_length_2862_cov_9.060803	2409	2489	5	40	80	0.5000000
NODE_703_length_2862_cov_9.060803	2409	2489	6	7	80	0.0875000
NODE_703_length_2862_cov_9.060803	2462	2542	4	77	80	0.9625000
NODE_703_length_2862_cov_9.060803	2462	2542	5	3	80	0.0375000
NODE_712_length_2840_cov_2.079533	1660	1740	0	80	80	1.0000000
NODE_713_length_2839_cov_16.762044	327	402	2	75	75	1.0000000
NODE_713_length_2839_cov_16.762044	380	468	0	37	88	0.4204545
NODE_713_length_2839_cov_16.762044	380	468	2	51	88	0.5795454
NODE_713_length_2839_cov_16.762044	1021	1101	0	80	80	1.0000000
NODE_713_length_2839_cov_16.762044	1074	1154	0	80	80	1.0000000
NODE_714_length_2835_cov_29.691520	1552	1581	29	3	29	0.1034483
NODE_714_length_2835_cov_29.691520	1552	1581	30	9	29	0.3103448
NODE_714_length_2835_cov_29.691520	1552	1581	32	7	29	0.2413793
NODE_714_length_2835_cov_29.691520	1552	1581	34	10	29	0.3448276
NODE_714_length_2835_cov_29.691520	1554	1629	4	1	75	0.0133333
NODE_714_length_2835_cov_29.691520	1554	1629	6	2	75	0.0266667
NODE_714_length_2835_cov_29.691520	1554	1629	7	2	75	0.0266667
NODE_714_length_2835_cov_29.691520	1554	1629	8	2	75	0.0266667
NODE_714_length_2835_cov_29.691520	1554	1629	9	4	75	0.0533333
NODE_714_length_2835_cov_29.691520	1554	1629	10	7	75	0.0933333
NODE_714_length_2835_cov_29.691520	1554	1629	12	2	75	0.0266667
NODE_714_length_2835_cov_29.691520	1554	1629	14	2	75	0.0266667
NODE_714_length_2835_cov_29.691520	1554	1629	16	4	75	0.0533333
NODE_714_length_2835_cov_29.691520	1554	1629	18	3	75	0.0400000
NODE_714_length_2835_cov_29.691520	1554	1629	20	3	75	0.0400000
NODE_714_length_2835_cov_29.691520	1554	1629	21	1	75	0.0133333
NODE_714_length_2835_cov_29.691520	1554	1629	23	6	75	0.0800000
NODE_714_length_2835_cov_29.691520	1554	1629	25	2	75	0.0266667
NODE_714_length_2835_cov_29.691520	1554	1629	27	3	75	0.0400000
NODE_714_length_2835_cov_29.691520	1554	1629	29	7	75	0.0933333
NODE_714_length_2835_cov_29.691520	1554	1629	30	9	75	0.1200000
NODE_714_length_2835_cov_29.691520	1554	1629	32	7	75	0.0933333
NODE_714_length_2835_cov_29.691520	1554	1629	34	8	75	0.1066667
NODE_720_length_2825_cov_9.731108	487	567	0	42	80	0.5250000
NODE_720_length_2825_cov_9.731108	487	567	2	11	80	0.1375000
NODE_720_length_2825_cov_9.731108	487	567	3	4	80	0.0500000
NODE_720_length_2825_cov_9.731108	487	567	5	23	80	0.2875000
NODE_720_length_2825_cov_9.731108	540	620	3	4	80	0.0500000
NODE_720_length_2825_cov_9.731108	540	620	5	25	80	0.3125000
NODE_720_length_2825_cov_9.731108	540	620	6	51	80	0.6375000
NODE_726_length_2810_cov_2.844338	206	289	7	10	83	0.1204819
NODE_726_length_2810_cov_2.844338	206	289	8	4	83	0.0481928
NODE_726_length_2810_cov_2.844338	206	289	9	9	83	0.1084337
NODE_726_length_2810_cov_2.844338	206	289	10	4	83	0.0481928
NODE_726_length_2810_cov_2.844338	206	289	12	16	83	0.1927711
NODE_726_length_2810_cov_2.844338	206	289	13	1	83	0.0120482
NODE_726_length_2810_cov_2.844338	206	289	14	28	83	0.3373494
NODE_726_length_2810_cov_2.844338	206	289	16	4	83	0.0481928
NODE_726_length_2810_cov_2.844338	206	289	17	5	83	0.0602410
NODE_726_length_2810_cov_2.844338	206	289	19	2	83	0.0240964
NODE_728_length_2808_cov_2.867110	140	163	4	11	23	0.4782609
NODE_728_length_2808_cov_2.867110	140	163	5	12	23	0.5217391
NODE_729_length_2807_cov_8.423191	125	205	7	28	80	0.3500000
NODE_729_length_2807_cov_8.423191	125	205	8	39	80	0.4875000
NODE_729_length_2807_cov_8.423191	125	205	10	13	80	0.1625000
NODE_729_length_2807_cov_8.423191	178	258	8	14	80	0.1750000
NODE_729_length_2807_cov_8.423191	178	258	9	12	80	0.1500000
NODE_729_length_2807_cov_8.423191	178	258	10	19	80	0.2375000
NODE_729_length_2807_cov_8.423191	178	258	11	10	80	0.1250000
NODE_729_length_2807_cov_8.423191	178	258	12	16	80	0.2000000
NODE_729_length_2807_cov_8.423191	178	258	13	9	80	0.1125000
NODE_729_length_2807_cov_8.423191	2451	2515	3	32	64	0.5000000
NODE_729_length_2807_cov_8.423191	2451	2515	4	8	64	0.1250000
NODE_729_length_2807_cov_8.423191	2451	2515	5	24	64	0.3750000
NODE_735_length_2801_cov_26.131384	461	521	0	26	60	0.4333333
NODE_735_length_2801_cov_26.131384	461	521	2	34	60	0.5666667
NODE_735_length_2801_cov_26.131384	494	574	2	80	80	1.0000000
NODE_735_length_2801_cov_26.131384	1536	1596	10	1	60	0.0166667
NODE_735_length_2801_cov_26.131384	1536	1596	11	4	60	0.0666667
NODE_735_length_2801_cov_26.131384	1536	1596	14	13	60	0.2166667
NODE_735_length_2801_cov_26.131384	1536	1596	15	1	60	0.0166667
NODE_735_length_2801_cov_26.131384	1536	1596	16	4	60	0.0666667
NODE_735_length_2801_cov_26.131384	1536	1596	20	14	60	0.2333333
NODE_735_length_2801_cov_26.131384	1536	1596	22	4	60	0.0666667
NODE_735_length_2801_cov_26.131384	1536	1596	23	8	60	0.1333333
NODE_735_length_2801_cov_26.131384	1536	1596	24	3	60	0.0500000
NODE_735_length_2801_cov_26.131384	1536	1596	26	4	60	0.0666667
NODE_735_length_2801_cov_26.131384	1536	1596	27	2	60	0.0333333
NODE_735_length_2801_cov_26.131384	1536	1596	28	2	60	0.0333333
NODE_735_length_2801_cov_26.131384	1815	1881	1	3	66	0.0454545
NODE_735_length_2801_cov_26.131384	1815	1881	2	63	66	0.9545454
NODE_735_length_2801_cov_26.131384	1854	1934	1	3	80	0.0375000
NODE_735_length_2801_cov_26.131384	1854	1934	2	77	80	0.9625000
NODE_736_length_2801_cov_3.594375	2589	2645	0	8	56	0.1428571
NODE_736_length_2801_cov_3.594375	2589	2645	2	48	56	0.8571429
NODE_738_length_2796_cov_94.511680	1090	1137	8	11	47	0.2340426
NODE_738_length_2796_cov_94.511680	1090	1137	9	15	47	0.3191489
NODE_738_length_2796_cov_94.511680	1090	1137	10	2	47	0.0425532
NODE_738_length_2796_cov_94.511680	1090	1137	11	3	47	0.0638298
NODE_738_length_2796_cov_94.511680	1090	1137	12	1	47	0.0212766
NODE_738_length_2796_cov_94.511680	1090	1137	14	2	47	0.0425532
NODE_738_length_2796_cov_94.511680	1090	1137	15	5	47	0.1063830
NODE_738_length_2796_cov_94.511680	1090	1137	16	1	47	0.0212766
NODE_738_length_2796_cov_94.511680	1090	1137	17	2	47	0.0425532
NODE_738_length_2796_cov_94.511680	1090	1137	19	1	47	0.0212766
NODE_738_length_2796_cov_94.511680	1090	1137	22	1	47	0.0212766
NODE_738_length_2796_cov_94.511680	1090	1137	24	3	47	0.0638298
NODE_738_length_2796_cov_94.511680	2717	2796	0	79	79	1.0000000
NODE_744_length_2791_cov_9.997028	310	390	9	6	80	0.0750000
NODE_744_length_2791_cov_9.997028	310	390	10	30	80	0.3750000
NODE_744_length_2791_cov_9.997028	310	390	11	44	80	0.5500000
NODE_744_length_2791_cov_9.997028	363	443	1	6	80	0.0750000
NODE_744_length_2791_cov_9.997028	363	443	3	5	80	0.0625000
NODE_744_length_2791_cov_9.997028	363	443	5	6	80	0.0750000
NODE_744_length_2791_cov_9.997028	363	443	6	1	80	0.0125000
NODE_744_length_2791_cov_9.997028	363	443	7	20	80	0.2500000
NODE_744_length_2791_cov_9.997028	363	443	8	1	80	0.0125000
NODE_744_length_2791_cov_9.997028	363	443	9	18	80	0.2250000
NODE_744_length_2791_cov_9.997028	363	443	10	23	80	0.2875000
NODE_752_length_2778_cov_31.340799	2241	2321	2	29	80	0.3625000
NODE_752_length_2778_cov_31.340799	2241	2321	3	29	80	0.3625000
NODE_752_length_2778_cov_31.340799	2241	2321	5	6	80	0.0750000
NODE_752_length_2778_cov_31.340799	2241	2321	7	16	80	0.2000000
NODE_752_length_2778_cov_31.340799	2294	2374	3	5	80	0.0625000
NODE_752_length_2778_cov_31.340799	2294	2374	5	6	80	0.0750000
NODE_752_length_2778_cov_31.340799	2294	2374	7	40	80	0.5000000
NODE_752_length_2778_cov_31.340799	2294	2374	8	29	80	0.3625000
NODE_752_length_2778_cov_31.340799	2370	2450	3	14	80	0.1750000
NODE_752_length_2778_cov_31.340799	2370	2450	4	38	80	0.4750000
NODE_752_length_2778_cov_31.340799	2370	2450	6	2	80	0.0250000
NODE_752_length_2778_cov_31.340799	2370	2450	7	26	80	0.3250000
NODE_752_length_2778_cov_31.340799	2423	2503	0	28	80	0.3500000
NODE_752_length_2778_cov_31.340799	2423	2503	1	21	80	0.2625000
NODE_752_length_2778_cov_31.340799	2423	2503	3	18	80	0.2250000
NODE_752_length_2778_cov_31.340799	2423	2503	4	13	80	0.1625000
NODE_752_length_2778_cov_31.340799	2564	2620	3	56	56	1.0000000
NODE_758_length_2767_cov_12.450150	1941	2021	5	15	80	0.1875000
NODE_758_length_2767_cov_12.450150	1941	2021	6	38	80	0.4750000
NODE_758_length_2767_cov_12.450150	1941	2021	7	12	80	0.1500000
NODE_758_length_2767_cov_12.450150	1941	2021	9	15	80	0.1875000
NODE_758_length_2767_cov_12.450150	1994	2074	6	1	80	0.0125000
NODE_758_length_2767_cov_12.450150	1994	2074	7	11	80	0.1375000
NODE_758_length_2767_cov_12.450150	1994	2074	9	16	80	0.2000000
NODE_758_length_2767_cov_12.450150	1994	2074	10	32	80	0.4000000
NODE_758_length_2767_cov_12.450150	1994	2074	11	7	80	0.0875000
NODE_758_length_2767_cov_12.450150	1994	2074	12	13	80	0.1625000
NODE_767_length_2745_cov_5.322751	511	583	0	72	72	1.0000000
NODE_777_length_2720_cov_25.561618	2213	2293	3	14	80	0.1750000
NODE_777_length_2720_cov_25.561618	2213	2293	4	2	80	0.0250000
NODE_777_length_2720_cov_25.561618	2213	2293	5	64	80	0.8000000
NODE_777_length_2720_cov_25.561618	2266	2346	1	31	80	0.3875000
NODE_777_length_2720_cov_25.561618	2266	2346	3	14	80	0.1750000
NODE_777_length_2720_cov_25.561618	2266	2346	4	1	80	0.0125000
NODE_777_length_2720_cov_25.561618	2266	2346	5	34	80	0.4250000
NODE_782_length_2716_cov_39.885747	715	795	11	4	80	0.0500000
NODE_782_length_2716_cov_39.885747	715	795	12	2	80	0.0250000
NODE_782_length_2716_cov_39.885747	715	795	13	4	80	0.0500000
NODE_782_length_2716_cov_39.885747	715	795	14	5	80	0.0625000
NODE_782_length_2716_cov_39.885747	715	795	15	22	80	0.2750000
NODE_782_length_2716_cov_39.885747	715	795	16	42	80	0.5250000
NODE_782_length_2716_cov_39.885747	715	795	18	1	80	0.0125000
NODE_782_length_2716_cov_39.885747	768	848	10	22	80	0.2750000
NODE_782_length_2716_cov_39.885747	768	848	12	12	80	0.1500000
NODE_782_length_2716_cov_39.885747	768	848	13	20	80	0.2500000
NODE_782_length_2716_cov_39.885747	768	848	14	4	80	0.0500000
NODE_782_length_2716_cov_39.885747	768	848	15	22	80	0.2750000
NODE_782_length_2716_cov_39.885747	844	924	8	38	80	0.4750000
NODE_782_length_2716_cov_39.885747	844	924	9	26	80	0.3250000
NODE_782_length_2716_cov_39.885747	844	924	10	16	80	0.2000000
NODE_782_length_2716_cov_39.885747	897	977	8	58	80	0.7250000
NODE_782_length_2716_cov_39.885747	897	977	9	8	80	0.1000000
NODE_782_length_2716_cov_39.885747	897	977	10	13	80	0.1625000
NODE_782_length_2716_cov_39.885747	897	977	11	1	80	0.0125000
NODE_785_length_2710_cov_10.896974	2410	2446	0	36	36	1.0000000
NODE_785_length_2710_cov_10.896974	2419	2499	0	80	80	1.0000000
NODE_788_length_2708_cov_25.097355	2289	2369	0	4	80	0.0500000
NODE_788_length_2708_cov_25.097355	2289	2369	2	76	80	0.9500000
NODE_788_length_2708_cov_25.097355	2342	2422	0	46	80	0.5750000
NODE_788_length_2708_cov_25.097355	2342	2422	2	34	80	0.4250000
NODE_789_length_2708_cov_14.569950	18	98	8	3	80	0.0375000
NODE_789_length_2708_cov_14.569950	18	98	10	2	80	0.0250000
NODE_789_length_2708_cov_14.569950	18	98	12	2	80	0.0250000
NODE_789_length_2708_cov_14.569950	18	98	14	7	80	0.0875000
NODE_789_length_2708_cov_14.569950	18	98	15	66	80	0.8250000
NODE_789_length_2708_cov_14.569950	71	134	2	1	63	0.0158730
NODE_789_length_2708_cov_14.569950	71	134	3	1	63	0.0158730
NODE_789_length_2708_cov_14.569950	71	134	5	1	63	0.0158730
NODE_789_length_2708_cov_14.569950	71	134	9	1	63	0.0158730
NODE_789_length_2708_cov_14.569950	71	134	13	3	63	0.0476190
NODE_789_length_2708_cov_14.569950	71	134	15	56	63	0.8888889
NODE_797_length_2691_cov_35.457948	401	481	2	1	80	0.0125000
NODE_797_length_2691_cov_35.457948	401	481	3	45	80	0.5625000
NODE_797_length_2691_cov_35.457948	401	481	4	34	80	0.4250000
NODE_797_length_2691_cov_35.457948	454	534	2	50	80	0.6250000
NODE_797_length_2691_cov_35.457948	454	534	4	30	80	0.3750000
NODE_803_length_2684_cov_17.345068	146	194	0	48	48	1.0000000
NODE_803_length_2684_cov_17.345068	146	194	0	48	48	1.0000000
NODE_803_length_2684_cov_17.345068	146	194	0	48	48	1.0000000
NODE_803_length_2684_cov_17.345068	146	194	0	48	48	1.0000000
NODE_803_length_2684_cov_17.345068	146	194	0	48	48	1.0000000
NODE_805_length_2682_cov_43.500581	913	992	63	1	79	0.0126582
NODE_805_length_2682_cov_43.500581	913	992	64	2	79	0.0253165
NODE_805_length_2682_cov_43.500581	913	992	65	6	79	0.0759494
NODE_805_length_2682_cov_43.500581	913	992	66	1	79	0.0126582
NODE_805_length_2682_cov_43.500581	913	992	67	2	79	0.0253165
NODE_805_length_2682_cov_43.500581	913	992	68	1	79	0.0126582
NODE_805_length_2682_cov_43.500581	913	992	69	3	79	0.0379747
NODE_805_length_2682_cov_43.500581	913	992	70	3	79	0.0379747
NODE_805_length_2682_cov_43.500581	913	992	71	5	79	0.0632911
NODE_805_length_2682_cov_43.500581	913	992	72	5	79	0.0632911
NODE_805_length_2682_cov_43.500581	913	992	73	7	79	0.0886076
NODE_805_length_2682_cov_43.500581	913	992	74	4	79	0.0506329
NODE_805_length_2682_cov_43.500581	913	992	75	1	79	0.0126582
NODE_805_length_2682_cov_43.500581	913	992	77	1	79	0.0126582
NODE_805_length_2682_cov_43.500581	913	992	79	8	79	0.1012658
NODE_805_length_2682_cov_43.500581	913	992	80	1	79	0.0126582
NODE_805_length_2682_cov_43.500581	913	992	81	9	79	0.1139240
NODE_805_length_2682_cov_43.500581	913	992	83	1	79	0.0126582
NODE_805_length_2682_cov_43.500581	913	992	84	9	79	0.1139240
NODE_805_length_2682_cov_43.500581	913	992	85	3	79	0.0379747
NODE_805_length_2682_cov_43.500581	913	992	86	2	79	0.0253165
NODE_805_length_2682_cov_43.500581	913	992	87	4	79	0.0506329
NODE_805_length_2682_cov_43.500581	965	1002	78	3	37	0.0810811
NODE_805_length_2682_cov_43.500581	965	1002	79	2	37	0.0540541
NODE_805_length_2682_cov_43.500581	965	1002	81	7	37	0.1891892
NODE_805_length_2682_cov_43.500581	965	1002	83	3	37	0.0810811
NODE_805_length_2682_cov_43.500581	965	1002	84	12	37	0.3243243
NODE_805_length_2682_cov_43.500581	965	1002	85	4	37	0.1081081
NODE_805_length_2682_cov_43.500581	965	1002	86	2	37	0.0540541
NODE_805_length_2682_cov_43.500581	965	1002	87	4	37	0.1081081
NODE_808_length_2675_cov_10.369565	209	289	5	9	80	0.1125000
NODE_808_length_2675_cov_10.369565	209	289	6	53	80	0.6625000
NODE_808_length_2675_cov_10.369565	209	289	7	15	80	0.1875000
NODE_808_length_2675_cov_10.369565	209	289	8	3	80	0.0375000
NODE_813_length_2670_cov_17.489304	1995	2075	2	18	80	0.2250000
NODE_813_length_2670_cov_17.489304	1995	2075	3	21	80	0.2625000
NODE_813_length_2670_cov_17.489304	1995	2075	4	36	80	0.4500000
NODE_813_length_2670_cov_17.489304	1995	2075	5	5	80	0.0625000
NODE_813_length_2670_cov_17.489304	2048	2128	4	22	80	0.2750000
NODE_813_length_2670_cov_17.489304	2048	2128	5	58	80	0.7250000
NODE_813_length_2670_cov_17.489304	2124	2204	1	20	80	0.2500000
NODE_813_length_2670_cov_17.489304	2124	2204	2	21	80	0.2625000
NODE_813_length_2670_cov_17.489304	2124	2204	3	21	80	0.2625000
NODE_813_length_2670_cov_17.489304	2124	2204	4	5	80	0.0625000
NODE_813_length_2670_cov_17.489304	2124	2204	5	13	80	0.1625000
NODE_813_length_2670_cov_17.489304	2177	2257	0	18	80	0.2250000
NODE_813_length_2670_cov_17.489304	2177	2257	1	55	80	0.6875000
NODE_813_length_2670_cov_17.489304	2177	2257	2	7	80	0.0875000
NODE_815_length_2665_cov_19.145752	548	628	3	19	80	0.2375000
NODE_815_length_2665_cov_19.145752	548	628	5	6	80	0.0750000
NODE_815_length_2665_cov_19.145752	548	628	6	36	80	0.4500000
NODE_815_length_2665_cov_19.145752	548	628	7	6	80	0.0750000
NODE_815_length_2665_cov_19.145752	548	628	8	13	80	0.1625000
NODE_815_length_2665_cov_19.145752	601	681	6	8	80	0.1000000
NODE_815_length_2665_cov_19.145752	601	681	7	39	80	0.4875000
NODE_815_length_2665_cov_19.145752	601	681	8	23	80	0.2875000
NODE_815_length_2665_cov_19.145752	601	681	9	3	80	0.0375000
NODE_815_length_2665_cov_19.145752	601	681	10	7	80	0.0875000
NODE_815_length_2665_cov_19.145752	2099	2176	0	5	77	0.0649351
NODE_815_length_2665_cov_19.145752	2099	2176	1	25	77	0.3246753
NODE_815_length_2665_cov_19.145752	2099	2176	4	47	77	0.6103896
NODE_815_length_2665_cov_19.145752	2172	2252	4	6	80	0.0750000
NODE_815_length_2665_cov_19.145752	2172	2252	5	74	80	0.9250000
NODE_815_length_2665_cov_19.145752	2172	2252	4	6	80	0.0750000
NODE_815_length_2665_cov_19.145752	2172	2252	5	74	80	0.9250000
NODE_815_length_2665_cov_19.145752	2225	2267	2	2	42	0.0476190
NODE_815_length_2665_cov_19.145752	2225	2267	4	11	42	0.2619048
NODE_815_length_2665_cov_19.145752	2225	2267	5	29	42	0.6904762
NODE_816_length_2664_cov_4.175049	2005	2085	1	18	80	0.2250000
NODE_816_length_2664_cov_4.175049	2005	2085	2	62	80	0.7750000
NODE_816_length_2664_cov_4.175049	2058	2138	1	30	80	0.3750000
NODE_816_length_2664_cov_4.175049	2058	2138	2	50	80	0.6250000
NODE_822_length_2650_cov_19.800862	800	880	6	3	80	0.0375000
NODE_822_length_2650_cov_19.800862	800	880	7	1	80	0.0125000
NODE_822_length_2650_cov_19.800862	800	880	8	1	80	0.0125000
NODE_822_length_2650_cov_19.800862	800	880	9	7	80	0.0875000
NODE_822_length_2650_cov_19.800862	800	880	10	7	80	0.0875000
NODE_822_length_2650_cov_19.800862	800	880	11	1	80	0.0125000
NODE_822_length_2650_cov_19.800862	800	880	13	5	80	0.0625000
NODE_822_length_2650_cov_19.800862	800	880	15	31	80	0.3875000
NODE_822_length_2650_cov_19.800862	800	880	16	13	80	0.1625000
NODE_822_length_2650_cov_19.800862	800	880	17	11	80	0.1375000
NODE_824_length_2645_cov_8.618225	931	1011	1	61	80	0.7625000
NODE_824_length_2645_cov_8.618225	931	1011	2	19	80	0.2375000
NODE_824_length_2645_cov_8.618225	984	1064	0	8	80	0.1000000
NODE_824_length_2645_cov_8.618225	984	1064	1	72	80	0.9000000
NODE_827_length_2640_cov_16.462810	94	164	55	6	70	0.0857143
NODE_827_length_2640_cov_16.462810	94	164	56	4	70	0.0571429
NODE_827_length_2640_cov_16.462810	94	164	57	4	70	0.0571429
NODE_827_length_2640_cov_16.462810	94	164	58	6	70	0.0857143
NODE_827_length_2640_cov_16.462810	94	164	59	5	70	0.0714286
NODE_827_length_2640_cov_16.462810	94	164	61	3	70	0.0428571
NODE_827_length_2640_cov_16.462810	94	164	64	4	70	0.0571429
NODE_827_length_2640_cov_16.462810	94	164	65	7	70	0.1000000
NODE_827_length_2640_cov_16.462810	94	164	66	1	70	0.0142857
NODE_827_length_2640_cov_16.462810	94	164	67	1	70	0.0142857
NODE_827_length_2640_cov_16.462810	94	164	69	2	70	0.0285714
NODE_827_length_2640_cov_16.462810	94	164	71	2	70	0.0285714
NODE_827_length_2640_cov_16.462810	94	164	72	3	70	0.0428571
NODE_827_length_2640_cov_16.462810	94	164	73	2	70	0.0285714
NODE_827_length_2640_cov_16.462810	94	164	74	1	70	0.0142857
NODE_827_length_2640_cov_16.462810	94	164	77	19	70	0.2714286
NODE_827_length_2640_cov_16.462810	147	209	40	4	62	0.0645161
NODE_827_length_2640_cov_16.462810	147	209	41	3	62	0.0483871
NODE_827_length_2640_cov_16.462810	147	209	42	14	62	0.2258064
NODE_827_length_2640_cov_16.462810	147	209	43	4	62	0.0645161
NODE_827_length_2640_cov_16.462810	147	209	44	2	62	0.0322581
NODE_827_length_2640_cov_16.462810	147	209	46	1	62	0.0161290
NODE_827_length_2640_cov_16.462810	147	209	49	2	62	0.0322581
NODE_827_length_2640_cov_16.462810	147	209	50	2	62	0.0322581
NODE_827_length_2640_cov_16.462810	147	209	52	1	62	0.0161290
NODE_827_length_2640_cov_16.462810	147	209	54	1	62	0.0161290
NODE_827_length_2640_cov_16.462810	147	209	55	9	62	0.1451613
NODE_827_length_2640_cov_16.462810	147	209	56	3	62	0.0483871
NODE_827_length_2640_cov_16.462810	147	209	57	5	62	0.0806452
NODE_827_length_2640_cov_16.462810	147	209	58	5	62	0.0806452
NODE_827_length_2640_cov_16.462810	147	209	59	4	62	0.0645161
NODE_827_length_2640_cov_16.462810	147	209	61	2	62	0.0322581
NODE_828_length_2636_cov_200.191171	561	641	28	4	80	0.0500000
NODE_828_length_2636_cov_200.191171	561	641	29	5	80	0.0625000
NODE_828_length_2636_cov_200.191171	561	641	30	1	80	0.0125000
NODE_828_length_2636_cov_200.191171	561	641	31	17	80	0.2125000
NODE_828_length_2636_cov_200.191171	561	641	32	5	80	0.0625000
NODE_828_length_2636_cov_200.191171	561	641	33	3	80	0.0375000
NODE_828_length_2636_cov_200.191171	561	641	35	2	80	0.0250000
NODE_828_length_2636_cov_200.191171	561	641	36	5	80	0.0625000
NODE_828_length_2636_cov_200.191171	561	641	37	8	80	0.1000000
NODE_828_length_2636_cov_200.191171	561	641	39	7	80	0.0875000
NODE_828_length_2636_cov_200.191171	561	641	40	4	80	0.0500000
NODE_828_length_2636_cov_200.191171	561	641	41	12	80	0.1500000
NODE_828_length_2636_cov_200.191171	561	641	43	7	80	0.0875000
NODE_828_length_2636_cov_200.191171	614	695	14	1	81	0.0123457
NODE_828_length_2636_cov_200.191171	614	695	15	4	81	0.0493827
NODE_828_length_2636_cov_200.191171	614	695	16	3	81	0.0370370
NODE_828_length_2636_cov_200.191171	614	695	17	1	81	0.0123457
NODE_828_length_2636_cov_200.191171	614	695	19	3	81	0.0370370
NODE_828_length_2636_cov_200.191171	614	695	22	7	81	0.0864198
NODE_828_length_2636_cov_200.191171	614	695	23	4	81	0.0493827
NODE_828_length_2636_cov_200.191171	614	695	24	2	81	0.0246914
NODE_828_length_2636_cov_200.191171	614	695	25	16	81	0.1975309
NODE_828_length_2636_cov_200.191171	614	695	26	6	81	0.0740741
NODE_828_length_2636_cov_200.191171	614	695	28	11	81	0.1358025
NODE_828_length_2636_cov_200.191171	614	695	29	5	81	0.0617284
NODE_828_length_2636_cov_200.191171	614	695	30	1	81	0.0123457
NODE_828_length_2636_cov_200.191171	614	695	31	17	81	0.2098765
NODE_830_length_2631_cov_10.831754	446	526	13	3	80	0.0375000
NODE_830_length_2631_cov_10.831754	446	526	14	17	80	0.2125000
NODE_830_length_2631_cov_10.831754	446	526	16	3	80	0.0375000
NODE_830_length_2631_cov_10.831754	446	526	17	16	80	0.2000000
NODE_830_length_2631_cov_10.831754	446	526	18	34	80	0.4250000
NODE_830_length_2631_cov_10.831754	446	526	19	5	80	0.0625000
NODE_830_length_2631_cov_10.831754	446	526	20	2	80	0.0250000
NODE_830_length_2631_cov_10.831754	499	572	10	5	73	0.0684932
NODE_830_length_2631_cov_10.831754	499	572	11	12	73	0.1643836
NODE_830_length_2631_cov_10.831754	499	572	13	4	73	0.0547945
NODE_830_length_2631_cov_10.831754	499	572	15	14	73	0.1917808
NODE_830_length_2631_cov_10.831754	499	572	16	5	73	0.0684932
NODE_830_length_2631_cov_10.831754	499	572	17	1	73	0.0136986
NODE_830_length_2631_cov_10.831754	499	572	18	32	73	0.4383562
NODE_833_length_2622_cov_63.057471	1877	1953	57	5	76	0.0657895
NODE_833_length_2622_cov_63.057471	1877	1953	58	8	76	0.1052632
NODE_833_length_2622_cov_63.057471	1877	1953	59	1	76	0.0131579
NODE_833_length_2622_cov_63.057471	1877	1953	60	4	76	0.0526316
NODE_833_length_2622_cov_63.057471	1877	1953	61	8	76	0.1052632
NODE_833_length_2622_cov_63.057471	1877	1953	62	8	76	0.1052632
NODE_833_length_2622_cov_63.057471	1877	1953	63	2	76	0.0263158
NODE_833_length_2622_cov_63.057471	1877	1953	64	6	76	0.0789474
NODE_833_length_2622_cov_63.057471	1877	1953	65	5	76	0.0657895
NODE_833_length_2622_cov_63.057471	1877	1953	66	12	76	0.1578947
NODE_833_length_2622_cov_63.057471	1877	1953	67	10	76	0.1315790
NODE_833_length_2622_cov_63.057471	1877	1953	68	7	76	0.0921053
NODE_833_length_2622_cov_63.057471	2426	2506	22	10	80	0.1250000
NODE_833_length_2622_cov_63.057471	2426	2506	23	10	80	0.1250000
NODE_833_length_2622_cov_63.057471	2426	2506	24	13	80	0.1625000
NODE_833_length_2622_cov_63.057471	2426	2506	25	13	80	0.1625000
NODE_833_length_2622_cov_63.057471	2426	2506	26	18	80	0.2250000
NODE_833_length_2622_cov_63.057471	2426	2506	27	8	80	0.1000000
NODE_833_length_2622_cov_63.057471	2426	2506	28	1	80	0.0125000
NODE_833_length_2622_cov_63.057471	2426	2506	29	4	80	0.0500000
NODE_833_length_2622_cov_63.057471	2426	2506	30	3	80	0.0375000
NODE_833_length_2622_cov_63.057471	2479	2559	18	2	80	0.0250000
NODE_833_length_2622_cov_63.057471	2479	2559	19	18	80	0.2250000
NODE_833_length_2622_cov_63.057471	2479	2559	21	1	80	0.0125000
NODE_833_length_2622_cov_63.057471	2479	2559	24	3	80	0.0375000
NODE_833_length_2622_cov_63.057471	2479	2559	25	4	80	0.0500000
NODE_833_length_2622_cov_63.057471	2479	2559	26	23	80	0.2875000
NODE_833_length_2622_cov_63.057471	2479	2559	27	17	80	0.2125000
NODE_833_length_2622_cov_63.057471	2479	2559	28	1	80	0.0125000
NODE_833_length_2622_cov_63.057471	2479	2559	29	8	80	0.1000000
NODE_833_length_2622_cov_63.057471	2479	2559	30	3	80	0.0375000
NODE_836_length_2617_cov_16.817315	1404	1448	1	44	44	1.0000000
NODE_836_length_2617_cov_16.817315	1467	1521	0	54	54	1.0000000
NODE_839_length_2610_cov_2.232577	2127	2163	0	36	36	1.0000000
NODE_840_length_2609_cov_13.245418	2066	2146	0	18	80	0.2250000
NODE_840_length_2609_cov_13.245418	2066	2146	1	39	80	0.4875000
NODE_840_length_2609_cov_13.245418	2066	2146	2	23	80	0.2875000
NODE_840_length_2609_cov_13.245418	2119	2199	1	4	80	0.0500000
NODE_840_length_2609_cov_13.245418	2119	2199	2	76	80	0.9500000
NODE_840_length_2609_cov_13.245418	2195	2275	2	6	80	0.0750000
NODE_840_length_2609_cov_13.245418	2195	2275	3	39	80	0.4875000
NODE_840_length_2609_cov_13.245418	2195	2275	4	35	80	0.4375000
NODE_840_length_2609_cov_13.245418	2248	2328	0	29	80	0.3625000
NODE_840_length_2609_cov_13.245418	2248	2328	2	26	80	0.3250000
NODE_840_length_2609_cov_13.245418	2248	2328	3	25	80	0.3125000
NODE_845_length_2595_cov_5.638622	2157	2237	0	80	80	1.0000000
NODE_847_length_2594_cov_109.880160	386	450	20	7	64	0.1093750
NODE_847_length_2594_cov_109.880160	386	450	21	4	64	0.0625000
NODE_847_length_2594_cov_109.880160	386	450	22	5	64	0.0781250
NODE_847_length_2594_cov_109.880160	386	450	24	9	64	0.1406250
NODE_847_length_2594_cov_109.880160	386	450	25	2	64	0.0312500
NODE_847_length_2594_cov_109.880160	386	450	28	3	64	0.0468750
NODE_847_length_2594_cov_109.880160	386	450	30	2	64	0.0312500
NODE_847_length_2594_cov_109.880160	386	450	34	7	64	0.1093750
NODE_847_length_2594_cov_109.880160	386	450	36	5	64	0.0781250
NODE_847_length_2594_cov_109.880160	386	450	37	1	64	0.0156250
NODE_847_length_2594_cov_109.880160	386	450	38	6	64	0.0937500
NODE_847_length_2594_cov_109.880160	386	450	39	7	64	0.1093750
NODE_847_length_2594_cov_109.880160	386	450	40	3	64	0.0468750
NODE_847_length_2594_cov_109.880160	386	450	42	3	64	0.0468750
NODE_856_length_2575_cov_4.890549	1860	1912	2	42	52	0.8076923
NODE_856_length_2575_cov_4.890549	1860	1912	3	10	52	0.1923077
NODE_857_length_2572_cov_46.828548	302	382	0	14	80	0.1750000
NODE_857_length_2572_cov_46.828548	302	382	1	66	80	0.8250000
NODE_857_length_2572_cov_46.828548	355	435	0	67	80	0.8375000
NODE_857_length_2572_cov_46.828548	355	435	1	13	80	0.1625000
NODE_868_length_2551_cov_40.721860	1104	1150	10	6	46	0.1304348
NODE_868_length_2551_cov_40.721860	1104	1150	11	7	46	0.1521739
NODE_868_length_2551_cov_40.721860	1104	1150	12	2	46	0.0434783
NODE_868_length_2551_cov_40.721860	1104	1150	14	3	46	0.0652174
NODE_868_length_2551_cov_40.721860	1104	1150	16	28	46	0.6086956
NODE_868_length_2551_cov_40.721860	1199	1259	6	8	60	0.1333333
NODE_868_length_2551_cov_40.721860	1199	1259	7	11	60	0.1833333
NODE_868_length_2551_cov_40.721860	1199	1259	9	18	60	0.3000000
NODE_868_length_2551_cov_40.721860	1199	1259	10	2	60	0.0333333
NODE_868_length_2551_cov_40.721860	1199	1259	12	21	60	0.3500000
NODE_870_length_2547_cov_218.062908	436	486	1	17	50	0.3400000
NODE_870_length_2547_cov_218.062908	436	486	2	9	50	0.1800000
NODE_870_length_2547_cov_218.062908	436	486	6	3	50	0.0600000
NODE_870_length_2547_cov_218.062908	436	486	7	1	50	0.0200000
NODE_870_length_2547_cov_218.062908	436	486	9	1	50	0.0200000
NODE_870_length_2547_cov_218.062908	436	486	13	3	50	0.0600000
NODE_870_length_2547_cov_218.062908	436	486	15	1	50	0.0200000
NODE_870_length_2547_cov_218.062908	436	486	17	1	50	0.0200000
NODE_870_length_2547_cov_218.062908	436	486	18	1	50	0.0200000
NODE_870_length_2547_cov_218.062908	436	486	19	1	50	0.0200000
NODE_870_length_2547_cov_218.062908	436	486	20	1	50	0.0200000
NODE_870_length_2547_cov_218.062908	436	486	21	3	50	0.0600000
NODE_870_length_2547_cov_218.062908	436	486	24	1	50	0.0200000
NODE_870_length_2547_cov_218.062908	436	486	26	2	50	0.0400000
NODE_870_length_2547_cov_218.062908	436	486	28	1	50	0.0200000
NODE_870_length_2547_cov_218.062908	436	486	31	2	50	0.0400000
NODE_870_length_2547_cov_218.062908	436	486	32	1	50	0.0200000
NODE_870_length_2547_cov_218.062908	436	486	34	1	50	0.0200000
NODE_879_length_2527_cov_27.275947	503	548	15	2	45	0.0444444
NODE_879_length_2527_cov_27.275947	503	548	16	3	45	0.0666667
NODE_879_length_2527_cov_27.275947	503	548	17	4	45	0.0888889
NODE_879_length_2527_cov_27.275947	503	548	18	5	45	0.1111111
NODE_879_length_2527_cov_27.275947	503	548	19	28	45	0.6222222
NODE_879_length_2527_cov_27.275947	503	548	20	3	45	0.0666667
NODE_884_length_2519_cov_15.991322	2122	2202	11	2	80	0.0250000
NODE_884_length_2519_cov_15.991322	2122	2202	12	10	80	0.1250000
NODE_884_length_2519_cov_15.991322	2122	2202	13	10	80	0.1250000
NODE_884_length_2519_cov_15.991322	2122	2202	15	16	80	0.2000000
NODE_884_length_2519_cov_15.991322	2122	2202	16	18	80	0.2250000
NODE_884_length_2519_cov_15.991322	2122	2202	17	24	80	0.3000000
NODE_884_length_2519_cov_15.991322	2175	2255	9	3	80	0.0375000
NODE_884_length_2519_cov_15.991322	2175	2255	10	13	80	0.1625000
NODE_884_length_2519_cov_15.991322	2175	2255	11	22	80	0.2750000
NODE_884_length_2519_cov_15.991322	2175	2255	12	3	80	0.0375000
NODE_884_length_2519_cov_15.991322	2175	2255	13	5	80	0.0625000
NODE_884_length_2519_cov_15.991322	2175	2255	14	3	80	0.0375000
NODE_884_length_2519_cov_15.991322	2175	2255	15	7	80	0.0875000
NODE_884_length_2519_cov_15.991322	2175	2255	17	24	80	0.3000000
NODE_885_length_2518_cov_7.035965	62	142	7	1	80	0.0125000
NODE_885_length_2518_cov_7.035965	62	142	9	4	80	0.0500000
NODE_885_length_2518_cov_7.035965	62	142	11	2	80	0.0250000
NODE_885_length_2518_cov_7.035965	62	142	12	1	80	0.0125000
NODE_885_length_2518_cov_7.035965	62	142	13	12	80	0.1500000
NODE_885_length_2518_cov_7.035965	62	142	14	60	80	0.7500000
NODE_885_length_2518_cov_7.035965	2005	2085	0	80	80	1.0000000
NODE_885_length_2518_cov_7.035965	2058	2138	0	80	80	1.0000000
NODE_887_length_2515_cov_37.984272	393	473	1	1	80	0.0125000
NODE_887_length_2515_cov_37.984272	393	473	2	2	80	0.0250000
NODE_887_length_2515_cov_37.984272	393	473	4	77	80	0.9625000
NODE_887_length_2515_cov_37.984272	446	526	0	12	80	0.1500000
NODE_887_length_2515_cov_37.984272	446	526	1	42	80	0.5250000
NODE_887_length_2515_cov_37.984272	446	526	2	2	80	0.0250000
NODE_887_length_2515_cov_37.984272	446	526	4	24	80	0.3000000
NODE_887_length_2515_cov_37.984272	1896	1976	6	3	80	0.0375000
NODE_887_length_2515_cov_37.984272	1896	1976	7	77	80	0.9625000
NODE_887_length_2515_cov_37.984272	1949	2029	3	47	80	0.5875000
NODE_887_length_2515_cov_37.984272	1949	2029	4	3	80	0.0375000
NODE_887_length_2515_cov_37.984272	1949	2029	6	1	80	0.0125000
NODE_887_length_2515_cov_37.984272	1949	2029	7	29	80	0.3625000
NODE_887_length_2515_cov_37.984272	2025	2105	1	4	80	0.0500000
NODE_887_length_2515_cov_37.984272	2025	2105	2	44	80	0.5500000
NODE_887_length_2515_cov_37.984272	2025	2105	3	10	80	0.1250000
NODE_887_length_2515_cov_37.984272	2025	2105	4	22	80	0.2750000
NODE_887_length_2515_cov_37.984272	2025	2104	1	4	79	0.0506329
NODE_887_length_2515_cov_37.984272	2025	2104	2	44	79	0.5569620
NODE_887_length_2515_cov_37.984272	2025	2104	3	10	79	0.1265823
NODE_887_length_2515_cov_37.984272	2025	2104	4	21	79	0.2658228
NODE_887_length_2515_cov_37.984272	2078	2158	2	1	80	0.0125000
NODE_887_length_2515_cov_37.984272	2078	2158	3	4	80	0.0500000
NODE_887_length_2515_cov_37.984272	2078	2158	4	75	80	0.9375000
NODE_888_length_2512_cov_48.259428	1299	1379	6	22	80	0.2750000
NODE_888_length_2512_cov_48.259428	1299	1379	7	10	80	0.1250000
NODE_888_length_2512_cov_48.259428	1299	1379	8	14	80	0.1750000
NODE_888_length_2512_cov_48.259428	1299	1379	9	3	80	0.0375000
NODE_888_length_2512_cov_48.259428	1299	1379	11	3	80	0.0375000
NODE_888_length_2512_cov_48.259428	1299	1379	12	4	80	0.0500000
NODE_888_length_2512_cov_48.259428	1299	1379	13	8	80	0.1000000
NODE_888_length_2512_cov_48.259428	1299	1379	14	7	80	0.0875000
NODE_888_length_2512_cov_48.259428	1299	1379	15	1	80	0.0125000
NODE_888_length_2512_cov_48.259428	1299	1379	16	4	80	0.0500000
NODE_888_length_2512_cov_48.259428	1299	1379	17	4	80	0.0500000
NODE_888_length_2512_cov_48.259428	1352	1432	12	3	80	0.0375000
NODE_888_length_2512_cov_48.259428	1352	1432	13	8	80	0.1000000
NODE_888_length_2512_cov_48.259428	1352	1432	14	7	80	0.0875000
NODE_888_length_2512_cov_48.259428	1352	1432	15	1	80	0.0125000
NODE_888_length_2512_cov_48.259428	1352	1432	16	4	80	0.0500000
NODE_888_length_2512_cov_48.259428	1352	1432	17	18	80	0.2250000
NODE_888_length_2512_cov_48.259428	1352	1432	18	6	80	0.0750000
NODE_888_length_2512_cov_48.259428	1352	1432	20	7	80	0.0875000
NODE_888_length_2512_cov_48.259428	1352	1432	21	11	80	0.1375000
NODE_888_length_2512_cov_48.259428	1352	1432	22	11	80	0.1375000
NODE_888_length_2512_cov_48.259428	1352	1432	23	4	80	0.0500000
NODE_888_length_2512_cov_48.259428	1428	1512	22	3	84	0.0357143
NODE_888_length_2512_cov_48.259428	1428	1512	23	1	84	0.0119048
NODE_888_length_2512_cov_48.259428	1428	1512	24	5	84	0.0595238
NODE_888_length_2512_cov_48.259428	1428	1512	25	6	84	0.0714286
NODE_888_length_2512_cov_48.259428	1428	1512	26	9	84	0.1071429
NODE_888_length_2512_cov_48.259428	1428	1512	28	7	84	0.0833333
NODE_888_length_2512_cov_48.259428	1428	1512	29	10	84	0.1190476
NODE_888_length_2512_cov_48.259428	1428	1512	30	5	84	0.0595238
NODE_888_length_2512_cov_48.259428	1428	1512	31	1	84	0.0119048
NODE_888_length_2512_cov_48.259428	1428	1512	32	6	84	0.0714286
NODE_888_length_2512_cov_48.259428	1428	1512	33	6	84	0.0714286
NODE_888_length_2512_cov_48.259428	1428	1512	34	3	84	0.0357143
NODE_888_length_2512_cov_48.259428	1428	1512	35	9	84	0.1071429
NODE_888_length_2512_cov_48.259428	1428	1512	36	8	84	0.0952381
NODE_888_length_2512_cov_48.259428	1428	1512	37	5	84	0.0595238
NODE_888_length_2512_cov_48.259428	1485	1565	20	2	80	0.0250000
NODE_888_length_2512_cov_48.259428	1485	1565	22	7	80	0.0875000
NODE_888_length_2512_cov_48.259428	1485	1565	23	6	80	0.0750000
NODE_888_length_2512_cov_48.259428	1485	1565	24	1	80	0.0125000
NODE_888_length_2512_cov_48.259428	1485	1565	26	4	80	0.0500000
NODE_888_length_2512_cov_48.259428	1485	1565	30	1	80	0.0125000
NODE_888_length_2512_cov_48.259428	1485	1565	31	14	80	0.1750000
NODE_888_length_2512_cov_48.259428	1485	1565	32	24	80	0.3000000
NODE_888_length_2512_cov_48.259428	1485	1565	33	7	80	0.0875000
NODE_888_length_2512_cov_48.259428	1485	1565	34	2	80	0.0250000
NODE_888_length_2512_cov_48.259428	1485	1565	36	7	80	0.0875000
NODE_888_length_2512_cov_48.259428	1485	1565	37	5	80	0.0625000
NODE_891_length_2505_cov_102.009975	390	470	2	7	80	0.0875000
NODE_891_length_2505_cov_102.009975	390	470	3	9	80	0.1125000
NODE_891_length_2505_cov_102.009975	390	470	4	1	80	0.0125000
NODE_891_length_2505_cov_102.009975	390	470	5	47	80	0.5875000
NODE_891_length_2505_cov_102.009975	390	470	6	16	80	0.2000000
NODE_891_length_2505_cov_102.009975	443	510	2	47	67	0.7014925
NODE_891_length_2505_cov_102.009975	443	510	3	9	67	0.1343284
NODE_891_length_2505_cov_102.009975	443	510	5	11	67	0.1641791
NODE_894_length_2499_cov_2.655417	2325	2375	0	16	50	0.3200000
NODE_894_length_2499_cov_2.655417	2325	2375	2	34	50	0.6800000
NODE_895_length_2498_cov_9.614840	239	281	0	35	42	0.8333333
NODE_895_length_2498_cov_9.614840	239	281	1	7	42	0.1666667
NODE_895_length_2498_cov_9.614840	254	335	0	20	81	0.2469136
NODE_895_length_2498_cov_9.614840	254	335	1	12	81	0.1481481
NODE_895_length_2498_cov_9.614840	254	335	2	39	81	0.4814815
NODE_895_length_2498_cov_9.614840	254	335	4	10	81	0.1234568
NODE_895_length_2498_cov_9.614840	254	335	0	20	81	0.2469136
NODE_895_length_2498_cov_9.614840	254	335	1	12	81	0.1481481
NODE_895_length_2498_cov_9.614840	254	335	2	39	81	0.4814815
NODE_895_length_2498_cov_9.614840	254	335	4	10	81	0.1234568
NODE_895_length_2498_cov_9.614840	331	411	4	4	80	0.0500000
NODE_895_length_2498_cov_9.614840	331	411	5	76	80	0.9500000
NODE_895_length_2498_cov_9.614840	384	464	2	22	80	0.2750000
NODE_895_length_2498_cov_9.614840	384	464	3	18	80	0.2250000
NODE_895_length_2498_cov_9.614840	384	464	4	10	80	0.1250000
NODE_895_length_2498_cov_9.614840	384	464	5	30	80	0.3750000
NODE_898_length_2495_cov_5.151085	2395	2444	2	49	49	1.0000000
NODE_898_length_2495_cov_5.151085	2395	2444	2	49	49	1.0000000
NODE_898_length_2495_cov_5.151085	2396	2444	2	48	48	1.0000000
NODE_898_length_2495_cov_5.151085	2396	2444	2	48	48	1.0000000
NODE_898_length_2495_cov_5.151085	2396	2444	2	48	48	1.0000000
NODE_900_length_2492_cov_43.645215	408	488	0	53	80	0.6625000
NODE_900_length_2492_cov_43.645215	408	488	1	27	80	0.3375000
NODE_903_length_2489_cov_15.105021	204	234	2	1	30	0.0333333
NODE_903_length_2489_cov_15.105021	204	234	3	29	30	0.9666666
NODE_905_length_2488_cov_2.434910	2141	2200	6	1	59	0.0169492
NODE_905_length_2488_cov_2.434910	2141	2200	7	32	59	0.5423729
NODE_905_length_2488_cov_2.434910	2141	2200	8	26	59	0.4406780
NODE_906_length_2484_cov_335.301887	224	279	114	1	55	0.0181818
NODE_906_length_2484_cov_335.301887	224	279	115	1	55	0.0181818
NODE_906_length_2484_cov_335.301887	224	279	116	1	55	0.0181818
NODE_906_length_2484_cov_335.301887	224	279	117	1	55	0.0181818
NODE_906_length_2484_cov_335.301887	224	279	118	2	55	0.0363636
NODE_906_length_2484_cov_335.301887	224	279	123	1	55	0.0181818
NODE_906_length_2484_cov_335.301887	224	279	124	1	55	0.0181818
NODE_906_length_2484_cov_335.301887	224	279	125	2	55	0.0363636
NODE_906_length_2484_cov_335.301887	224	279	126	3	55	0.0545455
NODE_906_length_2484_cov_335.301887	224	279	127	4	55	0.0727273
NODE_906_length_2484_cov_335.301887	224	279	128	4	55	0.0727273
NODE_906_length_2484_cov_335.301887	224	279	129	3	55	0.0545455
NODE_906_length_2484_cov_335.301887	224	279	130	5	55	0.0909091
NODE_906_length_2484_cov_335.301887	224	279	131	4	55	0.0727273
NODE_906_length_2484_cov_335.301887	224	279	132	1	55	0.0181818
NODE_906_length_2484_cov_335.301887	224	279	133	1	55	0.0181818
NODE_906_length_2484_cov_335.301887	224	279	134	4	55	0.0727273
NODE_906_length_2484_cov_335.301887	224	279	135	3	55	0.0545455
NODE_906_length_2484_cov_335.301887	224	279	136	2	55	0.0363636
NODE_906_length_2484_cov_335.301887	224	279	137	3	55	0.0545455
NODE_906_length_2484_cov_335.301887	224	279	138	4	55	0.0727273
NODE_906_length_2484_cov_335.301887	224	279	139	4	55	0.0727273
NODE_906_length_2484_cov_335.301887	252	332	125	1	80	0.0125000
NODE_906_length_2484_cov_335.301887	252	332	126	1	80	0.0125000
NODE_906_length_2484_cov_335.301887	252	332	128	1	80	0.0125000
NODE_906_length_2484_cov_335.301887	252	332	129	2	80	0.0250000
NODE_906_length_2484_cov_335.301887	252	332	130	1	80	0.0125000
NODE_906_length_2484_cov_335.301887	252	332	132	1	80	0.0125000
NODE_906_length_2484_cov_335.301887	252	332	134	4	80	0.0500000
NODE_906_length_2484_cov_335.301887	252	332	135	4	80	0.0500000
NODE_906_length_2484_cov_335.301887	252	332	136	4	80	0.0500000
NODE_906_length_2484_cov_335.301887	252	332	137	7	80	0.0875000
NODE_906_length_2484_cov_335.301887	252	332	138	8	80	0.1000000
NODE_906_length_2484_cov_335.301887	252	332	139	9	80	0.1125000
NODE_906_length_2484_cov_335.301887	252	332	140	4	80	0.0500000
NODE_906_length_2484_cov_335.301887	252	332	141	5	80	0.0625000
NODE_906_length_2484_cov_335.301887	252	332	142	2	80	0.0250000
NODE_906_length_2484_cov_335.301887	252	332	143	3	80	0.0375000
NODE_906_length_2484_cov_335.301887	252	332	144	3	80	0.0375000
NODE_906_length_2484_cov_335.301887	252	332	145	5	80	0.0625000
NODE_906_length_2484_cov_335.301887	252	332	146	1	80	0.0125000
NODE_906_length_2484_cov_335.301887	252	332	147	3	80	0.0375000
NODE_906_length_2484_cov_335.301887	252	332	148	3	80	0.0375000
NODE_906_length_2484_cov_335.301887	252	332	150	5	80	0.0625000
NODE_906_length_2484_cov_335.301887	252	332	151	3	80	0.0375000
NODE_912_length_2479_cov_90.381092	369	449	0	33	80	0.4125000
NODE_912_length_2479_cov_90.381092	369	449	1	9	80	0.1125000
NODE_912_length_2479_cov_90.381092	369	449	2	2	80	0.0250000
NODE_912_length_2479_cov_90.381092	369	449	5	15	80	0.1875000
NODE_912_length_2479_cov_90.381092	369	449	6	21	80	0.2625000
NODE_912_length_2479_cov_90.381092	422	499	5	6	77	0.0779221
NODE_912_length_2479_cov_90.381092	422	499	6	71	77	0.9220779
NODE_912_length_2479_cov_90.381092	1610	1685	10	2	75	0.0266667
NODE_912_length_2479_cov_90.381092	1610	1685	11	6	75	0.0800000
NODE_912_length_2479_cov_90.381092	1610	1685	13	4	75	0.0533333
NODE_912_length_2479_cov_90.381092	1610	1685	14	4	75	0.0533333
NODE_912_length_2479_cov_90.381092	1610	1685	15	1	75	0.0133333
NODE_912_length_2479_cov_90.381092	1610	1685	17	3	75	0.0400000
NODE_912_length_2479_cov_90.381092	1610	1685	19	1	75	0.0133333
NODE_912_length_2479_cov_90.381092	1610	1685	20	1	75	0.0133333
NODE_912_length_2479_cov_90.381092	1610	1685	24	1	75	0.0133333
NODE_912_length_2479_cov_90.381092	1610	1685	26	1	75	0.0133333
NODE_912_length_2479_cov_90.381092	1610	1685	32	2	75	0.0266667
NODE_912_length_2479_cov_90.381092	1610	1685	33	5	75	0.0666667
NODE_912_length_2479_cov_90.381092	1610	1685	36	2	75	0.0266667
NODE_912_length_2479_cov_90.381092	1610	1685	37	1	75	0.0133333
NODE_912_length_2479_cov_90.381092	1610	1685	39	1	75	0.0133333
NODE_912_length_2479_cov_90.381092	1610	1685	40	1	75	0.0133333
NODE_912_length_2479_cov_90.381092	1610	1685	44	4	75	0.0533333
NODE_912_length_2479_cov_90.381092	1610	1685	46	2	75	0.0266667
NODE_912_length_2479_cov_90.381092	1610	1685	47	2	75	0.0266667
NODE_912_length_2479_cov_90.381092	1610	1685	49	2	75	0.0266667
NODE_912_length_2479_cov_90.381092	1610	1685	53	1	75	0.0133333
NODE_912_length_2479_cov_90.381092	1610	1685	56	9	75	0.1200000
NODE_912_length_2479_cov_90.381092	1610	1685	57	1	75	0.0133333
NODE_912_length_2479_cov_90.381092	1610	1685	59	1	75	0.0133333
NODE_912_length_2479_cov_90.381092	1610	1685	61	1	75	0.0133333
NODE_912_length_2479_cov_90.381092	1610	1685	63	3	75	0.0400000
NODE_912_length_2479_cov_90.381092	1610	1685	64	5	75	0.0666667
NODE_912_length_2479_cov_90.381092	1610	1685	65	5	75	0.0666667
NODE_912_length_2479_cov_90.381092	1610	1685	68	1	75	0.0133333
NODE_912_length_2479_cov_90.381092	1610	1685	69	2	75	0.0266667
NODE_912_length_2479_cov_90.381092	1658	1730	56	8	72	0.1111111
NODE_912_length_2479_cov_90.381092	1658	1730	57	1	72	0.0138889
NODE_912_length_2479_cov_90.381092	1658	1730	59	1	72	0.0138889
NODE_912_length_2479_cov_90.381092	1658	1730	61	1	72	0.0138889
NODE_912_length_2479_cov_90.381092	1658	1730	63	3	72	0.0416667
NODE_912_length_2479_cov_90.381092	1658	1730	64	5	72	0.0694444
NODE_912_length_2479_cov_90.381092	1658	1730	65	5	72	0.0694444
NODE_912_length_2479_cov_90.381092	1658	1730	68	3	72	0.0416667
NODE_912_length_2479_cov_90.381092	1658	1730	69	5	72	0.0694444
NODE_912_length_2479_cov_90.381092	1658	1730	70	2	72	0.0277778
NODE_912_length_2479_cov_90.381092	1658	1730	71	3	72	0.0416667
NODE_912_length_2479_cov_90.381092	1658	1730	72	1	72	0.0138889
NODE_912_length_2479_cov_90.381092	1658	1730	73	10	72	0.1388889
NODE_912_length_2479_cov_90.381092	1658	1730	74	1	72	0.0138889
NODE_912_length_2479_cov_90.381092	1658	1730	75	1	72	0.0138889
NODE_912_length_2479_cov_90.381092	1658	1730	77	4	72	0.0555556
NODE_912_length_2479_cov_90.381092	1658	1730	78	3	72	0.0416667
NODE_912_length_2479_cov_90.381092	1658	1730	79	7	72	0.0972222
NODE_912_length_2479_cov_90.381092	1658	1730	80	2	72	0.0277778
NODE_912_length_2479_cov_90.381092	1658	1730	81	6	72	0.0833333
NODE_913_length_2479_cov_3.433193	2379	2426	0	47	47	1.0000000
NODE_913_length_2479_cov_3.433193	2399	2479	0	80	80	1.0000000
NODE_915_length_2474_cov_7.237895	399	479	4	4	80	0.0500000
NODE_915_length_2474_cov_7.237895	399	479	5	1	80	0.0125000
NODE_915_length_2474_cov_7.237895	399	479	6	75	80	0.9375000
NODE_915_length_2474_cov_7.237895	452	532	2	14	80	0.1750000
NODE_915_length_2474_cov_7.237895	452	532	4	24	80	0.3000000
NODE_915_length_2474_cov_7.237895	452	532	5	16	80	0.2000000
NODE_915_length_2474_cov_7.237895	452	532	6	26	80	0.3250000
NODE_922_length_2465_cov_3.098056	2133	2213	0	80	80	1.0000000
NODE_922_length_2465_cov_3.098056	2191	2253	0	62	62	1.0000000
NODE_923_length_2464_cov_24.562791	331	409	0	31	78	0.3974359
NODE_923_length_2464_cov_24.562791	331	409	2	47	78	0.6025641
NODE_923_length_2464_cov_24.562791	382	462	2	60	80	0.7500000
NODE_923_length_2464_cov_24.562791	382	462	3	12	80	0.1500000
NODE_923_length_2464_cov_24.562791	382	462	4	8	80	0.1000000
NODE_924_length_2461_cov_2.696444	292	372	3	18	80	0.2250000
NODE_924_length_2461_cov_2.696444	292	372	4	24	80	0.3000000
NODE_924_length_2461_cov_2.696444	292	372	5	38	80	0.4750000
NODE_924_length_2461_cov_2.696444	345	425	1	6	80	0.0750000
NODE_924_length_2461_cov_2.696444	345	425	2	21	80	0.2625000
NODE_924_length_2461_cov_2.696444	345	425	3	44	80	0.5500000
NODE_924_length_2461_cov_2.696444	345	425	4	1	80	0.0125000
NODE_924_length_2461_cov_2.696444	345	425	5	8	80	0.1000000
NODE_938_length_2447_cov_16.079216	2344	2424	11	2	80	0.0250000
NODE_938_length_2447_cov_16.079216	2344	2424	15	13	80	0.1625000
NODE_938_length_2447_cov_16.079216	2344	2424	17	7	80	0.0875000
NODE_938_length_2447_cov_16.079216	2344	2424	18	10	80	0.1250000
NODE_938_length_2447_cov_16.079216	2344	2424	20	5	80	0.0625000
NODE_938_length_2447_cov_16.079216	2344	2424	21	4	80	0.0500000
NODE_938_length_2447_cov_16.079216	2344	2424	22	2	80	0.0250000
NODE_938_length_2447_cov_16.079216	2344	2424	23	3	80	0.0375000
NODE_938_length_2447_cov_16.079216	2344	2424	25	1	80	0.0125000
NODE_938_length_2447_cov_16.079216	2344	2424	26	12	80	0.1500000
NODE_938_length_2447_cov_16.079216	2344	2424	27	2	80	0.0250000
NODE_938_length_2447_cov_16.079216	2344	2424	28	11	80	0.1375000
NODE_938_length_2447_cov_16.079216	2344	2424	29	8	80	0.1000000
NODE_938_length_2447_cov_16.079216	2397	2447	4	4	50	0.0800000
NODE_938_length_2447_cov_16.079216	2397	2447	5	6	50	0.1200000
NODE_938_length_2447_cov_16.079216	2397	2447	7	1	50	0.0200000
NODE_938_length_2447_cov_16.079216	2397	2447	8	6	50	0.1200000
NODE_938_length_2447_cov_16.079216	2397	2447	10	6	50	0.1200000
NODE_938_length_2447_cov_16.079216	2397	2447	11	2	50	0.0400000
NODE_938_length_2447_cov_16.079216	2397	2447	15	13	50	0.2600000
NODE_938_length_2447_cov_16.079216	2397	2447	17	7	50	0.1400000
NODE_938_length_2447_cov_16.079216	2397	2447	18	5	50	0.1000000
NODE_940_length_2446_cov_2.341287	1521	1578	0	57	57	1.0000000
NODE_940_length_2446_cov_2.341287	1551	1593	0	42	42	1.0000000
NODE_949_length_2437_cov_13.341745	418	498	1	12	80	0.1500000
NODE_949_length_2437_cov_13.341745	418	498	2	1	80	0.0125000
NODE_949_length_2437_cov_13.341745	418	498	3	67	80	0.8375000
NODE_949_length_2437_cov_13.341745	471	551	1	44	80	0.5500000
NODE_949_length_2437_cov_13.341745	471	551	2	4	80	0.0500000
NODE_949_length_2437_cov_13.341745	471	551	3	15	80	0.1875000
NODE_949_length_2437_cov_13.341745	471	551	4	13	80	0.1625000
NODE_949_length_2437_cov_13.341745	471	551	5	1	80	0.0125000
NODE_949_length_2437_cov_13.341745	471	551	7	2	80	0.0250000
NODE_949_length_2437_cov_13.341745	471	551	9	1	80	0.0125000
NODE_951_length_2432_cov_70.360909	1875	1955	0	2	80	0.0250000
NODE_951_length_2432_cov_70.360909	1875	1955	5	20	80	0.2500000
NODE_951_length_2432_cov_70.360909	1875	1955	8	22	80	0.2750000
NODE_951_length_2432_cov_70.360909	1875	1955	9	26	80	0.3250000
NODE_951_length_2432_cov_70.360909	1875	1955	10	10	80	0.1250000
NODE_951_length_2432_cov_70.360909	1928	2008	9	35	80	0.4375000
NODE_951_length_2432_cov_70.360909	1928	2008	10	16	80	0.2000000
NODE_951_length_2432_cov_70.360909	1928	2008	11	28	80	0.3500000
NODE_951_length_2432_cov_70.360909	1928	2008	12	1	80	0.0125000
NODE_955_length_2430_cov_19.835264	0	68	11	2	68	0.0294118
NODE_955_length_2430_cov_19.835264	0	68	15	4	68	0.0588235
NODE_955_length_2430_cov_19.835264	0	68	18	5	68	0.0735294
NODE_955_length_2430_cov_19.835264	0	68	19	1	68	0.0147059
NODE_955_length_2430_cov_19.835264	0	68	24	3	68	0.0441176
NODE_955_length_2430_cov_19.835264	0	68	25	3	68	0.0441176
NODE_955_length_2430_cov_19.835264	0	68	27	6	68	0.0882353
NODE_955_length_2430_cov_19.835264	0	68	28	12	68	0.1764706
NODE_955_length_2430_cov_19.835264	0	68	30	1	68	0.0147059
NODE_955_length_2430_cov_19.835264	0	68	31	1	68	0.0147059
NODE_955_length_2430_cov_19.835264	0	68	33	6	68	0.0882353
NODE_955_length_2430_cov_19.835264	0	68	34	3	68	0.0441176
NODE_955_length_2430_cov_19.835264	0	68	36	3	68	0.0441176
NODE_955_length_2430_cov_19.835264	0	68	38	2	68	0.0294118
NODE_955_length_2430_cov_19.835264	0	68	39	1	68	0.0147059
NODE_955_length_2430_cov_19.835264	0	68	40	6	68	0.0882353
NODE_955_length_2430_cov_19.835264	0	68	42	3	68	0.0441176
NODE_955_length_2430_cov_19.835264	0	68	43	1	68	0.0147059
NODE_955_length_2430_cov_19.835264	0	68	45	4	68	0.0588235
NODE_955_length_2430_cov_19.835264	0	68	46	1	68	0.0147059
NODE_955_length_2430_cov_19.835264	0	24	11	2	24	0.0833333
NODE_955_length_2430_cov_19.835264	0	24	15	4	24	0.1666667
NODE_955_length_2430_cov_19.835264	0	24	18	5	24	0.2083333
NODE_955_length_2430_cov_19.835264	0	24	19	1	24	0.0416667
NODE_955_length_2430_cov_19.835264	0	24	24	3	24	0.1250000
NODE_955_length_2430_cov_19.835264	0	24	25	3	24	0.1250000
NODE_955_length_2430_cov_19.835264	0	24	27	6	24	0.2500000
NODE_956_length_2428_cov_179.842422	538	618	9	9	80	0.1125000
NODE_956_length_2428_cov_179.842422	538	618	10	1	80	0.0125000
NODE_956_length_2428_cov_179.842422	538	618	11	2	80	0.0250000
NODE_956_length_2428_cov_179.842422	538	618	15	8	80	0.1000000
NODE_956_length_2428_cov_179.842422	538	618	16	59	80	0.7375000
NODE_956_length_2428_cov_179.842422	538	618	17	1	80	0.0125000
NODE_956_length_2428_cov_179.842422	591	671	5	10	80	0.1250000
NODE_956_length_2428_cov_179.842422	591	671	6	16	80	0.2000000
NODE_956_length_2428_cov_179.842422	591	671	7	24	80	0.3000000
NODE_956_length_2428_cov_179.842422	591	671	8	1	80	0.0125000
NODE_956_length_2428_cov_179.842422	591	671	9	11	80	0.1375000
NODE_956_length_2428_cov_179.842422	591	671	10	1	80	0.0125000
NODE_956_length_2428_cov_179.842422	591	671	11	2	80	0.0250000
NODE_956_length_2428_cov_179.842422	591	671	15	8	80	0.1000000
NODE_956_length_2428_cov_179.842422	591	671	16	7	80	0.0875000
NODE_956_length_2428_cov_179.842422	667	747	5	12	80	0.1500000
NODE_956_length_2428_cov_179.842422	667	747	6	41	80	0.5125000
NODE_956_length_2428_cov_179.842422	667	747	7	27	80	0.3375000
NODE_956_length_2428_cov_179.842422	720	800	3	12	80	0.1500000
NODE_956_length_2428_cov_179.842422	720	800	4	8	80	0.1000000
NODE_956_length_2428_cov_179.842422	720	800	5	1	80	0.0125000
NODE_956_length_2428_cov_179.842422	720	800	6	40	80	0.5000000
NODE_956_length_2428_cov_179.842422	720	800	7	19	80	0.2375000
NODE_956_length_2428_cov_179.842422	1308	1388	0	29	80	0.3625000
NODE_956_length_2428_cov_179.842422	1308	1388	1	51	80	0.6375000
NODE_956_length_2428_cov_179.842422	1361	1441	1	28	80	0.3500000
NODE_956_length_2428_cov_179.842422	1361	1441	2	33	80	0.4125000
NODE_956_length_2428_cov_179.842422	1361	1441	6	19	80	0.2375000
NODE_956_length_2428_cov_179.842422	1437	1517	5	30	80	0.3750000
NODE_956_length_2428_cov_179.842422	1437	1517	6	50	80	0.6250000
NODE_956_length_2428_cov_179.842422	1490	1570	1	28	80	0.3500000
NODE_956_length_2428_cov_179.842422	1490	1570	2	3	80	0.0375000
NODE_956_length_2428_cov_179.842422	1490	1570	3	19	80	0.2375000
NODE_956_length_2428_cov_179.842422	1490	1570	5	30	80	0.3750000
NODE_956_length_2428_cov_179.842422	1986	2026	151	3	40	0.0750000
NODE_956_length_2428_cov_179.842422	1986	2026	152	4	40	0.1000000
NODE_956_length_2428_cov_179.842422	1986	2026	154	1	40	0.0250000
NODE_956_length_2428_cov_179.842422	1986	2026	155	1	40	0.0250000
NODE_956_length_2428_cov_179.842422	1986	2026	156	2	40	0.0500000
NODE_956_length_2428_cov_179.842422	1986	2026	157	5	40	0.1250000
NODE_956_length_2428_cov_179.842422	1986	2026	163	1	40	0.0250000
NODE_956_length_2428_cov_179.842422	1986	2026	165	1	40	0.0250000
NODE_956_length_2428_cov_179.842422	1986	2026	167	1	40	0.0250000
NODE_956_length_2428_cov_179.842422	1986	2026	171	2	40	0.0500000
NODE_956_length_2428_cov_179.842422	1986	2026	173	1	40	0.0250000
NODE_956_length_2428_cov_179.842422	1986	2026	174	5	40	0.1250000
NODE_956_length_2428_cov_179.842422	1986	2026	176	2	40	0.0500000
NODE_956_length_2428_cov_179.842422	1986	2026	178	1	40	0.0250000
NODE_956_length_2428_cov_179.842422	1986	2026	179	1	40	0.0250000
NODE_956_length_2428_cov_179.842422	1986	2026	180	2	40	0.0500000
NODE_956_length_2428_cov_179.842422	1986	2026	182	1	40	0.0250000
NODE_956_length_2428_cov_179.842422	1986	2026	185	1	40	0.0250000
NODE_956_length_2428_cov_179.842422	1986	2026	189	1	40	0.0250000
NODE_956_length_2428_cov_179.842422	1986	2026	195	1	40	0.0250000
NODE_956_length_2428_cov_179.842422	1986	2026	199	1	40	0.0250000
NODE_956_length_2428_cov_179.842422	1986	2026	201	1	40	0.0250000
NODE_956_length_2428_cov_179.842422	1986	2026	205	1	40	0.0250000
NODE_959_length_2422_cov_6.665088	197	255	0	56	58	0.9655172
NODE_959_length_2422_cov_6.665088	197	255	4	2	58	0.0344828
NODE_963_length_2414_cov_32.871706	411	491	3	9	80	0.1125000
NODE_963_length_2414_cov_32.871706	411	491	4	13	80	0.1625000
NODE_963_length_2414_cov_32.871706	411	491	5	34	80	0.4250000
NODE_963_length_2414_cov_32.871706	411	491	6	24	80	0.3000000
NODE_963_length_2414_cov_32.871706	464	544	4	24	80	0.3000000
NODE_963_length_2414_cov_32.871706	464	544	5	42	80	0.5250000
NODE_963_length_2414_cov_32.871706	464	544	6	14	80	0.1750000
NODE_964_length_2414_cov_2.105832	2349	2390	0	41	41	1.0000000
NODE_968_length_2410_cov_9.107313	1874	1954	4	11	80	0.1375000
NODE_968_length_2410_cov_9.107313	1874	1954	5	4	80	0.0500000
NODE_968_length_2410_cov_9.107313	1874	1954	7	65	80	0.8125000
NODE_968_length_2410_cov_9.107313	1927	2007	2	3	80	0.0375000
NODE_968_length_2410_cov_9.107313	1927	2007	3	6	80	0.0750000
NODE_968_length_2410_cov_9.107313	1927	2007	4	14	80	0.1750000
NODE_968_length_2410_cov_9.107313	1927	2007	5	1	80	0.0125000
NODE_968_length_2410_cov_9.107313	1927	2007	6	2	80	0.0250000
NODE_968_length_2410_cov_9.107313	1927	2007	7	54	80	0.6750000
NODE_977_length_2390_cov_20.371454	1753	1833	8	8	80	0.1000000
NODE_977_length_2390_cov_20.371454	1753	1833	9	38	80	0.4750000
NODE_977_length_2390_cov_20.371454	1753	1833	10	34	80	0.4250000
NODE_977_length_2390_cov_20.371454	1806	1886	2	24	80	0.3000000
NODE_977_length_2390_cov_20.371454	1806	1886	4	10	80	0.1250000
NODE_977_length_2390_cov_20.371454	1806	1886	5	1	80	0.0125000
NODE_977_length_2390_cov_20.371454	1806	1886	6	11	80	0.1375000
NODE_977_length_2390_cov_20.371454	1806	1886	8	15	80	0.1875000
NODE_977_length_2390_cov_20.371454	1806	1886	9	19	80	0.2375000
NODE_979_length_2389_cov_17.904803	1601	1681	3	22	80	0.2750000
NODE_979_length_2389_cov_17.904803	1601	1681	4	19	80	0.2375000
NODE_979_length_2389_cov_17.904803	1601	1681	6	1	80	0.0125000
NODE_979_length_2389_cov_17.904803	1601	1681	7	34	80	0.4250000
NODE_979_length_2389_cov_17.904803	1601	1681	8	1	80	0.0125000
NODE_979_length_2389_cov_17.904803	1601	1681	9	3	80	0.0375000
NODE_979_length_2389_cov_17.904803	1654	1734	7	23	80	0.2875000
NODE_979_length_2389_cov_17.904803	1654	1734	8	1	80	0.0125000
NODE_979_length_2389_cov_17.904803	1654	1734	9	4	80	0.0500000
NODE_979_length_2389_cov_17.904803	1654	1734	10	51	80	0.6375000
NODE_979_length_2389_cov_17.904803	1654	1734	11	1	80	0.0125000
NODE_979_length_2389_cov_17.904803	1730	1810	6	19	80	0.2375000
NODE_979_length_2389_cov_17.904803	1730	1810	9	31	80	0.3875000
NODE_979_length_2389_cov_17.904803	1730	1810	10	24	80	0.3000000
NODE_979_length_2389_cov_17.904803	1730	1810	11	6	80	0.0750000
NODE_979_length_2389_cov_17.904803	1783	1863	2	9	80	0.1125000
NODE_979_length_2389_cov_17.904803	1783	1863	3	23	80	0.2875000
NODE_979_length_2389_cov_17.904803	1783	1863	4	5	80	0.0625000
NODE_979_length_2389_cov_17.904803	1783	1863	5	2	80	0.0250000
NODE_979_length_2389_cov_17.904803	1783	1863	6	33	80	0.4125000
NODE_979_length_2389_cov_17.904803	1783	1863	9	4	80	0.0500000
NODE_979_length_2389_cov_17.904803	1783	1863	10	4	80	0.0500000
NODE_988_length_2381_cov_32.280894	398	478	9	3	80	0.0375000
NODE_988_length_2381_cov_32.280894	398	478	10	27	80	0.3375000
NODE_988_length_2381_cov_32.280894	398	478	12	25	80	0.3125000
NODE_988_length_2381_cov_32.280894	398	478	13	21	80	0.2625000
NODE_988_length_2381_cov_32.280894	398	478	14	4	80	0.0500000
NODE_988_length_2381_cov_32.280894	451	531	10	37	80	0.4625000
NODE_988_length_2381_cov_32.280894	451	531	11	5	80	0.0625000
NODE_988_length_2381_cov_32.280894	451	531	12	31	80	0.3875000
NODE_988_length_2381_cov_32.280894	451	531	13	7	80	0.0875000
NODE_988_length_2381_cov_32.280894	527	607	4	11	80	0.1375000
NODE_988_length_2381_cov_32.280894	527	607	5	13	80	0.1625000
NODE_988_length_2381_cov_32.280894	527	607	6	5	80	0.0625000
NODE_988_length_2381_cov_32.280894	527	607	7	5	80	0.0625000
NODE_988_length_2381_cov_32.280894	527	607	8	23	80	0.2875000
NODE_988_length_2381_cov_32.280894	527	607	9	12	80	0.1500000
NODE_988_length_2381_cov_32.280894	527	607	10	11	80	0.1375000
NODE_988_length_2381_cov_32.280894	580	660	4	17	80	0.2125000
NODE_988_length_2381_cov_32.280894	580	660	5	60	80	0.7500000
NODE_988_length_2381_cov_32.280894	580	660	6	3	80	0.0375000
NODE_988_length_2381_cov_32.280894	2288	2368	0	80	80	1.0000000
NODE_997_length_2369_cov_4.896916	241	321	4	16	80	0.2000000
NODE_997_length_2369_cov_4.896916	241	321	5	20	80	0.2500000
NODE_997_length_2369_cov_4.896916	241	321	9	44	80	0.5500000
NODE_997_length_2369_cov_4.896916	294	374	5	52	80	0.6500000
NODE_997_length_2369_cov_4.896916	294	374	9	28	80	0.3500000
NODE_1002_length_2364_cov_2.482561	0	79	0	79	79	1.0000000
NODE_1004_length_2360_cov_8.620080	587	651	1	18	64	0.2812500
NODE_1004_length_2360_cov_8.620080	587	651	2	22	64	0.3437500
NODE_1004_length_2360_cov_8.620080	587	651	3	18	64	0.2812500
NODE_1004_length_2360_cov_8.620080	587	651	4	6	64	0.0937500
NODE_1004_length_2360_cov_8.620080	587	651	1	18	64	0.2812500
NODE_1004_length_2360_cov_8.620080	587	651	2	22	64	0.3437500
NODE_1004_length_2360_cov_8.620080	587	651	3	18	64	0.2812500
NODE_1004_length_2360_cov_8.620080	587	651	4	6	64	0.0937500
NODE_1004_length_2360_cov_8.620080	624	684	2	3	60	0.0500000
NODE_1004_length_2360_cov_8.620080	624	684	3	51	60	0.8500000
NODE_1004_length_2360_cov_8.620080	624	684	4	6	60	0.1000000
NODE_1004_length_2360_cov_8.620080	1827	1907	4	8	80	0.1000000
NODE_1004_length_2360_cov_8.620080	1827	1907	5	6	80	0.0750000
NODE_1004_length_2360_cov_8.620080	1827	1907	6	37	80	0.4625000
NODE_1004_length_2360_cov_8.620080	1827	1907	8	16	80	0.2000000
NODE_1004_length_2360_cov_8.620080	1827	1907	10	1	80	0.0125000
NODE_1004_length_2360_cov_8.620080	1827	1907	11	3	80	0.0375000
NODE_1004_length_2360_cov_8.620080	1827	1907	12	4	80	0.0500000
NODE_1004_length_2360_cov_8.620080	1827	1907	13	5	80	0.0625000
NODE_1004_length_2360_cov_8.620080	1880	1960	8	14	80	0.1750000
NODE_1004_length_2360_cov_8.620080	1880	1960	10	1	80	0.0125000
NODE_1004_length_2360_cov_8.620080	1880	1960	11	32	80	0.4000000
NODE_1004_length_2360_cov_8.620080	1880	1960	12	4	80	0.0500000
NODE_1004_length_2360_cov_8.620080	1880	1960	13	7	80	0.0875000
NODE_1004_length_2360_cov_8.620080	1880	1960	14	22	80	0.2750000
NODE_1005_length_2359_cov_22.317257	958	1038	2	2	80	0.0250000
NODE_1005_length_2359_cov_22.317257	958	1038	4	51	80	0.6375000
NODE_1005_length_2359_cov_22.317257	958	1038	5	2	80	0.0250000
NODE_1005_length_2359_cov_22.317257	958	1038	6	25	80	0.3125000
NODE_1005_length_2359_cov_22.317257	1011	1091	4	50	80	0.6250000
NODE_1005_length_2359_cov_22.317257	1011	1091	5	30	80	0.3750000
NODE_1008_length_2357_cov_25.711249	716	796	9	3	80	0.0375000
NODE_1008_length_2357_cov_25.711249	716	796	10	13	80	0.1625000
NODE_1008_length_2357_cov_25.711249	716	796	11	14	80	0.1750000
NODE_1008_length_2357_cov_25.711249	716	796	12	2	80	0.0250000
NODE_1008_length_2357_cov_25.711249	716	796	15	3	80	0.0375000
NODE_1008_length_2357_cov_25.711249	716	796	16	17	80	0.2125000
NODE_1008_length_2357_cov_25.711249	716	796	20	4	80	0.0500000
NODE_1008_length_2357_cov_25.711249	716	796	22	4	80	0.0500000
NODE_1008_length_2357_cov_25.711249	716	796	23	3	80	0.0375000
NODE_1008_length_2357_cov_25.711249	716	796	24	7	80	0.0875000
NODE_1008_length_2357_cov_25.711249	716	796	25	7	80	0.0875000
NODE_1008_length_2357_cov_25.711249	716	796	26	3	80	0.0375000
NODE_1008_length_2357_cov_25.711249	769	849	17	9	80	0.1125000
NODE_1008_length_2357_cov_25.711249	769	849	18	2	80	0.0250000
NODE_1008_length_2357_cov_25.711249	769	849	19	2	80	0.0250000
NODE_1008_length_2357_cov_25.711249	769	849	20	5	80	0.0625000
NODE_1008_length_2357_cov_25.711249	769	849	22	14	80	0.1750000
NODE_1008_length_2357_cov_25.711249	769	849	23	14	80	0.1750000
NODE_1008_length_2357_cov_25.711249	769	849	24	24	80	0.3000000
NODE_1008_length_2357_cov_25.711249	769	849	25	7	80	0.0875000
NODE_1008_length_2357_cov_25.711249	769	849	26	3	80	0.0375000
NODE_1015_length_2345_cov_5.386465	1845	1925	0	23	80	0.2875000
NODE_1015_length_2345_cov_5.386465	1845	1925	1	2	80	0.0250000
NODE_1015_length_2345_cov_5.386465	1845	1925	2	36	80	0.4500000
NODE_1015_length_2345_cov_5.386465	1845	1925	4	3	80	0.0375000
NODE_1015_length_2345_cov_5.386465	1845	1925	5	16	80	0.2000000
NODE_1015_length_2345_cov_5.386465	1898	1978	2	8	80	0.1000000
NODE_1015_length_2345_cov_5.386465	1898	1978	4	3	80	0.0375000
NODE_1015_length_2345_cov_5.386465	1898	1978	5	69	80	0.8625000
NODE_1016_length_2344_cov_6.236526	1208	1269	3	16	61	0.2622951
NODE_1016_length_2344_cov_6.236526	1208	1269	4	4	61	0.0655738
NODE_1016_length_2344_cov_6.236526	1208	1269	5	38	61	0.6229508
NODE_1016_length_2344_cov_6.236526	1208	1269	6	3	61	0.0491803
NODE_1016_length_2344_cov_6.236526	1208	1269	3	16	61	0.2622951
NODE_1016_length_2344_cov_6.236526	1208	1269	4	4	61	0.0655738
NODE_1016_length_2344_cov_6.236526	1208	1269	5	38	61	0.6229508
NODE_1016_length_2344_cov_6.236526	1208	1269	6	3	61	0.0491803
NODE_1016_length_2344_cov_6.236526	1208	1269	3	16	61	0.2622951
NODE_1016_length_2344_cov_6.236526	1208	1269	4	4	61	0.0655738
NODE_1016_length_2344_cov_6.236526	1208	1269	5	38	61	0.6229508
NODE_1016_length_2344_cov_6.236526	1208	1269	6	3	61	0.0491803
NODE_1016_length_2344_cov_6.236526	1208	1267	3	14	59	0.2372881
NODE_1016_length_2344_cov_6.236526	1208	1267	4	4	59	0.0677966
NODE_1016_length_2344_cov_6.236526	1208	1267	5	38	59	0.6440678
NODE_1016_length_2344_cov_6.236526	1208	1267	6	3	59	0.0508475
NODE_1023_length_2332_cov_4.725929	34	101	0	64	67	0.9552239
NODE_1023_length_2332_cov_4.725929	34	101	1	1	67	0.0149254
NODE_1023_length_2332_cov_4.725929	34	101	2	2	67	0.0298507
NODE_1027_length_2327_cov_18.210952	2213	2293	1	37	80	0.4625000
NODE_1027_length_2327_cov_18.210952	2213	2293	2	14	80	0.1750000
NODE_1027_length_2327_cov_18.210952	2213	2293	3	29	80	0.3625000
NODE_1027_length_2327_cov_18.210952	2266	2327	2	48	61	0.7868853
NODE_1027_length_2327_cov_18.210952	2266	2327	3	13	61	0.2131148
NODE_1028_length_2326_cov_15.583745	1709	1789	12	6	80	0.0750000
NODE_1028_length_2326_cov_15.583745	1709	1789	14	9	80	0.1125000
NODE_1028_length_2326_cov_15.583745	1709	1789	18	24	80	0.3000000
NODE_1028_length_2326_cov_15.583745	1709	1789	21	4	80	0.0500000
NODE_1028_length_2326_cov_15.583745	1709	1789	22	4	80	0.0500000
NODE_1028_length_2326_cov_15.583745	1709	1789	24	2	80	0.0250000
NODE_1028_length_2326_cov_15.583745	1709	1789	27	15	80	0.1875000
NODE_1028_length_2326_cov_15.583745	1709	1789	28	9	80	0.1125000
NODE_1028_length_2326_cov_15.583745	1709	1789	29	1	80	0.0125000
NODE_1028_length_2326_cov_15.583745	1709	1789	34	6	80	0.0750000
NODE_1028_length_2326_cov_15.583745	1762	1842	26	2	80	0.0250000
NODE_1028_length_2326_cov_15.583745	1762	1842	27	11	80	0.1375000
NODE_1028_length_2326_cov_15.583745	1762	1842	28	9	80	0.1125000
NODE_1028_length_2326_cov_15.583745	1762	1842	29	2	80	0.0250000
NODE_1028_length_2326_cov_15.583745	1762	1842	30	8	80	0.1000000
NODE_1028_length_2326_cov_15.583745	1762	1842	32	16	80	0.2000000
NODE_1028_length_2326_cov_15.583745	1762	1842	33	2	80	0.0250000
NODE_1028_length_2326_cov_15.583745	1762	1842	34	29	80	0.3625000
NODE_1028_length_2326_cov_15.583745	1762	1842	36	1	80	0.0125000
NODE_1030_length_2325_cov_14.998652	553	633	1	80	80	1.0000000
NODE_1030_length_2325_cov_14.998652	606	686	0	20	80	0.2500000
NODE_1030_length_2325_cov_14.998652	606	686	1	60	80	0.7500000
NODE_1034_length_2317_cov_11.956718	920	1000	6	15	80	0.1875000
NODE_1034_length_2317_cov_11.956718	920	1000	8	8	80	0.1000000
NODE_1034_length_2317_cov_11.956718	920	1000	9	3	80	0.0375000
NODE_1034_length_2317_cov_11.956718	920	1000	10	54	80	0.6750000
NODE_1034_length_2317_cov_11.956718	973	1053	2	6	80	0.0750000
NODE_1034_length_2317_cov_11.956718	973	1053	3	30	80	0.3750000
NODE_1034_length_2317_cov_11.956718	973	1053	4	3	80	0.0375000
NODE_1034_length_2317_cov_11.956718	973	1053	5	12	80	0.1500000
NODE_1034_length_2317_cov_11.956718	973	1053	6	17	80	0.2125000
NODE_1034_length_2317_cov_11.956718	973	1053	8	8	80	0.1000000
NODE_1034_length_2317_cov_11.956718	973	1053	9	3	80	0.0375000
NODE_1034_length_2317_cov_11.956718	973	1053	10	1	80	0.0125000
NODE_1034_length_2317_cov_11.956718	1049	1129	1	18	80	0.2250000
NODE_1034_length_2317_cov_11.956718	1049	1129	2	12	80	0.1500000
NODE_1034_length_2317_cov_11.956718	1049	1129	3	50	80	0.6250000
NODE_1034_length_2317_cov_11.956718	1102	1184	3	77	82	0.9390244
NODE_1034_length_2317_cov_11.956718	1102	1184	4	5	82	0.0609756
NODE_1037_length_2316_cov_8.556608	168	247	30	1	79	0.0126582
NODE_1037_length_2316_cov_8.556608	168	247	32	1	79	0.0126582
NODE_1037_length_2316_cov_8.556608	168	247	33	4	79	0.0506329
NODE_1037_length_2316_cov_8.556608	168	247	35	1	79	0.0126582
NODE_1037_length_2316_cov_8.556608	168	247	37	8	79	0.1012658
NODE_1037_length_2316_cov_8.556608	168	247	38	3	79	0.0379747
NODE_1037_length_2316_cov_8.556608	168	247	39	4	79	0.0506329
NODE_1037_length_2316_cov_8.556608	168	247	40	8	79	0.1012658
NODE_1037_length_2316_cov_8.556608	168	247	41	3	79	0.0379747
NODE_1037_length_2316_cov_8.556608	168	247	42	6	79	0.0759494
NODE_1037_length_2316_cov_8.556608	168	247	43	8	79	0.1012658
NODE_1037_length_2316_cov_8.556608	168	247	44	9	79	0.1139240
NODE_1037_length_2316_cov_8.556608	168	247	45	5	79	0.0632911
NODE_1037_length_2316_cov_8.556608	168	247	46	11	79	0.1392405
NODE_1037_length_2316_cov_8.556608	168	247	47	6	79	0.0759494
NODE_1037_length_2316_cov_8.556608	168	247	48	1	79	0.0126582
NODE_1037_length_2316_cov_8.556608	1117	1198	8	12	81	0.1481481
NODE_1037_length_2316_cov_8.556608	1117	1198	9	5	81	0.0617284
NODE_1037_length_2316_cov_8.556608	1117	1198	11	19	81	0.2345679
NODE_1037_length_2316_cov_8.556608	1117	1198	12	25	81	0.3086420
NODE_1037_length_2316_cov_8.556608	1117	1198	13	5	81	0.0617284
NODE_1037_length_2316_cov_8.556608	1117	1198	14	15	81	0.1851852
NODE_1037_length_2316_cov_8.556608	1369	1412	33	3	43	0.0697674
NODE_1037_length_2316_cov_8.556608	1369	1412	34	4	43	0.0930233
NODE_1037_length_2316_cov_8.556608	1369	1412	35	5	43	0.1162791
NODE_1037_length_2316_cov_8.556608	1369	1412	36	7	43	0.1627907
NODE_1037_length_2316_cov_8.556608	1369	1412	37	2	43	0.0465116
NODE_1037_length_2316_cov_8.556608	1369	1412	38	2	43	0.0465116
NODE_1037_length_2316_cov_8.556608	1369	1412	39	3	43	0.0697674
NODE_1037_length_2316_cov_8.556608	1369	1412	40	1	43	0.0232558
NODE_1037_length_2316_cov_8.556608	1369	1412	41	1	43	0.0232558
NODE_1037_length_2316_cov_8.556608	1369	1412	42	3	43	0.0697674
NODE_1037_length_2316_cov_8.556608	1369	1412	43	6	43	0.1395349
NODE_1037_length_2316_cov_8.556608	1369	1412	45	2	43	0.0465116
NODE_1037_length_2316_cov_8.556608	1369	1412	46	1	43	0.0232558
NODE_1037_length_2316_cov_8.556608	1369	1412	47	3	43	0.0697674
NODE_1040_length_2311_cov_2.821881	2121	2201	0	80	80	1.0000000
NODE_1040_length_2311_cov_2.821881	2174	2225	0	51	51	1.0000000
NODE_1044_length_2306_cov_17.347984	995	1075	4	2	80	0.0250000
NODE_1044_length_2306_cov_17.347984	995	1075	5	10	80	0.1250000
NODE_1044_length_2306_cov_17.347984	995	1075	7	8	80	0.1000000
NODE_1044_length_2306_cov_17.347984	995	1075	8	1	80	0.0125000
NODE_1044_length_2306_cov_17.347984	995	1075	10	13	80	0.1625000
NODE_1044_length_2306_cov_17.347984	995	1075	13	40	80	0.5000000
NODE_1044_length_2306_cov_17.347984	995	1075	14	6	80	0.0750000
NODE_1044_length_2306_cov_17.347984	1048	1128	8	4	80	0.0500000
NODE_1044_length_2306_cov_17.347984	1048	1128	10	18	80	0.2250000
NODE_1044_length_2306_cov_17.347984	1048	1128	12	14	80	0.1750000
NODE_1044_length_2306_cov_17.347984	1048	1128	13	32	80	0.4000000
NODE_1044_length_2306_cov_17.347984	1048	1128	14	12	80	0.1500000
NODE_1052_length_2300_cov_9.803271	934	1014	0	80	80	1.0000000
NODE_1052_length_2300_cov_9.803271	1892	1965	0	73	73	1.0000000
NODE_1059_length_2289_cov_17.807306	968	1026	42	4	58	0.0689655
NODE_1059_length_2289_cov_17.807306	968	1026	43	11	58	0.1896552
NODE_1059_length_2289_cov_17.807306	968	1026	44	22	58	0.3793103
NODE_1059_length_2289_cov_17.807306	968	1026	45	18	58	0.3103448
NODE_1059_length_2289_cov_17.807306	968	1026	46	1	58	0.0172414
NODE_1059_length_2289_cov_17.807306	968	1026	47	2	58	0.0344828
NODE_1059_length_2289_cov_17.807306	1021	1079	28	1	58	0.0172414
NODE_1059_length_2289_cov_17.807306	1021	1079	29	1	58	0.0172414
NODE_1059_length_2289_cov_17.807306	1021	1079	31	1	58	0.0172414
NODE_1059_length_2289_cov_17.807306	1021	1079	34	1	58	0.0172414
NODE_1059_length_2289_cov_17.807306	1021	1079	36	4	58	0.0689655
NODE_1059_length_2289_cov_17.807306	1021	1079	37	2	58	0.0344828
NODE_1059_length_2289_cov_17.807306	1021	1079	38	6	58	0.1034483
NODE_1059_length_2289_cov_17.807306	1021	1079	39	6	58	0.1034483
NODE_1059_length_2289_cov_17.807306	1021	1079	40	20	58	0.3448276
NODE_1059_length_2289_cov_17.807306	1021	1079	41	2	58	0.0344828
NODE_1059_length_2289_cov_17.807306	1021	1079	42	1	58	0.0172414
NODE_1059_length_2289_cov_17.807306	1021	1079	43	4	58	0.0689655
NODE_1059_length_2289_cov_17.807306	1021	1079	44	6	58	0.1034483
NODE_1059_length_2289_cov_17.807306	1021	1079	46	1	58	0.0172414
NODE_1059_length_2289_cov_17.807306	1021	1079	47	2	58	0.0344828
NODE_1060_length_2289_cov_7.736986	2161	2218	3	1	57	0.0175439
NODE_1060_length_2289_cov_7.736986	2161	2218	5	2	57	0.0350877
NODE_1060_length_2289_cov_7.736986	2161	2218	6	2	57	0.0350877
NODE_1060_length_2289_cov_7.736986	2161	2218	7	7	57	0.1228070
NODE_1060_length_2289_cov_7.736986	2161	2218	8	1	57	0.0175439
NODE_1060_length_2289_cov_7.736986	2161	2218	10	7	57	0.1228070
NODE_1060_length_2289_cov_7.736986	2161	2218	12	37	57	0.6491228
NODE_1060_length_2289_cov_7.736986	2191	2271	8	14	80	0.1750000
NODE_1060_length_2289_cov_7.736986	2191	2271	12	66	80	0.8250000
NODE_1061_length_2288_cov_8.539973	340	420	0	53	80	0.6625000
NODE_1061_length_2288_cov_8.539973	340	420	2	21	80	0.2625000
NODE_1061_length_2288_cov_8.539973	340	420	3	6	80	0.0750000
NODE_1061_length_2288_cov_8.539973	393	473	0	76	80	0.9500000
NODE_1061_length_2288_cov_8.539973	393	473	1	1	80	0.0125000
NODE_1061_length_2288_cov_8.539973	393	473	2	3	80	0.0375000
NODE_1065_length_2278_cov_19.655805	450	530	10	6	80	0.0750000
NODE_1065_length_2278_cov_19.655805	450	530	11	19	80	0.2375000
NODE_1065_length_2278_cov_19.655805	450	530	12	27	80	0.3375000
NODE_1065_length_2278_cov_19.655805	450	530	13	1	80	0.0125000
NODE_1065_length_2278_cov_19.655805	450	530	14	27	80	0.3375000
NODE_1065_length_2278_cov_19.655805	503	583	11	9	80	0.1125000
NODE_1065_length_2278_cov_19.655805	503	583	12	1	80	0.0125000
NODE_1065_length_2278_cov_19.655805	503	583	13	18	80	0.2250000
NODE_1065_length_2278_cov_19.655805	503	583	14	52	80	0.6500000
NODE_1065_length_2278_cov_19.655805	579	659	9	6	80	0.0750000
NODE_1065_length_2278_cov_19.655805	579	659	10	16	80	0.2000000
NODE_1065_length_2278_cov_19.655805	579	659	11	15	80	0.1875000
NODE_1065_length_2278_cov_19.655805	579	659	12	36	80	0.4500000
NODE_1065_length_2278_cov_19.655805	579	659	13	7	80	0.0875000
NODE_1065_length_2278_cov_19.655805	632	712	9	25	80	0.3125000
NODE_1065_length_2278_cov_19.655805	632	712	10	7	80	0.0875000
NODE_1065_length_2278_cov_19.655805	632	712	11	29	80	0.3625000
NODE_1065_length_2278_cov_19.655805	632	712	12	14	80	0.1750000
NODE_1065_length_2278_cov_19.655805	632	712	13	5	80	0.0625000
NODE_1071_length_2272_cov_26.123792	226	306	0	2	80	0.0250000
NODE_1071_length_2272_cov_26.123792	226	306	1	78	80	0.9750000
NODE_1071_length_2272_cov_26.123792	279	359	1	80	80	1.0000000
NODE_1071_length_2272_cov_26.123792	1684	1731	5	1	47	0.0212766
NODE_1071_length_2272_cov_26.123792	1684	1731	6	1	47	0.0212766
NODE_1071_length_2272_cov_26.123792	1684	1731	13	1	47	0.0212766
NODE_1071_length_2272_cov_26.123792	1684	1731	17	1	47	0.0212766
NODE_1071_length_2272_cov_26.123792	1684	1731	22	1	47	0.0212766
NODE_1071_length_2272_cov_26.123792	1684	1731	25	2	47	0.0425532
NODE_1071_length_2272_cov_26.123792	1684	1731	26	2	47	0.0425532
NODE_1071_length_2272_cov_26.123792	1684	1731	28	3	47	0.0638298
NODE_1071_length_2272_cov_26.123792	1684	1731	30	3	47	0.0638298
NODE_1071_length_2272_cov_26.123792	1684	1731	33	3	47	0.0638298
NODE_1071_length_2272_cov_26.123792	1684	1731	34	2	47	0.0425532
NODE_1071_length_2272_cov_26.123792	1684	1731	35	2	47	0.0425532
NODE_1071_length_2272_cov_26.123792	1684	1731	37	4	47	0.0851064
NODE_1071_length_2272_cov_26.123792	1684	1731	40	3	47	0.0638298
NODE_1071_length_2272_cov_26.123792	1684	1731	45	1	47	0.0212766
NODE_1071_length_2272_cov_26.123792	1684	1731	47	3	47	0.0638298
NODE_1071_length_2272_cov_26.123792	1684	1731	49	1	47	0.0212766
NODE_1071_length_2272_cov_26.123792	1684	1731	50	1	47	0.0212766
NODE_1071_length_2272_cov_26.123792	1684	1731	51	1	47	0.0212766
NODE_1071_length_2272_cov_26.123792	1684	1731	52	1	47	0.0212766
NODE_1071_length_2272_cov_26.123792	1684	1731	54	1	47	0.0212766
NODE_1071_length_2272_cov_26.123792	1684	1731	55	1	47	0.0212766
NODE_1071_length_2272_cov_26.123792	1684	1731	60	2	47	0.0425532
NODE_1071_length_2272_cov_26.123792	1684	1731	61	1	47	0.0212766
NODE_1071_length_2272_cov_26.123792	1684	1731	63	1	47	0.0212766
NODE_1071_length_2272_cov_26.123792	1684	1731	65	1	47	0.0212766
NODE_1071_length_2272_cov_26.123792	1684	1731	67	1	47	0.0212766
NODE_1071_length_2272_cov_26.123792	1684	1731	68	1	47	0.0212766
NODE_1071_length_2272_cov_26.123792	1684	1731	70	1	47	0.0212766
NODE_1071_length_2272_cov_26.123792	1694	1725	25	1	31	0.0322581
NODE_1071_length_2272_cov_26.123792	1694	1725	26	2	31	0.0645161
NODE_1071_length_2272_cov_26.123792	1694	1725	28	3	31	0.0967742
NODE_1071_length_2272_cov_26.123792	1694	1725	30	3	31	0.0967742
NODE_1071_length_2272_cov_26.123792	1694	1725	33	3	31	0.0967742
NODE_1071_length_2272_cov_26.123792	1694	1725	34	2	31	0.0645161
NODE_1071_length_2272_cov_26.123792	1694	1725	35	2	31	0.0645161
NODE_1071_length_2272_cov_26.123792	1694	1725	37	4	31	0.1290323
NODE_1071_length_2272_cov_26.123792	1694	1725	40	3	31	0.0967742
NODE_1071_length_2272_cov_26.123792	1694	1725	45	1	31	0.0322581
NODE_1071_length_2272_cov_26.123792	1694	1725	47	3	31	0.0967742
NODE_1071_length_2272_cov_26.123792	1694	1725	49	1	31	0.0322581
NODE_1071_length_2272_cov_26.123792	1694	1725	50	1	31	0.0322581
NODE_1071_length_2272_cov_26.123792	1694	1725	51	1	31	0.0322581
NODE_1071_length_2272_cov_26.123792	1694	1725	52	1	31	0.0322581
NODE_1071_length_2272_cov_26.123792	1759	1833	2	24	74	0.3243243
NODE_1071_length_2272_cov_26.123792	1759	1833	3	37	74	0.5000000
NODE_1071_length_2272_cov_26.123792	1759	1833	5	13	74	0.1756757
NODE_1071_length_2272_cov_26.123792	1812	1892	2	14	80	0.1750000
NODE_1071_length_2272_cov_26.123792	1812	1892	3	8	80	0.1000000
NODE_1071_length_2272_cov_26.123792	1812	1892	4	13	80	0.1625000
NODE_1071_length_2272_cov_26.123792	1812	1892	5	45	80	0.5625000
NODE_1072_length_2272_cov_8.175334	213	293	20	35	80	0.4375000
NODE_1072_length_2272_cov_8.175334	213	293	22	19	80	0.2375000
NODE_1072_length_2272_cov_8.175334	213	293	23	13	80	0.1625000
NODE_1072_length_2272_cov_8.175334	213	293	25	1	80	0.0125000
NODE_1072_length_2272_cov_8.175334	213	293	27	12	80	0.1500000
NODE_1072_length_2272_cov_8.175334	266	346	0	2	80	0.0250000
NODE_1072_length_2272_cov_8.175334	266	346	2	2	80	0.0250000
NODE_1072_length_2272_cov_8.175334	266	346	4	2	80	0.0250000
NODE_1072_length_2272_cov_8.175334	266	346	5	3	80	0.0375000
NODE_1072_length_2272_cov_8.175334	266	346	6	1	80	0.0125000
NODE_1072_length_2272_cov_8.175334	266	346	8	3	80	0.0375000
NODE_1072_length_2272_cov_8.175334	266	346	9	5	80	0.0625000
NODE_1072_length_2272_cov_8.175334	266	346	10	1	80	0.0125000
NODE_1072_length_2272_cov_8.175334	266	346	14	15	80	0.1875000
NODE_1072_length_2272_cov_8.175334	266	346	15	4	80	0.0500000
NODE_1072_length_2272_cov_8.175334	266	346	17	7	80	0.0875000
NODE_1072_length_2272_cov_8.175334	266	346	20	35	80	0.4375000
NODE_1077_length_2266_cov_13.206276	359	439	8	12	80	0.1500000
NODE_1077_length_2266_cov_13.206276	359	439	9	5	80	0.0625000
NODE_1077_length_2266_cov_13.206276	359	439	10	5	80	0.0625000
NODE_1077_length_2266_cov_13.206276	359	439	11	14	80	0.1750000
NODE_1077_length_2266_cov_13.206276	359	439	12	44	80	0.5500000
NODE_1077_length_2266_cov_13.206276	412	492	3	4	80	0.0500000
NODE_1077_length_2266_cov_13.206276	412	492	4	24	80	0.3000000
NODE_1077_length_2266_cov_13.206276	412	492	5	1	80	0.0125000
NODE_1077_length_2266_cov_13.206276	412	492	8	34	80	0.4250000
NODE_1077_length_2266_cov_13.206276	412	492	9	5	80	0.0625000
NODE_1077_length_2266_cov_13.206276	412	492	11	12	80	0.1500000
NODE_1077_length_2266_cov_13.206276	488	568	2	9	80	0.1125000
NODE_1077_length_2266_cov_13.206276	488	568	3	6	80	0.0750000
NODE_1077_length_2266_cov_13.206276	488	568	4	23	80	0.2875000
NODE_1077_length_2266_cov_13.206276	488	568	7	42	80	0.5250000
NODE_1077_length_2266_cov_13.206276	541	627	6	3	86	0.0348837
NODE_1077_length_2266_cov_13.206276	541	627	7	83	86	0.9651163
NODE_1078_length_2262_cov_11.759131	413	493	0	80	80	1.0000000
NODE_1078_length_2262_cov_11.759131	466	546	0	80	80	1.0000000
NODE_1079_length_2260_cov_37.814901	219	299	0	80	80	1.0000000
NODE_1079_length_2260_cov_37.814901	742	822	2	80	80	1.0000000
NODE_1079_length_2260_cov_37.814901	795	875	1	34	80	0.4250000
NODE_1079_length_2260_cov_37.814901	795	875	2	46	80	0.5750000
NODE_1079_length_2260_cov_37.814901	1533	1613	11	33	80	0.4125000
NODE_1079_length_2260_cov_37.814901	1533	1613	12	1	80	0.0125000
NODE_1079_length_2260_cov_37.814901	1533	1613	13	13	80	0.1625000
NODE_1079_length_2260_cov_37.814901	1533	1613	14	8	80	0.1000000
NODE_1079_length_2260_cov_37.814901	1533	1613	15	8	80	0.1000000
NODE_1079_length_2260_cov_37.814901	1533	1613	16	17	80	0.2125000
NODE_1079_length_2260_cov_37.814901	1586	1666	10	37	80	0.4625000
NODE_1079_length_2260_cov_37.814901	1586	1666	11	20	80	0.2500000
NODE_1079_length_2260_cov_37.814901	1586	1666	13	13	80	0.1625000
NODE_1079_length_2260_cov_37.814901	1586	1666	14	4	80	0.0500000
NODE_1079_length_2260_cov_37.814901	1586	1666	15	2	80	0.0250000
NODE_1079_length_2260_cov_37.814901	1586	1666	16	4	80	0.0500000
NODE_1079_length_2260_cov_37.814901	1662	1742	2	4	80	0.0500000
NODE_1079_length_2260_cov_37.814901	1662	1742	3	26	80	0.3250000
NODE_1079_length_2260_cov_37.814901	1662	1742	4	15	80	0.1875000
NODE_1079_length_2260_cov_37.814901	1662	1742	6	15	80	0.1875000
NODE_1079_length_2260_cov_37.814901	1662	1742	7	5	80	0.0625000
NODE_1079_length_2260_cov_37.814901	1662	1742	8	5	80	0.0625000
NODE_1079_length_2260_cov_37.814901	1662	1742	10	4	80	0.0500000
NODE_1079_length_2260_cov_37.814901	1662	1742	11	6	80	0.0750000
NODE_1079_length_2260_cov_37.814901	1715	1795	1	31	80	0.3875000
NODE_1079_length_2260_cov_37.814901	1715	1795	2	26	80	0.3250000
NODE_1079_length_2260_cov_37.814901	1715	1795	3	23	80	0.2875000
NODE_1082_length_2253_cov_8.904828	472	552	7	21	80	0.2625000
NODE_1082_length_2253_cov_8.904828	472	552	9	43	80	0.5375000
NODE_1082_length_2253_cov_8.904828	472	552	10	16	80	0.2000000
NODE_1085_length_2252_cov_2.801208	1128	1170	0	42	42	1.0000000
NODE_1085_length_2252_cov_2.801208	1137	1172	0	35	35	1.0000000
NODE_1086_length_2252_cov_2.078031	13	62	0	49	49	1.0000000
NODE_1086_length_2252_cov_2.078031	13	61	0	48	48	1.0000000
NODE_1086_length_2252_cov_2.078031	13	62	0	49	49	1.0000000
NODE_1086_length_2252_cov_2.078031	13	62	0	49	49	1.0000000
NODE_1086_length_2252_cov_2.078031	13	61	0	48	48	1.0000000
NODE_1087_length_2251_cov_15.458178	1443	1506	0	7	63	0.1111111
NODE_1087_length_2251_cov_15.458178	1443	1506	2	16	63	0.2539683
NODE_1087_length_2251_cov_15.458178	1443	1506	3	15	63	0.2380952
NODE_1087_length_2251_cov_15.458178	1443	1506	4	21	63	0.3333333
NODE_1087_length_2251_cov_15.458178	1443	1506	5	1	63	0.0158730
NODE_1087_length_2251_cov_15.458178	1443	1506	6	2	63	0.0317460
NODE_1087_length_2251_cov_15.458178	1443	1506	10	1	63	0.0158730
NODE_1087_length_2251_cov_15.458178	1496	1550	3	6	54	0.1111111
NODE_1087_length_2251_cov_15.458178	1496	1550	4	3	54	0.0555556
NODE_1087_length_2251_cov_15.458178	1496	1550	5	4	54	0.0740741
NODE_1087_length_2251_cov_15.458178	1496	1550	6	1	54	0.0185185
NODE_1087_length_2251_cov_15.458178	1496	1550	8	2	54	0.0370370
NODE_1087_length_2251_cov_15.458178	1496	1550	9	4	54	0.0740741
NODE_1087_length_2251_cov_15.458178	1496	1550	11	2	54	0.0370370
NODE_1087_length_2251_cov_15.458178	1496	1550	12	9	54	0.1666667
NODE_1087_length_2251_cov_15.458178	1496	1550	14	2	54	0.0370370
NODE_1087_length_2251_cov_15.458178	1496	1550	15	8	54	0.1481481
NODE_1087_length_2251_cov_15.458178	1496	1550	17	13	54	0.2407407
NODE_1089_length_2250_cov_18.370990	1658	1738	3	9	80	0.1125000
NODE_1089_length_2250_cov_18.370990	1658	1738	4	32	80	0.4000000
NODE_1089_length_2250_cov_18.370990	1658	1738	6	39	80	0.4875000
NODE_1089_length_2250_cov_18.370990	1711	1791	1	6	80	0.0750000
NODE_1089_length_2250_cov_18.370990	1711	1791	3	56	80	0.7000000
NODE_1089_length_2250_cov_18.370990	1711	1791	4	18	80	0.2250000
NODE_1090_length_2250_cov_5.331474	1844	1924	1	5	80	0.0625000
NODE_1090_length_2250_cov_5.331474	1844	1924	7	75	80	0.9375000
NODE_1093_length_2247_cov_7.906890	364	436	1	19	72	0.2638889
NODE_1093_length_2247_cov_7.906890	364	436	2	53	72	0.7361111
NODE_1095_length_2246_cov_7.612948	1992	2055	2	59	63	0.9365079
NODE_1095_length_2246_cov_7.612948	1992	2055	3	4	63	0.0634921
NODE_1095_length_2246_cov_7.612948	2045	2108	1	32	63	0.5079365
NODE_1095_length_2246_cov_7.612948	2045	2108	2	31	63	0.4920635
NODE_1104_length_2233_cov_35.127460	1517	1597	3	11	80	0.1375000
NODE_1104_length_2233_cov_35.127460	1517	1597	4	11	80	0.1375000
NODE_1104_length_2233_cov_35.127460	1517	1597	6	58	80	0.7250000
NODE_1104_length_2233_cov_35.127460	1570	1650	3	5	80	0.0625000
NODE_1104_length_2233_cov_35.127460	1570	1650	5	28	80	0.3500000
NODE_1104_length_2233_cov_35.127460	1570	1650	6	47	80	0.5875000
NODE_1105_length_2231_cov_45.701689	315	396	3	49	81	0.6049383
NODE_1105_length_2231_cov_45.701689	315	396	4	30	81	0.3703704
NODE_1105_length_2231_cov_45.701689	315	396	6	2	81	0.0246914
NODE_1105_length_2231_cov_45.701689	369	449	0	1	80	0.0125000
NODE_1105_length_2231_cov_45.701689	369	449	1	30	80	0.3750000
NODE_1105_length_2231_cov_45.701689	369	449	2	22	80	0.2750000
NODE_1105_length_2231_cov_45.701689	369	449	3	27	80	0.3375000
NODE_1105_length_2231_cov_45.701689	496	576	0	80	80	1.0000000
NODE_1105_length_2231_cov_45.701689	582	662	0	80	80	1.0000000
NODE_1105_length_2231_cov_45.701689	625	705	0	80	80	1.0000000
NODE_1105_length_2231_cov_45.701689	711	791	0	80	80	1.0000000
NODE_1105_length_2231_cov_45.701689	1141	1186	4	45	45	1.0000000
NODE_1105_length_2231_cov_45.701689	1787	1867	0	80	80	1.0000000
NODE_1105_length_2231_cov_45.701689	1840	1920	0	80	80	1.0000000
NODE_1106_length_2230_cov_12.608634	1520	1600	0	80	80	1.0000000
NODE_1106_length_2230_cov_12.608634	1573	1653	0	80	80	1.0000000
NODE_1112_length_2218_cov_5.292591	1427	1497	6	5	70	0.0714286
NODE_1112_length_2218_cov_5.292591	1427	1497	7	1	70	0.0142857
NODE_1112_length_2218_cov_5.292591	1427	1497	8	3	70	0.0428571
NODE_1112_length_2218_cov_5.292591	1427	1497	9	23	70	0.3285714
NODE_1112_length_2218_cov_5.292591	1427	1497	11	23	70	0.3285714
NODE_1112_length_2218_cov_5.292591	1427	1497	12	15	70	0.2142857
NODE_1112_length_2218_cov_5.292591	1470	1536	6	3	66	0.0454545
NODE_1112_length_2218_cov_5.292591	1470	1536	7	8	66	0.1212121
NODE_1112_length_2218_cov_5.292591	1470	1536	8	8	66	0.1212121
NODE_1112_length_2218_cov_5.292591	1470	1536	9	8	66	0.1212121
NODE_1112_length_2218_cov_5.292591	1470	1536	10	5	66	0.0757576
NODE_1112_length_2218_cov_5.292591	1470	1536	11	22	66	0.3333333
NODE_1112_length_2218_cov_5.292591	1470	1536	12	12	66	0.1818182
NODE_1115_length_2215_cov_51.865784	108	188	0	60	80	0.7500000
NODE_1115_length_2215_cov_51.865784	108	188	2	20	80	0.2500000
NODE_1115_length_2215_cov_51.865784	161	241	0	7	80	0.0875000
NODE_1115_length_2215_cov_51.865784	161	241	2	73	80	0.9125000
NODE_1115_length_2215_cov_51.865784	237	317	0	30	80	0.3750000
NODE_1115_length_2215_cov_51.865784	237	317	2	50	80	0.6250000
NODE_1115_length_2215_cov_51.865784	290	370	0	54	80	0.6750000
NODE_1115_length_2215_cov_51.865784	290	370	1	26	80	0.3250000
NODE_1115_length_2215_cov_51.865784	1030	1102	13	1	72	0.0138889
NODE_1115_length_2215_cov_51.865784	1030	1102	19	3	72	0.0416667
NODE_1115_length_2215_cov_51.865784	1030	1102	22	3	72	0.0416667
NODE_1115_length_2215_cov_51.865784	1030	1102	28	3	72	0.0416667
NODE_1115_length_2215_cov_51.865784	1030	1102	30	4	72	0.0555556
NODE_1115_length_2215_cov_51.865784	1030	1102	32	1	72	0.0138889
NODE_1115_length_2215_cov_51.865784	1030	1102	33	2	72	0.0277778
NODE_1115_length_2215_cov_51.865784	1030	1102	34	1	72	0.0138889
NODE_1115_length_2215_cov_51.865784	1030	1102	35	1	72	0.0138889
NODE_1115_length_2215_cov_51.865784	1030	1102	37	1	72	0.0138889
NODE_1115_length_2215_cov_51.865784	1030	1102	39	3	72	0.0416667
NODE_1115_length_2215_cov_51.865784	1030	1102	41	1	72	0.0138889
NODE_1115_length_2215_cov_51.865784	1030	1102	45	1	72	0.0138889
NODE_1115_length_2215_cov_51.865784	1030	1102	46	2	72	0.0277778
NODE_1115_length_2215_cov_51.865784	1030	1102	47	12	72	0.1666667
NODE_1115_length_2215_cov_51.865784	1030	1102	49	6	72	0.0833333
NODE_1115_length_2215_cov_51.865784	1030	1102	51	1	72	0.0138889
NODE_1115_length_2215_cov_51.865784	1030	1102	52	1	72	0.0138889
NODE_1115_length_2215_cov_51.865784	1030	1102	54	1	72	0.0138889
NODE_1115_length_2215_cov_51.865784	1030	1102	55	5	72	0.0694444
NODE_1115_length_2215_cov_51.865784	1030	1102	56	1	72	0.0138889
NODE_1115_length_2215_cov_51.865784	1030	1102	58	9	72	0.1250000
NODE_1115_length_2215_cov_51.865784	1030	1102	59	8	72	0.1111111
NODE_1115_length_2215_cov_51.865784	1030	1102	61	1	72	0.0138889
NODE_1115_length_2215_cov_51.865784	1571	1651	4	4	80	0.0500000
NODE_1115_length_2215_cov_51.865784	1571	1651	6	28	80	0.3500000
NODE_1115_length_2215_cov_51.865784	1571	1651	7	24	80	0.3000000
NODE_1115_length_2215_cov_51.865784	1571	1651	11	13	80	0.1625000
NODE_1115_length_2215_cov_51.865784	1571	1651	12	11	80	0.1375000
NODE_1115_length_2215_cov_51.865784	1624	1704	7	3	80	0.0375000
NODE_1115_length_2215_cov_51.865784	1624	1704	11	13	80	0.1625000
NODE_1115_length_2215_cov_51.865784	1624	1704	12	12	80	0.1500000
NODE_1115_length_2215_cov_51.865784	1624	1704	13	18	80	0.2250000
NODE_1115_length_2215_cov_51.865784	1624	1704	14	31	80	0.3875000
NODE_1115_length_2215_cov_51.865784	1624	1704	15	3	80	0.0375000
NODE_1117_length_2212_cov_63.988168	459	539	3	11	80	0.1375000
NODE_1117_length_2212_cov_63.988168	459	539	4	2	80	0.0250000
NODE_1117_length_2212_cov_63.988168	459	539	5	60	80	0.7500000
NODE_1117_length_2212_cov_63.988168	459	539	7	5	80	0.0625000
NODE_1117_length_2212_cov_63.988168	459	539	8	2	80	0.0250000
NODE_1117_length_2212_cov_63.988168	512	592	5	20	80	0.2500000
NODE_1117_length_2212_cov_63.988168	512	592	6	7	80	0.0875000
NODE_1117_length_2212_cov_63.988168	512	592	7	37	80	0.4625000
NODE_1117_length_2212_cov_63.988168	512	592	8	2	80	0.0250000
NODE_1117_length_2212_cov_63.988168	512	592	9	14	80	0.1750000
NODE_1117_length_2212_cov_63.988168	588	668	4	28	80	0.3500000
NODE_1117_length_2212_cov_63.988168	588	668	6	39	80	0.4875000
NODE_1117_length_2212_cov_63.988168	588	668	7	3	80	0.0375000
NODE_1117_length_2212_cov_63.988168	588	668	8	10	80	0.1250000
NODE_1117_length_2212_cov_63.988168	641	721	0	33	80	0.4125000
NODE_1117_length_2212_cov_63.988168	641	721	1	2	80	0.0250000
NODE_1117_length_2212_cov_63.988168	641	721	2	3	80	0.0375000
NODE_1117_length_2212_cov_63.988168	641	721	4	42	80	0.5250000
NODE_1119_length_2212_cov_4.632750	1479	1559	0	25	80	0.3125000
NODE_1119_length_2212_cov_4.632750	1479	1559	2	55	80	0.6875000
NODE_1119_length_2212_cov_4.632750	1532	1612	2	64	80	0.8000000
NODE_1119_length_2212_cov_4.632750	1532	1612	4	3	80	0.0375000
NODE_1119_length_2212_cov_4.632750	1532	1612	5	13	80	0.1625000
NODE_1122_length_2211_cov_16.247159	1808	1888	5	67	80	0.8375000
NODE_1122_length_2211_cov_16.247159	1808	1888	6	4	80	0.0500000
NODE_1122_length_2211_cov_16.247159	1808	1888	7	9	80	0.1125000
NODE_1124_length_2207_cov_46.766129	1273	1348	35	8	75	0.1066667
NODE_1124_length_2207_cov_46.766129	1273	1348	36	5	75	0.0666667
NODE_1124_length_2207_cov_46.766129	1273	1348	37	20	75	0.2666667
NODE_1124_length_2207_cov_46.766129	1273	1348	38	8	75	0.1066667
NODE_1124_length_2207_cov_46.766129	1273	1348	39	4	75	0.0533333
NODE_1124_length_2207_cov_46.766129	1273	1348	40	8	75	0.1066667
NODE_1124_length_2207_cov_46.766129	1273	1348	41	7	75	0.0933333
NODE_1124_length_2207_cov_46.766129	1273	1348	42	7	75	0.0933333
NODE_1124_length_2207_cov_46.766129	1273	1348	43	8	75	0.1066667
NODE_1124_length_2207_cov_46.766129	1324	1401	34	6	77	0.0779221
NODE_1124_length_2207_cov_46.766129	1324	1401	35	5	77	0.0649351
NODE_1124_length_2207_cov_46.766129	1324	1401	36	5	77	0.0649351
NODE_1124_length_2207_cov_46.766129	1324	1401	37	8	77	0.1038961
NODE_1124_length_2207_cov_46.766129	1324	1401	38	2	77	0.0259740
NODE_1124_length_2207_cov_46.766129	1324	1401	39	8	77	0.1038961
NODE_1124_length_2207_cov_46.766129	1324	1401	40	18	77	0.2337662
NODE_1124_length_2207_cov_46.766129	1324	1401	41	2	77	0.0259740
NODE_1124_length_2207_cov_46.766129	1324	1401	42	13	77	0.1688312
NODE_1124_length_2207_cov_46.766129	1324	1401	43	10	77	0.1298701
NODE_1127_length_2205_cov_12.762108	1818	1898	4	3	80	0.0375000
NODE_1127_length_2205_cov_12.762108	1818	1898	5	49	80	0.6125000
NODE_1127_length_2205_cov_12.762108	1818	1898	6	28	80	0.3500000
NODE_1127_length_2205_cov_12.762108	1871	1951	2	12	80	0.1500000
NODE_1127_length_2205_cov_12.762108	1871	1951	3	7	80	0.0875000
NODE_1127_length_2205_cov_12.762108	1871	1951	4	11	80	0.1375000
NODE_1127_length_2205_cov_12.762108	1871	1951	5	50	80	0.6250000
NODE_1127_length_2205_cov_12.762108	1872	1951	2	12	79	0.1518987
NODE_1127_length_2205_cov_12.762108	1872	1951	3	7	79	0.0886076
NODE_1127_length_2205_cov_12.762108	1872	1951	4	11	79	0.1392405
NODE_1127_length_2205_cov_12.762108	1872	1951	5	49	79	0.6202531
NODE_1127_length_2205_cov_12.762108	1947	2020	0	21	73	0.2876712
NODE_1127_length_2205_cov_12.762108	1947	2020	1	28	73	0.3835616
NODE_1127_length_2205_cov_12.762108	1947	2020	2	24	73	0.3287671
NODE_1128_length_2202_cov_8.687114	1848	1912	0	18	64	0.2812500
NODE_1128_length_2202_cov_8.687114	1848	1912	1	32	64	0.5000000
NODE_1128_length_2202_cov_8.687114	1848	1912	2	14	64	0.2187500
NODE_1130_length_2200_cov_10.639695	1461	1541	2	80	80	1.0000000
NODE_1130_length_2200_cov_10.639695	1514	1594	0	28	80	0.3500000
NODE_1130_length_2200_cov_10.639695	1514	1594	2	52	80	0.6500000
NODE_1131_length_2199_cov_10.839524	1709	1789	6	9	80	0.1125000
NODE_1131_length_2199_cov_10.839524	1709	1789	7	25	80	0.3125000
NODE_1131_length_2199_cov_10.839524	1709	1789	8	2	80	0.0250000
NODE_1131_length_2199_cov_10.839524	1709	1789	9	1	80	0.0125000
NODE_1131_length_2199_cov_10.839524	1709	1789	11	2	80	0.0250000
NODE_1131_length_2199_cov_10.839524	1709	1789	12	5	80	0.0625000
NODE_1131_length_2199_cov_10.839524	1709	1789	13	27	80	0.3375000
NODE_1131_length_2199_cov_10.839524	1709	1789	15	9	80	0.1125000
NODE_1131_length_2199_cov_10.839524	1762	1842	11	9	80	0.1125000
NODE_1131_length_2199_cov_10.839524	1762	1842	12	6	80	0.0750000
NODE_1131_length_2199_cov_10.839524	1762	1842	13	56	80	0.7000000
NODE_1131_length_2199_cov_10.839524	1762	1842	15	9	80	0.1125000
NODE_1135_length_2196_cov_64.718646	885	965	15	4	80	0.0500000
NODE_1135_length_2196_cov_64.718646	885	965	17	1	80	0.0125000
NODE_1135_length_2196_cov_64.718646	885	965	20	12	80	0.1500000
NODE_1135_length_2196_cov_64.718646	885	965	21	5	80	0.0625000
NODE_1135_length_2196_cov_64.718646	885	965	23	3	80	0.0375000
NODE_1135_length_2196_cov_64.718646	885	965	25	22	80	0.2750000
NODE_1135_length_2196_cov_64.718646	885	965	26	16	80	0.2000000
NODE_1135_length_2196_cov_64.718646	885	965	27	10	80	0.1250000
NODE_1135_length_2196_cov_64.718646	885	965	28	7	80	0.0875000
NODE_1135_length_2196_cov_64.718646	938	1018	9	13	80	0.1625000
NODE_1135_length_2196_cov_64.718646	938	1018	11	4	80	0.0500000
NODE_1135_length_2196_cov_64.718646	938	1018	13	1	80	0.0125000
NODE_1135_length_2196_cov_64.718646	938	1018	19	5	80	0.0625000
NODE_1135_length_2196_cov_64.718646	938	1018	20	1	80	0.0125000
NODE_1135_length_2196_cov_64.718646	938	1018	22	12	80	0.1500000
NODE_1135_length_2196_cov_64.718646	938	1018	24	11	80	0.1375000
NODE_1135_length_2196_cov_64.718646	938	1018	25	1	80	0.0125000
NODE_1135_length_2196_cov_64.718646	938	1018	26	12	80	0.1500000
NODE_1135_length_2196_cov_64.718646	938	1018	27	13	80	0.1625000
NODE_1135_length_2196_cov_64.718646	938	1018	28	7	80	0.0875000
NODE_1138_length_2195_cov_8.443225	114	136	0	22	22	1.0000000
NODE_1139_length_2195_cov_6.113550	1245	1330	2	45	85	0.5294118
NODE_1139_length_2195_cov_6.113550	1245	1330	3	1	85	0.0117647
NODE_1139_length_2195_cov_6.113550	1245	1330	4	39	85	0.4588235
NODE_1139_length_2195_cov_6.113550	1306	1352	2	32	46	0.6956522
NODE_1139_length_2195_cov_6.113550	1306	1352	4	14	46	0.3043478
NODE_1141_length_2194_cov_1.366587	15	77	0	62	62	1.0000000
NODE_1142_length_2193_cov_8.320917	374	454	0	80	80	1.0000000
NODE_1142_length_2193_cov_8.320917	427	502	0	73	75	0.9733334
NODE_1142_length_2193_cov_8.320917	427	502	1	2	75	0.0266667
NODE_1146_length_2189_cov_36.884689	383	463	7	24	80	0.3000000
NODE_1146_length_2189_cov_36.884689	383	463	9	9	80	0.1125000
NODE_1146_length_2189_cov_36.884689	383	463	11	9	80	0.1125000
NODE_1146_length_2189_cov_36.884689	383	463	12	19	80	0.2375000
NODE_1146_length_2189_cov_36.884689	383	463	13	19	80	0.2375000
NODE_1146_length_2189_cov_36.884689	436	516	2	2	80	0.0250000
NODE_1146_length_2189_cov_36.884689	436	516	4	2	80	0.0250000
NODE_1146_length_2189_cov_36.884689	436	516	6	14	80	0.1750000
NODE_1146_length_2189_cov_36.884689	436	516	7	6	80	0.0750000
NODE_1146_length_2189_cov_36.884689	436	516	8	18	80	0.2250000
NODE_1146_length_2189_cov_36.884689	436	516	9	8	80	0.1000000
NODE_1146_length_2189_cov_36.884689	436	516	10	3	80	0.0375000
NODE_1146_length_2189_cov_36.884689	436	516	11	9	80	0.1125000
NODE_1146_length_2189_cov_36.884689	436	516	12	1	80	0.0125000
NODE_1146_length_2189_cov_36.884689	436	516	13	17	80	0.2125000
NODE_1146_length_2189_cov_36.884689	1257	1337	0	80	80	1.0000000
NODE_1146_length_2189_cov_36.884689	1310	1390	0	36	80	0.4500000
NODE_1146_length_2189_cov_36.884689	1310	1390	1	2	80	0.0250000
NODE_1146_length_2189_cov_36.884689	1310	1390	3	41	80	0.5125000
NODE_1146_length_2189_cov_36.884689	1310	1390	4	1	80	0.0125000
NODE_1146_length_2189_cov_36.884689	1427	1507	5	4	80	0.0500000
NODE_1146_length_2189_cov_36.884689	1427	1507	6	1	80	0.0125000
NODE_1146_length_2189_cov_36.884689	1427	1507	7	18	80	0.2250000
NODE_1146_length_2189_cov_36.884689	1427	1507	8	48	80	0.6000000
NODE_1146_length_2189_cov_36.884689	1427	1507	9	9	80	0.1125000
NODE_1146_length_2189_cov_36.884689	1480	1560	7	28	80	0.3500000
NODE_1146_length_2189_cov_36.884689	1480	1560	8	44	80	0.5500000
NODE_1146_length_2189_cov_36.884689	1480	1560	9	8	80	0.1000000
NODE_1152_length_2184_cov_9.464748	1536	1616	3	26	80	0.3250000
NODE_1152_length_2184_cov_9.464748	1536	1616	4	7	80	0.0875000
NODE_1152_length_2184_cov_9.464748	1536	1616	5	17	80	0.2125000
NODE_1152_length_2184_cov_9.464748	1536	1616	6	3	80	0.0375000
NODE_1152_length_2184_cov_9.464748	1536	1616	7	27	80	0.3375000
NODE_1152_length_2184_cov_9.464748	1589	1669	5	19	80	0.2375000
NODE_1152_length_2184_cov_9.464748	1589	1669	6	37	80	0.4625000
NODE_1152_length_2184_cov_9.464748	1589	1669	7	24	80	0.3000000
NODE_1154_length_2183_cov_45.471209	1632	1712	4	16	80	0.2000000
NODE_1154_length_2183_cov_45.471209	1632	1712	5	8	80	0.1000000
NODE_1154_length_2183_cov_45.471209	1632	1712	6	30	80	0.3750000
NODE_1154_length_2183_cov_45.471209	1632	1712	7	14	80	0.1750000
NODE_1154_length_2183_cov_45.471209	1632	1712	8	12	80	0.1500000
NODE_1154_length_2183_cov_45.471209	1685	1765	5	1	80	0.0125000
NODE_1154_length_2183_cov_45.471209	1685	1765	7	41	80	0.5125000
NODE_1154_length_2183_cov_45.471209	1685	1765	8	22	80	0.2750000
NODE_1154_length_2183_cov_45.471209	1685	1765	9	16	80	0.2000000
NODE_1159_length_2176_cov_47.338950	0	52	0	52	52	1.0000000
NODE_1162_length_2174_cov_40.560964	1638	1718	0	14	80	0.1750000
NODE_1162_length_2174_cov_40.560964	1638	1718	1	4	80	0.0500000
NODE_1162_length_2174_cov_40.560964	1638	1718	2	8	80	0.1000000
NODE_1162_length_2174_cov_40.560964	1638	1718	3	19	80	0.2375000
NODE_1162_length_2174_cov_40.560964	1638	1718	5	22	80	0.2750000
NODE_1162_length_2174_cov_40.560964	1638	1718	6	5	80	0.0625000
NODE_1162_length_2174_cov_40.560964	1638	1718	7	8	80	0.1000000
NODE_1162_length_2174_cov_40.560964	1691	1771	5	14	80	0.1750000
NODE_1162_length_2174_cov_40.560964	1691	1771	6	5	80	0.0625000
NODE_1162_length_2174_cov_40.560964	1691	1771	7	61	80	0.7625000
NODE_1163_length_2174_cov_35.399518	284	364	0	66	80	0.8250000
NODE_1163_length_2174_cov_35.399518	284	364	2	14	80	0.1750000
NODE_1163_length_2174_cov_35.399518	337	414	0	77	77	1.0000000
NODE_1163_length_2174_cov_35.399518	1542	1620	23	9	78	0.1153846
NODE_1163_length_2174_cov_35.399518	1542	1620	25	11	78	0.1410256
NODE_1163_length_2174_cov_35.399518	1542	1620	26	12	78	0.1538462
NODE_1163_length_2174_cov_35.399518	1542	1620	27	27	78	0.3461539
NODE_1163_length_2174_cov_35.399518	1542	1620	28	4	78	0.0512821
NODE_1163_length_2174_cov_35.399518	1542	1620	29	1	78	0.0128205
NODE_1163_length_2174_cov_35.399518	1542	1620	30	4	78	0.0512821
NODE_1163_length_2174_cov_35.399518	1542	1620	32	4	78	0.0512821
NODE_1163_length_2174_cov_35.399518	1542	1620	35	1	78	0.0128205
NODE_1163_length_2174_cov_35.399518	1542	1620	36	5	78	0.0641026
NODE_1163_length_2174_cov_35.399518	1593	1673	25	2	80	0.0250000
NODE_1163_length_2174_cov_35.399518	1593	1673	26	3	80	0.0375000
NODE_1163_length_2174_cov_35.399518	1593	1673	27	5	80	0.0625000
NODE_1163_length_2174_cov_35.399518	1593	1673	28	2	80	0.0250000
NODE_1163_length_2174_cov_35.399518	1593	1673	29	1	80	0.0125000
NODE_1163_length_2174_cov_35.399518	1593	1673	30	4	80	0.0500000
NODE_1163_length_2174_cov_35.399518	1593	1673	32	4	80	0.0500000
NODE_1163_length_2174_cov_35.399518	1593	1673	35	1	80	0.0125000
NODE_1163_length_2174_cov_35.399518	1593	1673	36	5	80	0.0625000
NODE_1163_length_2174_cov_35.399518	1593	1673	37	4	80	0.0500000
NODE_1163_length_2174_cov_35.399518	1593	1673	38	3	80	0.0375000
NODE_1163_length_2174_cov_35.399518	1593	1673	39	3	80	0.0375000
NODE_1163_length_2174_cov_35.399518	1593	1673	40	8	80	0.1000000
NODE_1163_length_2174_cov_35.399518	1593	1673	42	8	80	0.1000000
NODE_1163_length_2174_cov_35.399518	1593	1673	43	1	80	0.0125000
NODE_1163_length_2174_cov_35.399518	1593	1673	44	5	80	0.0625000
NODE_1163_length_2174_cov_35.399518	1593	1673	45	4	80	0.0500000
NODE_1163_length_2174_cov_35.399518	1593	1673	46	4	80	0.0500000
NODE_1163_length_2174_cov_35.399518	1593	1673	47	11	80	0.1375000
NODE_1163_length_2174_cov_35.399518	1593	1673	48	2	80	0.0250000
NODE_1163_length_2174_cov_35.399518	2075	2152	3	77	77	1.0000000
NODE_1163_length_2174_cov_35.399518	2075	2152	3	77	77	1.0000000
NODE_1163_length_2174_cov_35.399518	2075	2152	3	77	77	1.0000000
NODE_1163_length_2174_cov_35.399518	2125	2174	1	14	49	0.2857143
NODE_1163_length_2174_cov_35.399518	2125	2174	3	35	49	0.7142857
NODE_1163_length_2174_cov_35.399518	2128	2174	1	14	46	0.3043478
NODE_1163_length_2174_cov_35.399518	2128	2174	3	32	46	0.6956522
NODE_1163_length_2174_cov_35.399518	2130	2174	1	14	44	0.3181818
NODE_1163_length_2174_cov_35.399518	2130	2174	3	30	44	0.6818182
NODE_1164_length_2172_cov_44.861553	1110	1190	13	4	80	0.0500000
NODE_1164_length_2172_cov_44.861553	1110	1190	14	8	80	0.1000000
NODE_1164_length_2172_cov_44.861553	1110	1190	15	25	80	0.3125000
NODE_1164_length_2172_cov_44.861553	1110	1190	16	40	80	0.5000000
NODE_1164_length_2172_cov_44.861553	1110	1190	17	3	80	0.0375000
NODE_1164_length_2172_cov_44.861553	1163	1243	12	2	80	0.0250000
NODE_1164_length_2172_cov_44.861553	1163	1243	13	3	80	0.0375000
NODE_1164_length_2172_cov_44.861553	1163	1243	14	8	80	0.1000000
NODE_1164_length_2172_cov_44.861553	1163	1243	15	11	80	0.1375000
NODE_1164_length_2172_cov_44.861553	1163	1243	16	35	80	0.4375000
NODE_1164_length_2172_cov_44.861553	1163	1243	17	12	80	0.1500000
NODE_1164_length_2172_cov_44.861553	1163	1243	18	6	80	0.0750000
NODE_1164_length_2172_cov_44.861553	1163	1243	19	3	80	0.0375000
NODE_1164_length_2172_cov_44.861553	1239	1319	12	4	80	0.0500000
NODE_1164_length_2172_cov_44.861553	1239	1319	13	2	80	0.0250000
NODE_1164_length_2172_cov_44.861553	1239	1319	14	6	80	0.0750000
NODE_1164_length_2172_cov_44.861553	1239	1319	15	21	80	0.2625000
NODE_1164_length_2172_cov_44.861553	1239	1319	16	25	80	0.3125000
NODE_1164_length_2172_cov_44.861553	1239	1319	17	3	80	0.0375000
NODE_1164_length_2172_cov_44.861553	1239	1319	18	19	80	0.2375000
NODE_1164_length_2172_cov_44.861553	1292	1372	11	7	80	0.0875000
NODE_1164_length_2172_cov_44.861553	1292	1372	13	18	80	0.2250000
NODE_1164_length_2172_cov_44.861553	1292	1372	14	3	80	0.0375000
NODE_1164_length_2172_cov_44.861553	1292	1372	15	29	80	0.3625000
NODE_1164_length_2172_cov_44.861553	1292	1372	16	8	80	0.1000000
NODE_1164_length_2172_cov_44.861553	1292	1372	17	3	80	0.0375000
NODE_1164_length_2172_cov_44.861553	1292	1372	18	12	80	0.1500000
NODE_1166_length_2167_cov_33.133946	414	494	2	1	80	0.0125000
NODE_1166_length_2167_cov_33.133946	414	494	3	6	80	0.0750000
NODE_1166_length_2167_cov_33.133946	414	494	4	37	80	0.4625000
NODE_1166_length_2167_cov_33.133946	414	494	7	13	80	0.1625000
NODE_1166_length_2167_cov_33.133946	414	494	8	12	80	0.1500000
NODE_1166_length_2167_cov_33.133946	414	494	9	11	80	0.1375000
NODE_1166_length_2167_cov_33.133946	467	547	7	6	80	0.0750000
NODE_1166_length_2167_cov_33.133946	467	547	8	44	80	0.5500000
NODE_1166_length_2167_cov_33.133946	467	547	9	11	80	0.1375000
NODE_1166_length_2167_cov_33.133946	467	547	10	5	80	0.0625000
NODE_1166_length_2167_cov_33.133946	467	547	11	12	80	0.1500000
NODE_1166_length_2167_cov_33.133946	467	547	12	2	80	0.0250000
NODE_1166_length_2167_cov_33.133946	543	623	8	2	80	0.0250000
NODE_1166_length_2167_cov_33.133946	543	623	10	46	80	0.5750000
NODE_1166_length_2167_cov_33.133946	543	623	11	29	80	0.3625000
NODE_1166_length_2167_cov_33.133946	543	623	12	3	80	0.0375000
NODE_1166_length_2167_cov_33.133946	596	676	7	20	80	0.2500000
NODE_1166_length_2167_cov_33.133946	596	676	8	35	80	0.4375000
NODE_1166_length_2167_cov_33.133946	596	676	10	9	80	0.1125000
NODE_1166_length_2167_cov_33.133946	596	676	11	14	80	0.1750000
NODE_1166_length_2167_cov_33.133946	596	676	12	2	80	0.0250000
NODE_1169_length_2165_cov_21.460794	980	1060	2	41	80	0.5125000
NODE_1169_length_2165_cov_21.460794	980	1060	3	1	80	0.0125000
NODE_1169_length_2165_cov_21.460794	980	1060	4	12	80	0.1500000
NODE_1169_length_2165_cov_21.460794	980	1060	5	26	80	0.3250000
NODE_1169_length_2165_cov_21.460794	1033	1113	3	3	80	0.0375000
NODE_1169_length_2165_cov_21.460794	1033	1113	4	31	80	0.3875000
NODE_1169_length_2165_cov_21.460794	1033	1113	5	46	80	0.5750000
NODE_1176_length_2157_cov_22.284257	989	1069	8	5	80	0.0625000
NODE_1176_length_2157_cov_22.284257	989	1069	9	1	80	0.0125000
NODE_1176_length_2157_cov_22.284257	989	1069	11	3	80	0.0375000
NODE_1176_length_2157_cov_22.284257	989	1069	12	25	80	0.3125000
NODE_1176_length_2157_cov_22.284257	989	1069	13	44	80	0.5500000
NODE_1176_length_2157_cov_22.284257	989	1069	14	2	80	0.0250000
NODE_1176_length_2157_cov_22.284257	1042	1122	7	7	80	0.0875000
NODE_1176_length_2157_cov_22.284257	1042	1122	9	4	80	0.0500000
NODE_1176_length_2157_cov_22.284257	1042	1122	10	6	80	0.0750000
NODE_1176_length_2157_cov_22.284257	1042	1122	11	16	80	0.2000000
NODE_1176_length_2157_cov_22.284257	1042	1122	12	9	80	0.1125000
NODE_1176_length_2157_cov_22.284257	1042	1122	13	38	80	0.4750000
NODE_1176_length_2157_cov_22.284257	1118	1198	2	8	80	0.1000000
NODE_1176_length_2157_cov_22.284257	1118	1198	3	33	80	0.4125000
NODE_1176_length_2157_cov_22.284257	1118	1198	4	14	80	0.1750000
NODE_1176_length_2157_cov_22.284257	1118	1198	5	14	80	0.1750000
NODE_1176_length_2157_cov_22.284257	1118	1198	6	3	80	0.0375000
NODE_1176_length_2157_cov_22.284257	1118	1198	7	8	80	0.1000000
NODE_1176_length_2157_cov_22.284257	1171	1251	3	42	80	0.5250000
NODE_1176_length_2157_cov_22.284257	1171	1251	4	38	80	0.4750000
NODE_1177_length_2157_cov_8.830418	867	947	7	3	80	0.0375000
NODE_1177_length_2157_cov_8.830418	867	947	8	27	80	0.3375000
NODE_1177_length_2157_cov_8.830418	867	947	10	50	80	0.6250000
NODE_1177_length_2157_cov_8.830418	920	1000	4	10	80	0.1250000
NODE_1177_length_2157_cov_8.830418	920	1000	6	9	80	0.1125000
NODE_1177_length_2157_cov_8.830418	920	1000	8	35	80	0.4375000
NODE_1177_length_2157_cov_8.830418	920	1000	10	26	80	0.3250000
NODE_1177_length_2157_cov_8.830418	996	1076	0	56	80	0.7000000
NODE_1177_length_2157_cov_8.830418	996	1076	1	5	80	0.0625000
NODE_1177_length_2157_cov_8.830418	996	1076	2	11	80	0.1375000
NODE_1177_length_2157_cov_8.830418	996	1076	4	8	80	0.1000000
NODE_1177_length_2157_cov_8.830418	1049	1129	0	80	80	1.0000000
NODE_1178_length_2156_cov_25.065630	0	41	1	5	41	0.1219512
NODE_1178_length_2156_cov_25.065630	0	41	3	5	41	0.1219512
NODE_1178_length_2156_cov_25.065630	0	41	5	2	41	0.0487805
NODE_1178_length_2156_cov_25.065630	0	41	7	3	41	0.0731707
NODE_1178_length_2156_cov_25.065630	0	41	9	4	41	0.0975610
NODE_1178_length_2156_cov_25.065630	0	41	11	3	41	0.0731707
NODE_1178_length_2156_cov_25.065630	0	41	13	4	41	0.0975610
NODE_1178_length_2156_cov_25.065630	0	41	17	4	41	0.0975610
NODE_1178_length_2156_cov_25.065630	0	41	19	9	41	0.2195122
NODE_1178_length_2156_cov_25.065630	0	41	21	2	41	0.0487805
NODE_1178_length_2156_cov_25.065630	14	94	7	1	80	0.0125000
NODE_1178_length_2156_cov_25.065630	14	94	9	4	80	0.0500000
NODE_1178_length_2156_cov_25.065630	14	94	11	3	80	0.0375000
NODE_1178_length_2156_cov_25.065630	14	94	13	4	80	0.0500000
NODE_1178_length_2156_cov_25.065630	14	94	17	4	80	0.0500000
NODE_1178_length_2156_cov_25.065630	14	94	19	9	80	0.1125000
NODE_1178_length_2156_cov_25.065630	14	94	21	6	80	0.0750000
NODE_1178_length_2156_cov_25.065630	14	94	24	17	80	0.2125000
NODE_1178_length_2156_cov_25.065630	14	94	25	7	80	0.0875000
NODE_1178_length_2156_cov_25.065630	14	94	27	15	80	0.1875000
NODE_1178_length_2156_cov_25.065630	14	94	28	10	80	0.1250000
NODE_1181_length_2156_cov_3.216334	1890	1970	4	80	80	1.0000000
NODE_1181_length_2156_cov_3.216334	1943	2023	0	10	80	0.1250000
NODE_1181_length_2156_cov_3.216334	1943	2023	1	4	80	0.0500000
NODE_1181_length_2156_cov_3.216334	1943	2023	2	12	80	0.1500000
NODE_1181_length_2156_cov_3.216334	1943	2023	3	1	80	0.0125000
NODE_1181_length_2156_cov_3.216334	1943	2023	4	53	80	0.6625000
NODE_1184_length_2153_cov_11.610029	1968	2048	0	80	80	1.0000000
NODE_1184_length_2153_cov_11.610029	1977	2048	0	71	71	1.0000000
NODE_1190_length_2147_cov_25.116211	814	894	14	39	80	0.4875000
NODE_1190_length_2147_cov_25.116211	814	894	15	9	80	0.1125000
NODE_1190_length_2147_cov_25.116211	814	894	16	7	80	0.0875000
NODE_1190_length_2147_cov_25.116211	814	894	17	1	80	0.0125000
NODE_1190_length_2147_cov_25.116211	814	894	19	24	80	0.3000000
NODE_1190_length_2147_cov_25.116211	867	947	15	26	80	0.3250000
NODE_1190_length_2147_cov_25.116211	867	947	17	1	80	0.0125000
NODE_1190_length_2147_cov_25.116211	867	947	18	7	80	0.0875000
NODE_1190_length_2147_cov_25.116211	867	947	19	46	80	0.5750000
NODE_1197_length_2136_cov_16.947472	279	359	4	5	80	0.0625000
NODE_1197_length_2136_cov_16.947472	279	359	5	25	80	0.3125000
NODE_1197_length_2136_cov_16.947472	279	359	6	43	80	0.5375000
NODE_1197_length_2136_cov_16.947472	279	359	8	7	80	0.0875000
NODE_1197_length_2136_cov_16.947472	332	412	4	5	80	0.0625000
NODE_1197_length_2136_cov_16.947472	332	412	5	4	80	0.0500000
NODE_1197_length_2136_cov_16.947472	332	412	6	13	80	0.1625000
NODE_1197_length_2136_cov_16.947472	332	412	7	3	80	0.0375000
NODE_1197_length_2136_cov_16.947472	332	412	8	7	80	0.0875000
NODE_1197_length_2136_cov_16.947472	332	412	9	22	80	0.2750000
NODE_1197_length_2136_cov_16.947472	332	412	10	12	80	0.1500000
NODE_1197_length_2136_cov_16.947472	332	412	11	14	80	0.1750000
NODE_1197_length_2136_cov_16.947472	408	488	9	18	80	0.2250000
NODE_1197_length_2136_cov_16.947472	408	488	10	3	80	0.0375000
NODE_1197_length_2136_cov_16.947472	408	488	11	59	80	0.7375000
NODE_1197_length_2136_cov_16.947472	461	541	3	34	80	0.4250000
NODE_1197_length_2136_cov_16.947472	461	541	4	9	80	0.1125000
NODE_1197_length_2136_cov_16.947472	461	541	5	1	80	0.0125000
NODE_1197_length_2136_cov_16.947472	461	541	7	7	80	0.0875000
NODE_1197_length_2136_cov_16.947472	461	541	9	20	80	0.2500000
NODE_1197_length_2136_cov_16.947472	461	541	11	9	80	0.1125000
NODE_1199_length_2133_cov_15.038840	498	578	0	5	80	0.0625000
NODE_1199_length_2133_cov_15.038840	498	578	1	32	80	0.4000000
NODE_1199_length_2133_cov_15.038840	498	578	2	26	80	0.3250000
NODE_1199_length_2133_cov_15.038840	498	578	3	17	80	0.2125000
NODE_1199_length_2133_cov_15.038840	551	631	2	10	80	0.1250000
NODE_1199_length_2133_cov_15.038840	551	631	3	40	80	0.5000000
NODE_1199_length_2133_cov_15.038840	551	631	4	30	80	0.3750000
NODE_1199_length_2133_cov_15.038840	627	707	2	22	80	0.2750000
NODE_1199_length_2133_cov_15.038840	627	707	3	32	80	0.4000000
NODE_1199_length_2133_cov_15.038840	627	707	4	26	80	0.3250000
NODE_1199_length_2133_cov_15.038840	680	722	1	10	42	0.2380952
NODE_1199_length_2133_cov_15.038840	680	722	2	27	42	0.6428571
NODE_1199_length_2133_cov_15.038840	680	722	3	5	42	0.1190476
NODE_1204_length_2128_cov_11.799409	1698	1778	0	13	80	0.1625000
NODE_1204_length_2128_cov_11.799409	1698	1778	1	67	80	0.8375000
NODE_1204_length_2128_cov_11.799409	1751	1831	0	66	80	0.8250000
NODE_1204_length_2128_cov_11.799409	1751	1831	1	14	80	0.1750000
NODE_1206_length_2126_cov_6.854465	1614	1694	3	12	80	0.1500000
NODE_1206_length_2126_cov_6.854465	1614	1694	4	7	80	0.0875000
NODE_1206_length_2126_cov_6.854465	1614	1694	5	10	80	0.1250000
NODE_1206_length_2126_cov_6.854465	1614	1694	6	10	80	0.1250000
NODE_1206_length_2126_cov_6.854465	1614	1694	7	41	80	0.5125000
NODE_1206_length_2126_cov_6.854465	1667	1747	4	4	80	0.0500000
NODE_1206_length_2126_cov_6.854465	1667	1747	6	35	80	0.4375000
NODE_1206_length_2126_cov_6.854465	1667	1747	7	41	80	0.5125000
NODE_1209_length_2123_cov_12.668478	102	143	0	41	41	1.0000000
NODE_1209_length_2123_cov_12.668478	1474	1500	4	12	26	0.4615385
NODE_1209_length_2123_cov_12.668478	1474	1500	5	14	26	0.5384616
NODE_1209_length_2123_cov_12.668478	1552	1601	9	1	49	0.0204082
NODE_1209_length_2123_cov_12.668478	1552	1601	10	4	49	0.0816327
NODE_1209_length_2123_cov_12.668478	1552	1601	11	39	49	0.7959183
NODE_1209_length_2123_cov_12.668478	1552	1601	12	5	49	0.1020408
NODE_1209_length_2123_cov_12.668478	1574	1654	11	46	80	0.5750000
NODE_1209_length_2123_cov_12.668478	1574	1654	12	27	80	0.3375000
NODE_1209_length_2123_cov_12.668478	1574	1654	13	7	80	0.0875000
NODE_1211_length_2121_cov_10.101879	497	577	3	38	80	0.4750000
NODE_1211_length_2121_cov_10.101879	497	577	4	38	80	0.4750000
NODE_1211_length_2121_cov_10.101879	497	577	5	4	80	0.0500000
NODE_1211_length_2121_cov_10.101879	550	630	3	29	80	0.3625000
NODE_1211_length_2121_cov_10.101879	550	630	4	38	80	0.4750000
NODE_1211_length_2121_cov_10.101879	550	630	5	13	80	0.1625000
NODE_1211_length_2121_cov_10.101879	1935	2008	0	2	73	0.0273973
NODE_1211_length_2121_cov_10.101879	1935	2008	1	71	73	0.9726027
NODE_1212_length_2121_cov_9.964886	1523	1603	2	20	80	0.2500000
NODE_1212_length_2121_cov_9.964886	1523	1603	4	2	80	0.0250000
NODE_1212_length_2121_cov_9.964886	1523	1603	5	13	80	0.1625000
NODE_1212_length_2121_cov_9.964886	1523	1603	7	21	80	0.2625000
NODE_1212_length_2121_cov_9.964886	1523	1603	10	13	80	0.1625000
NODE_1212_length_2121_cov_9.964886	1523	1603	11	11	80	0.1375000
NODE_1212_length_2121_cov_9.964886	1576	1656	7	17	80	0.2125000
NODE_1212_length_2121_cov_9.964886	1576	1656	9	30	80	0.3750000
NODE_1212_length_2121_cov_9.964886	1576	1656	10	22	80	0.2750000
NODE_1212_length_2121_cov_9.964886	1576	1656	11	11	80	0.1375000
NODE_1213_length_2120_cov_24.609599	25	92	0	67	67	1.0000000
NODE_1215_length_2119_cov_18.446040	366	446	0	80	80	1.0000000
NODE_1215_length_2119_cov_18.446040	419	499	0	80	80	1.0000000
NODE_1215_length_2119_cov_18.446040	1239	1319	2	31	80	0.3875000
NODE_1215_length_2119_cov_18.446040	1239	1319	4	10	80	0.1250000
NODE_1215_length_2119_cov_18.446040	1239	1319	6	39	80	0.4875000
NODE_1215_length_2119_cov_18.446040	1292	1372	4	13	80	0.1625000
NODE_1215_length_2119_cov_18.446040	1292	1372	6	58	80	0.7250000
NODE_1215_length_2119_cov_18.446040	1292	1372	7	9	80	0.1125000
NODE_1225_length_2110_cov_8.668324	1755	1835	2	4	80	0.0500000
NODE_1225_length_2110_cov_8.668324	1755	1835	3	23	80	0.2875000
NODE_1225_length_2110_cov_8.668324	1755	1835	4	4	80	0.0500000
NODE_1225_length_2110_cov_8.668324	1755	1835	5	19	80	0.2375000
NODE_1225_length_2110_cov_8.668324	1755	1835	6	19	80	0.2375000
NODE_1225_length_2110_cov_8.668324	1755	1835	8	11	80	0.1375000
NODE_1225_length_2110_cov_8.668324	1808	1888	6	16	80	0.2000000
NODE_1225_length_2110_cov_8.668324	1808	1888	8	64	80	0.8000000
NODE_1227_length_2106_cov_14.643747	1579	1659	5	2	80	0.0250000
NODE_1227_length_2106_cov_14.643747	1579	1659	6	27	80	0.3375000
NODE_1227_length_2106_cov_14.643747	1579	1659	7	51	80	0.6375000
NODE_1227_length_2106_cov_14.643747	1632	1712	4	20	80	0.2500000
NODE_1227_length_2106_cov_14.643747	1632	1712	5	35	80	0.4375000
NODE_1227_length_2106_cov_14.643747	1632	1712	6	2	80	0.0250000
NODE_1227_length_2106_cov_14.643747	1632	1712	7	23	80	0.2875000
NODE_1227_length_2106_cov_14.643747	1708	1786	1	18	78	0.2307692
NODE_1227_length_2106_cov_14.643747	1708	1786	2	38	78	0.4871795
NODE_1227_length_2106_cov_14.643747	1708	1786	3	4	78	0.0512821
NODE_1227_length_2106_cov_14.643747	1708	1786	4	18	78	0.2307692
NODE_1227_length_2106_cov_14.643747	1759	1839	1	9	80	0.1125000
NODE_1227_length_2106_cov_14.643747	1759	1839	3	32	80	0.4000000
NODE_1227_length_2106_cov_14.643747	1759	1839	4	39	80	0.4875000
NODE_1228_length_2106_cov_3.173393	48	96	0	48	48	1.0000000
NODE_1228_length_2106_cov_3.173393	48	96	0	48	48	1.0000000
NODE_1228_length_2106_cov_3.173393	48	96	0	48	48	1.0000000
NODE_1228_length_2106_cov_3.173393	48	96	0	48	48	1.0000000
NODE_1228_length_2106_cov_3.173393	48	96	0	48	48	1.0000000
NODE_1229_length_2102_cov_23.872192	390	470	4	3	80	0.0375000
NODE_1229_length_2102_cov_23.872192	390	470	5	21	80	0.2625000
NODE_1229_length_2102_cov_23.872192	390	470	6	44	80	0.5500000
NODE_1229_length_2102_cov_23.872192	390	470	7	12	80	0.1500000
NODE_1229_length_2102_cov_23.872192	443	523	5	26	80	0.3250000
NODE_1229_length_2102_cov_23.872192	443	523	6	27	80	0.3375000
NODE_1229_length_2102_cov_23.872192	443	523	7	27	80	0.3375000
NODE_1229_length_2102_cov_23.872192	519	599	4	8	80	0.1000000
NODE_1229_length_2102_cov_23.872192	519	599	5	9	80	0.1125000
NODE_1229_length_2102_cov_23.872192	519	599	6	6	80	0.0750000
NODE_1229_length_2102_cov_23.872192	519	599	7	5	80	0.0625000
NODE_1229_length_2102_cov_23.872192	519	599	8	1	80	0.0125000
NODE_1229_length_2102_cov_23.872192	519	599	9	16	80	0.2000000
NODE_1229_length_2102_cov_23.872192	519	599	10	18	80	0.2250000
NODE_1229_length_2102_cov_23.872192	519	599	11	15	80	0.1875000
NODE_1229_length_2102_cov_23.872192	519	599	12	2	80	0.0250000
NODE_1229_length_2102_cov_23.872192	572	652	10	10	80	0.1250000
NODE_1229_length_2102_cov_23.872192	572	652	11	15	80	0.1875000
NODE_1229_length_2102_cov_23.872192	572	652	12	35	80	0.4375000
NODE_1229_length_2102_cov_23.872192	572	652	13	20	80	0.2500000
NODE_1229_length_2102_cov_23.872192	1049	1101	64	3	52	0.0576923
NODE_1229_length_2102_cov_23.872192	1049	1101	65	3	52	0.0576923
NODE_1229_length_2102_cov_23.872192	1049	1101	66	4	52	0.0769231
NODE_1229_length_2102_cov_23.872192	1049	1101	67	20	52	0.3846154
NODE_1229_length_2102_cov_23.872192	1049	1101	68	14	52	0.2692308
NODE_1229_length_2102_cov_23.872192	1049	1101	69	2	52	0.0384615
NODE_1229_length_2102_cov_23.872192	1049	1101	70	5	52	0.0961538
NODE_1229_length_2102_cov_23.872192	1049	1101	71	1	52	0.0192308
NODE_1231_length_2100_cov_21.504248	450	530	0	17	80	0.2125000
NODE_1231_length_2100_cov_21.504248	450	530	1	54	80	0.6750000
NODE_1231_length_2100_cov_21.504248	450	530	2	9	80	0.1125000
NODE_1231_length_2100_cov_21.504248	503	578	1	18	75	0.2400000
NODE_1231_length_2100_cov_21.504248	503	578	2	29	75	0.3866667
NODE_1231_length_2100_cov_21.504248	503	578	3	20	75	0.2666667
NODE_1231_length_2100_cov_21.504248	503	578	4	3	75	0.0400000
NODE_1231_length_2100_cov_21.504248	503	578	5	5	75	0.0666667
NODE_1231_length_2100_cov_21.504248	579	659	5	72	80	0.9000000
NODE_1231_length_2100_cov_21.504248	579	659	6	8	80	0.1000000
NODE_1231_length_2100_cov_21.504248	632	712	3	12	80	0.1500000
NODE_1231_length_2100_cov_21.504248	632	712	4	29	80	0.3625000
NODE_1231_length_2100_cov_21.504248	632	712	5	39	80	0.4875000
NODE_1231_length_2100_cov_21.504248	1420	1500	2	5	80	0.0625000
NODE_1231_length_2100_cov_21.504248	1420	1500	4	75	80	0.9375000
NODE_1231_length_2100_cov_21.504248	1473	1553	0	50	80	0.6250000
NODE_1231_length_2100_cov_21.504248	1473	1553	2	8	80	0.1000000
NODE_1231_length_2100_cov_21.504248	1473	1553	4	22	80	0.2750000
NODE_1232_length_2100_cov_6.399300	1510	1590	0	43	80	0.5375000
NODE_1232_length_2100_cov_6.399300	1510	1590	2	15	80	0.1875000
NODE_1232_length_2100_cov_6.399300	1510	1590	3	22	80	0.2750000
NODE_1232_length_2100_cov_6.399300	1559	1590	2	9	31	0.2903226
NODE_1232_length_2100_cov_6.399300	1559	1590	3	22	31	0.7096774
NODE_1232_length_2100_cov_6.399300	1563	1644	1	35	81	0.4320988
NODE_1232_length_2100_cov_6.399300	1563	1644	2	5	81	0.0617284
NODE_1232_length_2100_cov_6.399300	1563	1644	3	41	81	0.5061728
NODE_1232_length_2100_cov_6.399300	1563	1644	1	35	81	0.4320988
NODE_1232_length_2100_cov_6.399300	1563	1644	2	5	81	0.0617284
NODE_1232_length_2100_cov_6.399300	1563	1644	3	41	81	0.5061728
NODE_1234_length_2099_cov_40.603500	960	1040	2	15	80	0.1875000
NODE_1234_length_2099_cov_40.603500	960	1040	3	26	80	0.3250000
NODE_1234_length_2099_cov_40.603500	960	1040	4	15	80	0.1875000
NODE_1234_length_2099_cov_40.603500	960	1040	5	4	80	0.0500000
NODE_1234_length_2099_cov_40.603500	960	1040	6	10	80	0.1250000
NODE_1234_length_2099_cov_40.603500	960	1040	7	10	80	0.1250000
NODE_1234_length_2099_cov_40.603500	1013	1093	4	3	80	0.0375000
NODE_1234_length_2099_cov_40.603500	1013	1093	5	4	80	0.0500000
NODE_1234_length_2099_cov_40.603500	1013	1093	6	14	80	0.1750000
NODE_1234_length_2099_cov_40.603500	1013	1093	7	23	80	0.2875000
NODE_1234_length_2099_cov_40.603500	1013	1093	9	15	80	0.1875000
NODE_1234_length_2099_cov_40.603500	1013	1093	10	21	80	0.2625000
NODE_1234_length_2099_cov_40.603500	1089	1169	9	5	80	0.0625000
NODE_1234_length_2099_cov_40.603500	1089	1169	10	4	80	0.0500000
NODE_1234_length_2099_cov_40.603500	1089	1169	11	27	80	0.3375000
NODE_1234_length_2099_cov_40.603500	1089	1169	12	1	80	0.0125000
NODE_1234_length_2099_cov_40.603500	1089	1169	13	21	80	0.2625000
NODE_1234_length_2099_cov_40.603500	1089	1169	14	6	80	0.0750000
NODE_1234_length_2099_cov_40.603500	1089	1169	18	10	80	0.1250000
NODE_1234_length_2099_cov_40.603500	1089	1169	19	6	80	0.0750000
NODE_1234_length_2099_cov_40.603500	1142	1222	13	16	80	0.2000000
NODE_1234_length_2099_cov_40.603500	1142	1222	14	37	80	0.4625000
NODE_1234_length_2099_cov_40.603500	1142	1222	15	2	80	0.0250000
NODE_1234_length_2099_cov_40.603500	1142	1222	16	4	80	0.0500000
NODE_1234_length_2099_cov_40.603500	1142	1222	17	4	80	0.0500000
NODE_1234_length_2099_cov_40.603500	1142	1222	18	11	80	0.1375000
NODE_1234_length_2099_cov_40.603500	1142	1222	19	6	80	0.0750000
NODE_1235_length_2098_cov_62.733867	1042	1122	10	7	80	0.0875000
NODE_1235_length_2098_cov_62.733867	1042	1122	12	24	80	0.3000000
NODE_1235_length_2098_cov_62.733867	1042	1122	13	23	80	0.2875000
NODE_1235_length_2098_cov_62.733867	1042	1122	14	23	80	0.2875000
NODE_1235_length_2098_cov_62.733867	1042	1122	15	3	80	0.0375000
NODE_1235_length_2098_cov_62.733867	1095	1175	10	10	80	0.1250000
NODE_1235_length_2098_cov_62.733867	1095	1175	11	7	80	0.0875000
NODE_1235_length_2098_cov_62.733867	1095	1175	12	38	80	0.4750000
NODE_1235_length_2098_cov_62.733867	1095	1175	13	1	80	0.0125000
NODE_1235_length_2098_cov_62.733867	1095	1175	14	13	80	0.1625000
NODE_1235_length_2098_cov_62.733867	1095	1175	15	5	80	0.0625000
NODE_1235_length_2098_cov_62.733867	1095	1175	16	6	80	0.0750000
NODE_1235_length_2098_cov_62.733867	1171	1251	11	15	80	0.1875000
NODE_1235_length_2098_cov_62.733867	1171	1251	12	22	80	0.2750000
NODE_1235_length_2098_cov_62.733867	1171	1251	13	23	80	0.2875000
NODE_1235_length_2098_cov_62.733867	1171	1251	14	17	80	0.2125000
NODE_1235_length_2098_cov_62.733867	1171	1251	15	3	80	0.0375000
NODE_1235_length_2098_cov_62.733867	1224	1304	11	8	80	0.1000000
NODE_1235_length_2098_cov_62.733867	1224	1304	12	13	80	0.1625000
NODE_1235_length_2098_cov_62.733867	1224	1304	13	17	80	0.2125000
NODE_1235_length_2098_cov_62.733867	1224	1304	14	1	80	0.0125000
NODE_1235_length_2098_cov_62.733867	1224	1304	15	33	80	0.4125000
NODE_1235_length_2098_cov_62.733867	1224	1304	16	6	80	0.0750000
NODE_1235_length_2098_cov_62.733867	1224	1304	17	2	80	0.0250000
NODE_1236_length_2098_cov_20.220110	550	630	2	27	80	0.3375000
NODE_1236_length_2098_cov_20.220110	550	630	3	53	80	0.6625000
NODE_1236_length_2098_cov_20.220110	603	683	3	30	80	0.3750000
NODE_1236_length_2098_cov_20.220110	603	683	4	50	80	0.6250000
NODE_1236_length_2098_cov_20.220110	1571	1651	2	3	80	0.0375000
NODE_1236_length_2098_cov_20.220110	1571	1651	3	5	80	0.0625000
NODE_1236_length_2098_cov_20.220110	1571	1651	4	27	80	0.3375000
NODE_1236_length_2098_cov_20.220110	1571	1651	5	45	80	0.5625000
NODE_1236_length_2098_cov_20.220110	1624	1704	0	5	80	0.0625000
NODE_1236_length_2098_cov_20.220110	1624	1704	1	28	80	0.3500000
NODE_1236_length_2098_cov_20.220110	1624	1704	2	23	80	0.2875000
NODE_1236_length_2098_cov_20.220110	1624	1704	3	5	80	0.0625000
NODE_1236_length_2098_cov_20.220110	1624	1704	4	19	80	0.2375000
NODE_1237_length_2098_cov_8.261631	324	404	0	80	80	1.0000000
NODE_1239_length_2095_cov_29.930862	1128	1209	33	2	81	0.0246914
NODE_1239_length_2095_cov_29.930862	1128	1209	34	1	81	0.0123457
NODE_1239_length_2095_cov_29.930862	1128	1209	35	3	81	0.0370370
NODE_1239_length_2095_cov_29.930862	1128	1209	37	1	81	0.0123457
NODE_1239_length_2095_cov_29.930862	1128	1209	39	1	81	0.0123457
NODE_1239_length_2095_cov_29.930862	1128	1209	42	1	81	0.0123457
NODE_1239_length_2095_cov_29.930862	1128	1209	46	3	81	0.0370370
NODE_1239_length_2095_cov_29.930862	1128	1209	47	1	81	0.0123457
NODE_1239_length_2095_cov_29.930862	1128	1209	48	1	81	0.0123457
NODE_1239_length_2095_cov_29.930862	1128	1209	51	1	81	0.0123457
NODE_1239_length_2095_cov_29.930862	1128	1209	52	1	81	0.0123457
NODE_1239_length_2095_cov_29.930862	1128	1209	53	1	81	0.0123457
NODE_1239_length_2095_cov_29.930862	1128	1209	54	6	81	0.0740741
NODE_1239_length_2095_cov_29.930862	1128	1209	55	4	81	0.0493827
NODE_1239_length_2095_cov_29.930862	1128	1209	56	6	81	0.0740741
NODE_1239_length_2095_cov_29.930862	1128	1209	58	1	81	0.0123457
NODE_1239_length_2095_cov_29.930862	1128	1209	60	1	81	0.0123457
NODE_1239_length_2095_cov_29.930862	1128	1209	62	1	81	0.0123457
NODE_1239_length_2095_cov_29.930862	1128	1209	63	2	81	0.0246914
NODE_1239_length_2095_cov_29.930862	1128	1209	64	3	81	0.0370370
NODE_1239_length_2095_cov_29.930862	1128	1209	67	1	81	0.0123457
NODE_1239_length_2095_cov_29.930862	1128	1209	70	2	81	0.0246914
NODE_1239_length_2095_cov_29.930862	1128	1209	71	4	81	0.0493827
NODE_1239_length_2095_cov_29.930862	1128	1209	73	1	81	0.0123457
NODE_1239_length_2095_cov_29.930862	1128	1209	76	2	81	0.0246914
NODE_1239_length_2095_cov_29.930862	1128	1209	78	8	81	0.0987654
NODE_1239_length_2095_cov_29.930862	1128	1209	80	4	81	0.0493827
NODE_1239_length_2095_cov_29.930862	1128	1209	82	1	81	0.0123457
NODE_1239_length_2095_cov_29.930862	1128	1209	83	4	81	0.0493827
NODE_1239_length_2095_cov_29.930862	1128	1209	84	5	81	0.0617284
NODE_1239_length_2095_cov_29.930862	1128	1209	87	2	81	0.0246914
NODE_1239_length_2095_cov_29.930862	1128	1209	88	1	81	0.0123457
NODE_1239_length_2095_cov_29.930862	1128	1209	89	4	81	0.0493827
NODE_1239_length_2095_cov_29.930862	1128	1209	90	1	81	0.0123457
NODE_1239_length_2095_cov_29.930862	1204	1258	84	1	54	0.0185185
NODE_1239_length_2095_cov_29.930862	1204	1258	85	2	54	0.0370370
NODE_1239_length_2095_cov_29.930862	1204	1258	88	1	54	0.0185185
NODE_1239_length_2095_cov_29.930862	1204	1258	89	4	54	0.0740741
NODE_1239_length_2095_cov_29.930862	1204	1258	90	5	54	0.0925926
NODE_1239_length_2095_cov_29.930862	1204	1258	91	3	54	0.0555556
NODE_1239_length_2095_cov_29.930862	1204	1258	92	3	54	0.0555556
NODE_1239_length_2095_cov_29.930862	1204	1258	93	7	54	0.1296296
NODE_1239_length_2095_cov_29.930862	1204	1258	94	3	54	0.0555556
NODE_1239_length_2095_cov_29.930862	1204	1258	95	4	54	0.0740741
NODE_1239_length_2095_cov_29.930862	1204	1258	96	2	54	0.0370370
NODE_1239_length_2095_cov_29.930862	1204	1258	97	1	54	0.0185185
NODE_1239_length_2095_cov_29.930862	1204	1258	98	5	54	0.0925926
NODE_1239_length_2095_cov_29.930862	1204	1258	99	2	54	0.0370370
NODE_1239_length_2095_cov_29.930862	1204	1258	100	4	54	0.0740741
NODE_1239_length_2095_cov_29.930862	1204	1258	101	6	54	0.1111111
NODE_1239_length_2095_cov_29.930862	1204	1258	102	1	54	0.0185185
NODE_1251_length_2084_cov_1.720403	959	1039	0	7	80	0.0875000
NODE_1251_length_2084_cov_1.720403	959	1039	1	48	80	0.6000000
NODE_1251_length_2084_cov_1.720403	959	1039	2	25	80	0.3125000
NODE_1251_length_2084_cov_1.720403	1012	1092	0	60	80	0.7500000
NODE_1251_length_2084_cov_1.720403	1012	1092	1	20	80	0.2500000
NODE_1252_length_2083_cov_5.864415	419	499	0	21	80	0.2625000
NODE_1252_length_2083_cov_5.864415	419	499	1	56	80	0.7000000
NODE_1252_length_2083_cov_5.864415	419	499	2	3	80	0.0375000
NODE_1252_length_2083_cov_5.864415	472	552	1	24	80	0.3000000
NODE_1252_length_2083_cov_5.864415	472	552	2	5	80	0.0625000
NODE_1252_length_2083_cov_5.864415	472	552	3	21	80	0.2625000
NODE_1252_length_2083_cov_5.864415	472	552	4	25	80	0.3125000
NODE_1252_length_2083_cov_5.864415	472	552	5	2	80	0.0250000
NODE_1252_length_2083_cov_5.864415	472	552	7	3	80	0.0375000
NODE_1252_length_2083_cov_5.864415	548	628	5	1	80	0.0125000
NODE_1252_length_2083_cov_5.864415	548	628	7	45	80	0.5625000
NODE_1252_length_2083_cov_5.864415	548	628	8	34	80	0.4250000
NODE_1252_length_2083_cov_5.864415	601	681	2	10	80	0.1250000
NODE_1252_length_2083_cov_5.864415	601	681	3	17	80	0.2125000
NODE_1252_length_2083_cov_5.864415	601	681	5	3	80	0.0375000
NODE_1252_length_2083_cov_5.864415	601	681	6	5	80	0.0625000
NODE_1252_length_2083_cov_5.864415	601	681	7	45	80	0.5625000
NODE_1256_length_2078_cov_47.394644	311	391	0	18	80	0.2250000
NODE_1256_length_2078_cov_47.394644	311	391	3	34	80	0.4250000
NODE_1256_length_2078_cov_47.394644	311	391	4	28	80	0.3500000
NODE_1256_length_2078_cov_47.394644	364	444	4	66	80	0.8250000
NODE_1256_length_2078_cov_47.394644	364	444	5	2	80	0.0250000
NODE_1256_length_2078_cov_47.394644	364	444	6	2	80	0.0250000
NODE_1256_length_2078_cov_47.394644	364	444	8	10	80	0.1250000
NODE_1256_length_2078_cov_47.394644	440	520	5	7	80	0.0875000
NODE_1256_length_2078_cov_47.394644	440	520	6	34	80	0.4250000
NODE_1256_length_2078_cov_47.394644	440	520	7	18	80	0.2250000
NODE_1256_length_2078_cov_47.394644	440	520	8	18	80	0.2250000
NODE_1256_length_2078_cov_47.394644	440	520	9	3	80	0.0375000
NODE_1256_length_2078_cov_47.394644	493	573	3	9	80	0.1125000
NODE_1256_length_2078_cov_47.394644	493	573	5	51	80	0.6375000
NODE_1256_length_2078_cov_47.394644	493	573	6	20	80	0.2500000
NODE_1267_length_2067_cov_13.647866	1349	1429	7	35	80	0.4375000
NODE_1267_length_2067_cov_13.647866	1349	1429	8	40	80	0.5000000
NODE_1267_length_2067_cov_13.647866	1349	1429	10	5	80	0.0625000
NODE_1267_length_2067_cov_13.647866	1402	1482	6	14	80	0.1750000
NODE_1267_length_2067_cov_13.647866	1402	1482	7	3	80	0.0375000
NODE_1267_length_2067_cov_13.647866	1402	1482	8	25	80	0.3125000
NODE_1267_length_2067_cov_13.647866	1402	1482	9	11	80	0.1375000
NODE_1267_length_2067_cov_13.647866	1402	1482	10	21	80	0.2625000
NODE_1267_length_2067_cov_13.647866	1402	1482	11	6	80	0.0750000
NODE_1269_length_2066_cov_19.127605	1497	1577	2	62	80	0.7750000
NODE_1269_length_2066_cov_19.127605	1497	1577	3	18	80	0.2250000
NODE_1269_length_2066_cov_19.127605	1550	1630	2	80	80	1.0000000
NODE_1274_length_2061_cov_43.187054	364	444	0	21	80	0.2625000
NODE_1274_length_2061_cov_43.187054	364	444	1	46	80	0.5750000
NODE_1274_length_2061_cov_43.187054	364	444	3	13	80	0.1625000
NODE_1274_length_2061_cov_43.187054	417	497	1	14	80	0.1750000
NODE_1274_length_2061_cov_43.187054	417	497	3	14	80	0.1750000
NODE_1274_length_2061_cov_43.187054	417	497	4	4	80	0.0500000
NODE_1274_length_2061_cov_43.187054	417	497	5	48	80	0.6000000
NODE_1275_length_2061_cov_3.251784	981	1033	1	52	52	1.0000000
NODE_1275_length_2061_cov_3.251784	1006	1086	1	54	80	0.6750000
NODE_1275_length_2061_cov_3.251784	1006	1086	2	26	80	0.3250000
NODE_1277_length_2058_cov_4.531394	1844	1875	0	5	31	0.1612903
NODE_1277_length_2058_cov_4.531394	1844	1875	2	18	31	0.5806451
NODE_1277_length_2058_cov_4.531394	1844	1875	4	8	31	0.2580645
NODE_1277_length_2058_cov_4.531394	1848	1928	0	1	80	0.0125000
NODE_1277_length_2058_cov_4.531394	1848	1928	2	18	80	0.2250000
NODE_1277_length_2058_cov_4.531394	1848	1928	4	61	80	0.7625000
NODE_1279_length_2056_cov_20.525805	749	829	1	42	80	0.5250000
NODE_1279_length_2056_cov_20.525805	749	829	2	2	80	0.0250000
NODE_1279_length_2056_cov_20.525805	749	829	3	1	80	0.0125000
NODE_1279_length_2056_cov_20.525805	749	829	4	2	80	0.0250000
NODE_1279_length_2056_cov_20.525805	749	829	5	16	80	0.2000000
NODE_1279_length_2056_cov_20.525805	749	829	6	13	80	0.1625000
NODE_1279_length_2056_cov_20.525805	749	829	7	4	80	0.0500000
NODE_1279_length_2056_cov_20.525805	802	882	5	10	80	0.1250000
NODE_1279_length_2056_cov_20.525805	802	882	6	13	80	0.1625000
NODE_1279_length_2056_cov_20.525805	802	882	7	22	80	0.2750000
NODE_1279_length_2056_cov_20.525805	802	882	8	2	80	0.0250000
NODE_1279_length_2056_cov_20.525805	802	882	9	9	80	0.1125000
NODE_1279_length_2056_cov_20.525805	802	882	10	16	80	0.2000000
NODE_1279_length_2056_cov_20.525805	802	882	12	8	80	0.1000000
NODE_1279_length_2056_cov_20.525805	878	958	12	11	80	0.1375000
NODE_1279_length_2056_cov_20.525805	878	958	13	1	80	0.0125000
NODE_1279_length_2056_cov_20.525805	878	958	14	15	80	0.1875000
NODE_1279_length_2056_cov_20.525805	878	958	15	4	80	0.0500000
NODE_1279_length_2056_cov_20.525805	878	958	16	1	80	0.0125000
NODE_1279_length_2056_cov_20.525805	878	958	17	20	80	0.2500000
NODE_1279_length_2056_cov_20.525805	878	958	18	28	80	0.3500000
NODE_1279_length_2056_cov_20.525805	931	1011	7	3	80	0.0375000
NODE_1279_length_2056_cov_20.525805	931	1011	8	11	80	0.1375000
NODE_1279_length_2056_cov_20.525805	931	1011	10	6	80	0.0750000
NODE_1279_length_2056_cov_20.525805	931	1011	12	16	80	0.2000000
NODE_1279_length_2056_cov_20.525805	931	1011	13	13	80	0.1625000
NODE_1279_length_2056_cov_20.525805	931	1011	14	16	80	0.2000000
NODE_1279_length_2056_cov_20.525805	931	1011	15	2	80	0.0250000
NODE_1279_length_2056_cov_20.525805	931	1011	16	1	80	0.0125000
NODE_1279_length_2056_cov_20.525805	931	1011	17	2	80	0.0250000
NODE_1279_length_2056_cov_20.525805	931	1011	18	10	80	0.1250000
NODE_1281_length_2055_cov_10.047546	1468	1548	0	80	80	1.0000000
NODE_1281_length_2055_cov_10.047546	1521	1601	0	80	80	1.0000000
NODE_1286_length_2049_cov_6.846154	270	350	0	21	80	0.2625000
NODE_1286_length_2049_cov_6.846154	270	350	2	4	80	0.0500000
NODE_1286_length_2049_cov_6.846154	270	350	4	26	80	0.3250000
NODE_1286_length_2049_cov_6.846154	270	350	5	1	80	0.0125000
NODE_1286_length_2049_cov_6.846154	270	350	6	28	80	0.3500000
NODE_1286_length_2049_cov_6.846154	323	403	6	41	80	0.5125000
NODE_1286_length_2049_cov_6.846154	323	403	8	39	80	0.4875000
NODE_1286_length_2049_cov_6.846154	1595	1674	1	10	79	0.1265823
NODE_1286_length_2049_cov_6.846154	1595	1674	2	32	79	0.4050633
NODE_1286_length_2049_cov_6.846154	1595	1674	3	37	79	0.4683544
NODE_1286_length_2049_cov_6.846154	1648	1712	2	21	64	0.3281250
NODE_1286_length_2049_cov_6.846154	1648	1712	3	43	64	0.6718750
NODE_1293_length_2045_cov_46.790339	876	956	12	8	80	0.1000000
NODE_1293_length_2045_cov_46.790339	876	956	14	7	80	0.0875000
NODE_1293_length_2045_cov_46.790339	876	956	16	3	80	0.0375000
NODE_1293_length_2045_cov_46.790339	876	956	17	3	80	0.0375000
NODE_1293_length_2045_cov_46.790339	876	956	19	19	80	0.2375000
NODE_1293_length_2045_cov_46.790339	876	956	20	4	80	0.0500000
NODE_1293_length_2045_cov_46.790339	876	956	21	3	80	0.0375000
NODE_1293_length_2045_cov_46.790339	876	956	22	7	80	0.0875000
NODE_1293_length_2045_cov_46.790339	876	956	23	1	80	0.0125000
NODE_1293_length_2045_cov_46.790339	876	956	24	3	80	0.0375000
NODE_1293_length_2045_cov_46.790339	876	956	25	5	80	0.0625000
NODE_1293_length_2045_cov_46.790339	876	956	27	6	80	0.0750000
NODE_1293_length_2045_cov_46.790339	876	956	28	6	80	0.0750000
NODE_1293_length_2045_cov_46.790339	876	956	29	4	80	0.0500000
NODE_1293_length_2045_cov_46.790339	876	956	30	1	80	0.0125000
NODE_1293_length_2045_cov_46.790339	929	1009	22	1	80	0.0125000
NODE_1293_length_2045_cov_46.790339	929	1009	23	12	80	0.1500000
NODE_1293_length_2045_cov_46.790339	929	1009	24	17	80	0.2125000
NODE_1293_length_2045_cov_46.790339	929	1009	25	19	80	0.2375000
NODE_1293_length_2045_cov_46.790339	929	1009	26	4	80	0.0500000
NODE_1293_length_2045_cov_46.790339	929	1009	27	8	80	0.1000000
NODE_1293_length_2045_cov_46.790339	929	1009	28	14	80	0.1750000
NODE_1293_length_2045_cov_46.790339	929	1009	29	4	80	0.0500000
NODE_1293_length_2045_cov_46.790339	929	1009	30	1	80	0.0125000
NODE_1293_length_2045_cov_46.790339	1005	1085	21	3	80	0.0375000
NODE_1293_length_2045_cov_46.790339	1005	1085	22	18	80	0.2250000
NODE_1293_length_2045_cov_46.790339	1005	1085	23	25	80	0.3125000
NODE_1293_length_2045_cov_46.790339	1005	1085	24	17	80	0.2125000
NODE_1293_length_2045_cov_46.790339	1005	1085	25	15	80	0.1875000
NODE_1293_length_2045_cov_46.790339	1005	1085	26	2	80	0.0250000
NODE_1293_length_2045_cov_46.790339	1058	1138	20	6	80	0.0750000
NODE_1293_length_2045_cov_46.790339	1058	1138	21	17	80	0.2125000
NODE_1293_length_2045_cov_46.790339	1058	1138	22	31	80	0.3875000
NODE_1293_length_2045_cov_46.790339	1058	1138	23	11	80	0.1375000
NODE_1293_length_2045_cov_46.790339	1058	1138	24	2	80	0.0250000
NODE_1293_length_2045_cov_46.790339	1058	1138	25	11	80	0.1375000
NODE_1293_length_2045_cov_46.790339	1058	1138	26	2	80	0.0250000
NODE_1298_length_2042_cov_4.447761	241	315	0	43	74	0.5810811
NODE_1298_length_2042_cov_4.447761	241	315	1	31	74	0.4189189
NODE_1301_length_2040_cov_30.109737	1760	1844	48	1	84	0.0119048
NODE_1301_length_2040_cov_30.109737	1760	1844	49	2	84	0.0238095
NODE_1301_length_2040_cov_30.109737	1760	1844	50	5	84	0.0595238
NODE_1301_length_2040_cov_30.109737	1760	1844	51	12	84	0.1428571
NODE_1301_length_2040_cov_30.109737	1760	1844	52	17	84	0.2023810
NODE_1301_length_2040_cov_30.109737	1760	1844	53	19	84	0.2261905
NODE_1301_length_2040_cov_30.109737	1760	1844	54	6	84	0.0714286
NODE_1301_length_2040_cov_30.109737	1760	1844	55	6	84	0.0714286
NODE_1301_length_2040_cov_30.109737	1760	1844	56	1	84	0.0119048
NODE_1301_length_2040_cov_30.109737	1760	1844	57	3	84	0.0357143
NODE_1301_length_2040_cov_30.109737	1760	1844	59	9	84	0.1071429
NODE_1301_length_2040_cov_30.109737	1760	1844	61	3	84	0.0357143
NODE_1306_length_2036_cov_11.672173	369	449	0	80	80	1.0000000
NODE_1306_length_2036_cov_11.672173	422	502	0	80	80	1.0000000
NODE_1312_length_2032_cov_11.188308	416	496	0	80	80	1.0000000
NODE_1312_length_2032_cov_11.188308	469	549	0	80	80	1.0000000
NODE_1318_length_2027_cov_43.702282	1129	1209	2	7	80	0.0875000
NODE_1318_length_2027_cov_43.702282	1129	1209	3	7	80	0.0875000
NODE_1318_length_2027_cov_43.702282	1129	1209	4	17	80	0.2125000
NODE_1318_length_2027_cov_43.702282	1129	1209	5	4	80	0.0500000
NODE_1318_length_2027_cov_43.702282	1129	1209	6	8	80	0.1000000
NODE_1318_length_2027_cov_43.702282	1129	1209	7	12	80	0.1500000
NODE_1318_length_2027_cov_43.702282	1129	1209	8	25	80	0.3125000
NODE_1318_length_2027_cov_43.702282	1182	1262	7	2	80	0.0250000
NODE_1318_length_2027_cov_43.702282	1182	1262	8	28	80	0.3500000
NODE_1318_length_2027_cov_43.702282	1182	1262	9	1	80	0.0125000
NODE_1318_length_2027_cov_43.702282	1182	1262	10	2	80	0.0250000
NODE_1318_length_2027_cov_43.702282	1182	1262	11	5	80	0.0625000
NODE_1318_length_2027_cov_43.702282	1182	1262	13	19	80	0.2375000
NODE_1318_length_2027_cov_43.702282	1182	1262	14	7	80	0.0875000
NODE_1318_length_2027_cov_43.702282	1182	1262	15	2	80	0.0250000
NODE_1318_length_2027_cov_43.702282	1182	1262	16	2	80	0.0250000
NODE_1318_length_2027_cov_43.702282	1182	1262	17	10	80	0.1250000
NODE_1318_length_2027_cov_43.702282	1182	1262	18	2	80	0.0250000
NODE_1318_length_2027_cov_43.702282	1258	1338	13	4	80	0.0500000
NODE_1318_length_2027_cov_43.702282	1258	1338	14	5	80	0.0625000
NODE_1318_length_2027_cov_43.702282	1258	1338	15	10	80	0.1250000
NODE_1318_length_2027_cov_43.702282	1258	1338	16	9	80	0.1125000
NODE_1318_length_2027_cov_43.702282	1258	1338	17	33	80	0.4125000
NODE_1318_length_2027_cov_43.702282	1258	1338	18	10	80	0.1250000
NODE_1318_length_2027_cov_43.702282	1258	1338	19	9	80	0.1125000
NODE_1318_length_2027_cov_43.702282	1311	1391	11	22	80	0.2750000
NODE_1318_length_2027_cov_43.702282	1311	1391	12	6	80	0.0750000
NODE_1318_length_2027_cov_43.702282	1311	1391	13	14	80	0.1750000
NODE_1318_length_2027_cov_43.702282	1311	1391	14	20	80	0.2500000
NODE_1318_length_2027_cov_43.702282	1311	1391	15	10	80	0.1250000
NODE_1318_length_2027_cov_43.702282	1311	1391	16	8	80	0.1000000
NODE_1319_length_2027_cov_6.558610	229	303	0	74	74	1.0000000
NODE_1319_length_2027_cov_6.558610	229	303	0	74	74	1.0000000
NODE_1319_length_2027_cov_6.558610	276	356	0	80	80	1.0000000
NODE_1320_length_2026_cov_18.457706	688	768	6	1	80	0.0125000
NODE_1320_length_2026_cov_18.457706	688	768	7	11	80	0.1375000
NODE_1320_length_2026_cov_18.457706	688	768	8	31	80	0.3875000
NODE_1320_length_2026_cov_18.457706	688	768	9	11	80	0.1375000
NODE_1320_length_2026_cov_18.457706	688	768	10	26	80	0.3250000
NODE_1320_length_2026_cov_18.457706	741	821	5	29	80	0.3625000
NODE_1320_length_2026_cov_18.457706	741	821	6	25	80	0.3125000
NODE_1320_length_2026_cov_18.457706	741	821	8	18	80	0.2250000
NODE_1320_length_2026_cov_18.457706	741	821	9	8	80	0.1000000
NODE_1324_length_2025_cov_10.711319	617	697	0	31	80	0.3875000
NODE_1324_length_2025_cov_10.711319	617	697	2	27	80	0.3375000
NODE_1324_length_2025_cov_10.711319	617	697	3	22	80	0.2750000
NODE_1324_length_2025_cov_10.711319	712	783	2	10	71	0.1408451
NODE_1324_length_2025_cov_10.711319	712	783	3	48	71	0.6760563
NODE_1324_length_2025_cov_10.711319	712	783	4	13	71	0.1830986
NODE_1324_length_2025_cov_10.711319	756	829	3	29	73	0.3972603
NODE_1324_length_2025_cov_10.711319	756	829	4	4	73	0.0547945
NODE_1324_length_2025_cov_10.711319	756	829	5	40	73	0.5479452
NODE_1325_length_2024_cov_33.891948	1045	1125	2	14	80	0.1750000
NODE_1325_length_2024_cov_33.891948	1045	1125	3	3	80	0.0375000
NODE_1325_length_2024_cov_33.891948	1045	1125	4	18	80	0.2250000
NODE_1325_length_2024_cov_33.891948	1045	1125	6	22	80	0.2750000
NODE_1325_length_2024_cov_33.891948	1045	1125	7	16	80	0.2000000
NODE_1325_length_2024_cov_33.891948	1045	1125	9	7	80	0.0875000
NODE_1325_length_2024_cov_33.891948	1098	1178	6	4	80	0.0500000
NODE_1325_length_2024_cov_33.891948	1098	1178	7	16	80	0.2000000
NODE_1325_length_2024_cov_33.891948	1098	1178	9	7	80	0.0875000
NODE_1325_length_2024_cov_33.891948	1098	1178	10	4	80	0.0500000
NODE_1325_length_2024_cov_33.891948	1098	1178	11	40	80	0.5000000
NODE_1325_length_2024_cov_33.891948	1098	1178	12	9	80	0.1125000
NODE_1331_length_2018_cov_33.742053	1215	1295	20	5	80	0.0625000
NODE_1331_length_2018_cov_33.742053	1215	1295	21	9	80	0.1125000
NODE_1331_length_2018_cov_33.742053	1215	1295	22	9	80	0.1125000
NODE_1331_length_2018_cov_33.742053	1215	1295	23	28	80	0.3500000
NODE_1331_length_2018_cov_33.742053	1215	1295	25	16	80	0.2000000
NODE_1331_length_2018_cov_33.742053	1215	1295	26	1	80	0.0125000
NODE_1331_length_2018_cov_33.742053	1215	1295	27	1	80	0.0125000
NODE_1331_length_2018_cov_33.742053	1215	1295	28	4	80	0.0500000
NODE_1331_length_2018_cov_33.742053	1215	1295	29	5	80	0.0625000
NODE_1331_length_2018_cov_33.742053	1215	1295	30	2	80	0.0250000
NODE_1331_length_2018_cov_33.742053	1268	1298	20	4	30	0.1333333
NODE_1331_length_2018_cov_33.742053	1268	1298	21	5	30	0.1666667
NODE_1331_length_2018_cov_33.742053	1268	1298	22	1	30	0.0333333
NODE_1331_length_2018_cov_33.742053	1268	1298	23	20	30	0.6666667
NODE_1331_length_2018_cov_33.742053	1876	1942	46	1	66	0.0151515
NODE_1331_length_2018_cov_33.742053	1876	1942	48	2	66	0.0303030
NODE_1331_length_2018_cov_33.742053	1876	1942	49	1	66	0.0151515
NODE_1331_length_2018_cov_33.742053	1876	1942	52	3	66	0.0454545
NODE_1331_length_2018_cov_33.742053	1876	1942	54	1	66	0.0151515
NODE_1331_length_2018_cov_33.742053	1876	1942	55	2	66	0.0303030
NODE_1331_length_2018_cov_33.742053	1876	1942	60	1	66	0.0151515
NODE_1331_length_2018_cov_33.742053	1876	1942	63	3	66	0.0454545
NODE_1331_length_2018_cov_33.742053	1876	1942	64	1	66	0.0151515
NODE_1331_length_2018_cov_33.742053	1876	1942	68	2	66	0.0303030
NODE_1331_length_2018_cov_33.742053	1876	1942	70	5	66	0.0757576
NODE_1331_length_2018_cov_33.742053	1876	1942	71	2	66	0.0303030
NODE_1331_length_2018_cov_33.742053	1876	1942	72	4	66	0.0606061
NODE_1331_length_2018_cov_33.742053	1876	1942	74	3	66	0.0454545
NODE_1331_length_2018_cov_33.742053	1876	1942	75	4	66	0.0606061
NODE_1331_length_2018_cov_33.742053	1876	1942	76	3	66	0.0454545
NODE_1331_length_2018_cov_33.742053	1876	1942	77	7	66	0.1060606
NODE_1331_length_2018_cov_33.742053	1876	1942	78	5	66	0.0757576
NODE_1331_length_2018_cov_33.742053	1876	1942	83	7	66	0.1060606
NODE_1331_length_2018_cov_33.742053	1876	1942	84	4	66	0.0606061
NODE_1331_length_2018_cov_33.742053	1876	1942	85	3	66	0.0454545
NODE_1331_length_2018_cov_33.742053	1876	1942	86	1	66	0.0151515
NODE_1331_length_2018_cov_33.742053	1876	1942	88	1	66	0.0151515
NODE_1331_length_2018_cov_33.742053	1915	1995	2	4	80	0.0500000
NODE_1331_length_2018_cov_33.742053	1915	1995	8	2	80	0.0250000
NODE_1331_length_2018_cov_33.742053	1915	1995	12	4	80	0.0500000
NODE_1331_length_2018_cov_33.742053	1915	1995	15	1	80	0.0125000
NODE_1331_length_2018_cov_33.742053	1915	1995	16	4	80	0.0500000
NODE_1331_length_2018_cov_33.742053	1915	1995	21	2	80	0.0250000
NODE_1331_length_2018_cov_33.742053	1915	1995	22	3	80	0.0375000
NODE_1331_length_2018_cov_33.742053	1915	1995	23	4	80	0.0500000
NODE_1331_length_2018_cov_33.742053	1915	1995	26	5	80	0.0625000
NODE_1331_length_2018_cov_33.742053	1915	1995	28	3	80	0.0375000
NODE_1331_length_2018_cov_33.742053	1915	1995	29	1	80	0.0125000
NODE_1331_length_2018_cov_33.742053	1915	1995	30	1	80	0.0125000
NODE_1331_length_2018_cov_33.742053	1915	1995	34	3	80	0.0375000
NODE_1331_length_2018_cov_33.742053	1915	1995	35	1	80	0.0125000
NODE_1331_length_2018_cov_33.742053	1915	1995	36	1	80	0.0125000
NODE_1331_length_2018_cov_33.742053	1915	1995	37	1	80	0.0125000
NODE_1331_length_2018_cov_33.742053	1915	1995	39	1	80	0.0125000
NODE_1331_length_2018_cov_33.742053	1915	1995	41	1	80	0.0125000
NODE_1331_length_2018_cov_33.742053	1915	1995	42	1	80	0.0125000
NODE_1331_length_2018_cov_33.742053	1915	1995	44	6	80	0.0750000
NODE_1331_length_2018_cov_33.742053	1915	1995	46	5	80	0.0625000
NODE_1331_length_2018_cov_33.742053	1915	1995	48	2	80	0.0250000
NODE_1331_length_2018_cov_33.742053	1915	1995	49	1	80	0.0125000
NODE_1331_length_2018_cov_33.742053	1915	1995	52	3	80	0.0375000
NODE_1331_length_2018_cov_33.742053	1915	1995	54	1	80	0.0125000
NODE_1331_length_2018_cov_33.742053	1915	1995	55	2	80	0.0250000
NODE_1331_length_2018_cov_33.742053	1915	1995	60	1	80	0.0125000
NODE_1331_length_2018_cov_33.742053	1915	1995	63	3	80	0.0375000
NODE_1331_length_2018_cov_33.742053	1915	1995	64	1	80	0.0125000
NODE_1331_length_2018_cov_33.742053	1915	1995	68	2	80	0.0250000
NODE_1331_length_2018_cov_33.742053	1915	1995	70	5	80	0.0625000
NODE_1331_length_2018_cov_33.742053	1915	1995	71	2	80	0.0250000
NODE_1331_length_2018_cov_33.742053	1915	1995	72	3	80	0.0375000
NODE_1337_length_2011_cov_22.430439	434	514	7	3	80	0.0375000
NODE_1337_length_2011_cov_22.430439	434	514	8	17	80	0.2125000
NODE_1337_length_2011_cov_22.430439	434	514	10	7	80	0.0875000
NODE_1337_length_2011_cov_22.430439	434	514	11	53	80	0.6625000
NODE_1337_length_2011_cov_22.430439	487	567	0	32	80	0.4000000
NODE_1337_length_2011_cov_22.430439	487	567	5	13	80	0.1625000
NODE_1337_length_2011_cov_22.430439	487	567	7	11	80	0.1375000
NODE_1337_length_2011_cov_22.430439	487	567	8	17	80	0.2125000
NODE_1337_length_2011_cov_22.430439	487	567	10	7	80	0.0875000
NODE_1337_length_2011_cov_22.430439	1124	1204	5	9	80	0.1125000
NODE_1337_length_2011_cov_22.430439	1124	1204	7	36	80	0.4500000
NODE_1337_length_2011_cov_22.430439	1124	1204	8	8	80	0.1000000
NODE_1337_length_2011_cov_22.430439	1124	1204	9	2	80	0.0250000
NODE_1337_length_2011_cov_22.430439	1124	1204	10	25	80	0.3125000
NODE_1337_length_2011_cov_22.430439	1177	1257	5	7	80	0.0875000
NODE_1337_length_2011_cov_22.430439	1177	1257	7	1	80	0.0125000
NODE_1337_length_2011_cov_22.430439	1177	1257	8	4	80	0.0500000
NODE_1337_length_2011_cov_22.430439	1177	1257	9	6	80	0.0750000
NODE_1337_length_2011_cov_22.430439	1177	1257	10	50	80	0.6250000
NODE_1337_length_2011_cov_22.430439	1177	1257	11	12	80	0.1500000
NODE_1343_length_2001_cov_10.416404	692	772	6	9	80	0.1125000
NODE_1343_length_2001_cov_10.416404	692	772	7	29	80	0.3625000
NODE_1343_length_2001_cov_10.416404	692	772	8	13	80	0.1625000
NODE_1343_length_2001_cov_10.416404	692	772	9	29	80	0.3625000
NODE_1343_length_2001_cov_10.416404	745	825	5	14	80	0.1750000
NODE_1343_length_2001_cov_10.416404	745	825	6	42	80	0.5250000
NODE_1343_length_2001_cov_10.416404	745	825	9	24	80	0.3000000
NODE_1350_length_1991_cov_112.926533	212	292	63	1	80	0.0125000
NODE_1350_length_1991_cov_112.926533	212	292	64	2	80	0.0250000
NODE_1350_length_1991_cov_112.926533	212	292	65	1	80	0.0125000
NODE_1350_length_1991_cov_112.926533	212	292	66	2	80	0.0250000
NODE_1350_length_1991_cov_112.926533	212	292	69	1	80	0.0125000
NODE_1350_length_1991_cov_112.926533	212	292	70	2	80	0.0250000
NODE_1350_length_1991_cov_112.926533	212	292	71	2	80	0.0250000
NODE_1350_length_1991_cov_112.926533	212	292	72	1	80	0.0125000
NODE_1350_length_1991_cov_112.926533	212	292	73	3	80	0.0375000
NODE_1350_length_1991_cov_112.926533	212	292	74	7	80	0.0875000
NODE_1350_length_1991_cov_112.926533	212	292	75	1	80	0.0125000
NODE_1350_length_1991_cov_112.926533	212	292	76	1	80	0.0125000
NODE_1350_length_1991_cov_112.926533	212	292	78	1	80	0.0125000
NODE_1350_length_1991_cov_112.926533	212	292	79	5	80	0.0625000
NODE_1350_length_1991_cov_112.926533	212	292	80	5	80	0.0625000
NODE_1350_length_1991_cov_112.926533	212	292	81	13	80	0.1625000
NODE_1350_length_1991_cov_112.926533	212	292	82	7	80	0.0875000
NODE_1350_length_1991_cov_112.926533	212	292	83	3	80	0.0375000
NODE_1350_length_1991_cov_112.926533	212	292	84	13	80	0.1625000
NODE_1350_length_1991_cov_112.926533	212	292	85	8	80	0.1000000
NODE_1350_length_1991_cov_112.926533	212	292	86	1	80	0.0125000
NODE_1352_length_1988_cov_13.736368	865	945	10	16	80	0.2000000
NODE_1352_length_1988_cov_13.736368	865	945	12	50	80	0.6250000
NODE_1352_length_1988_cov_13.736368	865	945	13	14	80	0.1750000
NODE_1352_length_1988_cov_13.736368	918	998	6	6	80	0.0750000
NODE_1352_length_1988_cov_13.736368	918	998	7	5	80	0.0625000
NODE_1352_length_1988_cov_13.736368	918	998	9	18	80	0.2250000
NODE_1352_length_1988_cov_13.736368	918	998	10	8	80	0.1000000
NODE_1352_length_1988_cov_13.736368	918	998	12	42	80	0.5250000
NODE_1352_length_1988_cov_13.736368	918	998	13	1	80	0.0125000
NODE_1353_length_1988_cov_9.980413	1616	1696	3	7	80	0.0875000
NODE_1353_length_1988_cov_9.980413	1616	1696	4	13	80	0.1625000
NODE_1353_length_1988_cov_9.980413	1616	1696	5	36	80	0.4500000
NODE_1353_length_1988_cov_9.980413	1616	1696	6	24	80	0.3000000
NODE_1353_length_1988_cov_9.980413	1669	1749	4	64	80	0.8000000
NODE_1353_length_1988_cov_9.980413	1669	1749	5	2	80	0.0250000
NODE_1353_length_1988_cov_9.980413	1669	1749	6	14	80	0.1750000
NODE_1356_length_1983_cov_17.332803	494	574	6	4	80	0.0500000
NODE_1356_length_1983_cov_17.332803	494	574	8	10	80	0.1250000
NODE_1356_length_1983_cov_17.332803	494	574	9	31	80	0.3875000
NODE_1356_length_1983_cov_17.332803	494	574	10	3	80	0.0375000
NODE_1356_length_1983_cov_17.332803	494	574	11	17	80	0.2125000
NODE_1356_length_1983_cov_17.332803	494	574	13	10	80	0.1250000
NODE_1356_length_1983_cov_17.332803	494	574	14	5	80	0.0625000
NODE_1356_length_1983_cov_17.332803	547	627	7	8	80	0.1000000
NODE_1356_length_1983_cov_17.332803	547	627	8	41	80	0.5125000
NODE_1356_length_1983_cov_17.332803	547	627	9	1	80	0.0125000
NODE_1356_length_1983_cov_17.332803	547	627	11	19	80	0.2375000
NODE_1356_length_1983_cov_17.332803	547	627	13	10	80	0.1250000
NODE_1356_length_1983_cov_17.332803	547	627	14	1	80	0.0125000
NODE_1356_length_1983_cov_17.332803	1600	1680	3	13	80	0.1625000
NODE_1356_length_1983_cov_17.332803	1600	1680	5	6	80	0.0750000
NODE_1356_length_1983_cov_17.332803	1600	1680	7	28	80	0.3500000
NODE_1356_length_1983_cov_17.332803	1600	1680	8	27	80	0.3375000
NODE_1356_length_1983_cov_17.332803	1600	1680	9	6	80	0.0750000
NODE_1356_length_1983_cov_17.332803	1653	1733	5	2	80	0.0250000
NODE_1356_length_1983_cov_17.332803	1653	1733	7	2	80	0.0250000
NODE_1356_length_1983_cov_17.332803	1653	1733	8	23	80	0.2875000
NODE_1356_length_1983_cov_17.332803	1653	1733	9	53	80	0.6625000
NODE_1359_length_1982_cov_17.164100	457	537	3	10	80	0.1250000
NODE_1359_length_1982_cov_17.164100	457	537	4	68	80	0.8500000
NODE_1359_length_1982_cov_17.164100	457	537	5	2	80	0.0250000
NODE_1359_length_1982_cov_17.164100	510	590	2	39	80	0.4875000
NODE_1359_length_1982_cov_17.164100	510	590	4	41	80	0.5125000
NODE_1359_length_1982_cov_17.164100	586	666	1	7	80	0.0875000
NODE_1359_length_1982_cov_17.164100	586	666	2	64	80	0.8000000
NODE_1359_length_1982_cov_17.164100	586	666	3	9	80	0.1125000
NODE_1359_length_1982_cov_17.164100	639	723	1	6	84	0.0714286
NODE_1359_length_1982_cov_17.164100	639	723	2	14	84	0.1666667
NODE_1359_length_1982_cov_17.164100	639	723	3	64	84	0.7619048
NODE_1360_length_1981_cov_46.444208	0	70	1	2	70	0.0285714
NODE_1360_length_1981_cov_46.444208	0	70	2	68	70	0.9714286
NODE_1362_length_1979_cov_1.630851	1554	1634	0	80	80	1.0000000
NODE_1364_length_1976_cov_1.959510	154	215	8	4	61	0.0655738
NODE_1364_length_1976_cov_1.959510	154	215	9	38	61	0.6229508
NODE_1364_length_1976_cov_1.959510	154	215	10	17	61	0.2786885
NODE_1364_length_1976_cov_1.959510	154	215	11	2	61	0.0327869
NODE_1364_length_1976_cov_1.959510	154	215	8	4	61	0.0655738
NODE_1364_length_1976_cov_1.959510	154	215	9	38	61	0.6229508
NODE_1364_length_1976_cov_1.959510	154	215	10	17	61	0.2786885
NODE_1364_length_1976_cov_1.959510	154	215	11	2	61	0.0327869
NODE_1364_length_1976_cov_1.959510	154	213	8	4	59	0.0677966
NODE_1364_length_1976_cov_1.959510	154	213	9	36	59	0.6101695
NODE_1364_length_1976_cov_1.959510	154	213	10	17	59	0.2881356
NODE_1364_length_1976_cov_1.959510	154	213	11	2	59	0.0338983
NODE_1365_length_1974_cov_8.058133	617	697	2	48	80	0.6000000
NODE_1365_length_1974_cov_8.058133	617	697	6	32	80	0.4000000
NODE_1365_length_1974_cov_8.058133	670	750	4	26	80	0.3250000
NODE_1365_length_1974_cov_8.058133	670	750	6	54	80	0.6750000
NODE_1366_length_1973_cov_14.885272	640	726	5	10	86	0.1162791
NODE_1366_length_1973_cov_14.885272	640	726	6	48	86	0.5581396
NODE_1366_length_1973_cov_14.885272	640	726	7	11	86	0.1279070
NODE_1366_length_1973_cov_14.885272	640	726	8	17	86	0.1976744
NODE_1366_length_1973_cov_14.885272	699	779	3	15	80	0.1875000
NODE_1366_length_1973_cov_14.885272	699	779	4	36	80	0.4500000
NODE_1366_length_1973_cov_14.885272	699	779	5	6	80	0.0750000
NODE_1366_length_1973_cov_14.885272	699	779	7	8	80	0.1000000
NODE_1366_length_1973_cov_14.885272	699	779	8	15	80	0.1875000
NODE_1366_length_1973_cov_14.885272	1389	1469	2	22	80	0.2750000
NODE_1366_length_1973_cov_14.885272	1389	1469	3	1	80	0.0125000
NODE_1366_length_1973_cov_14.885272	1389	1469	4	33	80	0.4125000
NODE_1366_length_1973_cov_14.885272	1389	1469	5	24	80	0.3000000
NODE_1366_length_1973_cov_14.885272	1442	1522	4	27	80	0.3375000
NODE_1366_length_1973_cov_14.885272	1442	1522	5	49	80	0.6125000
NODE_1366_length_1973_cov_14.885272	1442	1522	6	4	80	0.0500000
NODE_1372_length_1971_cov_3.126068	1662	1742	3	27	80	0.3375000
NODE_1372_length_1971_cov_3.126068	1662	1742	4	33	80	0.4125000
NODE_1372_length_1971_cov_3.126068	1662	1742	5	16	80	0.2000000
NODE_1372_length_1971_cov_3.126068	1662	1742	6	4	80	0.0500000
NODE_1372_length_1971_cov_3.126068	1715	1799	4	7	84	0.0833333
NODE_1372_length_1971_cov_3.126068	1715	1799	5	16	84	0.1904762
NODE_1372_length_1971_cov_3.126068	1715	1799	6	9	84	0.1071429
NODE_1372_length_1971_cov_3.126068	1715	1799	7	27	84	0.3214286
NODE_1372_length_1971_cov_3.126068	1715	1799	8	3	84	0.0357143
NODE_1372_length_1971_cov_3.126068	1715	1799	9	22	84	0.2619048
NODE_1386_length_1962_cov_23.774557	281	311	3	10	30	0.3333333
NODE_1386_length_1962_cov_23.774557	281	311	4	20	30	0.6666667
NODE_1386_length_1962_cov_23.774557	329	355	7	26	26	1.0000000
NODE_1386_length_1962_cov_23.774557	408	487	4	13	79	0.1645570
NODE_1386_length_1962_cov_23.774557	408	487	5	32	79	0.4050633
NODE_1386_length_1962_cov_23.774557	408	487	7	18	79	0.2278481
NODE_1386_length_1962_cov_23.774557	408	487	8	1	79	0.0126582
NODE_1386_length_1962_cov_23.774557	408	487	9	15	79	0.1898734
NODE_1386_length_1962_cov_23.774557	460	540	4	15	80	0.1875000
NODE_1386_length_1962_cov_23.774557	460	540	5	17	80	0.2125000
NODE_1386_length_1962_cov_23.774557	460	540	6	48	80	0.6000000
NODE_1386_length_1962_cov_23.774557	1417	1497	2	33	80	0.4125000
NODE_1386_length_1962_cov_23.774557	1417	1497	3	47	80	0.5875000
NODE_1386_length_1962_cov_23.774557	1470	1550	1	5	80	0.0625000
NODE_1386_length_1962_cov_23.774557	1470	1550	2	75	80	0.9375000
NODE_1386_length_1962_cov_23.774557	1607	1640	1	33	33	1.0000000
NODE_1395_length_1953_cov_26.183927	1	81	0	80	80	1.0000000
NODE_1395_length_1953_cov_26.183927	6	28	0	22	22	1.0000000
NODE_1395_length_1953_cov_26.183927	152	232	0	80	80	1.0000000
NODE_1395_length_1953_cov_26.183927	205	257	0	50	52	0.9615384
NODE_1395_length_1953_cov_26.183927	205	257	3	1	52	0.0192308
NODE_1395_length_1953_cov_26.183927	205	257	10	1	52	0.0192308
NODE_1405_length_1943_cov_11.218547	516	596	2	50	80	0.6250000
NODE_1405_length_1943_cov_11.218547	516	596	3	30	80	0.3750000
NODE_1405_length_1943_cov_11.218547	569	649	0	42	80	0.5250000
NODE_1405_length_1943_cov_11.218547	569	649	1	8	80	0.1000000
NODE_1405_length_1943_cov_11.218547	569	649	2	30	80	0.3750000
NODE_1408_length_1941_cov_14.407709	891	921	0	30	30	1.0000000
NODE_1408_length_1941_cov_14.407709	894	964	0	70	70	1.0000000
NODE_1408_length_1941_cov_14.407709	1878	1941	0	63	63	1.0000000
NODE_1409_length_1941_cov_9.632465	139	213	1	16	74	0.2162162
NODE_1409_length_1941_cov_9.632465	139	213	2	45	74	0.6081081
NODE_1409_length_1941_cov_9.632465	139	213	3	11	74	0.1486486
NODE_1409_length_1941_cov_9.632465	139	213	4	2	74	0.0270270
NODE_1409_length_1941_cov_9.632465	139	219	1	16	80	0.2000000
NODE_1409_length_1941_cov_9.632465	139	219	2	45	80	0.5625000
NODE_1409_length_1941_cov_9.632465	139	219	3	17	80	0.2125000
NODE_1409_length_1941_cov_9.632465	139	219	4	2	80	0.0250000
NODE_1409_length_1941_cov_9.632465	139	194	1	16	55	0.2909091
NODE_1409_length_1941_cov_9.632465	139	194	2	39	55	0.7090909
NODE_1409_length_1941_cov_9.632465	192	272	2	8	80	0.1000000
NODE_1409_length_1941_cov_9.632465	192	272	3	23	80	0.2875000
NODE_1409_length_1941_cov_9.632465	192	272	4	49	80	0.6125000
NODE_1414_length_1936_cov_13.338596	679	759	7	8	80	0.1000000
NODE_1414_length_1936_cov_13.338596	679	759	8	1	80	0.0125000
NODE_1414_length_1936_cov_13.338596	679	759	9	9	80	0.1125000
NODE_1414_length_1936_cov_13.338596	679	759	10	5	80	0.0625000
NODE_1414_length_1936_cov_13.338596	679	759	11	8	80	0.1000000
NODE_1414_length_1936_cov_13.338596	679	759	13	49	80	0.6125000
NODE_1414_length_1936_cov_13.338596	732	812	2	9	80	0.1125000
NODE_1414_length_1936_cov_13.338596	732	812	3	11	80	0.1375000
NODE_1414_length_1936_cov_13.338596	732	812	5	14	80	0.1750000
NODE_1414_length_1936_cov_13.338596	732	812	6	1	80	0.0125000
NODE_1414_length_1936_cov_13.338596	732	812	7	26	80	0.3250000
NODE_1414_length_1936_cov_13.338596	732	812	8	1	80	0.0125000
NODE_1414_length_1936_cov_13.338596	732	812	9	4	80	0.0500000
NODE_1414_length_1936_cov_13.338596	732	812	10	5	80	0.0625000
NODE_1414_length_1936_cov_13.338596	732	812	13	9	80	0.1125000
NODE_1414_length_1936_cov_13.338596	738	812	2	9	74	0.1216216
NODE_1414_length_1936_cov_13.338596	738	812	3	11	74	0.1486486
NODE_1414_length_1936_cov_13.338596	738	812	5	14	74	0.1891892
NODE_1414_length_1936_cov_13.338596	738	812	6	1	74	0.0135135
NODE_1414_length_1936_cov_13.338596	738	812	7	26	74	0.3513514
NODE_1414_length_1936_cov_13.338596	738	812	8	1	74	0.0135135
NODE_1414_length_1936_cov_13.338596	738	812	9	4	74	0.0540541
NODE_1414_length_1936_cov_13.338596	738	812	10	5	74	0.0675676
NODE_1414_length_1936_cov_13.338596	738	812	13	3	74	0.0405405
NODE_1414_length_1936_cov_13.338596	738	759	7	8	21	0.3809524
NODE_1414_length_1936_cov_13.338596	738	759	8	1	21	0.0476190
NODE_1414_length_1936_cov_13.338596	738	759	9	4	21	0.1904762
NODE_1414_length_1936_cov_13.338596	738	759	10	5	21	0.2380952
NODE_1414_length_1936_cov_13.338596	738	759	13	3	21	0.1428571
NODE_1415_length_1936_cov_12.592814	102	153	0	29	51	0.5686275
NODE_1415_length_1936_cov_12.592814	102	153	2	7	51	0.1372549
NODE_1415_length_1936_cov_12.592814	102	153	4	15	51	0.2941177
NODE_1415_length_1936_cov_12.592814	154	230	2	35	76	0.4605263
NODE_1415_length_1936_cov_12.592814	154	230	3	7	76	0.0921053
NODE_1415_length_1936_cov_12.592814	154	230	4	34	76	0.4473684
NODE_1415_length_1936_cov_12.592814	211	251	4	26	40	0.6500000
NODE_1415_length_1936_cov_12.592814	211	251	5	14	40	0.3500000
NODE_1416_length_1933_cov_86.724646	1044	1124	11	5	80	0.0625000
NODE_1416_length_1933_cov_86.724646	1044	1124	12	5	80	0.0625000
NODE_1416_length_1933_cov_86.724646	1044	1124	13	11	80	0.1375000
NODE_1416_length_1933_cov_86.724646	1044	1124	14	2	80	0.0250000
NODE_1416_length_1933_cov_86.724646	1044	1124	16	6	80	0.0750000
NODE_1416_length_1933_cov_86.724646	1044	1124	18	4	80	0.0500000
NODE_1416_length_1933_cov_86.724646	1044	1124	19	5	80	0.0625000
NODE_1416_length_1933_cov_86.724646	1044	1124	20	13	80	0.1625000
NODE_1416_length_1933_cov_86.724646	1044	1124	22	2	80	0.0250000
NODE_1416_length_1933_cov_86.724646	1044	1124	24	3	80	0.0375000
NODE_1416_length_1933_cov_86.724646	1044	1124	25	1	80	0.0125000
NODE_1416_length_1933_cov_86.724646	1044	1124	26	4	80	0.0500000
NODE_1416_length_1933_cov_86.724646	1044	1124	27	19	80	0.2375000
NODE_1416_length_1933_cov_86.724646	1097	1177	17	15	80	0.1875000
NODE_1416_length_1933_cov_86.724646	1097	1177	18	1	80	0.0125000
NODE_1416_length_1933_cov_86.724646	1097	1177	19	7	80	0.0875000
NODE_1416_length_1933_cov_86.724646	1097	1177	20	1	80	0.0125000
NODE_1416_length_1933_cov_86.724646	1097	1177	24	7	80	0.0875000
NODE_1416_length_1933_cov_86.724646	1097	1177	25	14	80	0.1750000
NODE_1416_length_1933_cov_86.724646	1097	1177	26	9	80	0.1125000
NODE_1416_length_1933_cov_86.724646	1097	1177	27	26	80	0.3250000
NODE_1416_length_1933_cov_86.724646	1173	1253	7	2	80	0.0250000
NODE_1416_length_1933_cov_86.724646	1173	1253	8	1	80	0.0125000
NODE_1416_length_1933_cov_86.724646	1173	1253	9	10	80	0.1250000
NODE_1416_length_1933_cov_86.724646	1173	1253	10	10	80	0.1250000
NODE_1416_length_1933_cov_86.724646	1173	1253	11	3	80	0.0375000
NODE_1416_length_1933_cov_86.724646	1173	1253	12	12	80	0.1500000
NODE_1416_length_1933_cov_86.724646	1173	1253	13	14	80	0.1750000
NODE_1416_length_1933_cov_86.724646	1173	1253	14	8	80	0.1000000
NODE_1416_length_1933_cov_86.724646	1173	1253	16	8	80	0.1000000
NODE_1416_length_1933_cov_86.724646	1173	1253	17	12	80	0.1500000
NODE_1416_length_1933_cov_86.724646	1226	1306	4	16	80	0.2000000
NODE_1416_length_1933_cov_86.724646	1226	1306	5	27	80	0.3375000
NODE_1416_length_1933_cov_86.724646	1226	1306	6	10	80	0.1250000
NODE_1416_length_1933_cov_86.724646	1226	1306	7	2	80	0.0250000
NODE_1416_length_1933_cov_86.724646	1226	1306	8	1	80	0.0125000
NODE_1416_length_1933_cov_86.724646	1226	1306	9	10	80	0.1250000
NODE_1416_length_1933_cov_86.724646	1226	1306	10	10	80	0.1250000
NODE_1416_length_1933_cov_86.724646	1226	1306	11	3	80	0.0375000
NODE_1416_length_1933_cov_86.724646	1226	1306	12	1	80	0.0125000
NODE_1419_length_1932_cov_5.905074	1534	1614	8	7	80	0.0875000
NODE_1419_length_1932_cov_5.905074	1534	1614	9	16	80	0.2000000
NODE_1419_length_1932_cov_5.905074	1534	1614	10	2	80	0.0250000
NODE_1419_length_1932_cov_5.905074	1534	1614	12	10	80	0.1250000
NODE_1419_length_1932_cov_5.905074	1534	1614	13	22	80	0.2750000
NODE_1419_length_1932_cov_5.905074	1534	1614	14	23	80	0.2875000
NODE_1422_length_1930_cov_3.005461	1700	1780	3	7	80	0.0875000
NODE_1422_length_1930_cov_3.005461	1700	1780	4	73	80	0.9125000
NODE_1427_length_1928_cov_2.580098	74	131	8	5	57	0.0877193
NODE_1427_length_1928_cov_2.580098	74	131	12	9	57	0.1578947
NODE_1427_length_1928_cov_2.580098	74	131	13	3	57	0.0526316
NODE_1427_length_1928_cov_2.580098	74	131	14	40	57	0.7017544
NODE_1427_length_1928_cov_2.580098	127	184	6	19	57	0.3333333
NODE_1427_length_1928_cov_2.580098	127	184	8	4	57	0.0701754
NODE_1427_length_1928_cov_2.580098	127	184	9	6	57	0.1052632
NODE_1427_length_1928_cov_2.580098	127	184	10	1	57	0.0175439
NODE_1427_length_1928_cov_2.580098	127	184	12	27	57	0.4736842
NODE_1434_length_1919_cov_17.901099	454	529	2	16	75	0.2133333
NODE_1434_length_1919_cov_17.901099	454	529	3	3	75	0.0400000
NODE_1434_length_1919_cov_17.901099	454	529	4	56	75	0.7466667
NODE_1434_length_1919_cov_17.901099	507	558	0	16	51	0.3137255
NODE_1434_length_1919_cov_17.901099	507	558	2	29	51	0.5686275
NODE_1434_length_1919_cov_17.901099	507	558	3	3	51	0.0588235
NODE_1434_length_1919_cov_17.901099	507	558	4	3	51	0.0588235
NODE_1436_length_1918_cov_14.876855	314	396	2	2	82	0.0243902
NODE_1436_length_1918_cov_14.876855	314	396	6	80	82	0.9756098
NODE_1438_length_1918_cov_3.493128	9	55	0	46	46	1.0000000
NODE_1438_length_1918_cov_3.493128	1480	1561	0	81	81	1.0000000
NODE_1440_length_1916_cov_4.426527	162	192	0	30	30	1.0000000
NODE_1442_length_1915_cov_35.787996	106	186	4	17	80	0.2125000
NODE_1442_length_1915_cov_35.787996	106	186	6	2	80	0.0250000
NODE_1442_length_1915_cov_35.787996	106	186	7	33	80	0.4125000
NODE_1442_length_1915_cov_35.787996	106	186	8	28	80	0.3500000
NODE_1451_length_1905_cov_18.464563	740	820	2	43	80	0.5375000
NODE_1451_length_1905_cov_18.464563	740	820	4	37	80	0.4625000
NODE_1451_length_1905_cov_18.464563	793	873	2	60	80	0.7500000
NODE_1451_length_1905_cov_18.464563	793	873	3	3	80	0.0375000
NODE_1451_length_1905_cov_18.464563	793	873	4	17	80	0.2125000
NODE_1451_length_1905_cov_18.464563	869	949	0	18	80	0.2250000
NODE_1451_length_1905_cov_18.464563	869	949	1	8	80	0.1000000
NODE_1451_length_1905_cov_18.464563	869	949	2	1	80	0.0125000
NODE_1451_length_1905_cov_18.464563	869	949	3	53	80	0.6625000
NODE_1451_length_1905_cov_18.464563	922	1010	0	79	88	0.8977273
NODE_1451_length_1905_cov_18.464563	922	1010	1	8	88	0.0909091
NODE_1451_length_1905_cov_18.464563	922	1010	3	1	88	0.0113636
NODE_1452_length_1905_cov_7.197121	596	676	3	15	80	0.1875000
NODE_1452_length_1905_cov_7.197121	596	676	4	16	80	0.2000000
NODE_1452_length_1905_cov_7.197121	596	676	5	49	80	0.6125000
NODE_1452_length_1905_cov_7.197121	649	682	2	1	33	0.0303030
NODE_1452_length_1905_cov_7.197121	649	682	3	20	33	0.6060606
NODE_1452_length_1905_cov_7.197121	649	682	4	12	33	0.3636364
NODE_1455_length_1902_cov_1.633943	1728	1792	2	20	64	0.3125000
NODE_1455_length_1902_cov_1.633943	1728	1792	3	2	64	0.0312500
NODE_1455_length_1902_cov_1.633943	1728	1792	4	42	64	0.6562500
NODE_1458_length_1900_cov_1.081066	1805	1851	0	46	46	1.0000000
NODE_1458_length_1900_cov_1.081066	1824	1900	0	76	76	1.0000000
NODE_1461_length_1895_cov_17.940980	1070	1150	3	12	80	0.1500000
NODE_1461_length_1895_cov_17.940980	1070	1150	5	1	80	0.0125000
NODE_1461_length_1895_cov_17.940980	1070	1150	6	13	80	0.1625000
NODE_1461_length_1895_cov_17.940980	1070	1150	7	54	80	0.6750000
NODE_1461_length_1895_cov_17.940980	1123	1203	3	16	80	0.2000000
NODE_1461_length_1895_cov_17.940980	1123	1203	5	3	80	0.0375000
NODE_1461_length_1895_cov_17.940980	1123	1203	7	61	80	0.7625000
NODE_1466_length_1893_cov_3.299331	918	998	1	29	80	0.3625000
NODE_1466_length_1893_cov_3.299331	918	998	2	31	80	0.3875000
NODE_1466_length_1893_cov_3.299331	918	998	3	20	80	0.2500000
NODE_1467_length_1892_cov_5.158394	317	397	4	6	80	0.0750000
NODE_1467_length_1892_cov_5.158394	317	397	5	27	80	0.3375000
NODE_1467_length_1892_cov_5.158394	317	397	6	10	80	0.1250000
NODE_1467_length_1892_cov_5.158394	317	397	7	13	80	0.1625000
NODE_1467_length_1892_cov_5.158394	317	397	8	24	80	0.3000000
NODE_1467_length_1892_cov_5.158394	370	445	6	10	75	0.1333333
NODE_1467_length_1892_cov_5.158394	370	445	7	40	75	0.5333334
NODE_1467_length_1892_cov_5.158394	370	445	8	25	75	0.3333333
NODE_1469_length_1889_cov_4.049162	1652	1686	1	34	34	1.0000000
NODE_1470_length_1889_cov_3.888268	960	1040	0	80	80	1.0000000
NODE_1470_length_1889_cov_3.888268	1013	1093	0	80	80	1.0000000
NODE_1472_length_1888_cov_17.106764	15	96	2	11	81	0.1358025
NODE_1472_length_1888_cov_17.106764	15	96	4	70	81	0.8641976
NODE_1472_length_1888_cov_17.106764	68	143	1	4	75	0.0533333
NODE_1472_length_1888_cov_17.106764	68	143	2	1	75	0.0133333
NODE_1472_length_1888_cov_17.106764	68	143	3	14	75	0.1866667
NODE_1472_length_1888_cov_17.106764	68	143	4	56	75	0.7466667
NODE_1477_length_1885_cov_4.439530	441	521	1	3	80	0.0375000
NODE_1477_length_1885_cov_4.439530	441	521	2	38	80	0.4750000
NODE_1477_length_1885_cov_4.439530	441	521	4	23	80	0.2875000
NODE_1477_length_1885_cov_4.439530	441	521	5	16	80	0.2000000
NODE_1477_length_1885_cov_4.439530	494	574	4	39	80	0.4875000
NODE_1477_length_1885_cov_4.439530	494	574	5	41	80	0.5125000
NODE_1483_length_1882_cov_5.884464	1499	1579	1	13	80	0.1625000
NODE_1483_length_1882_cov_5.884464	1499	1579	4	14	80	0.1750000
NODE_1483_length_1882_cov_5.884464	1499	1579	5	21	80	0.2625000
NODE_1483_length_1882_cov_5.884464	1499	1579	6	32	80	0.4000000
NODE_1483_length_1882_cov_5.884464	1552	1632	4	7	80	0.0875000
NODE_1483_length_1882_cov_5.884464	1552	1632	5	22	80	0.2750000
NODE_1483_length_1882_cov_5.884464	1552	1632	6	51	80	0.6375000
NODE_1493_length_1875_cov_3.974662	1650	1730	7	43	80	0.5375000
NODE_1493_length_1875_cov_3.974662	1650	1730	8	9	80	0.1125000
NODE_1493_length_1875_cov_3.974662	1650	1730	9	17	80	0.2125000
NODE_1493_length_1875_cov_3.974662	1650	1730	10	4	80	0.0500000
NODE_1493_length_1875_cov_3.974662	1650	1730	11	7	80	0.0875000
NODE_1497_length_1872_cov_21.355330	153	201	0	48	48	1.0000000
NODE_1503_length_1868_cov_96.046919	1018	1098	33	7	80	0.0875000
NODE_1503_length_1868_cov_96.046919	1018	1098	35	1	80	0.0125000
NODE_1503_length_1868_cov_96.046919	1018	1098	36	1	80	0.0125000
NODE_1503_length_1868_cov_96.046919	1018	1098	37	5	80	0.0625000
NODE_1503_length_1868_cov_96.046919	1018	1098	38	1	80	0.0125000
NODE_1503_length_1868_cov_96.046919	1018	1098	39	3	80	0.0375000
NODE_1503_length_1868_cov_96.046919	1018	1098	40	18	80	0.2250000
NODE_1503_length_1868_cov_96.046919	1018	1098	41	9	80	0.1125000
NODE_1503_length_1868_cov_96.046919	1018	1098	42	1	80	0.0125000
NODE_1503_length_1868_cov_96.046919	1018	1098	44	3	80	0.0375000
NODE_1503_length_1868_cov_96.046919	1018	1098	45	19	80	0.2375000
NODE_1503_length_1868_cov_96.046919	1018	1098	46	10	80	0.1250000
NODE_1503_length_1868_cov_96.046919	1018	1098	47	2	80	0.0250000
NODE_1503_length_1868_cov_96.046919	1071	1151	40	2	80	0.0250000
NODE_1503_length_1868_cov_96.046919	1071	1151	42	1	80	0.0125000
NODE_1503_length_1868_cov_96.046919	1071	1151	43	3	80	0.0375000
NODE_1503_length_1868_cov_96.046919	1071	1151	45	25	80	0.3125000
NODE_1503_length_1868_cov_96.046919	1071	1151	46	9	80	0.1125000
NODE_1503_length_1868_cov_96.046919	1071	1151	47	4	80	0.0500000
NODE_1503_length_1868_cov_96.046919	1071	1151	48	4	80	0.0500000
NODE_1503_length_1868_cov_96.046919	1071	1151	49	7	80	0.0875000
NODE_1503_length_1868_cov_96.046919	1071	1151	50	6	80	0.0750000
NODE_1503_length_1868_cov_96.046919	1071	1151	51	4	80	0.0500000
NODE_1503_length_1868_cov_96.046919	1071	1151	52	6	80	0.0750000
NODE_1503_length_1868_cov_96.046919	1071	1151	53	5	80	0.0625000
NODE_1503_length_1868_cov_96.046919	1071	1151	54	4	80	0.0500000
NODE_1508_length_1866_cov_53.869270	1149	1229	7	9	80	0.1125000
NODE_1508_length_1866_cov_53.869270	1149	1229	8	22	80	0.2750000
NODE_1508_length_1866_cov_53.869270	1149	1229	9	6	80	0.0750000
NODE_1508_length_1866_cov_53.869270	1149	1229	10	6	80	0.0750000
NODE_1508_length_1866_cov_53.869270	1149	1229	11	37	80	0.4625000
NODE_1508_length_1866_cov_53.869270	1202	1282	4	8	80	0.1000000
NODE_1508_length_1866_cov_53.869270	1202	1282	5	34	80	0.4250000
NODE_1508_length_1866_cov_53.869270	1202	1282	6	6	80	0.0750000
NODE_1508_length_1866_cov_53.869270	1202	1282	7	7	80	0.0875000
NODE_1508_length_1866_cov_53.869270	1202	1282	8	5	80	0.0625000
NODE_1508_length_1866_cov_53.869270	1202	1282	9	6	80	0.0750000
NODE_1508_length_1866_cov_53.869270	1202	1282	11	14	80	0.1750000
NODE_1508_length_1866_cov_53.869270	1278	1358	4	12	80	0.1500000
NODE_1508_length_1866_cov_53.869270	1278	1358	5	52	80	0.6500000
NODE_1508_length_1866_cov_53.869270	1278	1358	6	16	80	0.2000000
NODE_1508_length_1866_cov_53.869270	1331	1411	3	12	80	0.1500000
NODE_1508_length_1866_cov_53.869270	1331	1411	4	22	80	0.2750000
NODE_1508_length_1866_cov_53.869270	1331	1411	5	46	80	0.5750000
NODE_1510_length_1866_cov_3.347482	888	966	0	78	78	1.0000000
NODE_1510_length_1866_cov_3.347482	939	1019	0	80	80	1.0000000
NODE_1513_length_1863_cov_11.265306	698	778	0	26	80	0.3250000
NODE_1513_length_1863_cov_11.265306	698	778	1	34	80	0.4250000
NODE_1513_length_1863_cov_11.265306	698	778	3	20	80	0.2500000
NODE_1513_length_1863_cov_11.265306	751	831	1	7	80	0.0875000
NODE_1513_length_1863_cov_11.265306	751	831	3	73	80	0.9125000
NODE_1518_length_1858_cov_19.019329	23	85	0	62	62	1.0000000
NODE_1518_length_1858_cov_19.019329	1125	1205	0	7	80	0.0875000
NODE_1518_length_1858_cov_19.019329	1125	1205	1	71	80	0.8875000
NODE_1518_length_1858_cov_19.019329	1125	1205	2	2	80	0.0250000
NODE_1518_length_1858_cov_19.019329	1178	1256	0	37	78	0.4743590
NODE_1518_length_1858_cov_19.019329	1178	1256	1	41	78	0.5256410
NODE_1518_length_1858_cov_19.019329	1387	1464	6	8	77	0.1038961
NODE_1518_length_1858_cov_19.019329	1387	1464	7	6	77	0.0779221
NODE_1518_length_1858_cov_19.019329	1387	1464	8	4	77	0.0519481
NODE_1518_length_1858_cov_19.019329	1387	1464	10	19	77	0.2467532
NODE_1518_length_1858_cov_19.019329	1387	1464	11	7	77	0.0909091
NODE_1518_length_1858_cov_19.019329	1387	1464	13	23	77	0.2987013
NODE_1518_length_1858_cov_19.019329	1387	1464	14	10	77	0.1298701
NODE_1518_length_1858_cov_19.019329	1440	1503	12	21	63	0.3333333
NODE_1518_length_1858_cov_19.019329	1440	1503	13	18	63	0.2857143
NODE_1518_length_1858_cov_19.019329	1440	1503	14	20	63	0.3174603
NODE_1518_length_1858_cov_19.019329	1440	1503	15	4	63	0.0634921
NODE_1519_length_1857_cov_18.402730	1282	1348	5	22	66	0.3333333
NODE_1519_length_1857_cov_18.402730	1282	1348	6	44	66	0.6666667
NODE_1519_length_1857_cov_18.402730	1321	1401	2	4	80	0.0500000
NODE_1519_length_1857_cov_18.402730	1321	1401	3	4	80	0.0500000
NODE_1519_length_1857_cov_18.402730	1321	1401	4	9	80	0.1125000
NODE_1519_length_1857_cov_18.402730	1321	1401	5	25	80	0.3125000
NODE_1519_length_1857_cov_18.402730	1321	1401	6	38	80	0.4750000
NODE_1519_length_1857_cov_18.402730	1397	1477	5	69	80	0.8625000
NODE_1519_length_1857_cov_18.402730	1397	1477	6	11	80	0.1375000
NODE_1519_length_1857_cov_18.402730	1450	1530	2	4	80	0.0500000
NODE_1519_length_1857_cov_18.402730	1450	1530	3	3	80	0.0375000
NODE_1519_length_1857_cov_18.402730	1450	1530	5	69	80	0.8625000
NODE_1519_length_1857_cov_18.402730	1450	1530	6	4	80	0.0500000
NODE_1531_length_1845_cov_12.653494	473	553	4	9	80	0.1125000
NODE_1531_length_1845_cov_12.653494	473	553	6	23	80	0.2875000
NODE_1531_length_1845_cov_12.653494	473	553	7	6	80	0.0750000
NODE_1531_length_1845_cov_12.653494	473	553	8	1	80	0.0125000
NODE_1531_length_1845_cov_12.653494	473	553	9	41	80	0.5125000
NODE_1531_length_1845_cov_12.653494	526	606	7	45	80	0.5625000
NODE_1531_length_1845_cov_12.653494	526	606	8	14	80	0.1750000
NODE_1531_length_1845_cov_12.653494	526	606	9	21	80	0.2625000
NODE_1546_length_1833_cov_31.337947	810	888	4	27	78	0.3461539
NODE_1546_length_1833_cov_31.337947	810	888	6	7	78	0.0897436
NODE_1546_length_1833_cov_31.337947	810	888	8	6	78	0.0769231
NODE_1546_length_1833_cov_31.337947	810	888	9	10	78	0.1282051
NODE_1546_length_1833_cov_31.337947	810	888	11	4	78	0.0512821
NODE_1546_length_1833_cov_31.337947	810	888	12	9	78	0.1153846
NODE_1546_length_1833_cov_31.337947	810	888	14	6	78	0.0769231
NODE_1546_length_1833_cov_31.337947	810	888	16	9	78	0.1153846
NODE_1546_length_1833_cov_31.337947	861	941	11	3	80	0.0375000
NODE_1546_length_1833_cov_31.337947	861	941	12	9	80	0.1125000
NODE_1546_length_1833_cov_31.337947	861	941	13	23	80	0.2875000
NODE_1546_length_1833_cov_31.337947	861	941	14	6	80	0.0750000
NODE_1546_length_1833_cov_31.337947	861	941	15	12	80	0.1500000
NODE_1546_length_1833_cov_31.337947	861	941	16	26	80	0.3250000
NODE_1546_length_1833_cov_31.337947	861	941	17	1	80	0.0125000
NODE_1546_length_1833_cov_31.337947	937	1017	8	3	80	0.0375000
NODE_1546_length_1833_cov_31.337947	937	1017	9	3	80	0.0375000
NODE_1546_length_1833_cov_31.337947	937	1017	11	12	80	0.1500000
NODE_1546_length_1833_cov_31.337947	937	1017	13	25	80	0.3125000
NODE_1546_length_1833_cov_31.337947	937	1017	14	6	80	0.0750000
NODE_1546_length_1833_cov_31.337947	937	1017	15	31	80	0.3875000
NODE_1546_length_1833_cov_31.337947	990	1070	7	2	80	0.0250000
NODE_1546_length_1833_cov_31.337947	990	1070	8	35	80	0.4375000
NODE_1546_length_1833_cov_31.337947	990	1070	9	22	80	0.2750000
NODE_1546_length_1833_cov_31.337947	990	1070	11	12	80	0.1500000
NODE_1546_length_1833_cov_31.337947	990	1070	13	5	80	0.0625000
NODE_1546_length_1833_cov_31.337947	990	1070	15	4	80	0.0500000
NODE_1550_length_1831_cov_3.065820	112	154	0	2	42	0.0476190
NODE_1550_length_1831_cov_3.065820	112	154	1	5	42	0.1190476
NODE_1550_length_1831_cov_3.065820	112	154	2	10	42	0.2380952
NODE_1550_length_1831_cov_3.065820	112	154	4	5	42	0.1190476
NODE_1550_length_1831_cov_3.065820	112	154	6	7	42	0.1666667
NODE_1550_length_1831_cov_3.065820	112	154	8	13	42	0.3095238
NODE_1553_length_1830_cov_2.512998	123	203	0	1	80	0.0125000
NODE_1553_length_1830_cov_2.512998	123	203	2	25	80	0.3125000
NODE_1553_length_1830_cov_2.512998	123	203	3	9	80	0.1125000
NODE_1553_length_1830_cov_2.512998	123	203	4	45	80	0.5625000
NODE_1553_length_1830_cov_2.512998	176	256	0	18	80	0.2250000
NODE_1553_length_1830_cov_2.512998	176	256	2	4	80	0.0500000
NODE_1553_length_1830_cov_2.512998	176	256	4	58	80	0.7250000
NODE_1553_length_1830_cov_2.512998	308	357	0	49	49	1.0000000
NODE_1554_length_1828_cov_40.437825	789	869	6	13	80	0.1625000
NODE_1554_length_1828_cov_40.437825	789	869	8	8	80	0.1000000
NODE_1554_length_1828_cov_40.437825	789	869	12	35	80	0.4375000
NODE_1554_length_1828_cov_40.437825	789	869	13	4	80	0.0500000
NODE_1554_length_1828_cov_40.437825	789	869	14	3	80	0.0375000
NODE_1554_length_1828_cov_40.437825	789	869	15	17	80	0.2125000
NODE_1554_length_1828_cov_40.437825	842	922	11	3	80	0.0375000
NODE_1554_length_1828_cov_40.437825	842	922	12	19	80	0.2375000
NODE_1554_length_1828_cov_40.437825	842	922	13	21	80	0.2625000
NODE_1554_length_1828_cov_40.437825	842	922	14	17	80	0.2125000
NODE_1554_length_1828_cov_40.437825	842	922	15	20	80	0.2500000
NODE_1554_length_1828_cov_40.437825	918	998	14	4	80	0.0500000
NODE_1554_length_1828_cov_40.437825	918	998	15	3	80	0.0375000
NODE_1554_length_1828_cov_40.437825	918	998	16	2	80	0.0250000
NODE_1554_length_1828_cov_40.437825	918	998	17	33	80	0.4125000
NODE_1554_length_1828_cov_40.437825	918	998	18	13	80	0.1625000
NODE_1554_length_1828_cov_40.437825	918	998	19	25	80	0.3125000
NODE_1554_length_1828_cov_40.437825	971	1051	8	4	80	0.0500000
NODE_1554_length_1828_cov_40.437825	971	1051	9	5	80	0.0625000
NODE_1554_length_1828_cov_40.437825	971	1051	10	1	80	0.0125000
NODE_1554_length_1828_cov_40.437825	971	1051	12	10	80	0.1250000
NODE_1554_length_1828_cov_40.437825	971	1051	13	12	80	0.1500000
NODE_1554_length_1828_cov_40.437825	971	1051	15	12	80	0.1500000
NODE_1554_length_1828_cov_40.437825	971	1051	16	7	80	0.0875000
NODE_1554_length_1828_cov_40.437825	971	1051	17	1	80	0.0125000
NODE_1554_length_1828_cov_40.437825	971	1051	18	4	80	0.0500000
NODE_1554_length_1828_cov_40.437825	971	1051	19	24	80	0.3000000
NODE_1559_length_1825_cov_6.652955	641	689	1	48	48	1.0000000
NODE_1559_length_1825_cov_6.652955	694	744	1	50	50	1.0000000
NODE_1562_length_1824_cov_10.152464	685	765	16	5	80	0.0625000
NODE_1562_length_1824_cov_10.152464	685	765	17	6	80	0.0750000
NODE_1562_length_1824_cov_10.152464	685	765	18	3	80	0.0375000
NODE_1562_length_1824_cov_10.152464	685	765	19	4	80	0.0500000
NODE_1562_length_1824_cov_10.152464	685	765	20	13	80	0.1625000
NODE_1562_length_1824_cov_10.152464	685	765	21	4	80	0.0500000
NODE_1562_length_1824_cov_10.152464	685	765	22	24	80	0.3000000
NODE_1562_length_1824_cov_10.152464	685	765	23	21	80	0.2625000
NODE_1562_length_1824_cov_10.152464	738	818	10	12	80	0.1500000
NODE_1562_length_1824_cov_10.152464	738	818	11	2	80	0.0250000
NODE_1562_length_1824_cov_10.152464	738	818	12	4	80	0.0500000
NODE_1562_length_1824_cov_10.152464	738	818	15	14	80	0.1750000
NODE_1562_length_1824_cov_10.152464	738	818	16	2	80	0.0250000
NODE_1562_length_1824_cov_10.152464	738	818	17	1	80	0.0125000
NODE_1562_length_1824_cov_10.152464	738	818	19	8	80	0.1000000
NODE_1562_length_1824_cov_10.152464	738	818	20	2	80	0.0250000
NODE_1562_length_1824_cov_10.152464	738	818	21	12	80	0.1500000
NODE_1562_length_1824_cov_10.152464	738	818	22	17	80	0.2125000
NODE_1562_length_1824_cov_10.152464	738	818	23	6	80	0.0750000
NODE_1562_length_1824_cov_10.152464	1412	1433	0	21	21	1.0000000
NODE_1564_length_1821_cov_7.682346	953	1033	2	25	80	0.3125000
NODE_1564_length_1821_cov_7.682346	953	1033	4	55	80	0.6875000
NODE_1564_length_1821_cov_7.682346	1006	1086	4	80	80	1.0000000
NODE_1566_length_1820_cov_12.061592	477	557	2	33	80	0.4125000
NODE_1566_length_1820_cov_12.061592	477	557	3	17	80	0.2125000
NODE_1566_length_1820_cov_12.061592	477	557	4	26	80	0.3250000
NODE_1566_length_1820_cov_12.061592	477	557	5	4	80	0.0500000
NODE_1566_length_1820_cov_12.061592	530	610	3	8	80	0.1000000
NODE_1566_length_1820_cov_12.061592	530	610	4	64	80	0.8000000
NODE_1566_length_1820_cov_12.061592	530	610	5	8	80	0.1000000
NODE_1566_length_1820_cov_12.061592	1232	1312	2	80	80	1.0000000
NODE_1566_length_1820_cov_12.061592	1285	1365	2	80	80	1.0000000
NODE_1572_length_1817_cov_8.302095	63	122	0	59	59	1.0000000
NODE_1572_length_1817_cov_8.302095	1195	1275	0	57	80	0.7125000
NODE_1572_length_1817_cov_8.302095	1195	1275	2	23	80	0.2875000
NODE_1572_length_1817_cov_8.302095	1248	1328	0	4	80	0.0500000
NODE_1572_length_1817_cov_8.302095	1248	1328	2	72	80	0.9000000
NODE_1572_length_1817_cov_8.302095	1248	1328	4	4	80	0.0500000
NODE_1573_length_1816_cov_25.489225	1059	1139	8	14	80	0.1750000
NODE_1573_length_1816_cov_25.489225	1059	1139	9	6	80	0.0750000
NODE_1573_length_1816_cov_25.489225	1059	1139	10	16	80	0.2000000
NODE_1573_length_1816_cov_25.489225	1059	1139	12	17	80	0.2125000
NODE_1573_length_1816_cov_25.489225	1059	1139	13	27	80	0.3375000
NODE_1573_length_1816_cov_25.489225	1112	1192	4	5	80	0.0625000
NODE_1573_length_1816_cov_25.489225	1112	1192	5	2	80	0.0250000
NODE_1573_length_1816_cov_25.489225	1112	1192	6	5	80	0.0625000
NODE_1573_length_1816_cov_25.489225	1112	1192	7	3	80	0.0375000
NODE_1573_length_1816_cov_25.489225	1112	1192	9	12	80	0.1500000
NODE_1573_length_1816_cov_25.489225	1112	1192	10	4	80	0.0500000
NODE_1573_length_1816_cov_25.489225	1112	1192	12	33	80	0.4125000
NODE_1573_length_1816_cov_25.489225	1112	1192	13	16	80	0.2000000
NODE_1578_length_1812_cov_11.453006	398	427	5	3	29	0.1034483
NODE_1578_length_1812_cov_11.453006	398	427	8	21	29	0.7241379
NODE_1578_length_1812_cov_11.453006	398	427	9	5	29	0.1724138
NODE_1578_length_1812_cov_11.453006	400	480	5	1	80	0.0125000
NODE_1578_length_1812_cov_11.453006	400	480	8	21	80	0.2625000
NODE_1578_length_1812_cov_11.453006	400	480	9	45	80	0.5625000
NODE_1578_length_1812_cov_11.453006	400	480	10	13	80	0.1625000
NODE_1586_length_1807_cov_3.977752	1743	1807	0	64	64	1.0000000
NODE_1590_length_1806_cov_2.681312	1461	1541	0	5	80	0.0625000
NODE_1590_length_1806_cov_2.681312	1461	1541	1	1	80	0.0125000
NODE_1590_length_1806_cov_2.681312	1461	1541	2	5	80	0.0625000
NODE_1590_length_1806_cov_2.681312	1461	1541	3	1	80	0.0125000
NODE_1590_length_1806_cov_2.681312	1461	1541	4	1	80	0.0125000
NODE_1590_length_1806_cov_2.681312	1461	1541	5	10	80	0.1250000
NODE_1590_length_1806_cov_2.681312	1461	1541	6	13	80	0.1625000
NODE_1590_length_1806_cov_2.681312	1461	1541	8	12	80	0.1500000
NODE_1590_length_1806_cov_2.681312	1461	1541	9	8	80	0.1000000
NODE_1590_length_1806_cov_2.681312	1461	1541	11	9	80	0.1125000
NODE_1590_length_1806_cov_2.681312	1461	1541	12	9	80	0.1125000
NODE_1590_length_1806_cov_2.681312	1461	1541	14	4	80	0.0500000
NODE_1590_length_1806_cov_2.681312	1461	1541	15	2	80	0.0250000
NODE_1590_length_1806_cov_2.681312	1517	1594	0	58	77	0.7532467
NODE_1590_length_1806_cov_2.681312	1517	1594	1	1	77	0.0129870
NODE_1590_length_1806_cov_2.681312	1517	1594	2	5	77	0.0649351
NODE_1590_length_1806_cov_2.681312	1517	1594	3	1	77	0.0129870
NODE_1590_length_1806_cov_2.681312	1517	1594	4	1	77	0.0129870
NODE_1590_length_1806_cov_2.681312	1517	1594	5	10	77	0.1298701
NODE_1590_length_1806_cov_2.681312	1517	1594	6	1	77	0.0129870
NODE_1593_length_1805_cov_10.271395	258	329	3	2	71	0.0281690
NODE_1593_length_1805_cov_10.271395	258	329	4	10	71	0.1408451
NODE_1593_length_1805_cov_10.271395	258	329	6	59	71	0.8309859
NODE_1593_length_1805_cov_10.271395	311	391	2	18	80	0.2250000
NODE_1593_length_1805_cov_10.271395	311	391	4	28	80	0.3500000
NODE_1593_length_1805_cov_10.271395	311	391	5	11	80	0.1375000
NODE_1593_length_1805_cov_10.271395	311	391	6	20	80	0.2500000
NODE_1593_length_1805_cov_10.271395	311	391	7	3	80	0.0375000
NODE_1598_length_1802_cov_11.546682	1284	1364	0	80	80	1.0000000
NODE_1598_length_1802_cov_11.546682	1337	1417	0	80	80	1.0000000
NODE_1600_length_1801_cov_12.145711	85	165	5	3	80	0.0375000
NODE_1600_length_1801_cov_12.145711	85	165	6	9	80	0.1125000
NODE_1600_length_1801_cov_12.145711	85	165	7	17	80	0.2125000
NODE_1600_length_1801_cov_12.145711	85	165	8	1	80	0.0125000
NODE_1600_length_1801_cov_12.145711	85	165	9	1	80	0.0125000
NODE_1600_length_1801_cov_12.145711	85	165	10	49	80	0.6125000
NODE_1600_length_1801_cov_12.145711	138	218	6	4	80	0.0500000
NODE_1600_length_1801_cov_12.145711	138	218	7	6	80	0.0750000
NODE_1600_length_1801_cov_12.145711	138	218	8	36	80	0.4500000
NODE_1600_length_1801_cov_12.145711	138	218	10	34	80	0.4250000
NODE_1601_length_1801_cov_9.793184	1010	1090	1	50	80	0.6250000
NODE_1601_length_1801_cov_9.793184	1010	1090	3	30	80	0.3750000
NODE_1601_length_1801_cov_9.793184	1063	1143	0	30	80	0.3750000
NODE_1601_length_1801_cov_9.793184	1063	1143	1	35	80	0.4375000
NODE_1601_length_1801_cov_9.793184	1063	1143	3	9	80	0.1125000
NODE_1601_length_1801_cov_9.793184	1063	1143	4	2	80	0.0250000
NODE_1601_length_1801_cov_9.793184	1063	1143	5	4	80	0.0500000
NODE_1604_length_1800_cov_15.074662	695	775	0	29	80	0.3625000
NODE_1604_length_1800_cov_15.074662	695	775	2	51	80	0.6375000
NODE_1604_length_1800_cov_15.074662	755	826	2	71	71	1.0000000
NODE_1605_length_1800_cov_7.281599	10	74	5	1	64	0.0156250
NODE_1605_length_1800_cov_7.281599	10	74	8	1	64	0.0156250
NODE_1605_length_1800_cov_7.281599	10	74	9	52	64	0.8125000
NODE_1605_length_1800_cov_7.281599	10	74	10	10	64	0.1562500
NODE_1605_length_1800_cov_7.281599	10	74	5	1	64	0.0156250
NODE_1605_length_1800_cov_7.281599	10	74	8	1	64	0.0156250
NODE_1605_length_1800_cov_7.281599	10	74	9	52	64	0.8125000
NODE_1605_length_1800_cov_7.281599	10	74	10	10	64	0.1562500
NODE_1605_length_1800_cov_7.281599	10	74	5	1	64	0.0156250
NODE_1605_length_1800_cov_7.281599	10	74	8	1	64	0.0156250
NODE_1605_length_1800_cov_7.281599	10	74	9	52	64	0.8125000
NODE_1605_length_1800_cov_7.281599	10	74	10	10	64	0.1562500
NODE_1605_length_1800_cov_7.281599	47	127	6	3	80	0.0375000
NODE_1605_length_1800_cov_7.281599	47	127	9	17	80	0.2125000
NODE_1605_length_1800_cov_7.281599	47	127	10	23	80	0.2875000
NODE_1605_length_1800_cov_7.281599	47	127	12	37	80	0.4625000
NODE_1605_length_1800_cov_7.281599	63	126	6	2	63	0.0317460
NODE_1605_length_1800_cov_7.281599	63	126	9	1	63	0.0158730
NODE_1605_length_1800_cov_7.281599	63	126	10	23	63	0.3650794
NODE_1605_length_1800_cov_7.281599	63	126	12	37	63	0.5873016
NODE_1616_length_1793_cov_16.161157	539	619	3	64	80	0.8000000
NODE_1616_length_1793_cov_16.161157	539	619	4	16	80	0.2000000
NODE_1616_length_1793_cov_16.161157	592	672	2	26	80	0.3250000
NODE_1616_length_1793_cov_16.161157	592	672	3	38	80	0.4750000
NODE_1616_length_1793_cov_16.161157	592	672	4	16	80	0.2000000
NODE_1616_length_1793_cov_16.161157	1202	1281	0	78	79	0.9873418
NODE_1616_length_1793_cov_16.161157	1202	1281	1	1	79	0.0126582
NODE_1616_length_1793_cov_16.161157	1254	1335	0	81	81	1.0000000
NODE_1617_length_1793_cov_14.322904	521	601	1	4	80	0.0500000
NODE_1617_length_1793_cov_14.322904	521	601	2	4	80	0.0500000
NODE_1617_length_1793_cov_14.322904	521	601	3	41	80	0.5125000
NODE_1617_length_1793_cov_14.322904	521	601	4	12	80	0.1500000
NODE_1617_length_1793_cov_14.322904	521	601	5	19	80	0.2375000
NODE_1617_length_1793_cov_14.322904	574	654	3	11	80	0.1375000
NODE_1617_length_1793_cov_14.322904	574	654	4	26	80	0.3250000
NODE_1617_length_1793_cov_14.322904	574	654	5	43	80	0.5375000
NODE_1617_length_1793_cov_14.322904	1230	1310	4	4	80	0.0500000
NODE_1617_length_1793_cov_14.322904	1230	1310	5	27	80	0.3375000
NODE_1617_length_1793_cov_14.322904	1230	1310	6	12	80	0.1500000
NODE_1617_length_1793_cov_14.322904	1230	1310	7	37	80	0.4625000
NODE_1618_length_1791_cov_5.516548	1190	1261	0	71	71	1.0000000
NODE_1621_length_1790_cov_4.282082	684	764	1	1	80	0.0125000
NODE_1621_length_1790_cov_4.282082	684	764	2	56	80	0.7000000
NODE_1621_length_1790_cov_4.282082	684	764	3	23	80	0.2875000
NODE_1621_length_1790_cov_4.282082	737	817	2	54	80	0.6750000
NODE_1621_length_1790_cov_4.282082	737	817	3	26	80	0.3250000
NODE_1623_length_1788_cov_39.558911	385	465	0	80	80	1.0000000
NODE_1623_length_1788_cov_39.558911	438	518	0	80	80	1.0000000
NODE_1623_length_1788_cov_39.558911	514	594	0	30	80	0.3750000
NODE_1623_length_1788_cov_39.558911	514	594	1	50	80	0.6250000
NODE_1623_length_1788_cov_39.558911	567	647	1	80	80	1.0000000
NODE_1624_length_1787_cov_44.927133	530	610	10	1	80	0.0125000
NODE_1624_length_1787_cov_44.927133	530	610	11	11	80	0.1375000
NODE_1624_length_1787_cov_44.927133	530	610	12	5	80	0.0625000
NODE_1624_length_1787_cov_44.927133	530	610	13	8	80	0.1000000
NODE_1624_length_1787_cov_44.927133	530	610	14	25	80	0.3125000
NODE_1624_length_1787_cov_44.927133	530	610	15	16	80	0.2000000
NODE_1624_length_1787_cov_44.927133	530	610	16	7	80	0.0875000
NODE_1624_length_1787_cov_44.927133	530	610	17	7	80	0.0875000
NODE_1625_length_1787_cov_2.752370	675	755	0	80	80	1.0000000
NODE_1625_length_1787_cov_2.752370	728	806	0	78	78	1.0000000
NODE_1626_length_1786_cov_13.459395	523	603	2	25	80	0.3125000
NODE_1626_length_1786_cov_13.459395	523	603	3	34	80	0.4250000
NODE_1626_length_1786_cov_13.459395	523	603	5	14	80	0.1750000
NODE_1626_length_1786_cov_13.459395	523	603	6	7	80	0.0875000
NODE_1626_length_1786_cov_13.459395	576	656	3	6	80	0.0750000
NODE_1626_length_1786_cov_13.459395	576	656	4	43	80	0.5375000
NODE_1626_length_1786_cov_13.459395	576	656	5	15	80	0.1875000
NODE_1626_length_1786_cov_13.459395	576	656	6	16	80	0.2000000
NODE_1633_length_1784_cov_40.769733	358	438	2	25	80	0.3125000
NODE_1633_length_1784_cov_40.769733	358	438	3	4	80	0.0500000
NODE_1633_length_1784_cov_40.769733	358	438	4	3	80	0.0375000
NODE_1633_length_1784_cov_40.769733	358	438	5	41	80	0.5125000
NODE_1633_length_1784_cov_40.769733	358	438	6	7	80	0.0875000
NODE_1633_length_1784_cov_40.769733	411	491	3	5	80	0.0625000
NODE_1633_length_1784_cov_40.769733	411	491	4	16	80	0.2000000
NODE_1633_length_1784_cov_40.769733	411	491	5	52	80	0.6500000
NODE_1633_length_1784_cov_40.769733	411	491	6	7	80	0.0875000
NODE_1633_length_1784_cov_40.769733	1057	1137	0	3	80	0.0375000
NODE_1633_length_1784_cov_40.769733	1057	1137	2	7	80	0.0875000
NODE_1633_length_1784_cov_40.769733	1057	1137	3	35	80	0.4375000
NODE_1633_length_1784_cov_40.769733	1057	1137	4	15	80	0.1875000
NODE_1633_length_1784_cov_40.769733	1057	1137	5	20	80	0.2500000
NODE_1633_length_1784_cov_40.769733	1110	1190	4	7	80	0.0875000
NODE_1633_length_1784_cov_40.769733	1110	1190	5	36	80	0.4500000
NODE_1633_length_1784_cov_40.769733	1110	1190	7	22	80	0.2750000
NODE_1633_length_1784_cov_40.769733	1110	1190	8	15	80	0.1875000
NODE_1633_length_1784_cov_40.769733	1186	1266	8	6	80	0.0750000
NODE_1633_length_1784_cov_40.769733	1186	1266	9	9	80	0.1125000
NODE_1633_length_1784_cov_40.769733	1186	1266	10	20	80	0.2500000
NODE_1633_length_1784_cov_40.769733	1186	1266	11	43	80	0.5375000
NODE_1633_length_1784_cov_40.769733	1186	1266	12	2	80	0.0250000
NODE_1633_length_1784_cov_40.769733	1239	1319	8	21	80	0.2625000
NODE_1633_length_1784_cov_40.769733	1239	1319	9	31	80	0.3875000
NODE_1633_length_1784_cov_40.769733	1239	1319	10	4	80	0.0500000
NODE_1633_length_1784_cov_40.769733	1239	1319	11	22	80	0.2750000
NODE_1633_length_1784_cov_40.769733	1239	1319	12	2	80	0.0250000
NODE_1634_length_1784_cov_6.049258	1646	1725	0	79	79	1.0000000
NODE_1637_length_1783_cov_45.569477	600	680	7	8	80	0.1000000
NODE_1637_length_1783_cov_45.569477	600	680	9	38	80	0.4750000
NODE_1637_length_1783_cov_45.569477	600	680	10	34	80	0.4250000
NODE_1637_length_1783_cov_45.569477	653	733	7	8	80	0.1000000
NODE_1637_length_1783_cov_45.569477	653	733	8	4	80	0.0500000
NODE_1637_length_1783_cov_45.569477	653	733	9	63	80	0.7875000
NODE_1637_length_1783_cov_45.569477	653	733	10	5	80	0.0625000
NODE_1640_length_1780_cov_21.089233	361	441	4	24	80	0.3000000
NODE_1640_length_1780_cov_21.089233	361	441	5	39	80	0.4875000
NODE_1640_length_1780_cov_21.089233	361	441	6	17	80	0.2125000
NODE_1640_length_1780_cov_21.089233	414	494	5	52	80	0.6500000
NODE_1640_length_1780_cov_21.089233	414	494	6	2	80	0.0250000
NODE_1640_length_1780_cov_21.089233	414	494	7	16	80	0.2000000
NODE_1640_length_1780_cov_21.089233	414	494	9	10	80	0.1250000
NODE_1640_length_1780_cov_21.089233	1031	1104	0	34	73	0.4657534
NODE_1640_length_1780_cov_21.089233	1031	1104	1	1	73	0.0136986
NODE_1640_length_1780_cov_21.089233	1031	1104	3	5	73	0.0684932
NODE_1640_length_1780_cov_21.089233	1031	1104	4	8	73	0.1095890
NODE_1640_length_1780_cov_21.089233	1031	1104	6	5	73	0.0684932
NODE_1640_length_1780_cov_21.089233	1031	1104	7	8	73	0.1095890
NODE_1640_length_1780_cov_21.089233	1031	1104	8	2	73	0.0273973
NODE_1640_length_1780_cov_21.089233	1031	1104	11	2	73	0.0273973
NODE_1640_length_1780_cov_21.089233	1031	1104	12	3	73	0.0410959
NODE_1640_length_1780_cov_21.089233	1031	1104	14	5	73	0.0684932
NODE_1640_length_1780_cov_21.089233	1071	1112	4	8	41	0.1951219
NODE_1640_length_1780_cov_21.089233	1071	1112	6	5	41	0.1219512
NODE_1640_length_1780_cov_21.089233	1071	1112	7	8	41	0.1951219
NODE_1640_length_1780_cov_21.089233	1071	1112	8	2	41	0.0487805
NODE_1640_length_1780_cov_21.089233	1071	1112	11	2	41	0.0487805
NODE_1640_length_1780_cov_21.089233	1071	1112	12	3	41	0.0731707
NODE_1640_length_1780_cov_21.089233	1071	1112	14	13	41	0.3170732
NODE_1641_length_1780_cov_7.837597	1682	1747	0	65	65	1.0000000
NODE_1649_length_1778_cov_52.804050	1528	1568	1	1	40	0.0250000
NODE_1649_length_1778_cov_52.804050	1528	1568	2	1	40	0.0250000
NODE_1649_length_1778_cov_52.804050	1528	1568	5	1	40	0.0250000
NODE_1649_length_1778_cov_52.804050	1528	1568	6	1	40	0.0250000
NODE_1649_length_1778_cov_52.804050	1528	1568	7	2	40	0.0500000
NODE_1649_length_1778_cov_52.804050	1528	1568	9	6	40	0.1500000
NODE_1649_length_1778_cov_52.804050	1528	1568	11	2	40	0.0500000
NODE_1649_length_1778_cov_52.804050	1528	1568	13	2	40	0.0500000
NODE_1649_length_1778_cov_52.804050	1528	1568	15	1	40	0.0250000
NODE_1649_length_1778_cov_52.804050	1528	1568	18	17	40	0.4250000
NODE_1649_length_1778_cov_52.804050	1528	1568	19	3	40	0.0750000
NODE_1649_length_1778_cov_52.804050	1528	1568	20	2	40	0.0500000
NODE_1649_length_1778_cov_52.804050	1528	1568	22	1	40	0.0250000
NODE_1649_length_1778_cov_52.804050	1541	1621	11	1	80	0.0125000
NODE_1649_length_1778_cov_52.804050	1541	1621	13	2	80	0.0250000
NODE_1649_length_1778_cov_52.804050	1541	1621	15	1	80	0.0125000
NODE_1649_length_1778_cov_52.804050	1541	1621	18	17	80	0.2125000
NODE_1649_length_1778_cov_52.804050	1541	1621	19	3	80	0.0375000
NODE_1649_length_1778_cov_52.804050	1541	1621	20	2	80	0.0250000
NODE_1649_length_1778_cov_52.804050	1541	1621	22	18	80	0.2250000
NODE_1649_length_1778_cov_52.804050	1541	1621	24	15	80	0.1875000
NODE_1649_length_1778_cov_52.804050	1541	1621	26	7	80	0.0875000
NODE_1649_length_1778_cov_52.804050	1541	1621	27	4	80	0.0500000
NODE_1649_length_1778_cov_52.804050	1541	1621	28	1	80	0.0125000
NODE_1649_length_1778_cov_52.804050	1541	1621	30	9	80	0.1125000
NODE_1649_length_1778_cov_52.804050	1541	1621	11	1	80	0.0125000
NODE_1649_length_1778_cov_52.804050	1541	1621	13	2	80	0.0250000
NODE_1649_length_1778_cov_52.804050	1541	1621	15	1	80	0.0125000
NODE_1649_length_1778_cov_52.804050	1541	1621	18	17	80	0.2125000
NODE_1649_length_1778_cov_52.804050	1541	1621	19	3	80	0.0375000
NODE_1649_length_1778_cov_52.804050	1541	1621	20	2	80	0.0250000
NODE_1649_length_1778_cov_52.804050	1541	1621	22	18	80	0.2250000
NODE_1649_length_1778_cov_52.804050	1541	1621	24	15	80	0.1875000
NODE_1649_length_1778_cov_52.804050	1541	1621	26	7	80	0.0875000
NODE_1649_length_1778_cov_52.804050	1541	1621	27	4	80	0.0500000
NODE_1649_length_1778_cov_52.804050	1541	1621	28	1	80	0.0125000
NODE_1649_length_1778_cov_52.804050	1541	1621	30	9	80	0.1125000
NODE_1649_length_1778_cov_52.804050	1541	1621	11	1	80	0.0125000
NODE_1649_length_1778_cov_52.804050	1541	1621	13	2	80	0.0250000
NODE_1649_length_1778_cov_52.804050	1541	1621	15	1	80	0.0125000
NODE_1649_length_1778_cov_52.804050	1541	1621	18	17	80	0.2125000
NODE_1649_length_1778_cov_52.804050	1541	1621	19	3	80	0.0375000
NODE_1649_length_1778_cov_52.804050	1541	1621	20	2	80	0.0250000
NODE_1649_length_1778_cov_52.804050	1541	1621	22	18	80	0.2250000
NODE_1649_length_1778_cov_52.804050	1541	1621	24	15	80	0.1875000
NODE_1649_length_1778_cov_52.804050	1541	1621	26	7	80	0.0875000
NODE_1649_length_1778_cov_52.804050	1541	1621	27	4	80	0.0500000
NODE_1649_length_1778_cov_52.804050	1541	1621	28	1	80	0.0125000
NODE_1649_length_1778_cov_52.804050	1541	1621	30	9	80	0.1125000
NODE_1649_length_1778_cov_52.804050	1541	1621	11	1	80	0.0125000
NODE_1649_length_1778_cov_52.804050	1541	1621	13	2	80	0.0250000
NODE_1649_length_1778_cov_52.804050	1541	1621	15	1	80	0.0125000
NODE_1649_length_1778_cov_52.804050	1541	1621	18	17	80	0.2125000
NODE_1649_length_1778_cov_52.804050	1541	1621	19	3	80	0.0375000
NODE_1649_length_1778_cov_52.804050	1541	1621	20	2	80	0.0250000
NODE_1649_length_1778_cov_52.804050	1541	1621	22	18	80	0.2250000
NODE_1649_length_1778_cov_52.804050	1541	1621	24	15	80	0.1875000
NODE_1649_length_1778_cov_52.804050	1541	1621	26	7	80	0.0875000
NODE_1649_length_1778_cov_52.804050	1541	1621	27	4	80	0.0500000
NODE_1649_length_1778_cov_52.804050	1541	1621	28	1	80	0.0125000
NODE_1649_length_1778_cov_52.804050	1541	1621	30	9	80	0.1125000
NODE_1649_length_1778_cov_52.804050	1541	1621	11	1	80	0.0125000
NODE_1649_length_1778_cov_52.804050	1541	1621	13	2	80	0.0250000
NODE_1649_length_1778_cov_52.804050	1541	1621	15	1	80	0.0125000
NODE_1649_length_1778_cov_52.804050	1541	1621	18	17	80	0.2125000
NODE_1649_length_1778_cov_52.804050	1541	1621	19	3	80	0.0375000
NODE_1649_length_1778_cov_52.804050	1541	1621	20	2	80	0.0250000
NODE_1649_length_1778_cov_52.804050	1541	1621	22	18	80	0.2250000
NODE_1649_length_1778_cov_52.804050	1541	1621	24	15	80	0.1875000
NODE_1649_length_1778_cov_52.804050	1541	1621	26	7	80	0.0875000
NODE_1649_length_1778_cov_52.804050	1541	1621	27	4	80	0.0500000
NODE_1649_length_1778_cov_52.804050	1541	1621	28	1	80	0.0125000
NODE_1649_length_1778_cov_52.804050	1541	1621	30	9	80	0.1125000
NODE_1649_length_1778_cov_52.804050	1541	1621	11	1	80	0.0125000
NODE_1649_length_1778_cov_52.804050	1541	1621	13	2	80	0.0250000
NODE_1649_length_1778_cov_52.804050	1541	1621	15	1	80	0.0125000
NODE_1649_length_1778_cov_52.804050	1541	1621	18	17	80	0.2125000
NODE_1649_length_1778_cov_52.804050	1541	1621	19	3	80	0.0375000
NODE_1649_length_1778_cov_52.804050	1541	1621	20	2	80	0.0250000
NODE_1649_length_1778_cov_52.804050	1541	1621	22	18	80	0.2250000
NODE_1649_length_1778_cov_52.804050	1541	1621	24	15	80	0.1875000
NODE_1649_length_1778_cov_52.804050	1541	1621	26	7	80	0.0875000
NODE_1649_length_1778_cov_52.804050	1541	1621	27	4	80	0.0500000
NODE_1649_length_1778_cov_52.804050	1541	1621	28	1	80	0.0125000
NODE_1649_length_1778_cov_52.804050	1541	1621	30	9	80	0.1125000
NODE_1649_length_1778_cov_52.804050	1617	1697	12	2	80	0.0250000
NODE_1649_length_1778_cov_52.804050	1617	1697	13	6	80	0.0750000
NODE_1649_length_1778_cov_52.804050	1617	1697	15	7	80	0.0875000
NODE_1649_length_1778_cov_52.804050	1617	1697	16	1	80	0.0125000
NODE_1649_length_1778_cov_52.804050	1617	1697	17	1	80	0.0125000
NODE_1649_length_1778_cov_52.804050	1617	1697	20	1	80	0.0125000
NODE_1649_length_1778_cov_52.804050	1617	1697	21	2	80	0.0250000
NODE_1649_length_1778_cov_52.804050	1617	1697	23	2	80	0.0250000
NODE_1649_length_1778_cov_52.804050	1617	1697	26	4	80	0.0500000
NODE_1649_length_1778_cov_52.804050	1617	1697	28	7	80	0.0875000
NODE_1649_length_1778_cov_52.804050	1617	1697	30	47	80	0.5875000
NODE_1649_length_1778_cov_52.804050	1617	1697	12	2	80	0.0250000
NODE_1649_length_1778_cov_52.804050	1617	1697	13	6	80	0.0750000
NODE_1649_length_1778_cov_52.804050	1617	1697	15	7	80	0.0875000
NODE_1649_length_1778_cov_52.804050	1617	1697	16	1	80	0.0125000
NODE_1649_length_1778_cov_52.804050	1617	1697	17	1	80	0.0125000
NODE_1649_length_1778_cov_52.804050	1617	1697	20	1	80	0.0125000
NODE_1649_length_1778_cov_52.804050	1617	1697	21	2	80	0.0250000
NODE_1649_length_1778_cov_52.804050	1617	1697	23	2	80	0.0250000
NODE_1649_length_1778_cov_52.804050	1617	1697	26	4	80	0.0500000
NODE_1649_length_1778_cov_52.804050	1617	1697	28	7	80	0.0875000
NODE_1649_length_1778_cov_52.804050	1617	1697	30	47	80	0.5875000
NODE_1649_length_1778_cov_52.804050	1617	1697	12	2	80	0.0250000
NODE_1649_length_1778_cov_52.804050	1617	1697	13	6	80	0.0750000
NODE_1649_length_1778_cov_52.804050	1617	1697	15	7	80	0.0875000
NODE_1649_length_1778_cov_52.804050	1617	1697	16	1	80	0.0125000
NODE_1649_length_1778_cov_52.804050	1617	1697	17	1	80	0.0125000
NODE_1649_length_1778_cov_52.804050	1617	1697	20	1	80	0.0125000
NODE_1649_length_1778_cov_52.804050	1617	1697	21	2	80	0.0250000
NODE_1649_length_1778_cov_52.804050	1617	1697	23	2	80	0.0250000
NODE_1649_length_1778_cov_52.804050	1617	1697	26	4	80	0.0500000
NODE_1649_length_1778_cov_52.804050	1617	1697	28	7	80	0.0875000
NODE_1649_length_1778_cov_52.804050	1617	1697	30	47	80	0.5875000
NODE_1649_length_1778_cov_52.804050	1617	1697	12	2	80	0.0250000
NODE_1649_length_1778_cov_52.804050	1617	1697	13	6	80	0.0750000
NODE_1649_length_1778_cov_52.804050	1617	1697	15	7	80	0.0875000
NODE_1649_length_1778_cov_52.804050	1617	1697	16	1	80	0.0125000
NODE_1649_length_1778_cov_52.804050	1617	1697	17	1	80	0.0125000
NODE_1649_length_1778_cov_52.804050	1617	1697	20	1	80	0.0125000
NODE_1649_length_1778_cov_52.804050	1617	1697	21	2	80	0.0250000
NODE_1649_length_1778_cov_52.804050	1617	1697	23	2	80	0.0250000
NODE_1649_length_1778_cov_52.804050	1617	1697	26	4	80	0.0500000
NODE_1649_length_1778_cov_52.804050	1617	1697	28	7	80	0.0875000
NODE_1649_length_1778_cov_52.804050	1617	1697	30	47	80	0.5875000
NODE_1649_length_1778_cov_52.804050	1670	1750	2	36	80	0.4500000
NODE_1649_length_1778_cov_52.804050	1670	1750	4	2	80	0.0250000
NODE_1649_length_1778_cov_52.804050	1670	1750	5	1	80	0.0125000
NODE_1649_length_1778_cov_52.804050	1670	1750	7	3	80	0.0375000
NODE_1649_length_1778_cov_52.804050	1670	1750	8	5	80	0.0625000
NODE_1649_length_1778_cov_52.804050	1670	1750	9	1	80	0.0125000
NODE_1649_length_1778_cov_52.804050	1670	1750	12	7	80	0.0875000
NODE_1649_length_1778_cov_52.804050	1670	1750	13	6	80	0.0750000
NODE_1649_length_1778_cov_52.804050	1670	1750	15	7	80	0.0875000
NODE_1649_length_1778_cov_52.804050	1670	1750	16	1	80	0.0125000
NODE_1649_length_1778_cov_52.804050	1670	1750	17	1	80	0.0125000
NODE_1649_length_1778_cov_52.804050	1670	1750	20	1	80	0.0125000
NODE_1649_length_1778_cov_52.804050	1670	1750	21	2	80	0.0250000
NODE_1649_length_1778_cov_52.804050	1670	1750	23	2	80	0.0250000
NODE_1649_length_1778_cov_52.804050	1670	1750	26	4	80	0.0500000
NODE_1649_length_1778_cov_52.804050	1670	1750	28	1	80	0.0125000
NODE_1649_length_1778_cov_52.804050	1670	1750	2	36	80	0.4500000
NODE_1649_length_1778_cov_52.804050	1670	1750	4	2	80	0.0250000
NODE_1649_length_1778_cov_52.804050	1670	1750	5	1	80	0.0125000
NODE_1649_length_1778_cov_52.804050	1670	1750	7	3	80	0.0375000
NODE_1649_length_1778_cov_52.804050	1670	1750	8	5	80	0.0625000
NODE_1649_length_1778_cov_52.804050	1670	1750	9	1	80	0.0125000
NODE_1649_length_1778_cov_52.804050	1670	1750	12	7	80	0.0875000
NODE_1649_length_1778_cov_52.804050	1670	1750	13	6	80	0.0750000
NODE_1649_length_1778_cov_52.804050	1670	1750	15	7	80	0.0875000
NODE_1649_length_1778_cov_52.804050	1670	1750	16	1	80	0.0125000
NODE_1649_length_1778_cov_52.804050	1670	1750	17	1	80	0.0125000
NODE_1649_length_1778_cov_52.804050	1670	1750	20	1	80	0.0125000
NODE_1649_length_1778_cov_52.804050	1670	1750	21	2	80	0.0250000
NODE_1649_length_1778_cov_52.804050	1670	1750	23	2	80	0.0250000
NODE_1649_length_1778_cov_52.804050	1670	1750	26	4	80	0.0500000
NODE_1649_length_1778_cov_52.804050	1670	1750	28	1	80	0.0125000
NODE_1649_length_1778_cov_52.804050	1670	1750	2	36	80	0.4500000
NODE_1649_length_1778_cov_52.804050	1670	1750	4	2	80	0.0250000
NODE_1649_length_1778_cov_52.804050	1670	1750	5	1	80	0.0125000
NODE_1649_length_1778_cov_52.804050	1670	1750	7	3	80	0.0375000
NODE_1649_length_1778_cov_52.804050	1670	1750	8	5	80	0.0625000
NODE_1649_length_1778_cov_52.804050	1670	1750	9	1	80	0.0125000
NODE_1649_length_1778_cov_52.804050	1670	1750	12	7	80	0.0875000
NODE_1649_length_1778_cov_52.804050	1670	1750	13	6	80	0.0750000
NODE_1649_length_1778_cov_52.804050	1670	1750	15	7	80	0.0875000
NODE_1649_length_1778_cov_52.804050	1670	1750	16	1	80	0.0125000
NODE_1649_length_1778_cov_52.804050	1670	1750	17	1	80	0.0125000
NODE_1649_length_1778_cov_52.804050	1670	1750	20	1	80	0.0125000
NODE_1649_length_1778_cov_52.804050	1670	1750	21	2	80	0.0250000
NODE_1649_length_1778_cov_52.804050	1670	1750	23	2	80	0.0250000
NODE_1649_length_1778_cov_52.804050	1670	1750	26	4	80	0.0500000
NODE_1649_length_1778_cov_52.804050	1670	1750	28	1	80	0.0125000
NODE_1649_length_1778_cov_52.804050	1670	1741	2	27	71	0.3802817
NODE_1649_length_1778_cov_52.804050	1670	1741	4	2	71	0.0281690
NODE_1649_length_1778_cov_52.804050	1670	1741	5	1	71	0.0140845
NODE_1649_length_1778_cov_52.804050	1670	1741	7	3	71	0.0422535
NODE_1649_length_1778_cov_52.804050	1670	1741	8	5	71	0.0704225
NODE_1649_length_1778_cov_52.804050	1670	1741	9	1	71	0.0140845
NODE_1649_length_1778_cov_52.804050	1670	1741	12	7	71	0.0985916
NODE_1649_length_1778_cov_52.804050	1670	1741	13	6	71	0.0845070
NODE_1649_length_1778_cov_52.804050	1670	1741	15	7	71	0.0985916
NODE_1649_length_1778_cov_52.804050	1670	1741	16	1	71	0.0140845
NODE_1649_length_1778_cov_52.804050	1670	1741	17	1	71	0.0140845
NODE_1649_length_1778_cov_52.804050	1670	1741	20	1	71	0.0140845
NODE_1649_length_1778_cov_52.804050	1670	1741	21	2	71	0.0281690
NODE_1649_length_1778_cov_52.804050	1670	1741	23	2	71	0.0281690
NODE_1649_length_1778_cov_52.804050	1670	1741	26	4	71	0.0563380
NODE_1649_length_1778_cov_52.804050	1670	1741	28	1	71	0.0140845
NODE_1649_length_1778_cov_52.804050	1673	1743	2	29	70	0.4142857
NODE_1649_length_1778_cov_52.804050	1673	1743	4	2	70	0.0285714
NODE_1649_length_1778_cov_52.804050	1673	1743	5	1	70	0.0142857
NODE_1649_length_1778_cov_52.804050	1673	1743	7	3	70	0.0428571
NODE_1649_length_1778_cov_52.804050	1673	1743	8	5	70	0.0714286
NODE_1649_length_1778_cov_52.804050	1673	1743	9	1	70	0.0142857
NODE_1649_length_1778_cov_52.804050	1673	1743	12	7	70	0.1000000
NODE_1649_length_1778_cov_52.804050	1673	1743	13	6	70	0.0857143
NODE_1649_length_1778_cov_52.804050	1673	1743	15	7	70	0.1000000
NODE_1649_length_1778_cov_52.804050	1673	1743	16	1	70	0.0142857
NODE_1649_length_1778_cov_52.804050	1673	1743	17	1	70	0.0142857
NODE_1649_length_1778_cov_52.804050	1673	1743	20	1	70	0.0142857
NODE_1649_length_1778_cov_52.804050	1673	1743	21	2	70	0.0285714
NODE_1649_length_1778_cov_52.804050	1673	1743	23	2	70	0.0285714
NODE_1649_length_1778_cov_52.804050	1673	1743	26	2	70	0.0285714
NODE_1649_length_1778_cov_52.804050	1679	1750	2	36	71	0.5070422
NODE_1649_length_1778_cov_52.804050	1679	1750	4	2	71	0.0281690
NODE_1649_length_1778_cov_52.804050	1679	1750	5	1	71	0.0140845
NODE_1649_length_1778_cov_52.804050	1679	1750	7	3	71	0.0422535
NODE_1649_length_1778_cov_52.804050	1679	1750	8	5	71	0.0704225
NODE_1649_length_1778_cov_52.804050	1679	1750	9	1	71	0.0140845
NODE_1649_length_1778_cov_52.804050	1679	1750	12	7	71	0.0985916
NODE_1649_length_1778_cov_52.804050	1679	1750	13	6	71	0.0845070
NODE_1649_length_1778_cov_52.804050	1679	1750	15	7	71	0.0985916
NODE_1649_length_1778_cov_52.804050	1679	1750	16	1	71	0.0140845
NODE_1649_length_1778_cov_52.804050	1679	1750	17	1	71	0.0140845
NODE_1649_length_1778_cov_52.804050	1679	1750	20	1	71	0.0140845
NODE_1651_length_1776_cov_43.081694	1246	1308	0	19	62	0.3064516
NODE_1651_length_1776_cov_43.081694	1246	1308	2	11	62	0.1774193
NODE_1651_length_1776_cov_43.081694	1246	1308	3	2	62	0.0322581
NODE_1651_length_1776_cov_43.081694	1246	1308	4	25	62	0.4032258
NODE_1651_length_1776_cov_43.081694	1246	1308	6	3	62	0.0483871
NODE_1651_length_1776_cov_43.081694	1246	1308	7	1	62	0.0161290
NODE_1651_length_1776_cov_43.081694	1246	1308	10	1	62	0.0161290
NODE_1651_length_1776_cov_43.081694	1281	1361	2	2	80	0.0250000
NODE_1651_length_1776_cov_43.081694	1281	1361	4	78	80	0.9750000
NODE_1652_length_1776_cov_9.256410	1120	1200	1	26	80	0.3250000
NODE_1652_length_1776_cov_9.256410	1120	1200	2	19	80	0.2375000
NODE_1652_length_1776_cov_9.256410	1120	1200	3	24	80	0.3000000
NODE_1652_length_1776_cov_9.256410	1120	1200	4	11	80	0.1375000
NODE_1652_length_1776_cov_9.256410	1173	1253	3	16	80	0.2000000
NODE_1652_length_1776_cov_9.256410	1173	1253	4	20	80	0.2500000
NODE_1652_length_1776_cov_9.256410	1173	1253	6	2	80	0.0250000
NODE_1652_length_1776_cov_9.256410	1173	1253	8	42	80	0.5250000
NODE_1652_length_1776_cov_9.256410	1249	1329	5	14	80	0.1750000
NODE_1652_length_1776_cov_9.256410	1249	1329	6	36	80	0.4500000
NODE_1652_length_1776_cov_9.256410	1249	1329	7	7	80	0.0875000
NODE_1652_length_1776_cov_9.256410	1249	1329	8	23	80	0.2875000
NODE_1652_length_1776_cov_9.256410	1302	1382	0	43	80	0.5375000
NODE_1652_length_1776_cov_9.256410	1302	1382	1	2	80	0.0250000
NODE_1652_length_1776_cov_9.256410	1302	1382	3	7	80	0.0875000
NODE_1652_length_1776_cov_9.256410	1302	1382	5	15	80	0.1875000
NODE_1652_length_1776_cov_9.256410	1302	1382	6	13	80	0.1625000
NODE_1657_length_1775_cov_54.208234	1103	1167	5	2	64	0.0312500
NODE_1657_length_1775_cov_54.208234	1103	1167	6	5	64	0.0781250
NODE_1657_length_1775_cov_54.208234	1103	1167	7	26	64	0.4062500
NODE_1657_length_1775_cov_54.208234	1103	1167	8	17	64	0.2656250
NODE_1657_length_1775_cov_54.208234	1103	1167	9	1	64	0.0156250
NODE_1657_length_1775_cov_54.208234	1103	1167	10	6	64	0.0937500
NODE_1657_length_1775_cov_54.208234	1103	1167	12	7	64	0.1093750
NODE_1657_length_1775_cov_54.208234	1103	1167	5	2	64	0.0312500
NODE_1657_length_1775_cov_54.208234	1103	1167	6	5	64	0.0781250
NODE_1657_length_1775_cov_54.208234	1103	1167	7	26	64	0.4062500
NODE_1657_length_1775_cov_54.208234	1103	1167	8	17	64	0.2656250
NODE_1657_length_1775_cov_54.208234	1103	1167	9	1	64	0.0156250
NODE_1657_length_1775_cov_54.208234	1103	1167	10	6	64	0.0937500
NODE_1657_length_1775_cov_54.208234	1103	1167	12	7	64	0.1093750
NODE_1657_length_1775_cov_54.208234	1140	1200	3	6	60	0.1000000
NODE_1657_length_1775_cov_54.208234	1140	1200	4	9	60	0.1500000
NODE_1657_length_1775_cov_54.208234	1140	1200	5	20	60	0.3333333
NODE_1657_length_1775_cov_54.208234	1140	1200	6	5	60	0.0833333
NODE_1657_length_1775_cov_54.208234	1140	1200	7	14	60	0.2333333
NODE_1657_length_1775_cov_54.208234	1140	1200	8	6	60	0.1000000
NODE_1658_length_1775_cov_13.181981	1170	1250	5	17	80	0.2125000
NODE_1658_length_1775_cov_13.181981	1170	1250	6	63	80	0.7875000
NODE_1658_length_1775_cov_13.181981	1223	1303	1	7	80	0.0875000
NODE_1658_length_1775_cov_13.181981	1223	1303	2	27	80	0.3375000
NODE_1658_length_1775_cov_13.181981	1223	1303	4	5	80	0.0625000
NODE_1658_length_1775_cov_13.181981	1223	1303	6	41	80	0.5125000
NODE_1659_length_1775_cov_4.218974	1304	1384	1	80	80	1.0000000
NODE_1659_length_1775_cov_4.218974	1357	1437	1	80	80	1.0000000
NODE_1660_length_1774_cov_48.617313	345	425	5	39	80	0.4875000
NODE_1660_length_1774_cov_48.617313	345	425	6	41	80	0.5125000
NODE_1660_length_1774_cov_48.617313	398	478	1	5	80	0.0625000
NODE_1660_length_1774_cov_48.617313	398	478	2	7	80	0.0875000
NODE_1660_length_1774_cov_48.617313	398	478	3	9	80	0.1125000
NODE_1660_length_1774_cov_48.617313	398	478	4	1	80	0.0125000
NODE_1660_length_1774_cov_48.617313	398	478	6	58	80	0.7250000
NODE_1660_length_1774_cov_48.617313	474	554	0	14	80	0.1750000
NODE_1660_length_1774_cov_48.617313	474	554	1	66	80	0.8250000
NODE_1660_length_1774_cov_48.617313	527	607	0	67	80	0.8375000
NODE_1660_length_1774_cov_48.617313	527	607	1	13	80	0.1625000
NODE_1660_length_1774_cov_48.617313	1027	1107	7	22	80	0.2750000
NODE_1660_length_1774_cov_48.617313	1027	1107	8	10	80	0.1250000
NODE_1660_length_1774_cov_48.617313	1027	1107	9	14	80	0.1750000
NODE_1660_length_1774_cov_48.617313	1027	1107	10	12	80	0.1500000
NODE_1660_length_1774_cov_48.617313	1027	1107	11	8	80	0.1000000
NODE_1660_length_1774_cov_48.617313	1027	1107	12	14	80	0.1750000
NODE_1660_length_1774_cov_48.617313	1080	1160	10	5	80	0.0625000
NODE_1660_length_1774_cov_48.617313	1080	1160	11	15	80	0.1875000
NODE_1660_length_1774_cov_48.617313	1080	1160	12	21	80	0.2625000
NODE_1660_length_1774_cov_48.617313	1080	1160	13	9	80	0.1125000
NODE_1660_length_1774_cov_48.617313	1080	1160	14	6	80	0.0750000
NODE_1660_length_1774_cov_48.617313	1080	1160	15	24	80	0.3000000
NODE_1660_length_1774_cov_48.617313	1156	1236	14	11	80	0.1375000
NODE_1660_length_1774_cov_48.617313	1156	1236	15	29	80	0.3625000
NODE_1660_length_1774_cov_48.617313	1156	1236	16	23	80	0.2875000
NODE_1660_length_1774_cov_48.617313	1156	1236	17	17	80	0.2125000
NODE_1660_length_1774_cov_48.617313	1209	1289	11	1	80	0.0125000
NODE_1660_length_1774_cov_48.617313	1209	1289	13	1	80	0.0125000
NODE_1660_length_1774_cov_48.617313	1209	1289	14	1	80	0.0125000
NODE_1660_length_1774_cov_48.617313	1209	1289	15	10	80	0.1250000
NODE_1660_length_1774_cov_48.617313	1209	1289	16	26	80	0.3250000
NODE_1660_length_1774_cov_48.617313	1209	1289	17	28	80	0.3500000
NODE_1660_length_1774_cov_48.617313	1209	1289	18	7	80	0.0875000
NODE_1660_length_1774_cov_48.617313	1209	1289	19	6	80	0.0750000
NODE_1662_length_1774_cov_8.011343	1655	1735	0	80	80	1.0000000
NODE_1663_length_1773_cov_5.547192	433	513	5	12	80	0.1500000
NODE_1663_length_1773_cov_5.547192	433	513	6	58	80	0.7250000
NODE_1663_length_1773_cov_5.547192	433	513	7	10	80	0.1250000
NODE_1663_length_1773_cov_5.547192	486	566	3	26	80	0.3250000
NODE_1663_length_1773_cov_5.547192	486	566	4	24	80	0.3000000
NODE_1663_length_1773_cov_5.547192	486	566	5	2	80	0.0250000
NODE_1663_length_1773_cov_5.547192	486	566	6	28	80	0.3500000
NODE_1664_length_1773_cov_3.925329	267	347	1	7	80	0.0875000
NODE_1664_length_1773_cov_3.925329	267	347	2	73	80	0.9125000
NODE_1664_length_1773_cov_3.925329	320	400	0	46	80	0.5750000
NODE_1664_length_1773_cov_3.925329	320	400	1	14	80	0.1750000
NODE_1664_length_1773_cov_3.925329	320	400	2	20	80	0.2500000
NODE_1666_length_1770_cov_9.912029	369	437	3	68	68	1.0000000
NODE_1666_length_1770_cov_9.912029	388	431	3	43	43	1.0000000
NODE_1666_length_1770_cov_9.912029	509	577	5	6	68	0.0882353
NODE_1666_length_1770_cov_9.912029	509	577	6	29	68	0.4264706
NODE_1666_length_1770_cov_9.912029	509	577	7	4	68	0.0588235
NODE_1666_length_1770_cov_9.912029	509	577	8	2	68	0.0294118
NODE_1666_length_1770_cov_9.912029	509	577	9	27	68	0.3970588
NODE_1666_length_1770_cov_9.912029	515	571	6	29	56	0.5178571
NODE_1666_length_1770_cov_9.912029	515	571	8	2	56	0.0357143
NODE_1666_length_1770_cov_9.912029	515	571	9	25	56	0.4464286
NODE_1666_length_1770_cov_9.912029	579	618	5	6	39	0.1538462
NODE_1666_length_1770_cov_9.912029	579	618	7	5	39	0.1282051
NODE_1666_length_1770_cov_9.912029	579	618	8	28	39	0.7179487
NODE_1666_length_1770_cov_9.912029	697	776	0	20	79	0.2531646
NODE_1666_length_1770_cov_9.912029	697	776	1	12	79	0.1518987
NODE_1666_length_1770_cov_9.912029	697	776	2	37	79	0.4683544
NODE_1666_length_1770_cov_9.912029	697	776	3	10	79	0.1265823
NODE_1666_length_1770_cov_9.912029	714	794	0	20	80	0.2500000
NODE_1666_length_1770_cov_9.912029	714	794	1	12	80	0.1500000
NODE_1666_length_1770_cov_9.912029	714	794	2	20	80	0.2500000
NODE_1666_length_1770_cov_9.912029	714	794	3	28	80	0.3500000
NODE_1666_length_1770_cov_9.912029	767	819	3	39	52	0.7500000
NODE_1666_length_1770_cov_9.912029	767	819	4	13	52	0.2500000
NODE_1666_length_1770_cov_9.912029	785	819	3	21	34	0.6176471
NODE_1666_length_1770_cov_9.912029	785	819	4	13	34	0.3823529
NODE_1667_length_1768_cov_9.134811	687	736	11	3	49	0.0612245
NODE_1667_length_1768_cov_9.134811	687	736	12	10	49	0.2040816
NODE_1667_length_1768_cov_9.134811	687	736	13	16	49	0.3265306
NODE_1667_length_1768_cov_9.134811	687	736	14	14	49	0.2857143
NODE_1667_length_1768_cov_9.134811	687	736	15	6	49	0.1224490
NODE_1668_length_1768_cov_6.605153	1207	1287	1	37	80	0.4625000
NODE_1668_length_1768_cov_6.605153	1207	1287	2	43	80	0.5375000
NODE_1668_length_1768_cov_6.605153	1260	1340	2	66	80	0.8250000
NODE_1668_length_1768_cov_6.605153	1260	1340	3	4	80	0.0500000
NODE_1668_length_1768_cov_6.605153	1260	1340	4	10	80	0.1250000
NODE_1668_length_1768_cov_6.605153	1336	1416	2	22	80	0.2750000
NODE_1668_length_1768_cov_6.605153	1336	1416	3	53	80	0.6625000
NODE_1668_length_1768_cov_6.605153	1336	1416	4	5	80	0.0625000
NODE_1668_length_1768_cov_6.605153	1389	1469	2	75	80	0.9375000
NODE_1668_length_1768_cov_6.605153	1389	1469	3	5	80	0.0625000
NODE_1669_length_1767_cov_5.475420	508	588	6	45	80	0.5625000
NODE_1669_length_1767_cov_5.475420	508	588	7	11	80	0.1375000
NODE_1669_length_1767_cov_5.475420	508	588	8	20	80	0.2500000
NODE_1669_length_1767_cov_5.475420	508	588	9	4	80	0.0500000
NODE_1680_length_1762_cov_18.673482	606	686	4	14	80	0.1750000
NODE_1680_length_1762_cov_18.673482	606	686	5	52	80	0.6500000
NODE_1680_length_1762_cov_18.673482	606	686	6	14	80	0.1750000
NODE_1680_length_1762_cov_18.673482	659	739	2	23	80	0.2875000
NODE_1680_length_1762_cov_18.673482	659	739	3	9	80	0.1125000
NODE_1680_length_1762_cov_18.673482	659	739	4	3	80	0.0375000
NODE_1680_length_1762_cov_18.673482	659	739	5	45	80	0.5625000
NODE_1680_length_1762_cov_18.673482	735	815	4	21	80	0.2625000
NODE_1680_length_1762_cov_18.673482	735	815	5	23	80	0.2875000
NODE_1680_length_1762_cov_18.673482	735	815	6	36	80	0.4500000
NODE_1680_length_1762_cov_18.673482	788	868	4	65	80	0.8125000
NODE_1680_length_1762_cov_18.673482	788	868	5	9	80	0.1125000
NODE_1680_length_1762_cov_18.673482	788	868	6	6	80	0.0750000
NODE_1681_length_1762_cov_6.760072	1033	1113	0	2	80	0.0250000
NODE_1681_length_1762_cov_6.760072	1033	1113	1	78	80	0.9750000
NODE_1681_length_1762_cov_6.760072	1086	1166	1	37	80	0.4625000
NODE_1681_length_1762_cov_6.760072	1086	1166	3	43	80	0.5375000
NODE_1685_length_1760_cov_8.064419	941	1021	2	80	80	1.0000000
NODE_1685_length_1760_cov_8.064419	994	1074	0	3	80	0.0375000
NODE_1685_length_1760_cov_8.064419	994	1074	2	77	80	0.9625000
NODE_1692_length_1758_cov_99.869198	599	679	6	30	80	0.3750000
NODE_1692_length_1758_cov_99.869198	599	679	7	27	80	0.3375000
NODE_1692_length_1758_cov_99.869198	599	679	8	6	80	0.0750000
NODE_1692_length_1758_cov_99.869198	599	679	10	17	80	0.2125000
NODE_1692_length_1758_cov_99.869198	652	732	6	4	80	0.0500000
NODE_1692_length_1758_cov_99.869198	652	732	8	6	80	0.0750000
NODE_1692_length_1758_cov_99.869198	652	732	9	4	80	0.0500000
NODE_1692_length_1758_cov_99.869198	652	732	10	18	80	0.2250000
NODE_1692_length_1758_cov_99.869198	652	732	11	2	80	0.0250000
NODE_1692_length_1758_cov_99.869198	652	732	13	3	80	0.0375000
NODE_1692_length_1758_cov_99.869198	652	732	15	3	80	0.0375000
NODE_1692_length_1758_cov_99.869198	652	732	16	17	80	0.2125000
NODE_1692_length_1758_cov_99.869198	652	732	17	3	80	0.0375000
NODE_1692_length_1758_cov_99.869198	652	732	18	5	80	0.0625000
NODE_1692_length_1758_cov_99.869198	652	732	19	4	80	0.0500000
NODE_1692_length_1758_cov_99.869198	652	732	20	8	80	0.1000000
NODE_1692_length_1758_cov_99.869198	652	732	23	3	80	0.0375000
NODE_1692_length_1758_cov_99.869198	728	808	20	1	80	0.0125000
NODE_1692_length_1758_cov_99.869198	728	808	23	8	80	0.1000000
NODE_1692_length_1758_cov_99.869198	728	808	24	3	80	0.0375000
NODE_1692_length_1758_cov_99.869198	728	808	25	2	80	0.0250000
NODE_1692_length_1758_cov_99.869198	728	808	26	2	80	0.0250000
NODE_1692_length_1758_cov_99.869198	728	808	27	2	80	0.0250000
NODE_1692_length_1758_cov_99.869198	728	808	28	1	80	0.0125000
NODE_1692_length_1758_cov_99.869198	728	808	29	4	80	0.0500000
NODE_1692_length_1758_cov_99.869198	728	808	30	11	80	0.1375000
NODE_1692_length_1758_cov_99.869198	728	808	31	4	80	0.0500000
NODE_1692_length_1758_cov_99.869198	728	808	32	2	80	0.0250000
NODE_1692_length_1758_cov_99.869198	728	808	33	13	80	0.1625000
NODE_1692_length_1758_cov_99.869198	728	808	34	16	80	0.2000000
NODE_1692_length_1758_cov_99.869198	728	808	35	11	80	0.1375000
NODE_1692_length_1758_cov_99.869198	781	861	21	4	80	0.0500000
NODE_1692_length_1758_cov_99.869198	781	861	23	2	80	0.0250000
NODE_1692_length_1758_cov_99.869198	781	861	24	3	80	0.0375000
NODE_1692_length_1758_cov_99.869198	781	861	26	18	80	0.2250000
NODE_1692_length_1758_cov_99.869198	781	861	28	5	80	0.0625000
NODE_1692_length_1758_cov_99.869198	781	861	29	20	80	0.2500000
NODE_1692_length_1758_cov_99.869198	781	861	31	6	80	0.0750000
NODE_1692_length_1758_cov_99.869198	781	861	32	2	80	0.0250000
NODE_1692_length_1758_cov_99.869198	781	861	33	13	80	0.1625000
NODE_1692_length_1758_cov_99.869198	781	861	34	3	80	0.0375000
NODE_1692_length_1758_cov_99.869198	781	861	35	4	80	0.0500000
NODE_1693_length_1757_cov_3.126659	49	121	0	72	72	1.0000000
NODE_1696_length_1755_cov_9.938406	231	311	1	4	80	0.0500000
NODE_1696_length_1755_cov_9.938406	231	311	3	25	80	0.3125000
NODE_1696_length_1755_cov_9.938406	231	311	4	51	80	0.6375000
NODE_1696_length_1755_cov_9.938406	284	364	1	9	80	0.1125000
NODE_1696_length_1755_cov_9.938406	284	364	3	1	80	0.0125000
NODE_1696_length_1755_cov_9.938406	284	364	4	70	80	0.8750000
NODE_1698_length_1755_cov_3.614130	171	222	1	51	51	1.0000000
NODE_1699_length_1754_cov_8.523263	0	77	0	77	77	1.0000000
NODE_1699_length_1754_cov_8.523263	0	77	0	77	77	1.0000000
NODE_1699_length_1754_cov_8.523263	0	77	0	77	77	1.0000000
NODE_1699_length_1754_cov_8.523263	50	99	0	49	49	1.0000000
NODE_1699_length_1754_cov_8.523263	53	99	0	46	46	1.0000000
NODE_1699_length_1754_cov_8.523263	55	99	0	44	44	1.0000000
NODE_1700_length_1753_cov_26.851874	356	436	6	8	80	0.1000000
NODE_1700_length_1753_cov_26.851874	356	436	7	13	80	0.1625000
NODE_1700_length_1753_cov_26.851874	356	436	8	23	80	0.2875000
NODE_1700_length_1753_cov_26.851874	356	436	9	11	80	0.1375000
NODE_1700_length_1753_cov_26.851874	356	436	10	25	80	0.3125000
NODE_1700_length_1753_cov_26.851874	409	489	9	62	80	0.7750000
NODE_1700_length_1753_cov_26.851874	409	489	10	18	80	0.2250000
NODE_1701_length_1753_cov_12.297461	355	435	0	15	80	0.1875000
NODE_1701_length_1753_cov_12.297461	355	435	2	65	80	0.8125000
NODE_1701_length_1753_cov_12.297461	408	488	2	80	80	1.0000000
NODE_1705_length_1750_cov_90.732283	1191	1254	51	3	63	0.0476190
NODE_1705_length_1750_cov_90.732283	1191	1254	52	2	63	0.0317460
NODE_1705_length_1750_cov_90.732283	1191	1254	53	19	63	0.3015873
NODE_1705_length_1750_cov_90.732283	1191	1254	54	3	63	0.0476190
NODE_1705_length_1750_cov_90.732283	1191	1254	55	9	63	0.1428571
NODE_1705_length_1750_cov_90.732283	1191	1254	56	5	63	0.0793651
NODE_1705_length_1750_cov_90.732283	1191	1254	57	4	63	0.0634921
NODE_1705_length_1750_cov_90.732283	1191	1254	58	1	63	0.0158730
NODE_1705_length_1750_cov_90.732283	1191	1254	59	1	63	0.0158730
NODE_1705_length_1750_cov_90.732283	1191	1254	62	2	63	0.0317460
NODE_1705_length_1750_cov_90.732283	1191	1254	63	2	63	0.0317460
NODE_1705_length_1750_cov_90.732283	1191	1254	64	9	63	0.1428571
NODE_1705_length_1750_cov_90.732283	1191	1254	65	3	63	0.0476190
NODE_1705_length_1750_cov_90.732283	1239	1310	62	6	71	0.0845070
NODE_1705_length_1750_cov_90.732283	1239	1310	63	5	71	0.0704225
NODE_1705_length_1750_cov_90.732283	1239	1310	64	12	71	0.1690141
NODE_1705_length_1750_cov_90.732283	1239	1310	65	8	71	0.1126761
NODE_1705_length_1750_cov_90.732283	1239	1310	66	7	71	0.0985916
NODE_1705_length_1750_cov_90.732283	1239	1310	68	8	71	0.1126761
NODE_1705_length_1750_cov_90.732283	1239	1310	69	4	71	0.0563380
NODE_1705_length_1750_cov_90.732283	1239	1310	70	6	71	0.0845070
NODE_1705_length_1750_cov_90.732283	1239	1310	71	5	71	0.0704225
NODE_1705_length_1750_cov_90.732283	1239	1310	72	9	71	0.1267606
NODE_1705_length_1750_cov_90.732283	1239	1310	73	1	71	0.0140845
NODE_1711_length_1746_cov_3.095932	458	524	0	5	66	0.0757576
NODE_1711_length_1746_cov_3.095932	458	524	1	61	66	0.9242424
NODE_1712_length_1745_cov_7.646416	430	510	2	80	80	1.0000000
NODE_1712_length_1745_cov_7.646416	483	563	1	10	80	0.1250000
NODE_1712_length_1745_cov_7.646416	483	563	2	70	80	0.8750000
NODE_1715_length_1744_cov_10.144681	1213	1289	4	15	76	0.1973684
NODE_1715_length_1744_cov_10.144681	1213	1289	6	61	76	0.8026316
NODE_1715_length_1744_cov_10.144681	1262	1342	4	6	80	0.0750000
NODE_1715_length_1744_cov_10.144681	1262	1342	6	36	80	0.4500000
NODE_1715_length_1744_cov_10.144681	1262	1342	8	38	80	0.4750000
NODE_1719_length_1742_cov_18.923311	699	776	0	53	77	0.6883117
NODE_1719_length_1742_cov_18.923311	699	776	1	24	77	0.3116883
NODE_1719_length_1742_cov_18.923311	749	829	0	3	80	0.0375000
NODE_1719_length_1742_cov_18.923311	749	829	1	77	80	0.9625000
NODE_1722_length_1741_cov_7.657734	1234	1314	0	80	80	1.0000000
NODE_1722_length_1741_cov_7.657734	1287	1367	0	31	80	0.3875000
NODE_1722_length_1741_cov_7.657734	1287	1367	2	49	80	0.6125000
NODE_1722_length_1741_cov_7.657734	1363	1443	2	80	80	1.0000000
NODE_1722_length_1741_cov_7.657734	1416	1496	0	32	80	0.4000000
NODE_1722_length_1741_cov_7.657734	1416	1496	2	48	80	0.6000000
NODE_1726_length_1740_cov_38.411335	517	597	17	2	80	0.0250000
NODE_1726_length_1740_cov_38.411335	517	597	18	8	80	0.1000000
NODE_1726_length_1740_cov_38.411335	517	597	19	14	80	0.1750000
NODE_1726_length_1740_cov_38.411335	517	597	20	12	80	0.1500000
NODE_1726_length_1740_cov_38.411335	517	597	21	8	80	0.1000000
NODE_1726_length_1740_cov_38.411335	517	597	22	1	80	0.0125000
NODE_1726_length_1740_cov_38.411335	517	597	23	1	80	0.0125000
NODE_1726_length_1740_cov_38.411335	517	597	25	20	80	0.2500000
NODE_1726_length_1740_cov_38.411335	517	597	26	7	80	0.0875000
NODE_1726_length_1740_cov_38.411335	517	597	27	7	80	0.0875000
NODE_1726_length_1740_cov_38.411335	570	650	18	4	80	0.0500000
NODE_1726_length_1740_cov_38.411335	570	650	20	6	80	0.0750000
NODE_1726_length_1740_cov_38.411335	570	650	21	6	80	0.0750000
NODE_1726_length_1740_cov_38.411335	570	650	22	22	80	0.2750000
NODE_1726_length_1740_cov_38.411335	570	650	23	16	80	0.2000000
NODE_1726_length_1740_cov_38.411335	570	650	25	17	80	0.2125000
NODE_1726_length_1740_cov_38.411335	570	650	26	6	80	0.0750000
NODE_1726_length_1740_cov_38.411335	570	650	27	3	80	0.0375000
NODE_1726_length_1740_cov_38.411335	646	726	7	4	80	0.0500000
NODE_1726_length_1740_cov_38.411335	646	726	8	7	80	0.0875000
NODE_1726_length_1740_cov_38.411335	646	726	9	3	80	0.0375000
NODE_1726_length_1740_cov_38.411335	646	726	10	1	80	0.0125000
NODE_1726_length_1740_cov_38.411335	646	726	11	8	80	0.1000000
NODE_1726_length_1740_cov_38.411335	646	726	12	12	80	0.1500000
NODE_1726_length_1740_cov_38.411335	646	726	13	17	80	0.2125000
NODE_1726_length_1740_cov_38.411335	646	726	14	10	80	0.1250000
NODE_1726_length_1740_cov_38.411335	646	726	15	11	80	0.1375000
NODE_1726_length_1740_cov_38.411335	646	726	16	2	80	0.0250000
NODE_1726_length_1740_cov_38.411335	646	726	18	5	80	0.0625000
NODE_1726_length_1740_cov_38.411335	699	779	5	17	80	0.2125000
NODE_1726_length_1740_cov_38.411335	699	779	7	36	80	0.4500000
NODE_1726_length_1740_cov_38.411335	699	779	8	11	80	0.1375000
NODE_1726_length_1740_cov_38.411335	699	779	9	3	80	0.0375000
NODE_1726_length_1740_cov_38.411335	699	779	10	1	80	0.0125000
NODE_1726_length_1740_cov_38.411335	699	779	11	8	80	0.1000000
NODE_1726_length_1740_cov_38.411335	699	779	12	4	80	0.0500000
NODE_1727_length_1740_cov_10.843388	552	632	1	2	80	0.0250000
NODE_1727_length_1740_cov_10.843388	552	632	3	10	80	0.1250000
NODE_1727_length_1740_cov_10.843388	552	632	5	35	80	0.4375000
NODE_1727_length_1740_cov_10.843388	552	632	6	33	80	0.4125000
NODE_1727_length_1740_cov_10.843388	708	788	0	64	80	0.8000000
NODE_1727_length_1740_cov_10.843388	708	788	1	16	80	0.2000000
NODE_1727_length_1740_cov_10.843388	708	788	0	64	80	0.8000000
NODE_1727_length_1740_cov_10.843388	708	788	1	16	80	0.2000000
NODE_1727_length_1740_cov_10.843388	708	788	0	64	80	0.8000000
NODE_1727_length_1740_cov_10.843388	708	788	1	16	80	0.2000000
NODE_1727_length_1740_cov_10.843388	761	841	0	80	80	1.0000000
NODE_1727_length_1740_cov_10.843388	761	808	0	47	47	1.0000000
NODE_1727_length_1740_cov_10.843388	761	808	0	47	47	1.0000000
NODE_1737_length_1736_cov_71.959682	841	901	11	4	60	0.0666667
NODE_1737_length_1736_cov_71.959682	841	901	13	2	60	0.0333333
NODE_1737_length_1736_cov_71.959682	841	901	16	9	60	0.1500000
NODE_1737_length_1736_cov_71.959682	841	901	17	12	60	0.2000000
NODE_1737_length_1736_cov_71.959682	841	901	18	20	60	0.3333333
NODE_1737_length_1736_cov_71.959682	841	901	19	7	60	0.1166667
NODE_1737_length_1736_cov_71.959682	841	901	20	6	60	0.1000000
NODE_1738_length_1736_cov_29.174710	1361	1390	24	11	29	0.3793103
NODE_1738_length_1736_cov_29.174710	1361	1390	25	3	29	0.1034483
NODE_1738_length_1736_cov_29.174710	1361	1390	26	6	29	0.2068966
NODE_1738_length_1736_cov_29.174710	1361	1390	27	3	29	0.1034483
NODE_1738_length_1736_cov_29.174710	1361	1390	31	1	29	0.0344828
NODE_1738_length_1736_cov_29.174710	1361	1390	32	1	29	0.0344828
NODE_1738_length_1736_cov_29.174710	1361	1390	33	1	29	0.0344828
NODE_1738_length_1736_cov_29.174710	1361	1390	35	3	29	0.1034483
NODE_1738_length_1736_cov_29.174710	1566	1628	30	2	62	0.0322581
NODE_1738_length_1736_cov_29.174710	1566	1628	31	1	62	0.0161290
NODE_1738_length_1736_cov_29.174710	1566	1628	32	2	62	0.0322581
NODE_1738_length_1736_cov_29.174710	1566	1628	33	4	62	0.0645161
NODE_1738_length_1736_cov_29.174710	1566	1628	34	2	62	0.0322581
NODE_1738_length_1736_cov_29.174710	1566	1628	37	2	62	0.0322581
NODE_1738_length_1736_cov_29.174710	1566	1628	39	7	62	0.1129032
NODE_1738_length_1736_cov_29.174710	1566	1628	40	3	62	0.0483871
NODE_1738_length_1736_cov_29.174710	1566	1628	41	11	62	0.1774193
NODE_1738_length_1736_cov_29.174710	1566	1628	42	15	62	0.2419355
NODE_1738_length_1736_cov_29.174710	1566	1628	43	2	62	0.0322581
NODE_1738_length_1736_cov_29.174710	1566	1628	44	11	62	0.1774193
NODE_1743_length_1732_cov_6.162890	807	887	2	80	80	1.0000000
NODE_1743_length_1732_cov_6.162890	860	940	0	48	80	0.6000000
NODE_1743_length_1732_cov_6.162890	860	940	2	32	80	0.4000000
NODE_1749_length_1729_cov_23.708589	364	443	6	15	79	0.1898734
NODE_1749_length_1729_cov_23.708589	364	443	8	32	79	0.4050633
NODE_1749_length_1729_cov_23.708589	364	443	10	21	79	0.2658228
NODE_1749_length_1729_cov_23.708589	364	443	11	3	79	0.0379747
NODE_1749_length_1729_cov_23.708589	364	443	12	7	79	0.0886076
NODE_1749_length_1729_cov_23.708589	364	443	13	1	79	0.0126582
NODE_1749_length_1729_cov_23.708589	416	496	10	16	80	0.2000000
NODE_1749_length_1729_cov_23.708589	416	496	11	3	80	0.0375000
NODE_1749_length_1729_cov_23.708589	416	496	12	40	80	0.5000000
NODE_1749_length_1729_cov_23.708589	416	496	13	21	80	0.2625000
NODE_1749_length_1729_cov_23.708589	492	572	6	1	80	0.0125000
NODE_1749_length_1729_cov_23.708589	492	572	7	5	80	0.0625000
NODE_1749_length_1729_cov_23.708589	492	572	9	18	80	0.2250000
NODE_1749_length_1729_cov_23.708589	492	572	10	5	80	0.0625000
NODE_1749_length_1729_cov_23.708589	492	572	11	14	80	0.1750000
NODE_1749_length_1729_cov_23.708589	492	572	12	4	80	0.0500000
NODE_1749_length_1729_cov_23.708589	492	572	13	23	80	0.2875000
NODE_1749_length_1729_cov_23.708589	492	572	14	10	80	0.1250000
NODE_1749_length_1729_cov_23.708589	545	625	6	1	80	0.0125000
NODE_1749_length_1729_cov_23.708589	545	625	7	5	80	0.0625000
NODE_1749_length_1729_cov_23.708589	545	625	8	2	80	0.0250000
NODE_1749_length_1729_cov_23.708589	545	625	9	48	80	0.6000000
NODE_1749_length_1729_cov_23.708589	545	625	10	12	80	0.1500000
NODE_1749_length_1729_cov_23.708589	545	625	11	12	80	0.1500000
NODE_1753_length_1728_cov_26.505832	259	339	3	6	80	0.0750000
NODE_1753_length_1728_cov_26.505832	259	339	6	13	80	0.1625000
NODE_1753_length_1728_cov_26.505832	259	339	7	1	80	0.0125000
NODE_1753_length_1728_cov_26.505832	259	339	10	21	80	0.2625000
NODE_1753_length_1728_cov_26.505832	259	339	11	10	80	0.1250000
NODE_1753_length_1728_cov_26.505832	259	339	12	20	80	0.2500000
NODE_1753_length_1728_cov_26.505832	259	339	13	9	80	0.1125000
NODE_1753_length_1728_cov_26.505832	312	392	8	28	80	0.3500000
NODE_1753_length_1728_cov_26.505832	312	392	12	23	80	0.2875000
NODE_1753_length_1728_cov_26.505832	312	392	13	29	80	0.3625000
NODE_1757_length_1725_cov_142.158057	767	814	110	4	47	0.0851064
NODE_1757_length_1725_cov_142.158057	767	814	112	2	47	0.0425532
NODE_1757_length_1725_cov_142.158057	767	814	113	1	47	0.0212766
NODE_1757_length_1725_cov_142.158057	767	814	114	2	47	0.0425532
NODE_1757_length_1725_cov_142.158057	767	814	115	1	47	0.0212766
NODE_1757_length_1725_cov_142.158057	767	814	117	2	47	0.0425532
NODE_1757_length_1725_cov_142.158057	767	814	118	3	47	0.0638298
NODE_1757_length_1725_cov_142.158057	767	814	119	2	47	0.0425532
NODE_1757_length_1725_cov_142.158057	767	814	120	4	47	0.0851064
NODE_1757_length_1725_cov_142.158057	767	814	121	5	47	0.1063830
NODE_1757_length_1725_cov_142.158057	767	814	122	1	47	0.0212766
NODE_1757_length_1725_cov_142.158057	767	814	123	3	47	0.0638298
NODE_1757_length_1725_cov_142.158057	767	814	124	3	47	0.0638298
NODE_1757_length_1725_cov_142.158057	767	814	125	9	47	0.1914894
NODE_1757_length_1725_cov_142.158057	767	814	126	4	47	0.0851064
NODE_1757_length_1725_cov_142.158057	767	814	127	1	47	0.0212766
NODE_1757_length_1725_cov_142.158057	803	867	110	1	64	0.0156250
NODE_1757_length_1725_cov_142.158057	803	867	111	1	64	0.0156250
NODE_1757_length_1725_cov_142.158057	803	867	112	3	64	0.0468750
NODE_1757_length_1725_cov_142.158057	803	867	113	5	64	0.0781250
NODE_1757_length_1725_cov_142.158057	803	867	114	3	64	0.0468750
NODE_1757_length_1725_cov_142.158057	803	867	115	2	64	0.0312500
NODE_1757_length_1725_cov_142.158057	803	867	116	4	64	0.0625000
NODE_1757_length_1725_cov_142.158057	803	867	117	3	64	0.0468750
NODE_1757_length_1725_cov_142.158057	803	867	119	2	64	0.0312500
NODE_1757_length_1725_cov_142.158057	803	867	120	2	64	0.0312500
NODE_1757_length_1725_cov_142.158057	803	867	121	2	64	0.0312500
NODE_1757_length_1725_cov_142.158057	803	867	122	10	64	0.1562500
NODE_1757_length_1725_cov_142.158057	803	867	123	5	64	0.0781250
NODE_1757_length_1725_cov_142.158057	803	867	124	1	64	0.0156250
NODE_1757_length_1725_cov_142.158057	803	867	125	8	64	0.1250000
NODE_1757_length_1725_cov_142.158057	803	867	126	5	64	0.0781250
NODE_1757_length_1725_cov_142.158057	803	867	127	7	64	0.1093750
NODE_1759_length_1724_cov_17.931077	677	746	6	17	69	0.2463768
NODE_1759_length_1724_cov_17.931077	677	746	7	29	69	0.4202898
NODE_1759_length_1724_cov_17.931077	677	746	8	5	69	0.0724638
NODE_1759_length_1724_cov_17.931077	677	746	9	9	69	0.1304348
NODE_1759_length_1724_cov_17.931077	677	746	11	2	69	0.0289855
NODE_1759_length_1724_cov_17.931077	677	746	12	7	69	0.1014493
NODE_1759_length_1724_cov_17.931077	788	850	12	8	62	0.1290323
NODE_1759_length_1724_cov_17.931077	788	850	13	14	62	0.2258064
NODE_1759_length_1724_cov_17.931077	788	850	14	26	62	0.4193548
NODE_1759_length_1724_cov_17.931077	788	850	15	2	62	0.0322581
NODE_1759_length_1724_cov_17.931077	788	850	16	12	62	0.1935484
NODE_1761_length_1723_cov_35.355296	1174	1254	3	52	80	0.6500000
NODE_1761_length_1723_cov_35.355296	1174	1254	4	6	80	0.0750000
NODE_1761_length_1723_cov_35.355296	1174	1254	5	22	80	0.2750000
NODE_1761_length_1723_cov_35.355296	1227	1307	4	6	80	0.0750000
NODE_1761_length_1723_cov_35.355296	1227	1307	5	35	80	0.4375000
NODE_1761_length_1723_cov_35.355296	1227	1307	6	24	80	0.3000000
NODE_1761_length_1723_cov_35.355296	1227	1307	7	15	80	0.1875000
NODE_1763_length_1722_cov_13.235367	708	788	3	21	80	0.2625000
NODE_1763_length_1722_cov_13.235367	708	788	4	3	80	0.0375000
NODE_1763_length_1722_cov_13.235367	708	788	5	6	80	0.0750000
NODE_1763_length_1722_cov_13.235367	708	788	6	21	80	0.2625000
NODE_1763_length_1722_cov_13.235367	708	788	7	29	80	0.3625000
NODE_1763_length_1722_cov_13.235367	761	841	3	4	80	0.0500000
NODE_1763_length_1722_cov_13.235367	761	841	4	14	80	0.1750000
NODE_1763_length_1722_cov_13.235367	761	841	6	56	80	0.7000000
NODE_1763_length_1722_cov_13.235367	761	841	7	6	80	0.0750000
NODE_1763_length_1722_cov_13.235367	1319	1399	0	80	80	1.0000000
NODE_1763_length_1722_cov_13.235367	1372	1452	0	80	80	1.0000000
NODE_1765_length_1720_cov_27.328192	1248	1307	22	1	59	0.0169492
NODE_1765_length_1720_cov_27.328192	1248	1307	25	25	59	0.4237288
NODE_1765_length_1720_cov_27.328192	1248	1307	28	1	59	0.0169492
NODE_1765_length_1720_cov_27.328192	1248	1307	29	23	59	0.3898305
NODE_1765_length_1720_cov_27.328192	1248	1307	30	9	59	0.1525424
NODE_1765_length_1720_cov_27.328192	1280	1360	21	1	80	0.0125000
NODE_1765_length_1720_cov_27.328192	1280	1360	23	1	80	0.0125000
NODE_1765_length_1720_cov_27.328192	1280	1360	24	31	80	0.3875000
NODE_1765_length_1720_cov_27.328192	1280	1360	25	1	80	0.0125000
NODE_1765_length_1720_cov_27.328192	1280	1360	26	12	80	0.1500000
NODE_1765_length_1720_cov_27.328192	1280	1360	27	1	80	0.0125000
NODE_1765_length_1720_cov_27.328192	1280	1360	29	21	80	0.2625000
NODE_1765_length_1720_cov_27.328192	1280	1360	30	12	80	0.1500000
NODE_1766_length_1720_cov_4.129550	241	321	0	80	80	1.0000000
NODE_1766_length_1720_cov_4.129550	294	374	0	80	80	1.0000000
NODE_1768_length_1719_cov_9.878395	410	490	2	2	80	0.0250000
NODE_1768_length_1719_cov_9.878395	410	490	4	1	80	0.0125000
NODE_1768_length_1719_cov_9.878395	410	490	5	14	80	0.1750000
NODE_1768_length_1719_cov_9.878395	410	490	6	12	80	0.1500000
NODE_1768_length_1719_cov_9.878395	410	490	7	51	80	0.6375000
NODE_1768_length_1719_cov_9.878395	463	543	6	1	80	0.0125000
NODE_1768_length_1719_cov_9.878395	463	543	7	52	80	0.6500000
NODE_1768_length_1719_cov_9.878395	463	543	8	12	80	0.1500000
NODE_1768_length_1719_cov_9.878395	463	543	9	10	80	0.1250000
NODE_1768_length_1719_cov_9.878395	463	543	11	4	80	0.0500000
NODE_1768_length_1719_cov_9.878395	463	543	12	1	80	0.0125000
NODE_1768_length_1719_cov_9.878395	539	619	11	32	80	0.4000000
NODE_1768_length_1719_cov_9.878395	539	619	12	48	80	0.6000000
NODE_1768_length_1719_cov_9.878395	592	672	10	36	80	0.4500000
NODE_1768_length_1719_cov_9.878395	592	672	11	19	80	0.2375000
NODE_1768_length_1719_cov_9.878395	592	672	12	25	80	0.3125000
NODE_1772_length_1717_cov_5.159456	145	219	0	6	74	0.0810811
NODE_1772_length_1717_cov_5.159456	145	219	1	1	74	0.0135135
NODE_1772_length_1717_cov_5.159456	145	219	2	16	74	0.2162162
NODE_1772_length_1717_cov_5.159456	145	219	3	2	74	0.0270270
NODE_1772_length_1717_cov_5.159456	145	219	10	18	74	0.2432432
NODE_1772_length_1717_cov_5.159456	145	219	14	4	74	0.0540541
NODE_1772_length_1717_cov_5.159456	145	219	16	5	74	0.0675676
NODE_1772_length_1717_cov_5.159456	145	219	18	4	74	0.0540541
NODE_1772_length_1717_cov_5.159456	145	219	20	11	74	0.1486486
NODE_1772_length_1717_cov_5.159456	145	219	21	2	74	0.0270270
NODE_1772_length_1717_cov_5.159456	145	219	22	5	74	0.0675676
NODE_1772_length_1717_cov_5.159456	1450	1508	3	58	58	1.0000000
NODE_1772_length_1717_cov_5.159456	1503	1561	3	49	58	0.8448276
NODE_1772_length_1717_cov_5.159456	1503	1561	4	9	58	0.1551724
NODE_1778_length_1715_cov_12.607054	555	635	12	1	80	0.0125000
NODE_1778_length_1715_cov_12.607054	555	635	13	14	80	0.1750000
NODE_1778_length_1715_cov_12.607054	555	635	14	5	80	0.0625000
NODE_1778_length_1715_cov_12.607054	555	635	16	30	80	0.3750000
NODE_1778_length_1715_cov_12.607054	555	635	17	21	80	0.2625000
NODE_1778_length_1715_cov_12.607054	555	635	18	9	80	0.1125000
NODE_1778_length_1715_cov_12.607054	608	688	7	10	80	0.1250000
NODE_1778_length_1715_cov_12.607054	608	688	11	18	80	0.2250000
NODE_1778_length_1715_cov_12.607054	608	688	12	11	80	0.1375000
NODE_1778_length_1715_cov_12.607054	608	688	13	15	80	0.1875000
NODE_1778_length_1715_cov_12.607054	608	688	17	17	80	0.2125000
NODE_1778_length_1715_cov_12.607054	608	688	18	9	80	0.1125000
NODE_1778_length_1715_cov_12.607054	684	764	7	7	80	0.0875000
NODE_1778_length_1715_cov_12.607054	684	764	8	6	80	0.0750000
NODE_1778_length_1715_cov_12.607054	684	764	9	13	80	0.1625000
NODE_1778_length_1715_cov_12.607054	684	764	10	39	80	0.4875000
NODE_1778_length_1715_cov_12.607054	684	764	11	9	80	0.1125000
NODE_1778_length_1715_cov_12.607054	684	764	12	5	80	0.0625000
NODE_1778_length_1715_cov_12.607054	684	764	13	1	80	0.0125000
NODE_1778_length_1715_cov_12.607054	737	817	6	4	80	0.0500000
NODE_1778_length_1715_cov_12.607054	737	817	7	5	80	0.0625000
NODE_1778_length_1715_cov_12.607054	737	817	8	2	80	0.0250000
NODE_1778_length_1715_cov_12.607054	737	817	9	3	80	0.0375000
NODE_1778_length_1715_cov_12.607054	737	817	10	48	80	0.6000000
NODE_1778_length_1715_cov_12.607054	737	817	11	18	80	0.2250000
NODE_1788_length_1707_cov_16.909204	397	477	3	20	80	0.2500000
NODE_1788_length_1707_cov_16.909204	397	477	5	30	80	0.3750000
NODE_1788_length_1707_cov_16.909204	397	477	6	12	80	0.1500000
NODE_1788_length_1707_cov_16.909204	397	477	7	10	80	0.1250000
NODE_1788_length_1707_cov_16.909204	397	477	8	1	80	0.0125000
NODE_1788_length_1707_cov_16.909204	397	477	9	7	80	0.0875000
NODE_1788_length_1707_cov_16.909204	450	530	6	9	80	0.1125000
NODE_1788_length_1707_cov_16.909204	450	530	7	16	80	0.2000000
NODE_1788_length_1707_cov_16.909204	450	530	8	38	80	0.4750000
NODE_1788_length_1707_cov_16.909204	450	530	9	9	80	0.1125000
NODE_1788_length_1707_cov_16.909204	450	530	10	6	80	0.0750000
NODE_1788_length_1707_cov_16.909204	450	530	11	2	80	0.0250000
NODE_1788_length_1707_cov_16.909204	1151	1231	2	23	80	0.2875000
NODE_1788_length_1707_cov_16.909204	1151	1231	3	26	80	0.3250000
NODE_1788_length_1707_cov_16.909204	1151	1231	4	14	80	0.1750000
NODE_1788_length_1707_cov_16.909204	1151	1231	5	17	80	0.2125000
NODE_1788_length_1707_cov_16.909204	1204	1284	1	51	80	0.6375000
NODE_1788_length_1707_cov_16.909204	1204	1284	2	24	80	0.3000000
NODE_1788_length_1707_cov_16.909204	1204	1284	3	5	80	0.0625000
NODE_1792_length_1705_cov_19.645081	451	531	0	80	80	1.0000000
NODE_1792_length_1705_cov_19.645081	504	584	0	63	80	0.7875000
NODE_1792_length_1705_cov_19.645081	504	584	1	17	80	0.2125000
NODE_1792_length_1705_cov_19.645081	580	660	1	66	80	0.8250000
NODE_1792_length_1705_cov_19.645081	580	660	2	14	80	0.1750000
NODE_1792_length_1705_cov_19.645081	633	714	1	13	81	0.1604938
NODE_1792_length_1705_cov_19.645081	633	714	2	68	81	0.8395061
NODE_1792_length_1705_cov_19.645081	1315	1395	0	7	80	0.0875000
NODE_1792_length_1705_cov_19.645081	1315	1395	2	73	80	0.9125000
NODE_1792_length_1705_cov_19.645081	1368	1448	0	33	80	0.4125000
NODE_1792_length_1705_cov_19.645081	1368	1448	2	47	80	0.5875000
NODE_1796_length_1703_cov_26.016833	1201	1264	0	52	63	0.8253968
NODE_1796_length_1703_cov_26.016833	1201	1264	3	1	63	0.0158730
NODE_1796_length_1703_cov_26.016833	1201	1264	5	1	63	0.0158730
NODE_1796_length_1703_cov_26.016833	1201	1264	6	1	63	0.0158730
NODE_1796_length_1703_cov_26.016833	1201	1264	14	1	63	0.0158730
NODE_1796_length_1703_cov_26.016833	1201	1264	19	1	63	0.0158730
NODE_1796_length_1703_cov_26.016833	1201	1264	22	1	63	0.0158730
NODE_1796_length_1703_cov_26.016833	1201	1264	23	1	63	0.0158730
NODE_1796_length_1703_cov_26.016833	1201	1264	29	1	63	0.0158730
NODE_1796_length_1703_cov_26.016833	1201	1264	32	1	63	0.0158730
NODE_1796_length_1703_cov_26.016833	1201	1264	34	1	63	0.0158730
NODE_1796_length_1703_cov_26.016833	1201	1264	36	1	63	0.0158730
NODE_1796_length_1703_cov_26.016833	1207	1264	0	52	57	0.9122807
NODE_1796_length_1703_cov_26.016833	1207	1264	3	1	57	0.0175439
NODE_1796_length_1703_cov_26.016833	1207	1264	5	1	57	0.0175439
NODE_1796_length_1703_cov_26.016833	1207	1264	6	1	57	0.0175439
NODE_1796_length_1703_cov_26.016833	1207	1264	14	1	57	0.0175439
NODE_1796_length_1703_cov_26.016833	1207	1264	19	1	57	0.0175439
NODE_1796_length_1703_cov_26.016833	1207	1264	0	52	57	0.9122807
NODE_1796_length_1703_cov_26.016833	1207	1264	3	1	57	0.0175439
NODE_1796_length_1703_cov_26.016833	1207	1264	5	1	57	0.0175439
NODE_1796_length_1703_cov_26.016833	1207	1264	6	1	57	0.0175439
NODE_1796_length_1703_cov_26.016833	1207	1264	14	1	57	0.0175439
NODE_1796_length_1703_cov_26.016833	1207	1264	19	1	57	0.0175439
NODE_1799_length_1701_cov_15.969413	1490	1565	8	8	75	0.1066667
NODE_1799_length_1701_cov_15.969413	1490	1565	9	4	75	0.0533333
NODE_1799_length_1701_cov_15.969413	1490	1565	11	1	75	0.0133333
NODE_1799_length_1701_cov_15.969413	1490	1565	12	4	75	0.0533333
NODE_1799_length_1701_cov_15.969413	1490	1565	14	5	75	0.0666667
NODE_1799_length_1701_cov_15.969413	1490	1565	15	2	75	0.0266667
NODE_1799_length_1701_cov_15.969413	1490	1565	16	1	75	0.0133333
NODE_1799_length_1701_cov_15.969413	1490	1565	17	1	75	0.0133333
NODE_1799_length_1701_cov_15.969413	1490	1565	20	2	75	0.0266667
NODE_1799_length_1701_cov_15.969413	1490	1565	21	2	75	0.0266667
NODE_1799_length_1701_cov_15.969413	1490	1565	24	4	75	0.0533333
NODE_1799_length_1701_cov_15.969413	1490	1565	25	2	75	0.0266667
NODE_1799_length_1701_cov_15.969413	1490	1565	26	4	75	0.0533333
NODE_1799_length_1701_cov_15.969413	1490	1565	28	3	75	0.0400000
NODE_1799_length_1701_cov_15.969413	1490	1565	31	1	75	0.0133333
NODE_1799_length_1701_cov_15.969413	1490	1565	33	1	75	0.0133333
NODE_1799_length_1701_cov_15.969413	1490	1565	34	12	75	0.1600000
NODE_1799_length_1701_cov_15.969413	1490	1565	35	3	75	0.0400000
NODE_1799_length_1701_cov_15.969413	1490	1565	36	2	75	0.0266667
NODE_1799_length_1701_cov_15.969413	1490	1565	37	6	75	0.0800000
NODE_1799_length_1701_cov_15.969413	1490	1565	38	7	75	0.0933333
NODE_1799_length_1701_cov_15.969413	1538	1603	34	9	65	0.1384615
NODE_1799_length_1701_cov_15.969413	1538	1603	35	3	65	0.0461538
NODE_1799_length_1701_cov_15.969413	1538	1603	36	2	65	0.0307692
NODE_1799_length_1701_cov_15.969413	1538	1603	37	6	65	0.0923077
NODE_1799_length_1701_cov_15.969413	1538	1603	38	39	65	0.6000000
NODE_1799_length_1701_cov_15.969413	1538	1603	40	6	65	0.0923077
NODE_1800_length_1701_cov_13.549313	607	687	1	5	80	0.0625000
NODE_1800_length_1701_cov_13.549313	607	687	2	3	80	0.0375000
NODE_1800_length_1701_cov_13.549313	607	687	3	63	80	0.7875000
NODE_1800_length_1701_cov_13.549313	607	687	4	9	80	0.1125000
NODE_1800_length_1701_cov_13.549313	660	740	2	8	80	0.1000000
NODE_1800_length_1701_cov_13.549313	660	740	3	15	80	0.1875000
NODE_1800_length_1701_cov_13.549313	660	740	4	57	80	0.7125000
NODE_1805_length_1700_cov_20.003123	1168	1197	57	1	29	0.0344828
NODE_1805_length_1700_cov_20.003123	1168	1197	58	5	29	0.1724138
NODE_1805_length_1700_cov_20.003123	1168	1197	59	6	29	0.2068966
NODE_1805_length_1700_cov_20.003123	1168	1197	60	6	29	0.2068966
NODE_1805_length_1700_cov_20.003123	1168	1197	61	7	29	0.2413793
NODE_1805_length_1700_cov_20.003123	1168	1197	64	4	29	0.1379310
NODE_1805_length_1700_cov_20.003123	1184	1263	44	1	79	0.0126582
NODE_1805_length_1700_cov_20.003123	1184	1263	45	6	79	0.0759494
NODE_1805_length_1700_cov_20.003123	1184	1263	46	4	79	0.0506329
NODE_1805_length_1700_cov_20.003123	1184	1263	47	12	79	0.1518987
NODE_1805_length_1700_cov_20.003123	1184	1263	48	4	79	0.0506329
NODE_1805_length_1700_cov_20.003123	1184	1263	49	1	79	0.0126582
NODE_1805_length_1700_cov_20.003123	1184	1263	50	8	79	0.1012658
NODE_1805_length_1700_cov_20.003123	1184	1263	51	6	79	0.0759494
NODE_1805_length_1700_cov_20.003123	1184	1263	52	1	79	0.0126582
NODE_1805_length_1700_cov_20.003123	1184	1263	53	1	79	0.0126582
NODE_1805_length_1700_cov_20.003123	1184	1263	54	2	79	0.0253165
NODE_1805_length_1700_cov_20.003123	1184	1263	55	7	79	0.0886076
NODE_1805_length_1700_cov_20.003123	1184	1263	56	4	79	0.0506329
NODE_1805_length_1700_cov_20.003123	1184	1263	57	6	79	0.0759494
NODE_1805_length_1700_cov_20.003123	1184	1263	58	7	79	0.0886076
NODE_1805_length_1700_cov_20.003123	1184	1263	59	3	79	0.0379747
NODE_1805_length_1700_cov_20.003123	1184	1263	60	3	79	0.0379747
NODE_1805_length_1700_cov_20.003123	1184	1263	61	3	79	0.0379747
NODE_1810_length_1698_cov_19.175735	1001	1081	7	23	80	0.2875000
NODE_1810_length_1698_cov_19.175735	1001	1081	8	16	80	0.2000000
NODE_1810_length_1698_cov_19.175735	1001	1081	9	6	80	0.0750000
NODE_1810_length_1698_cov_19.175735	1001	1081	10	32	80	0.4000000
NODE_1810_length_1698_cov_19.175735	1001	1081	12	3	80	0.0375000
NODE_1810_length_1698_cov_19.175735	1054	1134	9	5	80	0.0625000
NODE_1810_length_1698_cov_19.175735	1054	1134	10	60	80	0.7500000
NODE_1810_length_1698_cov_19.175735	1054	1134	11	5	80	0.0625000
NODE_1810_length_1698_cov_19.175735	1054	1134	12	10	80	0.1250000
NODE_1814_length_1696_cov_11.494678	590	670	0	11	80	0.1375000
NODE_1814_length_1696_cov_11.494678	590	670	2	19	80	0.2375000
NODE_1814_length_1696_cov_11.494678	590	670	6	1	80	0.0125000
NODE_1814_length_1696_cov_11.494678	590	670	7	10	80	0.1250000
NODE_1814_length_1696_cov_11.494678	590	670	8	4	80	0.0500000
NODE_1814_length_1696_cov_11.494678	590	670	10	35	80	0.4375000
NODE_1814_length_1696_cov_11.494678	643	723	2	4	80	0.0500000
NODE_1814_length_1696_cov_11.494678	643	723	4	13	80	0.1625000
NODE_1814_length_1696_cov_11.494678	643	723	6	3	80	0.0375000
NODE_1814_length_1696_cov_11.494678	643	723	10	60	80	0.7500000
NODE_1815_length_1696_cov_6.620539	369	449	5	6	80	0.0750000
NODE_1815_length_1696_cov_6.620539	369	449	6	18	80	0.2250000
NODE_1815_length_1696_cov_6.620539	369	449	7	37	80	0.4625000
NODE_1815_length_1696_cov_6.620539	369	449	8	19	80	0.2375000
NODE_1815_length_1696_cov_6.620539	422	502	5	46	80	0.5750000
NODE_1815_length_1696_cov_6.620539	422	502	6	8	80	0.1000000
NODE_1815_length_1696_cov_6.620539	422	502	7	25	80	0.3125000
NODE_1815_length_1696_cov_6.620539	422	502	8	1	80	0.0125000
NODE_1816_length_1695_cov_27.783208	399	479	0	4	80	0.0500000
NODE_1816_length_1695_cov_27.783208	399	479	1	33	80	0.4125000
NODE_1816_length_1695_cov_27.783208	399	479	2	43	80	0.5375000
NODE_1816_length_1695_cov_27.783208	452	532	0	57	80	0.7125000
NODE_1816_length_1695_cov_27.783208	452	532	1	23	80	0.2875000
NODE_1817_length_1695_cov_12.084586	1047	1127	7	5	80	0.0625000
NODE_1817_length_1695_cov_12.084586	1047	1127	8	21	80	0.2625000
NODE_1817_length_1695_cov_12.084586	1047	1127	10	9	80	0.1125000
NODE_1817_length_1695_cov_12.084586	1047	1127	11	11	80	0.1375000
NODE_1817_length_1695_cov_12.084586	1047	1127	12	34	80	0.4250000
NODE_1817_length_1695_cov_12.084586	1100	1180	6	50	80	0.6250000
NODE_1817_length_1695_cov_12.084586	1100	1180	8	16	80	0.2000000
NODE_1817_length_1695_cov_12.084586	1100	1180	12	14	80	0.1750000
NODE_1825_length_1692_cov_4.557439	727	807	4	30	80	0.3750000
NODE_1825_length_1692_cov_4.557439	727	807	6	50	80	0.6250000
NODE_1825_length_1692_cov_4.557439	780	860	2	29	80	0.3625000
NODE_1825_length_1692_cov_4.557439	780	860	4	15	80	0.1875000
NODE_1825_length_1692_cov_4.557439	780	860	5	6	80	0.0750000
NODE_1825_length_1692_cov_4.557439	780	860	6	30	80	0.3750000
NODE_1830_length_1689_cov_5.844025	1210	1285	1	33	75	0.4400000
NODE_1830_length_1689_cov_5.844025	1210	1285	2	22	75	0.2933333
NODE_1830_length_1689_cov_5.844025	1210	1285	3	20	75	0.2666667
NODE_1830_length_1689_cov_5.844025	1260	1338	2	75	78	0.9615384
NODE_1830_length_1689_cov_5.844025	1260	1338	3	3	78	0.0384615
NODE_1837_length_1682_cov_14.416930	1183	1263	5	18	80	0.2250000
NODE_1837_length_1682_cov_14.416930	1183	1263	6	54	80	0.6750000
NODE_1837_length_1682_cov_14.416930	1183	1263	7	8	80	0.1000000
NODE_1837_length_1682_cov_14.416930	1236	1315	2	9	79	0.1139240
NODE_1837_length_1682_cov_14.416930	1236	1315	3	9	79	0.1139240
NODE_1837_length_1682_cov_14.416930	1236	1315	4	7	79	0.0886076
NODE_1837_length_1682_cov_14.416930	1236	1315	5	6	79	0.0759494
NODE_1837_length_1682_cov_14.416930	1236	1315	6	33	79	0.4177215
NODE_1837_length_1682_cov_14.416930	1236	1315	7	15	79	0.1898734
NODE_1843_length_1678_cov_23.965168	636	716	5	8	80	0.1000000
NODE_1843_length_1678_cov_23.965168	636	716	6	72	80	0.9000000
NODE_1843_length_1678_cov_23.965168	689	769	1	13	80	0.1625000
NODE_1843_length_1678_cov_23.965168	689	769	3	16	80	0.2000000
NODE_1843_length_1678_cov_23.965168	689	769	4	21	80	0.2625000
NODE_1843_length_1678_cov_23.965168	689	769	5	11	80	0.1375000
NODE_1843_length_1678_cov_23.965168	689	769	6	19	80	0.2375000
NODE_1843_length_1678_cov_23.965168	1145	1225	0	23	80	0.2875000
NODE_1843_length_1678_cov_23.965168	1145	1225	2	16	80	0.2000000
NODE_1843_length_1678_cov_23.965168	1145	1225	4	7	80	0.0875000
NODE_1843_length_1678_cov_23.965168	1145	1225	5	34	80	0.4250000
NODE_1843_length_1678_cov_23.965168	1198	1278	5	80	80	1.0000000
NODE_1846_length_1677_cov_3.578580	407	487	0	9	80	0.1125000
NODE_1846_length_1677_cov_3.578580	407	487	2	71	80	0.8875000
NODE_1846_length_1677_cov_3.578580	460	530	0	29	70	0.4142857
NODE_1846_length_1677_cov_3.578580	460	530	2	41	70	0.5857143
NODE_1846_length_1677_cov_3.578580	666	724	0	41	58	0.7068965
NODE_1846_length_1677_cov_3.578580	666	724	2	17	58	0.2931035
NODE_1856_length_1670_cov_29.264163	741	821	2	80	80	1.0000000
NODE_1856_length_1670_cov_29.264163	794	874	0	29	80	0.3625000
NODE_1856_length_1670_cov_29.264163	794	874	2	51	80	0.6375000
NODE_1857_length_1669_cov_5.913376	246	326	0	16	80	0.2000000
NODE_1857_length_1669_cov_5.913376	246	326	1	16	80	0.2000000
NODE_1857_length_1669_cov_5.913376	246	326	2	48	80	0.6000000
NODE_1857_length_1669_cov_5.913376	299	379	2	80	80	1.0000000
NODE_1860_length_1668_cov_18.372212	1100	1180	1	40	80	0.5000000
NODE_1860_length_1668_cov_18.372212	1100	1180	2	40	80	0.5000000
NODE_1860_length_1668_cov_18.372212	1153	1233	1	66	80	0.8250000
NODE_1860_length_1668_cov_18.372212	1153	1233	2	14	80	0.1750000
NODE_1861_length_1667_cov_15.651786	902	982	7	5	80	0.0625000
NODE_1861_length_1667_cov_15.651786	902	982	9	21	80	0.2625000
NODE_1861_length_1667_cov_15.651786	902	982	10	3	80	0.0375000
NODE_1861_length_1667_cov_15.651786	902	982	11	27	80	0.3375000
NODE_1861_length_1667_cov_15.651786	902	982	12	15	80	0.1875000
NODE_1861_length_1667_cov_15.651786	902	982	13	9	80	0.1125000
NODE_1861_length_1667_cov_15.651786	955	1035	7	1	80	0.0125000
NODE_1861_length_1667_cov_15.651786	955	1035	8	4	80	0.0500000
NODE_1861_length_1667_cov_15.651786	955	1035	9	28	80	0.3500000
NODE_1861_length_1667_cov_15.651786	955	1035	10	5	80	0.0625000
NODE_1861_length_1667_cov_15.651786	955	1035	11	4	80	0.0500000
NODE_1861_length_1667_cov_15.651786	955	1035	12	16	80	0.2000000
NODE_1861_length_1667_cov_15.651786	955	1035	13	22	80	0.2750000
NODE_1862_length_1667_cov_3.661352	649	679	0	26	30	0.8666667
NODE_1862_length_1667_cov_3.661352	649	679	2	4	30	0.1333333
NODE_1865_length_1666_cov_4.601149	1541	1623	0	82	82	1.0000000
NODE_1865_length_1666_cov_4.601149	1553	1613	0	60	60	1.0000000
NODE_1865_length_1666_cov_4.601149	1553	1613	0	60	60	1.0000000
NODE_1865_length_1666_cov_4.601149	1557	1623	0	66	66	1.0000000
NODE_1865_length_1666_cov_4.601149	1596	1666	0	70	70	1.0000000
NODE_1865_length_1666_cov_4.601149	1596	1666	0	70	70	1.0000000
NODE_1865_length_1666_cov_4.601149	1596	1666	0	70	70	1.0000000
NODE_1872_length_1662_cov_16.638516	538	618	10	5	80	0.0625000
NODE_1872_length_1662_cov_16.638516	538	618	11	19	80	0.2375000
NODE_1872_length_1662_cov_16.638516	538	618	12	45	80	0.5625000
NODE_1872_length_1662_cov_16.638516	538	618	13	11	80	0.1375000
NODE_1872_length_1662_cov_16.638516	591	671	8	7	80	0.0875000
NODE_1872_length_1662_cov_16.638516	591	671	9	2	80	0.0250000
NODE_1872_length_1662_cov_16.638516	591	671	10	32	80	0.4000000
NODE_1872_length_1662_cov_16.638516	591	671	11	24	80	0.3000000
NODE_1872_length_1662_cov_16.638516	591	671	12	15	80	0.1875000
NODE_1872_length_1662_cov_16.638516	667	747	9	7	80	0.0875000
NODE_1872_length_1662_cov_16.638516	667	747	10	10	80	0.1250000
NODE_1872_length_1662_cov_16.638516	667	747	11	20	80	0.2500000
NODE_1872_length_1662_cov_16.638516	667	747	12	35	80	0.4375000
NODE_1872_length_1662_cov_16.638516	667	747	13	8	80	0.1000000
NODE_1872_length_1662_cov_16.638516	720	800	8	1	80	0.0125000
NODE_1872_length_1662_cov_16.638516	720	800	9	10	80	0.1250000
NODE_1872_length_1662_cov_16.638516	720	800	11	24	80	0.3000000
NODE_1872_length_1662_cov_16.638516	720	800	12	17	80	0.2125000
NODE_1872_length_1662_cov_16.638516	720	800	13	28	80	0.3500000
NODE_1876_length_1660_cov_28.297886	415	495	8	3	80	0.0375000
NODE_1876_length_1660_cov_28.297886	415	495	9	4	80	0.0500000
NODE_1876_length_1660_cov_28.297886	415	495	10	3	80	0.0375000
NODE_1876_length_1660_cov_28.297886	415	495	11	4	80	0.0500000
NODE_1876_length_1660_cov_28.297886	415	495	12	6	80	0.0750000
NODE_1876_length_1660_cov_28.297886	415	495	13	12	80	0.1500000
NODE_1876_length_1660_cov_28.297886	415	495	14	13	80	0.1625000
NODE_1876_length_1660_cov_28.297886	415	495	16	8	80	0.1000000
NODE_1876_length_1660_cov_28.297886	415	495	17	13	80	0.1625000
NODE_1876_length_1660_cov_28.297886	415	495	18	14	80	0.1750000
NODE_1876_length_1660_cov_28.297886	468	548	10	2	80	0.0250000
NODE_1876_length_1660_cov_28.297886	468	548	11	13	80	0.1625000
NODE_1876_length_1660_cov_28.297886	468	548	12	2	80	0.0250000
NODE_1876_length_1660_cov_28.297886	468	548	14	11	80	0.1375000
NODE_1876_length_1660_cov_28.297886	468	548	15	23	80	0.2875000
NODE_1876_length_1660_cov_28.297886	468	548	17	15	80	0.1875000
NODE_1876_length_1660_cov_28.297886	468	548	18	14	80	0.1750000
NODE_1886_length_1654_cov_17.245016	631	711	6	13	80	0.1625000
NODE_1886_length_1654_cov_17.245016	631	711	8	2	80	0.0250000
NODE_1886_length_1654_cov_17.245016	631	711	9	13	80	0.1625000
NODE_1886_length_1654_cov_17.245016	631	711	10	2	80	0.0250000
NODE_1886_length_1654_cov_17.245016	631	711	11	46	80	0.5750000
NODE_1886_length_1654_cov_17.245016	631	711	12	4	80	0.0500000
NODE_1886_length_1654_cov_17.245016	684	764	4	2	80	0.0250000
NODE_1886_length_1654_cov_17.245016	684	764	6	1	80	0.0125000
NODE_1886_length_1654_cov_17.245016	684	764	8	18	80	0.2250000
NODE_1886_length_1654_cov_17.245016	684	764	9	4	80	0.0500000
NODE_1886_length_1654_cov_17.245016	684	764	10	12	80	0.1500000
NODE_1886_length_1654_cov_17.245016	684	764	11	43	80	0.5375000
NODE_1888_length_1653_cov_34.827542	0	41	0	41	41	1.0000000
NODE_1888_length_1653_cov_34.827542	14	44	0	30	30	1.0000000
NODE_1888_length_1653_cov_34.827542	1081	1161	1	4	80	0.0500000
NODE_1888_length_1653_cov_34.827542	1081	1161	2	1	80	0.0125000
NODE_1888_length_1653_cov_34.827542	1081	1161	3	22	80	0.2750000
NODE_1888_length_1653_cov_34.827542	1081	1161	4	2	80	0.0250000
NODE_1888_length_1653_cov_34.827542	1081	1161	5	9	80	0.1125000
NODE_1888_length_1653_cov_34.827542	1081	1161	8	7	80	0.0875000
NODE_1888_length_1653_cov_34.827542	1081	1161	9	11	80	0.1375000
NODE_1888_length_1653_cov_34.827542	1081	1161	10	10	80	0.1250000
NODE_1888_length_1653_cov_34.827542	1081	1161	11	5	80	0.0625000
NODE_1888_length_1653_cov_34.827542	1081	1161	12	6	80	0.0750000
NODE_1888_length_1653_cov_34.827542	1081	1161	15	3	80	0.0375000
NODE_1888_length_1653_cov_34.827542	1134	1214	9	3	80	0.0375000
NODE_1888_length_1653_cov_34.827542	1134	1214	10	10	80	0.1250000
NODE_1888_length_1653_cov_34.827542	1134	1214	11	5	80	0.0625000
NODE_1888_length_1653_cov_34.827542	1134	1214	12	6	80	0.0750000
NODE_1888_length_1653_cov_34.827542	1134	1214	15	13	80	0.1625000
NODE_1888_length_1653_cov_34.827542	1134	1214	17	4	80	0.0500000
NODE_1888_length_1653_cov_34.827542	1134	1214	19	6	80	0.0750000
NODE_1888_length_1653_cov_34.827542	1134	1214	20	22	80	0.2750000
NODE_1888_length_1653_cov_34.827542	1134	1214	21	4	80	0.0500000
NODE_1888_length_1653_cov_34.827542	1134	1214	23	5	80	0.0625000
NODE_1888_length_1653_cov_34.827542	1134	1214	25	2	80	0.0250000
NODE_1888_length_1653_cov_34.827542	1210	1290	11	1	80	0.0125000
NODE_1888_length_1653_cov_34.827542	1210	1290	12	6	80	0.0750000
NODE_1888_length_1653_cov_34.827542	1210	1290	14	4	80	0.0500000
NODE_1888_length_1653_cov_34.827542	1210	1290	15	10	80	0.1250000
NODE_1888_length_1653_cov_34.827542	1210	1290	16	7	80	0.0875000
NODE_1888_length_1653_cov_34.827542	1210	1290	17	4	80	0.0500000
NODE_1888_length_1653_cov_34.827542	1210	1290	18	13	80	0.1625000
NODE_1888_length_1653_cov_34.827542	1210	1290	20	9	80	0.1125000
NODE_1888_length_1653_cov_34.827542	1210	1290	21	1	80	0.0125000
NODE_1888_length_1653_cov_34.827542	1210	1290	22	8	80	0.1000000
NODE_1888_length_1653_cov_34.827542	1210	1290	23	4	80	0.0500000
NODE_1888_length_1653_cov_34.827542	1210	1290	25	13	80	0.1625000
NODE_1888_length_1653_cov_34.827542	1263	1339	5	8	76	0.1052632
NODE_1888_length_1653_cov_34.827542	1263	1339	6	8	76	0.1052632
NODE_1888_length_1653_cov_34.827542	1263	1339	7	2	76	0.0263158
NODE_1888_length_1653_cov_34.827542	1263	1339	8	13	76	0.1710526
NODE_1888_length_1653_cov_34.827542	1263	1339	9	2	76	0.0263158
NODE_1888_length_1653_cov_34.827542	1263	1339	10	6	76	0.0789474
NODE_1888_length_1653_cov_34.827542	1263	1339	11	11	76	0.1447368
NODE_1888_length_1653_cov_34.827542	1263	1339	12	6	76	0.0789474
NODE_1888_length_1653_cov_34.827542	1263	1339	14	4	76	0.0526316
NODE_1888_length_1653_cov_34.827542	1263	1339	15	10	76	0.1315790
NODE_1888_length_1653_cov_34.827542	1263	1339	16	6	76	0.0789474
NODE_1892_length_1652_cov_23.939472	1352	1432	1	66	80	0.8250000
NODE_1892_length_1652_cov_23.939472	1352	1432	2	14	80	0.1750000
NODE_1892_length_1652_cov_23.939472	1405	1485	0	47	80	0.5875000
NODE_1892_length_1652_cov_23.939472	1405	1485	1	33	80	0.4125000
NODE_1894_length_1651_cov_3.916881	1552	1617	0	65	65	1.0000000
NODE_1899_length_1649_cov_7.480000	774	854	2	80	80	1.0000000
NODE_1899_length_1649_cov_7.480000	827	907	0	14	80	0.1750000
NODE_1899_length_1649_cov_7.480000	827	907	1	15	80	0.1875000
NODE_1899_length_1649_cov_7.480000	827	907	2	51	80	0.6375000
NODE_1903_length_1647_cov_3.534238	1012	1075	3	10	63	0.1587302
NODE_1903_length_1647_cov_3.534238	1012	1075	4	18	63	0.2857143
NODE_1903_length_1647_cov_3.534238	1012	1075	5	11	63	0.1746032
NODE_1903_length_1647_cov_3.534238	1012	1075	6	9	63	0.1428571
NODE_1903_length_1647_cov_3.534238	1012	1075	7	3	63	0.0476190
NODE_1903_length_1647_cov_3.534238	1012	1075	8	12	63	0.1904762
NODE_1906_length_1645_cov_16.040103	155	235	5	6	80	0.0750000
NODE_1906_length_1645_cov_16.040103	155	235	6	26	80	0.3250000
NODE_1906_length_1645_cov_16.040103	155	235	7	7	80	0.0875000
NODE_1906_length_1645_cov_16.040103	155	235	8	41	80	0.5125000
NODE_1906_length_1645_cov_16.040103	208	288	3	17	80	0.2125000
NODE_1906_length_1645_cov_16.040103	208	288	4	31	80	0.3875000
NODE_1906_length_1645_cov_16.040103	208	288	5	11	80	0.1375000
NODE_1906_length_1645_cov_16.040103	208	288	6	20	80	0.2500000
NODE_1906_length_1645_cov_16.040103	208	288	8	1	80	0.0125000
NODE_1906_length_1645_cov_16.040103	1090	1170	3	10	80	0.1250000
NODE_1906_length_1645_cov_16.040103	1090	1170	4	34	80	0.4250000
NODE_1906_length_1645_cov_16.040103	1090	1170	5	36	80	0.4500000
NODE_1906_length_1645_cov_16.040103	1143	1222	0	9	79	0.1139240
NODE_1906_length_1645_cov_16.040103	1143	1222	1	11	79	0.1392405
NODE_1906_length_1645_cov_16.040103	1143	1222	2	6	79	0.0759494
NODE_1906_length_1645_cov_16.040103	1143	1222	3	36	79	0.4556962
NODE_1906_length_1645_cov_16.040103	1143	1222	4	17	79	0.2151899
NODE_1908_length_1644_cov_2.902913	1160	1240	1	5	80	0.0625000
NODE_1908_length_1644_cov_2.902913	1160	1240	2	32	80	0.4000000
NODE_1908_length_1644_cov_2.902913	1160	1240	3	19	80	0.2375000
NODE_1908_length_1644_cov_2.902913	1160	1240	6	23	80	0.2875000
NODE_1908_length_1644_cov_2.902913	1160	1240	7	1	80	0.0125000
NODE_1917_length_1641_cov_34.032425	487	567	0	10	80	0.1250000
NODE_1917_length_1641_cov_34.032425	487	567	1	70	80	0.8750000
NODE_1917_length_1641_cov_34.032425	540	620	1	39	80	0.4875000
NODE_1917_length_1641_cov_34.032425	540	620	2	15	80	0.1875000
NODE_1917_length_1641_cov_34.032425	540	620	3	26	80	0.3250000
NODE_1917_length_1641_cov_34.032425	616	696	2	29	80	0.3625000
NODE_1917_length_1641_cov_34.032425	616	696	3	31	80	0.3875000
NODE_1917_length_1641_cov_34.032425	616	696	4	20	80	0.2500000
NODE_1917_length_1641_cov_34.032425	669	749	2	12	80	0.1500000
NODE_1917_length_1641_cov_34.032425	669	749	3	15	80	0.1875000
NODE_1917_length_1641_cov_34.032425	669	749	4	53	80	0.6625000
NODE_1917_length_1641_cov_34.032425	1168	1248	0	2	80	0.0250000
NODE_1917_length_1641_cov_34.032425	1168	1248	2	78	80	0.9750000
NODE_1917_length_1641_cov_34.032425	1219	1301	0	55	82	0.6707317
NODE_1917_length_1641_cov_34.032425	1219	1301	2	27	82	0.3292683
NODE_1918_length_1641_cov_7.042802	339	390	0	51	51	1.0000000
NODE_1922_length_1640_cov_33.097339	943	1023	1	4	80	0.0500000
NODE_1922_length_1640_cov_33.097339	943	1023	2	27	80	0.3375000
NODE_1922_length_1640_cov_33.097339	943	1023	3	4	80	0.0500000
NODE_1922_length_1640_cov_33.097339	943	1023	4	38	80	0.4750000
NODE_1922_length_1640_cov_33.097339	943	1023	5	7	80	0.0875000
NODE_1922_length_1640_cov_33.097339	996	1076	4	20	80	0.2500000
NODE_1922_length_1640_cov_33.097339	996	1076	5	26	80	0.3250000
NODE_1922_length_1640_cov_33.097339	996	1076	6	22	80	0.2750000
NODE_1922_length_1640_cov_33.097339	996	1076	7	12	80	0.1500000
NODE_1922_length_1640_cov_33.097339	1072	1152	4	24	80	0.3000000
NODE_1922_length_1640_cov_33.097339	1072	1152	5	23	80	0.2875000
NODE_1922_length_1640_cov_33.097339	1072	1152	6	18	80	0.2250000
NODE_1922_length_1640_cov_33.097339	1072	1152	7	15	80	0.1875000
NODE_1922_length_1640_cov_33.097339	1125	1206	2	14	81	0.1728395
NODE_1922_length_1640_cov_33.097339	1125	1206	3	26	81	0.3209876
NODE_1922_length_1640_cov_33.097339	1125	1206	4	38	81	0.4691358
NODE_1922_length_1640_cov_33.097339	1125	1206	5	3	81	0.0370370
NODE_1923_length_1640_cov_18.519143	471	551	0	80	80	1.0000000
NODE_1923_length_1640_cov_18.519143	524	604	0	80	80	1.0000000
NODE_1925_length_1639_cov_6.585714	975	1056	0	81	81	1.0000000
NODE_1925_length_1639_cov_6.585714	1028	1109	0	81	81	1.0000000
NODE_1926_length_1639_cov_2.163636	1260	1334	0	74	74	1.0000000
NODE_1926_length_1639_cov_2.163636	1312	1387	0	43	75	0.5733333
NODE_1926_length_1639_cov_2.163636	1312	1387	1	28	75	0.3733333
NODE_1926_length_1639_cov_2.163636	1312	1387	2	4	75	0.0533333
NODE_1928_length_1638_cov_18.598441	443	523	2	9	80	0.1125000
NODE_1928_length_1638_cov_18.598441	443	523	3	52	80	0.6500000
NODE_1928_length_1638_cov_18.598441	443	523	4	19	80	0.2375000
NODE_1928_length_1638_cov_18.598441	496	576	1	18	80	0.2250000
NODE_1928_length_1638_cov_18.598441	496	576	2	37	80	0.4625000
NODE_1928_length_1638_cov_18.598441	496	576	3	25	80	0.3125000
NODE_1928_length_1638_cov_18.598441	1157	1237	1	23	80	0.2875000
NODE_1928_length_1638_cov_18.598441	1157	1237	3	57	80	0.7125000
NODE_1928_length_1638_cov_18.598441	1210	1290	3	80	80	1.0000000
NODE_1932_length_1637_cov_12.048765	410	490	8	26	80	0.3250000
NODE_1932_length_1637_cov_12.048765	410	490	10	21	80	0.2625000
NODE_1932_length_1637_cov_12.048765	410	490	11	19	80	0.2375000
NODE_1932_length_1637_cov_12.048765	410	490	12	14	80	0.1750000
NODE_1932_length_1637_cov_12.048765	463	543	6	3	80	0.0375000
NODE_1932_length_1637_cov_12.048765	463	543	7	7	80	0.0875000
NODE_1932_length_1637_cov_12.048765	463	543	8	15	80	0.1875000
NODE_1932_length_1637_cov_12.048765	463	543	10	19	80	0.2375000
NODE_1932_length_1637_cov_12.048765	463	543	11	30	80	0.3750000
NODE_1932_length_1637_cov_12.048765	463	543	12	6	80	0.0750000
NODE_1932_length_1637_cov_12.048765	1081	1161	2	9	80	0.1125000
NODE_1932_length_1637_cov_12.048765	1081	1161	3	5	80	0.0625000
NODE_1932_length_1637_cov_12.048765	1081	1161	4	66	80	0.8250000
NODE_1932_length_1637_cov_12.048765	1134	1214	2	29	80	0.3625000
NODE_1932_length_1637_cov_12.048765	1134	1214	3	5	80	0.0625000
NODE_1932_length_1637_cov_12.048765	1134	1214	4	46	80	0.5750000
NODE_1934_length_1635_cov_21.022786	958	1038	9	1	80	0.0125000
NODE_1934_length_1635_cov_21.022786	958	1038	11	11	80	0.1375000
NODE_1934_length_1635_cov_21.022786	958	1038	13	23	80	0.2875000
NODE_1934_length_1635_cov_21.022786	958	1038	14	28	80	0.3500000
NODE_1934_length_1635_cov_21.022786	958	1038	15	17	80	0.2125000
NODE_1934_length_1635_cov_21.022786	1011	1091	5	5	80	0.0625000
NODE_1934_length_1635_cov_21.022786	1011	1091	7	30	80	0.3750000
NODE_1934_length_1635_cov_21.022786	1011	1091	8	15	80	0.1875000
NODE_1934_length_1635_cov_21.022786	1011	1091	10	1	80	0.0125000
NODE_1934_length_1635_cov_21.022786	1011	1091	11	12	80	0.1500000
NODE_1934_length_1635_cov_21.022786	1011	1091	13	17	80	0.2125000
NODE_1934_length_1635_cov_21.022786	1087	1167	1	44	80	0.5500000
NODE_1934_length_1635_cov_21.022786	1087	1167	2	13	80	0.1625000
NODE_1934_length_1635_cov_21.022786	1087	1167	3	6	80	0.0750000
NODE_1934_length_1635_cov_21.022786	1087	1167	4	8	80	0.1000000
NODE_1934_length_1635_cov_21.022786	1087	1167	5	9	80	0.1125000
NODE_1934_length_1635_cov_21.022786	1140	1220	0	9	80	0.1125000
NODE_1934_length_1635_cov_21.022786	1140	1220	1	71	80	0.8875000
NODE_1936_length_1633_cov_16.743807	1067	1147	4	20	80	0.2500000
NODE_1936_length_1633_cov_16.743807	1067	1147	5	32	80	0.4000000
NODE_1936_length_1633_cov_16.743807	1067	1147	6	28	80	0.3500000
NODE_1936_length_1633_cov_16.743807	1120	1200	3	31	80	0.3875000
NODE_1936_length_1633_cov_16.743807	1120	1200	4	5	80	0.0625000
NODE_1936_length_1633_cov_16.743807	1120	1200	5	35	80	0.4375000
NODE_1936_length_1633_cov_16.743807	1120	1200	6	9	80	0.1125000
NODE_1937_length_1633_cov_14.271838	977	1057	0	76	80	0.9500000
NODE_1937_length_1633_cov_14.271838	977	1057	2	2	80	0.0250000
NODE_1937_length_1633_cov_14.271838	977	1057	3	2	80	0.0250000
NODE_1937_length_1633_cov_14.271838	1030	1110	0	23	80	0.2875000
NODE_1937_length_1633_cov_14.271838	1030	1110	2	2	80	0.0250000
NODE_1937_length_1633_cov_14.271838	1030	1110	3	4	80	0.0500000
NODE_1937_length_1633_cov_14.271838	1030	1110	4	3	80	0.0375000
NODE_1937_length_1633_cov_14.271838	1030	1110	5	4	80	0.0500000
NODE_1937_length_1633_cov_14.271838	1030	1110	6	7	80	0.0875000
NODE_1937_length_1633_cov_14.271838	1030	1110	7	37	80	0.4625000
NODE_1937_length_1633_cov_14.271838	1106	1186	7	80	80	1.0000000
NODE_1937_length_1633_cov_14.271838	1159	1239	1	16	80	0.2000000
NODE_1937_length_1633_cov_14.271838	1159	1239	2	8	80	0.1000000
NODE_1937_length_1633_cov_14.271838	1159	1239	3	3	80	0.0375000
NODE_1937_length_1633_cov_14.271838	1159	1239	4	3	80	0.0375000
NODE_1937_length_1633_cov_14.271838	1159	1239	5	4	80	0.0500000
NODE_1937_length_1633_cov_14.271838	1159	1239	6	2	80	0.0250000
NODE_1937_length_1633_cov_14.271838	1159	1239	7	37	80	0.4625000
NODE_1937_length_1633_cov_14.271838	1159	1239	8	7	80	0.0875000
NODE_1939_length_1631_cov_25.881201	424	504	8	9	80	0.1125000
NODE_1939_length_1631_cov_25.881201	424	504	9	42	80	0.5250000
NODE_1939_length_1631_cov_25.881201	424	504	10	24	80	0.3000000
NODE_1939_length_1631_cov_25.881201	424	504	11	5	80	0.0625000
NODE_1939_length_1631_cov_25.881201	477	557	3	6	80	0.0750000
NODE_1939_length_1631_cov_25.881201	477	557	4	5	80	0.0625000
NODE_1939_length_1631_cov_25.881201	477	557	5	15	80	0.1875000
NODE_1939_length_1631_cov_25.881201	477	557	7	6	80	0.0750000
NODE_1939_length_1631_cov_25.881201	477	557	8	11	80	0.1375000
NODE_1939_length_1631_cov_25.881201	477	557	9	37	80	0.4625000
NODE_1939_length_1631_cov_25.881201	553	633	3	5	80	0.0625000
NODE_1939_length_1631_cov_25.881201	553	633	5	23	80	0.2875000
NODE_1939_length_1631_cov_25.881201	553	633	6	20	80	0.2500000
NODE_1939_length_1631_cov_25.881201	553	633	8	4	80	0.0500000
NODE_1939_length_1631_cov_25.881201	553	633	9	24	80	0.3000000
NODE_1939_length_1631_cov_25.881201	553	633	10	4	80	0.0500000
NODE_1939_length_1631_cov_25.881201	606	686	7	32	80	0.4000000
NODE_1939_length_1631_cov_25.881201	606	686	8	2	80	0.0250000
NODE_1939_length_1631_cov_25.881201	606	686	9	34	80	0.4250000
NODE_1939_length_1631_cov_25.881201	606	686	10	12	80	0.1500000
NODE_1943_length_1629_cov_32.733987	518	598	3	21	80	0.2625000
NODE_1943_length_1629_cov_32.733987	518	598	4	38	80	0.4750000
NODE_1943_length_1629_cov_32.733987	518	598	5	21	80	0.2625000
NODE_1943_length_1629_cov_32.733987	635	715	7	5	80	0.0625000
NODE_1943_length_1629_cov_32.733987	635	715	8	7	80	0.0875000
NODE_1943_length_1629_cov_32.733987	635	715	9	9	80	0.1125000
NODE_1943_length_1629_cov_32.733987	635	715	11	3	80	0.0375000
NODE_1943_length_1629_cov_32.733987	635	715	13	11	80	0.1375000
NODE_1943_length_1629_cov_32.733987	635	715	15	1	80	0.0125000
NODE_1943_length_1629_cov_32.733987	635	715	16	2	80	0.0250000
NODE_1943_length_1629_cov_32.733987	635	715	17	1	80	0.0125000
NODE_1943_length_1629_cov_32.733987	635	715	18	4	80	0.0500000
NODE_1943_length_1629_cov_32.733987	635	715	19	8	80	0.1000000
NODE_1943_length_1629_cov_32.733987	635	715	21	1	80	0.0125000
NODE_1943_length_1629_cov_32.733987	635	715	22	15	80	0.1875000
NODE_1943_length_1629_cov_32.733987	635	715	23	10	80	0.1250000
NODE_1943_length_1629_cov_32.733987	635	715	24	3	80	0.0375000
NODE_1943_length_1629_cov_32.733987	688	768	15	4	80	0.0500000
NODE_1943_length_1629_cov_32.733987	688	768	17	4	80	0.0500000
NODE_1943_length_1629_cov_32.733987	688	768	18	7	80	0.0875000
NODE_1943_length_1629_cov_32.733987	688	768	19	7	80	0.0875000
NODE_1943_length_1629_cov_32.733987	688	768	20	5	80	0.0625000
NODE_1943_length_1629_cov_32.733987	688	768	22	21	80	0.2625000
NODE_1943_length_1629_cov_32.733987	688	768	23	9	80	0.1125000
NODE_1943_length_1629_cov_32.733987	688	768	24	23	80	0.2875000
NODE_1946_length_1628_cov_15.551995	1454	1518	14	1	64	0.0156250
NODE_1946_length_1628_cov_15.551995	1454	1518	15	1	64	0.0156250
NODE_1946_length_1628_cov_15.551995	1454	1518	16	1	64	0.0156250
NODE_1946_length_1628_cov_15.551995	1454	1518	17	2	64	0.0312500
NODE_1946_length_1628_cov_15.551995	1454	1518	18	1	64	0.0156250
NODE_1946_length_1628_cov_15.551995	1454	1518	19	1	64	0.0156250
NODE_1946_length_1628_cov_15.551995	1454	1518	20	2	64	0.0312500
NODE_1946_length_1628_cov_15.551995	1454	1518	21	3	64	0.0468750
NODE_1946_length_1628_cov_15.551995	1454	1518	23	1	64	0.0156250
NODE_1946_length_1628_cov_15.551995	1454	1518	27	5	64	0.0781250
NODE_1946_length_1628_cov_15.551995	1454	1518	28	2	64	0.0312500
NODE_1946_length_1628_cov_15.551995	1454	1518	32	2	64	0.0312500
NODE_1946_length_1628_cov_15.551995	1454	1518	33	1	64	0.0156250
NODE_1946_length_1628_cov_15.551995	1454	1518	35	5	64	0.0781250
NODE_1946_length_1628_cov_15.551995	1454	1518	37	2	64	0.0312500
NODE_1946_length_1628_cov_15.551995	1454	1518	41	7	64	0.1093750
NODE_1946_length_1628_cov_15.551995	1454	1518	42	10	64	0.1562500
NODE_1946_length_1628_cov_15.551995	1454	1518	44	11	64	0.1718750
NODE_1946_length_1628_cov_15.551995	1454	1518	46	6	64	0.0937500
NODE_1947_length_1628_cov_4.852845	81	163	3	68	82	0.8292683
NODE_1947_length_1628_cov_4.852845	81	163	4	14	82	0.1707317
NODE_1952_length_1626_cov_20.549443	495	575	6	12	80	0.1500000
NODE_1952_length_1626_cov_20.549443	495	575	7	7	80	0.0875000
NODE_1952_length_1626_cov_20.549443	495	575	8	32	80	0.4000000
NODE_1952_length_1626_cov_20.549443	495	575	11	5	80	0.0625000
NODE_1952_length_1626_cov_20.549443	495	575	13	14	80	0.1750000
NODE_1952_length_1626_cov_20.549443	495	575	16	10	80	0.1250000
NODE_1952_length_1626_cov_20.549443	548	628	9	11	80	0.1375000
NODE_1952_length_1626_cov_20.549443	548	628	10	3	80	0.0375000
NODE_1952_length_1626_cov_20.549443	548	628	11	3	80	0.0375000
NODE_1952_length_1626_cov_20.549443	548	628	12	3	80	0.0375000
NODE_1952_length_1626_cov_20.549443	548	628	13	14	80	0.1750000
NODE_1952_length_1626_cov_20.549443	548	628	14	15	80	0.1875000
NODE_1952_length_1626_cov_20.549443	548	628	15	2	80	0.0250000
NODE_1952_length_1626_cov_20.549443	548	628	16	29	80	0.3625000
NODE_1953_length_1626_cov_6.552718	1189	1269	4	80	80	1.0000000
NODE_1953_length_1626_cov_6.552718	1242	1321	0	23	79	0.2911392
NODE_1953_length_1626_cov_6.552718	1242	1321	2	24	79	0.3037975
NODE_1953_length_1626_cov_6.552718	1242	1321	4	32	79	0.4050633
NODE_1954_length_1626_cov_4.728880	247	329	0	29	82	0.3536585
NODE_1954_length_1626_cov_4.728880	247	329	2	53	82	0.6463414
NODE_1954_length_1626_cov_4.728880	302	382	0	80	80	1.0000000
NODE_1956_length_1625_cov_20.598952	938	1018	10	17	80	0.2125000
NODE_1956_length_1625_cov_20.598952	938	1018	12	32	80	0.4000000
NODE_1956_length_1625_cov_20.598952	938	1018	13	16	80	0.2000000
NODE_1956_length_1625_cov_20.598952	938	1018	14	15	80	0.1875000
NODE_1956_length_1625_cov_20.598952	991	1071	6	2	80	0.0250000
NODE_1956_length_1625_cov_20.598952	991	1071	7	7	80	0.0875000
NODE_1956_length_1625_cov_20.598952	991	1071	9	4	80	0.0500000
NODE_1956_length_1625_cov_20.598952	991	1071	10	22	80	0.2750000
NODE_1956_length_1625_cov_20.598952	991	1071	12	17	80	0.2125000
NODE_1956_length_1625_cov_20.598952	991	1071	13	13	80	0.1625000
NODE_1956_length_1625_cov_20.598952	991	1071	14	15	80	0.1875000
NODE_1962_length_1623_cov_28.551181	416	486	6	15	70	0.2142857
NODE_1962_length_1623_cov_28.551181	416	486	7	1	70	0.0142857
NODE_1962_length_1623_cov_28.551181	416	486	8	25	70	0.3571429
NODE_1962_length_1623_cov_28.551181	416	486	10	1	70	0.0142857
NODE_1962_length_1623_cov_28.551181	416	486	12	6	70	0.0857143
NODE_1962_length_1623_cov_28.551181	416	486	13	11	70	0.1571429
NODE_1962_length_1623_cov_28.551181	416	486	15	2	70	0.0285714
NODE_1962_length_1623_cov_28.551181	416	486	16	9	70	0.1285714
NODE_1962_length_1623_cov_28.551181	459	507	3	6	48	0.1250000
NODE_1962_length_1623_cov_28.551181	459	507	4	1	48	0.0208333
NODE_1962_length_1623_cov_28.551181	459	507	5	5	48	0.1041667
NODE_1962_length_1623_cov_28.551181	459	507	6	21	48	0.4375000
NODE_1962_length_1623_cov_28.551181	459	507	7	1	48	0.0208333
NODE_1962_length_1623_cov_28.551181	459	507	8	11	48	0.2291667
NODE_1962_length_1623_cov_28.551181	459	507	9	3	48	0.0625000
NODE_1965_length_1622_cov_7.969140	645	725	0	80	80	1.0000000
NODE_1965_length_1622_cov_7.969140	698	778	0	80	80	1.0000000
NODE_1970_length_1621_cov_2.192510	330	401	4	37	71	0.5211267
NODE_1970_length_1621_cov_2.192510	330	401	5	23	71	0.3239437
NODE_1970_length_1621_cov_2.192510	330	401	6	10	71	0.1408451
NODE_1970_length_1621_cov_2.192510	330	401	7	1	71	0.0140845
NODE_1975_length_1618_cov_44.138907	361	441	5	12	80	0.1500000
NODE_1975_length_1618_cov_44.138907	361	441	6	68	80	0.8500000
NODE_1975_length_1618_cov_44.138907	414	494	2	4	80	0.0500000
NODE_1975_length_1618_cov_44.138907	414	494	4	16	80	0.2000000
NODE_1975_length_1618_cov_44.138907	414	494	5	15	80	0.1875000
NODE_1975_length_1618_cov_44.138907	414	494	6	45	80	0.5625000
NODE_1975_length_1618_cov_44.138907	1063	1143	12	15	80	0.1875000
NODE_1975_length_1618_cov_44.138907	1063	1143	13	8	80	0.1000000
NODE_1975_length_1618_cov_44.138907	1063	1143	14	3	80	0.0375000
NODE_1975_length_1618_cov_44.138907	1063	1143	15	11	80	0.1375000
NODE_1975_length_1618_cov_44.138907	1063	1143	16	7	80	0.0875000
NODE_1975_length_1618_cov_44.138907	1063	1143	17	19	80	0.2375000
NODE_1975_length_1618_cov_44.138907	1063	1143	18	12	80	0.1500000
NODE_1975_length_1618_cov_44.138907	1063	1143	19	5	80	0.0625000
NODE_1975_length_1618_cov_44.138907	1116	1196	9	8	80	0.1000000
NODE_1975_length_1618_cov_44.138907	1116	1196	10	3	80	0.0375000
NODE_1975_length_1618_cov_44.138907	1116	1196	11	1	80	0.0125000
NODE_1975_length_1618_cov_44.138907	1116	1196	12	20	80	0.2500000
NODE_1975_length_1618_cov_44.138907	1116	1196	14	7	80	0.0875000
NODE_1975_length_1618_cov_44.138907	1116	1196	16	4	80	0.0500000
NODE_1975_length_1618_cov_44.138907	1116	1196	17	15	80	0.1875000
NODE_1975_length_1618_cov_44.138907	1116	1196	18	16	80	0.2000000
NODE_1975_length_1618_cov_44.138907	1116	1196	19	6	80	0.0750000
NODE_1976_length_1618_cov_5.779460	332	414	0	82	82	1.0000000
NODE_1976_length_1618_cov_5.779460	387	467	0	80	80	1.0000000
NODE_1976_length_1618_cov_5.779460	972	1028	2	29	56	0.5178571
NODE_1976_length_1618_cov_5.779460	972	1028	4	27	56	0.4821429
NODE_1980_length_1616_cov_5.313777	589	669	2	43	80	0.5375000
NODE_1980_length_1616_cov_5.313777	589	669	3	26	80	0.3250000
NODE_1980_length_1616_cov_5.313777	589	669	4	11	80	0.1375000
NODE_1980_length_1616_cov_5.313777	642	722	0	4	80	0.0500000
NODE_1980_length_1616_cov_5.313777	642	722	2	33	80	0.4125000
NODE_1980_length_1616_cov_5.313777	642	722	3	42	80	0.5250000
NODE_1980_length_1616_cov_5.313777	642	722	4	1	80	0.0125000
NODE_1981_length_1615_cov_12.575858	1032	1112	2	7	80	0.0875000
NODE_1981_length_1615_cov_12.575858	1032	1112	4	19	80	0.2375000
NODE_1981_length_1615_cov_12.575858	1032	1112	6	50	80	0.6250000
NODE_1981_length_1615_cov_12.575858	1032	1112	7	4	80	0.0500000
NODE_1981_length_1615_cov_12.575858	1085	1162	5	22	77	0.2857143
NODE_1981_length_1615_cov_12.575858	1085	1162	6	47	77	0.6103896
NODE_1981_length_1615_cov_12.575858	1085	1162	7	8	77	0.1038961
NODE_1981_length_1615_cov_12.575858	1158	1238	2	22	80	0.2750000
NODE_1981_length_1615_cov_12.575858	1158	1238	3	24	80	0.3000000
NODE_1981_length_1615_cov_12.575858	1158	1238	4	22	80	0.2750000
NODE_1981_length_1615_cov_12.575858	1158	1238	5	12	80	0.1500000
NODE_1981_length_1615_cov_12.575858	1211	1291	3	19	80	0.2375000
NODE_1981_length_1615_cov_12.575858	1211	1291	4	31	80	0.3875000
NODE_1981_length_1615_cov_12.575858	1211	1291	5	12	80	0.1500000
NODE_1981_length_1615_cov_12.575858	1211	1291	6	18	80	0.2250000
NODE_1983_length_1614_cov_94.900990	0	46	0	5	46	0.1086956
NODE_1983_length_1614_cov_94.900990	0	46	2	1	46	0.0217391
NODE_1983_length_1614_cov_94.900990	0	46	4	40	46	0.8695652
NODE_1983_length_1614_cov_94.900990	23	99	4	76	76	1.0000000
NODE_1984_length_1614_cov_18.799340	655	735	6	5	80	0.0625000
NODE_1984_length_1614_cov_18.799340	655	735	8	7	80	0.0875000
NODE_1984_length_1614_cov_18.799340	655	735	9	48	80	0.6000000
NODE_1984_length_1614_cov_18.799340	655	735	10	20	80	0.2500000
NODE_1984_length_1614_cov_18.799340	708	788	4	6	80	0.0750000
NODE_1984_length_1614_cov_18.799340	708	788	5	36	80	0.4500000
NODE_1984_length_1614_cov_18.799340	708	788	7	2	80	0.0250000
NODE_1984_length_1614_cov_18.799340	708	788	9	27	80	0.3375000
NODE_1984_length_1614_cov_18.799340	708	788	10	9	80	0.1125000
NODE_1986_length_1613_cov_6.865258	1128	1203	1	49	75	0.6533333
NODE_1986_length_1613_cov_6.865258	1128	1203	3	26	75	0.3466667
NODE_1986_length_1613_cov_6.865258	1176	1256	0	12	80	0.1500000
NODE_1986_length_1613_cov_6.865258	1176	1256	1	27	80	0.3375000
NODE_1986_length_1613_cov_6.865258	1176	1256	2	24	80	0.3000000
NODE_1986_length_1613_cov_6.865258	1176	1256	3	17	80	0.2125000
NODE_1993_length_1610_cov_18.014560	1035	1115	9	20	80	0.2500000
NODE_1993_length_1610_cov_18.014560	1035	1115	10	9	80	0.1125000
NODE_1993_length_1610_cov_18.014560	1035	1115	11	40	80	0.5000000
NODE_1993_length_1610_cov_18.014560	1035	1115	12	11	80	0.1375000
NODE_1993_length_1610_cov_18.014560	1088	1168	5	45	80	0.5625000
NODE_1993_length_1610_cov_18.014560	1088	1168	6	6	80	0.0750000
NODE_1993_length_1610_cov_18.014560	1088	1168	8	2	80	0.0250000
NODE_1993_length_1610_cov_18.014560	1088	1168	9	9	80	0.1125000
NODE_1993_length_1610_cov_18.014560	1088	1168	11	11	80	0.1375000
NODE_1993_length_1610_cov_18.014560	1088	1168	12	7	80	0.0875000
NODE_2001_length_1603_cov_9.128324	1109	1189	0	80	80	1.0000000
NODE_2001_length_1603_cov_9.128324	1162	1242	0	80	80	1.0000000
NODE_2003_length_1602_cov_79.840319	1378	1445	29	3	67	0.0447761
NODE_2003_length_1602_cov_79.840319	1378	1445	31	12	67	0.1791045
NODE_2003_length_1602_cov_79.840319	1378	1445	32	9	67	0.1343284
NODE_2003_length_1602_cov_79.840319	1378	1445	33	2	67	0.0298507
NODE_2003_length_1602_cov_79.840319	1378	1445	36	2	67	0.0298507
NODE_2003_length_1602_cov_79.840319	1378	1445	38	1	67	0.0149254
NODE_2003_length_1602_cov_79.840319	1378	1445	40	2	67	0.0298507
NODE_2003_length_1602_cov_79.840319	1378	1445	42	4	67	0.0597015
NODE_2003_length_1602_cov_79.840319	1378	1445	43	9	67	0.1343284
NODE_2003_length_1602_cov_79.840319	1378	1445	44	4	67	0.0597015
NODE_2003_length_1602_cov_79.840319	1378	1445	45	2	67	0.0298507
NODE_2003_length_1602_cov_79.840319	1378	1445	46	6	67	0.0895522
NODE_2003_length_1602_cov_79.840319	1378	1445	48	2	67	0.0298507
NODE_2003_length_1602_cov_79.840319	1378	1445	50	3	67	0.0447761
NODE_2003_length_1602_cov_79.840319	1378	1445	51	3	67	0.0447761
NODE_2003_length_1602_cov_79.840319	1378	1445	52	1	67	0.0149254
NODE_2003_length_1602_cov_79.840319	1378	1445	54	2	67	0.0298507
NODE_2003_length_1602_cov_79.840319	1462	1508	9	1	46	0.0217391
NODE_2003_length_1602_cov_79.840319	1462	1508	11	1	46	0.0217391
NODE_2003_length_1602_cov_79.840319	1462	1508	12	7	46	0.1521739
NODE_2003_length_1602_cov_79.840319	1462	1508	13	3	46	0.0652174
NODE_2003_length_1602_cov_79.840319	1462	1508	14	8	46	0.1739130
NODE_2003_length_1602_cov_79.840319	1462	1508	15	4	46	0.0869565
NODE_2003_length_1602_cov_79.840319	1462	1508	16	2	46	0.0434783
NODE_2003_length_1602_cov_79.840319	1462	1508	17	6	46	0.1304348
NODE_2003_length_1602_cov_79.840319	1462	1508	19	11	46	0.2391304
NODE_2003_length_1602_cov_79.840319	1462	1508	20	2	46	0.0434783
NODE_2003_length_1602_cov_79.840319	1462	1508	21	1	46	0.0217391
NODE_2004_length_1602_cov_2.701264	1490	1570	2	80	80	1.0000000
NODE_2009_length_1600_cov_34.988008	785	865	24	2	80	0.0250000
NODE_2009_length_1600_cov_34.988008	785	865	26	1	80	0.0125000
NODE_2009_length_1600_cov_34.988008	785	865	27	19	80	0.2375000
NODE_2009_length_1600_cov_34.988008	785	865	28	2	80	0.0250000
NODE_2009_length_1600_cov_34.988008	785	865	29	1	80	0.0125000
NODE_2009_length_1600_cov_34.988008	785	865	31	7	80	0.0875000
NODE_2009_length_1600_cov_34.988008	785	865	32	7	80	0.0875000
NODE_2009_length_1600_cov_34.988008	785	865	33	9	80	0.1125000
NODE_2009_length_1600_cov_34.988008	785	865	34	20	80	0.2500000
NODE_2009_length_1600_cov_34.988008	785	865	35	12	80	0.1500000
NODE_2009_length_1600_cov_34.988008	838	918	17	6	80	0.0750000
NODE_2009_length_1600_cov_34.988008	838	918	18	1	80	0.0125000
NODE_2009_length_1600_cov_34.988008	838	918	19	19	80	0.2375000
NODE_2009_length_1600_cov_34.988008	838	918	21	10	80	0.1250000
NODE_2009_length_1600_cov_34.988008	838	918	23	2	80	0.0250000
NODE_2009_length_1600_cov_34.988008	838	918	25	12	80	0.1500000
NODE_2009_length_1600_cov_34.988008	838	918	29	4	80	0.0500000
NODE_2009_length_1600_cov_34.988008	838	918	31	7	80	0.0875000
NODE_2009_length_1600_cov_34.988008	838	918	33	8	80	0.1000000
NODE_2009_length_1600_cov_34.988008	838	918	34	11	80	0.1375000
NODE_2009_length_1600_cov_34.988008	914	994	9	7	80	0.0875000
NODE_2009_length_1600_cov_34.988008	914	994	10	15	80	0.1875000
NODE_2009_length_1600_cov_34.988008	914	994	11	13	80	0.1625000
NODE_2009_length_1600_cov_34.988008	914	994	13	1	80	0.0125000
NODE_2009_length_1600_cov_34.988008	914	994	14	13	80	0.1625000
NODE_2009_length_1600_cov_34.988008	914	994	15	1	80	0.0125000
NODE_2009_length_1600_cov_34.988008	914	994	16	7	80	0.0875000
NODE_2009_length_1600_cov_34.988008	914	994	17	10	80	0.1250000
NODE_2009_length_1600_cov_34.988008	914	994	18	5	80	0.0625000
NODE_2009_length_1600_cov_34.988008	914	994	19	8	80	0.1000000
NODE_2009_length_1600_cov_34.988008	967	1047	4	4	80	0.0500000
NODE_2009_length_1600_cov_34.988008	967	1047	5	1	80	0.0125000
NODE_2009_length_1600_cov_34.988008	967	1047	6	1	80	0.0125000
NODE_2009_length_1600_cov_34.988008	967	1047	8	46	80	0.5750000
NODE_2009_length_1600_cov_34.988008	967	1047	9	8	80	0.1000000
NODE_2009_length_1600_cov_34.988008	967	1047	10	15	80	0.1875000
NODE_2009_length_1600_cov_34.988008	967	1047	11	5	80	0.0625000
NODE_2011_length_1600_cov_11.383744	0	72	0	72	72	1.0000000
NODE_2011_length_1600_cov_11.383744	45	99	0	54	54	1.0000000
NODE_2011_length_1600_cov_11.383744	891	971	0	80	80	1.0000000
NODE_2011_length_1600_cov_11.383744	944	1024	0	80	80	1.0000000
NODE_2013_length_1600_cov_7.236509	1037	1109	1	28	72	0.3888889
NODE_2013_length_1600_cov_7.236509	1037	1109	2	37	72	0.5138889
NODE_2013_length_1600_cov_7.236509	1037	1109	3	7	72	0.0972222
NODE_2013_length_1600_cov_7.236509	1090	1160	2	59	70	0.8428571
NODE_2013_length_1600_cov_7.236509	1090	1160	3	11	70	0.1571429
NODE_2018_length_1598_cov_29.337558	335	415	11	5	80	0.0625000
NODE_2018_length_1598_cov_29.337558	335	415	13	13	80	0.1625000
NODE_2018_length_1598_cov_29.337558	335	415	14	9	80	0.1125000
NODE_2018_length_1598_cov_29.337558	335	415	15	12	80	0.1500000
NODE_2018_length_1598_cov_29.337558	335	415	16	25	80	0.3125000
NODE_2018_length_1598_cov_29.337558	335	415	17	16	80	0.2000000
NODE_2018_length_1598_cov_29.337558	388	468	11	22	80	0.2750000
NODE_2018_length_1598_cov_29.337558	388	468	12	16	80	0.2000000
NODE_2018_length_1598_cov_29.337558	388	468	13	2	80	0.0250000
NODE_2018_length_1598_cov_29.337558	388	468	14	11	80	0.1375000
NODE_2018_length_1598_cov_29.337558	388	468	15	13	80	0.1625000
NODE_2018_length_1598_cov_29.337558	388	468	16	9	80	0.1125000
NODE_2018_length_1598_cov_29.337558	388	468	17	7	80	0.0875000
NODE_2018_length_1598_cov_29.337558	464	516	10	2	52	0.0384615
NODE_2018_length_1598_cov_29.337558	464	516	11	2	52	0.0384615
NODE_2018_length_1598_cov_29.337558	464	516	12	4	52	0.0769231
NODE_2018_length_1598_cov_29.337558	464	516	13	36	52	0.6923077
NODE_2018_length_1598_cov_29.337558	464	516	14	5	52	0.0961538
NODE_2018_length_1598_cov_29.337558	464	516	15	2	52	0.0384615
NODE_2018_length_1598_cov_29.337558	464	516	16	1	52	0.0192308
NODE_2018_length_1598_cov_29.337558	1026	1106	2	59	80	0.7375000
NODE_2018_length_1598_cov_29.337558	1026	1106	3	21	80	0.2625000
NODE_2018_length_1598_cov_29.337558	1079	1159	2	21	80	0.2625000
NODE_2018_length_1598_cov_29.337558	1079	1159	3	59	80	0.7375000
NODE_2019_length_1598_cov_3.730487	1117	1197	0	35	80	0.4375000
NODE_2019_length_1598_cov_3.730487	1117	1197	1	42	80	0.5250000
NODE_2019_length_1598_cov_3.730487	1117	1197	2	3	80	0.0375000
NODE_2021_length_1597_cov_7.434579	1373	1453	0	79	80	0.9875000
NODE_2021_length_1597_cov_7.434579	1373	1453	2	1	80	0.0125000
NODE_2021_length_1597_cov_7.434579	1382	1453	0	70	71	0.9859155
NODE_2021_length_1597_cov_7.434579	1382	1453	2	1	71	0.0140845
NODE_2022_length_1595_cov_16.788770	215	267	0	38	52	0.7307692
NODE_2022_length_1595_cov_16.788770	215	267	1	14	52	0.2692308
NODE_2022_length_1595_cov_16.788770	614	673	9	2	59	0.0338983
NODE_2022_length_1595_cov_16.788770	614	673	11	43	59	0.7288136
NODE_2022_length_1595_cov_16.788770	614	673	12	14	59	0.2372881
NODE_2025_length_1593_cov_22.412316	144	224	2	6	80	0.0750000
NODE_2025_length_1593_cov_22.412316	144	224	3	3	80	0.0375000
NODE_2025_length_1593_cov_22.412316	144	224	4	69	80	0.8625000
NODE_2025_length_1593_cov_22.412316	144	224	5	1	80	0.0125000
NODE_2025_length_1593_cov_22.412316	144	224	7	1	80	0.0125000
NODE_2025_length_1593_cov_22.412316	197	277	4	25	80	0.3125000
NODE_2025_length_1593_cov_22.412316	197	277	5	16	80	0.2000000
NODE_2025_length_1593_cov_22.412316	197	277	7	39	80	0.4875000
NODE_2025_length_1593_cov_22.412316	1192	1272	0	69	80	0.8625000
NODE_2025_length_1593_cov_22.412316	1192	1272	1	11	80	0.1375000
NODE_2025_length_1593_cov_22.412316	1245	1325	0	16	80	0.2000000
NODE_2025_length_1593_cov_22.412316	1245	1325	1	15	80	0.1875000
NODE_2025_length_1593_cov_22.412316	1245	1325	2	36	80	0.4500000
NODE_2025_length_1593_cov_22.412316	1245	1325	4	13	80	0.1625000
NODE_2026_length_1593_cov_14.092369	357	437	5	29	80	0.3625000
NODE_2026_length_1593_cov_14.092369	357	437	6	44	80	0.5500000
NODE_2026_length_1593_cov_14.092369	357	437	7	7	80	0.0875000
NODE_2026_length_1593_cov_14.092369	410	490	2	7	80	0.0875000
NODE_2026_length_1593_cov_14.092369	410	490	3	24	80	0.3000000
NODE_2026_length_1593_cov_14.092369	410	490	4	20	80	0.2500000
NODE_2026_length_1593_cov_14.092369	410	490	5	29	80	0.3625000
NODE_2026_length_1593_cov_14.092369	1061	1141	5	32	80	0.4000000
NODE_2026_length_1593_cov_14.092369	1061	1141	6	10	80	0.1250000
NODE_2026_length_1593_cov_14.092369	1061	1141	7	38	80	0.4750000
NODE_2026_length_1593_cov_14.092369	1114	1194	1	1	80	0.0125000
NODE_2026_length_1593_cov_14.092369	1114	1194	2	4	80	0.0500000
NODE_2026_length_1593_cov_14.092369	1114	1194	4	47	80	0.5875000
NODE_2026_length_1593_cov_14.092369	1114	1194	5	28	80	0.3500000
NODE_2031_length_1592_cov_4.576691	277	357	0	76	80	0.9500000
NODE_2031_length_1592_cov_4.576691	277	357	2	4	80	0.0500000
NODE_2031_length_1592_cov_4.576691	330	410	0	80	80	1.0000000
NODE_2034_length_1591_cov_15.481233	841	921	5	11	80	0.1375000
NODE_2034_length_1591_cov_15.481233	841	921	7	13	80	0.1625000
NODE_2034_length_1591_cov_15.481233	841	921	8	4	80	0.0500000
NODE_2034_length_1591_cov_15.481233	841	921	9	34	80	0.4250000
NODE_2034_length_1591_cov_15.481233	841	921	10	2	80	0.0250000
NODE_2034_length_1591_cov_15.481233	841	921	11	16	80	0.2000000
NODE_2034_length_1591_cov_15.481233	894	974	6	1	80	0.0125000
NODE_2034_length_1591_cov_15.481233	894	974	7	24	80	0.3000000
NODE_2034_length_1591_cov_15.481233	894	974	9	30	80	0.3750000
NODE_2034_length_1591_cov_15.481233	894	974	10	9	80	0.1125000
NODE_2034_length_1591_cov_15.481233	894	974	11	16	80	0.2000000
NODE_2035_length_1591_cov_4.040885	35	65	0	30	30	1.0000000
NODE_2035_length_1591_cov_4.040885	38	99	0	59	61	0.9672131
NODE_2035_length_1591_cov_4.040885	38	99	1	2	61	0.0327869
NODE_2042_length_1589_cov_10.184564	379	459	1	21	80	0.2625000
NODE_2042_length_1589_cov_10.184564	379	459	2	23	80	0.2875000
NODE_2042_length_1589_cov_10.184564	379	459	3	30	80	0.3750000
NODE_2042_length_1589_cov_10.184564	379	459	4	6	80	0.0750000
NODE_2042_length_1589_cov_10.184564	432	512	3	38	80	0.4750000
NODE_2042_length_1589_cov_10.184564	432	512	4	42	80	0.5250000
NODE_2042_length_1589_cov_10.184564	473	512	3	17	39	0.4358974
NODE_2042_length_1589_cov_10.184564	473	512	4	22	39	0.5641026
NODE_2042_length_1589_cov_10.184564	508	588	1	9	80	0.1125000
NODE_2042_length_1589_cov_10.184564	508	588	2	29	80	0.3625000
NODE_2042_length_1589_cov_10.184564	508	588	3	42	80	0.5250000
NODE_2042_length_1589_cov_10.184564	561	641	1	9	80	0.1125000
NODE_2042_length_1589_cov_10.184564	561	641	2	71	80	0.8875000
NODE_2043_length_1588_cov_9.955675	415	495	2	23	80	0.2875000
NODE_2043_length_1588_cov_9.955675	415	495	3	35	80	0.4375000
NODE_2043_length_1588_cov_9.955675	415	495	4	22	80	0.2750000
NODE_2043_length_1588_cov_9.955675	468	548	2	15	80	0.1875000
NODE_2043_length_1588_cov_9.955675	468	548	3	45	80	0.5625000
NODE_2043_length_1588_cov_9.955675	468	548	4	20	80	0.2500000
NODE_2046_length_1587_cov_7.942204	710	790	8	2	80	0.0250000
NODE_2046_length_1587_cov_7.942204	710	790	9	8	80	0.1000000
NODE_2046_length_1587_cov_7.942204	710	790	10	18	80	0.2250000
NODE_2046_length_1587_cov_7.942204	710	790	13	18	80	0.2250000
NODE_2046_length_1587_cov_7.942204	710	790	14	31	80	0.3875000
NODE_2046_length_1587_cov_7.942204	710	790	15	1	80	0.0125000
NODE_2046_length_1587_cov_7.942204	710	790	16	2	80	0.0250000
NODE_2046_length_1587_cov_7.942204	763	843	6	13	80	0.1625000
NODE_2046_length_1587_cov_7.942204	763	843	7	11	80	0.1375000
NODE_2046_length_1587_cov_7.942204	763	843	8	2	80	0.0250000
NODE_2046_length_1587_cov_7.942204	763	843	9	37	80	0.4625000
NODE_2046_length_1587_cov_7.942204	763	843	10	17	80	0.2125000
NODE_2049_length_1586_cov_6.488231	447	474	2	27	27	1.0000000
NODE_2049_length_1586_cov_6.488231	447	527	1	40	80	0.5000000
NODE_2049_length_1586_cov_6.488231	447	527	2	40	80	0.5000000
NODE_2049_length_1586_cov_6.488231	500	580	0	34	80	0.4250000
NODE_2049_length_1586_cov_6.488231	500	580	1	46	80	0.5750000
NODE_2056_length_1583_cov_27.825472	800	880	7	7	80	0.0875000
NODE_2056_length_1583_cov_27.825472	800	880	9	13	80	0.1625000
NODE_2056_length_1583_cov_27.825472	800	880	10	44	80	0.5500000
NODE_2056_length_1583_cov_27.825472	800	880	11	9	80	0.1125000
NODE_2056_length_1583_cov_27.825472	800	880	12	7	80	0.0875000
NODE_2056_length_1583_cov_27.825472	853	933	6	9	80	0.1125000
NODE_2056_length_1583_cov_27.825472	853	933	8	32	80	0.4000000
NODE_2056_length_1583_cov_27.825472	853	933	9	15	80	0.1875000
NODE_2056_length_1583_cov_27.825472	853	933	10	12	80	0.1500000
NODE_2056_length_1583_cov_27.825472	853	933	11	5	80	0.0625000
NODE_2056_length_1583_cov_27.825472	853	933	12	7	80	0.0875000
NODE_2056_length_1583_cov_27.825472	929	1009	5	15	80	0.1875000
NODE_2056_length_1583_cov_27.825472	929	1009	6	51	80	0.6375000
NODE_2056_length_1583_cov_27.825472	929	1009	7	11	80	0.1375000
NODE_2056_length_1583_cov_27.825472	929	1009	8	3	80	0.0375000
NODE_2056_length_1583_cov_27.825472	982	1062	5	36	80	0.4500000
NODE_2056_length_1583_cov_27.825472	982	1062	6	30	80	0.3750000
NODE_2056_length_1583_cov_27.825472	982	1062	7	11	80	0.1375000
NODE_2056_length_1583_cov_27.825472	982	1062	8	3	80	0.0375000
NODE_2060_length_1581_cov_10.610661	457	537	1	19	80	0.2375000
NODE_2060_length_1581_cov_10.610661	457	537	3	46	80	0.5750000
NODE_2060_length_1581_cov_10.610661	457	537	5	15	80	0.1875000
NODE_2060_length_1581_cov_10.610661	510	590	2	30	80	0.3750000
NODE_2060_length_1581_cov_10.610661	510	590	3	14	80	0.1750000
NODE_2060_length_1581_cov_10.610661	510	590	5	36	80	0.4500000
NODE_2065_length_1579_cov_7.395946	5	80	0	75	75	1.0000000
NODE_2065_length_1579_cov_7.395946	58	126	0	68	68	1.0000000
NODE_2066_length_1579_cov_7.152027	1331	1409	0	20	78	0.2564103
NODE_2066_length_1579_cov_7.152027	1331	1409	1	58	78	0.7435898
NODE_2066_length_1579_cov_7.152027	1382	1462	1	52	80	0.6500000
NODE_2066_length_1579_cov_7.152027	1382	1462	2	28	80	0.3500000
NODE_2067_length_1579_cov_6.741892	4	52	2	48	48	1.0000000
NODE_2067_length_1579_cov_6.741892	4	52	2	48	48	1.0000000
NODE_2067_length_1579_cov_6.741892	4	52	2	48	48	1.0000000
NODE_2067_length_1579_cov_6.741892	25	105	2	80	80	1.0000000
NODE_2067_length_1579_cov_6.741892	25	91	2	66	66	1.0000000
NODE_2067_length_1579_cov_6.741892	25	96	2	71	71	1.0000000
NODE_2076_length_1575_cov_4.250000	993	1073	1	80	80	1.0000000
NODE_2076_length_1575_cov_4.250000	1046	1126	0	2	80	0.0250000
NODE_2076_length_1575_cov_4.250000	1046	1126	1	78	80	0.9750000
NODE_2078_length_1574_cov_40.682034	551	631	12	7	80	0.0875000
NODE_2078_length_1574_cov_40.682034	551	631	13	19	80	0.2375000
NODE_2078_length_1574_cov_40.682034	551	631	15	26	80	0.3250000
NODE_2078_length_1574_cov_40.682034	551	631	16	9	80	0.1125000
NODE_2078_length_1574_cov_40.682034	551	631	17	9	80	0.1125000
NODE_2078_length_1574_cov_40.682034	551	631	18	10	80	0.1250000
NODE_2078_length_1574_cov_40.682034	604	684	7	9	80	0.1125000
NODE_2078_length_1574_cov_40.682034	604	684	8	1	80	0.0125000
NODE_2078_length_1574_cov_40.682034	604	684	9	13	80	0.1625000
NODE_2078_length_1574_cov_40.682034	604	684	10	4	80	0.0500000
NODE_2078_length_1574_cov_40.682034	604	684	12	11	80	0.1375000
NODE_2078_length_1574_cov_40.682034	604	684	13	17	80	0.2125000
NODE_2078_length_1574_cov_40.682034	604	684	14	10	80	0.1250000
NODE_2078_length_1574_cov_40.682034	604	684	15	15	80	0.1875000
NODE_2078_length_1574_cov_40.682034	680	760	3	11	80	0.1375000
NODE_2078_length_1574_cov_40.682034	680	760	4	39	80	0.4875000
NODE_2078_length_1574_cov_40.682034	680	760	5	8	80	0.1000000
NODE_2078_length_1574_cov_40.682034	680	760	6	1	80	0.0125000
NODE_2078_length_1574_cov_40.682034	680	760	7	21	80	0.2625000
NODE_2078_length_1574_cov_40.682034	733	813	2	16	80	0.2000000
NODE_2078_length_1574_cov_40.682034	733	813	3	10	80	0.1250000
NODE_2078_length_1574_cov_40.682034	733	813	4	54	80	0.6750000
NODE_2079_length_1574_cov_7.572203	1306	1386	4	71	80	0.8875000
NODE_2079_length_1574_cov_7.572203	1306	1386	5	9	80	0.1125000
NODE_2079_length_1574_cov_7.572203	1359	1439	3	26	80	0.3250000
NODE_2079_length_1574_cov_7.572203	1359	1439	4	45	80	0.5625000
NODE_2079_length_1574_cov_7.572203	1359	1439	5	9	80	0.1125000
NODE_2081_length_1573_cov_16.107191	437	512	0	51	75	0.6800000
NODE_2081_length_1573_cov_16.107191	437	512	1	24	75	0.3200000
NODE_2081_length_1573_cov_16.107191	485	565	0	3	80	0.0375000
NODE_2081_length_1573_cov_16.107191	485	565	1	72	80	0.9000000
NODE_2081_length_1573_cov_16.107191	485	565	2	5	80	0.0625000
NODE_2081_length_1573_cov_16.107191	561	639	2	4	78	0.0512821
NODE_2081_length_1573_cov_16.107191	561	639	3	29	78	0.3717949
NODE_2081_length_1573_cov_16.107191	561	639	5	1	78	0.0128205
NODE_2081_length_1573_cov_16.107191	561	639	7	23	78	0.2948718
NODE_2081_length_1573_cov_16.107191	561	639	9	19	78	0.2435897
NODE_2081_length_1573_cov_16.107191	561	639	10	2	78	0.0256410
NODE_2081_length_1573_cov_16.107191	612	692	7	6	80	0.0750000
NODE_2081_length_1573_cov_16.107191	612	692	9	35	80	0.4375000
NODE_2081_length_1573_cov_16.107191	612	692	10	39	80	0.4875000
NODE_2085_length_1572_cov_25.966735	359	404	50	1	45	0.0222222
NODE_2085_length_1572_cov_25.966735	359	404	51	9	45	0.2000000
NODE_2085_length_1572_cov_25.966735	359	404	52	8	45	0.1777778
NODE_2085_length_1572_cov_25.966735	359	404	53	13	45	0.2888889
NODE_2085_length_1572_cov_25.966735	359	404	54	6	45	0.1333333
NODE_2085_length_1572_cov_25.966735	359	404	55	5	45	0.1111111
NODE_2085_length_1572_cov_25.966735	359	404	56	2	45	0.0444444
NODE_2085_length_1572_cov_25.966735	359	404	57	1	45	0.0222222
NODE_2085_length_1572_cov_25.966735	405	477	47	6	72	0.0833333
NODE_2085_length_1572_cov_25.966735	405	477	48	17	72	0.2361111
NODE_2085_length_1572_cov_25.966735	405	477	49	10	72	0.1388889
NODE_2085_length_1572_cov_25.966735	405	477	50	3	72	0.0416667
NODE_2085_length_1572_cov_25.966735	405	477	51	4	72	0.0555556
NODE_2085_length_1572_cov_25.966735	405	477	52	1	72	0.0138889
NODE_2085_length_1572_cov_25.966735	405	477	53	3	72	0.0416667
NODE_2085_length_1572_cov_25.966735	405	477	54	7	72	0.0972222
NODE_2085_length_1572_cov_25.966735	405	477	55	6	72	0.0833333
NODE_2085_length_1572_cov_25.966735	405	477	56	5	72	0.0694444
NODE_2085_length_1572_cov_25.966735	405	477	57	2	72	0.0277778
NODE_2085_length_1572_cov_25.966735	405	477	58	8	72	0.1111111
NODE_2085_length_1572_cov_25.966735	1016	1096	4	5	80	0.0625000
NODE_2085_length_1572_cov_25.966735	1016	1096	5	17	80	0.2125000
NODE_2085_length_1572_cov_25.966735	1016	1096	7	13	80	0.1625000
NODE_2085_length_1572_cov_25.966735	1016	1096	8	45	80	0.5625000
NODE_2085_length_1572_cov_25.966735	1069	1149	3	28	80	0.3500000
NODE_2085_length_1572_cov_25.966735	1069	1149	4	30	80	0.3750000
NODE_2085_length_1572_cov_25.966735	1069	1149	8	22	80	0.2750000
NODE_2086_length_1572_cov_3.513238	1386	1462	1	63	76	0.8289474
NODE_2086_length_1572_cov_3.513238	1386	1462	3	13	76	0.1710526
NODE_2090_length_1570_cov_21.745071	700	780	6	1	80	0.0125000
NODE_2090_length_1570_cov_21.745071	700	780	7	27	80	0.3375000
NODE_2090_length_1570_cov_21.745071	700	780	8	38	80	0.4750000
NODE_2090_length_1570_cov_21.745071	700	780	9	14	80	0.1750000
NODE_2090_length_1570_cov_21.745071	753	833	5	42	80	0.5250000
NODE_2090_length_1570_cov_21.745071	753	833	6	1	80	0.0125000
NODE_2090_length_1570_cov_21.745071	753	833	7	26	80	0.3250000
NODE_2090_length_1570_cov_21.745071	753	833	8	11	80	0.1375000
NODE_2091_length_1570_cov_3.276003	387	467	2	1	80	0.0125000
NODE_2091_length_1570_cov_3.276003	387	467	3	27	80	0.3375000
NODE_2091_length_1570_cov_3.276003	387	467	4	52	80	0.6500000
NODE_2091_length_1570_cov_3.276003	440	520	2	54	80	0.6750000
NODE_2091_length_1570_cov_3.276003	440	520	3	1	80	0.0125000
NODE_2091_length_1570_cov_3.276003	440	520	4	25	80	0.3125000
NODE_2093_length_1569_cov_53.941497	741	821	11	9	80	0.1125000
NODE_2093_length_1569_cov_53.941497	741	821	12	26	80	0.3250000
NODE_2093_length_1569_cov_53.941497	741	821	13	28	80	0.3500000
NODE_2093_length_1569_cov_53.941497	741	821	14	16	80	0.2000000
NODE_2093_length_1569_cov_53.941497	741	821	15	1	80	0.0125000
NODE_2093_length_1569_cov_53.941497	794	874	6	12	80	0.1500000
NODE_2093_length_1569_cov_53.941497	794	874	8	3	80	0.0375000
NODE_2093_length_1569_cov_53.941497	794	874	9	4	80	0.0500000
NODE_2093_length_1569_cov_53.941497	794	874	10	18	80	0.2250000
NODE_2093_length_1569_cov_53.941497	794	874	11	17	80	0.2125000
NODE_2093_length_1569_cov_53.941497	794	874	12	9	80	0.1125000
NODE_2093_length_1569_cov_53.941497	794	874	13	11	80	0.1375000
NODE_2093_length_1569_cov_53.941497	794	874	14	6	80	0.0750000
NODE_2093_length_1569_cov_53.941497	870	950	2	8	80	0.1000000
NODE_2093_length_1569_cov_53.941497	870	950	3	3	80	0.0375000
NODE_2093_length_1569_cov_53.941497	870	950	4	47	80	0.5875000
NODE_2093_length_1569_cov_53.941497	870	950	5	12	80	0.1500000
NODE_2093_length_1569_cov_53.941497	870	950	6	10	80	0.1250000
NODE_2093_length_1569_cov_53.941497	923	1003	4	43	80	0.5375000
NODE_2093_length_1569_cov_53.941497	923	1003	5	30	80	0.3750000
NODE_2093_length_1569_cov_53.941497	923	1003	6	7	80	0.0875000
NODE_2094_length_1569_cov_12.426531	640	720	2	47	80	0.5875000
NODE_2094_length_1569_cov_12.426531	640	720	3	4	80	0.0500000
NODE_2094_length_1569_cov_12.426531	640	720	4	29	80	0.3625000
NODE_2094_length_1569_cov_12.426531	693	773	4	45	80	0.5625000
NODE_2094_length_1569_cov_12.426531	693	773	5	35	80	0.4375000
NODE_2094_length_1569_cov_12.426531	769	849	2	8	80	0.1000000
NODE_2094_length_1569_cov_12.426531	769	849	3	5	80	0.0625000
NODE_2094_length_1569_cov_12.426531	769	849	4	58	80	0.7250000
NODE_2094_length_1569_cov_12.426531	769	849	5	9	80	0.1125000
NODE_2094_length_1569_cov_12.426531	822	902	1	14	80	0.1750000
NODE_2094_length_1569_cov_12.426531	822	902	2	47	80	0.5875000
NODE_2094_length_1569_cov_12.426531	822	902	3	4	80	0.0500000
NODE_2094_length_1569_cov_12.426531	822	902	4	15	80	0.1875000
NODE_2095_length_1569_cov_12.365986	450	530	5	1	80	0.0125000
NODE_2095_length_1569_cov_12.365986	450	530	6	6	80	0.0750000
NODE_2095_length_1569_cov_12.365986	450	530	7	24	80	0.3000000
NODE_2095_length_1569_cov_12.365986	450	530	8	15	80	0.1875000
NODE_2095_length_1569_cov_12.365986	450	530	9	14	80	0.1750000
NODE_2095_length_1569_cov_12.365986	450	530	10	12	80	0.1500000
NODE_2095_length_1569_cov_12.365986	450	530	12	8	80	0.1000000
NODE_2095_length_1569_cov_12.365986	450	530	5	1	80	0.0125000
NODE_2095_length_1569_cov_12.365986	450	530	6	6	80	0.0750000
NODE_2095_length_1569_cov_12.365986	450	530	7	24	80	0.3000000
NODE_2095_length_1569_cov_12.365986	450	530	8	15	80	0.1875000
NODE_2095_length_1569_cov_12.365986	450	530	9	14	80	0.1750000
NODE_2095_length_1569_cov_12.365986	450	530	10	12	80	0.1500000
NODE_2095_length_1569_cov_12.365986	450	530	12	8	80	0.1000000
NODE_2095_length_1569_cov_12.365986	503	564	9	7	61	0.1147541
NODE_2095_length_1569_cov_12.365986	503	564	10	24	61	0.3934426
NODE_2095_length_1569_cov_12.365986	503	564	12	30	61	0.4918033
NODE_2095_length_1569_cov_12.365986	503	556	9	7	53	0.1320755
NODE_2095_length_1569_cov_12.365986	503	556	10	16	53	0.3018868
NODE_2095_length_1569_cov_12.365986	503	556	12	30	53	0.5660377
NODE_2096_length_1569_cov_11.599320	798	878	6	19	80	0.2375000
NODE_2096_length_1569_cov_11.599320	798	878	7	11	80	0.1375000
NODE_2096_length_1569_cov_11.599320	798	878	8	37	80	0.4625000
NODE_2096_length_1569_cov_11.599320	798	878	9	13	80	0.1625000
NODE_2096_length_1569_cov_11.599320	851	931	6	4	80	0.0500000
NODE_2096_length_1569_cov_11.599320	851	931	8	28	80	0.3500000
NODE_2096_length_1569_cov_11.599320	851	931	9	9	80	0.1125000
NODE_2096_length_1569_cov_11.599320	851	931	10	26	80	0.3250000
NODE_2096_length_1569_cov_11.599320	851	931	11	1	80	0.0125000
NODE_2096_length_1569_cov_11.599320	851	931	12	9	80	0.1125000
NODE_2096_length_1569_cov_11.599320	851	931	13	1	80	0.0125000
NODE_2096_length_1569_cov_11.599320	851	931	14	2	80	0.0250000
NODE_2097_length_1569_cov_10.917687	521	601	0	80	80	1.0000000
NODE_2097_length_1569_cov_10.917687	574	654	0	80	80	1.0000000
NODE_2108_length_1563_cov_15.357240	590	670	3	25	80	0.3125000
NODE_2108_length_1563_cov_15.357240	590	670	4	7	80	0.0875000
NODE_2108_length_1563_cov_15.357240	590	670	6	4	80	0.0500000
NODE_2108_length_1563_cov_15.357240	590	670	8	44	80	0.5500000
NODE_2108_length_1563_cov_15.357240	643	723	7	6	80	0.0750000
NODE_2108_length_1563_cov_15.357240	643	723	8	40	80	0.5000000
NODE_2108_length_1563_cov_15.357240	643	723	9	34	80	0.4250000
NODE_2110_length_1561_cov_18.420657	354	434	2	80	80	1.0000000
NODE_2110_length_1561_cov_18.420657	407	487	2	75	80	0.9375000
NODE_2110_length_1561_cov_18.420657	407	487	3	5	80	0.0625000
NODE_2110_length_1561_cov_18.420657	483	563	1	21	80	0.2625000
NODE_2110_length_1561_cov_18.420657	483	563	2	30	80	0.3750000
NODE_2110_length_1561_cov_18.420657	483	563	3	4	80	0.0500000
NODE_2110_length_1561_cov_18.420657	483	563	5	20	80	0.2500000
NODE_2110_length_1561_cov_18.420657	483	563	7	5	80	0.0625000
NODE_2110_length_1561_cov_18.420657	536	616	3	2	80	0.0250000
NODE_2110_length_1561_cov_18.420657	536	616	5	20	80	0.2500000
NODE_2110_length_1561_cov_18.420657	536	616	7	56	80	0.7000000
NODE_2110_length_1561_cov_18.420657	536	616	8	2	80	0.0250000
NODE_2116_length_1559_cov_7.071233	347	427	3	50	80	0.6250000
NODE_2116_length_1559_cov_7.071233	347	427	4	29	80	0.3625000
NODE_2116_length_1559_cov_7.071233	347	427	5	1	80	0.0125000
NODE_2116_length_1559_cov_7.071233	400	478	1	33	78	0.4230769
NODE_2116_length_1559_cov_7.071233	400	478	2	1	78	0.0128205
NODE_2116_length_1559_cov_7.071233	400	478	3	44	78	0.5641026
NODE_2116_length_1559_cov_7.071233	1187	1238	0	51	51	1.0000000
NODE_2118_length_1558_cov_3.486635	338	418	2	2	80	0.0250000
NODE_2118_length_1558_cov_3.486635	338	418	4	78	80	0.9750000
NODE_2118_length_1558_cov_3.486635	391	471	0	9	80	0.1125000
NODE_2118_length_1558_cov_3.486635	391	471	2	46	80	0.5750000
NODE_2118_length_1558_cov_3.486635	391	471	4	25	80	0.3125000
NODE_2119_length_1557_cov_17.089163	542	622	11	3	80	0.0375000
NODE_2119_length_1557_cov_17.089163	542	622	13	5	80	0.0625000
NODE_2119_length_1557_cov_17.089163	542	622	14	4	80	0.0500000
NODE_2119_length_1557_cov_17.089163	542	622	15	1	80	0.0125000
NODE_2119_length_1557_cov_17.089163	542	622	16	24	80	0.3000000
NODE_2119_length_1557_cov_17.089163	542	622	17	10	80	0.1250000
NODE_2119_length_1557_cov_17.089163	542	622	18	26	80	0.3250000
NODE_2119_length_1557_cov_17.089163	542	622	19	5	80	0.0625000
NODE_2119_length_1557_cov_17.089163	542	622	20	2	80	0.0250000
NODE_2119_length_1557_cov_17.089163	595	675	6	2	80	0.0250000
NODE_2119_length_1557_cov_17.089163	595	675	7	7	80	0.0875000
NODE_2119_length_1557_cov_17.089163	595	675	8	3	80	0.0375000
NODE_2119_length_1557_cov_17.089163	595	675	9	14	80	0.1750000
NODE_2119_length_1557_cov_17.089163	595	675	10	24	80	0.3000000
NODE_2119_length_1557_cov_17.089163	595	675	11	6	80	0.0750000
NODE_2119_length_1557_cov_17.089163	595	675	13	5	80	0.0625000
NODE_2119_length_1557_cov_17.089163	595	675	14	4	80	0.0500000
NODE_2119_length_1557_cov_17.089163	595	675	15	1	80	0.0125000
NODE_2119_length_1557_cov_17.089163	595	675	16	8	80	0.1000000
NODE_2119_length_1557_cov_17.089163	595	675	17	3	80	0.0375000
NODE_2119_length_1557_cov_17.089163	595	675	18	3	80	0.0375000
NODE_2120_length_1557_cov_4.639918	0	56	0	56	56	1.0000000
NODE_2120_length_1557_cov_4.639918	49	112	0	63	63	1.0000000
NODE_2120_length_1557_cov_4.639918	85	161	0	76	76	1.0000000
NODE_2123_length_1556_cov_23.289636	456	536	4	3	80	0.0375000
NODE_2123_length_1556_cov_23.289636	456	536	5	4	80	0.0500000
NODE_2123_length_1556_cov_23.289636	456	536	6	18	80	0.2250000
NODE_2123_length_1556_cov_23.289636	456	536	7	7	80	0.0875000
NODE_2123_length_1556_cov_23.289636	456	536	8	48	80	0.6000000
NODE_2123_length_1556_cov_23.289636	509	589	2	19	80	0.2375000
NODE_2123_length_1556_cov_23.289636	509	589	4	7	80	0.0875000
NODE_2123_length_1556_cov_23.289636	509	589	6	24	80	0.3000000
NODE_2123_length_1556_cov_23.289636	509	589	7	10	80	0.1250000
NODE_2123_length_1556_cov_23.289636	509	589	8	20	80	0.2500000
NODE_2123_length_1556_cov_23.289636	681	761	2	16	80	0.2000000
NODE_2123_length_1556_cov_23.289636	681	761	4	64	80	0.8000000
NODE_2123_length_1556_cov_23.289636	734	814	4	80	80	1.0000000
NODE_2123_length_1556_cov_23.289636	1445	1525	8	4	80	0.0500000
NODE_2123_length_1556_cov_23.289636	1445	1525	10	76	80	0.9500000
NODE_2124_length_1556_cov_7.494166	300	380	1	4	80	0.0500000
NODE_2124_length_1556_cov_7.494166	300	380	2	18	80	0.2250000
NODE_2124_length_1556_cov_7.494166	300	380	4	28	80	0.3500000
NODE_2124_length_1556_cov_7.494166	300	380	6	15	80	0.1875000
NODE_2124_length_1556_cov_7.494166	300	380	7	15	80	0.1875000
NODE_2124_length_1556_cov_7.494166	353	433	6	46	80	0.5750000
NODE_2124_length_1556_cov_7.494166	353	433	7	18	80	0.2250000
NODE_2124_length_1556_cov_7.494166	353	433	8	16	80	0.2000000
NODE_2126_length_1555_cov_13.461538	666	746	6	48	80	0.6000000
NODE_2126_length_1555_cov_13.461538	666	746	7	2	80	0.0250000
NODE_2126_length_1555_cov_13.461538	666	746	8	11	80	0.1375000
NODE_2126_length_1555_cov_13.461538	666	746	9	19	80	0.2375000
NODE_2126_length_1555_cov_13.461538	719	799	5	11	80	0.1375000
NODE_2126_length_1555_cov_13.461538	719	799	7	17	80	0.2125000
NODE_2126_length_1555_cov_13.461538	719	799	8	29	80	0.3625000
NODE_2126_length_1555_cov_13.461538	719	799	9	23	80	0.2875000
NODE_2127_length_1554_cov_30.239175	144	226	0	42	82	0.5121951
NODE_2127_length_1554_cov_30.239175	144	226	1	23	82	0.2804878
NODE_2127_length_1554_cov_30.239175	144	226	2	3	82	0.0365854
NODE_2127_length_1554_cov_30.239175	144	226	3	14	82	0.1707317
NODE_2127_length_1554_cov_30.239175	199	279	1	10	80	0.1250000
NODE_2127_length_1554_cov_30.239175	199	279	2	3	80	0.0375000
NODE_2127_length_1554_cov_30.239175	199	279	3	14	80	0.1750000
NODE_2127_length_1554_cov_30.239175	199	279	4	38	80	0.4750000
NODE_2127_length_1554_cov_30.239175	199	279	5	1	80	0.0125000
NODE_2127_length_1554_cov_30.239175	199	279	6	3	80	0.0375000
NODE_2127_length_1554_cov_30.239175	199	279	9	9	80	0.1125000
NODE_2127_length_1554_cov_30.239175	199	279	10	2	80	0.0250000
NODE_2127_length_1554_cov_30.239175	877	903	4	26	26	1.0000000
NODE_2127_length_1554_cov_30.239175	930	1010	9	1	80	0.0125000
NODE_2127_length_1554_cov_30.239175	930	1010	10	1	80	0.0125000
NODE_2127_length_1554_cov_30.239175	930	1010	11	8	80	0.1000000
NODE_2127_length_1554_cov_30.239175	930	1010	13	57	80	0.7125000
NODE_2127_length_1554_cov_30.239175	930	1010	14	13	80	0.1625000
NODE_2127_length_1554_cov_30.239175	983	1063	7	38	80	0.4750000
NODE_2127_length_1554_cov_30.239175	983	1063	9	2	80	0.0250000
NODE_2127_length_1554_cov_30.239175	983	1063	11	12	80	0.1500000
NODE_2127_length_1554_cov_30.239175	983	1063	12	1	80	0.0125000
NODE_2127_length_1554_cov_30.239175	983	1063	13	27	80	0.3375000
NODE_2128_length_1554_cov_5.381443	1494	1554	0	4	60	0.0666667
NODE_2128_length_1554_cov_5.381443	1494	1554	1	6	60	0.1000000
NODE_2128_length_1554_cov_5.381443	1494	1554	3	28	60	0.4666667
NODE_2128_length_1554_cov_5.381443	1494	1554	4	22	60	0.3666667
NODE_2132_length_1552_cov_11.367515	379	445	3	66	66	1.0000000
NODE_2132_length_1552_cov_11.367515	418	484	2	1	66	0.0151515
NODE_2132_length_1552_cov_11.367515	418	484	3	65	66	0.9848485
NODE_2138_length_1549_cov_15.480000	1288	1368	0	27	80	0.3375000
NODE_2138_length_1549_cov_15.480000	1288	1368	2	53	80	0.6625000
NODE_2138_length_1549_cov_15.480000	1341	1421	2	80	80	1.0000000
NODE_2142_length_1548_cov_12.789510	770	850	1	3	80	0.0375000
NODE_2142_length_1548_cov_12.789510	770	850	2	42	80	0.5250000
NODE_2142_length_1548_cov_12.789510	770	850	3	5	80	0.0625000
NODE_2142_length_1548_cov_12.789510	770	850	4	30	80	0.3750000
NODE_2142_length_1548_cov_12.789510	823	903	3	5	80	0.0625000
NODE_2142_length_1548_cov_12.789510	823	903	4	75	80	0.9375000
NODE_2149_length_1546_cov_24.069800	775	855	3	2	80	0.0250000
NODE_2149_length_1546_cov_24.069800	775	855	4	5	80	0.0625000
NODE_2149_length_1546_cov_24.069800	775	855	5	4	80	0.0500000
NODE_2149_length_1546_cov_24.069800	775	855	7	69	80	0.8625000
NODE_2149_length_1546_cov_24.069800	828	908	2	22	80	0.2750000
NODE_2149_length_1546_cov_24.069800	828	908	3	7	80	0.0875000
NODE_2149_length_1546_cov_24.069800	828	908	5	27	80	0.3375000
NODE_2149_length_1546_cov_24.069800	828	908	7	24	80	0.3000000
NODE_2150_length_1546_cov_10.911541	417	497	1	64	80	0.8000000
NODE_2150_length_1546_cov_10.911541	417	497	3	16	80	0.2000000
NODE_2150_length_1546_cov_10.911541	470	550	1	11	80	0.1375000
NODE_2150_length_1546_cov_10.911541	470	550	3	69	80	0.8625000
NODE_2150_length_1546_cov_10.911541	1065	1145	0	49	80	0.6125000
NODE_2150_length_1546_cov_10.911541	1065	1145	1	31	80	0.3875000
NODE_2150_length_1546_cov_10.911541	1118	1198	0	70	80	0.8750000
NODE_2150_length_1546_cov_10.911541	1118	1198	1	10	80	0.1250000
NODE_2155_length_1543_cov_10.400970	480	560	6	3	80	0.0375000
NODE_2155_length_1543_cov_10.400970	480	560	7	28	80	0.3500000
NODE_2155_length_1543_cov_10.400970	480	560	8	49	80	0.6125000
NODE_2155_length_1543_cov_10.400970	533	613	4	14	80	0.1750000
NODE_2155_length_1543_cov_10.400970	533	613	5	4	80	0.0500000
NODE_2155_length_1543_cov_10.400970	533	613	7	38	80	0.4750000
NODE_2155_length_1543_cov_10.400970	533	613	8	24	80	0.3000000
NODE_2156_length_1543_cov_4.532548	43	98	0	55	55	1.0000000
NODE_2162_length_1541_cov_7.316921	523	603	4	13	80	0.1625000
NODE_2162_length_1541_cov_7.316921	523	603	7	54	80	0.6750000
NODE_2162_length_1541_cov_7.316921	523	603	8	13	80	0.1625000
NODE_2162_length_1541_cov_7.316921	576	658	3	1	82	0.0121951
NODE_2162_length_1541_cov_7.316921	576	658	4	17	82	0.2073171
NODE_2162_length_1541_cov_7.316921	576	658	5	15	82	0.1829268
NODE_2162_length_1541_cov_7.316921	576	658	6	15	82	0.1829268
NODE_2162_length_1541_cov_7.316921	576	658	7	34	82	0.4146341
NODE_2165_length_1539_cov_19.067361	334	414	2	37	80	0.4625000
NODE_2165_length_1539_cov_19.067361	334	414	4	43	80	0.5375000
NODE_2165_length_1539_cov_19.067361	387	467	3	21	80	0.2625000
NODE_2165_length_1539_cov_19.067361	387	467	4	59	80	0.7375000
NODE_2165_length_1539_cov_19.067361	463	543	3	4	80	0.0500000
NODE_2165_length_1539_cov_19.067361	463	543	4	45	80	0.5625000
NODE_2165_length_1539_cov_19.067361	463	543	5	10	80	0.1250000
NODE_2165_length_1539_cov_19.067361	463	543	6	10	80	0.1250000
NODE_2165_length_1539_cov_19.067361	463	543	7	11	80	0.1375000
NODE_2165_length_1539_cov_19.067361	516	596	4	1	80	0.0125000
NODE_2165_length_1539_cov_19.067361	516	596	5	10	80	0.1250000
NODE_2165_length_1539_cov_19.067361	516	596	6	11	80	0.1375000
NODE_2165_length_1539_cov_19.067361	516	596	7	46	80	0.5750000
NODE_2165_length_1539_cov_19.067361	516	596	9	12	80	0.1500000
NODE_2171_length_1538_cov_68.273801	604	684	15	1	80	0.0125000
NODE_2171_length_1538_cov_68.273801	604	684	16	1	80	0.0125000
NODE_2171_length_1538_cov_68.273801	604	684	18	5	80	0.0625000
NODE_2171_length_1538_cov_68.273801	604	684	19	3	80	0.0375000
NODE_2171_length_1538_cov_68.273801	604	684	20	9	80	0.1125000
NODE_2171_length_1538_cov_68.273801	604	684	21	1	80	0.0125000
NODE_2171_length_1538_cov_68.273801	604	684	24	10	80	0.1250000
NODE_2171_length_1538_cov_68.273801	604	684	25	14	80	0.1750000
NODE_2171_length_1538_cov_68.273801	604	684	26	5	80	0.0625000
NODE_2171_length_1538_cov_68.273801	604	684	27	14	80	0.1750000
NODE_2171_length_1538_cov_68.273801	604	684	28	8	80	0.1000000
NODE_2171_length_1538_cov_68.273801	604	684	29	2	80	0.0250000
NODE_2171_length_1538_cov_68.273801	604	684	30	7	80	0.0875000
NODE_2171_length_1538_cov_68.273801	657	737	8	1	80	0.0125000
NODE_2171_length_1538_cov_68.273801	657	737	9	19	80	0.2375000
NODE_2171_length_1538_cov_68.273801	657	737	10	4	80	0.0500000
NODE_2171_length_1538_cov_68.273801	657	737	11	3	80	0.0375000
NODE_2171_length_1538_cov_68.273801	657	737	12	12	80	0.1500000
NODE_2171_length_1538_cov_68.273801	657	737	13	6	80	0.0750000
NODE_2171_length_1538_cov_68.273801	657	737	14	3	80	0.0375000
NODE_2171_length_1538_cov_68.273801	657	737	15	6	80	0.0750000
NODE_2171_length_1538_cov_68.273801	657	737	16	1	80	0.0125000
NODE_2171_length_1538_cov_68.273801	657	737	18	5	80	0.0625000
NODE_2171_length_1538_cov_68.273801	657	737	19	3	80	0.0375000
NODE_2171_length_1538_cov_68.273801	657	737	20	9	80	0.1125000
NODE_2171_length_1538_cov_68.273801	657	737	21	1	80	0.0125000
NODE_2171_length_1538_cov_68.273801	657	737	24	7	80	0.0875000
NODE_2172_length_1538_cov_2.402363	1456	1499	0	43	43	1.0000000
NODE_2173_length_1537_cov_39.413074	782	862	3	16	80	0.2000000
NODE_2173_length_1537_cov_39.413074	782	862	4	17	80	0.2125000
NODE_2173_length_1537_cov_39.413074	782	862	5	5	80	0.0625000
NODE_2173_length_1537_cov_39.413074	782	862	6	32	80	0.4000000
NODE_2173_length_1537_cov_39.413074	782	862	7	10	80	0.1250000
NODE_2173_length_1537_cov_39.413074	835	915	5	5	80	0.0625000
NODE_2173_length_1537_cov_39.413074	835	915	6	12	80	0.1500000
NODE_2173_length_1537_cov_39.413074	835	915	7	13	80	0.1625000
NODE_2173_length_1537_cov_39.413074	835	915	8	17	80	0.2125000
NODE_2173_length_1537_cov_39.413074	835	915	9	1	80	0.0125000
NODE_2173_length_1537_cov_39.413074	835	915	12	32	80	0.4000000
NODE_2173_length_1537_cov_39.413074	911	991	10	3	80	0.0375000
NODE_2173_length_1537_cov_39.413074	911	991	11	38	80	0.4750000
NODE_2173_length_1537_cov_39.413074	911	991	12	39	80	0.4875000
NODE_2173_length_1537_cov_39.413074	964	1044	2	10	80	0.1250000
NODE_2173_length_1537_cov_39.413074	964	1044	4	5	80	0.0625000
NODE_2173_length_1537_cov_39.413074	964	1044	5	11	80	0.1375000
NODE_2173_length_1537_cov_39.413074	964	1044	9	3	80	0.0375000
NODE_2173_length_1537_cov_39.413074	964	1044	10	13	80	0.1625000
NODE_2173_length_1537_cov_39.413074	964	1044	11	24	80	0.3000000
NODE_2173_length_1537_cov_39.413074	964	1044	12	14	80	0.1750000
NODE_2174_length_1537_cov_30.412378	739	819	13	1	80	0.0125000
NODE_2174_length_1537_cov_30.412378	739	819	15	8	80	0.1000000
NODE_2174_length_1537_cov_30.412378	739	819	16	3	80	0.0375000
NODE_2174_length_1537_cov_30.412378	739	819	17	4	80	0.0500000
NODE_2174_length_1537_cov_30.412378	739	819	18	3	80	0.0375000
NODE_2174_length_1537_cov_30.412378	739	819	19	34	80	0.4250000
NODE_2174_length_1537_cov_30.412378	739	819	20	25	80	0.3125000
NODE_2174_length_1537_cov_30.412378	739	819	21	2	80	0.0250000
NODE_2174_length_1537_cov_30.412378	792	872	9	5	80	0.0625000
NODE_2174_length_1537_cov_30.412378	792	872	10	4	80	0.0500000
NODE_2174_length_1537_cov_30.412378	792	872	11	4	80	0.0500000
NODE_2174_length_1537_cov_30.412378	792	872	12	6	80	0.0750000
NODE_2174_length_1537_cov_30.412378	792	872	13	5	80	0.0625000
NODE_2174_length_1537_cov_30.412378	792	872	14	3	80	0.0375000
NODE_2174_length_1537_cov_30.412378	792	872	15	1	80	0.0125000
NODE_2174_length_1537_cov_30.412378	792	872	17	8	80	0.1000000
NODE_2174_length_1537_cov_30.412378	792	872	18	6	80	0.0750000
NODE_2174_length_1537_cov_30.412378	792	872	19	33	80	0.4125000
NODE_2174_length_1537_cov_30.412378	792	872	20	5	80	0.0625000
NODE_2174_length_1537_cov_30.412378	868	948	2	6	80	0.0750000
NODE_2174_length_1537_cov_30.412378	868	948	3	12	80	0.1500000
NODE_2174_length_1537_cov_30.412378	868	948	4	20	80	0.2500000
NODE_2174_length_1537_cov_30.412378	868	948	5	9	80	0.1125000
NODE_2174_length_1537_cov_30.412378	868	948	6	3	80	0.0375000
NODE_2174_length_1537_cov_30.412378	868	948	7	13	80	0.1625000
NODE_2174_length_1537_cov_30.412378	868	948	8	6	80	0.0750000
NODE_2174_length_1537_cov_30.412378	868	948	9	11	80	0.1375000
NODE_2174_length_1537_cov_30.412378	921	1001	2	5	80	0.0625000
NODE_2174_length_1537_cov_30.412378	921	1001	3	25	80	0.3125000
NODE_2174_length_1537_cov_30.412378	921	1001	4	45	80	0.5625000
NODE_2174_length_1537_cov_30.412378	921	1001	5	5	80	0.0625000
NODE_2175_length_1537_cov_18.707232	669	749	7	23	80	0.2875000
NODE_2175_length_1537_cov_18.707232	669	749	8	33	80	0.4125000
NODE_2175_length_1537_cov_18.707232	669	749	9	5	80	0.0625000
NODE_2175_length_1537_cov_18.707232	669	749	10	19	80	0.2375000
NODE_2175_length_1537_cov_18.707232	722	802	3	9	80	0.1125000
NODE_2175_length_1537_cov_18.707232	722	802	4	4	80	0.0500000
NODE_2175_length_1537_cov_18.707232	722	802	5	2	80	0.0250000
NODE_2175_length_1537_cov_18.707232	722	802	6	22	80	0.2750000
NODE_2175_length_1537_cov_18.707232	722	802	7	28	80	0.3500000
NODE_2175_length_1537_cov_18.707232	722	802	8	8	80	0.1000000
NODE_2175_length_1537_cov_18.707232	722	802	10	7	80	0.0875000
NODE_2176_length_1536_cov_24.991649	832	912	0	36	80	0.4500000
NODE_2176_length_1536_cov_24.991649	832	912	2	44	80	0.5500000
NODE_2176_length_1536_cov_24.991649	885	965	2	57	80	0.7125000
NODE_2176_length_1536_cov_24.991649	885	965	3	23	80	0.2875000
NODE_2176_length_1536_cov_24.991649	961	1041	3	7	80	0.0875000
NODE_2176_length_1536_cov_24.991649	961	1041	4	16	80	0.2000000
NODE_2176_length_1536_cov_24.991649	961	1041	6	26	80	0.3250000
NODE_2176_length_1536_cov_24.991649	961	1041	8	31	80	0.3875000
NODE_2176_length_1536_cov_24.991649	1014	1094	3	2	80	0.0250000
NODE_2176_length_1536_cov_24.991649	1014	1094	4	16	80	0.2000000
NODE_2176_length_1536_cov_24.991649	1014	1094	6	58	80	0.7250000
NODE_2176_length_1536_cov_24.991649	1014	1094	8	4	80	0.0500000
NODE_2183_length_1535_cov_46.662256	992	1072	4	2	80	0.0250000
NODE_2183_length_1535_cov_46.662256	992	1072	6	30	80	0.3750000
NODE_2183_length_1535_cov_46.662256	992	1072	8	5	80	0.0625000
NODE_2183_length_1535_cov_46.662256	992	1072	10	22	80	0.2750000
NODE_2183_length_1535_cov_46.662256	992	1072	11	21	80	0.2625000
NODE_2183_length_1535_cov_46.662256	1045	1125	8	1	80	0.0125000
NODE_2183_length_1535_cov_46.662256	1045	1125	9	9	80	0.1125000
NODE_2183_length_1535_cov_46.662256	1045	1125	10	38	80	0.4750000
NODE_2183_length_1535_cov_46.662256	1045	1125	11	32	80	0.4000000
NODE_2183_length_1535_cov_46.662256	1127	1203	5	1	76	0.0131579
NODE_2183_length_1535_cov_46.662256	1127	1203	7	55	76	0.7236842
NODE_2183_length_1535_cov_46.662256	1127	1203	9	15	76	0.1973684
NODE_2183_length_1535_cov_46.662256	1127	1203	10	1	76	0.0131579
NODE_2183_length_1535_cov_46.662256	1127	1203	11	4	76	0.0526316
NODE_2183_length_1535_cov_46.662256	1176	1256	4	1	80	0.0125000
NODE_2183_length_1535_cov_46.662256	1176	1256	5	14	80	0.1750000
NODE_2183_length_1535_cov_46.662256	1176	1256	6	37	80	0.4625000
NODE_2183_length_1535_cov_46.662256	1176	1256	7	28	80	0.3500000
NODE_2184_length_1535_cov_32.610724	992	1072	0	21	80	0.2625000
NODE_2184_length_1535_cov_32.610724	992	1072	1	46	80	0.5750000
NODE_2184_length_1535_cov_32.610724	992	1072	2	13	80	0.1625000
NODE_2184_length_1535_cov_32.610724	1045	1125	1	14	80	0.1750000
NODE_2184_length_1535_cov_32.610724	1045	1125	2	23	80	0.2875000
NODE_2184_length_1535_cov_32.610724	1045	1125	3	2	80	0.0250000
NODE_2184_length_1535_cov_32.610724	1045	1125	4	13	80	0.1625000
NODE_2184_length_1535_cov_32.610724	1045	1125	5	9	80	0.1125000
NODE_2184_length_1535_cov_32.610724	1045	1125	7	4	80	0.0500000
NODE_2184_length_1535_cov_32.610724	1045	1125	8	15	80	0.1875000
NODE_2184_length_1535_cov_32.610724	1121	1201	8	27	80	0.3375000
NODE_2184_length_1535_cov_32.610724	1121	1201	9	3	80	0.0375000
NODE_2184_length_1535_cov_32.610724	1121	1201	10	6	80	0.0750000
NODE_2184_length_1535_cov_32.610724	1121	1201	11	11	80	0.1375000
NODE_2184_length_1535_cov_32.610724	1121	1201	12	15	80	0.1875000
NODE_2184_length_1535_cov_32.610724	1121	1201	13	18	80	0.2250000
NODE_2184_length_1535_cov_32.610724	1174	1254	8	4	80	0.0500000
NODE_2184_length_1535_cov_32.610724	1174	1254	9	6	80	0.0750000
NODE_2184_length_1535_cov_32.610724	1174	1254	10	8	80	0.1000000
NODE_2184_length_1535_cov_32.610724	1174	1254	11	4	80	0.0500000
NODE_2184_length_1535_cov_32.610724	1174	1254	12	32	80	0.4000000
NODE_2184_length_1535_cov_32.610724	1174	1254	13	26	80	0.3250000
NODE_2185_length_1535_cov_25.406685	619	699	3	10	80	0.1250000
NODE_2185_length_1535_cov_25.406685	619	699	5	14	80	0.1750000
NODE_2185_length_1535_cov_25.406685	619	699	6	30	80	0.3750000
NODE_2185_length_1535_cov_25.406685	619	699	7	26	80	0.3250000
NODE_2185_length_1535_cov_25.406685	672	752	5	4	80	0.0500000
NODE_2185_length_1535_cov_25.406685	672	752	6	54	80	0.6750000
NODE_2185_length_1535_cov_25.406685	672	752	7	15	80	0.1875000
NODE_2185_length_1535_cov_25.406685	672	752	8	7	80	0.0875000
NODE_2190_length_1534_cov_13.542857	439	519	3	34	80	0.4250000
NODE_2190_length_1534_cov_13.542857	439	519	5	32	80	0.4000000
NODE_2190_length_1534_cov_13.542857	439	519	6	14	80	0.1750000
NODE_2190_length_1534_cov_13.542857	492	567	5	29	75	0.3866667
NODE_2190_length_1534_cov_13.542857	492	567	6	46	75	0.6133333
NODE_2197_length_1531_cov_17.336592	324	404	0	32	80	0.4000000
NODE_2197_length_1531_cov_17.336592	324	404	1	36	80	0.4500000
NODE_2197_length_1531_cov_17.336592	324	404	2	12	80	0.1500000
NODE_2198_length_1531_cov_6.267458	606	686	0	21	80	0.2625000
NODE_2198_length_1531_cov_6.267458	606	686	2	59	80	0.7375000
NODE_2198_length_1531_cov_6.267458	659	739	0	74	80	0.9250000
NODE_2198_length_1531_cov_6.267458	659	739	2	6	80	0.0750000
NODE_2199_length_1530_cov_13.514326	323	403	1	17	80	0.2125000
NODE_2199_length_1530_cov_13.514326	323	403	2	21	80	0.2625000
NODE_2199_length_1530_cov_13.514326	323	403	3	42	80	0.5250000
NODE_2199_length_1530_cov_13.514326	376	456	3	80	80	1.0000000
NODE_2199_length_1530_cov_13.514326	1465	1513	0	48	48	1.0000000
NODE_2200_length_1530_cov_9.012579	637	717	4	20	80	0.2500000
NODE_2200_length_1530_cov_9.012579	637	717	5	42	80	0.5250000
NODE_2200_length_1530_cov_9.012579	637	717	6	12	80	0.1500000
NODE_2200_length_1530_cov_9.012579	637	717	7	6	80	0.0750000
NODE_2200_length_1530_cov_9.012579	690	770	3	10	80	0.1250000
NODE_2200_length_1530_cov_9.012579	690	770	4	45	80	0.5625000
NODE_2200_length_1530_cov_9.012579	690	770	5	25	80	0.3125000
NODE_2203_length_1529_cov_21.061538	983	1063	7	20	80	0.2500000
NODE_2203_length_1529_cov_21.061538	983	1063	8	30	80	0.3750000
NODE_2203_length_1529_cov_21.061538	983	1063	9	30	80	0.3750000
NODE_2203_length_1529_cov_21.061538	1036	1116	3	1	80	0.0125000
NODE_2203_length_1529_cov_21.061538	1036	1116	4	21	80	0.2625000
NODE_2203_length_1529_cov_21.061538	1036	1116	5	5	80	0.0625000
NODE_2203_length_1529_cov_21.061538	1036	1116	6	3	80	0.0375000
NODE_2203_length_1529_cov_21.061538	1036	1116	8	43	80	0.5375000
NODE_2203_length_1529_cov_21.061538	1036	1116	9	7	80	0.0875000
NODE_2205_length_1529_cov_1.380420	219	282	0	63	63	1.0000000
NODE_2205_length_1529_cov_1.380420	272	323	0	51	51	1.0000000
NODE_2206_length_1528_cov_8.578027	449	529	4	80	80	1.0000000
NODE_2206_length_1528_cov_8.578027	502	582	1	1	80	0.0125000
NODE_2206_length_1528_cov_8.578027	502	582	2	28	80	0.3500000
NODE_2206_length_1528_cov_8.578027	502	582	4	51	80	0.6375000
NODE_2210_length_1526_cov_92.265592	986	1066	5	56	80	0.7000000
NODE_2210_length_1526_cov_92.265592	986	1066	6	24	80	0.3000000
NODE_2210_length_1526_cov_92.265592	1039	1119	3	3	80	0.0375000
NODE_2210_length_1526_cov_92.265592	1039	1119	4	38	80	0.4750000
NODE_2210_length_1526_cov_92.265592	1039	1119	5	3	80	0.0375000
NODE_2210_length_1526_cov_92.265592	1039	1119	6	36	80	0.4500000
NODE_2211_length_1526_cov_4.051857	291	370	2	5	79	0.0632911
NODE_2211_length_1526_cov_4.051857	291	370	4	74	79	0.9367089
NODE_2213_length_1525_cov_20.232118	1014	1090	30	6	76	0.0789474
NODE_2213_length_1525_cov_20.232118	1014	1090	31	3	76	0.0394737
NODE_2213_length_1525_cov_20.232118	1014	1090	32	1	76	0.0131579
NODE_2213_length_1525_cov_20.232118	1014	1090	34	5	76	0.0657895
NODE_2213_length_1525_cov_20.232118	1014	1090	36	3	76	0.0394737
NODE_2213_length_1525_cov_20.232118	1014	1090	38	9	76	0.1184211
NODE_2213_length_1525_cov_20.232118	1014	1090	40	5	76	0.0657895
NODE_2213_length_1525_cov_20.232118	1014	1090	41	2	76	0.0263158
NODE_2213_length_1525_cov_20.232118	1014	1090	43	7	76	0.0921053
NODE_2213_length_1525_cov_20.232118	1014	1090	44	4	76	0.0526316
NODE_2213_length_1525_cov_20.232118	1014	1090	45	5	76	0.0657895
NODE_2213_length_1525_cov_20.232118	1014	1090	46	5	76	0.0657895
NODE_2213_length_1525_cov_20.232118	1014	1090	47	13	76	0.1710526
NODE_2213_length_1525_cov_20.232118	1014	1090	48	7	76	0.0921053
NODE_2213_length_1525_cov_20.232118	1014	1090	50	1	76	0.0131579
NODE_2213_length_1525_cov_20.232118	1281	1338	0	57	57	1.0000000
NODE_2214_length_1525_cov_11.421459	804	884	4	37	80	0.4625000
NODE_2214_length_1525_cov_11.421459	804	884	5	23	80	0.2875000
NODE_2214_length_1525_cov_11.421459	804	884	6	20	80	0.2500000
NODE_2214_length_1525_cov_11.421459	857	937	2	32	80	0.4000000
NODE_2214_length_1525_cov_11.421459	857	937	3	17	80	0.2125000
NODE_2214_length_1525_cov_11.421459	857	937	4	31	80	0.3875000
NODE_2217_length_1524_cov_130.874386	171	243	82	3	72	0.0416667
NODE_2217_length_1524_cov_130.874386	171	243	84	4	72	0.0555556
NODE_2217_length_1524_cov_130.874386	171	243	85	2	72	0.0277778
NODE_2217_length_1524_cov_130.874386	171	243	86	1	72	0.0138889
NODE_2217_length_1524_cov_130.874386	171	243	87	4	72	0.0555556
NODE_2217_length_1524_cov_130.874386	171	243	88	1	72	0.0138889
NODE_2217_length_1524_cov_130.874386	171	243	89	1	72	0.0138889
NODE_2217_length_1524_cov_130.874386	171	243	90	7	72	0.0972222
NODE_2217_length_1524_cov_130.874386	171	243	91	1	72	0.0138889
NODE_2217_length_1524_cov_130.874386	171	243	92	5	72	0.0694444
NODE_2217_length_1524_cov_130.874386	171	243	93	1	72	0.0138889
NODE_2217_length_1524_cov_130.874386	171	243	94	7	72	0.0972222
NODE_2217_length_1524_cov_130.874386	171	243	95	9	72	0.1250000
NODE_2217_length_1524_cov_130.874386	171	243	96	13	72	0.1805556
NODE_2217_length_1524_cov_130.874386	171	243	97	2	72	0.0277778
NODE_2217_length_1524_cov_130.874386	171	243	98	2	72	0.0277778
NODE_2217_length_1524_cov_130.874386	171	243	99	4	72	0.0555556
NODE_2217_length_1524_cov_130.874386	171	243	100	5	72	0.0694444
NODE_2217_length_1524_cov_130.874386	191	247	85	2	56	0.0357143
NODE_2217_length_1524_cov_130.874386	191	247	86	1	56	0.0178571
NODE_2217_length_1524_cov_130.874386	191	247	88	1	56	0.0178571
NODE_2217_length_1524_cov_130.874386	191	247	90	3	56	0.0535714
NODE_2217_length_1524_cov_130.874386	191	247	91	1	56	0.0178571
NODE_2217_length_1524_cov_130.874386	191	247	92	5	56	0.0892857
NODE_2217_length_1524_cov_130.874386	191	247	93	1	56	0.0178571
NODE_2217_length_1524_cov_130.874386	191	247	94	7	56	0.1250000
NODE_2217_length_1524_cov_130.874386	191	247	95	9	56	0.1607143
NODE_2217_length_1524_cov_130.874386	191	247	96	13	56	0.2321429
NODE_2217_length_1524_cov_130.874386	191	247	97	2	56	0.0357143
NODE_2217_length_1524_cov_130.874386	191	247	98	2	56	0.0357143
NODE_2217_length_1524_cov_130.874386	191	247	99	4	56	0.0714286
NODE_2217_length_1524_cov_130.874386	191	247	100	5	56	0.0892857
NODE_2217_length_1524_cov_130.874386	219	296	49	1	77	0.0129870
NODE_2217_length_1524_cov_130.874386	219	296	50	2	77	0.0259740
NODE_2217_length_1524_cov_130.874386	219	296	51	2	77	0.0259740
NODE_2217_length_1524_cov_130.874386	219	296	55	2	77	0.0259740
NODE_2217_length_1524_cov_130.874386	219	296	58	2	77	0.0259740
NODE_2217_length_1524_cov_130.874386	219	296	60	1	77	0.0129870
NODE_2217_length_1524_cov_130.874386	219	296	61	6	77	0.0779221
NODE_2217_length_1524_cov_130.874386	219	296	62	1	77	0.0129870
NODE_2217_length_1524_cov_130.874386	219	296	63	1	77	0.0129870
NODE_2217_length_1524_cov_130.874386	219	296	66	1	77	0.0129870
NODE_2217_length_1524_cov_130.874386	219	296	68	6	77	0.0779221
NODE_2217_length_1524_cov_130.874386	219	296	70	2	77	0.0259740
NODE_2217_length_1524_cov_130.874386	219	296	73	1	77	0.0129870
NODE_2217_length_1524_cov_130.874386	219	296	74	2	77	0.0259740
NODE_2217_length_1524_cov_130.874386	219	296	75	3	77	0.0389610
NODE_2217_length_1524_cov_130.874386	219	296	76	2	77	0.0259740
NODE_2217_length_1524_cov_130.874386	219	296	78	2	77	0.0259740
NODE_2217_length_1524_cov_130.874386	219	296	79	6	77	0.0779221
NODE_2217_length_1524_cov_130.874386	219	296	80	2	77	0.0259740
NODE_2217_length_1524_cov_130.874386	219	296	81	1	77	0.0129870
NODE_2217_length_1524_cov_130.874386	219	296	82	1	77	0.0129870
NODE_2217_length_1524_cov_130.874386	219	296	83	2	77	0.0259740
NODE_2217_length_1524_cov_130.874386	219	296	85	2	77	0.0259740
NODE_2217_length_1524_cov_130.874386	219	296	86	1	77	0.0129870
NODE_2217_length_1524_cov_130.874386	219	296	90	2	77	0.0259740
NODE_2217_length_1524_cov_130.874386	219	296	92	2	77	0.0259740
NODE_2217_length_1524_cov_130.874386	219	296	94	5	77	0.0649351
NODE_2217_length_1524_cov_130.874386	219	296	95	1	77	0.0129870
NODE_2217_length_1524_cov_130.874386	219	296	96	2	77	0.0259740
NODE_2217_length_1524_cov_130.874386	219	296	97	2	77	0.0259740
NODE_2217_length_1524_cov_130.874386	219	296	98	2	77	0.0259740
NODE_2217_length_1524_cov_130.874386	219	296	99	4	77	0.0519481
NODE_2217_length_1524_cov_130.874386	219	296	100	5	77	0.0649351
NODE_2217_length_1524_cov_130.874386	253	333	27	4	80	0.0500000
NODE_2217_length_1524_cov_130.874386	253	333	28	3	80	0.0375000
NODE_2217_length_1524_cov_130.874386	253	333	29	1	80	0.0125000
NODE_2217_length_1524_cov_130.874386	253	333	32	4	80	0.0500000
NODE_2217_length_1524_cov_130.874386	253	333	34	5	80	0.0625000
NODE_2217_length_1524_cov_130.874386	253	333	37	1	80	0.0125000
NODE_2217_length_1524_cov_130.874386	253	333	38	2	80	0.0250000
NODE_2217_length_1524_cov_130.874386	253	333	40	1	80	0.0125000
NODE_2217_length_1524_cov_130.874386	253	333	41	6	80	0.0750000
NODE_2217_length_1524_cov_130.874386	253	333	42	4	80	0.0500000
NODE_2217_length_1524_cov_130.874386	253	333	44	5	80	0.0625000
NODE_2217_length_1524_cov_130.874386	253	333	46	1	80	0.0125000
NODE_2217_length_1524_cov_130.874386	253	333	49	1	80	0.0125000
NODE_2217_length_1524_cov_130.874386	253	333	50	2	80	0.0250000
NODE_2217_length_1524_cov_130.874386	253	333	51	2	80	0.0250000
NODE_2217_length_1524_cov_130.874386	253	333	55	2	80	0.0250000
NODE_2217_length_1524_cov_130.874386	253	333	58	2	80	0.0250000
NODE_2217_length_1524_cov_130.874386	253	333	60	1	80	0.0125000
NODE_2217_length_1524_cov_130.874386	253	333	61	6	80	0.0750000
NODE_2217_length_1524_cov_130.874386	253	333	62	1	80	0.0125000
NODE_2217_length_1524_cov_130.874386	253	333	63	1	80	0.0125000
NODE_2217_length_1524_cov_130.874386	253	333	66	1	80	0.0125000
NODE_2217_length_1524_cov_130.874386	253	333	68	6	80	0.0750000
NODE_2217_length_1524_cov_130.874386	253	333	70	2	80	0.0250000
NODE_2217_length_1524_cov_130.874386	253	333	73	1	80	0.0125000
NODE_2217_length_1524_cov_130.874386	253	333	74	2	80	0.0250000
NODE_2217_length_1524_cov_130.874386	253	333	75	3	80	0.0375000
NODE_2217_length_1524_cov_130.874386	253	333	76	2	80	0.0250000
NODE_2217_length_1524_cov_130.874386	253	333	78	2	80	0.0250000
NODE_2217_length_1524_cov_130.874386	253	333	79	4	80	0.0500000
NODE_2217_length_1524_cov_130.874386	253	333	80	2	80	0.0250000
NODE_2217_length_1524_cov_130.874386	306	386	7	4	80	0.0500000
NODE_2217_length_1524_cov_130.874386	306	386	8	7	80	0.0875000
NODE_2217_length_1524_cov_130.874386	306	386	9	1	80	0.0125000
NODE_2217_length_1524_cov_130.874386	306	386	11	1	80	0.0125000
NODE_2217_length_1524_cov_130.874386	306	386	12	1	80	0.0125000
NODE_2217_length_1524_cov_130.874386	306	386	13	1	80	0.0125000
NODE_2217_length_1524_cov_130.874386	306	386	14	4	80	0.0500000
NODE_2217_length_1524_cov_130.874386	306	386	15	1	80	0.0125000
NODE_2217_length_1524_cov_130.874386	306	386	16	2	80	0.0250000
NODE_2217_length_1524_cov_130.874386	306	386	17	2	80	0.0250000
NODE_2217_length_1524_cov_130.874386	306	386	18	7	80	0.0875000
NODE_2217_length_1524_cov_130.874386	306	386	19	2	80	0.0250000
NODE_2217_length_1524_cov_130.874386	306	386	20	5	80	0.0625000
NODE_2217_length_1524_cov_130.874386	306	386	21	2	80	0.0250000
NODE_2217_length_1524_cov_130.874386	306	386	22	2	80	0.0250000
NODE_2217_length_1524_cov_130.874386	306	386	23	1	80	0.0125000
NODE_2217_length_1524_cov_130.874386	306	386	24	3	80	0.0375000
NODE_2217_length_1524_cov_130.874386	306	386	26	4	80	0.0500000
NODE_2217_length_1524_cov_130.874386	306	386	27	7	80	0.0875000
NODE_2217_length_1524_cov_130.874386	306	386	28	3	80	0.0375000
NODE_2217_length_1524_cov_130.874386	306	386	29	1	80	0.0125000
NODE_2217_length_1524_cov_130.874386	306	386	32	4	80	0.0500000
NODE_2217_length_1524_cov_130.874386	306	386	34	5	80	0.0625000
NODE_2217_length_1524_cov_130.874386	306	386	37	1	80	0.0125000
NODE_2217_length_1524_cov_130.874386	306	386	38	2	80	0.0250000
NODE_2217_length_1524_cov_130.874386	306	386	40	1	80	0.0125000
NODE_2217_length_1524_cov_130.874386	306	386	41	6	80	0.0750000
NODE_2219_length_1523_cov_24.115169	366	446	3	23	80	0.2875000
NODE_2219_length_1523_cov_24.115169	366	446	4	28	80	0.3500000
NODE_2219_length_1523_cov_24.115169	366	446	5	6	80	0.0750000
NODE_2219_length_1523_cov_24.115169	366	446	6	23	80	0.2875000
NODE_2219_length_1523_cov_24.115169	419	499	3	12	80	0.1500000
NODE_2219_length_1523_cov_24.115169	419	499	4	19	80	0.2375000
NODE_2219_length_1523_cov_24.115169	419	499	5	19	80	0.2375000
NODE_2219_length_1523_cov_24.115169	419	499	6	30	80	0.3750000
NODE_2219_length_1523_cov_24.115169	495	575	1	2	80	0.0250000
NODE_2219_length_1523_cov_24.115169	495	575	2	24	80	0.3000000
NODE_2219_length_1523_cov_24.115169	495	575	3	54	80	0.6750000
NODE_2219_length_1523_cov_24.115169	548	628	1	3	80	0.0375000
NODE_2219_length_1523_cov_24.115169	548	628	2	67	80	0.8375000
NODE_2219_length_1523_cov_24.115169	548	628	3	10	80	0.1250000
NODE_2223_length_1522_cov_13.278988	361	441	4	5	80	0.0625000
NODE_2223_length_1522_cov_13.278988	361	441	5	24	80	0.3000000
NODE_2223_length_1522_cov_13.278988	361	441	7	24	80	0.3000000
NODE_2223_length_1522_cov_13.278988	361	441	8	5	80	0.0625000
NODE_2223_length_1522_cov_13.278988	361	441	9	14	80	0.1750000
NODE_2223_length_1522_cov_13.278988	361	441	11	8	80	0.1000000
NODE_2223_length_1522_cov_13.278988	414	494	8	5	80	0.0625000
NODE_2223_length_1522_cov_13.278988	414	494	9	38	80	0.4750000
NODE_2223_length_1522_cov_13.278988	414	494	10	7	80	0.0875000
NODE_2223_length_1522_cov_13.278988	414	494	11	16	80	0.2000000
NODE_2223_length_1522_cov_13.278988	414	494	12	2	80	0.0250000
NODE_2223_length_1522_cov_13.278988	414	494	13	12	80	0.1500000
NODE_2225_length_1521_cov_20.965541	772	852	0	2	80	0.0250000
NODE_2225_length_1521_cov_20.965541	772	852	1	41	80	0.5125000
NODE_2225_length_1521_cov_20.965541	772	852	2	37	80	0.4625000
NODE_2225_length_1521_cov_20.965541	825	905	2	65	80	0.8125000
NODE_2225_length_1521_cov_20.965541	825	905	3	10	80	0.1250000
NODE_2225_length_1521_cov_20.965541	825	905	4	5	80	0.0625000
NODE_2226_length_1521_cov_15.381153	907	987	0	80	80	1.0000000
NODE_2226_length_1521_cov_15.381153	960	1040	0	80	80	1.0000000
NODE_2226_length_1521_cov_15.381153	988	1040	0	52	52	1.0000000
NODE_2227_length_1521_cov_7.682138	525	605	2	1	80	0.0125000
NODE_2227_length_1521_cov_7.682138	525	605	3	27	80	0.3375000
NODE_2227_length_1521_cov_7.682138	525	605	4	30	80	0.3750000
NODE_2227_length_1521_cov_7.682138	525	605	5	22	80	0.2750000
NODE_2227_length_1521_cov_7.682138	578	658	4	80	80	1.0000000
NODE_2236_length_1519_cov_20.792958	714	794	0	7	80	0.0875000
NODE_2236_length_1519_cov_20.792958	714	794	1	3	80	0.0375000
NODE_2236_length_1519_cov_20.792958	714	794	2	70	80	0.8750000
NODE_2236_length_1519_cov_20.792958	767	847	0	60	80	0.7500000
NODE_2236_length_1519_cov_20.792958	767	847	1	3	80	0.0375000
NODE_2236_length_1519_cov_20.792958	767	847	2	17	80	0.2125000
NODE_2239_length_1517_cov_24.074048	413	450	0	37	37	1.0000000
NODE_2239_length_1517_cov_24.074048	842	922	8	4	80	0.0500000
NODE_2239_length_1517_cov_24.074048	842	922	9	20	80	0.2500000
NODE_2239_length_1517_cov_24.074048	842	922	10	18	80	0.2250000
NODE_2239_length_1517_cov_24.074048	842	922	12	25	80	0.3125000
NODE_2239_length_1517_cov_24.074048	842	922	13	13	80	0.1625000
NODE_2239_length_1517_cov_24.074048	895	975	6	4	80	0.0500000
NODE_2239_length_1517_cov_24.074048	895	975	8	33	80	0.4125000
NODE_2239_length_1517_cov_24.074048	895	975	9	3	80	0.0375000
NODE_2239_length_1517_cov_24.074048	895	975	10	31	80	0.3875000
NODE_2239_length_1517_cov_24.074048	895	975	12	6	80	0.0750000
NODE_2239_length_1517_cov_24.074048	895	975	13	3	80	0.0375000
NODE_2240_length_1517_cov_22.897743	383	463	4	1	80	0.0125000
NODE_2240_length_1517_cov_22.897743	383	463	5	25	80	0.3125000
NODE_2240_length_1517_cov_22.897743	383	463	6	12	80	0.1500000
NODE_2240_length_1517_cov_22.897743	383	463	7	3	80	0.0375000
NODE_2240_length_1517_cov_22.897743	383	463	9	13	80	0.1625000
NODE_2240_length_1517_cov_22.897743	383	463	10	6	80	0.0750000
NODE_2240_length_1517_cov_22.897743	383	463	11	3	80	0.0375000
NODE_2240_length_1517_cov_22.897743	383	463	12	8	80	0.1000000
NODE_2240_length_1517_cov_22.897743	383	463	13	9	80	0.1125000
NODE_2240_length_1517_cov_22.897743	436	516	9	1	80	0.0125000
NODE_2240_length_1517_cov_22.897743	436	516	10	11	80	0.1375000
NODE_2240_length_1517_cov_22.897743	436	516	11	17	80	0.2125000
NODE_2240_length_1517_cov_22.897743	436	516	12	25	80	0.3125000
NODE_2240_length_1517_cov_22.897743	436	516	13	26	80	0.3250000
NODE_2241_length_1517_cov_11.781382	381	461	5	49	80	0.6125000
NODE_2241_length_1517_cov_11.781382	381	461	6	17	80	0.2125000
NODE_2241_length_1517_cov_11.781382	381	461	7	14	80	0.1750000
NODE_2241_length_1517_cov_11.781382	434	514	5	21	80	0.2625000
NODE_2241_length_1517_cov_11.781382	434	514	6	45	80	0.5625000
NODE_2241_length_1517_cov_11.781382	434	514	7	14	80	0.1750000
NODE_2243_length_1517_cov_4.944993	393	473	6	4	80	0.0500000
NODE_2243_length_1517_cov_4.944993	393	473	7	7	80	0.0875000
NODE_2243_length_1517_cov_4.944993	393	473	8	26	80	0.3250000
NODE_2243_length_1517_cov_4.944993	393	473	9	14	80	0.1750000
NODE_2243_length_1517_cov_4.944993	393	473	10	28	80	0.3500000
NODE_2243_length_1517_cov_4.944993	393	473	11	1	80	0.0125000
NODE_2243_length_1517_cov_4.944993	446	526	6	31	80	0.3875000
NODE_2243_length_1517_cov_4.944993	446	526	8	5	80	0.0625000
NODE_2243_length_1517_cov_4.944993	446	526	9	7	80	0.0875000
NODE_2243_length_1517_cov_4.944993	446	526	10	34	80	0.4250000
NODE_2243_length_1517_cov_4.944993	446	526	11	3	80	0.0375000
NODE_2247_length_1516_cov_11.177135	230	310	5	1	80	0.0125000
NODE_2247_length_1516_cov_11.177135	230	310	6	77	80	0.9625000
NODE_2247_length_1516_cov_11.177135	230	310	7	2	80	0.0250000
NODE_2247_length_1516_cov_11.177135	283	363	3	4	80	0.0500000
NODE_2247_length_1516_cov_11.177135	283	363	4	15	80	0.1875000
NODE_2247_length_1516_cov_11.177135	283	363	5	3	80	0.0375000
NODE_2247_length_1516_cov_11.177135	283	363	6	25	80	0.3125000
NODE_2247_length_1516_cov_11.177135	283	363	7	33	80	0.4125000
NODE_2248_length_1516_cov_8.608327	580	660	6	13	80	0.1625000
NODE_2248_length_1516_cov_8.608327	580	660	8	7	80	0.0875000
NODE_2248_length_1516_cov_8.608327	580	660	9	49	80	0.6125000
NODE_2248_length_1516_cov_8.608327	580	660	10	7	80	0.0875000
NODE_2248_length_1516_cov_8.608327	580	660	11	4	80	0.0500000
NODE_2248_length_1516_cov_8.608327	633	713	6	57	80	0.7125000
NODE_2248_length_1516_cov_8.608327	633	713	7	1	80	0.0125000
NODE_2248_length_1516_cov_8.608327	633	713	8	13	80	0.1625000
NODE_2248_length_1516_cov_8.608327	633	713	9	9	80	0.1125000
NODE_2250_length_1515_cov_16.990819	333	413	4	11	80	0.1375000
NODE_2250_length_1515_cov_16.990819	333	413	5	61	80	0.7625000
NODE_2250_length_1515_cov_16.990819	333	413	6	6	80	0.0750000
NODE_2250_length_1515_cov_16.990819	333	413	10	2	80	0.0250000
NODE_2250_length_1515_cov_16.990819	386	448	0	15	62	0.2419355
NODE_2250_length_1515_cov_16.990819	386	448	1	9	62	0.1451613
NODE_2250_length_1515_cov_16.990819	386	448	2	6	62	0.0967742
NODE_2250_length_1515_cov_16.990819	386	448	4	16	62	0.2580645
NODE_2250_length_1515_cov_16.990819	386	448	5	16	62	0.2580645
NODE_2258_length_1512_cov_5.111819	506	560	2	54	54	1.0000000
NODE_2258_length_1512_cov_5.111819	677	698	0	21	21	1.0000000
NODE_2258_length_1512_cov_5.111819	677	698	0	21	21	1.0000000
NODE_2258_length_1512_cov_5.111819	1057	1137	0	80	80	1.0000000
NODE_2258_length_1512_cov_5.111819	1110	1190	0	80	80	1.0000000
NODE_2258_length_1512_cov_5.111819	1144	1190	0	46	46	1.0000000
NODE_2259_length_1512_cov_4.251946	132	204	0	72	72	1.0000000
NODE_2262_length_1511_cov_30.963173	787	867	4	49	80	0.6125000
NODE_2262_length_1511_cov_30.963173	787	867	5	23	80	0.2875000
NODE_2262_length_1511_cov_30.963173	787	867	6	8	80	0.1000000
NODE_2262_length_1511_cov_30.963173	840	920	4	9	80	0.1125000
NODE_2262_length_1511_cov_30.963173	840	920	5	21	80	0.2625000
NODE_2262_length_1511_cov_30.963173	840	920	6	43	80	0.5375000
NODE_2262_length_1511_cov_30.963173	840	920	7	7	80	0.0875000
NODE_2262_length_1511_cov_30.963173	916	996	5	11	80	0.1375000
NODE_2262_length_1511_cov_30.963173	916	996	6	47	80	0.5875000
NODE_2262_length_1511_cov_30.963173	916	996	7	11	80	0.1375000
NODE_2262_length_1511_cov_30.963173	916	996	9	11	80	0.1375000
NODE_2262_length_1511_cov_30.963173	969	1059	6	27	90	0.3000000
NODE_2262_length_1511_cov_30.963173	969	1059	7	25	90	0.2777778
NODE_2262_length_1511_cov_30.963173	969	1059	8	10	90	0.1111111
NODE_2262_length_1511_cov_30.963173	969	1059	9	28	90	0.3111111
NODE_2265_length_1510_cov_24.184975	434	514	3	5	80	0.0625000
NODE_2265_length_1510_cov_24.184975	434	514	5	14	80	0.1750000
NODE_2265_length_1510_cov_24.184975	434	514	7	39	80	0.4875000
NODE_2265_length_1510_cov_24.184975	434	514	8	18	80	0.2250000
NODE_2265_length_1510_cov_24.184975	434	514	9	4	80	0.0500000
NODE_2265_length_1510_cov_24.184975	487	567	7	5	80	0.0625000
NODE_2265_length_1510_cov_24.184975	487	567	8	18	80	0.2250000
NODE_2265_length_1510_cov_24.184975	487	567	9	13	80	0.1625000
NODE_2265_length_1510_cov_24.184975	487	567	10	44	80	0.5500000
NODE_2265_length_1510_cov_24.184975	563	643	2	3	80	0.0375000
NODE_2265_length_1510_cov_24.184975	563	643	3	3	80	0.0375000
NODE_2265_length_1510_cov_24.184975	563	643	5	34	80	0.4250000
NODE_2265_length_1510_cov_24.184975	563	643	6	1	80	0.0125000
NODE_2265_length_1510_cov_24.184975	563	643	7	13	80	0.1625000
NODE_2265_length_1510_cov_24.184975	563	643	8	5	80	0.0625000
NODE_2265_length_1510_cov_24.184975	563	643	9	11	80	0.1375000
NODE_2265_length_1510_cov_24.184975	563	643	10	10	80	0.1250000
NODE_2265_length_1510_cov_24.184975	616	696	2	53	80	0.6625000
NODE_2265_length_1510_cov_24.184975	616	696	3	6	80	0.0750000
NODE_2265_length_1510_cov_24.184975	616	696	5	21	80	0.2625000
NODE_2269_length_1509_cov_51.836170	655	735	6	31	80	0.3875000
NODE_2269_length_1509_cov_51.836170	655	735	7	15	80	0.1875000
NODE_2269_length_1509_cov_51.836170	655	735	8	34	80	0.4250000
NODE_2269_length_1509_cov_51.836170	708	788	4	36	80	0.4500000
NODE_2269_length_1509_cov_51.836170	708	788	5	3	80	0.0375000
NODE_2269_length_1509_cov_51.836170	708	788	6	8	80	0.1000000
NODE_2269_length_1509_cov_51.836170	708	788	7	6	80	0.0750000
NODE_2269_length_1509_cov_51.836170	708	788	8	27	80	0.3375000
NODE_2269_length_1509_cov_51.836170	784	864	3	22	80	0.2750000
NODE_2269_length_1509_cov_51.836170	784	864	4	10	80	0.1250000
NODE_2269_length_1509_cov_51.836170	784	864	5	33	80	0.4125000
NODE_2269_length_1509_cov_51.836170	784	864	6	15	80	0.1875000
NODE_2269_length_1509_cov_51.836170	837	917	4	3	80	0.0375000
NODE_2269_length_1509_cov_51.836170	837	917	5	14	80	0.1750000
NODE_2269_length_1509_cov_51.836170	837	917	6	56	80	0.7000000
NODE_2269_length_1509_cov_51.836170	837	917	7	7	80	0.0875000
NODE_2270_length_1509_cov_16.010638	497	577	3	37	80	0.4625000
NODE_2270_length_1509_cov_16.010638	497	577	4	2	80	0.0250000
NODE_2270_length_1509_cov_16.010638	497	577	5	14	80	0.1750000
NODE_2270_length_1509_cov_16.010638	497	577	6	5	80	0.0625000
NODE_2270_length_1509_cov_16.010638	497	577	7	9	80	0.1125000
NODE_2270_length_1509_cov_16.010638	497	577	8	13	80	0.1625000
NODE_2270_length_1509_cov_16.010638	550	630	6	12	80	0.1500000
NODE_2270_length_1509_cov_16.010638	550	630	7	45	80	0.5625000
NODE_2270_length_1509_cov_16.010638	550	630	8	23	80	0.2875000
NODE_2270_length_1509_cov_16.010638	626	706	3	3	80	0.0375000
NODE_2270_length_1509_cov_16.010638	626	706	5	3	80	0.0375000
NODE_2270_length_1509_cov_16.010638	626	706	6	61	80	0.7625000
NODE_2270_length_1509_cov_16.010638	626	706	7	2	80	0.0250000
NODE_2270_length_1509_cov_16.010638	626	706	8	11	80	0.1375000
NODE_2270_length_1509_cov_16.010638	679	759	2	7	80	0.0875000
NODE_2270_length_1509_cov_16.010638	679	759	3	49	80	0.6125000
NODE_2270_length_1509_cov_16.010638	679	759	5	3	80	0.0375000
NODE_2270_length_1509_cov_16.010638	679	759	6	14	80	0.1750000
NODE_2270_length_1509_cov_16.010638	679	759	7	2	80	0.0250000
NODE_2270_length_1509_cov_16.010638	679	759	8	5	80	0.0625000
NODE_2271_length_1509_cov_8.883688	252	332	0	80	80	1.0000000
NODE_2271_length_1509_cov_8.883688	305	385	0	80	80	1.0000000
NODE_2271_length_1509_cov_8.883688	327	385	0	58	58	1.0000000
NODE_2271_length_1509_cov_8.883688	381	461	0	80	80	1.0000000
NODE_2271_length_1509_cov_8.883688	434	514	0	80	80	1.0000000
NODE_2272_length_1509_cov_5.826950	1029	1109	5	5	80	0.0625000
NODE_2272_length_1509_cov_5.826950	1029	1109	6	75	80	0.9375000
NODE_2272_length_1509_cov_5.826950	1082	1162	3	9	80	0.1125000
NODE_2272_length_1509_cov_5.826950	1082	1162	5	49	80	0.6125000
NODE_2272_length_1509_cov_5.826950	1082	1162	6	22	80	0.2750000
NODE_2277_length_1508_cov_24.176011	765	845	2	36	80	0.4500000
NODE_2277_length_1508_cov_24.176011	765	845	3	10	80	0.1250000
NODE_2277_length_1508_cov_24.176011	765	845	4	10	80	0.1250000
NODE_2277_length_1508_cov_24.176011	765	845	5	24	80	0.3000000
NODE_2277_length_1508_cov_24.176011	818	898	3	3	80	0.0375000
NODE_2277_length_1508_cov_24.176011	818	898	5	65	80	0.8125000
NODE_2277_length_1508_cov_24.176011	818	898	6	12	80	0.1500000
NODE_2290_length_1504_cov_17.449822	596	676	2	1	80	0.0125000
NODE_2290_length_1504_cov_17.449822	596	676	4	17	80	0.2125000
NODE_2290_length_1504_cov_17.449822	596	676	5	62	80	0.7750000
NODE_2290_length_1504_cov_17.449822	649	729	3	2	80	0.0250000
NODE_2290_length_1504_cov_17.449822	649	729	4	24	80	0.3000000
NODE_2290_length_1504_cov_17.449822	649	729	5	54	80	0.6750000
NODE_2293_length_1502_cov_42.989309	559	639	13	2	80	0.0250000
NODE_2293_length_1502_cov_42.989309	559	639	14	7	80	0.0875000
NODE_2293_length_1502_cov_42.989309	559	639	15	3	80	0.0375000
NODE_2293_length_1502_cov_42.989309	559	639	16	10	80	0.1250000
NODE_2293_length_1502_cov_42.989309	559	639	17	5	80	0.0625000
NODE_2293_length_1502_cov_42.989309	559	639	18	17	80	0.2125000
NODE_2293_length_1502_cov_42.989309	559	639	19	9	80	0.1125000
NODE_2293_length_1502_cov_42.989309	559	639	20	5	80	0.0625000
NODE_2293_length_1502_cov_42.989309	559	639	21	22	80	0.2750000
NODE_2293_length_1502_cov_42.989309	612	692	19	12	80	0.1500000
NODE_2293_length_1502_cov_42.989309	612	692	20	23	80	0.2875000
NODE_2293_length_1502_cov_42.989309	612	692	21	45	80	0.5625000
NODE_2294_length_1501_cov_22.828816	421	500	2	17	79	0.2151899
NODE_2294_length_1501_cov_22.828816	421	500	3	8	79	0.1012658
NODE_2294_length_1501_cov_22.828816	421	500	4	54	79	0.6835443
NODE_2294_length_1501_cov_22.828816	473	553	4	33	80	0.4125000
NODE_2294_length_1501_cov_22.828816	473	553	5	15	80	0.1875000
NODE_2294_length_1501_cov_22.828816	473	553	6	13	80	0.1625000
NODE_2294_length_1501_cov_22.828816	473	553	7	19	80	0.2375000
NODE_2294_length_1501_cov_22.828816	549	629	3	33	80	0.4125000
NODE_2294_length_1501_cov_22.828816	549	629	4	4	80	0.0500000
NODE_2294_length_1501_cov_22.828816	549	629	5	3	80	0.0375000
NODE_2294_length_1501_cov_22.828816	549	629	6	1	80	0.0125000
NODE_2294_length_1501_cov_22.828816	549	629	7	39	80	0.4875000
NODE_2294_length_1501_cov_22.828816	602	682	1	11	80	0.1375000
NODE_2294_length_1501_cov_22.828816	602	682	2	15	80	0.1875000
NODE_2294_length_1501_cov_22.828816	602	682	3	54	80	0.6750000
NODE_2295_length_1501_cov_14.422254	973	1053	3	6	80	0.0750000
NODE_2295_length_1501_cov_14.422254	973	1053	4	10	80	0.1250000
NODE_2295_length_1501_cov_14.422254	973	1053	6	64	80	0.8000000
NODE_2295_length_1501_cov_14.422254	1026	1106	1	3	80	0.0375000
NODE_2295_length_1501_cov_14.422254	1026	1106	3	4	80	0.0500000
NODE_2295_length_1501_cov_14.422254	1026	1106	4	31	80	0.3875000
NODE_2295_length_1501_cov_14.422254	1026	1106	6	42	80	0.5250000
NODE_2296_length_1501_cov_14.060628	225	305	2	48	80	0.6000000
NODE_2296_length_1501_cov_14.060628	225	305	4	32	80	0.4000000
NODE_2296_length_1501_cov_14.060628	278	358	2	30	80	0.3750000
NODE_2296_length_1501_cov_14.060628	278	358	4	50	80	0.6250000
NODE_2296_length_1501_cov_14.060628	986	1066	3	80	80	1.0000000
NODE_2296_length_1501_cov_14.060628	1039	1119	3	73	80	0.9125000
NODE_2296_length_1501_cov_14.060628	1039	1119	4	7	80	0.0875000
NODE_2300_length_1500_cov_40.056388	619	699	2	7	80	0.0875000
NODE_2300_length_1500_cov_40.056388	619	699	4	1	80	0.0125000
NODE_2300_length_1500_cov_40.056388	619	699	5	8	80	0.1000000
NODE_2300_length_1500_cov_40.056388	619	699	6	6	80	0.0750000
NODE_2300_length_1500_cov_40.056388	619	699	7	2	80	0.0250000
NODE_2300_length_1500_cov_40.056388	619	699	8	5	80	0.0625000
NODE_2300_length_1500_cov_40.056388	619	699	9	4	80	0.0500000
NODE_2300_length_1500_cov_40.056388	619	699	11	20	80	0.2500000
NODE_2300_length_1500_cov_40.056388	619	699	15	12	80	0.1500000
NODE_2300_length_1500_cov_40.056388	619	699	16	15	80	0.1875000
NODE_2300_length_1500_cov_40.056388	672	752	11	1	80	0.0125000
NODE_2300_length_1500_cov_40.056388	672	752	12	26	80	0.3250000
NODE_2300_length_1500_cov_40.056388	672	752	13	14	80	0.1750000
NODE_2300_length_1500_cov_40.056388	672	752	14	3	80	0.0375000
NODE_2300_length_1500_cov_40.056388	672	752	15	16	80	0.2000000
NODE_2300_length_1500_cov_40.056388	672	752	16	20	80	0.2500000
NODE_2305_length_1497_cov_38.344063	1401	1481	9	9	80	0.1125000
NODE_2305_length_1497_cov_38.344063	1401	1481	10	6	80	0.0750000
NODE_2305_length_1497_cov_38.344063	1401	1481	11	4	80	0.0500000
NODE_2305_length_1497_cov_38.344063	1401	1481	14	7	80	0.0875000
NODE_2305_length_1497_cov_38.344063	1401	1481	15	3	80	0.0375000
NODE_2305_length_1497_cov_38.344063	1401	1481	16	11	80	0.1375000
NODE_2305_length_1497_cov_38.344063	1401	1481	17	3	80	0.0375000
NODE_2305_length_1497_cov_38.344063	1401	1481	21	3	80	0.0375000
NODE_2305_length_1497_cov_38.344063	1401	1481	23	1	80	0.0125000
NODE_2305_length_1497_cov_38.344063	1401	1481	25	1	80	0.0125000
NODE_2305_length_1497_cov_38.344063	1401	1481	26	7	80	0.0875000
NODE_2305_length_1497_cov_38.344063	1401	1481	27	4	80	0.0500000
NODE_2305_length_1497_cov_38.344063	1401	1481	29	10	80	0.1250000
NODE_2305_length_1497_cov_38.344063	1401	1481	32	6	80	0.0750000
NODE_2305_length_1497_cov_38.344063	1401	1481	33	3	80	0.0375000
NODE_2305_length_1497_cov_38.344063	1401	1481	34	1	80	0.0125000
NODE_2305_length_1497_cov_38.344063	1401	1481	36	1	80	0.0125000
NODE_2308_length_1496_cov_3.936292	0	44	0	44	44	1.0000000
NODE_2308_length_1496_cov_3.936292	17	97	0	80	80	1.0000000
NODE_2311_length_1496_cov_1.103794	405	428	2	17	23	0.7391304
NODE_2311_length_1496_cov_1.103794	405	428	4	6	23	0.2608696
NODE_2313_length_1494_cov_65.437276	460	540	1	80	80	1.0000000
NODE_2313_length_1494_cov_65.437276	513	594	0	35	81	0.4320988
NODE_2313_length_1494_cov_65.437276	513	594	1	46	81	0.5679013
NODE_2313_length_1494_cov_65.437276	787	854	10	18	67	0.2686567
NODE_2313_length_1494_cov_65.437276	787	854	12	1	67	0.0149254
NODE_2313_length_1494_cov_65.437276	787	854	13	7	67	0.1044776
NODE_2313_length_1494_cov_65.437276	787	854	14	12	67	0.1791045
NODE_2313_length_1494_cov_65.437276	787	854	16	10	67	0.1492537
NODE_2313_length_1494_cov_65.437276	787	854	17	3	67	0.0447761
NODE_2313_length_1494_cov_65.437276	787	854	18	6	67	0.0895522
NODE_2313_length_1494_cov_65.437276	787	854	19	10	67	0.1492537
NODE_2313_length_1494_cov_65.437276	827	907	10	3	80	0.0375000
NODE_2313_length_1494_cov_65.437276	827	907	11	13	80	0.1625000
NODE_2313_length_1494_cov_65.437276	827	907	12	4	80	0.0500000
NODE_2313_length_1494_cov_65.437276	827	907	13	13	80	0.1625000
NODE_2313_length_1494_cov_65.437276	827	907	16	9	80	0.1125000
NODE_2313_length_1494_cov_65.437276	827	907	17	14	80	0.1750000
NODE_2313_length_1494_cov_65.437276	827	907	18	6	80	0.0750000
NODE_2313_length_1494_cov_65.437276	827	907	19	18	80	0.2250000
NODE_2316_length_1493_cov_100.467719	947	1028	43	3	81	0.0370370
NODE_2316_length_1493_cov_100.467719	947	1028	44	3	81	0.0370370
NODE_2316_length_1493_cov_100.467719	947	1028	46	2	81	0.0246914
NODE_2316_length_1493_cov_100.467719	947	1028	47	5	81	0.0617284
NODE_2316_length_1493_cov_100.467719	947	1028	48	1	81	0.0123457
NODE_2316_length_1493_cov_100.467719	947	1028	49	5	81	0.0617284
NODE_2316_length_1493_cov_100.467719	947	1028	50	4	81	0.0493827
NODE_2316_length_1493_cov_100.467719	947	1028	51	1	81	0.0123457
NODE_2316_length_1493_cov_100.467719	947	1028	52	1	81	0.0123457
NODE_2316_length_1493_cov_100.467719	947	1028	53	3	81	0.0370370
NODE_2316_length_1493_cov_100.467719	947	1028	55	1	81	0.0123457
NODE_2316_length_1493_cov_100.467719	947	1028	56	5	81	0.0617284
NODE_2316_length_1493_cov_100.467719	947	1028	57	2	81	0.0246914
NODE_2316_length_1493_cov_100.467719	947	1028	60	1	81	0.0123457
NODE_2316_length_1493_cov_100.467719	947	1028	62	2	81	0.0246914
NODE_2316_length_1493_cov_100.467719	947	1028	63	2	81	0.0246914
NODE_2316_length_1493_cov_100.467719	947	1028	64	8	81	0.0987654
NODE_2316_length_1493_cov_100.467719	947	1028	65	6	81	0.0740741
NODE_2316_length_1493_cov_100.467719	947	1028	66	7	81	0.0864198
NODE_2316_length_1493_cov_100.467719	947	1028	67	6	81	0.0740741
NODE_2316_length_1493_cov_100.467719	947	1028	68	9	81	0.1111111
NODE_2316_length_1493_cov_100.467719	947	1028	69	3	81	0.0370370
NODE_2316_length_1493_cov_100.467719	947	1028	70	1	81	0.0123457
NODE_2316_length_1493_cov_100.467719	1001	1071	64	1	70	0.0142857
NODE_2316_length_1493_cov_100.467719	1001	1071	65	1	70	0.0142857
NODE_2316_length_1493_cov_100.467719	1001	1071	66	6	70	0.0857143
NODE_2316_length_1493_cov_100.467719	1001	1071	67	6	70	0.0857143
NODE_2316_length_1493_cov_100.467719	1001	1071	68	9	70	0.1285714
NODE_2316_length_1493_cov_100.467719	1001	1071	69	3	70	0.0428571
NODE_2316_length_1493_cov_100.467719	1001	1071	70	6	70	0.0857143
NODE_2316_length_1493_cov_100.467719	1001	1071	71	5	70	0.0714286
NODE_2316_length_1493_cov_100.467719	1001	1071	72	3	70	0.0428571
NODE_2316_length_1493_cov_100.467719	1001	1071	73	2	70	0.0285714
NODE_2316_length_1493_cov_100.467719	1001	1071	75	4	70	0.0571429
NODE_2316_length_1493_cov_100.467719	1001	1071	77	1	70	0.0142857
NODE_2316_length_1493_cov_100.467719	1001	1071	78	6	70	0.0857143
NODE_2316_length_1493_cov_100.467719	1001	1071	79	8	70	0.1142857
NODE_2316_length_1493_cov_100.467719	1001	1071	80	2	70	0.0285714
NODE_2316_length_1493_cov_100.467719	1001	1071	81	3	70	0.0428571
NODE_2316_length_1493_cov_100.467719	1001	1071	82	1	70	0.0142857
NODE_2316_length_1493_cov_100.467719	1001	1071	84	3	70	0.0428571
NODE_2316_length_1493_cov_100.467719	1077	1157	86	1	80	0.0125000
NODE_2316_length_1493_cov_100.467719	1077	1157	87	2	80	0.0250000
NODE_2316_length_1493_cov_100.467719	1077	1157	88	3	80	0.0375000
NODE_2316_length_1493_cov_100.467719	1077	1157	89	2	80	0.0250000
NODE_2316_length_1493_cov_100.467719	1077	1157	90	1	80	0.0125000
NODE_2316_length_1493_cov_100.467719	1077	1157	91	5	80	0.0625000
NODE_2316_length_1493_cov_100.467719	1077	1157	92	17	80	0.2125000
NODE_2316_length_1493_cov_100.467719	1077	1157	93	1	80	0.0125000
NODE_2316_length_1493_cov_100.467719	1077	1157	95	2	80	0.0250000
NODE_2316_length_1493_cov_100.467719	1077	1157	100	7	80	0.0875000
NODE_2316_length_1493_cov_100.467719	1077	1157	101	3	80	0.0375000
NODE_2316_length_1493_cov_100.467719	1077	1157	102	7	80	0.0875000
NODE_2316_length_1493_cov_100.467719	1077	1157	103	6	80	0.0750000
NODE_2316_length_1493_cov_100.467719	1077	1157	104	2	80	0.0250000
NODE_2316_length_1493_cov_100.467719	1077	1157	105	5	80	0.0625000
NODE_2316_length_1493_cov_100.467719	1077	1157	106	3	80	0.0375000
NODE_2316_length_1493_cov_100.467719	1077	1157	107	7	80	0.0875000
NODE_2316_length_1493_cov_100.467719	1077	1157	108	4	80	0.0500000
NODE_2316_length_1493_cov_100.467719	1077	1157	109	1	80	0.0125000
NODE_2316_length_1493_cov_100.467719	1077	1157	110	1	80	0.0125000
NODE_2316_length_1493_cov_100.467719	1130	1210	95	1	80	0.0125000
NODE_2316_length_1493_cov_100.467719	1130	1210	96	3	80	0.0375000
NODE_2316_length_1493_cov_100.467719	1130	1210	98	1	80	0.0125000
NODE_2316_length_1493_cov_100.467719	1130	1210	99	1	80	0.0125000
NODE_2316_length_1493_cov_100.467719	1130	1210	100	1	80	0.0125000
NODE_2316_length_1493_cov_100.467719	1130	1210	101	3	80	0.0375000
NODE_2316_length_1493_cov_100.467719	1130	1210	102	4	80	0.0500000
NODE_2316_length_1493_cov_100.467719	1130	1210	103	4	80	0.0500000
NODE_2316_length_1493_cov_100.467719	1130	1210	104	4	80	0.0500000
NODE_2316_length_1493_cov_100.467719	1130	1210	105	6	80	0.0750000
NODE_2316_length_1493_cov_100.467719	1130	1210	106	6	80	0.0750000
NODE_2316_length_1493_cov_100.467719	1130	1210	107	8	80	0.1000000
NODE_2316_length_1493_cov_100.467719	1130	1210	108	4	80	0.0500000
NODE_2316_length_1493_cov_100.467719	1130	1210	109	4	80	0.0500000
NODE_2316_length_1493_cov_100.467719	1130	1210	110	1	80	0.0125000
NODE_2316_length_1493_cov_100.467719	1130	1210	111	2	80	0.0250000
NODE_2316_length_1493_cov_100.467719	1130	1210	112	6	80	0.0750000
NODE_2316_length_1493_cov_100.467719	1130	1210	113	1	80	0.0125000
NODE_2316_length_1493_cov_100.467719	1130	1210	114	8	80	0.1000000
NODE_2316_length_1493_cov_100.467719	1130	1210	115	8	80	0.1000000
NODE_2316_length_1493_cov_100.467719	1130	1210	116	2	80	0.0250000
NODE_2316_length_1493_cov_100.467719	1130	1210	117	2	80	0.0250000
NODE_2321_length_1493_cov_1.138451	1341	1420	0	79	79	1.0000000
NODE_2321_length_1493_cov_1.138451	1341	1420	0	79	79	1.0000000
NODE_2321_length_1493_cov_1.138451	1393	1459	0	66	66	1.0000000
NODE_2332_length_1490_cov_5.726096	233	295	3	20	62	0.3225806
NODE_2332_length_1490_cov_5.726096	233	295	4	42	62	0.6774194
NODE_2332_length_1490_cov_5.726096	1065	1149	1	84	84	1.0000000
NODE_2333_length_1490_cov_4.687275	318	399	0	21	81	0.2592593
NODE_2333_length_1490_cov_4.687275	318	399	1	8	81	0.0987654
NODE_2333_length_1490_cov_4.687275	318	399	2	52	81	0.6419753
NODE_2333_length_1490_cov_4.687275	372	452	2	80	80	1.0000000
NODE_2338_length_1488_cov_3.734341	1141	1221	0	18	80	0.2250000
NODE_2338_length_1488_cov_3.734341	1141	1221	2	62	80	0.7750000
NODE_2340_length_1487_cov_19.332133	673	753	0	80	80	1.0000000
NODE_2340_length_1487_cov_19.332133	726	806	0	80	80	1.0000000
NODE_2348_length_1484_cov_38.342960	706	786	4	16	80	0.2000000
NODE_2348_length_1484_cov_38.342960	706	786	6	17	80	0.2125000
NODE_2348_length_1484_cov_38.342960	706	786	7	20	80	0.2500000
NODE_2348_length_1484_cov_38.342960	706	786	8	20	80	0.2500000
NODE_2348_length_1484_cov_38.342960	706	786	9	7	80	0.0875000
NODE_2348_length_1484_cov_38.342960	759	839	3	2	80	0.0250000
NODE_2348_length_1484_cov_38.342960	759	839	4	52	80	0.6500000
NODE_2348_length_1484_cov_38.342960	759	839	6	15	80	0.1875000
NODE_2348_length_1484_cov_38.342960	759	839	8	6	80	0.0750000
NODE_2348_length_1484_cov_38.342960	759	839	9	5	80	0.0625000
NODE_2349_length_1484_cov_21.260650	348	428	0	80	80	1.0000000
NODE_2349_length_1484_cov_21.260650	401	481	0	80	80	1.0000000
NODE_2349_length_1484_cov_21.260650	978	1058	11	6	80	0.0750000
NODE_2349_length_1484_cov_21.260650	978	1058	12	6	80	0.0750000
NODE_2349_length_1484_cov_21.260650	978	1058	13	16	80	0.2000000
NODE_2349_length_1484_cov_21.260650	978	1058	14	27	80	0.3375000
NODE_2349_length_1484_cov_21.260650	978	1058	15	7	80	0.0875000
NODE_2349_length_1484_cov_21.260650	978	1058	16	7	80	0.0875000
NODE_2349_length_1484_cov_21.260650	978	1058	17	11	80	0.1375000
NODE_2349_length_1484_cov_21.260650	1031	1111	9	34	80	0.4250000
NODE_2349_length_1484_cov_21.260650	1031	1111	10	10	80	0.1250000
NODE_2349_length_1484_cov_21.260650	1031	1111	12	2	80	0.0250000
NODE_2349_length_1484_cov_21.260650	1031	1111	14	18	80	0.2250000
NODE_2349_length_1484_cov_21.260650	1031	1111	15	5	80	0.0625000
NODE_2349_length_1484_cov_21.260650	1031	1111	16	4	80	0.0500000
NODE_2349_length_1484_cov_21.260650	1031	1111	17	7	80	0.0875000
NODE_2350_length_1484_cov_19.243321	952	1032	1	2	80	0.0250000
NODE_2350_length_1484_cov_19.243321	952	1032	2	2	80	0.0250000
NODE_2350_length_1484_cov_19.243321	952	1032	3	8	80	0.1000000
NODE_2350_length_1484_cov_19.243321	952	1032	4	39	80	0.4875000
NODE_2350_length_1484_cov_19.243321	952	1032	5	29	80	0.3625000
NODE_2350_length_1484_cov_19.243321	1005	1085	4	17	80	0.2125000
NODE_2350_length_1484_cov_19.243321	1005	1085	5	63	80	0.7875000
NODE_2351_length_1484_cov_9.085199	314	394	1	63	80	0.7875000
NODE_2351_length_1484_cov_9.085199	314	394	2	17	80	0.2125000
NODE_2351_length_1484_cov_9.085199	367	447	0	18	80	0.2250000
NODE_2351_length_1484_cov_9.085199	367	447	1	62	80	0.7750000
NODE_2353_length_1483_cov_21.207370	555	635	10	47	80	0.5875000
NODE_2353_length_1483_cov_21.207370	555	635	11	33	80	0.4125000
NODE_2353_length_1483_cov_21.207370	608	688	3	21	80	0.2625000
NODE_2353_length_1483_cov_21.207370	608	688	5	9	80	0.1125000
NODE_2353_length_1483_cov_21.207370	608	688	7	5	80	0.0625000
NODE_2353_length_1483_cov_21.207370	608	688	8	17	80	0.2125000
NODE_2353_length_1483_cov_21.207370	608	688	10	28	80	0.3500000
NODE_2359_length_1482_cov_20.177874	430	510	4	12	80	0.1500000
NODE_2359_length_1482_cov_20.177874	430	510	5	58	80	0.7250000
NODE_2359_length_1482_cov_20.177874	430	510	6	8	80	0.1000000
NODE_2359_length_1482_cov_20.177874	430	510	7	2	80	0.0250000
NODE_2359_length_1482_cov_20.177874	483	563	4	10	80	0.1250000
NODE_2359_length_1482_cov_20.177874	483	563	5	59	80	0.7375000
NODE_2359_length_1482_cov_20.177874	483	563	6	11	80	0.1375000
NODE_2359_length_1482_cov_20.177874	559	639	4	1	80	0.0125000
NODE_2359_length_1482_cov_20.177874	559	639	5	15	80	0.1875000
NODE_2359_length_1482_cov_20.177874	559	639	6	60	80	0.7500000
NODE_2359_length_1482_cov_20.177874	559	639	7	3	80	0.0375000
NODE_2359_length_1482_cov_20.177874	559	639	8	1	80	0.0125000
NODE_2359_length_1482_cov_20.177874	612	692	3	20	80	0.2500000
NODE_2359_length_1482_cov_20.177874	612	692	4	21	80	0.2625000
NODE_2359_length_1482_cov_20.177874	612	692	5	10	80	0.1250000
NODE_2359_length_1482_cov_20.177874	612	692	6	29	80	0.3625000
NODE_2360_length_1482_cov_13.644252	1000	1080	3	13	80	0.1625000
NODE_2360_length_1482_cov_13.644252	1000	1080	4	13	80	0.1625000
NODE_2360_length_1482_cov_13.644252	1000	1080	5	33	80	0.4125000
NODE_2360_length_1482_cov_13.644252	1000	1080	6	21	80	0.2625000
NODE_2360_length_1482_cov_13.644252	1053	1133	4	10	80	0.1250000
NODE_2360_length_1482_cov_13.644252	1053	1133	5	70	80	0.8750000
NODE_2361_length_1482_cov_6.157628	525	605	3	7	80	0.0875000
NODE_2361_length_1482_cov_6.157628	525	605	4	12	80	0.1500000
NODE_2361_length_1482_cov_6.157628	525	605	6	11	80	0.1375000
NODE_2361_length_1482_cov_6.157628	525	605	7	15	80	0.1875000
NODE_2361_length_1482_cov_6.157628	525	605	8	35	80	0.4375000
NODE_2361_length_1482_cov_6.157628	578	658	3	15	80	0.1875000
NODE_2361_length_1482_cov_6.157628	578	658	5	1	80	0.0125000
NODE_2361_length_1482_cov_6.157628	578	658	6	21	80	0.2625000
NODE_2361_length_1482_cov_6.157628	578	658	8	43	80	0.5375000
NODE_2361_length_1482_cov_6.157628	1306	1388	0	4	82	0.0487805
NODE_2361_length_1482_cov_6.157628	1306	1388	2	5	82	0.0609756
NODE_2361_length_1482_cov_6.157628	1306	1388	4	10	82	0.1219512
NODE_2361_length_1482_cov_6.157628	1306	1388	6	63	82	0.7682927
NODE_2364_length_1481_cov_19.238784	480	560	5	3	80	0.0375000
NODE_2364_length_1481_cov_19.238784	480	560	8	56	80	0.7000000
NODE_2364_length_1481_cov_19.238784	480	560	9	21	80	0.2625000
NODE_2364_length_1481_cov_19.238784	533	613	2	26	80	0.3250000
NODE_2364_length_1481_cov_19.238784	533	613	3	7	80	0.0875000
NODE_2364_length_1481_cov_19.238784	533	613	4	15	80	0.1875000
NODE_2364_length_1481_cov_19.238784	533	613	5	8	80	0.1000000
NODE_2364_length_1481_cov_19.238784	533	613	8	24	80	0.3000000
NODE_2365_length_1481_cov_18.139653	706	786	10	1	80	0.0125000
NODE_2365_length_1481_cov_18.139653	706	786	12	6	80	0.0750000
NODE_2365_length_1481_cov_18.139653	706	786	13	34	80	0.4250000
NODE_2365_length_1481_cov_18.139653	706	786	14	21	80	0.2625000
NODE_2365_length_1481_cov_18.139653	706	786	15	17	80	0.2125000
NODE_2365_length_1481_cov_18.139653	706	786	16	1	80	0.0125000
NODE_2365_length_1481_cov_18.139653	759	839	10	8	80	0.1000000
NODE_2365_length_1481_cov_18.139653	759	839	11	2	80	0.0250000
NODE_2365_length_1481_cov_18.139653	759	839	12	3	80	0.0375000
NODE_2365_length_1481_cov_18.139653	759	839	13	2	80	0.0250000
NODE_2365_length_1481_cov_18.139653	759	839	14	48	80	0.6000000
NODE_2365_length_1481_cov_18.139653	759	839	15	16	80	0.2000000
NODE_2365_length_1481_cov_18.139653	759	839	16	1	80	0.0125000
NODE_2367_length_1480_cov_27.552498	762	842	1	73	80	0.9125000
NODE_2367_length_1480_cov_27.552498	762	842	2	7	80	0.0875000
NODE_2367_length_1480_cov_27.552498	815	895	1	20	80	0.2500000
NODE_2367_length_1480_cov_27.552498	815	895	2	46	80	0.5750000
NODE_2367_length_1480_cov_27.552498	815	895	3	14	80	0.1750000
NODE_2367_length_1480_cov_27.552498	891	971	2	21	80	0.2625000
NODE_2367_length_1480_cov_27.552498	891	971	4	59	80	0.7375000
NODE_2367_length_1480_cov_27.552498	944	1024	2	13	80	0.1625000
NODE_2367_length_1480_cov_27.552498	944	1024	3	26	80	0.3250000
NODE_2367_length_1480_cov_27.552498	944	1024	4	41	80	0.5125000
NODE_2367_length_1480_cov_27.552498	1171	1222	10	3	51	0.0588235
NODE_2367_length_1480_cov_27.552498	1171	1222	11	5	51	0.0980392
NODE_2367_length_1480_cov_27.552498	1171	1222	13	11	51	0.2156863
NODE_2367_length_1480_cov_27.552498	1171	1222	15	1	51	0.0196078
NODE_2367_length_1480_cov_27.552498	1171	1222	17	6	51	0.1176471
NODE_2367_length_1480_cov_27.552498	1171	1222	19	4	51	0.0784314
NODE_2367_length_1480_cov_27.552498	1171	1222	20	1	51	0.0196078
NODE_2367_length_1480_cov_27.552498	1171	1222	21	7	51	0.1372549
NODE_2367_length_1480_cov_27.552498	1171	1222	22	2	51	0.0392157
NODE_2367_length_1480_cov_27.552498	1171	1222	23	11	51	0.2156863
NODE_2369_length_1480_cov_12.535844	466	546	0	35	80	0.4375000
NODE_2369_length_1480_cov_12.535844	466	546	1	45	80	0.5625000
NODE_2369_length_1480_cov_12.535844	519	599	0	18	80	0.2250000
NODE_2369_length_1480_cov_12.535844	519	599	1	16	80	0.2000000
NODE_2369_length_1480_cov_12.535844	519	599	2	40	80	0.5000000
NODE_2369_length_1480_cov_12.535844	519	599	3	6	80	0.0750000
NODE_2373_length_1479_cov_17.035507	708	788	0	14	80	0.1750000
NODE_2373_length_1479_cov_17.035507	708	788	1	42	80	0.5250000
NODE_2373_length_1479_cov_17.035507	708	788	2	24	80	0.3000000
NODE_2373_length_1479_cov_17.035507	761	841	1	3	80	0.0375000
NODE_2373_length_1479_cov_17.035507	761	841	2	24	80	0.3000000
NODE_2373_length_1479_cov_17.035507	761	841	3	9	80	0.1125000
NODE_2373_length_1479_cov_17.035507	761	841	4	2	80	0.0250000
NODE_2373_length_1479_cov_17.035507	761	841	5	35	80	0.4375000
NODE_2373_length_1479_cov_17.035507	761	841	6	7	80	0.0875000
NODE_2373_length_1479_cov_17.035507	837	917	5	26	80	0.3250000
NODE_2373_length_1479_cov_17.035507	837	917	6	54	80	0.6750000
NODE_2373_length_1479_cov_17.035507	890	970	2	21	80	0.2625000
NODE_2373_length_1479_cov_17.035507	890	970	3	2	80	0.0250000
NODE_2373_length_1479_cov_17.035507	890	970	4	11	80	0.1375000
NODE_2373_length_1479_cov_17.035507	890	970	5	27	80	0.3375000
NODE_2373_length_1479_cov_17.035507	890	970	6	19	80	0.2375000
NODE_2374_length_1479_cov_16.448551	908	988	1	14	80	0.1750000
NODE_2374_length_1479_cov_16.448551	908	988	2	66	80	0.8250000
NODE_2374_length_1479_cov_16.448551	961	1041	2	41	80	0.5125000
NODE_2374_length_1479_cov_16.448551	961	1041	3	1	80	0.0125000
NODE_2374_length_1479_cov_16.448551	961	1041	7	38	80	0.4750000
NODE_2375_length_1479_cov_5.285507	123	185	3	1	62	0.0161290
NODE_2375_length_1479_cov_5.285507	123	185	6	1	62	0.0161290
NODE_2375_length_1479_cov_5.285507	123	185	10	1	62	0.0161290
NODE_2375_length_1479_cov_5.285507	123	185	11	6	62	0.0967742
NODE_2375_length_1479_cov_5.285507	123	185	12	2	62	0.0322581
NODE_2375_length_1479_cov_5.285507	123	185	13	11	62	0.1774193
NODE_2375_length_1479_cov_5.285507	123	185	14	4	62	0.0645161
NODE_2375_length_1479_cov_5.285507	123	185	15	5	62	0.0806452
NODE_2375_length_1479_cov_5.285507	123	185	16	2	62	0.0322581
NODE_2375_length_1479_cov_5.285507	123	185	18	2	62	0.0322581
NODE_2375_length_1479_cov_5.285507	123	185	19	9	62	0.1451613
NODE_2375_length_1479_cov_5.285507	123	185	21	18	62	0.2903226
NODE_2376_length_1479_cov_2.018841	881	967	0	86	86	1.0000000
NODE_2377_length_1478_cov_32.050761	411	491	9	23	80	0.2875000
NODE_2377_length_1478_cov_32.050761	411	491	10	4	80	0.0500000
NODE_2377_length_1478_cov_32.050761	411	491	11	8	80	0.1000000
NODE_2377_length_1478_cov_32.050761	411	491	12	13	80	0.1625000
NODE_2377_length_1478_cov_32.050761	411	491	13	32	80	0.4000000
NODE_2377_length_1478_cov_32.050761	464	544	9	15	80	0.1875000
NODE_2377_length_1478_cov_32.050761	464	544	10	2	80	0.0250000
NODE_2377_length_1478_cov_32.050761	464	544	11	19	80	0.2375000
NODE_2377_length_1478_cov_32.050761	464	544	12	29	80	0.3625000
NODE_2377_length_1478_cov_32.050761	464	544	13	15	80	0.1875000
NODE_2377_length_1478_cov_32.050761	540	620	4	8	80	0.1000000
NODE_2377_length_1478_cov_32.050761	540	620	6	7	80	0.0875000
NODE_2377_length_1478_cov_32.050761	540	620	7	9	80	0.1125000
NODE_2377_length_1478_cov_32.050761	540	620	8	25	80	0.3125000
NODE_2377_length_1478_cov_32.050761	540	620	9	10	80	0.1250000
NODE_2377_length_1478_cov_32.050761	540	620	10	16	80	0.2000000
NODE_2377_length_1478_cov_32.050761	540	620	11	5	80	0.0625000
NODE_2377_length_1478_cov_32.050761	593	673	3	9	80	0.1125000
NODE_2377_length_1478_cov_32.050761	593	673	4	19	80	0.2375000
NODE_2377_length_1478_cov_32.050761	593	673	5	33	80	0.4125000
NODE_2377_length_1478_cov_32.050761	593	673	7	9	80	0.1125000
NODE_2377_length_1478_cov_32.050761	593	673	8	10	80	0.1250000
NODE_2378_length_1478_cov_27.414793	817	897	1	28	80	0.3500000
NODE_2378_length_1478_cov_27.414793	817	897	2	1	80	0.0125000
NODE_2378_length_1478_cov_27.414793	817	897	3	30	80	0.3750000
NODE_2378_length_1478_cov_27.414793	817	897	4	21	80	0.2625000
NODE_2378_length_1478_cov_27.414793	870	950	3	6	80	0.0750000
NODE_2378_length_1478_cov_27.414793	870	950	4	21	80	0.2625000
NODE_2378_length_1478_cov_27.414793	870	950	5	4	80	0.0500000
NODE_2378_length_1478_cov_27.414793	870	950	6	49	80	0.6125000
NODE_2379_length_1478_cov_23.472081	1212	1241	8	9	29	0.3103448
NODE_2379_length_1478_cov_23.472081	1212	1241	9	20	29	0.6896552
NODE_2380_length_1478_cov_10.746193	678	758	5	20	80	0.2500000
NODE_2380_length_1478_cov_10.746193	678	758	6	24	80	0.3000000
NODE_2380_length_1478_cov_10.746193	678	758	7	23	80	0.2875000
NODE_2380_length_1478_cov_10.746193	678	758	9	13	80	0.1625000
NODE_2380_length_1478_cov_10.746193	731	811	6	19	80	0.2375000
NODE_2380_length_1478_cov_10.746193	731	811	7	9	80	0.1125000
NODE_2380_length_1478_cov_10.746193	731	811	8	12	80	0.1500000
NODE_2380_length_1478_cov_10.746193	731	811	9	40	80	0.5000000
NODE_2380_length_1478_cov_10.746193	807	892	6	22	85	0.2588235
NODE_2380_length_1478_cov_10.746193	807	892	7	39	85	0.4588235
NODE_2380_length_1478_cov_10.746193	807	892	8	24	85	0.2823530
NODE_2380_length_1478_cov_10.746193	860	945	3	9	85	0.1058824
NODE_2380_length_1478_cov_10.746193	860	945	4	40	85	0.4705882
NODE_2380_length_1478_cov_10.746193	860	945	6	20	85	0.2352941
NODE_2380_length_1478_cov_10.746193	860	945	7	16	85	0.1882353
NODE_2384_length_1476_cov_6.522150	791	871	3	8	80	0.1000000
NODE_2384_length_1476_cov_6.522150	791	871	4	72	80	0.9000000
NODE_2384_length_1476_cov_6.522150	844	924	3	10	80	0.1250000
NODE_2384_length_1476_cov_6.522150	844	924	4	70	80	0.8750000
NODE_2392_length_1474_cov_11.209455	515	595	0	80	80	1.0000000
NODE_2392_length_1474_cov_11.209455	568	648	0	80	80	1.0000000
NODE_2397_length_1472_cov_22.159505	428	508	0	24	80	0.3000000
NODE_2397_length_1472_cov_22.159505	428	508	2	9	80	0.1125000
NODE_2397_length_1472_cov_22.159505	428	508	3	8	80	0.1000000
NODE_2397_length_1472_cov_22.159505	428	508	4	39	80	0.4875000
NODE_2397_length_1472_cov_22.159505	428	508	0	24	80	0.3000000
NODE_2397_length_1472_cov_22.159505	428	508	2	9	80	0.1125000
NODE_2397_length_1472_cov_22.159505	428	508	3	8	80	0.1000000
NODE_2397_length_1472_cov_22.159505	428	508	4	39	80	0.4875000
NODE_2397_length_1472_cov_22.159505	481	561	0	66	80	0.8250000
NODE_2397_length_1472_cov_22.159505	481	561	2	6	80	0.0750000
NODE_2397_length_1472_cov_22.159505	481	561	4	2	80	0.0250000
NODE_2397_length_1472_cov_22.159505	481	561	6	6	80	0.0750000
NODE_2397_length_1472_cov_22.159505	913	993	2	33	80	0.4125000
NODE_2397_length_1472_cov_22.159505	913	993	3	18	80	0.2250000
NODE_2397_length_1472_cov_22.159505	913	993	5	29	80	0.3625000
NODE_2397_length_1472_cov_22.159505	966	1046	3	13	80	0.1625000
NODE_2397_length_1472_cov_22.159505	966	1046	4	11	80	0.1375000
NODE_2397_length_1472_cov_22.159505	966	1046	5	56	80	0.7000000
NODE_2397_length_1472_cov_22.159505	1042	1122	0	26	80	0.3250000
NODE_2397_length_1472_cov_22.159505	1042	1122	1	1	80	0.0125000
NODE_2397_length_1472_cov_22.159505	1042	1122	3	53	80	0.6625000
NODE_2397_length_1472_cov_22.159505	1095	1175	0	47	80	0.5875000
NODE_2397_length_1472_cov_22.159505	1095	1175	1	33	80	0.4125000
NODE_2398_length_1472_cov_22.018208	523	590	6	7	67	0.1044776
NODE_2398_length_1472_cov_22.018208	523	590	7	2	67	0.0298507
NODE_2398_length_1472_cov_22.018208	523	590	9	9	67	0.1343284
NODE_2398_length_1472_cov_22.018208	523	590	11	9	67	0.1343284
NODE_2398_length_1472_cov_22.018208	523	590	12	24	67	0.3582090
NODE_2398_length_1472_cov_22.018208	523	590	13	16	67	0.2388060
NODE_2398_length_1472_cov_22.018208	563	643	12	16	80	0.2000000
NODE_2398_length_1472_cov_22.018208	563	643	13	52	80	0.6500000
NODE_2398_length_1472_cov_22.018208	563	643	15	8	80	0.1000000
NODE_2398_length_1472_cov_22.018208	563	643	16	4	80	0.0500000
NODE_2398_length_1472_cov_22.018208	639	719	10	26	80	0.3250000
NODE_2398_length_1472_cov_22.018208	639	719	11	15	80	0.1875000
NODE_2398_length_1472_cov_22.018208	639	719	12	8	80	0.1000000
NODE_2398_length_1472_cov_22.018208	639	719	13	21	80	0.2625000
NODE_2398_length_1472_cov_22.018208	639	719	15	10	80	0.1250000
NODE_2398_length_1472_cov_22.018208	692	772	9	32	80	0.4000000
NODE_2398_length_1472_cov_22.018208	692	772	10	38	80	0.4750000
NODE_2398_length_1472_cov_22.018208	692	772	11	8	80	0.1000000
NODE_2398_length_1472_cov_22.018208	692	772	12	2	80	0.0250000
NODE_2404_length_1470_cov_7.042305	5	57	2	52	52	1.0000000
NODE_2405_length_1470_cov_2.185266	199	245	0	46	46	1.0000000
NODE_2407_length_1469_cov_5.683942	834	914	0	80	80	1.0000000
NODE_2407_length_1469_cov_5.683942	887	967	0	80	80	1.0000000
NODE_2410_length_1467_cov_31.231725	1048	1131	0	83	83	1.0000000
NODE_2411_length_1467_cov_19.731725	485	565	8	10	80	0.1250000
NODE_2411_length_1467_cov_19.731725	485	565	9	23	80	0.2875000
NODE_2411_length_1467_cov_19.731725	485	565	10	2	80	0.0250000
NODE_2411_length_1467_cov_19.731725	485	565	11	9	80	0.1125000
NODE_2411_length_1467_cov_19.731725	485	565	12	36	80	0.4500000
NODE_2411_length_1467_cov_19.731725	538	618	10	32	80	0.4000000
NODE_2411_length_1467_cov_19.731725	538	618	11	29	80	0.3625000
NODE_2411_length_1467_cov_19.731725	538	618	12	19	80	0.2375000
NODE_2412_length_1467_cov_11.807749	180	242	6	62	62	1.0000000
NODE_2412_length_1467_cov_11.807749	264	293	2	3	29	0.1034483
NODE_2412_length_1467_cov_11.807749	264	293	4	13	29	0.4482759
NODE_2412_length_1467_cov_11.807749	264	293	5	9	29	0.3103448
NODE_2412_length_1467_cov_11.807749	264	293	6	4	29	0.1379310
NODE_2412_length_1467_cov_11.807749	930	1010	6	14	80	0.1750000
NODE_2412_length_1467_cov_11.807749	930	1010	8	25	80	0.3125000
NODE_2412_length_1467_cov_11.807749	930	1010	10	41	80	0.5125000
NODE_2412_length_1467_cov_11.807749	983	1063	0	5	80	0.0625000
NODE_2412_length_1467_cov_11.807749	983	1063	2	9	80	0.1125000
NODE_2412_length_1467_cov_11.807749	983	1063	4	24	80	0.3000000
NODE_2412_length_1467_cov_11.807749	983	1063	6	19	80	0.2375000
NODE_2412_length_1467_cov_11.807749	983	1063	8	23	80	0.2875000
NODE_2414_length_1466_cov_41.326993	664	744	1	15	80	0.1875000
NODE_2414_length_1466_cov_41.326993	664	744	2	5	80	0.0625000
NODE_2414_length_1466_cov_41.326993	664	744	3	7	80	0.0875000
NODE_2414_length_1466_cov_41.326993	664	744	4	22	80	0.2750000
NODE_2414_length_1466_cov_41.326993	664	744	6	24	80	0.3000000
NODE_2414_length_1466_cov_41.326993	664	744	7	7	80	0.0875000
NODE_2414_length_1466_cov_41.326993	717	797	6	20	80	0.2500000
NODE_2414_length_1466_cov_41.326993	717	797	7	19	80	0.2375000
NODE_2414_length_1466_cov_41.326993	717	797	8	19	80	0.2375000
NODE_2414_length_1466_cov_41.326993	717	797	9	22	80	0.2750000
NODE_2414_length_1466_cov_41.326993	793	873	9	4	80	0.0500000
NODE_2414_length_1466_cov_41.326993	793	873	10	43	80	0.5375000
NODE_2414_length_1466_cov_41.326993	793	873	11	7	80	0.0875000
NODE_2414_length_1466_cov_41.326993	793	873	12	11	80	0.1375000
NODE_2414_length_1466_cov_41.326993	793	873	13	15	80	0.1875000
NODE_2414_length_1466_cov_41.326993	846	926	9	25	80	0.3125000
NODE_2414_length_1466_cov_41.326993	846	926	10	49	80	0.6125000
NODE_2414_length_1466_cov_41.326993	846	926	11	6	80	0.0750000
NODE_2420_length_1464_cov_6.726740	137	204	2	55	67	0.8208955
NODE_2420_length_1464_cov_6.726740	137	204	4	12	67	0.1791045
NODE_2422_length_1464_cov_2.198535	1301	1363	1	18	62	0.2903226
NODE_2422_length_1464_cov_2.198535	1301	1363	2	4	62	0.0645161
NODE_2422_length_1464_cov_2.198535	1301	1363	4	30	62	0.4838710
NODE_2422_length_1464_cov_2.198535	1301	1363	6	10	62	0.1612903
NODE_2425_length_1463_cov_15.345308	314	394	1	1	80	0.0125000
NODE_2425_length_1463_cov_15.345308	314	394	2	9	80	0.1125000
NODE_2425_length_1463_cov_15.345308	314	394	3	28	80	0.3500000
NODE_2425_length_1463_cov_15.345308	314	394	5	7	80	0.0875000
NODE_2425_length_1463_cov_15.345308	314	394	7	35	80	0.4375000
NODE_2425_length_1463_cov_15.345308	367	447	7	48	80	0.6000000
NODE_2425_length_1463_cov_15.345308	367	447	8	32	80	0.4000000
NODE_2427_length_1462_cov_18.082172	418	498	4	21	80	0.2625000
NODE_2427_length_1462_cov_18.082172	418	498	5	17	80	0.2125000
NODE_2427_length_1462_cov_18.082172	418	498	6	39	80	0.4875000
NODE_2427_length_1462_cov_18.082172	418	498	7	3	80	0.0375000
NODE_2427_length_1462_cov_18.082172	471	551	4	8	80	0.1000000
NODE_2427_length_1462_cov_18.082172	471	551	5	11	80	0.1375000
NODE_2427_length_1462_cov_18.082172	471	551	6	45	80	0.5625000
NODE_2427_length_1462_cov_18.082172	471	551	7	16	80	0.2000000
NODE_2427_length_1462_cov_18.082172	1036	1116	0	14	80	0.1750000
NODE_2427_length_1462_cov_18.082172	1036	1116	2	66	80	0.8250000
NODE_2427_length_1462_cov_18.082172	1089	1169	2	80	80	1.0000000
NODE_2428_length_1462_cov_1.792370	1247	1319	0	72	72	1.0000000
NODE_2428_length_1462_cov_1.792370	1305	1374	0	69	69	1.0000000
NODE_2433_length_1460_cov_23.927994	852	932	6	42	80	0.5250000
NODE_2433_length_1460_cov_23.927994	852	932	7	38	80	0.4750000
NODE_2433_length_1460_cov_23.927994	905	985	2	33	80	0.4125000
NODE_2433_length_1460_cov_23.927994	905	985	3	6	80	0.0750000
NODE_2433_length_1460_cov_23.927994	905	985	6	2	80	0.0250000
NODE_2433_length_1460_cov_23.927994	905	985	7	39	80	0.4875000
NODE_2436_length_1459_cov_43.600000	535	615	6	2	80	0.0250000
NODE_2436_length_1459_cov_43.600000	535	615	7	2	80	0.0250000
NODE_2436_length_1459_cov_43.600000	535	615	8	3	80	0.0375000
NODE_2436_length_1459_cov_43.600000	535	615	9	37	80	0.4625000
NODE_2436_length_1459_cov_43.600000	535	615	10	36	80	0.4500000
NODE_2436_length_1459_cov_43.600000	588	668	3	40	80	0.5000000
NODE_2436_length_1459_cov_43.600000	588	668	5	9	80	0.1125000
NODE_2436_length_1459_cov_43.600000	588	668	6	6	80	0.0750000
NODE_2436_length_1459_cov_43.600000	588	668	7	2	80	0.0250000
NODE_2436_length_1459_cov_43.600000	588	668	8	3	80	0.0375000
NODE_2436_length_1459_cov_43.600000	588	668	9	2	80	0.0250000
NODE_2436_length_1459_cov_43.600000	588	668	10	18	80	0.2250000
NODE_2436_length_1459_cov_43.600000	664	744	1	24	80	0.3000000
NODE_2436_length_1459_cov_43.600000	664	744	2	43	80	0.5375000
NODE_2436_length_1459_cov_43.600000	664	744	3	13	80	0.1625000
NODE_2436_length_1459_cov_43.600000	717	797	0	53	80	0.6625000
NODE_2436_length_1459_cov_43.600000	717	797	1	24	80	0.3000000
NODE_2436_length_1459_cov_43.600000	717	797	2	3	80	0.0375000
NODE_2437_length_1459_cov_32.276471	865	945	12	7	80	0.0875000
NODE_2437_length_1459_cov_32.276471	865	945	15	5	80	0.0625000
NODE_2437_length_1459_cov_32.276471	865	945	16	5	80	0.0625000
NODE_2437_length_1459_cov_32.276471	865	945	17	4	80	0.0500000
NODE_2437_length_1459_cov_32.276471	865	945	18	3	80	0.0375000
NODE_2437_length_1459_cov_32.276471	865	945	19	6	80	0.0750000
NODE_2437_length_1459_cov_32.276471	865	945	20	6	80	0.0750000
NODE_2437_length_1459_cov_32.276471	865	945	21	28	80	0.3500000
NODE_2437_length_1459_cov_32.276471	865	945	22	16	80	0.2000000
NODE_2437_length_1459_cov_32.276471	918	998	17	15	80	0.1875000
NODE_2437_length_1459_cov_32.276471	918	998	18	3	80	0.0375000
NODE_2437_length_1459_cov_32.276471	918	998	19	6	80	0.0750000
NODE_2437_length_1459_cov_32.276471	918	998	20	4	80	0.0500000
NODE_2437_length_1459_cov_32.276471	918	998	21	31	80	0.3875000
NODE_2437_length_1459_cov_32.276471	918	998	22	4	80	0.0500000
NODE_2437_length_1459_cov_32.276471	918	998	23	17	80	0.2125000
NODE_2437_length_1459_cov_32.276471	994	1074	9	2	80	0.0250000
NODE_2437_length_1459_cov_32.276471	994	1074	10	11	80	0.1375000
NODE_2437_length_1459_cov_32.276471	994	1074	11	22	80	0.2750000
NODE_2437_length_1459_cov_32.276471	994	1074	12	32	80	0.4000000
NODE_2437_length_1459_cov_32.276471	994	1074	14	1	80	0.0125000
NODE_2437_length_1459_cov_32.276471	994	1074	15	4	80	0.0500000
NODE_2437_length_1459_cov_32.276471	994	1074	17	8	80	0.1000000
NODE_2437_length_1459_cov_32.276471	1047	1127	6	19	80	0.2375000
NODE_2437_length_1459_cov_32.276471	1047	1127	8	15	80	0.1875000
NODE_2437_length_1459_cov_32.276471	1047	1127	10	24	80	0.3000000
NODE_2437_length_1459_cov_32.276471	1047	1127	11	11	80	0.1375000
NODE_2437_length_1459_cov_32.276471	1047	1127	12	11	80	0.1375000
NODE_2441_length_1458_cov_2.184695	1361	1441	0	80	80	1.0000000
NODE_2442_length_1457_cov_19.687040	834	914	1	11	80	0.1375000
NODE_2442_length_1457_cov_19.687040	834	914	2	3	80	0.0375000
NODE_2442_length_1457_cov_19.687040	834	914	3	6	80	0.0750000
NODE_2442_length_1457_cov_19.687040	834	914	4	11	80	0.1375000
NODE_2442_length_1457_cov_19.687040	834	914	5	4	80	0.0500000
NODE_2442_length_1457_cov_19.687040	834	914	6	45	80	0.5625000
NODE_2442_length_1457_cov_19.687040	887	967	6	57	80	0.7125000
NODE_2442_length_1457_cov_19.687040	887	967	7	21	80	0.2625000
NODE_2442_length_1457_cov_19.687040	887	967	8	2	80	0.0250000
NODE_2442_length_1457_cov_19.687040	963	1043	5	32	80	0.4000000
NODE_2442_length_1457_cov_19.687040	963	1043	6	11	80	0.1375000
NODE_2442_length_1457_cov_19.687040	963	1043	7	7	80	0.0875000
NODE_2442_length_1457_cov_19.687040	963	1043	8	30	80	0.3750000
NODE_2442_length_1457_cov_19.687040	1016	1096	2	22	80	0.2750000
NODE_2442_length_1457_cov_19.687040	1016	1096	4	5	80	0.0625000
NODE_2442_length_1457_cov_19.687040	1016	1096	5	51	80	0.6375000
NODE_2442_length_1457_cov_19.687040	1016	1096	6	2	80	0.0250000
NODE_2444_length_1457_cov_14.944772	754	834	5	5	80	0.0625000
NODE_2444_length_1457_cov_14.944772	754	834	6	34	80	0.4250000
NODE_2444_length_1457_cov_14.944772	754	834	7	3	80	0.0375000
NODE_2444_length_1457_cov_14.944772	754	834	8	4	80	0.0500000
NODE_2444_length_1457_cov_14.944772	754	834	9	27	80	0.3375000
NODE_2444_length_1457_cov_14.944772	754	834	10	7	80	0.0875000
NODE_2444_length_1457_cov_14.944772	807	887	8	24	80	0.3000000
NODE_2444_length_1457_cov_14.944772	807	887	9	39	80	0.4875000
NODE_2444_length_1457_cov_14.944772	807	887	10	17	80	0.2125000
NODE_2445_length_1457_cov_10.168630	827	907	7	50	80	0.6250000
NODE_2445_length_1457_cov_10.168630	827	907	8	21	80	0.2625000
NODE_2445_length_1457_cov_10.168630	827	907	9	9	80	0.1125000
NODE_2445_length_1457_cov_10.168630	880	960	7	18	80	0.2250000
NODE_2445_length_1457_cov_10.168630	880	960	8	21	80	0.2625000
NODE_2445_length_1457_cov_10.168630	880	960	9	12	80	0.1500000
NODE_2445_length_1457_cov_10.168630	880	960	10	29	80	0.3625000
NODE_2445_length_1457_cov_10.168630	956	1036	5	14	80	0.1750000
NODE_2445_length_1457_cov_10.168630	956	1036	6	29	80	0.3625000
NODE_2445_length_1457_cov_10.168630	956	1036	7	27	80	0.3375000
NODE_2445_length_1457_cov_10.168630	956	1036	8	10	80	0.1250000
NODE_2445_length_1457_cov_10.168630	1009	1089	1	1	80	0.0125000
NODE_2445_length_1457_cov_10.168630	1009	1089	2	31	80	0.3875000
NODE_2445_length_1457_cov_10.168630	1009	1089	3	9	80	0.1125000
NODE_2445_length_1457_cov_10.168630	1009	1089	4	1	80	0.0125000
NODE_2445_length_1457_cov_10.168630	1009	1089	5	25	80	0.3125000
NODE_2445_length_1457_cov_10.168630	1009	1089	6	13	80	0.1625000
NODE_2448_length_1456_cov_13.675755	557	637	2	2	80	0.0250000
NODE_2448_length_1456_cov_13.675755	557	637	3	23	80	0.2875000
NODE_2448_length_1456_cov_13.675755	557	637	4	55	80	0.6875000
NODE_2448_length_1456_cov_13.675755	610	690	2	31	80	0.3875000
NODE_2448_length_1456_cov_13.675755	610	690	3	24	80	0.3000000
NODE_2448_length_1456_cov_13.675755	610	690	4	25	80	0.3125000
NODE_2449_length_1456_cov_11.109064	951	1031	1	29	80	0.3625000
NODE_2449_length_1456_cov_11.109064	951	1031	3	30	80	0.3750000
NODE_2449_length_1456_cov_11.109064	951	1031	4	11	80	0.1375000
NODE_2449_length_1456_cov_11.109064	951	1031	5	10	80	0.1250000
NODE_2449_length_1456_cov_11.109064	1004	1084	3	10	80	0.1250000
NODE_2449_length_1456_cov_11.109064	1004	1084	4	11	80	0.1375000
NODE_2449_length_1456_cov_11.109064	1004	1084	5	48	80	0.6000000
NODE_2449_length_1456_cov_11.109064	1004	1084	6	11	80	0.1375000
NODE_2452_length_1456_cov_3.137067	374	410	2	7	36	0.1944444
NODE_2452_length_1456_cov_3.137067	374	410	3	18	36	0.5000000
NODE_2452_length_1456_cov_3.137067	374	410	4	11	36	0.3055556
NODE_2454_length_1456_cov_1.889462	35	99	0	63	64	0.9843750
NODE_2454_length_1456_cov_1.889462	35	99	2	1	64	0.0156250
NODE_2456_length_1455_cov_60.874631	369	449	5	5	80	0.0625000
NODE_2456_length_1455_cov_60.874631	369	449	6	23	80	0.2875000
NODE_2456_length_1455_cov_60.874631	369	449	7	35	80	0.4375000
NODE_2456_length_1455_cov_60.874631	369	449	8	2	80	0.0250000
NODE_2456_length_1455_cov_60.874631	369	449	9	15	80	0.1875000
NODE_2456_length_1455_cov_60.874631	422	502	7	10	80	0.1250000
NODE_2456_length_1455_cov_60.874631	422	502	8	2	80	0.0250000
NODE_2456_length_1455_cov_60.874631	422	502	9	15	80	0.1875000
NODE_2456_length_1455_cov_60.874631	422	502	11	6	80	0.0750000
NODE_2456_length_1455_cov_60.874631	422	502	12	10	80	0.1250000
NODE_2456_length_1455_cov_60.874631	422	502	13	4	80	0.0500000
NODE_2456_length_1455_cov_60.874631	422	502	14	20	80	0.2500000
NODE_2456_length_1455_cov_60.874631	422	502	15	5	80	0.0625000
NODE_2456_length_1455_cov_60.874631	422	502	16	6	80	0.0750000
NODE_2456_length_1455_cov_60.874631	422	502	17	2	80	0.0250000
NODE_2456_length_1455_cov_60.874631	498	578	16	9	80	0.1125000
NODE_2456_length_1455_cov_60.874631	498	578	17	5	80	0.0625000
NODE_2456_length_1455_cov_60.874631	498	578	18	6	80	0.0750000
NODE_2456_length_1455_cov_60.874631	498	578	19	18	80	0.2250000
NODE_2456_length_1455_cov_60.874631	498	578	20	17	80	0.2125000
NODE_2456_length_1455_cov_60.874631	498	578	21	25	80	0.3125000
NODE_2456_length_1455_cov_60.874631	551	631	9	2	80	0.0250000
NODE_2456_length_1455_cov_60.874631	551	631	10	4	80	0.0500000
NODE_2456_length_1455_cov_60.874631	551	631	11	6	80	0.0750000
NODE_2456_length_1455_cov_60.874631	551	631	12	7	80	0.0875000
NODE_2456_length_1455_cov_60.874631	551	631	13	31	80	0.3875000
NODE_2456_length_1455_cov_60.874631	551	631	19	16	80	0.2000000
NODE_2456_length_1455_cov_60.874631	551	631	20	3	80	0.0375000
NODE_2456_length_1455_cov_60.874631	551	631	21	11	80	0.1375000
NODE_2458_length_1455_cov_35.253687	615	695	2	3	80	0.0375000
NODE_2458_length_1455_cov_35.253687	615	695	3	13	80	0.1625000
NODE_2458_length_1455_cov_35.253687	615	695	5	15	80	0.1875000
NODE_2458_length_1455_cov_35.253687	615	695	6	5	80	0.0625000
NODE_2458_length_1455_cov_35.253687	615	695	8	11	80	0.1375000
NODE_2458_length_1455_cov_35.253687	615	695	10	27	80	0.3375000
NODE_2458_length_1455_cov_35.253687	615	695	11	6	80	0.0750000
NODE_2458_length_1455_cov_35.253687	668	748	9	32	80	0.4000000
NODE_2458_length_1455_cov_35.253687	668	748	10	21	80	0.2625000
NODE_2458_length_1455_cov_35.253687	668	748	11	27	80	0.3375000
NODE_2458_length_1455_cov_35.253687	744	824	7	25	80	0.3125000
NODE_2458_length_1455_cov_35.253687	744	824	8	10	80	0.1250000
NODE_2458_length_1455_cov_35.253687	744	824	9	12	80	0.1500000
NODE_2458_length_1455_cov_35.253687	744	824	10	17	80	0.2125000
NODE_2458_length_1455_cov_35.253687	744	824	11	5	80	0.0625000
NODE_2458_length_1455_cov_35.253687	744	824	12	11	80	0.1375000
NODE_2458_length_1455_cov_35.253687	797	877	9	16	80	0.2000000
NODE_2458_length_1455_cov_35.253687	797	877	10	29	80	0.3625000
NODE_2458_length_1455_cov_35.253687	797	877	11	24	80	0.3000000
NODE_2458_length_1455_cov_35.253687	797	877	12	11	80	0.1375000
NODE_2465_length_1452_cov_7.101256	976	1056	0	80	80	1.0000000
NODE_2465_length_1452_cov_7.101256	1029	1109	0	80	80	1.0000000
NODE_2465_length_1452_cov_7.101256	1105	1185	0	80	80	1.0000000
NODE_2465_length_1452_cov_7.101256	1158	1238	0	80	80	1.0000000
NODE_2470_length_1451_cov_23.880178	439	520	2	15	81	0.1851852
NODE_2470_length_1451_cov_23.880178	439	520	4	66	81	0.8148148
NODE_2470_length_1451_cov_23.880178	493	573	3	1	80	0.0125000
NODE_2470_length_1451_cov_23.880178	493	573	4	79	80	0.9875000
NODE_2471_length_1451_cov_16.249260	422	502	1	33	80	0.4125000
NODE_2471_length_1451_cov_16.249260	422	502	2	47	80	0.5875000
NODE_2471_length_1451_cov_16.249260	475	555	1	33	80	0.4125000
NODE_2471_length_1451_cov_16.249260	475	555	2	47	80	0.5875000
NODE_2472_length_1451_cov_8.663462	908	988	4	23	80	0.2875000
NODE_2472_length_1451_cov_8.663462	908	988	6	57	80	0.7125000
NODE_2472_length_1451_cov_8.663462	961	1040	2	33	79	0.4177215
NODE_2472_length_1451_cov_8.663462	961	1040	4	2	79	0.0253165
NODE_2472_length_1451_cov_8.663462	961	1040	6	44	79	0.5569620
NODE_2474_length_1451_cov_5.219675	897	977	2	80	80	1.0000000
NODE_2474_length_1451_cov_5.219675	950	1030	2	80	80	1.0000000
NODE_2477_length_1450_cov_20.371577	611	691	3	17	80	0.2125000
NODE_2477_length_1450_cov_20.371577	611	691	4	48	80	0.6000000
NODE_2477_length_1450_cov_20.371577	611	691	5	15	80	0.1875000
NODE_2477_length_1450_cov_20.371577	664	744	2	36	80	0.4500000
NODE_2477_length_1450_cov_20.371577	664	744	3	14	80	0.1750000
NODE_2477_length_1450_cov_20.371577	664	744	4	30	80	0.3750000
NODE_2482_length_1449_cov_24.665926	432	512	5	3	80	0.0375000
NODE_2482_length_1449_cov_24.665926	432	512	6	70	80	0.8750000
NODE_2482_length_1449_cov_24.665926	432	512	7	7	80	0.0875000
NODE_2482_length_1449_cov_24.665926	485	565	5	21	80	0.2625000
NODE_2482_length_1449_cov_24.665926	485	565	6	33	80	0.4125000
NODE_2482_length_1449_cov_24.665926	485	565	7	26	80	0.3250000
NODE_2482_length_1449_cov_24.665926	561	643	7	4	82	0.0487805
NODE_2482_length_1449_cov_24.665926	561	643	8	8	82	0.0975610
NODE_2482_length_1449_cov_24.665926	561	643	9	1	82	0.0121951
NODE_2482_length_1449_cov_24.665926	561	643	10	59	82	0.7195122
NODE_2482_length_1449_cov_24.665926	561	643	11	10	82	0.1219512
NODE_2482_length_1449_cov_24.665926	616	696	9	16	80	0.2000000
NODE_2482_length_1449_cov_24.665926	616	696	10	64	80	0.8000000
NODE_2485_length_1448_cov_20.587102	904	984	4	7	80	0.0875000
NODE_2485_length_1448_cov_20.587102	904	984	5	28	80	0.3500000
NODE_2485_length_1448_cov_20.587102	904	984	7	12	80	0.1500000
NODE_2485_length_1448_cov_20.587102	904	984	8	1	80	0.0125000
NODE_2485_length_1448_cov_20.587102	904	984	9	7	80	0.0875000
NODE_2485_length_1448_cov_20.587102	904	984	11	2	80	0.0250000
NODE_2485_length_1448_cov_20.587102	904	984	12	6	80	0.0750000
NODE_2485_length_1448_cov_20.587102	904	984	13	10	80	0.1250000
NODE_2485_length_1448_cov_20.587102	904	984	14	2	80	0.0250000
NODE_2485_length_1448_cov_20.587102	904	984	16	1	80	0.0125000
NODE_2485_length_1448_cov_20.587102	904	984	17	4	80	0.0500000
NODE_2485_length_1448_cov_20.587102	957	1037	9	6	80	0.0750000
NODE_2485_length_1448_cov_20.587102	957	1037	11	1	80	0.0125000
NODE_2485_length_1448_cov_20.587102	957	1037	12	3	80	0.0375000
NODE_2485_length_1448_cov_20.587102	957	1037	13	10	80	0.1250000
NODE_2485_length_1448_cov_20.587102	957	1037	14	2	80	0.0250000
NODE_2485_length_1448_cov_20.587102	957	1037	16	31	80	0.3875000
NODE_2485_length_1448_cov_20.587102	957	1037	17	8	80	0.1000000
NODE_2485_length_1448_cov_20.587102	957	1037	18	15	80	0.1875000
NODE_2485_length_1448_cov_20.587102	957	1037	19	2	80	0.0250000
NODE_2485_length_1448_cov_20.587102	957	1037	20	2	80	0.0250000
NODE_2487_length_1448_cov_8.693847	537	617	1	49	80	0.6125000
NODE_2487_length_1448_cov_8.693847	537	617	3	31	80	0.3875000
NODE_2487_length_1448_cov_8.693847	590	670	1	5	80	0.0625000
NODE_2487_length_1448_cov_8.693847	590	670	2	5	80	0.0625000
NODE_2487_length_1448_cov_8.693847	590	670	3	37	80	0.4625000
NODE_2487_length_1448_cov_8.693847	590	670	4	33	80	0.4125000
NODE_2488_length_1447_cov_21.391691	519	599	1	7	80	0.0875000
NODE_2488_length_1447_cov_21.391691	519	599	2	48	80	0.6000000
NODE_2488_length_1447_cov_21.391691	519	599	3	25	80	0.3125000
NODE_2488_length_1447_cov_21.391691	572	652	2	3	80	0.0375000
NODE_2488_length_1447_cov_21.391691	572	652	3	77	80	0.9625000
NODE_2488_length_1447_cov_21.391691	648	728	2	29	80	0.3625000
NODE_2488_length_1447_cov_21.391691	648	728	3	49	80	0.6125000
NODE_2488_length_1447_cov_21.391691	648	728	4	2	80	0.0250000
NODE_2488_length_1447_cov_21.391691	701	781	2	4	80	0.0500000
NODE_2488_length_1447_cov_21.391691	701	781	3	28	80	0.3500000
NODE_2488_length_1447_cov_21.391691	701	781	4	48	80	0.6000000
NODE_2491_length_1447_cov_2.262611	1268	1325	0	23	57	0.4035088
NODE_2491_length_1447_cov_2.262611	1268	1325	2	6	57	0.1052632
NODE_2491_length_1447_cov_2.262611	1268	1325	3	13	57	0.2280702
NODE_2491_length_1447_cov_2.262611	1268	1325	4	1	57	0.0175439
NODE_2491_length_1447_cov_2.262611	1268	1325	6	14	57	0.2456140
NODE_2491_length_1447_cov_2.262611	1321	1378	6	57	57	1.0000000
NODE_2494_length_1445_cov_22.052006	759	839	5	1	80	0.0125000
NODE_2494_length_1445_cov_22.052006	759	839	7	1	80	0.0125000
NODE_2494_length_1445_cov_22.052006	759	839	8	4	80	0.0500000
NODE_2494_length_1445_cov_22.052006	759	839	9	4	80	0.0500000
NODE_2494_length_1445_cov_22.052006	759	839	11	21	80	0.2625000
NODE_2494_length_1445_cov_22.052006	759	839	12	15	80	0.1875000
NODE_2494_length_1445_cov_22.052006	759	839	13	10	80	0.1250000
NODE_2494_length_1445_cov_22.052006	759	839	14	24	80	0.3000000
NODE_2494_length_1445_cov_22.052006	812	892	6	1	80	0.0125000
NODE_2494_length_1445_cov_22.052006	812	892	8	34	80	0.4250000
NODE_2494_length_1445_cov_22.052006	812	892	10	13	80	0.1625000
NODE_2494_length_1445_cov_22.052006	812	892	11	7	80	0.0875000
NODE_2494_length_1445_cov_22.052006	812	892	12	15	80	0.1875000
NODE_2494_length_1445_cov_22.052006	812	892	14	10	80	0.1250000
NODE_2494_length_1445_cov_22.052006	888	968	3	16	80	0.2000000
NODE_2494_length_1445_cov_22.052006	888	968	4	20	80	0.2500000
NODE_2494_length_1445_cov_22.052006	888	968	5	30	80	0.3750000
NODE_2494_length_1445_cov_22.052006	888	968	6	11	80	0.1375000
NODE_2494_length_1445_cov_22.052006	888	968	8	3	80	0.0375000
NODE_2494_length_1445_cov_22.052006	941	1021	3	35	80	0.4375000
NODE_2494_length_1445_cov_22.052006	941	1021	4	15	80	0.1875000
NODE_2494_length_1445_cov_22.052006	941	1021	5	30	80	0.3750000
NODE_2495_length_1445_cov_13.378900	584	664	2	8	80	0.1000000
NODE_2495_length_1445_cov_13.378900	584	664	3	5	80	0.0625000
NODE_2495_length_1445_cov_13.378900	584	664	4	67	80	0.8375000
NODE_2495_length_1445_cov_13.378900	637	717	2	39	80	0.4875000
NODE_2495_length_1445_cov_13.378900	637	717	4	41	80	0.5125000
NODE_2501_length_1443_cov_7.628720	480	560	1	80	80	1.0000000
NODE_2501_length_1443_cov_7.628720	533	613	0	6	80	0.0750000
NODE_2501_length_1443_cov_7.628720	533	613	1	74	80	0.9250000
NODE_2501_length_1443_cov_7.628720	609	689	0	80	80	1.0000000
NODE_2501_length_1443_cov_7.628720	662	742	0	39	80	0.4875000
NODE_2501_length_1443_cov_7.628720	662	742	1	41	80	0.5125000
NODE_2502_length_1443_cov_4.843006	924	1004	0	54	80	0.6750000
NODE_2502_length_1443_cov_4.843006	924	1004	1	26	80	0.3250000
NODE_2502_length_1443_cov_4.843006	977	1057	0	1	80	0.0125000
NODE_2502_length_1443_cov_4.843006	977	1057	1	79	80	0.9875000
NODE_2508_length_1442_cov_24.551750	427	507	5	31	80	0.3875000
NODE_2508_length_1442_cov_24.551750	427	507	6	7	80	0.0875000
NODE_2508_length_1442_cov_24.551750	427	507	7	1	80	0.0125000
NODE_2508_length_1442_cov_24.551750	427	507	8	23	80	0.2875000
NODE_2508_length_1442_cov_24.551750	427	507	9	1	80	0.0125000
NODE_2508_length_1442_cov_24.551750	427	507	10	6	80	0.0750000
NODE_2508_length_1442_cov_24.551750	427	507	11	11	80	0.1375000
NODE_2508_length_1442_cov_24.551750	480	560	8	9	80	0.1125000
NODE_2508_length_1442_cov_24.551750	480	560	9	9	80	0.1125000
NODE_2508_length_1442_cov_24.551750	480	560	10	19	80	0.2375000
NODE_2508_length_1442_cov_24.551750	480	560	11	13	80	0.1625000
NODE_2508_length_1442_cov_24.551750	480	560	12	11	80	0.1375000
NODE_2508_length_1442_cov_24.551750	480	560	13	1	80	0.0125000
NODE_2508_length_1442_cov_24.551750	480	560	14	2	80	0.0250000
NODE_2508_length_1442_cov_24.551750	480	560	15	2	80	0.0250000
NODE_2508_length_1442_cov_24.551750	480	560	16	1	80	0.0125000
NODE_2508_length_1442_cov_24.551750	480	560	17	1	80	0.0125000
NODE_2508_length_1442_cov_24.551750	480	560	18	9	80	0.1125000
NODE_2508_length_1442_cov_24.551750	480	560	19	3	80	0.0375000
NODE_2508_length_1442_cov_24.551750	556	636	16	3	80	0.0375000
NODE_2508_length_1442_cov_24.551750	556	636	18	4	80	0.0500000
NODE_2508_length_1442_cov_24.551750	556	636	19	10	80	0.1250000
NODE_2508_length_1442_cov_24.551750	556	636	20	4	80	0.0500000
NODE_2508_length_1442_cov_24.551750	556	636	21	7	80	0.0875000
NODE_2508_length_1442_cov_24.551750	556	636	22	9	80	0.1125000
NODE_2508_length_1442_cov_24.551750	556	636	23	3	80	0.0375000
NODE_2508_length_1442_cov_24.551750	556	636	24	4	80	0.0500000
NODE_2508_length_1442_cov_24.551750	556	636	26	5	80	0.0625000
NODE_2508_length_1442_cov_24.551750	556	636	28	3	80	0.0375000
NODE_2508_length_1442_cov_24.551750	556	636	29	21	80	0.2625000
NODE_2508_length_1442_cov_24.551750	556	636	30	7	80	0.0875000
NODE_2508_length_1442_cov_24.551750	609	689	22	9	80	0.1125000
NODE_2508_length_1442_cov_24.551750	609	689	23	2	80	0.0250000
NODE_2508_length_1442_cov_24.551750	609	689	25	11	80	0.1375000
NODE_2508_length_1442_cov_24.551750	609	689	26	5	80	0.0625000
NODE_2508_length_1442_cov_24.551750	609	689	27	12	80	0.1500000
NODE_2508_length_1442_cov_24.551750	609	689	28	3	80	0.0375000
NODE_2508_length_1442_cov_24.551750	609	689	29	31	80	0.3875000
NODE_2508_length_1442_cov_24.551750	609	689	30	7	80	0.0875000
NODE_2509_length_1442_cov_24.032762	424	504	4	6	80	0.0750000
NODE_2509_length_1442_cov_24.032762	424	504	5	74	80	0.9250000
NODE_2509_length_1442_cov_24.032762	477	557	3	1	80	0.0125000
NODE_2509_length_1442_cov_24.032762	477	557	4	18	80	0.2250000
NODE_2509_length_1442_cov_24.032762	477	557	5	25	80	0.3125000
NODE_2509_length_1442_cov_24.032762	477	557	6	21	80	0.2625000
NODE_2509_length_1442_cov_24.032762	477	557	7	15	80	0.1875000
NODE_2511_length_1441_cov_16.528316	963	1043	1	5	80	0.0625000
NODE_2511_length_1441_cov_16.528316	963	1043	2	11	80	0.1375000
NODE_2511_length_1441_cov_16.528316	963	1043	4	64	80	0.8000000
NODE_2511_length_1441_cov_16.528316	1016	1096	4	80	80	1.0000000
NODE_2512_length_1441_cov_3.781669	80	156	5	4	76	0.0526316
NODE_2512_length_1441_cov_3.781669	80	156	6	4	76	0.0526316
NODE_2512_length_1441_cov_3.781669	80	156	7	59	76	0.7763158
NODE_2512_length_1441_cov_3.781669	80	156	9	9	76	0.1184211
NODE_2512_length_1441_cov_3.781669	129	209	7	28	80	0.3500000
NODE_2512_length_1441_cov_3.781669	129	209	8	41	80	0.5125000
NODE_2512_length_1441_cov_3.781669	129	209	9	11	80	0.1375000
NODE_2515_length_1440_cov_34.523490	446	526	7	2	80	0.0250000
NODE_2515_length_1440_cov_34.523490	446	526	8	17	80	0.2125000
NODE_2515_length_1440_cov_34.523490	446	526	10	17	80	0.2125000
NODE_2515_length_1440_cov_34.523490	446	526	11	4	80	0.0500000
NODE_2515_length_1440_cov_34.523490	446	526	12	13	80	0.1625000
NODE_2515_length_1440_cov_34.523490	446	526	13	27	80	0.3375000
NODE_2515_length_1440_cov_34.523490	499	576	5	12	77	0.1558442
NODE_2515_length_1440_cov_34.523490	499	576	6	2	77	0.0259740
NODE_2515_length_1440_cov_34.523490	499	576	8	20	77	0.2597403
NODE_2515_length_1440_cov_34.523490	499	576	10	5	77	0.0649351
NODE_2515_length_1440_cov_34.523490	499	576	12	21	77	0.2727273
NODE_2515_length_1440_cov_34.523490	499	576	13	17	77	0.2207792
NODE_2515_length_1440_cov_34.523490	576	654	5	15	78	0.1923077
NODE_2515_length_1440_cov_34.523490	576	654	6	19	78	0.2435897
NODE_2515_length_1440_cov_34.523490	576	654	7	21	78	0.2692308
NODE_2515_length_1440_cov_34.523490	576	654	8	23	78	0.2948718
NODE_2515_length_1440_cov_34.523490	627	707	5	34	80	0.4250000
NODE_2515_length_1440_cov_34.523490	627	707	6	33	80	0.4125000
NODE_2515_length_1440_cov_34.523490	627	707	7	13	80	0.1625000
NODE_2516_length_1440_cov_20.372110	776	856	2	30	80	0.3750000
NODE_2516_length_1440_cov_20.372110	776	856	3	2	80	0.0250000
NODE_2516_length_1440_cov_20.372110	776	856	4	9	80	0.1125000
NODE_2516_length_1440_cov_20.372110	776	856	5	33	80	0.4125000
NODE_2516_length_1440_cov_20.372110	776	856	6	6	80	0.0750000
NODE_2516_length_1440_cov_20.372110	829	909	5	21	80	0.2625000
NODE_2516_length_1440_cov_20.372110	829	909	6	15	80	0.1875000
NODE_2516_length_1440_cov_20.372110	829	909	8	15	80	0.1875000
NODE_2516_length_1440_cov_20.372110	829	909	9	29	80	0.3625000
NODE_2516_length_1440_cov_20.372110	905	985	9	22	80	0.2750000
NODE_2516_length_1440_cov_20.372110	905	985	10	11	80	0.1375000
NODE_2516_length_1440_cov_20.372110	905	985	11	2	80	0.0250000
NODE_2516_length_1440_cov_20.372110	905	985	12	6	80	0.0750000
NODE_2516_length_1440_cov_20.372110	905	985	13	5	80	0.0625000
NODE_2516_length_1440_cov_20.372110	905	985	14	33	80	0.4125000
NODE_2516_length_1440_cov_20.372110	905	985	15	1	80	0.0125000
NODE_2516_length_1440_cov_20.372110	958	1038	10	18	80	0.2250000
NODE_2516_length_1440_cov_20.372110	958	1038	11	25	80	0.3125000
NODE_2516_length_1440_cov_20.372110	958	1038	13	2	80	0.0250000
NODE_2516_length_1440_cov_20.372110	958	1038	14	35	80	0.4375000
NODE_2517_length_1440_cov_14.476510	586	615	1	10	29	0.3448276
NODE_2517_length_1440_cov_14.476510	586	615	2	19	29	0.6551724
NODE_2517_length_1440_cov_14.476510	666	695	0	29	29	1.0000000
NODE_2517_length_1440_cov_14.476510	1295	1359	19	4	64	0.0625000
NODE_2517_length_1440_cov_14.476510	1295	1359	22	8	64	0.1250000
NODE_2517_length_1440_cov_14.476510	1295	1359	23	3	64	0.0468750
NODE_2517_length_1440_cov_14.476510	1295	1359	24	49	64	0.7656250
NODE_2518_length_1440_cov_9.049217	384	464	2	41	80	0.5125000
NODE_2518_length_1440_cov_9.049217	384	464	3	2	80	0.0250000
NODE_2518_length_1440_cov_9.049217	384	464	4	37	80	0.4625000
NODE_2518_length_1440_cov_9.049217	437	517	2	19	80	0.2375000
NODE_2518_length_1440_cov_9.049217	437	517	4	61	80	0.7625000
NODE_2520_length_1439_cov_11.784328	898	978	2	7	80	0.0875000
NODE_2520_length_1439_cov_11.784328	898	978	3	1	80	0.0125000
NODE_2520_length_1439_cov_11.784328	898	978	4	4	80	0.0500000
NODE_2520_length_1439_cov_11.784328	898	978	6	19	80	0.2375000
NODE_2520_length_1439_cov_11.784328	898	978	8	37	80	0.4625000
NODE_2520_length_1439_cov_11.784328	898	978	9	12	80	0.1500000
NODE_2520_length_1439_cov_11.784328	951	1031	5	18	80	0.2250000
NODE_2520_length_1439_cov_11.784328	951	1031	7	33	80	0.4125000
NODE_2520_length_1439_cov_11.784328	951	1031	8	20	80	0.2500000
NODE_2520_length_1439_cov_11.784328	951	1031	9	9	80	0.1125000
NODE_2525_length_1438_cov_41.481703	671	751	10	14	80	0.1750000
NODE_2525_length_1438_cov_41.481703	671	751	11	5	80	0.0625000
NODE_2525_length_1438_cov_41.481703	671	751	12	6	80	0.0750000
NODE_2525_length_1438_cov_41.481703	671	751	13	1	80	0.0125000
NODE_2525_length_1438_cov_41.481703	671	751	14	17	80	0.2125000
NODE_2525_length_1438_cov_41.481703	671	751	15	10	80	0.1250000
NODE_2525_length_1438_cov_41.481703	671	751	16	12	80	0.1500000
NODE_2525_length_1438_cov_41.481703	671	751	17	15	80	0.1875000
NODE_2525_length_1438_cov_41.481703	724	804	9	19	80	0.2375000
NODE_2525_length_1438_cov_41.481703	724	804	10	6	80	0.0750000
NODE_2525_length_1438_cov_41.481703	724	804	12	24	80	0.3000000
NODE_2525_length_1438_cov_41.481703	724	804	14	1	80	0.0125000
NODE_2525_length_1438_cov_41.481703	724	804	15	3	80	0.0375000
NODE_2525_length_1438_cov_41.481703	724	804	16	11	80	0.1375000
NODE_2525_length_1438_cov_41.481703	724	804	17	16	80	0.2000000
NODE_2529_length_1437_cov_14.449178	815	895	4	3	80	0.0375000
NODE_2529_length_1437_cov_14.449178	815	895	5	33	80	0.4125000
NODE_2529_length_1437_cov_14.449178	815	895	6	38	80	0.4750000
NODE_2529_length_1437_cov_14.449178	815	895	7	6	80	0.0750000
NODE_2529_length_1437_cov_14.449178	868	948	6	48	80	0.6000000
NODE_2529_length_1437_cov_14.449178	868	948	7	32	80	0.4000000
NODE_2529_length_1437_cov_14.449178	944	1024	5	23	80	0.2875000
NODE_2529_length_1437_cov_14.449178	944	1024	6	50	80	0.6250000
NODE_2529_length_1437_cov_14.449178	944	1024	7	7	80	0.0875000
NODE_2529_length_1437_cov_14.449178	997	1077	1	21	80	0.2625000
NODE_2529_length_1437_cov_14.449178	997	1077	2	6	80	0.0750000
NODE_2529_length_1437_cov_14.449178	997	1077	4	17	80	0.2125000
NODE_2529_length_1437_cov_14.449178	997	1077	5	32	80	0.4000000
NODE_2529_length_1437_cov_14.449178	997	1077	6	4	80	0.0500000
NODE_2532_length_1436_cov_96.256545	1145	1225	4	24	80	0.3000000
NODE_2532_length_1436_cov_96.256545	1145	1225	5	33	80	0.4125000
NODE_2532_length_1436_cov_96.256545	1145	1225	6	23	80	0.2875000
NODE_2532_length_1436_cov_96.256545	1198	1278	3	3	80	0.0375000
NODE_2532_length_1436_cov_96.256545	1198	1278	4	7	80	0.0875000
NODE_2532_length_1436_cov_96.256545	1198	1278	5	4	80	0.0500000
NODE_2532_length_1436_cov_96.256545	1198	1278	6	66	80	0.8250000
NODE_2532_length_1436_cov_96.256545	1274	1354	1	2	80	0.0250000
NODE_2532_length_1436_cov_96.256545	1274	1354	2	44	80	0.5500000
NODE_2532_length_1436_cov_96.256545	1274	1354	3	33	80	0.4125000
NODE_2532_length_1436_cov_96.256545	1274	1354	4	1	80	0.0125000
NODE_2532_length_1436_cov_96.256545	1327	1407	1	55	80	0.6875000
NODE_2532_length_1436_cov_96.256545	1327	1407	2	25	80	0.3125000
NODE_2536_length_1435_cov_21.468563	783	863	2	7	80	0.0875000
NODE_2536_length_1435_cov_21.468563	783	863	4	18	80	0.2250000
NODE_2536_length_1435_cov_21.468563	783	863	5	55	80	0.6875000
NODE_2536_length_1435_cov_21.468563	836	916	2	39	80	0.4875000
NODE_2536_length_1435_cov_21.468563	836	916	3	21	80	0.2625000
NODE_2536_length_1435_cov_21.468563	836	916	4	18	80	0.2250000
NODE_2536_length_1435_cov_21.468563	836	916	5	2	80	0.0250000
NODE_2536_length_1435_cov_21.468563	912	992	2	25	80	0.3125000
NODE_2536_length_1435_cov_21.468563	912	992	3	4	80	0.0500000
NODE_2536_length_1435_cov_21.468563	912	992	4	16	80	0.2000000
NODE_2536_length_1435_cov_21.468563	912	992	5	33	80	0.4125000
NODE_2536_length_1435_cov_21.468563	912	992	7	2	80	0.0250000
NODE_2536_length_1435_cov_21.468563	965	1045	5	25	80	0.3125000
NODE_2536_length_1435_cov_21.468563	965	1045	7	41	80	0.5125000
NODE_2536_length_1435_cov_21.468563	965	1045	8	14	80	0.1750000
NODE_2537_length_1435_cov_18.593563	1123	1203	3	31	80	0.3875000
NODE_2537_length_1435_cov_18.593563	1123	1203	4	18	80	0.2250000
NODE_2537_length_1435_cov_18.593563	1123	1203	5	3	80	0.0375000
NODE_2537_length_1435_cov_18.593563	1123	1203	6	2	80	0.0250000
NODE_2537_length_1435_cov_18.593563	1123	1203	8	26	80	0.3250000
NODE_2537_length_1435_cov_18.593563	1176	1256	2	29	80	0.3625000
NODE_2537_length_1435_cov_18.593563	1176	1256	3	32	80	0.4000000
NODE_2537_length_1435_cov_18.593563	1176	1256	4	19	80	0.2375000
NODE_2538_length_1435_cov_5.828593	299	379	0	25	80	0.3125000
NODE_2538_length_1435_cov_5.828593	299	379	1	55	80	0.6875000
NODE_2538_length_1435_cov_5.828593	352	432	1	80	80	1.0000000
NODE_2540_length_1434_cov_17.610487	1023	1103	5	31	80	0.3875000
NODE_2540_length_1434_cov_17.610487	1023	1103	6	27	80	0.3375000
NODE_2540_length_1434_cov_17.610487	1023	1103	7	8	80	0.1000000
NODE_2540_length_1434_cov_17.610487	1023	1103	8	4	80	0.0500000
NODE_2540_length_1434_cov_17.610487	1023	1103	9	10	80	0.1250000
NODE_2540_length_1434_cov_17.610487	1076	1156	6	5	80	0.0625000
NODE_2540_length_1434_cov_17.610487	1076	1156	7	8	80	0.1000000
NODE_2540_length_1434_cov_17.610487	1076	1156	8	4	80	0.0500000
NODE_2540_length_1434_cov_17.610487	1076	1156	9	36	80	0.4500000
NODE_2540_length_1434_cov_17.610487	1076	1156	12	12	80	0.1500000
NODE_2540_length_1434_cov_17.610487	1076	1156	13	10	80	0.1250000
NODE_2540_length_1434_cov_17.610487	1076	1156	14	5	80	0.0625000
NODE_2540_length_1434_cov_17.610487	1152	1232	10	8	80	0.1000000
NODE_2540_length_1434_cov_17.610487	1152	1232	11	10	80	0.1250000
NODE_2540_length_1434_cov_17.610487	1152	1232	12	23	80	0.2875000
NODE_2540_length_1434_cov_17.610487	1152	1232	13	39	80	0.4875000
NODE_2540_length_1434_cov_17.610487	1205	1285	3	6	80	0.0750000
NODE_2540_length_1434_cov_17.610487	1205	1285	4	29	80	0.3625000
NODE_2540_length_1434_cov_17.610487	1205	1285	6	2	80	0.0250000
NODE_2540_length_1434_cov_17.610487	1205	1285	7	3	80	0.0375000
NODE_2540_length_1434_cov_17.610487	1205	1285	9	3	80	0.0375000
NODE_2540_length_1434_cov_17.610487	1205	1285	10	9	80	0.1125000
NODE_2540_length_1434_cov_17.610487	1205	1285	11	19	80	0.2375000
NODE_2540_length_1434_cov_17.610487	1205	1285	13	9	80	0.1125000
NODE_2541_length_1434_cov_9.845693	846	926	2	29	80	0.3625000
NODE_2541_length_1434_cov_9.845693	846	926	4	46	80	0.5750000
NODE_2541_length_1434_cov_9.845693	846	926	5	5	80	0.0625000
NODE_2541_length_1434_cov_9.845693	899	978	2	39	79	0.4936709
NODE_2541_length_1434_cov_9.845693	899	978	3	40	79	0.5063291
NODE_2544_length_1433_cov_36.452774	538	618	6	1	80	0.0125000
NODE_2544_length_1433_cov_36.452774	538	618	7	13	80	0.1625000
NODE_2544_length_1433_cov_36.452774	538	618	8	18	80	0.2250000
NODE_2544_length_1433_cov_36.452774	538	618	9	12	80	0.1500000
NODE_2544_length_1433_cov_36.452774	538	618	10	36	80	0.4500000
NODE_2544_length_1433_cov_36.452774	591	671	7	2	80	0.0250000
NODE_2544_length_1433_cov_36.452774	591	671	8	6	80	0.0750000
NODE_2544_length_1433_cov_36.452774	591	671	9	9	80	0.1125000
NODE_2544_length_1433_cov_36.452774	591	671	10	63	80	0.7875000
NODE_2544_length_1433_cov_36.452774	667	747	5	13	80	0.1625000
NODE_2544_length_1433_cov_36.452774	667	747	6	15	80	0.1875000
NODE_2544_length_1433_cov_36.452774	667	747	7	50	80	0.6250000
NODE_2544_length_1433_cov_36.452774	667	747	9	2	80	0.0250000
NODE_2544_length_1433_cov_36.452774	720	800	5	55	80	0.6875000
NODE_2544_length_1433_cov_36.452774	720	800	6	13	80	0.1625000
NODE_2544_length_1433_cov_36.452774	720	800	7	12	80	0.1500000
NODE_2550_length_1431_cov_7.409159	513	593	1	80	80	1.0000000
NODE_2550_length_1431_cov_7.409159	566	646	0	10	80	0.1250000
NODE_2550_length_1431_cov_7.409159	566	646	1	70	80	0.8750000
NODE_2551_length_1431_cov_6.721471	1074	1154	1	34	80	0.4250000
NODE_2551_length_1431_cov_6.721471	1074	1154	2	46	80	0.5750000
NODE_2551_length_1431_cov_6.721471	1127	1207	0	13	80	0.1625000
NODE_2551_length_1431_cov_6.721471	1127	1207	1	67	80	0.8375000
NODE_2552_length_1430_cov_32.643877	753	833	3	26	80	0.3250000
NODE_2552_length_1430_cov_32.643877	753	833	5	17	80	0.2125000
NODE_2552_length_1430_cov_32.643877	753	833	9	3	80	0.0375000
NODE_2552_length_1430_cov_32.643877	753	833	10	28	80	0.3500000
NODE_2552_length_1430_cov_32.643877	753	833	11	6	80	0.0750000
NODE_2552_length_1430_cov_32.643877	806	886	9	5	80	0.0625000
NODE_2552_length_1430_cov_32.643877	806	886	10	71	80	0.8875000
NODE_2552_length_1430_cov_32.643877	806	886	11	4	80	0.0500000
NODE_2552_length_1430_cov_32.643877	882	962	3	25	80	0.3125000
NODE_2552_length_1430_cov_32.643877	882	962	5	20	80	0.2500000
NODE_2552_length_1430_cov_32.643877	882	962	7	5	80	0.0625000
NODE_2552_length_1430_cov_32.643877	882	962	9	28	80	0.3500000
NODE_2552_length_1430_cov_32.643877	882	962	10	2	80	0.0250000
NODE_2552_length_1430_cov_32.643877	935	1016	3	7	81	0.0864198
NODE_2552_length_1430_cov_32.643877	935	1016	5	60	81	0.7407407
NODE_2552_length_1430_cov_32.643877	935	1016	6	14	81	0.1728395
NODE_2557_length_1428_cov_5.895410	340	416	1	37	76	0.4868421
NODE_2557_length_1428_cov_5.895410	340	416	3	39	76	0.5131579
NODE_2557_length_1428_cov_5.895410	393	476	0	50	83	0.6024097
NODE_2557_length_1428_cov_5.895410	393	476	1	33	83	0.3975904
NODE_2560_length_1427_cov_38.919428	707	787	7	4	80	0.0500000
NODE_2560_length_1427_cov_38.919428	707	787	9	20	80	0.2500000
NODE_2560_length_1427_cov_38.919428	707	787	11	11	80	0.1375000
NODE_2560_length_1427_cov_38.919428	707	787	12	14	80	0.1750000
NODE_2560_length_1427_cov_38.919428	707	787	13	10	80	0.1250000
NODE_2560_length_1427_cov_38.919428	707	787	15	21	80	0.2625000
NODE_2560_length_1427_cov_38.919428	760	840	9	5	80	0.0625000
NODE_2560_length_1427_cov_38.919428	760	840	10	20	80	0.2500000
NODE_2560_length_1427_cov_38.919428	760	840	11	7	80	0.0875000
NODE_2560_length_1427_cov_38.919428	760	840	13	12	80	0.1500000
NODE_2560_length_1427_cov_38.919428	760	840	14	8	80	0.1000000
NODE_2560_length_1427_cov_38.919428	760	840	15	28	80	0.3500000
NODE_2560_length_1427_cov_38.919428	836	916	6	10	80	0.1250000
NODE_2560_length_1427_cov_38.919428	836	916	7	42	80	0.5250000
NODE_2560_length_1427_cov_38.919428	836	916	8	6	80	0.0750000
NODE_2560_length_1427_cov_38.919428	836	916	9	2	80	0.0250000
NODE_2560_length_1427_cov_38.919428	836	916	10	17	80	0.2125000
NODE_2560_length_1427_cov_38.919428	836	916	11	3	80	0.0375000
NODE_2560_length_1427_cov_38.919428	889	969	6	28	80	0.3500000
NODE_2560_length_1427_cov_38.919428	889	969	7	47	80	0.5875000
NODE_2560_length_1427_cov_38.919428	889	969	8	5	80	0.0625000
NODE_2561_length_1427_cov_19.442771	808	888	2	49	80	0.6125000
NODE_2561_length_1427_cov_19.442771	808	888	4	21	80	0.2625000
NODE_2561_length_1427_cov_19.442771	808	888	5	10	80	0.1250000
NODE_2561_length_1427_cov_19.442771	861	941	4	36	80	0.4500000
NODE_2561_length_1427_cov_19.442771	861	941	5	20	80	0.2500000
NODE_2561_length_1427_cov_19.442771	861	941	6	24	80	0.3000000
NODE_2561_length_1427_cov_19.442771	937	1017	4	24	80	0.3000000
NODE_2561_length_1427_cov_19.442771	937	1017	5	20	80	0.2500000
NODE_2561_length_1427_cov_19.442771	937	1017	6	36	80	0.4500000
NODE_2561_length_1427_cov_19.442771	990	1070	2	25	80	0.3125000
NODE_2561_length_1427_cov_19.442771	990	1070	3	3	80	0.0375000
NODE_2561_length_1427_cov_19.442771	990	1070	5	14	80	0.1750000
NODE_2561_length_1427_cov_19.442771	990	1070	6	38	80	0.4750000
NODE_2562_length_1427_cov_10.490964	728	808	1	80	80	1.0000000
NODE_2562_length_1427_cov_10.490964	781	861	1	67	80	0.8375000
NODE_2562_length_1427_cov_10.490964	781	861	2	13	80	0.1625000
NODE_2562_length_1427_cov_10.490964	857	937	1	70	80	0.8750000
NODE_2562_length_1427_cov_10.490964	857	937	2	10	80	0.1250000
NODE_2562_length_1427_cov_10.490964	910	990	1	57	80	0.7125000
NODE_2562_length_1427_cov_10.490964	910	990	3	23	80	0.2875000
NODE_2563_length_1427_cov_9.929217	646	726	0	16	80	0.2000000
NODE_2563_length_1427_cov_9.929217	646	726	1	2	80	0.0250000
NODE_2563_length_1427_cov_9.929217	646	726	2	44	80	0.5500000
NODE_2563_length_1427_cov_9.929217	646	726	5	18	80	0.2250000
NODE_2563_length_1427_cov_9.929217	699	779	2	9	80	0.1125000
NODE_2563_length_1427_cov_9.929217	699	779	5	18	80	0.2250000
NODE_2563_length_1427_cov_9.929217	699	779	8	17	80	0.2125000
NODE_2563_length_1427_cov_9.929217	699	779	9	36	80	0.4500000
NODE_2563_length_1427_cov_9.929217	775	855	7	6	80	0.0750000
NODE_2563_length_1427_cov_9.929217	775	855	8	58	80	0.7250000
NODE_2563_length_1427_cov_9.929217	775	855	9	16	80	0.2000000
NODE_2563_length_1427_cov_9.929217	828	908	1	15	80	0.1875000
NODE_2563_length_1427_cov_9.929217	828	908	2	17	80	0.2125000
NODE_2563_length_1427_cov_9.929217	828	908	5	18	80	0.2250000
NODE_2563_length_1427_cov_9.929217	828	908	7	1	80	0.0125000
NODE_2563_length_1427_cov_9.929217	828	908	8	29	80	0.3625000
NODE_2563_length_1427_cov_9.929217	1248	1324	0	66	76	0.8684211
NODE_2563_length_1427_cov_9.929217	1248	1324	2	10	76	0.1315790
NODE_2563_length_1427_cov_9.929217	1301	1376	0	13	75	0.1733333
NODE_2563_length_1427_cov_9.929217	1301	1376	2	62	75	0.8266667
NODE_2564_length_1427_cov_3.122741	1336	1399	0	63	63	1.0000000
NODE_2570_length_1426_cov_36.580256	422	502	5	9	80	0.1125000
NODE_2570_length_1426_cov_36.580256	422	502	6	14	80	0.1750000
NODE_2570_length_1426_cov_36.580256	422	502	7	22	80	0.2750000
NODE_2570_length_1426_cov_36.580256	422	502	9	5	80	0.0625000
NODE_2570_length_1426_cov_36.580256	422	502	10	14	80	0.1750000
NODE_2570_length_1426_cov_36.580256	422	502	11	16	80	0.2000000
NODE_2570_length_1426_cov_36.580256	475	555	9	14	80	0.1750000
NODE_2570_length_1426_cov_36.580256	475	555	10	13	80	0.1625000
NODE_2570_length_1426_cov_36.580256	475	555	11	35	80	0.4375000
NODE_2570_length_1426_cov_36.580256	475	555	13	4	80	0.0500000
NODE_2570_length_1426_cov_36.580256	475	555	14	14	80	0.1750000
NODE_2570_length_1426_cov_36.580256	551	631	12	10	80	0.1250000
NODE_2570_length_1426_cov_36.580256	551	631	13	7	80	0.0875000
NODE_2570_length_1426_cov_36.580256	551	631	14	37	80	0.4625000
NODE_2570_length_1426_cov_36.580256	551	631	15	19	80	0.2375000
NODE_2570_length_1426_cov_36.580256	551	631	16	7	80	0.0875000
NODE_2570_length_1426_cov_36.580256	604	684	10	1	80	0.0125000
NODE_2570_length_1426_cov_36.580256	604	684	11	21	80	0.2625000
NODE_2570_length_1426_cov_36.580256	604	684	12	27	80	0.3375000
NODE_2570_length_1426_cov_36.580256	604	684	13	18	80	0.2250000
NODE_2570_length_1426_cov_36.580256	604	684	14	13	80	0.1625000
NODE_2574_length_1425_cov_25.524133	561	641	3	3	80	0.0375000
NODE_2574_length_1425_cov_25.524133	561	641	4	3	80	0.0375000
NODE_2574_length_1425_cov_25.524133	561	641	5	4	80	0.0500000
NODE_2574_length_1425_cov_25.524133	561	641	6	27	80	0.3375000
NODE_2574_length_1425_cov_25.524133	561	641	7	9	80	0.1125000
NODE_2574_length_1425_cov_25.524133	561	641	8	12	80	0.1500000
NODE_2574_length_1425_cov_25.524133	561	641	9	22	80	0.2750000
NODE_2574_length_1425_cov_25.524133	614	694	7	9	80	0.1125000
NODE_2574_length_1425_cov_25.524133	614	694	8	5	80	0.0625000
NODE_2574_length_1425_cov_25.524133	614	694	9	66	80	0.8250000
NODE_2575_length_1425_cov_10.175716	361	441	1	80	80	1.0000000
NODE_2575_length_1425_cov_10.175716	414	494	0	12	80	0.1500000
NODE_2575_length_1425_cov_10.175716	414	494	1	68	80	0.8500000
NODE_2587_length_1423_cov_31.158610	862	942	14	7	80	0.0875000
NODE_2587_length_1423_cov_31.158610	862	942	15	4	80	0.0500000
NODE_2587_length_1423_cov_31.158610	862	942	17	2	80	0.0250000
NODE_2587_length_1423_cov_31.158610	862	942	19	16	80	0.2000000
NODE_2587_length_1423_cov_31.158610	862	942	20	10	80	0.1250000
NODE_2587_length_1423_cov_31.158610	862	942	21	33	80	0.4125000
NODE_2587_length_1423_cov_31.158610	862	942	23	8	80	0.1000000
NODE_2587_length_1423_cov_31.158610	915	995	7	9	80	0.1125000
NODE_2587_length_1423_cov_31.158610	915	995	9	2	80	0.0250000
NODE_2587_length_1423_cov_31.158610	915	995	12	4	80	0.0500000
NODE_2587_length_1423_cov_31.158610	915	995	13	1	80	0.0125000
NODE_2587_length_1423_cov_31.158610	915	995	14	19	80	0.2375000
NODE_2587_length_1423_cov_31.158610	915	995	15	5	80	0.0625000
NODE_2587_length_1423_cov_31.158610	915	995	16	4	80	0.0500000
NODE_2587_length_1423_cov_31.158610	915	995	18	6	80	0.0750000
NODE_2587_length_1423_cov_31.158610	915	995	20	12	80	0.1500000
NODE_2587_length_1423_cov_31.158610	915	995	21	18	80	0.2250000
NODE_2588_length_1423_cov_30.731873	764	844	6	7	80	0.0875000
NODE_2588_length_1423_cov_30.731873	764	844	7	5	80	0.0625000
NODE_2588_length_1423_cov_30.731873	764	844	8	2	80	0.0250000
NODE_2588_length_1423_cov_30.731873	764	844	9	2	80	0.0250000
NODE_2588_length_1423_cov_30.731873	764	844	12	21	80	0.2625000
NODE_2588_length_1423_cov_30.731873	764	844	14	4	80	0.0500000
NODE_2588_length_1423_cov_30.731873	764	844	15	4	80	0.0500000
NODE_2588_length_1423_cov_30.731873	764	844	17	20	80	0.2500000
NODE_2588_length_1423_cov_30.731873	764	844	19	15	80	0.1875000
NODE_2588_length_1423_cov_30.731873	817	897	14	5	80	0.0625000
NODE_2588_length_1423_cov_30.731873	817	897	16	17	80	0.2125000
NODE_2588_length_1423_cov_30.731873	817	897	17	12	80	0.1500000
NODE_2588_length_1423_cov_30.731873	817	897	18	17	80	0.2125000
NODE_2588_length_1423_cov_30.731873	817	897	19	28	80	0.3500000
NODE_2588_length_1423_cov_30.731873	817	897	21	1	80	0.0125000
NODE_2596_length_1421_cov_8.285930	136	212	43	9	76	0.1184211
NODE_2596_length_1421_cov_8.285930	136	212	44	4	76	0.0526316
NODE_2596_length_1421_cov_8.285930	136	212	45	5	76	0.0657895
NODE_2596_length_1421_cov_8.285930	136	212	46	6	76	0.0789474
NODE_2596_length_1421_cov_8.285930	136	212	47	14	76	0.1842105
NODE_2596_length_1421_cov_8.285930	136	212	48	5	76	0.0657895
NODE_2596_length_1421_cov_8.285930	136	212	49	4	76	0.0526316
NODE_2596_length_1421_cov_8.285930	136	212	50	7	76	0.0921053
NODE_2596_length_1421_cov_8.285930	136	212	51	11	76	0.1447368
NODE_2596_length_1421_cov_8.285930	136	212	54	4	76	0.0526316
NODE_2596_length_1421_cov_8.285930	136	212	55	2	76	0.0263158
NODE_2596_length_1421_cov_8.285930	136	212	56	2	76	0.0263158
NODE_2596_length_1421_cov_8.285930	136	212	57	2	76	0.0263158
NODE_2596_length_1421_cov_8.285930	136	212	58	1	76	0.0131579
NODE_2598_length_1421_cov_2.574130	22	102	0	80	80	1.0000000
NODE_2598_length_1421_cov_2.574130	75	132	0	57	57	1.0000000
NODE_2599_length_1420_cov_256.442846	60	140	2	20	80	0.2500000
NODE_2599_length_1420_cov_256.442846	60	140	3	16	80	0.2000000
NODE_2599_length_1420_cov_256.442846	60	140	4	2	80	0.0250000
NODE_2599_length_1420_cov_256.442846	60	140	5	2	80	0.0250000
NODE_2599_length_1420_cov_256.442846	60	140	7	10	80	0.1250000
NODE_2599_length_1420_cov_256.442846	60	140	8	8	80	0.1000000
NODE_2599_length_1420_cov_256.442846	60	140	9	22	80	0.2750000
NODE_2599_length_1420_cov_256.442846	1294	1360	0	66	66	1.0000000
NODE_2600_length_1420_cov_7.547313	628	708	0	80	80	1.0000000
NODE_2600_length_1420_cov_7.547313	681	761	0	80	80	1.0000000
NODE_2602_length_1420_cov_2.051476	972	1039	4	55	67	0.8208955
NODE_2602_length_1420_cov_2.051476	972	1039	5	12	67	0.1791045
NODE_2604_length_1419_cov_46.997727	1230	1305	0	75	75	1.0000000
NODE_2604_length_1419_cov_46.997727	1278	1332	0	54	54	1.0000000
NODE_2609_length_1418_cov_11.373010	432	512	3	7	80	0.0875000
NODE_2609_length_1418_cov_11.373010	432	512	5	14	80	0.1750000
NODE_2609_length_1418_cov_11.373010	432	512	7	59	80	0.7375000
NODE_2609_length_1418_cov_11.373010	485	556	1	6	71	0.0845070
NODE_2609_length_1418_cov_11.373010	485	556	2	19	71	0.2676056
NODE_2609_length_1418_cov_11.373010	485	556	3	26	71	0.3661972
NODE_2609_length_1418_cov_11.373010	485	556	5	14	71	0.1971831
NODE_2609_length_1418_cov_11.373010	485	556	7	6	71	0.0845070
NODE_2615_length_1417_cov_12.477997	354	399	3	45	45	1.0000000
NODE_2616_length_1417_cov_11.120637	794	874	4	9	80	0.1125000
NODE_2616_length_1417_cov_11.120637	794	874	5	52	80	0.6500000
NODE_2616_length_1417_cov_11.120637	794	874	6	7	80	0.0875000
NODE_2616_length_1417_cov_11.120637	794	874	7	12	80	0.1500000
NODE_2616_length_1417_cov_11.120637	847	927	4	18	80	0.2250000
NODE_2616_length_1417_cov_11.120637	847	927	5	6	80	0.0750000
NODE_2616_length_1417_cov_11.120637	847	927	6	2	80	0.0250000
NODE_2616_length_1417_cov_11.120637	847	927	7	46	80	0.5750000
NODE_2616_length_1417_cov_11.120637	847	927	8	8	80	0.1000000
NODE_2625_length_1415_cov_51.375380	423	503	10	5	80	0.0625000
NODE_2625_length_1415_cov_51.375380	423	503	11	4	80	0.0500000
NODE_2625_length_1415_cov_51.375380	423	503	12	6	80	0.0750000
NODE_2625_length_1415_cov_51.375380	423	503	13	17	80	0.2125000
NODE_2625_length_1415_cov_51.375380	423	503	14	16	80	0.2000000
NODE_2625_length_1415_cov_51.375380	423	503	15	31	80	0.3875000
NODE_2625_length_1415_cov_51.375380	423	503	16	1	80	0.0125000
NODE_2625_length_1415_cov_51.375380	476	556	7	10	80	0.1250000
NODE_2625_length_1415_cov_51.375380	476	556	8	3	80	0.0375000
NODE_2625_length_1415_cov_51.375380	476	556	9	15	80	0.1875000
NODE_2625_length_1415_cov_51.375380	476	556	10	4	80	0.0500000
NODE_2625_length_1415_cov_51.375380	476	556	12	10	80	0.1250000
NODE_2625_length_1415_cov_51.375380	476	556	13	21	80	0.2625000
NODE_2625_length_1415_cov_51.375380	476	556	14	17	80	0.2125000
NODE_2625_length_1415_cov_51.375380	552	632	9	15	80	0.1875000
NODE_2625_length_1415_cov_51.375380	552	632	10	3	80	0.0375000
NODE_2625_length_1415_cov_51.375380	552	632	11	1	80	0.0125000
NODE_2625_length_1415_cov_51.375380	552	632	12	9	80	0.1125000
NODE_2625_length_1415_cov_51.375380	552	632	13	3	80	0.0375000
NODE_2625_length_1415_cov_51.375380	552	632	18	8	80	0.1000000
NODE_2625_length_1415_cov_51.375380	552	632	19	12	80	0.1500000
NODE_2625_length_1415_cov_51.375380	552	632	20	12	80	0.1500000
NODE_2625_length_1415_cov_51.375380	552	632	21	3	80	0.0375000
NODE_2625_length_1415_cov_51.375380	552	632	22	11	80	0.1375000
NODE_2625_length_1415_cov_51.375380	552	632	23	3	80	0.0375000
NODE_2625_length_1415_cov_51.375380	605	683	15	1	78	0.0128205
NODE_2625_length_1415_cov_51.375380	605	683	17	10	78	0.1282051
NODE_2625_length_1415_cov_51.375380	605	683	18	11	78	0.1410256
NODE_2625_length_1415_cov_51.375380	605	683	19	14	78	0.1794872
NODE_2625_length_1415_cov_51.375380	605	683	20	10	78	0.1282051
NODE_2625_length_1415_cov_51.375380	605	683	21	12	78	0.1538462
NODE_2625_length_1415_cov_51.375380	605	683	22	17	78	0.2179487
NODE_2625_length_1415_cov_51.375380	605	683	23	3	78	0.0384615
NODE_2626_length_1415_cov_38.272036	513	593	10	6	80	0.0750000
NODE_2626_length_1415_cov_38.272036	513	593	13	10	80	0.1250000
NODE_2626_length_1415_cov_38.272036	513	593	14	10	80	0.1250000
NODE_2626_length_1415_cov_38.272036	513	593	15	42	80	0.5250000
NODE_2626_length_1415_cov_38.272036	513	593	16	10	80	0.1250000
NODE_2626_length_1415_cov_38.272036	513	593	17	2	80	0.0250000
NODE_2626_length_1415_cov_38.272036	566	646	8	9	80	0.1125000
NODE_2626_length_1415_cov_38.272036	566	646	9	3	80	0.0375000
NODE_2626_length_1415_cov_38.272036	566	646	10	3	80	0.0375000
NODE_2626_length_1415_cov_38.272036	566	646	12	4	80	0.0500000
NODE_2626_length_1415_cov_38.272036	566	646	13	9	80	0.1125000
NODE_2626_length_1415_cov_38.272036	566	646	14	2	80	0.0250000
NODE_2626_length_1415_cov_38.272036	566	646	15	33	80	0.4125000
NODE_2626_length_1415_cov_38.272036	566	646	16	10	80	0.1250000
NODE_2626_length_1415_cov_38.272036	566	646	17	7	80	0.0875000
NODE_2627_length_1415_cov_17.232523	642	722	4	9	80	0.1125000
NODE_2627_length_1415_cov_17.232523	642	722	5	7	80	0.0875000
NODE_2627_length_1415_cov_17.232523	642	722	6	28	80	0.3500000
NODE_2627_length_1415_cov_17.232523	642	722	7	4	80	0.0500000
NODE_2627_length_1415_cov_17.232523	642	722	9	19	80	0.2375000
NODE_2627_length_1415_cov_17.232523	642	722	10	5	80	0.0625000
NODE_2627_length_1415_cov_17.232523	642	722	11	8	80	0.1000000
NODE_2627_length_1415_cov_17.232523	695	775	8	25	80	0.3125000
NODE_2627_length_1415_cov_17.232523	695	775	9	14	80	0.1750000
NODE_2627_length_1415_cov_17.232523	695	775	10	32	80	0.4000000
NODE_2627_length_1415_cov_17.232523	695	775	11	9	80	0.1125000
NODE_2629_length_1414_cov_5.307985	1026	1106	2	72	80	0.9000000
NODE_2629_length_1414_cov_5.307985	1026	1106	4	8	80	0.1000000
NODE_2629_length_1414_cov_5.307985	1079	1159	0	15	80	0.1875000
NODE_2629_length_1414_cov_5.307985	1079	1159	1	16	80	0.2000000
NODE_2629_length_1414_cov_5.307985	1079	1159	2	49	80	0.6125000
NODE_2637_length_1412_cov_17.723534	875	955	4	23	80	0.2875000
NODE_2637_length_1412_cov_17.723534	875	955	6	16	80	0.2000000
NODE_2637_length_1412_cov_17.723534	875	955	8	13	80	0.1625000
NODE_2637_length_1412_cov_17.723534	875	955	9	1	80	0.0125000
NODE_2637_length_1412_cov_17.723534	875	955	10	27	80	0.3375000
NODE_2637_length_1412_cov_17.723534	928	1008	4	10	80	0.1250000
NODE_2637_length_1412_cov_17.723534	928	1008	6	5	80	0.0625000
NODE_2637_length_1412_cov_17.723534	928	1008	8	38	80	0.4750000
NODE_2637_length_1412_cov_17.723534	928	1008	10	27	80	0.3375000
NODE_2641_length_1411_cov_34.004573	516	596	7	1	80	0.0125000
NODE_2641_length_1411_cov_34.004573	516	596	9	9	80	0.1125000
NODE_2641_length_1411_cov_34.004573	516	596	10	5	80	0.0625000
NODE_2641_length_1411_cov_34.004573	516	596	11	2	80	0.0250000
NODE_2641_length_1411_cov_34.004573	516	596	12	1	80	0.0125000
NODE_2641_length_1411_cov_34.004573	516	596	13	9	80	0.1125000
NODE_2641_length_1411_cov_34.004573	516	596	14	16	80	0.2000000
NODE_2641_length_1411_cov_34.004573	516	596	15	9	80	0.1125000
NODE_2641_length_1411_cov_34.004573	516	596	16	17	80	0.2125000
NODE_2641_length_1411_cov_34.004573	516	596	17	8	80	0.1000000
NODE_2641_length_1411_cov_34.004573	516	596	18	3	80	0.0375000
NODE_2641_length_1411_cov_34.004573	569	649	14	3	80	0.0375000
NODE_2641_length_1411_cov_34.004573	569	649	15	33	80	0.4125000
NODE_2641_length_1411_cov_34.004573	569	649	16	29	80	0.3625000
NODE_2641_length_1411_cov_34.004573	569	649	17	11	80	0.1375000
NODE_2641_length_1411_cov_34.004573	569	649	18	4	80	0.0500000
NODE_2641_length_1411_cov_34.004573	645	725	13	7	80	0.0875000
NODE_2641_length_1411_cov_34.004573	645	725	14	20	80	0.2500000
NODE_2641_length_1411_cov_34.004573	645	725	15	10	80	0.1250000
NODE_2641_length_1411_cov_34.004573	645	725	16	11	80	0.1375000
NODE_2641_length_1411_cov_34.004573	645	725	17	19	80	0.2375000
NODE_2641_length_1411_cov_34.004573	645	725	18	1	80	0.0125000
NODE_2641_length_1411_cov_34.004573	645	725	19	9	80	0.1125000
NODE_2641_length_1411_cov_34.004573	645	725	20	3	80	0.0375000
NODE_2641_length_1411_cov_34.004573	698	778	16	5	80	0.0625000
NODE_2641_length_1411_cov_34.004573	698	778	17	19	80	0.2375000
NODE_2641_length_1411_cov_34.004573	698	778	18	15	80	0.1875000
NODE_2641_length_1411_cov_34.004573	698	778	19	35	80	0.4375000
NODE_2641_length_1411_cov_34.004573	698	778	20	6	80	0.0750000
NODE_2643_length_1409_cov_25.380153	828	908	2	26	80	0.3250000
NODE_2643_length_1409_cov_25.380153	828	908	4	10	80	0.1250000
NODE_2643_length_1409_cov_25.380153	828	908	5	14	80	0.1750000
NODE_2643_length_1409_cov_25.380153	828	908	6	30	80	0.3750000
NODE_2643_length_1409_cov_25.380153	881	961	5	1	80	0.0125000
NODE_2643_length_1409_cov_25.380153	881	961	6	51	80	0.6375000
NODE_2643_length_1409_cov_25.380153	881	961	7	26	80	0.3250000
NODE_2643_length_1409_cov_25.380153	881	961	8	2	80	0.0250000
NODE_2644_length_1409_cov_13.028244	349	405	0	56	56	1.0000000
NODE_2644_length_1409_cov_13.028244	416	482	0	66	66	1.0000000
NODE_2648_length_1408_cov_6.261268	492	572	5	64	80	0.8000000
NODE_2648_length_1408_cov_6.261268	492	572	6	16	80	0.2000000
NODE_2648_length_1408_cov_6.261268	545	625	1	1	80	0.0125000
NODE_2648_length_1408_cov_6.261268	545	625	2	3	80	0.0375000
NODE_2648_length_1408_cov_6.261268	545	625	4	22	80	0.2750000
NODE_2648_length_1408_cov_6.261268	545	625	5	11	80	0.1375000
NODE_2648_length_1408_cov_6.261268	545	625	6	43	80	0.5375000
NODE_2652_length_1407_cov_27.711009	772	852	17	7	80	0.0875000
NODE_2652_length_1407_cov_27.711009	772	852	18	16	80	0.2000000
NODE_2652_length_1407_cov_27.711009	772	852	19	20	80	0.2500000
NODE_2652_length_1407_cov_27.711009	772	852	20	37	80	0.4625000
NODE_2652_length_1407_cov_27.711009	825	905	7	7	80	0.0875000
NODE_2652_length_1407_cov_27.711009	825	905	8	3	80	0.0375000
NODE_2652_length_1407_cov_27.711009	825	905	9	1	80	0.0125000
NODE_2652_length_1407_cov_27.711009	825	905	10	6	80	0.0750000
NODE_2652_length_1407_cov_27.711009	825	905	11	16	80	0.2000000
NODE_2652_length_1407_cov_27.711009	825	905	12	6	80	0.0750000
NODE_2652_length_1407_cov_27.711009	825	905	13	6	80	0.0750000
NODE_2652_length_1407_cov_27.711009	825	905	14	3	80	0.0375000
NODE_2652_length_1407_cov_27.711009	825	905	16	1	80	0.0125000
NODE_2652_length_1407_cov_27.711009	825	905	17	11	80	0.1375000
NODE_2652_length_1407_cov_27.711009	825	905	18	5	80	0.0625000
NODE_2652_length_1407_cov_27.711009	825	905	19	4	80	0.0500000
NODE_2652_length_1407_cov_27.711009	825	905	20	11	80	0.1375000
NODE_2653_length_1407_cov_24.387615	586	666	4	2	80	0.0250000
NODE_2653_length_1407_cov_24.387615	586	666	6	22	80	0.2750000
NODE_2653_length_1407_cov_24.387615	586	666	7	27	80	0.3375000
NODE_2653_length_1407_cov_24.387615	586	666	9	29	80	0.3625000
NODE_2653_length_1407_cov_24.387615	639	719	7	20	80	0.2500000
NODE_2653_length_1407_cov_24.387615	639	719	8	37	80	0.4625000
NODE_2653_length_1407_cov_24.387615	639	719	9	23	80	0.2875000
NODE_2653_length_1407_cov_24.387615	715	795	6	26	80	0.3250000
NODE_2653_length_1407_cov_24.387615	715	795	7	30	80	0.3750000
NODE_2653_length_1407_cov_24.387615	715	795	8	22	80	0.2750000
NODE_2653_length_1407_cov_24.387615	715	795	9	2	80	0.0250000
NODE_2653_length_1407_cov_24.387615	768	848	4	30	80	0.3750000
NODE_2653_length_1407_cov_24.387615	768	848	6	49	80	0.6125000
NODE_2653_length_1407_cov_24.387615	768	848	8	1	80	0.0125000
NODE_2654_length_1407_cov_19.022936	551	629	7	14	78	0.1794872
NODE_2654_length_1407_cov_19.022936	551	629	8	43	78	0.5512820
NODE_2654_length_1407_cov_19.022936	551	629	9	14	78	0.1794872
NODE_2654_length_1407_cov_19.022936	551	629	10	7	78	0.0897436
NODE_2654_length_1407_cov_19.022936	602	665	5	10	63	0.1587302
NODE_2654_length_1407_cov_19.022936	602	665	6	15	63	0.2380952
NODE_2654_length_1407_cov_19.022936	602	665	7	14	63	0.2222222
NODE_2654_length_1407_cov_19.022936	602	665	8	24	63	0.3809524
NODE_2655_length_1407_cov_11.266820	813	893	4	48	80	0.6000000
NODE_2655_length_1407_cov_11.266820	813	893	5	26	80	0.3250000
NODE_2655_length_1407_cov_11.266820	813	893	7	6	80	0.0750000
NODE_2655_length_1407_cov_11.266820	866	946	3	24	80	0.3000000
NODE_2655_length_1407_cov_11.266820	866	946	4	2	80	0.0250000
NODE_2655_length_1407_cov_11.266820	866	946	5	45	80	0.5625000
NODE_2655_length_1407_cov_11.266820	866	946	6	9	80	0.1125000
NODE_2655_length_1407_cov_11.266820	942	1022	3	22	80	0.2750000
NODE_2655_length_1407_cov_11.266820	942	1022	4	20	80	0.2500000
NODE_2655_length_1407_cov_11.266820	942	1022	5	3	80	0.0375000
NODE_2655_length_1407_cov_11.266820	942	1022	6	13	80	0.1625000
NODE_2655_length_1407_cov_11.266820	942	1022	7	22	80	0.2750000
NODE_2655_length_1407_cov_11.266820	995	1075	5	22	80	0.2750000
NODE_2655_length_1407_cov_11.266820	995	1075	6	36	80	0.4500000
NODE_2655_length_1407_cov_11.266820	995	1075	7	22	80	0.2750000
NODE_2657_length_1406_cov_7.247896	761	841	0	28	80	0.3500000
NODE_2657_length_1406_cov_7.247896	761	841	1	24	80	0.3000000
NODE_2657_length_1406_cov_7.247896	761	841	2	28	80	0.3500000
NODE_2657_length_1406_cov_7.247896	814	894	2	80	80	1.0000000
NODE_2659_length_1404_cov_23.406130	826	906	3	20	80	0.2500000
NODE_2659_length_1404_cov_23.406130	826	906	4	7	80	0.0875000
NODE_2659_length_1404_cov_23.406130	826	906	5	3	80	0.0375000
NODE_2659_length_1404_cov_23.406130	826	906	7	3	80	0.0375000
NODE_2659_length_1404_cov_23.406130	826	906	9	4	80	0.0500000
NODE_2659_length_1404_cov_23.406130	826	906	10	43	80	0.5375000
NODE_2659_length_1404_cov_23.406130	879	959	8	6	80	0.0750000
NODE_2659_length_1404_cov_23.406130	879	959	9	14	80	0.1750000
NODE_2659_length_1404_cov_23.406130	879	959	10	60	80	0.7500000
NODE_2659_length_1404_cov_23.406130	955	1035	5	13	80	0.1625000
NODE_2659_length_1404_cov_23.406130	955	1035	6	23	80	0.2875000
NODE_2659_length_1404_cov_23.406130	955	1035	8	14	80	0.1750000
NODE_2659_length_1404_cov_23.406130	955	1035	9	5	80	0.0625000
NODE_2659_length_1404_cov_23.406130	955	1035	10	21	80	0.2625000
NODE_2659_length_1404_cov_23.406130	955	1035	12	4	80	0.0500000
NODE_2659_length_1404_cov_23.406130	1008	1088	3	6	80	0.0750000
NODE_2659_length_1404_cov_23.406130	1008	1088	5	48	80	0.6000000
NODE_2659_length_1404_cov_23.406130	1008	1088	6	17	80	0.2125000
NODE_2659_length_1404_cov_23.406130	1008	1088	7	1	80	0.0125000
NODE_2659_length_1404_cov_23.406130	1008	1088	8	8	80	0.1000000
NODE_2666_length_1403_cov_14.331288	325	405	0	80	80	1.0000000
NODE_2666_length_1403_cov_14.331288	378	458	0	80	80	1.0000000
NODE_2666_length_1403_cov_14.331288	454	534	0	80	80	1.0000000
NODE_2666_length_1403_cov_14.331288	454	534	0	80	80	1.0000000
NODE_2666_length_1403_cov_14.331288	454	524	0	70	70	1.0000000
NODE_2666_length_1403_cov_14.331288	507	587	0	79	80	0.9875000
NODE_2666_length_1403_cov_14.331288	507	587	2	1	80	0.0125000
NODE_2666_length_1403_cov_14.331288	507	579	0	72	72	1.0000000
NODE_2668_length_1402_cov_29.095165	610	690	3	3	80	0.0375000
NODE_2668_length_1402_cov_29.095165	610	690	4	1	80	0.0125000
NODE_2668_length_1402_cov_29.095165	610	690	5	3	80	0.0375000
NODE_2668_length_1402_cov_29.095165	610	690	6	21	80	0.2625000
NODE_2668_length_1402_cov_29.095165	610	690	7	30	80	0.3750000
NODE_2668_length_1402_cov_29.095165	610	690	9	22	80	0.2750000
NODE_2668_length_1402_cov_29.095165	663	743	7	10	80	0.1250000
NODE_2668_length_1402_cov_29.095165	663	743	9	35	80	0.4375000
NODE_2668_length_1402_cov_29.095165	663	743	10	1	80	0.0125000
NODE_2668_length_1402_cov_29.095165	663	743	11	34	80	0.4250000
NODE_2669_length_1402_cov_23.411358	528	608	1	51	80	0.6375000
NODE_2669_length_1402_cov_23.411358	528	608	2	29	80	0.3625000
NODE_2669_length_1402_cov_23.411358	581	661	1	26	80	0.3250000
NODE_2669_length_1402_cov_23.411358	581	661	2	29	80	0.3625000
NODE_2669_length_1402_cov_23.411358	581	661	3	25	80	0.3125000
NODE_2669_length_1402_cov_23.411358	657	737	3	5	80	0.0625000
NODE_2669_length_1402_cov_23.411358	657	737	4	18	80	0.2250000
NODE_2669_length_1402_cov_23.411358	657	737	5	7	80	0.0875000
NODE_2669_length_1402_cov_23.411358	657	737	6	50	80	0.6250000
NODE_2669_length_1402_cov_23.411358	710	790	4	15	80	0.1875000
NODE_2669_length_1402_cov_23.411358	710	790	5	19	80	0.2375000
NODE_2669_length_1402_cov_23.411358	710	790	6	46	80	0.5750000
NODE_2670_length_1402_cov_11.732924	661	741	4	8	80	0.1000000
NODE_2670_length_1402_cov_11.732924	661	741	6	72	80	0.9000000
NODE_2670_length_1402_cov_11.732924	714	794	2	27	80	0.3375000
NODE_2670_length_1402_cov_11.732924	714	794	3	10	80	0.1250000
NODE_2670_length_1402_cov_11.732924	714	794	4	7	80	0.0875000
NODE_2670_length_1402_cov_11.732924	714	794	5	14	80	0.1750000
NODE_2670_length_1402_cov_11.732924	714	794	6	22	80	0.2750000
NODE_2671_length_1402_cov_9.929394	766	846	4	11	80	0.1375000
NODE_2671_length_1402_cov_9.929394	766	846	5	21	80	0.2625000
NODE_2671_length_1402_cov_9.929394	766	846	7	10	80	0.1250000
NODE_2671_length_1402_cov_9.929394	766	846	8	38	80	0.4750000
NODE_2671_length_1402_cov_9.929394	819	899	4	10	80	0.1250000
NODE_2671_length_1402_cov_9.929394	819	899	5	20	80	0.2500000
NODE_2671_length_1402_cov_9.929394	819	899	8	50	80	0.6250000
NODE_2677_length_1401_cov_35.754992	825	905	13	6	80	0.0750000
NODE_2677_length_1401_cov_35.754992	825	905	14	6	80	0.0750000
NODE_2677_length_1401_cov_35.754992	825	905	15	5	80	0.0625000
NODE_2677_length_1401_cov_35.754992	825	905	17	10	80	0.1250000
NODE_2677_length_1401_cov_35.754992	825	905	20	5	80	0.0625000
NODE_2677_length_1401_cov_35.754992	825	905	21	7	80	0.0875000
NODE_2677_length_1401_cov_35.754992	825	905	22	7	80	0.0875000
NODE_2677_length_1401_cov_35.754992	825	905	23	8	80	0.1000000
NODE_2677_length_1401_cov_35.754992	825	905	24	26	80	0.3250000
NODE_2677_length_1401_cov_35.754992	878	958	10	3	80	0.0375000
NODE_2677_length_1401_cov_35.754992	878	958	11	8	80	0.1000000
NODE_2677_length_1401_cov_35.754992	878	958	20	10	80	0.1250000
NODE_2677_length_1401_cov_35.754992	878	958	21	7	80	0.0875000
NODE_2677_length_1401_cov_35.754992	878	958	22	12	80	0.1500000
NODE_2677_length_1401_cov_35.754992	878	958	23	18	80	0.2250000
NODE_2677_length_1401_cov_35.754992	878	958	24	22	80	0.2750000
NODE_2678_length_1401_cov_10.811828	539	619	0	75	80	0.9375000
NODE_2678_length_1401_cov_10.811828	539	619	2	5	80	0.0625000
NODE_2678_length_1401_cov_10.811828	592	672	0	22	80	0.2750000
NODE_2678_length_1401_cov_10.811828	592	672	2	58	80	0.7250000
NODE_2679_length_1401_cov_5.438556	241	321	2	17	80	0.2125000
NODE_2679_length_1401_cov_5.438556	241	321	3	63	80	0.7875000
NODE_2679_length_1401_cov_5.438556	294	374	2	43	80	0.5375000
NODE_2679_length_1401_cov_5.438556	294	374	3	37	80	0.4625000
NODE_2683_length_1400_cov_16.680246	813	893	1	47	80	0.5875000
NODE_2683_length_1400_cov_16.680246	813	893	3	3	80	0.0375000
NODE_2683_length_1400_cov_16.680246	813	893	4	30	80	0.3750000
NODE_2683_length_1400_cov_16.680246	866	946	3	26	80	0.3250000
NODE_2683_length_1400_cov_16.680246	866	946	4	54	80	0.6750000
NODE_2684_length_1400_cov_8.166795	53	133	5	18	80	0.2250000
NODE_2684_length_1400_cov_8.166795	53	133	7	14	80	0.1750000
NODE_2684_length_1400_cov_8.166795	53	133	8	48	80	0.6000000
NODE_2684_length_1400_cov_8.166795	106	186	3	3	80	0.0375000
NODE_2684_length_1400_cov_8.166795	106	186	4	9	80	0.1125000
NODE_2684_length_1400_cov_8.166795	106	186	6	10	80	0.1250000
NODE_2684_length_1400_cov_8.166795	106	186	7	31	80	0.3875000
NODE_2684_length_1400_cov_8.166795	106	186	8	27	80	0.3375000
NODE_2694_length_1397_cov_25.549307	869	918	3	19	49	0.3877551
NODE_2694_length_1397_cov_25.549307	869	918	4	4	49	0.0816327
NODE_2694_length_1397_cov_25.549307	869	918	5	26	49	0.5306122
NODE_2694_length_1397_cov_25.549307	891	971	4	23	80	0.2875000
NODE_2694_length_1397_cov_25.549307	891	971	5	26	80	0.3250000
NODE_2694_length_1397_cov_25.549307	891	971	6	31	80	0.3875000
NODE_2695_length_1397_cov_14.395223	672	752	2	80	80	1.0000000
NODE_2695_length_1397_cov_14.395223	725	805	2	80	80	1.0000000
NODE_2695_length_1397_cov_14.395223	801	881	0	24	80	0.3000000
NODE_2695_length_1397_cov_14.395223	801	881	1	49	80	0.6125000
NODE_2695_length_1397_cov_14.395223	801	881	2	7	80	0.0875000
NODE_2695_length_1397_cov_14.395223	854	934	1	80	80	1.0000000
NODE_2699_length_1396_cov_21.656130	825	905	4	80	80	1.0000000
NODE_2699_length_1396_cov_21.656130	878	958	0	20	80	0.2500000
NODE_2699_length_1396_cov_21.656130	878	958	1	12	80	0.1500000
NODE_2699_length_1396_cov_21.656130	878	958	2	9	80	0.1125000
NODE_2699_length_1396_cov_21.656130	878	958	3	4	80	0.0500000
NODE_2699_length_1396_cov_21.656130	878	958	4	35	80	0.4375000
NODE_2700_length_1396_cov_18.108712	560	640	0	5	80	0.0625000
NODE_2700_length_1396_cov_18.108712	560	640	2	15	80	0.1875000
NODE_2700_length_1396_cov_18.108712	560	640	4	49	80	0.6125000
NODE_2700_length_1396_cov_18.108712	560	640	6	4	80	0.0500000
NODE_2700_length_1396_cov_18.108712	560	640	8	7	80	0.0875000
NODE_2700_length_1396_cov_18.108712	613	693	4	16	80	0.2000000
NODE_2700_length_1396_cov_18.108712	613	693	6	4	80	0.0500000
NODE_2700_length_1396_cov_18.108712	613	693	8	11	80	0.1375000
NODE_2700_length_1396_cov_18.108712	613	693	9	49	80	0.6125000
NODE_2701_length_1396_cov_16.208944	136	198	0	62	62	1.0000000
NODE_2701_length_1396_cov_16.208944	848	928	10	80	80	1.0000000
NODE_2701_length_1396_cov_16.208944	901	981	1	19	80	0.2375000
NODE_2701_length_1396_cov_16.208944	901	981	2	4	80	0.0500000
NODE_2701_length_1396_cov_16.208944	901	981	3	4	80	0.0500000
NODE_2701_length_1396_cov_16.208944	901	981	4	13	80	0.1625000
NODE_2701_length_1396_cov_16.208944	901	981	5	10	80	0.1250000
NODE_2701_length_1396_cov_16.208944	901	981	9	1	80	0.0125000
NODE_2701_length_1396_cov_16.208944	901	981	10	29	80	0.3625000
NODE_2701_length_1396_cov_16.208944	977	1057	0	62	80	0.7750000
NODE_2701_length_1396_cov_16.208944	977	1057	1	18	80	0.2250000
NODE_2701_length_1396_cov_16.208944	1030	1110	0	80	80	1.0000000
NODE_2702_length_1396_cov_9.196608	428	508	4	7	80	0.0875000
NODE_2702_length_1396_cov_9.196608	428	508	6	12	80	0.1500000
NODE_2702_length_1396_cov_9.196608	428	508	7	6	80	0.0750000
NODE_2702_length_1396_cov_9.196608	428	508	8	18	80	0.2250000
NODE_2702_length_1396_cov_9.196608	428	508	9	5	80	0.0625000
NODE_2702_length_1396_cov_9.196608	428	508	10	18	80	0.2250000
NODE_2702_length_1396_cov_9.196608	428	508	12	14	80	0.1750000
NODE_2702_length_1396_cov_9.196608	481	561	8	5	80	0.0625000
NODE_2702_length_1396_cov_9.196608	481	561	9	22	80	0.2750000
NODE_2702_length_1396_cov_9.196608	481	561	10	22	80	0.2750000
NODE_2702_length_1396_cov_9.196608	481	561	12	31	80	0.3875000
NODE_2712_length_1394_cov_29.602317	349	415	0	66	66	1.0000000
NODE_2712_length_1394_cov_29.602317	349	416	0	67	67	1.0000000
NODE_2712_length_1394_cov_29.602317	1117	1197	4	5	80	0.0625000
NODE_2712_length_1394_cov_29.602317	1117	1197	6	75	80	0.9375000
NODE_2712_length_1394_cov_29.602317	1170	1250	3	2	80	0.0250000
NODE_2712_length_1394_cov_29.602317	1170	1250	4	31	80	0.3875000
NODE_2712_length_1394_cov_29.602317	1170	1250	5	14	80	0.1750000
NODE_2712_length_1394_cov_29.602317	1170	1250	6	33	80	0.4125000
NODE_2713_length_1394_cov_6.291892	313	393	3	32	80	0.4000000
NODE_2713_length_1394_cov_6.291892	313	393	4	6	80	0.0750000
NODE_2713_length_1394_cov_6.291892	313	393	5	2	80	0.0250000
NODE_2713_length_1394_cov_6.291892	313	393	6	40	80	0.5000000
NODE_2713_length_1394_cov_6.291892	366	446	3	5	80	0.0625000
NODE_2713_length_1394_cov_6.291892	366	446	4	51	80	0.6375000
NODE_2713_length_1394_cov_6.291892	366	446	5	2	80	0.0250000
NODE_2713_length_1394_cov_6.291892	366	446	6	22	80	0.2750000
NODE_2716_length_1393_cov_14.635240	1286	1339	0	53	53	1.0000000
NODE_2717_length_1393_cov_12.032457	737	817	0	13	80	0.1625000
NODE_2717_length_1393_cov_12.032457	737	817	1	41	80	0.5125000
NODE_2717_length_1393_cov_12.032457	737	817	2	26	80	0.3250000
NODE_2717_length_1393_cov_12.032457	790	870	1	1	80	0.0125000
NODE_2717_length_1393_cov_12.032457	790	870	2	79	80	0.9875000
NODE_2720_length_1392_cov_5.898685	270	350	0	40	80	0.5000000
NODE_2720_length_1392_cov_5.898685	270	350	1	12	80	0.1500000
NODE_2720_length_1392_cov_5.898685	270	350	2	28	80	0.3500000
NODE_2720_length_1392_cov_5.898685	323	399	0	76	76	1.0000000
NODE_2723_length_1391_cov_35.921827	415	495	5	21	80	0.2625000
NODE_2723_length_1391_cov_35.921827	415	495	6	41	80	0.5125000
NODE_2723_length_1391_cov_35.921827	415	495	7	16	80	0.2000000
NODE_2723_length_1391_cov_35.921827	415	495	8	2	80	0.0250000
NODE_2723_length_1391_cov_35.921827	468	548	5	1	80	0.0125000
NODE_2723_length_1391_cov_35.921827	468	548	6	8	80	0.1000000
NODE_2723_length_1391_cov_35.921827	468	548	7	57	80	0.7125000
NODE_2723_length_1391_cov_35.921827	468	548	8	14	80	0.1750000
NODE_2723_length_1391_cov_35.921827	544	624	6	2	80	0.0250000
NODE_2723_length_1391_cov_35.921827	544	624	7	18	80	0.2250000
NODE_2723_length_1391_cov_35.921827	544	624	8	23	80	0.2875000
NODE_2723_length_1391_cov_35.921827	544	624	9	20	80	0.2500000
NODE_2723_length_1391_cov_35.921827	544	624	10	13	80	0.1625000
NODE_2723_length_1391_cov_35.921827	544	624	11	4	80	0.0500000
NODE_2723_length_1391_cov_35.921827	597	677	7	35	80	0.4375000
NODE_2723_length_1391_cov_35.921827	597	677	8	12	80	0.1500000
NODE_2723_length_1391_cov_35.921827	597	677	9	16	80	0.2000000
NODE_2723_length_1391_cov_35.921827	597	677	10	13	80	0.1625000
NODE_2723_length_1391_cov_35.921827	597	677	11	4	80	0.0500000
NODE_2729_length_1390_cov_16.326878	550	630	2	40	80	0.5000000
NODE_2729_length_1390_cov_16.326878	550	630	3	7	80	0.0875000
NODE_2729_length_1390_cov_16.326878	550	630	4	2	80	0.0250000
NODE_2729_length_1390_cov_16.326878	550	630	6	15	80	0.1875000
NODE_2729_length_1390_cov_16.326878	550	630	8	13	80	0.1625000
NODE_2729_length_1390_cov_16.326878	550	630	9	3	80	0.0375000
NODE_2729_length_1390_cov_16.326878	603	683	6	11	80	0.1375000
NODE_2729_length_1390_cov_16.326878	603	683	8	13	80	0.1625000
NODE_2729_length_1390_cov_16.326878	603	683	9	23	80	0.2875000
NODE_2729_length_1390_cov_16.326878	603	683	10	1	80	0.0125000
NODE_2729_length_1390_cov_16.326878	603	683	11	11	80	0.1375000
NODE_2729_length_1390_cov_16.326878	603	683	12	15	80	0.1875000
NODE_2729_length_1390_cov_16.326878	603	683	13	6	80	0.0750000
NODE_2731_length_1389_cov_29.772093	780	860	12	14	80	0.1750000
NODE_2731_length_1389_cov_29.772093	780	860	13	10	80	0.1250000
NODE_2731_length_1389_cov_29.772093	780	860	14	2	80	0.0250000
NODE_2731_length_1389_cov_29.772093	780	860	15	10	80	0.1250000
NODE_2731_length_1389_cov_29.772093	780	860	16	5	80	0.0625000
NODE_2731_length_1389_cov_29.772093	780	860	17	3	80	0.0375000
NODE_2731_length_1389_cov_29.772093	780	860	18	11	80	0.1375000
NODE_2731_length_1389_cov_29.772093	780	860	19	25	80	0.3125000
NODE_2731_length_1389_cov_29.772093	833	913	11	6	80	0.0750000
NODE_2731_length_1389_cov_29.772093	833	913	12	14	80	0.1750000
NODE_2731_length_1389_cov_29.772093	833	913	13	5	80	0.0625000
NODE_2731_length_1389_cov_29.772093	833	913	14	24	80	0.3000000
NODE_2731_length_1389_cov_29.772093	833	913	15	6	80	0.0750000
NODE_2731_length_1389_cov_29.772093	833	913	16	5	80	0.0625000
NODE_2731_length_1389_cov_29.772093	833	913	18	5	80	0.0625000
NODE_2731_length_1389_cov_29.772093	833	913	19	15	80	0.1875000
NODE_2732_length_1389_cov_12.858140	821	901	2	25	80	0.3125000
NODE_2732_length_1389_cov_12.858140	821	901	3	55	80	0.6875000
NODE_2732_length_1389_cov_12.858140	874	954	0	7	80	0.0875000
NODE_2732_length_1389_cov_12.858140	874	954	1	31	80	0.3875000
NODE_2732_length_1389_cov_12.858140	874	954	2	40	80	0.5000000
NODE_2732_length_1389_cov_12.858140	874	954	3	2	80	0.0250000
NODE_2735_length_1388_cov_14.641583	529	610	1	81	81	1.0000000
NODE_2735_length_1388_cov_14.641583	583	660	0	44	77	0.5714286
NODE_2735_length_1388_cov_14.641583	583	660	1	33	77	0.4285714
NODE_2736_length_1388_cov_5.168348	427	499	18	15	72	0.2083333
NODE_2736_length_1388_cov_5.168348	427	499	19	20	72	0.2777778
NODE_2736_length_1388_cov_5.168348	427	499	20	15	72	0.2083333
NODE_2736_length_1388_cov_5.168348	427	499	21	20	72	0.2777778
NODE_2736_length_1388_cov_5.168348	427	499	22	2	72	0.0277778
NODE_2742_length_1386_cov_55.384615	559	639	9	3	80	0.0375000
NODE_2742_length_1386_cov_55.384615	559	639	11	2	80	0.0250000
NODE_2742_length_1386_cov_55.384615	559	639	12	7	80	0.0875000
NODE_2742_length_1386_cov_55.384615	559	639	14	24	80	0.3000000
NODE_2742_length_1386_cov_55.384615	559	639	15	5	80	0.0625000
NODE_2742_length_1386_cov_55.384615	559	639	16	39	80	0.4875000
NODE_2742_length_1386_cov_55.384615	612	692	10	9	80	0.1125000
NODE_2742_length_1386_cov_55.384615	612	692	11	10	80	0.1250000
NODE_2742_length_1386_cov_55.384615	612	692	12	1	80	0.0125000
NODE_2742_length_1386_cov_55.384615	612	692	13	13	80	0.1625000
NODE_2742_length_1386_cov_55.384615	612	692	14	37	80	0.4625000
NODE_2742_length_1386_cov_55.384615	612	692	15	1	80	0.0125000
NODE_2742_length_1386_cov_55.384615	612	692	16	9	80	0.1125000
NODE_2742_length_1386_cov_55.384615	688	768	3	36	80	0.4500000
NODE_2742_length_1386_cov_55.384615	688	768	4	4	80	0.0500000
NODE_2742_length_1386_cov_55.384615	688	768	5	13	80	0.1625000
NODE_2742_length_1386_cov_55.384615	688	768	7	2	80	0.0250000
NODE_2742_length_1386_cov_55.384615	688	768	8	3	80	0.0375000
NODE_2742_length_1386_cov_55.384615	688	768	9	9	80	0.1125000
NODE_2742_length_1386_cov_55.384615	688	768	10	9	80	0.1125000
NODE_2742_length_1386_cov_55.384615	688	768	11	4	80	0.0500000
NODE_2742_length_1386_cov_55.384615	741	821	3	41	80	0.5125000
NODE_2742_length_1386_cov_55.384615	741	821	4	39	80	0.4875000
NODE_2744_length_1386_cov_13.181041	549	629	11	11	80	0.1375000
NODE_2744_length_1386_cov_13.181041	549	629	12	11	80	0.1375000
NODE_2744_length_1386_cov_13.181041	549	629	14	17	80	0.2125000
NODE_2744_length_1386_cov_13.181041	549	629	15	41	80	0.5125000
NODE_2744_length_1386_cov_13.181041	602	682	4	3	80	0.0375000
NODE_2744_length_1386_cov_13.181041	602	682	6	34	80	0.4250000
NODE_2744_length_1386_cov_13.181041	602	682	7	1	80	0.0125000
NODE_2744_length_1386_cov_13.181041	602	682	8	8	80	0.1000000
NODE_2744_length_1386_cov_13.181041	602	682	9	4	80	0.0500000
NODE_2744_length_1386_cov_13.181041	602	682	10	2	80	0.0250000
NODE_2744_length_1386_cov_13.181041	602	682	11	12	80	0.1500000
NODE_2744_length_1386_cov_13.181041	602	682	12	11	80	0.1375000
NODE_2744_length_1386_cov_13.181041	602	682	14	4	80	0.0500000
NODE_2744_length_1386_cov_13.181041	602	682	15	1	80	0.0125000
NODE_2748_length_1385_cov_41.636081	968	1048	16	2	80	0.0250000
NODE_2748_length_1385_cov_41.636081	968	1048	18	2	80	0.0250000
NODE_2748_length_1385_cov_41.636081	968	1048	19	22	80	0.2750000
NODE_2748_length_1385_cov_41.636081	968	1048	20	1	80	0.0125000
NODE_2748_length_1385_cov_41.636081	968	1048	21	13	80	0.1625000
NODE_2748_length_1385_cov_41.636081	968	1048	22	16	80	0.2000000
NODE_2748_length_1385_cov_41.636081	968	1048	23	9	80	0.1125000
NODE_2748_length_1385_cov_41.636081	968	1048	24	15	80	0.1875000
NODE_2748_length_1385_cov_41.636081	1021	1101	10	1	80	0.0125000
NODE_2748_length_1385_cov_41.636081	1021	1101	11	7	80	0.0875000
NODE_2748_length_1385_cov_41.636081	1021	1101	12	14	80	0.1750000
NODE_2748_length_1385_cov_41.636081	1021	1101	14	3	80	0.0375000
NODE_2748_length_1385_cov_41.636081	1021	1101	16	2	80	0.0250000
NODE_2748_length_1385_cov_41.636081	1021	1101	17	2	80	0.0250000
NODE_2748_length_1385_cov_41.636081	1021	1101	19	29	80	0.3625000
NODE_2748_length_1385_cov_41.636081	1021	1101	20	10	80	0.1250000
NODE_2748_length_1385_cov_41.636081	1021	1101	21	4	80	0.0500000
NODE_2748_length_1385_cov_41.636081	1021	1101	23	8	80	0.1000000
NODE_2749_length_1385_cov_38.877138	707	787	10	24	80	0.3000000
NODE_2749_length_1385_cov_38.877138	707	787	11	29	80	0.3625000
NODE_2749_length_1385_cov_38.877138	707	787	12	27	80	0.3375000
NODE_2749_length_1385_cov_38.877138	760	840	6	8	80	0.1000000
NODE_2749_length_1385_cov_38.877138	760	840	7	15	80	0.1875000
NODE_2749_length_1385_cov_38.877138	760	840	8	1	80	0.0125000
NODE_2749_length_1385_cov_38.877138	760	840	9	2	80	0.0250000
NODE_2749_length_1385_cov_38.877138	760	840	10	21	80	0.2625000
NODE_2749_length_1385_cov_38.877138	760	840	11	12	80	0.1500000
NODE_2749_length_1385_cov_38.877138	760	840	12	21	80	0.2625000
NODE_2749_length_1385_cov_38.877138	836	916	6	4	80	0.0500000
NODE_2749_length_1385_cov_38.877138	836	916	7	24	80	0.3000000
NODE_2749_length_1385_cov_38.877138	836	916	8	44	80	0.5500000
NODE_2749_length_1385_cov_38.877138	836	916	9	5	80	0.0625000
NODE_2749_length_1385_cov_38.877138	836	916	10	3	80	0.0375000
NODE_2749_length_1385_cov_38.877138	889	969	4	5	80	0.0625000
NODE_2749_length_1385_cov_38.877138	889	969	6	30	80	0.3750000
NODE_2749_length_1385_cov_38.877138	889	969	7	21	80	0.2625000
NODE_2749_length_1385_cov_38.877138	889	969	8	23	80	0.2875000
NODE_2749_length_1385_cov_38.877138	889	969	9	1	80	0.0125000
NODE_2751_length_1385_cov_4.608865	844	904	4	26	60	0.4333333
NODE_2751_length_1385_cov_4.608865	844	904	5	12	60	0.2000000
NODE_2751_length_1385_cov_4.608865	844	904	6	22	60	0.3666667
NODE_2758_length_1384_cov_10.574319	865	922	4	5	57	0.0877193
NODE_2758_length_1384_cov_10.574319	865	922	7	21	57	0.3684210
NODE_2758_length_1384_cov_10.574319	865	922	9	31	57	0.5438597
NODE_2758_length_1384_cov_10.574319	933	1013	0	80	80	1.0000000
NODE_2758_length_1384_cov_10.574319	986	1066	0	80	80	1.0000000
NODE_2759_length_1383_cov_10.710280	414	493	0	79	79	1.0000000
NODE_2759_length_1383_cov_10.710280	466	546	0	80	80	1.0000000
NODE_2763_length_1382_cov_12.521434	837	917	1	56	80	0.7000000
NODE_2763_length_1382_cov_12.521434	837	917	2	24	80	0.3000000
NODE_2763_length_1382_cov_12.521434	890	970	1	38	80	0.4750000
NODE_2763_length_1382_cov_12.521434	890	970	2	42	80	0.5250000
NODE_2764_length_1382_cov_5.074045	1028	1108	0	80	80	1.0000000
NODE_2764_length_1382_cov_5.074045	1081	1161	0	80	80	1.0000000
NODE_2771_length_1381_cov_7.796412	307	387	1	39	80	0.4875000
NODE_2771_length_1381_cov_7.796412	307	387	2	41	80	0.5125000
NODE_2771_length_1381_cov_7.796412	360	440	0	26	80	0.3250000
NODE_2771_length_1381_cov_7.796412	360	440	1	54	80	0.6750000
NODE_2775_length_1380_cov_12.804059	835	915	3	13	80	0.1625000
NODE_2775_length_1380_cov_12.804059	835	915	4	3	80	0.0375000
NODE_2775_length_1380_cov_12.804059	835	915	5	64	80	0.8000000
NODE_2775_length_1380_cov_12.804059	888	968	2	32	80	0.4000000
NODE_2775_length_1380_cov_12.804059	888	968	3	30	80	0.3750000
NODE_2775_length_1380_cov_12.804059	888	968	4	1	80	0.0125000
NODE_2775_length_1380_cov_12.804059	888	968	5	17	80	0.2125000
NODE_2782_length_1378_cov_25.362002	368	448	4	5	80	0.0625000
NODE_2782_length_1378_cov_25.362002	368	448	5	20	80	0.2500000
NODE_2782_length_1378_cov_25.362002	368	448	6	40	80	0.5000000
NODE_2782_length_1378_cov_25.362002	368	448	7	15	80	0.1875000
NODE_2782_length_1378_cov_25.362002	421	501	6	12	80	0.1500000
NODE_2782_length_1378_cov_25.362002	421	501	7	22	80	0.2750000
NODE_2782_length_1378_cov_25.362002	421	501	8	34	80	0.4250000
NODE_2782_length_1378_cov_25.362002	421	501	9	9	80	0.1125000
NODE_2782_length_1378_cov_25.362002	421	501	10	3	80	0.0375000
NODE_2782_length_1378_cov_25.362002	497	577	8	2	80	0.0250000
NODE_2782_length_1378_cov_25.362002	497	577	9	15	80	0.1875000
NODE_2782_length_1378_cov_25.362002	497	577	10	13	80	0.1625000
NODE_2782_length_1378_cov_25.362002	497	577	11	12	80	0.1500000
NODE_2782_length_1378_cov_25.362002	497	577	12	38	80	0.4750000
NODE_2782_length_1378_cov_25.362002	550	630	9	1	80	0.0125000
NODE_2782_length_1378_cov_25.362002	550	630	10	6	80	0.0750000
NODE_2782_length_1378_cov_25.362002	550	630	11	18	80	0.2250000
NODE_2782_length_1378_cov_25.362002	550	630	12	54	80	0.6750000
NODE_2782_length_1378_cov_25.362002	550	630	13	1	80	0.0125000
NODE_2783_length_1378_cov_20.508210	318	338	0	20	20	1.0000000
NODE_2783_length_1378_cov_20.508210	318	391	0	43	73	0.5890411
NODE_2783_length_1378_cov_20.508210	318	391	1	11	73	0.1506849
NODE_2783_length_1378_cov_20.508210	318	391	2	5	73	0.0684932
NODE_2783_length_1378_cov_20.508210	318	391	3	8	73	0.1095890
NODE_2783_length_1378_cov_20.508210	318	391	4	6	73	0.0821918
NODE_2785_length_1377_cov_103.832551	1259	1299	45	2	40	0.0500000
NODE_2785_length_1377_cov_103.832551	1259	1299	47	3	40	0.0750000
NODE_2785_length_1377_cov_103.832551	1259	1299	49	8	40	0.2000000
NODE_2785_length_1377_cov_103.832551	1259	1299	50	2	40	0.0500000
NODE_2785_length_1377_cov_103.832551	1259	1299	54	2	40	0.0500000
NODE_2785_length_1377_cov_103.832551	1259	1299	55	4	40	0.1000000
NODE_2785_length_1377_cov_103.832551	1259	1299	57	3	40	0.0750000
NODE_2785_length_1377_cov_103.832551	1259	1299	59	4	40	0.1000000
NODE_2785_length_1377_cov_103.832551	1259	1299	62	6	40	0.1500000
NODE_2785_length_1377_cov_103.832551	1259	1299	64	2	40	0.0500000
NODE_2785_length_1377_cov_103.832551	1259	1299	67	1	40	0.0250000
NODE_2785_length_1377_cov_103.832551	1259	1299	69	3	40	0.0750000
NODE_2788_length_1376_cov_7.967110	904	984	1	80	80	1.0000000
NODE_2788_length_1376_cov_7.967110	957	1037	0	5	80	0.0625000
NODE_2788_length_1376_cov_7.967110	957	1037	1	75	80	0.9375000
NODE_2798_length_1373_cov_52.691523	524	606	25	4	82	0.0487805
NODE_2798_length_1373_cov_52.691523	524	606	26	1	82	0.0121951
NODE_2798_length_1373_cov_52.691523	524	606	27	9	82	0.1097561
NODE_2798_length_1373_cov_52.691523	524	606	28	12	82	0.1463415
NODE_2798_length_1373_cov_52.691523	524	606	29	7	82	0.0853659
NODE_2798_length_1373_cov_52.691523	524	606	30	10	82	0.1219512
NODE_2798_length_1373_cov_52.691523	524	606	31	1	82	0.0121951
NODE_2798_length_1373_cov_52.691523	524	606	32	4	82	0.0487805
NODE_2798_length_1373_cov_52.691523	524	606	33	13	82	0.1585366
NODE_2798_length_1373_cov_52.691523	524	606	34	5	82	0.0609756
NODE_2798_length_1373_cov_52.691523	524	606	35	16	82	0.1951219
NODE_2798_length_1373_cov_52.691523	579	659	18	4	80	0.0500000
NODE_2798_length_1373_cov_52.691523	579	659	19	2	80	0.0250000
NODE_2798_length_1373_cov_52.691523	579	659	20	3	80	0.0375000
NODE_2798_length_1373_cov_52.691523	579	659	21	9	80	0.1125000
NODE_2798_length_1373_cov_52.691523	579	659	22	6	80	0.0750000
NODE_2798_length_1373_cov_52.691523	579	659	25	14	80	0.1750000
NODE_2798_length_1373_cov_52.691523	579	659	26	1	80	0.0125000
NODE_2798_length_1373_cov_52.691523	579	659	27	2	80	0.0250000
NODE_2798_length_1373_cov_52.691523	579	659	28	6	80	0.0750000
NODE_2798_length_1373_cov_52.691523	579	659	30	13	80	0.1625000
NODE_2798_length_1373_cov_52.691523	579	659	32	4	80	0.0500000
NODE_2798_length_1373_cov_52.691523	579	659	33	5	80	0.0625000
NODE_2798_length_1373_cov_52.691523	579	659	35	11	80	0.1375000
NODE_2799_length_1373_cov_20.880691	987	1067	5	26	80	0.3250000
NODE_2799_length_1373_cov_20.880691	987	1067	6	3	80	0.0375000
NODE_2799_length_1373_cov_20.880691	987	1067	8	51	80	0.6375000
NODE_2799_length_1373_cov_20.880691	1116	1195	9	6	79	0.0759494
NODE_2799_length_1373_cov_20.880691	1116	1195	10	39	79	0.4936709
NODE_2799_length_1373_cov_20.880691	1116	1195	11	34	79	0.4303797
NODE_2799_length_1373_cov_20.880691	1168	1248	2	3	80	0.0375000
NODE_2799_length_1373_cov_20.880691	1168	1248	4	8	80	0.1000000
NODE_2799_length_1373_cov_20.880691	1168	1248	6	4	80	0.0500000
NODE_2799_length_1373_cov_20.880691	1168	1248	8	29	80	0.3625000
NODE_2799_length_1373_cov_20.880691	1168	1248	10	36	80	0.4500000
NODE_2800_length_1373_cov_12.694662	94	167	7	14	73	0.1917808
NODE_2800_length_1373_cov_12.694662	94	167	8	8	73	0.1095890
NODE_2800_length_1373_cov_12.694662	94	167	10	5	73	0.0684932
NODE_2800_length_1373_cov_12.694662	94	167	11	4	73	0.0547945
NODE_2800_length_1373_cov_12.694662	94	167	12	1	73	0.0136986
NODE_2800_length_1373_cov_12.694662	94	167	13	3	73	0.0410959
NODE_2800_length_1373_cov_12.694662	94	167	15	13	73	0.1780822
NODE_2800_length_1373_cov_12.694662	94	167	16	6	73	0.0821918
NODE_2800_length_1373_cov_12.694662	94	167	17	1	73	0.0136986
NODE_2800_length_1373_cov_12.694662	94	167	18	4	73	0.0547945
NODE_2800_length_1373_cov_12.694662	94	167	19	5	73	0.0684932
NODE_2800_length_1373_cov_12.694662	94	167	20	3	73	0.0410959
NODE_2800_length_1373_cov_12.694662	94	167	22	4	73	0.0547945
NODE_2800_length_1373_cov_12.694662	94	167	23	2	73	0.0273973
NODE_2800_length_1373_cov_12.694662	140	224	15	2	84	0.0238095
NODE_2800_length_1373_cov_12.694662	140	224	16	6	84	0.0714286
NODE_2800_length_1373_cov_12.694662	140	224	17	1	84	0.0119048
NODE_2800_length_1373_cov_12.694662	140	224	18	4	84	0.0476190
NODE_2800_length_1373_cov_12.694662	140	224	19	5	84	0.0595238
NODE_2800_length_1373_cov_12.694662	140	224	20	3	84	0.0357143
NODE_2800_length_1373_cov_12.694662	140	224	22	7	84	0.0833333
NODE_2800_length_1373_cov_12.694662	140	224	23	26	84	0.3095238
NODE_2800_length_1373_cov_12.694662	140	224	24	3	84	0.0357143
NODE_2800_length_1373_cov_12.694662	140	224	25	1	84	0.0119048
NODE_2800_length_1373_cov_12.694662	140	224	26	16	84	0.1904762
NODE_2800_length_1373_cov_12.694662	140	224	27	10	84	0.1190476
NODE_2800_length_1373_cov_12.694662	1214	1286	0	72	72	1.0000000
NODE_2800_length_1373_cov_12.694662	1267	1339	0	72	72	1.0000000
NODE_2801_length_1372_cov_25.408484	665	745	16	7	80	0.0875000
NODE_2801_length_1372_cov_25.408484	665	745	17	1	80	0.0125000
NODE_2801_length_1372_cov_25.408484	665	745	18	16	80	0.2000000
NODE_2801_length_1372_cov_25.408484	665	745	19	16	80	0.2000000
NODE_2801_length_1372_cov_25.408484	665	745	20	34	80	0.4250000
NODE_2801_length_1372_cov_25.408484	665	745	21	1	80	0.0125000
NODE_2801_length_1372_cov_25.408484	665	745	22	5	80	0.0625000
NODE_2801_length_1372_cov_25.408484	718	798	13	14	80	0.1750000
NODE_2801_length_1372_cov_25.408484	718	798	14	12	80	0.1500000
NODE_2801_length_1372_cov_25.408484	718	798	15	24	80	0.3000000
NODE_2801_length_1372_cov_25.408484	718	798	16	10	80	0.1250000
NODE_2801_length_1372_cov_25.408484	718	798	17	1	80	0.0125000
NODE_2801_length_1372_cov_25.408484	718	798	19	3	80	0.0375000
NODE_2801_length_1372_cov_25.408484	718	798	20	13	80	0.1625000
NODE_2801_length_1372_cov_25.408484	718	798	22	3	80	0.0375000
NODE_2802_length_1372_cov_17.123331	647	727	9	14	80	0.1750000
NODE_2802_length_1372_cov_17.123331	647	727	10	8	80	0.1000000
NODE_2802_length_1372_cov_17.123331	647	727	12	7	80	0.0875000
NODE_2802_length_1372_cov_17.123331	647	727	13	15	80	0.1875000
NODE_2802_length_1372_cov_17.123331	647	727	14	27	80	0.3375000
NODE_2802_length_1372_cov_17.123331	647	727	15	6	80	0.0750000
NODE_2802_length_1372_cov_17.123331	647	727	17	1	80	0.0125000
NODE_2802_length_1372_cov_17.123331	647	727	18	2	80	0.0250000
NODE_2802_length_1372_cov_17.123331	700	780	12	3	80	0.0375000
NODE_2802_length_1372_cov_17.123331	700	780	13	3	80	0.0375000
NODE_2802_length_1372_cov_17.123331	700	780	14	43	80	0.5375000
NODE_2802_length_1372_cov_17.123331	700	780	15	17	80	0.2125000
NODE_2802_length_1372_cov_17.123331	700	780	16	1	80	0.0125000
NODE_2802_length_1372_cov_17.123331	700	780	17	2	80	0.0250000
NODE_2802_length_1372_cov_17.123331	700	780	18	11	80	0.1375000
NODE_2802_length_1372_cov_17.123331	776	856	12	13	80	0.1625000
NODE_2802_length_1372_cov_17.123331	776	856	13	15	80	0.1875000
NODE_2802_length_1372_cov_17.123331	776	856	14	15	80	0.1875000
NODE_2802_length_1372_cov_17.123331	776	856	15	27	80	0.3375000
NODE_2802_length_1372_cov_17.123331	776	856	16	2	80	0.0250000
NODE_2802_length_1372_cov_17.123331	776	856	17	8	80	0.1000000
NODE_2802_length_1372_cov_17.123331	829	909	4	20	80	0.2500000
NODE_2802_length_1372_cov_17.123331	829	909	7	1	80	0.0125000
NODE_2802_length_1372_cov_17.123331	829	909	9	13	80	0.1625000
NODE_2802_length_1372_cov_17.123331	829	909	10	4	80	0.0500000
NODE_2802_length_1372_cov_17.123331	829	909	11	11	80	0.1375000
NODE_2802_length_1372_cov_17.123331	829	909	12	17	80	0.2125000
NODE_2802_length_1372_cov_17.123331	829	909	13	12	80	0.1500000
NODE_2802_length_1372_cov_17.123331	829	909	14	2	80	0.0250000
NODE_2803_length_1372_cov_14.418696	211	291	5	2	80	0.0250000
NODE_2803_length_1372_cov_14.418696	211	291	6	1	80	0.0125000
NODE_2803_length_1372_cov_14.418696	211	291	7	23	80	0.2875000
NODE_2803_length_1372_cov_14.418696	211	291	8	5	80	0.0625000
NODE_2803_length_1372_cov_14.418696	211	291	9	6	80	0.0750000
NODE_2803_length_1372_cov_14.418696	211	291	10	9	80	0.1125000
NODE_2803_length_1372_cov_14.418696	211	291	12	4	80	0.0500000
NODE_2803_length_1372_cov_14.418696	211	291	13	9	80	0.1125000
NODE_2803_length_1372_cov_14.418696	211	291	15	1	80	0.0125000
NODE_2803_length_1372_cov_14.418696	211	291	16	13	80	0.1625000
NODE_2803_length_1372_cov_14.418696	211	291	17	7	80	0.0875000
NODE_2803_length_1372_cov_14.418696	264	344	11	10	80	0.1250000
NODE_2803_length_1372_cov_14.418696	264	344	13	28	80	0.3500000
NODE_2803_length_1372_cov_14.418696	264	344	14	19	80	0.2375000
NODE_2803_length_1372_cov_14.418696	264	344	15	1	80	0.0125000
NODE_2803_length_1372_cov_14.418696	264	344	16	15	80	0.1875000
NODE_2803_length_1372_cov_14.418696	264	344	17	7	80	0.0875000
NODE_2806_length_1371_cov_39.366352	715	795	4	8	80	0.1000000
NODE_2806_length_1371_cov_39.366352	715	795	6	7	80	0.0875000
NODE_2806_length_1371_cov_39.366352	715	795	8	15	80	0.1875000
NODE_2806_length_1371_cov_39.366352	715	795	10	33	80	0.4125000
NODE_2806_length_1371_cov_39.366352	715	795	12	17	80	0.2125000
NODE_2806_length_1371_cov_39.366352	768	848	10	10	80	0.1250000
NODE_2806_length_1371_cov_39.366352	768	848	12	18	80	0.2250000
NODE_2806_length_1371_cov_39.366352	768	848	13	3	80	0.0375000
NODE_2806_length_1371_cov_39.366352	768	848	14	7	80	0.0875000
NODE_2806_length_1371_cov_39.366352	768	848	15	6	80	0.0750000
NODE_2806_length_1371_cov_39.366352	768	848	16	19	80	0.2375000
NODE_2806_length_1371_cov_39.366352	768	848	17	17	80	0.2125000
NODE_2807_length_1371_cov_36.961478	371	455	2	84	84	1.0000000
NODE_2807_length_1371_cov_36.961478	424	508	1	36	84	0.4285714
NODE_2807_length_1371_cov_36.961478	424	508	2	48	84	0.5714286
NODE_2807_length_1371_cov_36.961478	504	584	1	36	80	0.4500000
NODE_2807_length_1371_cov_36.961478	504	584	2	15	80	0.1875000
NODE_2807_length_1371_cov_36.961478	504	584	4	29	80	0.3625000
NODE_2807_length_1371_cov_36.961478	557	637	4	60	80	0.7500000
NODE_2807_length_1371_cov_36.961478	557	637	5	20	80	0.2500000
NODE_2808_length_1371_cov_16.944182	459	539	0	50	80	0.6250000
NODE_2808_length_1371_cov_16.944182	459	539	2	30	80	0.3750000
NODE_2808_length_1371_cov_16.944182	512	592	2	80	80	1.0000000
NODE_2808_length_1371_cov_16.944182	588	668	2	35	80	0.4375000
NODE_2808_length_1371_cov_16.944182	588	668	3	20	80	0.2500000
NODE_2808_length_1371_cov_16.944182	588	668	5	25	80	0.3125000
NODE_2808_length_1371_cov_16.944182	641	721	3	2	80	0.0250000
NODE_2808_length_1371_cov_16.944182	641	721	5	78	80	0.9750000
NODE_2812_length_1370_cov_11.627065	502	582	0	80	80	1.0000000
NODE_2812_length_1370_cov_11.627065	555	635	0	80	80	1.0000000
NODE_2812_length_1370_cov_11.627065	631	711	0	80	80	1.0000000
NODE_2812_length_1370_cov_11.627065	684	764	0	80	80	1.0000000
NODE_2813_length_1369_cov_27.937795	597	677	6	8	80	0.1000000
NODE_2813_length_1369_cov_27.937795	597	677	7	1	80	0.0125000
NODE_2813_length_1369_cov_27.937795	597	677	8	7	80	0.0875000
NODE_2813_length_1369_cov_27.937795	597	677	10	2	80	0.0250000
NODE_2813_length_1369_cov_27.937795	597	677	11	5	80	0.0625000
NODE_2813_length_1369_cov_27.937795	597	677	12	6	80	0.0750000
NODE_2813_length_1369_cov_27.937795	597	677	13	26	80	0.3250000
NODE_2813_length_1369_cov_27.937795	597	677	14	25	80	0.3125000
NODE_2813_length_1369_cov_27.937795	650	730	7	8	80	0.1000000
NODE_2813_length_1369_cov_27.937795	650	730	8	8	80	0.1000000
NODE_2813_length_1369_cov_27.937795	650	730	9	14	80	0.1750000
NODE_2813_length_1369_cov_27.937795	650	730	10	8	80	0.1000000
NODE_2813_length_1369_cov_27.937795	650	730	13	5	80	0.0625000
NODE_2813_length_1369_cov_27.937795	650	730	14	37	80	0.4625000
NODE_2820_length_1368_cov_35.148148	546	626	5	4	80	0.0500000
NODE_2820_length_1368_cov_35.148148	546	626	6	4	80	0.0500000
NODE_2820_length_1368_cov_35.148148	546	626	7	4	80	0.0500000
NODE_2820_length_1368_cov_35.148148	546	626	8	23	80	0.2875000
NODE_2820_length_1368_cov_35.148148	546	626	9	4	80	0.0500000
NODE_2820_length_1368_cov_35.148148	546	626	10	4	80	0.0500000
NODE_2820_length_1368_cov_35.148148	546	626	11	6	80	0.0750000
NODE_2820_length_1368_cov_35.148148	546	626	12	28	80	0.3500000
NODE_2820_length_1368_cov_35.148148	546	626	13	3	80	0.0375000
NODE_2820_length_1368_cov_35.148148	599	679	6	15	80	0.1875000
NODE_2820_length_1368_cov_35.148148	599	679	8	40	80	0.5000000
NODE_2820_length_1368_cov_35.148148	599	679	12	25	80	0.3125000
NODE_2821_length_1368_cov_27.847912	486	559	4	46	73	0.6301370
NODE_2821_length_1368_cov_27.847912	486	559	5	11	73	0.1506849
NODE_2821_length_1368_cov_27.847912	486	559	6	16	73	0.2191781
NODE_2821_length_1368_cov_27.847912	532	612	0	10	80	0.1250000
NODE_2821_length_1368_cov_27.847912	532	612	1	30	80	0.3750000
NODE_2821_length_1368_cov_27.847912	532	612	3	11	80	0.1375000
NODE_2821_length_1368_cov_27.847912	532	612	4	29	80	0.3625000
NODE_2821_length_1368_cov_27.847912	608	688	0	80	80	1.0000000
NODE_2821_length_1368_cov_27.847912	661	741	0	80	80	1.0000000
NODE_2822_length_1368_cov_26.832151	458	538	1	63	80	0.7875000
NODE_2822_length_1368_cov_26.832151	458	538	2	4	80	0.0500000
NODE_2822_length_1368_cov_26.832151	458	538	3	13	80	0.1625000
NODE_2822_length_1368_cov_26.832151	511	591	1	10	80	0.1250000
NODE_2822_length_1368_cov_26.832151	511	591	2	4	80	0.0500000
NODE_2822_length_1368_cov_26.832151	511	591	3	31	80	0.3875000
NODE_2822_length_1368_cov_26.832151	511	591	4	19	80	0.2375000
NODE_2822_length_1368_cov_26.832151	511	591	5	1	80	0.0125000
NODE_2822_length_1368_cov_26.832151	511	591	7	5	80	0.0625000
NODE_2822_length_1368_cov_26.832151	511	591	9	2	80	0.0250000
NODE_2822_length_1368_cov_26.832151	511	591	11	8	80	0.1000000
NODE_2822_length_1368_cov_26.832151	587	667	11	15	80	0.1875000
NODE_2822_length_1368_cov_26.832151	587	667	13	2	80	0.0250000
NODE_2822_length_1368_cov_26.832151	587	667	15	30	80	0.3750000
NODE_2822_length_1368_cov_26.832151	587	667	16	17	80	0.2125000
NODE_2822_length_1368_cov_26.832151	587	667	17	3	80	0.0375000
NODE_2822_length_1368_cov_26.832151	587	667	18	5	80	0.0625000
NODE_2822_length_1368_cov_26.832151	587	667	19	8	80	0.1000000
NODE_2822_length_1368_cov_26.832151	640	720	8	4	80	0.0500000
NODE_2822_length_1368_cov_26.832151	640	720	10	2	80	0.0250000
NODE_2822_length_1368_cov_26.832151	640	720	11	1	80	0.0125000
NODE_2822_length_1368_cov_26.832151	640	720	13	12	80	0.1500000
NODE_2822_length_1368_cov_26.832151	640	720	15	15	80	0.1875000
NODE_2822_length_1368_cov_26.832151	640	720	16	25	80	0.3125000
NODE_2822_length_1368_cov_26.832151	640	720	17	3	80	0.0375000
NODE_2822_length_1368_cov_26.832151	640	720	18	6	80	0.0750000
NODE_2822_length_1368_cov_26.832151	640	720	19	12	80	0.1500000
NODE_2823_length_1368_cov_18.205674	603	683	0	3	80	0.0375000
NODE_2823_length_1368_cov_18.205674	603	683	1	21	80	0.2625000
NODE_2823_length_1368_cov_18.205674	603	683	2	10	80	0.1250000
NODE_2823_length_1368_cov_18.205674	603	683	4	27	80	0.3375000
NODE_2823_length_1368_cov_18.205674	603	683	5	19	80	0.2375000
NODE_2823_length_1368_cov_18.205674	656	736	4	8	80	0.1000000
NODE_2823_length_1368_cov_18.205674	656	736	5	59	80	0.7375000
NODE_2823_length_1368_cov_18.205674	656	736	6	13	80	0.1625000
NODE_2826_length_1367_cov_576.769716	799	879	136	1	80	0.0125000
NODE_2826_length_1367_cov_576.769716	799	879	137	1	80	0.0125000
NODE_2826_length_1367_cov_576.769716	799	879	139	5	80	0.0625000
NODE_2826_length_1367_cov_576.769716	799	879	140	1	80	0.0125000
NODE_2826_length_1367_cov_576.769716	799	879	141	2	80	0.0250000
NODE_2826_length_1367_cov_576.769716	799	879	142	2	80	0.0250000
NODE_2826_length_1367_cov_576.769716	799	879	143	3	80	0.0375000
NODE_2826_length_1367_cov_576.769716	799	879	144	6	80	0.0750000
NODE_2826_length_1367_cov_576.769716	799	879	145	3	80	0.0375000
NODE_2826_length_1367_cov_576.769716	799	879	146	5	80	0.0625000
NODE_2826_length_1367_cov_576.769716	799	879	147	6	80	0.0750000
NODE_2826_length_1367_cov_576.769716	799	879	148	6	80	0.0750000
NODE_2826_length_1367_cov_576.769716	799	879	149	7	80	0.0875000
NODE_2826_length_1367_cov_576.769716	799	879	150	5	80	0.0625000
NODE_2826_length_1367_cov_576.769716	799	879	151	2	80	0.0250000
NODE_2826_length_1367_cov_576.769716	799	879	152	5	80	0.0625000
NODE_2826_length_1367_cov_576.769716	799	879	153	1	80	0.0125000
NODE_2826_length_1367_cov_576.769716	799	879	155	1	80	0.0125000
NODE_2826_length_1367_cov_576.769716	799	879	157	3	80	0.0375000
NODE_2826_length_1367_cov_576.769716	799	879	158	2	80	0.0250000
NODE_2826_length_1367_cov_576.769716	799	879	159	1	80	0.0125000
NODE_2826_length_1367_cov_576.769716	799	879	160	2	80	0.0250000
NODE_2826_length_1367_cov_576.769716	799	879	161	2	80	0.0250000
NODE_2826_length_1367_cov_576.769716	799	879	162	3	80	0.0375000
NODE_2826_length_1367_cov_576.769716	799	879	165	1	80	0.0125000
NODE_2826_length_1367_cov_576.769716	799	879	166	2	80	0.0250000
NODE_2826_length_1367_cov_576.769716	799	879	167	2	80	0.0250000
NODE_2826_length_1367_cov_576.769716	852	932	143	1	80	0.0125000
NODE_2826_length_1367_cov_576.769716	852	932	144	1	80	0.0125000
NODE_2826_length_1367_cov_576.769716	852	932	146	1	80	0.0125000
NODE_2826_length_1367_cov_576.769716	852	932	147	1	80	0.0125000
NODE_2826_length_1367_cov_576.769716	852	932	148	3	80	0.0375000
NODE_2826_length_1367_cov_576.769716	852	932	149	1	80	0.0125000
NODE_2826_length_1367_cov_576.769716	852	932	150	1	80	0.0125000
NODE_2826_length_1367_cov_576.769716	852	932	151	1	80	0.0125000
NODE_2826_length_1367_cov_576.769716	852	932	152	4	80	0.0500000
NODE_2826_length_1367_cov_576.769716	852	932	153	1	80	0.0125000
NODE_2826_length_1367_cov_576.769716	852	932	154	2	80	0.0250000
NODE_2826_length_1367_cov_576.769716	852	932	155	2	80	0.0250000
NODE_2826_length_1367_cov_576.769716	852	932	156	2	80	0.0250000
NODE_2826_length_1367_cov_576.769716	852	932	157	5	80	0.0625000
NODE_2826_length_1367_cov_576.769716	852	932	158	2	80	0.0250000
NODE_2826_length_1367_cov_576.769716	852	932	159	1	80	0.0125000
NODE_2826_length_1367_cov_576.769716	852	932	160	2	80	0.0250000
NODE_2826_length_1367_cov_576.769716	852	932	161	3	80	0.0375000
NODE_2826_length_1367_cov_576.769716	852	932	162	3	80	0.0375000
NODE_2826_length_1367_cov_576.769716	852	932	163	1	80	0.0125000
NODE_2826_length_1367_cov_576.769716	852	932	164	1	80	0.0125000
NODE_2826_length_1367_cov_576.769716	852	932	165	4	80	0.0500000
NODE_2826_length_1367_cov_576.769716	852	932	166	9	80	0.1125000
NODE_2826_length_1367_cov_576.769716	852	932	167	6	80	0.0750000
NODE_2826_length_1367_cov_576.769716	852	932	168	8	80	0.1000000
NODE_2826_length_1367_cov_576.769716	852	932	169	9	80	0.1125000
NODE_2826_length_1367_cov_576.769716	852	932	170	5	80	0.0625000
NODE_2826_length_1367_cov_576.769716	900	980	99	2	80	0.0250000
NODE_2826_length_1367_cov_576.769716	900	980	110	2	80	0.0250000
NODE_2826_length_1367_cov_576.769716	900	980	111	6	80	0.0750000
NODE_2826_length_1367_cov_576.769716	900	980	112	2	80	0.0250000
NODE_2826_length_1367_cov_576.769716	900	980	113	6	80	0.0750000
NODE_2826_length_1367_cov_576.769716	900	980	114	2	80	0.0250000
NODE_2826_length_1367_cov_576.769716	900	980	115	3	80	0.0375000
NODE_2826_length_1367_cov_576.769716	900	980	117	2	80	0.0250000
NODE_2826_length_1367_cov_576.769716	900	980	118	1	80	0.0125000
NODE_2826_length_1367_cov_576.769716	900	980	121	3	80	0.0375000
NODE_2826_length_1367_cov_576.769716	900	980	122	4	80	0.0500000
NODE_2826_length_1367_cov_576.769716	900	980	124	1	80	0.0125000
NODE_2826_length_1367_cov_576.769716	900	980	125	1	80	0.0125000
NODE_2826_length_1367_cov_576.769716	900	980	126	1	80	0.0125000
NODE_2826_length_1367_cov_576.769716	900	980	128	1	80	0.0125000
NODE_2826_length_1367_cov_576.769716	900	980	129	1	80	0.0125000
NODE_2826_length_1367_cov_576.769716	900	980	130	2	80	0.0250000
NODE_2826_length_1367_cov_576.769716	900	980	131	3	80	0.0375000
NODE_2826_length_1367_cov_576.769716	900	980	132	1	80	0.0125000
NODE_2826_length_1367_cov_576.769716	900	980	135	1	80	0.0125000
NODE_2826_length_1367_cov_576.769716	900	980	139	1	80	0.0125000
NODE_2826_length_1367_cov_576.769716	900	980	142	2	80	0.0250000
NODE_2826_length_1367_cov_576.769716	900	980	143	1	80	0.0125000
NODE_2826_length_1367_cov_576.769716	900	980	144	1	80	0.0125000
NODE_2826_length_1367_cov_576.769716	900	980	146	1	80	0.0125000
NODE_2826_length_1367_cov_576.769716	900	980	147	1	80	0.0125000
NODE_2826_length_1367_cov_576.769716	900	980	148	3	80	0.0375000
NODE_2826_length_1367_cov_576.769716	900	980	154	2	80	0.0250000
NODE_2826_length_1367_cov_576.769716	900	980	155	1	80	0.0125000
NODE_2826_length_1367_cov_576.769716	900	980	156	2	80	0.0250000
NODE_2826_length_1367_cov_576.769716	900	980	157	2	80	0.0250000
NODE_2826_length_1367_cov_576.769716	900	980	161	1	80	0.0125000
NODE_2826_length_1367_cov_576.769716	900	980	163	1	80	0.0125000
NODE_2826_length_1367_cov_576.769716	900	980	164	1	80	0.0125000
NODE_2826_length_1367_cov_576.769716	900	980	165	2	80	0.0250000
NODE_2826_length_1367_cov_576.769716	900	980	166	6	80	0.0750000
NODE_2826_length_1367_cov_576.769716	900	980	167	2	80	0.0250000
NODE_2826_length_1367_cov_576.769716	900	980	168	3	80	0.0375000
NODE_2826_length_1367_cov_576.769716	900	980	169	2	80	0.0250000
NODE_2826_length_1367_cov_576.769716	905	927	147	1	22	0.0454545
NODE_2826_length_1367_cov_576.769716	905	927	148	1	22	0.0454545
NODE_2826_length_1367_cov_576.769716	905	927	154	2	22	0.0909091
NODE_2826_length_1367_cov_576.769716	905	927	155	1	22	0.0454545
NODE_2826_length_1367_cov_576.769716	905	927	156	2	22	0.0909091
NODE_2826_length_1367_cov_576.769716	905	927	157	2	22	0.0909091
NODE_2826_length_1367_cov_576.769716	905	927	161	1	22	0.0454545
NODE_2826_length_1367_cov_576.769716	905	927	163	1	22	0.0454545
NODE_2826_length_1367_cov_576.769716	905	927	164	1	22	0.0454545
NODE_2826_length_1367_cov_576.769716	905	927	165	2	22	0.0909091
NODE_2826_length_1367_cov_576.769716	905	927	166	6	22	0.2727273
NODE_2826_length_1367_cov_576.769716	905	927	167	1	22	0.0454545
NODE_2826_length_1367_cov_576.769716	905	927	168	1	22	0.0454545
NODE_2826_length_1367_cov_576.769716	1051	1131	82	5	80	0.0625000
NODE_2826_length_1367_cov_576.769716	1051	1131	83	7	80	0.0875000
NODE_2826_length_1367_cov_576.769716	1051	1131	84	13	80	0.1625000
NODE_2826_length_1367_cov_576.769716	1051	1131	85	11	80	0.1375000
NODE_2826_length_1367_cov_576.769716	1051	1131	86	5	80	0.0625000
NODE_2826_length_1367_cov_576.769716	1051	1131	87	1	80	0.0125000
NODE_2826_length_1367_cov_576.769716	1051	1131	88	6	80	0.0750000
NODE_2826_length_1367_cov_576.769716	1051	1131	89	1	80	0.0125000
NODE_2826_length_1367_cov_576.769716	1051	1131	90	4	80	0.0500000
NODE_2826_length_1367_cov_576.769716	1051	1131	92	5	80	0.0625000
NODE_2826_length_1367_cov_576.769716	1051	1131	93	4	80	0.0500000
NODE_2826_length_1367_cov_576.769716	1051	1131	94	3	80	0.0375000
NODE_2826_length_1367_cov_576.769716	1051	1131	95	3	80	0.0375000
NODE_2826_length_1367_cov_576.769716	1051	1131	96	7	80	0.0875000
NODE_2826_length_1367_cov_576.769716	1051	1131	97	5	80	0.0625000
NODE_2826_length_1367_cov_576.769716	1104	1184	77	2	80	0.0250000
NODE_2826_length_1367_cov_576.769716	1104	1184	78	1	80	0.0125000
NODE_2826_length_1367_cov_576.769716	1104	1184	79	1	80	0.0125000
NODE_2826_length_1367_cov_576.769716	1104	1184	80	5	80	0.0625000
NODE_2826_length_1367_cov_576.769716	1104	1184	81	1	80	0.0125000
NODE_2826_length_1367_cov_576.769716	1104	1184	82	4	80	0.0500000
NODE_2826_length_1367_cov_576.769716	1104	1184	83	3	80	0.0375000
NODE_2826_length_1367_cov_576.769716	1104	1184	84	11	80	0.1375000
NODE_2826_length_1367_cov_576.769716	1104	1184	85	11	80	0.1375000
NODE_2826_length_1367_cov_576.769716	1104	1184	86	5	80	0.0625000
NODE_2826_length_1367_cov_576.769716	1104	1184	87	3	80	0.0375000
NODE_2826_length_1367_cov_576.769716	1104	1184	88	2	80	0.0250000
NODE_2826_length_1367_cov_576.769716	1104	1184	89	2	80	0.0250000
NODE_2826_length_1367_cov_576.769716	1104	1184	90	4	80	0.0500000
NODE_2826_length_1367_cov_576.769716	1104	1184	92	12	80	0.1500000
NODE_2826_length_1367_cov_576.769716	1104	1184	93	4	80	0.0500000
NODE_2826_length_1367_cov_576.769716	1104	1184	94	3	80	0.0375000
NODE_2826_length_1367_cov_576.769716	1104	1184	95	2	80	0.0250000
NODE_2826_length_1367_cov_576.769716	1104	1184	97	4	80	0.0500000
NODE_2827_length_1367_cov_152.824921	513	593	5	11	80	0.1375000
NODE_2827_length_1367_cov_152.824921	513	593	7	2	80	0.0250000
NODE_2827_length_1367_cov_152.824921	513	593	8	7	80	0.0875000
NODE_2827_length_1367_cov_152.824921	513	593	9	12	80	0.1500000
NODE_2827_length_1367_cov_152.824921	513	593	10	11	80	0.1375000
NODE_2827_length_1367_cov_152.824921	513	593	12	3	80	0.0375000
NODE_2827_length_1367_cov_152.824921	513	593	13	4	80	0.0500000
NODE_2827_length_1367_cov_152.824921	513	593	14	19	80	0.2375000
NODE_2827_length_1367_cov_152.824921	513	593	15	1	80	0.0125000
NODE_2827_length_1367_cov_152.824921	513	593	16	10	80	0.1250000
NODE_2827_length_1367_cov_152.824921	566	646	12	10	80	0.1250000
NODE_2827_length_1367_cov_152.824921	566	646	14	31	80	0.3875000
NODE_2827_length_1367_cov_152.824921	566	646	15	4	80	0.0500000
NODE_2827_length_1367_cov_152.824921	566	646	16	24	80	0.3000000
NODE_2827_length_1367_cov_152.824921	566	646	17	11	80	0.1375000
NODE_2827_length_1367_cov_152.824921	642	722	15	3	80	0.0375000
NODE_2827_length_1367_cov_152.824921	642	722	16	5	80	0.0625000
NODE_2827_length_1367_cov_152.824921	642	722	17	7	80	0.0875000
NODE_2827_length_1367_cov_152.824921	642	722	18	14	80	0.1750000
NODE_2827_length_1367_cov_152.824921	642	722	19	5	80	0.0625000
NODE_2827_length_1367_cov_152.824921	642	722	20	2	80	0.0250000
NODE_2827_length_1367_cov_152.824921	642	722	21	8	80	0.1000000
NODE_2827_length_1367_cov_152.824921	642	722	22	27	80	0.3375000
NODE_2827_length_1367_cov_152.824921	642	722	23	5	80	0.0625000
NODE_2827_length_1367_cov_152.824921	642	722	24	4	80	0.0500000
NODE_2827_length_1367_cov_152.824921	695	775	11	1	80	0.0125000
NODE_2827_length_1367_cov_152.824921	695	775	12	19	80	0.2375000
NODE_2827_length_1367_cov_152.824921	695	775	14	9	80	0.1125000
NODE_2827_length_1367_cov_152.824921	695	775	15	3	80	0.0375000
NODE_2827_length_1367_cov_152.824921	695	775	17	11	80	0.1375000
NODE_2827_length_1367_cov_152.824921	695	775	20	7	80	0.0875000
NODE_2827_length_1367_cov_152.824921	695	775	21	1	80	0.0125000
NODE_2827_length_1367_cov_152.824921	695	775	22	20	80	0.2500000
NODE_2827_length_1367_cov_152.824921	695	775	23	5	80	0.0625000
NODE_2827_length_1367_cov_152.824921	695	775	24	4	80	0.0500000
NODE_2829_length_1367_cov_2.947161	250	326	0	26	76	0.3421053
NODE_2829_length_1367_cov_2.947161	250	326	2	50	76	0.6578947
NODE_2831_length_1366_cov_82.742699	198	278	7	1	80	0.0125000
NODE_2831_length_1366_cov_82.742699	198	278	8	18	80	0.2250000
NODE_2831_length_1366_cov_82.742699	198	278	9	37	80	0.4625000
NODE_2831_length_1366_cov_82.742699	198	278	10	24	80	0.3000000
NODE_2831_length_1366_cov_82.742699	251	331	5	12	80	0.1500000
NODE_2831_length_1366_cov_82.742699	251	331	7	16	80	0.2000000
NODE_2831_length_1366_cov_82.742699	251	331	8	22	80	0.2750000
NODE_2831_length_1366_cov_82.742699	251	331	9	30	80	0.3750000
NODE_2832_length_1366_cov_36.659037	577	657	8	11	80	0.1375000
NODE_2832_length_1366_cov_36.659037	577	657	9	6	80	0.0750000
NODE_2832_length_1366_cov_36.659037	577	657	10	10	80	0.1250000
NODE_2832_length_1366_cov_36.659037	577	657	14	10	80	0.1250000
NODE_2832_length_1366_cov_36.659037	577	657	15	23	80	0.2875000
NODE_2832_length_1366_cov_36.659037	577	657	16	18	80	0.2250000
NODE_2832_length_1366_cov_36.659037	577	657	17	2	80	0.0250000
NODE_2832_length_1366_cov_36.659037	630	710	12	5	80	0.0625000
NODE_2832_length_1366_cov_36.659037	630	710	13	30	80	0.3750000
NODE_2832_length_1366_cov_36.659037	630	710	14	14	80	0.1750000
NODE_2832_length_1366_cov_36.659037	630	710	15	12	80	0.1500000
NODE_2832_length_1366_cov_36.659037	630	710	16	17	80	0.2125000
NODE_2832_length_1366_cov_36.659037	630	710	17	2	80	0.0250000
NODE_2834_length_1366_cov_2.320442	47	116	0	69	69	1.0000000
NODE_2834_length_1366_cov_2.320442	1122	1202	0	27	80	0.3375000
NODE_2834_length_1366_cov_2.320442	1122	1202	1	53	80	0.6625000
NODE_2834_length_1366_cov_2.320442	1175	1255	1	42	80	0.5250000
NODE_2834_length_1366_cov_2.320442	1175	1255	2	3	80	0.0375000
NODE_2834_length_1366_cov_2.320442	1175	1255	4	6	80	0.0750000
NODE_2834_length_1366_cov_2.320442	1175	1255	6	1	80	0.0125000
NODE_2834_length_1366_cov_2.320442	1175	1255	7	24	80	0.3000000
NODE_2834_length_1366_cov_2.320442	1175	1255	9	3	80	0.0375000
NODE_2834_length_1366_cov_2.320442	1175	1255	11	1	80	0.0125000
NODE_2834_length_1366_cov_2.320442	1251	1331	9	3	80	0.0375000
NODE_2834_length_1366_cov_2.320442	1251	1331	10	36	80	0.4500000
NODE_2834_length_1366_cov_2.320442	1251	1331	11	41	80	0.5125000
NODE_2835_length_1365_cov_25.540284	432	509	3	19	77	0.2467532
NODE_2835_length_1365_cov_25.540284	432	509	4	1	77	0.0129870
NODE_2835_length_1365_cov_25.540284	432	509	5	29	77	0.3766234
NODE_2835_length_1365_cov_25.540284	432	509	9	13	77	0.1688312
NODE_2835_length_1365_cov_25.540284	432	509	10	15	77	0.1948052
NODE_2835_length_1365_cov_25.540284	482	562	8	9	80	0.1125000
NODE_2835_length_1365_cov_25.540284	482	562	9	24	80	0.3000000
NODE_2835_length_1365_cov_25.540284	482	562	10	47	80	0.5875000
NODE_2835_length_1365_cov_25.540284	558	635	5	34	77	0.4415585
NODE_2835_length_1365_cov_25.540284	558	635	6	3	77	0.0389610
NODE_2835_length_1365_cov_25.540284	558	635	7	22	77	0.2857143
NODE_2835_length_1365_cov_25.540284	558	635	8	15	77	0.1948052
NODE_2835_length_1365_cov_25.540284	558	635	10	3	77	0.0389610
NODE_2835_length_1365_cov_25.540284	625	688	2	40	63	0.6349207
NODE_2835_length_1365_cov_25.540284	625	688	4	8	63	0.1269841
NODE_2835_length_1365_cov_25.540284	625	688	5	15	63	0.2380952
NODE_2838_length_1364_cov_15.222134	120	191	5	4	71	0.0563380
NODE_2838_length_1364_cov_15.222134	120	191	6	8	71	0.1126761
NODE_2838_length_1364_cov_15.222134	120	191	8	12	71	0.1690141
NODE_2838_length_1364_cov_15.222134	120	191	9	2	71	0.0281690
NODE_2838_length_1364_cov_15.222134	120	191	10	14	71	0.1971831
NODE_2838_length_1364_cov_15.222134	120	191	11	4	71	0.0563380
NODE_2838_length_1364_cov_15.222134	120	191	13	10	71	0.1408451
NODE_2838_length_1364_cov_15.222134	120	191	15	17	71	0.2394366
NODE_2839_length_1364_cov_7.456917	843	923	2	8	80	0.1000000
NODE_2839_length_1364_cov_7.456917	843	923	3	1	80	0.0125000
NODE_2839_length_1364_cov_7.456917	843	923	4	45	80	0.5625000
NODE_2839_length_1364_cov_7.456917	843	923	5	26	80	0.3250000
NODE_2839_length_1364_cov_7.456917	896	976	2	22	80	0.2750000
NODE_2839_length_1364_cov_7.456917	896	976	3	15	80	0.1875000
NODE_2839_length_1364_cov_7.456917	896	976	4	43	80	0.5375000
NODE_2840_length_1364_cov_5.055336	239	290	0	9	51	0.1764706
NODE_2840_length_1364_cov_5.055336	239	290	2	36	51	0.7058824
NODE_2840_length_1364_cov_5.055336	239	290	3	6	51	0.1176471
NODE_2840_length_1364_cov_5.055336	263	343	2	21	80	0.2625000
NODE_2840_length_1364_cov_5.055336	263	343	3	31	80	0.3875000
NODE_2840_length_1364_cov_5.055336	263	343	4	28	80	0.3500000
NODE_2846_length_1363_cov_19.442247	615	695	2	80	80	1.0000000
NODE_2846_length_1363_cov_19.442247	668	748	0	14	80	0.1750000
NODE_2846_length_1363_cov_19.442247	668	748	2	66	80	0.8250000
NODE_2847_length_1363_cov_13.575949	619	699	10	4	80	0.0500000
NODE_2847_length_1363_cov_13.575949	619	699	13	16	80	0.2000000
NODE_2847_length_1363_cov_13.575949	619	699	14	45	80	0.5625000
NODE_2847_length_1363_cov_13.575949	619	699	15	15	80	0.1875000
NODE_2847_length_1363_cov_13.575949	672	752	7	8	80	0.1000000
NODE_2847_length_1363_cov_13.575949	672	752	8	43	80	0.5375000
NODE_2847_length_1363_cov_13.575949	672	752	9	1	80	0.0125000
NODE_2847_length_1363_cov_13.575949	672	752	10	5	80	0.0625000
NODE_2847_length_1363_cov_13.575949	672	752	13	1	80	0.0125000
NODE_2847_length_1363_cov_13.575949	672	752	14	11	80	0.1375000
NODE_2847_length_1363_cov_13.575949	672	752	15	11	80	0.1375000
NODE_2850_length_1362_cov_15.796516	898	978	7	1	80	0.0125000
NODE_2850_length_1362_cov_15.796516	898	978	8	28	80	0.3500000
NODE_2850_length_1362_cov_15.796516	898	978	9	3	80	0.0375000
NODE_2850_length_1362_cov_15.796516	898	978	10	48	80	0.6000000
NODE_2850_length_1362_cov_15.796516	951	1031	0	11	80	0.1375000
NODE_2850_length_1362_cov_15.796516	951	1031	1	4	80	0.0500000
NODE_2850_length_1362_cov_15.796516	951	1031	3	15	80	0.1875000
NODE_2850_length_1362_cov_15.796516	951	1031	5	14	80	0.1750000
NODE_2850_length_1362_cov_15.796516	951	1031	6	7	80	0.0875000
NODE_2850_length_1362_cov_15.796516	951	1031	7	3	80	0.0375000
NODE_2850_length_1362_cov_15.796516	951	1031	9	3	80	0.0375000
NODE_2850_length_1362_cov_15.796516	951	1031	10	23	80	0.2875000
NODE_2855_length_1361_cov_24.574485	528	608	7	4	80	0.0500000
NODE_2855_length_1361_cov_24.574485	528	608	9	8	80	0.1000000
NODE_2855_length_1361_cov_24.574485	528	608	11	32	80	0.4000000
NODE_2855_length_1361_cov_24.574485	528	608	13	36	80	0.4500000
NODE_2855_length_1361_cov_24.574485	581	661	7	30	80	0.3750000
NODE_2855_length_1361_cov_24.574485	581	661	9	4	80	0.0500000
NODE_2855_length_1361_cov_24.574485	581	661	11	12	80	0.1500000
NODE_2855_length_1361_cov_24.574485	581	661	13	34	80	0.4250000
NODE_2856_length_1361_cov_20.148970	866	946	0	6	80	0.0750000
NODE_2856_length_1361_cov_20.148970	866	946	1	12	80	0.1500000
NODE_2856_length_1361_cov_20.148970	866	946	2	62	80	0.7750000
NODE_2856_length_1361_cov_20.148970	919	999	0	38	80	0.4750000
NODE_2856_length_1361_cov_20.148970	919	999	1	33	80	0.4125000
NODE_2856_length_1361_cov_20.148970	919	999	2	9	80	0.1125000
NODE_2858_length_1361_cov_10.530903	1139	1219	0	5	80	0.0625000
NODE_2858_length_1361_cov_10.530903	1139	1219	2	75	80	0.9375000
NODE_2858_length_1361_cov_10.530903	1139	1219	0	5	80	0.0625000
NODE_2858_length_1361_cov_10.530903	1139	1219	2	75	80	0.9375000
NODE_2858_length_1361_cov_10.530903	1192	1277	0	24	85	0.2823530
NODE_2858_length_1361_cov_10.530903	1192	1277	2	61	85	0.7176471
NODE_2858_length_1361_cov_10.530903	1273	1353	0	80	80	1.0000000
NODE_2858_length_1361_cov_10.530903	1273	1353	0	80	80	1.0000000
NODE_2858_length_1361_cov_10.530903	1273	1353	0	80	80	1.0000000
NODE_2858_length_1361_cov_10.530903	1273	1353	0	80	80	1.0000000
NODE_2858_length_1361_cov_10.530903	1273	1353	0	80	80	1.0000000
NODE_2858_length_1361_cov_10.530903	1273	1353	0	80	80	1.0000000
NODE_2859_length_1360_cov_42.789056	351	431	9	14	80	0.1750000
NODE_2859_length_1360_cov_42.789056	351	431	10	12	80	0.1500000
NODE_2859_length_1360_cov_42.789056	351	431	12	24	80	0.3000000
NODE_2859_length_1360_cov_42.789056	351	431	13	17	80	0.2125000
NODE_2859_length_1360_cov_42.789056	351	431	17	1	80	0.0125000
NODE_2859_length_1360_cov_42.789056	351	431	18	1	80	0.0125000
NODE_2859_length_1360_cov_42.789056	351	431	19	9	80	0.1125000
NODE_2859_length_1360_cov_42.789056	351	431	20	2	80	0.0250000
NODE_2859_length_1360_cov_42.789056	404	484	13	14	80	0.1750000
NODE_2859_length_1360_cov_42.789056	404	484	17	1	80	0.0125000
NODE_2859_length_1360_cov_42.789056	404	484	18	1	80	0.0125000
NODE_2859_length_1360_cov_42.789056	404	484	19	13	80	0.1625000
NODE_2859_length_1360_cov_42.789056	404	484	20	24	80	0.3000000
NODE_2859_length_1360_cov_42.789056	404	484	21	6	80	0.0750000
NODE_2859_length_1360_cov_42.789056	404	484	22	13	80	0.1625000
NODE_2859_length_1360_cov_42.789056	404	484	23	8	80	0.1000000
NODE_2860_length_1360_cov_26.407613	531	611	6	22	80	0.2750000
NODE_2860_length_1360_cov_26.407613	531	611	7	23	80	0.2875000
NODE_2860_length_1360_cov_26.407613	531	611	11	12	80	0.1500000
NODE_2860_length_1360_cov_26.407613	531	611	12	23	80	0.2875000
NODE_2860_length_1360_cov_26.407613	584	669	6	2	85	0.0235294
NODE_2860_length_1360_cov_26.407613	584	669	8	42	85	0.4941176
NODE_2860_length_1360_cov_26.407613	584	669	11	7	85	0.0823529
NODE_2860_length_1360_cov_26.407613	584	669	12	34	85	0.4000000
NODE_2861_length_1360_cov_16.182395	796	876	0	10	80	0.1250000
NODE_2861_length_1360_cov_16.182395	796	876	2	45	80	0.5625000
NODE_2861_length_1360_cov_16.182395	796	876	3	12	80	0.1500000
NODE_2861_length_1360_cov_16.182395	796	876	5	13	80	0.1625000
NODE_2861_length_1360_cov_16.182395	849	929	2	2	80	0.0250000
NODE_2861_length_1360_cov_16.182395	849	929	3	21	80	0.2625000
NODE_2861_length_1360_cov_16.182395	849	929	5	57	80	0.7125000
NODE_2861_length_1360_cov_16.182395	925	1005	3	36	80	0.4500000
NODE_2861_length_1360_cov_16.182395	925	1005	4	16	80	0.2000000
NODE_2861_length_1360_cov_16.182395	925	1005	6	4	80	0.0500000
NODE_2861_length_1360_cov_16.182395	925	1005	7	24	80	0.3000000
NODE_2861_length_1360_cov_16.182395	978	1058	4	45	80	0.5625000
NODE_2861_length_1360_cov_16.182395	978	1058	6	12	80	0.1500000
NODE_2861_length_1360_cov_16.182395	978	1058	7	23	80	0.2875000
NODE_2862_length_1360_cov_12.763680	582	662	5	53	80	0.6625000
NODE_2862_length_1360_cov_12.763680	582	662	6	23	80	0.2875000
NODE_2862_length_1360_cov_12.763680	582	662	7	4	80	0.0500000
NODE_2862_length_1360_cov_12.763680	635	715	3	14	80	0.1750000
NODE_2862_length_1360_cov_12.763680	635	715	5	66	80	0.8250000
NODE_2866_length_1359_cov_41.324603	674	754	10	4	80	0.0500000
NODE_2866_length_1359_cov_41.324603	674	754	12	6	80	0.0750000
NODE_2866_length_1359_cov_41.324603	674	754	13	5	80	0.0625000
NODE_2866_length_1359_cov_41.324603	674	754	14	2	80	0.0250000
NODE_2866_length_1359_cov_41.324603	674	754	15	14	80	0.1750000
NODE_2866_length_1359_cov_41.324603	674	754	16	4	80	0.0500000
NODE_2866_length_1359_cov_41.324603	674	754	17	1	80	0.0125000
NODE_2866_length_1359_cov_41.324603	674	754	18	5	80	0.0625000
NODE_2866_length_1359_cov_41.324603	674	754	19	11	80	0.1375000
NODE_2866_length_1359_cov_41.324603	674	754	20	11	80	0.1375000
NODE_2866_length_1359_cov_41.324603	674	754	21	10	80	0.1250000
NODE_2866_length_1359_cov_41.324603	674	754	22	7	80	0.0875000
NODE_2866_length_1359_cov_41.324603	727	807	17	4	80	0.0500000
NODE_2866_length_1359_cov_41.324603	727	807	19	9	80	0.1125000
NODE_2866_length_1359_cov_41.324603	727	807	20	5	80	0.0625000
NODE_2866_length_1359_cov_41.324603	727	807	21	22	80	0.2750000
NODE_2866_length_1359_cov_41.324603	727	807	22	40	80	0.5000000
NODE_2866_length_1359_cov_41.324603	803	883	7	1	80	0.0125000
NODE_2866_length_1359_cov_41.324603	803	883	8	5	80	0.0625000
NODE_2866_length_1359_cov_41.324603	803	883	9	16	80	0.2000000
NODE_2866_length_1359_cov_41.324603	803	883	10	6	80	0.0750000
NODE_2866_length_1359_cov_41.324603	803	883	11	1	80	0.0125000
NODE_2866_length_1359_cov_41.324603	803	883	12	6	80	0.0750000
NODE_2866_length_1359_cov_41.324603	803	883	13	9	80	0.1125000
NODE_2866_length_1359_cov_41.324603	803	883	14	5	80	0.0625000
NODE_2866_length_1359_cov_41.324603	803	883	15	10	80	0.1250000
NODE_2866_length_1359_cov_41.324603	803	883	16	2	80	0.0250000
NODE_2866_length_1359_cov_41.324603	803	883	17	19	80	0.2375000
NODE_2866_length_1359_cov_41.324603	856	936	7	1	80	0.0125000
NODE_2866_length_1359_cov_41.324603	856	936	8	8	80	0.1000000
NODE_2866_length_1359_cov_41.324603	856	936	9	64	80	0.8000000
NODE_2866_length_1359_cov_41.324603	856	936	10	7	80	0.0875000
NODE_2871_length_1358_cov_23.427323	292	372	5	16	80	0.2000000
NODE_2871_length_1358_cov_23.427323	292	372	6	36	80	0.4500000
NODE_2871_length_1358_cov_23.427323	292	372	7	22	80	0.2750000
NODE_2871_length_1358_cov_23.427323	292	372	8	4	80	0.0500000
NODE_2871_length_1358_cov_23.427323	292	372	9	2	80	0.0250000
NODE_2871_length_1358_cov_23.427323	345	425	6	52	80	0.6500000
NODE_2871_length_1358_cov_23.427323	345	425	7	18	80	0.2250000
NODE_2871_length_1358_cov_23.427323	345	425	8	4	80	0.0500000
NODE_2871_length_1358_cov_23.427323	345	425	9	6	80	0.0750000
NODE_2872_length_1358_cov_19.489277	411	491	6	12	80	0.1500000
NODE_2872_length_1358_cov_19.489277	411	491	7	39	80	0.4875000
NODE_2872_length_1358_cov_19.489277	411	491	8	29	80	0.3625000
NODE_2872_length_1358_cov_19.489277	464	544	4	20	80	0.2500000
NODE_2872_length_1358_cov_19.489277	464	544	5	12	80	0.1500000
NODE_2872_length_1358_cov_19.489277	464	544	6	1	80	0.0125000
NODE_2872_length_1358_cov_19.489277	464	544	7	47	80	0.5875000
NODE_2875_length_1357_cov_15.962639	732	812	4	80	80	1.0000000
NODE_2875_length_1357_cov_15.962639	785	865	0	22	80	0.2750000
NODE_2875_length_1357_cov_15.962639	785	865	1	20	80	0.2500000
NODE_2875_length_1357_cov_15.962639	785	865	3	5	80	0.0625000
NODE_2875_length_1357_cov_15.962639	785	865	4	33	80	0.4125000
NODE_2879_length_1354_cov_9.854980	735	815	3	12	80	0.1500000
NODE_2879_length_1354_cov_9.854980	735	815	5	68	80	0.8500000
NODE_2879_length_1354_cov_9.854980	788	868	3	32	80	0.4000000
NODE_2879_length_1354_cov_9.854980	788	868	4	1	80	0.0125000
NODE_2879_length_1354_cov_9.854980	788	868	5	47	80	0.5875000
NODE_2882_length_1353_cov_32.982456	708	788	11	17	80	0.2125000
NODE_2882_length_1353_cov_32.982456	708	788	12	7	80	0.0875000
NODE_2882_length_1353_cov_32.982456	708	788	13	9	80	0.1125000
NODE_2882_length_1353_cov_32.982456	708	788	15	29	80	0.3625000
NODE_2882_length_1353_cov_32.982456	708	788	16	9	80	0.1125000
NODE_2882_length_1353_cov_32.982456	708	788	17	9	80	0.1125000
NODE_2882_length_1353_cov_32.982456	761	841	10	2	80	0.0250000
NODE_2882_length_1353_cov_32.982456	761	841	11	10	80	0.1250000
NODE_2882_length_1353_cov_32.982456	761	841	12	9	80	0.1125000
NODE_2882_length_1353_cov_32.982456	761	841	13	5	80	0.0625000
NODE_2882_length_1353_cov_32.982456	761	841	15	17	80	0.2125000
NODE_2882_length_1353_cov_32.982456	761	841	16	12	80	0.1500000
NODE_2882_length_1353_cov_32.982456	761	841	17	18	80	0.2250000
NODE_2882_length_1353_cov_32.982456	761	841	18	7	80	0.0875000
NODE_2883_length_1353_cov_21.775120	493	573	6	1	80	0.0125000
NODE_2883_length_1353_cov_21.775120	493	573	10	23	80	0.2875000
NODE_2883_length_1353_cov_21.775120	493	573	11	11	80	0.1375000
NODE_2883_length_1353_cov_21.775120	493	573	12	4	80	0.0500000
NODE_2883_length_1353_cov_21.775120	493	573	13	4	80	0.0500000
NODE_2883_length_1353_cov_21.775120	493	573	15	1	80	0.0125000
NODE_2883_length_1353_cov_21.775120	493	573	16	36	80	0.4500000
NODE_2883_length_1353_cov_21.775120	546	626	9	1	80	0.0125000
NODE_2883_length_1353_cov_21.775120	546	626	10	12	80	0.1500000
NODE_2883_length_1353_cov_21.775120	546	626	11	13	80	0.1625000
NODE_2883_length_1353_cov_21.775120	546	626	15	3	80	0.0375000
NODE_2883_length_1353_cov_21.775120	546	626	16	51	80	0.6375000
NODE_2884_length_1353_cov_18.201754	696	776	10	5	80	0.0625000
NODE_2884_length_1353_cov_18.201754	696	776	11	9	80	0.1125000
NODE_2884_length_1353_cov_18.201754	696	776	12	3	80	0.0375000
NODE_2884_length_1353_cov_18.201754	696	776	13	37	80	0.4625000
NODE_2884_length_1353_cov_18.201754	696	776	14	21	80	0.2625000
NODE_2884_length_1353_cov_18.201754	696	776	15	5	80	0.0625000
NODE_2884_length_1353_cov_18.201754	749	829	6	5	80	0.0625000
NODE_2884_length_1353_cov_18.201754	749	829	7	26	80	0.3250000
NODE_2884_length_1353_cov_18.201754	749	829	8	3	80	0.0375000
NODE_2884_length_1353_cov_18.201754	749	829	9	5	80	0.0625000
NODE_2884_length_1353_cov_18.201754	749	829	10	5	80	0.0625000
NODE_2884_length_1353_cov_18.201754	749	829	12	8	80	0.1000000
NODE_2884_length_1353_cov_18.201754	749	829	13	23	80	0.2875000
NODE_2884_length_1353_cov_18.201754	749	829	14	5	80	0.0625000
NODE_2888_length_1352_cov_26.942538	455	535	9	16	80	0.2000000
NODE_2888_length_1352_cov_26.942538	455	535	13	4	80	0.0500000
NODE_2888_length_1352_cov_26.942538	455	535	14	1	80	0.0125000
NODE_2888_length_1352_cov_26.942538	455	535	16	1	80	0.0125000
NODE_2888_length_1352_cov_26.942538	455	535	17	4	80	0.0500000
NODE_2888_length_1352_cov_26.942538	455	535	19	14	80	0.1750000
NODE_2888_length_1352_cov_26.942538	455	535	20	2	80	0.0250000
NODE_2888_length_1352_cov_26.942538	455	535	21	9	80	0.1125000
NODE_2888_length_1352_cov_26.942538	455	535	22	3	80	0.0375000
NODE_2888_length_1352_cov_26.942538	455	535	23	2	80	0.0250000
NODE_2888_length_1352_cov_26.942538	455	535	25	7	80	0.0875000
NODE_2888_length_1352_cov_26.942538	455	535	26	2	80	0.0250000
NODE_2888_length_1352_cov_26.942538	455	535	27	15	80	0.1875000
NODE_2888_length_1352_cov_26.942538	508	588	12	4	80	0.0500000
NODE_2888_length_1352_cov_26.942538	508	588	13	4	80	0.0500000
NODE_2888_length_1352_cov_26.942538	508	588	15	9	80	0.1125000
NODE_2888_length_1352_cov_26.942538	508	588	17	2	80	0.0250000
NODE_2888_length_1352_cov_26.942538	508	588	19	4	80	0.0500000
NODE_2888_length_1352_cov_26.942538	508	588	20	7	80	0.0875000
NODE_2888_length_1352_cov_26.942538	508	588	22	1	80	0.0125000
NODE_2888_length_1352_cov_26.942538	508	588	23	2	80	0.0250000
NODE_2888_length_1352_cov_26.942538	508	588	24	3	80	0.0375000
NODE_2888_length_1352_cov_26.942538	508	588	25	8	80	0.1000000
NODE_2888_length_1352_cov_26.942538	508	588	26	9	80	0.1125000
NODE_2888_length_1352_cov_26.942538	508	588	27	23	80	0.2875000
NODE_2888_length_1352_cov_26.942538	508	588	28	4	80	0.0500000
NODE_2889_length_1352_cov_17.189944	717	797	7	24	80	0.3000000
NODE_2889_length_1352_cov_17.189944	717	797	9	29	80	0.3625000
NODE_2889_length_1352_cov_17.189944	717	797	10	14	80	0.1750000
NODE_2889_length_1352_cov_17.189944	717	797	11	13	80	0.1625000
NODE_2889_length_1352_cov_17.189944	770	850	7	12	80	0.1500000
NODE_2889_length_1352_cov_17.189944	770	850	8	8	80	0.1000000
NODE_2889_length_1352_cov_17.189944	770	850	9	31	80	0.3875000
NODE_2889_length_1352_cov_17.189944	770	850	10	16	80	0.2000000
NODE_2889_length_1352_cov_17.189944	770	850	11	13	80	0.1625000
NODE_2890_length_1352_cov_15.752594	640	720	2	80	80	1.0000000
NODE_2890_length_1352_cov_15.752594	693	773	2	80	80	1.0000000
NODE_2891_length_1352_cov_10.699920	237	317	3	9	80	0.1125000
NODE_2891_length_1352_cov_10.699920	237	317	4	48	80	0.6000000
NODE_2891_length_1352_cov_10.699920	237	317	5	23	80	0.2875000
NODE_2891_length_1352_cov_10.699920	290	370	4	4	80	0.0500000
NODE_2891_length_1352_cov_10.699920	290	370	5	70	80	0.8750000
NODE_2891_length_1352_cov_10.699920	290	370	6	6	80	0.0750000
NODE_2894_length_1351_cov_32.325879	561	641	11	2	80	0.0250000
NODE_2894_length_1351_cov_32.325879	561	641	12	17	80	0.2125000
NODE_2894_length_1351_cov_32.325879	561	641	13	2	80	0.0250000
NODE_2894_length_1351_cov_32.325879	561	641	14	44	80	0.5500000
NODE_2894_length_1351_cov_32.325879	561	641	15	15	80	0.1875000
NODE_2894_length_1351_cov_32.325879	614	694	6	3	80	0.0375000
NODE_2894_length_1351_cov_32.325879	614	694	7	3	80	0.0375000
NODE_2894_length_1351_cov_32.325879	614	694	8	26	80	0.3250000
NODE_2894_length_1351_cov_32.325879	614	694	10	10	80	0.1250000
NODE_2894_length_1351_cov_32.325879	614	694	11	13	80	0.1625000
NODE_2894_length_1351_cov_32.325879	614	694	12	1	80	0.0125000
NODE_2894_length_1351_cov_32.325879	614	694	13	2	80	0.0250000
NODE_2894_length_1351_cov_32.325879	614	694	14	16	80	0.2000000
NODE_2894_length_1351_cov_32.325879	614	694	15	6	80	0.0750000
NODE_2895_length_1351_cov_16.861022	97	162	6	2	65	0.0307692
NODE_2895_length_1351_cov_16.861022	97	162	8	63	65	0.9692308
NODE_2896_length_1351_cov_9.894569	331	411	2	34	80	0.4250000
NODE_2896_length_1351_cov_9.894569	331	411	3	46	80	0.5750000
NODE_2896_length_1351_cov_9.894569	384	464	2	62	80	0.7750000
NODE_2896_length_1351_cov_9.894569	384	464	3	18	80	0.2250000
NODE_2897_length_1351_cov_8.699681	1055	1137	0	75	82	0.9146342
NODE_2897_length_1351_cov_8.699681	1055	1137	6	7	82	0.0853659
NODE_2897_length_1351_cov_8.699681	1110	1175	0	65	65	1.0000000
NODE_2898_length_1351_cov_2.931310	68	148	4	3	80	0.0375000
NODE_2898_length_1351_cov_2.931310	68	148	5	31	80	0.3875000
NODE_2898_length_1351_cov_2.931310	68	148	6	3	80	0.0375000
NODE_2898_length_1351_cov_2.931310	68	148	7	5	80	0.0625000
NODE_2898_length_1351_cov_2.931310	68	148	8	1	80	0.0125000
NODE_2898_length_1351_cov_2.931310	68	148	10	16	80	0.2000000
NODE_2898_length_1351_cov_2.931310	68	148	11	5	80	0.0625000
NODE_2898_length_1351_cov_2.931310	68	148	14	5	80	0.0625000
NODE_2898_length_1351_cov_2.931310	68	148	15	10	80	0.1250000
NODE_2898_length_1351_cov_2.931310	68	148	16	1	80	0.0125000
NODE_2898_length_1351_cov_2.931310	495	528	0	33	33	1.0000000
NODE_2899_length_1350_cov_18.274181	424	504	3	3	80	0.0375000
NODE_2899_length_1350_cov_18.274181	424	504	4	10	80	0.1250000
NODE_2899_length_1350_cov_18.274181	424	504	5	39	80	0.4875000
NODE_2899_length_1350_cov_18.274181	424	504	6	28	80	0.3500000
NODE_2899_length_1350_cov_18.274181	477	557	4	4	80	0.0500000
NODE_2899_length_1350_cov_18.274181	477	557	5	37	80	0.4625000
NODE_2899_length_1350_cov_18.274181	477	557	6	38	80	0.4750000
NODE_2899_length_1350_cov_18.274181	477	557	7	1	80	0.0125000
NODE_2899_length_1350_cov_18.274181	553	633	5	1	80	0.0125000
NODE_2899_length_1350_cov_18.274181	553	633	6	10	80	0.1250000
NODE_2899_length_1350_cov_18.274181	553	633	7	21	80	0.2625000
NODE_2899_length_1350_cov_18.274181	553	633	8	8	80	0.1000000
NODE_2899_length_1350_cov_18.274181	553	633	9	39	80	0.4875000
NODE_2899_length_1350_cov_18.274181	553	633	10	1	80	0.0125000
NODE_2899_length_1350_cov_18.274181	606	686	7	32	80	0.4000000
NODE_2899_length_1350_cov_18.274181	606	686	8	28	80	0.3500000
NODE_2899_length_1350_cov_18.274181	606	686	9	20	80	0.2500000
NODE_2900_length_1350_cov_8.053557	737	817	2	16	80	0.2000000
NODE_2900_length_1350_cov_8.053557	737	817	3	64	80	0.8000000
NODE_2900_length_1350_cov_8.053557	790	870	0	27	80	0.3375000
NODE_2900_length_1350_cov_8.053557	790	870	2	42	80	0.5250000
NODE_2900_length_1350_cov_8.053557	790	870	3	11	80	0.1375000
NODE_2903_length_1349_cov_23.782400	839	919	6	14	80	0.1750000
NODE_2903_length_1349_cov_23.782400	839	919	7	16	80	0.2000000
NODE_2903_length_1349_cov_23.782400	839	919	8	14	80	0.1750000
NODE_2903_length_1349_cov_23.782400	839	919	9	16	80	0.2000000
NODE_2903_length_1349_cov_23.782400	839	919	10	20	80	0.2500000
NODE_2903_length_1349_cov_23.782400	892	972	7	21	80	0.2625000
NODE_2903_length_1349_cov_23.782400	892	972	8	57	80	0.7125000
NODE_2903_length_1349_cov_23.782400	892	972	9	2	80	0.0250000
NODE_2903_length_1349_cov_23.782400	968	1048	1	27	80	0.3375000
NODE_2903_length_1349_cov_23.782400	968	1048	2	6	80	0.0750000
NODE_2903_length_1349_cov_23.782400	968	1048	3	8	80	0.1000000
NODE_2903_length_1349_cov_23.782400	968	1048	5	4	80	0.0500000
NODE_2903_length_1349_cov_23.782400	968	1048	6	29	80	0.3625000
NODE_2903_length_1349_cov_23.782400	968	1048	7	6	80	0.0750000
NODE_2903_length_1349_cov_23.782400	1021	1101	1	62	80	0.7750000
NODE_2903_length_1349_cov_23.782400	1021	1101	2	18	80	0.2250000
NODE_2904_length_1349_cov_17.776800	811	891	7	14	80	0.1750000
NODE_2904_length_1349_cov_17.776800	811	891	8	14	80	0.1750000
NODE_2904_length_1349_cov_17.776800	811	891	9	40	80	0.5000000
NODE_2904_length_1349_cov_17.776800	811	891	10	12	80	0.1500000
NODE_2904_length_1349_cov_17.776800	864	944	3	27	80	0.3375000
NODE_2904_length_1349_cov_17.776800	864	944	4	4	80	0.0500000
NODE_2904_length_1349_cov_17.776800	864	944	5	4	80	0.0500000
NODE_2904_length_1349_cov_17.776800	864	944	6	1	80	0.0125000
NODE_2904_length_1349_cov_17.776800	864	944	8	9	80	0.1125000
NODE_2904_length_1349_cov_17.776800	864	944	9	30	80	0.3750000
NODE_2904_length_1349_cov_17.776800	864	944	10	5	80	0.0625000
NODE_2905_length_1349_cov_16.468800	828	908	5	17	80	0.2125000
NODE_2905_length_1349_cov_16.468800	828	908	6	31	80	0.3875000
NODE_2905_length_1349_cov_16.468800	828	908	7	2	80	0.0250000
NODE_2905_length_1349_cov_16.468800	828	908	8	4	80	0.0500000
NODE_2905_length_1349_cov_16.468800	828	908	10	8	80	0.1000000
NODE_2905_length_1349_cov_16.468800	828	908	12	18	80	0.2250000
NODE_2905_length_1349_cov_16.468800	881	961	8	11	80	0.1375000
NODE_2905_length_1349_cov_16.468800	881	961	9	14	80	0.1750000
NODE_2905_length_1349_cov_16.468800	881	961	10	21	80	0.2625000
NODE_2905_length_1349_cov_16.468800	881	961	11	14	80	0.1750000
NODE_2905_length_1349_cov_16.468800	881	961	12	20	80	0.2500000
NODE_2908_length_1348_cov_22.731785	468	548	13	3	80	0.0375000
NODE_2908_length_1348_cov_22.731785	468	548	14	19	80	0.2375000
NODE_2908_length_1348_cov_22.731785	468	548	15	11	80	0.1375000
NODE_2908_length_1348_cov_22.731785	468	548	16	31	80	0.3875000
NODE_2908_length_1348_cov_22.731785	468	548	17	2	80	0.0250000
NODE_2908_length_1348_cov_22.731785	468	548	18	14	80	0.1750000
NODE_2908_length_1348_cov_22.731785	521	601	4	7	80	0.0875000
NODE_2908_length_1348_cov_22.731785	521	601	6	27	80	0.3375000
NODE_2908_length_1348_cov_22.731785	521	601	7	11	80	0.1375000
NODE_2908_length_1348_cov_22.731785	521	601	8	1	80	0.0125000
NODE_2908_length_1348_cov_22.731785	521	601	11	3	80	0.0375000
NODE_2908_length_1348_cov_22.731785	521	601	13	7	80	0.0875000
NODE_2908_length_1348_cov_22.731785	521	601	14	8	80	0.1000000
NODE_2908_length_1348_cov_22.731785	521	601	16	16	80	0.2000000
NODE_2909_length_1348_cov_20.778223	517	597	2	21	80	0.2625000
NODE_2909_length_1348_cov_20.778223	517	597	3	4	80	0.0500000
NODE_2909_length_1348_cov_20.778223	517	597	4	12	80	0.1500000
NODE_2909_length_1348_cov_20.778223	517	597	6	32	80	0.4000000
NODE_2909_length_1348_cov_20.778223	517	597	7	11	80	0.1375000
NODE_2909_length_1348_cov_20.778223	570	650	6	17	80	0.2125000
NODE_2909_length_1348_cov_20.778223	570	650	7	62	80	0.7750000
NODE_2909_length_1348_cov_20.778223	570	650	9	1	80	0.0125000
NODE_2910_length_1348_cov_11.180144	673	753	3	74	80	0.9250000
NODE_2910_length_1348_cov_11.180144	673	753	4	6	80	0.0750000
NODE_2910_length_1348_cov_11.180144	726	806	3	76	80	0.9500000
NODE_2910_length_1348_cov_11.180144	726	806	4	4	80	0.0500000
NODE_2916_length_1347_cov_45.906250	683	763	8	4	80	0.0500000
NODE_2916_length_1347_cov_45.906250	683	763	9	2	80	0.0250000
NODE_2916_length_1347_cov_45.906250	683	763	11	25	80	0.3125000
NODE_2916_length_1347_cov_45.906250	683	763	13	13	80	0.1625000
NODE_2916_length_1347_cov_45.906250	683	763	16	12	80	0.1500000
NODE_2916_length_1347_cov_45.906250	683	763	18	5	80	0.0625000
NODE_2916_length_1347_cov_45.906250	683	763	19	13	80	0.1625000
NODE_2916_length_1347_cov_45.906250	683	763	20	6	80	0.0750000
NODE_2916_length_1347_cov_45.906250	736	816	15	9	80	0.1125000
NODE_2916_length_1347_cov_45.906250	736	816	16	4	80	0.0500000
NODE_2916_length_1347_cov_45.906250	736	816	17	17	80	0.2125000
NODE_2916_length_1347_cov_45.906250	736	816	18	14	80	0.1750000
NODE_2916_length_1347_cov_45.906250	736	816	19	15	80	0.1875000
NODE_2916_length_1347_cov_45.906250	736	816	20	16	80	0.2000000
NODE_2916_length_1347_cov_45.906250	736	816	21	5	80	0.0625000
NODE_2916_length_1347_cov_45.906250	812	892	9	1	80	0.0125000
NODE_2916_length_1347_cov_45.906250	812	892	11	25	80	0.3125000
NODE_2916_length_1347_cov_45.906250	812	892	12	20	80	0.2500000
NODE_2916_length_1347_cov_45.906250	812	892	13	20	80	0.2500000
NODE_2916_length_1347_cov_45.906250	812	892	14	5	80	0.0625000
NODE_2916_length_1347_cov_45.906250	812	892	15	9	80	0.1125000
NODE_2916_length_1347_cov_45.906250	865	945	11	4	80	0.0500000
NODE_2916_length_1347_cov_45.906250	865	945	12	22	80	0.2750000
NODE_2916_length_1347_cov_45.906250	865	945	13	36	80	0.4500000
NODE_2916_length_1347_cov_45.906250	865	945	14	18	80	0.2250000
NODE_2917_length_1347_cov_41.643429	439	519	6	6	80	0.0750000
NODE_2917_length_1347_cov_41.643429	439	519	7	30	80	0.3750000
NODE_2917_length_1347_cov_41.643429	439	519	8	22	80	0.2750000
NODE_2917_length_1347_cov_41.643429	439	519	10	3	80	0.0375000
NODE_2917_length_1347_cov_41.643429	439	519	11	3	80	0.0375000
NODE_2917_length_1347_cov_41.643429	439	519	12	11	80	0.1375000
NODE_2917_length_1347_cov_41.643429	439	519	13	2	80	0.0250000
NODE_2917_length_1347_cov_41.643429	439	519	14	3	80	0.0375000
NODE_2917_length_1347_cov_41.643429	492	572	8	5	80	0.0625000
NODE_2917_length_1347_cov_41.643429	492	572	10	3	80	0.0375000
NODE_2917_length_1347_cov_41.643429	492	572	11	17	80	0.2125000
NODE_2917_length_1347_cov_41.643429	492	572	12	18	80	0.2250000
NODE_2917_length_1347_cov_41.643429	492	572	13	2	80	0.0250000
NODE_2917_length_1347_cov_41.643429	492	572	14	35	80	0.4375000
NODE_2918_length_1347_cov_19.941506	458	538	2	1	80	0.0125000
NODE_2918_length_1347_cov_19.941506	458	538	3	37	80	0.4625000
NODE_2918_length_1347_cov_19.941506	458	538	4	42	80	0.5250000
NODE_2918_length_1347_cov_19.941506	511	591	3	33	80	0.4125000
NODE_2918_length_1347_cov_19.941506	511	591	4	37	80	0.4625000
NODE_2918_length_1347_cov_19.941506	511	591	5	10	80	0.1250000
NODE_2918_length_1347_cov_19.941506	587	667	1	21	80	0.2625000
NODE_2918_length_1347_cov_19.941506	587	667	2	38	80	0.4750000
NODE_2918_length_1347_cov_19.941506	587	667	3	21	80	0.2625000
NODE_2918_length_1347_cov_19.941506	640	720	1	48	80	0.6000000
NODE_2918_length_1347_cov_19.941506	640	720	2	32	80	0.4000000
NODE_2919_length_1347_cov_16.520833	713	793	0	6	80	0.0750000
NODE_2919_length_1347_cov_16.520833	713	793	5	2	80	0.0250000
NODE_2919_length_1347_cov_16.520833	713	793	6	6	80	0.0750000
NODE_2919_length_1347_cov_16.520833	713	793	7	27	80	0.3375000
NODE_2919_length_1347_cov_16.520833	713	793	8	5	80	0.0625000
NODE_2919_length_1347_cov_16.520833	713	793	9	17	80	0.2125000
NODE_2919_length_1347_cov_16.520833	713	793	10	17	80	0.2125000
NODE_2919_length_1347_cov_16.520833	766	846	0	59	80	0.7375000
NODE_2919_length_1347_cov_16.520833	766	846	5	2	80	0.0250000
NODE_2919_length_1347_cov_16.520833	766	846	6	6	80	0.0750000
NODE_2919_length_1347_cov_16.520833	766	846	7	13	80	0.1625000
NODE_2920_length_1347_cov_15.967147	638	718	6	7	80	0.0875000
NODE_2920_length_1347_cov_15.967147	638	718	7	7	80	0.0875000
NODE_2920_length_1347_cov_15.967147	638	718	9	44	80	0.5500000
NODE_2920_length_1347_cov_15.967147	638	718	11	6	80	0.0750000
NODE_2920_length_1347_cov_15.967147	638	718	13	2	80	0.0250000
NODE_2920_length_1347_cov_15.967147	638	718	14	14	80	0.1750000
NODE_2920_length_1347_cov_15.967147	691	771	9	5	80	0.0625000
NODE_2920_length_1347_cov_15.967147	691	771	11	15	80	0.1875000
NODE_2920_length_1347_cov_15.967147	691	771	12	29	80	0.3625000
NODE_2920_length_1347_cov_15.967147	691	771	13	2	80	0.0250000
NODE_2920_length_1347_cov_15.967147	691	771	14	29	80	0.3625000
NODE_2925_length_1346_cov_13.112269	429	509	2	33	80	0.4125000
NODE_2925_length_1346_cov_13.112269	429	509	4	6	80	0.0750000
NODE_2925_length_1346_cov_13.112269	429	509	5	41	80	0.5125000
NODE_2925_length_1346_cov_13.112269	482	562	3	12	80	0.1500000
NODE_2925_length_1346_cov_13.112269	482	562	4	6	80	0.0750000
NODE_2925_length_1346_cov_13.112269	482	562	5	62	80	0.7750000
NODE_2928_length_1345_cov_32.099518	629	709	4	13	80	0.1625000
NODE_2928_length_1345_cov_32.099518	629	709	5	4	80	0.0500000
NODE_2928_length_1345_cov_32.099518	629	709	6	3	80	0.0375000
NODE_2928_length_1345_cov_32.099518	629	709	7	47	80	0.5875000
NODE_2928_length_1345_cov_32.099518	629	709	8	6	80	0.0750000
NODE_2928_length_1345_cov_32.099518	629	709	9	7	80	0.0875000
NODE_2928_length_1345_cov_32.099518	682	762	6	2	80	0.0250000
NODE_2928_length_1345_cov_32.099518	682	762	7	12	80	0.1500000
NODE_2928_length_1345_cov_32.099518	682	762	8	6	80	0.0750000
NODE_2928_length_1345_cov_32.099518	682	762	9	15	80	0.1875000
NODE_2928_length_1345_cov_32.099518	682	762	10	3	80	0.0375000
NODE_2928_length_1345_cov_32.099518	682	762	11	22	80	0.2750000
NODE_2928_length_1345_cov_32.099518	682	762	12	20	80	0.2500000
NODE_2929_length_1345_cov_19.837881	723	803	10	2	80	0.0250000
NODE_2929_length_1345_cov_19.837881	723	803	11	75	80	0.9375000
NODE_2929_length_1345_cov_19.837881	723	803	12	3	80	0.0375000
NODE_2929_length_1345_cov_19.837881	776	856	5	5	80	0.0625000
NODE_2929_length_1345_cov_19.837881	776	856	6	11	80	0.1375000
NODE_2929_length_1345_cov_19.837881	776	856	7	4	80	0.0500000
NODE_2929_length_1345_cov_19.837881	776	856	8	7	80	0.0875000
NODE_2929_length_1345_cov_19.837881	776	856	10	22	80	0.2750000
NODE_2929_length_1345_cov_19.837881	776	856	11	31	80	0.3875000
NODE_2930_length_1345_cov_14.262440	361	441	0	80	80	1.0000000
NODE_2930_length_1345_cov_14.262440	414	494	0	80	80	1.0000000
NODE_2930_length_1345_cov_14.262440	490	570	0	26	80	0.3250000
NODE_2930_length_1345_cov_14.262440	490	570	1	1	80	0.0125000
NODE_2930_length_1345_cov_14.262440	490	570	2	21	80	0.2625000
NODE_2930_length_1345_cov_14.262440	490	570	4	10	80	0.1250000
NODE_2930_length_1345_cov_14.262440	490	570	5	6	80	0.0750000
NODE_2930_length_1345_cov_14.262440	490	570	7	10	80	0.1250000
NODE_2930_length_1345_cov_14.262440	490	570	9	6	80	0.0750000
NODE_2930_length_1345_cov_14.262440	543	623	4	5	80	0.0625000
NODE_2930_length_1345_cov_14.262440	543	623	5	6	80	0.0750000
NODE_2930_length_1345_cov_14.262440	543	623	7	10	80	0.1250000
NODE_2930_length_1345_cov_14.262440	543	623	9	14	80	0.1750000
NODE_2930_length_1345_cov_14.262440	543	623	11	1	80	0.0125000
NODE_2930_length_1345_cov_14.262440	543	623	12	44	80	0.5500000
NODE_2931_length_1345_cov_14.103531	950	1030	0	20	80	0.2500000
NODE_2931_length_1345_cov_14.103531	950	1030	1	60	80	0.7500000
NODE_2931_length_1345_cov_14.103531	1003	1083	1	56	80	0.7000000
NODE_2931_length_1345_cov_14.103531	1003	1083	2	24	80	0.3000000
NODE_2934_length_1344_cov_15.013655	345	425	4	52	80	0.6500000
NODE_2934_length_1344_cov_15.013655	345	425	6	28	80	0.3500000
NODE_2934_length_1344_cov_15.013655	398	478	2	26	80	0.3250000
NODE_2934_length_1344_cov_15.013655	398	478	4	47	80	0.5875000
NODE_2934_length_1344_cov_15.013655	398	478	6	7	80	0.0875000
NODE_2935_length_1344_cov_11.383133	519	599	1	12	80	0.1500000
NODE_2935_length_1344_cov_11.383133	519	599	2	1	80	0.0125000
NODE_2935_length_1344_cov_11.383133	519	599	3	67	80	0.8375000
NODE_2935_length_1344_cov_11.383133	572	652	2	48	80	0.6000000
NODE_2935_length_1344_cov_11.383133	572	652	3	26	80	0.3250000
NODE_2935_length_1344_cov_11.383133	572	652	4	6	80	0.0750000
NODE_2935_length_1344_cov_11.383133	648	728	2	36	80	0.4500000
NODE_2935_length_1344_cov_11.383133	648	728	3	44	80	0.5500000
NODE_2935_length_1344_cov_11.383133	701	781	2	42	80	0.5250000
NODE_2935_length_1344_cov_11.383133	701	781	3	31	80	0.3875000
NODE_2935_length_1344_cov_11.383133	701	781	4	7	80	0.0875000
NODE_2936_length_1344_cov_10.924498	529	609	4	36	80	0.4500000
NODE_2936_length_1344_cov_10.924498	529	609	5	3	80	0.0375000
NODE_2936_length_1344_cov_10.924498	529	609	6	16	80	0.2000000
NODE_2936_length_1344_cov_10.924498	529	609	7	3	80	0.0375000
NODE_2936_length_1344_cov_10.924498	529	609	8	2	80	0.0250000
NODE_2936_length_1344_cov_10.924498	529	609	9	20	80	0.2500000
NODE_2936_length_1344_cov_10.924498	582	662	6	2	80	0.0250000
NODE_2936_length_1344_cov_10.924498	582	662	7	8	80	0.1000000
NODE_2936_length_1344_cov_10.924498	582	662	8	50	80	0.6250000
NODE_2936_length_1344_cov_10.924498	582	662	9	20	80	0.2500000
NODE_2937_length_1344_cov_5.531727	920	975	0	55	55	1.0000000
NODE_2942_length_1343_cov_36.005627	150	230	11	4	80	0.0500000
NODE_2942_length_1343_cov_36.005627	150	230	12	51	80	0.6375000
NODE_2942_length_1343_cov_36.005627	150	230	13	3	80	0.0375000
NODE_2942_length_1343_cov_36.005627	150	230	14	11	80	0.1375000
NODE_2942_length_1343_cov_36.005627	150	230	16	8	80	0.1000000
NODE_2942_length_1343_cov_36.005627	150	230	18	3	80	0.0375000
NODE_2942_length_1343_cov_36.005627	286	366	5	15	80	0.1875000
NODE_2942_length_1343_cov_36.005627	286	366	6	65	80	0.8125000
NODE_2942_length_1343_cov_36.005627	339	419	0	6	80	0.0750000
NODE_2942_length_1343_cov_36.005627	339	419	2	16	80	0.2000000
NODE_2942_length_1343_cov_36.005627	339	419	3	14	80	0.1750000
NODE_2942_length_1343_cov_36.005627	339	419	5	32	80	0.4000000
NODE_2942_length_1343_cov_36.005627	339	419	6	12	80	0.1500000
NODE_2942_length_1343_cov_36.005627	415	495	2	54	80	0.6750000
NODE_2942_length_1343_cov_36.005627	415	495	4	26	80	0.3250000
NODE_2942_length_1343_cov_36.005627	468	548	2	35	80	0.4375000
NODE_2942_length_1343_cov_36.005627	468	548	4	45	80	0.5625000
NODE_2943_length_1343_cov_26.826367	782	862	0	1	80	0.0125000
NODE_2943_length_1343_cov_26.826367	782	862	2	12	80	0.1500000
NODE_2943_length_1343_cov_26.826367	782	862	3	9	80	0.1125000
NODE_2943_length_1343_cov_26.826367	782	862	4	16	80	0.2000000
NODE_2943_length_1343_cov_26.826367	782	862	5	42	80	0.5250000
NODE_2943_length_1343_cov_26.826367	835	915	5	59	80	0.7375000
NODE_2943_length_1343_cov_26.826367	835	915	6	21	80	0.2625000
NODE_2944_length_1343_cov_19.353698	799	879	3	15	80	0.1875000
NODE_2944_length_1343_cov_19.353698	799	879	4	9	80	0.1125000
NODE_2944_length_1343_cov_19.353698	799	879	5	26	80	0.3250000
NODE_2944_length_1343_cov_19.353698	799	879	6	9	80	0.1125000
NODE_2944_length_1343_cov_19.353698	799	879	7	20	80	0.2500000
NODE_2944_length_1343_cov_19.353698	799	879	8	1	80	0.0125000
NODE_2944_length_1343_cov_19.353698	852	932	6	6	80	0.0750000
NODE_2944_length_1343_cov_19.353698	852	932	7	20	80	0.2500000
NODE_2944_length_1343_cov_19.353698	852	932	8	5	80	0.0625000
NODE_2944_length_1343_cov_19.353698	852	932	9	4	80	0.0500000
NODE_2944_length_1343_cov_19.353698	852	932	10	20	80	0.2500000
NODE_2944_length_1343_cov_19.353698	852	932	11	8	80	0.1000000
NODE_2944_length_1343_cov_19.353698	852	932	12	2	80	0.0250000
NODE_2944_length_1343_cov_19.353698	852	932	13	12	80	0.1500000
NODE_2944_length_1343_cov_19.353698	852	932	14	3	80	0.0375000
NODE_2944_length_1343_cov_19.353698	928	1008	12	3	80	0.0375000
NODE_2944_length_1343_cov_19.353698	928	1008	13	6	80	0.0750000
NODE_2944_length_1343_cov_19.353698	928	1008	14	6	80	0.0750000
NODE_2944_length_1343_cov_19.353698	928	1008	17	2	80	0.0250000
NODE_2944_length_1343_cov_19.353698	928	1008	18	15	80	0.1875000
NODE_2944_length_1343_cov_19.353698	928	1008	19	19	80	0.2375000
NODE_2944_length_1343_cov_19.353698	928	1008	20	26	80	0.3250000
NODE_2944_length_1343_cov_19.353698	928	1008	21	3	80	0.0375000
NODE_2944_length_1343_cov_19.353698	981	1061	11	4	80	0.0500000
NODE_2944_length_1343_cov_19.353698	981	1061	12	10	80	0.1250000
NODE_2944_length_1343_cov_19.353698	981	1061	14	10	80	0.1250000
NODE_2944_length_1343_cov_19.353698	981	1061	15	4	80	0.0500000
NODE_2944_length_1343_cov_19.353698	981	1061	16	5	80	0.0625000
NODE_2944_length_1343_cov_19.353698	981	1061	17	6	80	0.0750000
NODE_2944_length_1343_cov_19.353698	981	1061	18	14	80	0.1750000
NODE_2944_length_1343_cov_19.353698	981	1061	19	11	80	0.1375000
NODE_2944_length_1343_cov_19.353698	981	1061	20	16	80	0.2000000
NODE_2945_length_1343_cov_15.717846	745	825	0	10	80	0.1250000
NODE_2945_length_1343_cov_15.717846	745	825	2	69	80	0.8625000
NODE_2945_length_1343_cov_15.717846	745	825	4	1	80	0.0125000
NODE_2945_length_1343_cov_15.717846	798	878	2	50	80	0.6250000
NODE_2945_length_1343_cov_15.717846	798	878	4	30	80	0.3750000
NODE_2949_length_1342_cov_30.491553	456	536	9	2	80	0.0250000
NODE_2949_length_1342_cov_30.491553	456	536	10	14	80	0.1750000
NODE_2949_length_1342_cov_30.491553	456	536	11	3	80	0.0375000
NODE_2949_length_1342_cov_30.491553	456	536	12	12	80	0.1500000
NODE_2949_length_1342_cov_30.491553	456	536	13	28	80	0.3500000
NODE_2949_length_1342_cov_30.491553	456	536	15	16	80	0.2000000
NODE_2949_length_1342_cov_30.491553	456	536	16	5	80	0.0625000
NODE_2949_length_1342_cov_30.491553	509	589	11	1	80	0.0125000
NODE_2949_length_1342_cov_30.491553	509	589	12	10	80	0.1250000
NODE_2949_length_1342_cov_30.491553	509	589	13	52	80	0.6500000
NODE_2949_length_1342_cov_30.491553	509	589	14	16	80	0.2000000
NODE_2949_length_1342_cov_30.491553	509	589	15	1	80	0.0125000
NODE_2949_length_1342_cov_30.491553	585	665	5	13	80	0.1625000
NODE_2949_length_1342_cov_30.491553	585	665	6	3	80	0.0375000
NODE_2949_length_1342_cov_30.491553	585	665	8	5	80	0.0625000
NODE_2949_length_1342_cov_30.491553	585	665	10	17	80	0.2125000
NODE_2949_length_1342_cov_30.491553	585	665	11	3	80	0.0375000
NODE_2949_length_1342_cov_30.491553	585	665	12	2	80	0.0250000
NODE_2949_length_1342_cov_30.491553	585	665	13	18	80	0.2250000
NODE_2949_length_1342_cov_30.491553	585	665	14	13	80	0.1625000
NODE_2949_length_1342_cov_30.491553	585	665	15	6	80	0.0750000
NODE_2949_length_1342_cov_30.491553	638	718	3	20	80	0.2500000
NODE_2949_length_1342_cov_30.491553	638	718	4	21	80	0.2625000
NODE_2949_length_1342_cov_30.491553	638	718	5	25	80	0.3125000
NODE_2949_length_1342_cov_30.491553	638	718	6	3	80	0.0375000
NODE_2949_length_1342_cov_30.491553	638	718	8	5	80	0.0625000
NODE_2949_length_1342_cov_30.491553	638	718	10	6	80	0.0750000
NODE_2950_length_1342_cov_26.796460	538	618	9	6	80	0.0750000
NODE_2950_length_1342_cov_26.796460	538	618	11	11	80	0.1375000
NODE_2950_length_1342_cov_26.796460	538	618	12	16	80	0.2000000
NODE_2950_length_1342_cov_26.796460	538	618	13	21	80	0.2625000
NODE_2950_length_1342_cov_26.796460	538	618	14	26	80	0.3250000
NODE_2950_length_1342_cov_26.796460	591	671	7	2	80	0.0250000
NODE_2950_length_1342_cov_26.796460	591	671	8	1	80	0.0125000
NODE_2950_length_1342_cov_26.796460	591	671	9	31	80	0.3875000
NODE_2950_length_1342_cov_26.796460	591	671	11	9	80	0.1125000
NODE_2950_length_1342_cov_26.796460	591	671	13	31	80	0.3875000
NODE_2950_length_1342_cov_26.796460	591	671	14	6	80	0.0750000
NODE_2950_length_1342_cov_26.796460	667	747	0	14	80	0.1750000
NODE_2950_length_1342_cov_26.796460	667	747	1	22	80	0.2750000
NODE_2950_length_1342_cov_26.796460	667	747	2	6	80	0.0750000
NODE_2950_length_1342_cov_26.796460	667	747	3	17	80	0.2125000
NODE_2950_length_1342_cov_26.796460	667	747	5	1	80	0.0125000
NODE_2950_length_1342_cov_26.796460	667	747	7	18	80	0.2250000
NODE_2950_length_1342_cov_26.796460	667	747	8	1	80	0.0125000
NODE_2950_length_1342_cov_26.796460	667	747	9	1	80	0.0125000
NODE_2950_length_1342_cov_26.796460	720	800	0	5	80	0.0625000
NODE_2950_length_1342_cov_26.796460	720	800	1	58	80	0.7250000
NODE_2950_length_1342_cov_26.796460	720	800	2	17	80	0.2125000
NODE_2951_length_1342_cov_22.769912	298	378	2	40	80	0.5000000
NODE_2951_length_1342_cov_22.769912	298	378	3	11	80	0.1375000
NODE_2951_length_1342_cov_22.769912	298	378	4	8	80	0.1000000
NODE_2951_length_1342_cov_22.769912	298	378	5	7	80	0.0875000
NODE_2951_length_1342_cov_22.769912	298	378	6	10	80	0.1250000
NODE_2951_length_1342_cov_22.769912	298	378	7	4	80	0.0500000
NODE_2951_length_1342_cov_22.769912	351	431	4	6	80	0.0750000
NODE_2951_length_1342_cov_22.769912	351	431	5	7	80	0.0875000
NODE_2951_length_1342_cov_22.769912	351	431	6	50	80	0.6250000
NODE_2951_length_1342_cov_22.769912	351	431	7	17	80	0.2125000
NODE_2951_length_1342_cov_22.769912	427	507	6	8	80	0.1000000
NODE_2951_length_1342_cov_22.769912	427	507	7	33	80	0.4125000
NODE_2951_length_1342_cov_22.769912	427	507	8	39	80	0.4875000
NODE_2951_length_1342_cov_22.769912	480	560	3	36	80	0.4500000
NODE_2951_length_1342_cov_22.769912	480	560	4	10	80	0.1250000
NODE_2951_length_1342_cov_22.769912	480	560	5	7	80	0.0875000
NODE_2951_length_1342_cov_22.769912	480	560	6	8	80	0.1000000
NODE_2951_length_1342_cov_22.769912	480	560	7	11	80	0.1375000
NODE_2951_length_1342_cov_22.769912	480	560	8	8	80	0.1000000
NODE_2953_length_1341_cov_22.449275	494	574	11	7	80	0.0875000
NODE_2953_length_1341_cov_22.449275	494	574	12	41	80	0.5125000
NODE_2953_length_1341_cov_22.449275	494	574	14	21	80	0.2625000
NODE_2953_length_1341_cov_22.449275	494	574	15	11	80	0.1375000
NODE_2953_length_1341_cov_22.449275	547	627	7	3	80	0.0375000
NODE_2953_length_1341_cov_22.449275	547	627	8	1	80	0.0125000
NODE_2953_length_1341_cov_22.449275	547	627	10	3	80	0.0375000
NODE_2953_length_1341_cov_22.449275	547	627	11	6	80	0.0750000
NODE_2953_length_1341_cov_22.449275	547	627	12	13	80	0.1625000
NODE_2953_length_1341_cov_22.449275	547	627	13	9	80	0.1125000
NODE_2953_length_1341_cov_22.449275	547	627	14	34	80	0.4250000
NODE_2953_length_1341_cov_22.449275	547	627	15	11	80	0.1375000
NODE_2953_length_1341_cov_22.449275	623	703	5	4	80	0.0500000
NODE_2953_length_1341_cov_22.449275	623	703	6	18	80	0.2250000
NODE_2953_length_1341_cov_22.449275	623	703	7	15	80	0.1875000
NODE_2953_length_1341_cov_22.449275	623	703	8	13	80	0.1625000
NODE_2953_length_1341_cov_22.449275	623	703	9	6	80	0.0750000
NODE_2953_length_1341_cov_22.449275	623	703	10	6	80	0.0750000
NODE_2953_length_1341_cov_22.449275	623	703	11	18	80	0.2250000
NODE_2953_length_1341_cov_22.449275	676	755	8	12	79	0.1518987
NODE_2953_length_1341_cov_22.449275	676	755	9	24	79	0.3037975
NODE_2953_length_1341_cov_22.449275	676	755	10	27	79	0.3417721
NODE_2953_length_1341_cov_22.449275	676	755	11	16	79	0.2025317
NODE_2954_length_1341_cov_14.497585	415	495	7	3	80	0.0375000
NODE_2954_length_1341_cov_14.497585	415	495	8	1	80	0.0125000
NODE_2954_length_1341_cov_14.497585	415	495	9	21	80	0.2625000
NODE_2954_length_1341_cov_14.497585	415	495	10	55	80	0.6875000
NODE_2954_length_1341_cov_14.497585	468	548	5	7	80	0.0875000
NODE_2954_length_1341_cov_14.497585	468	548	7	46	80	0.5750000
NODE_2954_length_1341_cov_14.497585	468	548	8	3	80	0.0375000
NODE_2954_length_1341_cov_14.497585	468	548	9	7	80	0.0875000
NODE_2954_length_1341_cov_14.497585	468	548	10	17	80	0.2125000
NODE_2954_length_1341_cov_14.497585	544	624	4	64	80	0.8000000
NODE_2954_length_1341_cov_14.497585	544	624	5	15	80	0.1875000
NODE_2954_length_1341_cov_14.497585	544	624	6	1	80	0.0125000
NODE_2954_length_1341_cov_14.497585	597	677	1	6	80	0.0750000
NODE_2954_length_1341_cov_14.497585	597	677	3	4	80	0.0500000
NODE_2954_length_1341_cov_14.497585	597	677	4	64	80	0.8000000
NODE_2954_length_1341_cov_14.497585	597	677	5	5	80	0.0625000
NODE_2954_length_1341_cov_14.497585	597	677	6	1	80	0.0125000
NODE_2960_length_1340_cov_9.460113	531	611	2	14	80	0.1750000
NODE_2960_length_1340_cov_9.460113	531	611	3	13	80	0.1625000
NODE_2960_length_1340_cov_9.460113	531	611	4	53	80	0.6625000
NODE_2960_length_1340_cov_9.460113	584	664	2	67	80	0.8375000
NODE_2960_length_1340_cov_9.460113	584	664	3	9	80	0.1125000
NODE_2960_length_1340_cov_9.460113	584	664	4	4	80	0.0500000
NODE_2961_length_1340_cov_6.511684	735	815	8	1	80	0.0125000
NODE_2961_length_1340_cov_6.511684	735	815	9	4	80	0.0500000
NODE_2961_length_1340_cov_6.511684	735	815	10	7	80	0.0875000
NODE_2961_length_1340_cov_6.511684	735	815	11	44	80	0.5500000
NODE_2961_length_1340_cov_6.511684	735	815	12	19	80	0.2375000
NODE_2961_length_1340_cov_6.511684	735	815	13	5	80	0.0625000
NODE_2961_length_1340_cov_6.511684	788	868	8	25	80	0.3125000
NODE_2961_length_1340_cov_6.511684	788	868	9	4	80	0.0500000
NODE_2961_length_1340_cov_6.511684	788	868	10	12	80	0.1500000
NODE_2961_length_1340_cov_6.511684	788	868	11	37	80	0.4625000
NODE_2961_length_1340_cov_6.511684	788	868	12	2	80	0.0250000
NODE_2966_length_1339_cov_22.725000	751	831	2	9	80	0.1125000
NODE_2966_length_1339_cov_22.725000	751	831	3	71	80	0.8875000
NODE_2966_length_1339_cov_22.725000	804	884	1	43	80	0.5375000
NODE_2966_length_1339_cov_22.725000	804	884	2	7	80	0.0875000
NODE_2966_length_1339_cov_22.725000	804	884	3	30	80	0.3750000
NODE_2967_length_1339_cov_9.322581	329	409	0	62	80	0.7750000
NODE_2967_length_1339_cov_9.322581	329	409	1	1	80	0.0125000
NODE_2967_length_1339_cov_9.322581	329	409	2	15	80	0.1875000
NODE_2967_length_1339_cov_9.322581	329	409	4	2	80	0.0250000
NODE_2967_length_1339_cov_9.322581	382	462	0	9	80	0.1125000
NODE_2967_length_1339_cov_9.322581	382	462	1	1	80	0.0125000
NODE_2967_length_1339_cov_9.322581	382	462	2	15	80	0.1875000
NODE_2967_length_1339_cov_9.322581	382	462	4	55	80	0.6875000
NODE_2970_length_1338_cov_31.740920	527	607	2	80	80	1.0000000
NODE_2970_length_1338_cov_31.740920	580	660	1	35	80	0.4375000
NODE_2970_length_1338_cov_31.740920	580	660	2	45	80	0.5625000
NODE_2970_length_1338_cov_31.740920	656	736	1	17	80	0.2125000
NODE_2970_length_1338_cov_31.740920	656	736	2	43	80	0.5375000
NODE_2970_length_1338_cov_31.740920	656	736	3	2	80	0.0250000
NODE_2970_length_1338_cov_31.740920	656	736	5	18	80	0.2250000
NODE_2970_length_1338_cov_31.740920	709	789	2	7	80	0.0875000
NODE_2970_length_1338_cov_31.740920	709	789	3	2	80	0.0250000
NODE_2970_length_1338_cov_31.740920	709	789	4	3	80	0.0375000
NODE_2970_length_1338_cov_31.740920	709	789	5	68	80	0.8500000
NODE_2971_length_1338_cov_21.254237	639	719	6	1	80	0.0125000
NODE_2971_length_1338_cov_21.254237	639	719	7	12	80	0.1500000
NODE_2971_length_1338_cov_21.254237	639	719	8	47	80	0.5875000
NODE_2971_length_1338_cov_21.254237	639	719	9	20	80	0.2500000
NODE_2971_length_1338_cov_21.254237	692	772	4	1	80	0.0125000
NODE_2971_length_1338_cov_21.254237	692	772	5	14	80	0.1750000
NODE_2971_length_1338_cov_21.254237	692	772	6	19	80	0.2375000
NODE_2971_length_1338_cov_21.254237	692	772	7	8	80	0.1000000
NODE_2971_length_1338_cov_21.254237	692	772	8	7	80	0.0875000
NODE_2971_length_1338_cov_21.254237	692	772	9	31	80	0.3875000
NODE_2974_length_1337_cov_32.307754	739	819	14	9	80	0.1125000
NODE_2974_length_1337_cov_32.307754	739	819	16	7	80	0.0875000
NODE_2974_length_1337_cov_32.307754	739	819	18	8	80	0.1000000
NODE_2974_length_1337_cov_32.307754	739	819	21	1	80	0.0125000
NODE_2974_length_1337_cov_32.307754	739	819	23	10	80	0.1250000
NODE_2974_length_1337_cov_32.307754	739	819	24	7	80	0.0875000
NODE_2974_length_1337_cov_32.307754	739	819	27	8	80	0.1000000
NODE_2974_length_1337_cov_32.307754	739	819	28	3	80	0.0375000
NODE_2974_length_1337_cov_32.307754	739	819	29	1	80	0.0125000
NODE_2974_length_1337_cov_32.307754	739	819	30	8	80	0.1000000
NODE_2974_length_1337_cov_32.307754	739	819	32	9	80	0.1125000
NODE_2974_length_1337_cov_32.307754	739	819	33	9	80	0.1125000
NODE_2974_length_1337_cov_32.307754	792	872	19	1	80	0.0125000
NODE_2974_length_1337_cov_32.307754	792	872	20	2	80	0.0250000
NODE_2974_length_1337_cov_32.307754	792	872	21	1	80	0.0125000
NODE_2974_length_1337_cov_32.307754	792	872	22	13	80	0.1625000
NODE_2974_length_1337_cov_32.307754	792	872	24	2	80	0.0250000
NODE_2974_length_1337_cov_32.307754	792	872	25	4	80	0.0500000
NODE_2974_length_1337_cov_32.307754	792	872	27	2	80	0.0250000
NODE_2974_length_1337_cov_32.307754	792	872	29	1	80	0.0125000
NODE_2974_length_1337_cov_32.307754	792	872	30	31	80	0.3875000
NODE_2974_length_1337_cov_32.307754	792	872	31	4	80	0.0500000
NODE_2974_length_1337_cov_32.307754	792	872	32	10	80	0.1250000
NODE_2974_length_1337_cov_32.307754	792	872	33	9	80	0.1125000
NODE_2975_length_1337_cov_30.412763	465	545	8	39	80	0.4875000
NODE_2975_length_1337_cov_30.412763	465	545	9	32	80	0.4000000
NODE_2975_length_1337_cov_30.412763	465	545	10	9	80	0.1125000
NODE_2975_length_1337_cov_30.412763	518	598	1	13	80	0.1625000
NODE_2975_length_1337_cov_30.412763	518	598	3	2	80	0.0250000
NODE_2975_length_1337_cov_30.412763	518	598	4	11	80	0.1375000
NODE_2975_length_1337_cov_30.412763	518	598	5	1	80	0.0125000
NODE_2975_length_1337_cov_30.412763	518	598	6	17	80	0.2125000
NODE_2975_length_1337_cov_30.412763	518	598	8	22	80	0.2750000
NODE_2975_length_1337_cov_30.412763	518	598	9	14	80	0.1750000
NODE_2976_length_1337_cov_12.760905	560	640	0	12	80	0.1500000
NODE_2976_length_1337_cov_12.760905	560	640	1	11	80	0.1375000
NODE_2976_length_1337_cov_12.760905	560	640	2	19	80	0.2375000
NODE_2976_length_1337_cov_12.760905	560	640	3	38	80	0.4750000
NODE_2976_length_1337_cov_12.760905	613	693	1	44	80	0.5500000
NODE_2976_length_1337_cov_12.760905	613	693	3	36	80	0.4500000
NODE_2977_length_1337_cov_9.463651	724	804	1	35	80	0.4375000
NODE_2977_length_1337_cov_9.463651	724	804	2	45	80	0.5625000
NODE_2977_length_1337_cov_9.463651	777	857	1	43	80	0.5375000
NODE_2977_length_1337_cov_9.463651	777	857	2	30	80	0.3750000
NODE_2977_length_1337_cov_9.463651	777	857	3	7	80	0.0875000
NODE_2979_length_1337_cov_4.540388	216	296	7	44	80	0.5500000
NODE_2979_length_1337_cov_4.540388	216	296	8	36	80	0.4500000
NODE_2979_length_1337_cov_4.540388	272	349	2	15	77	0.1948052
NODE_2979_length_1337_cov_4.540388	272	349	4	3	77	0.0389610
NODE_2979_length_1337_cov_4.540388	272	349	5	6	77	0.0779221
NODE_2979_length_1337_cov_4.540388	272	349	6	4	77	0.0519481
NODE_2979_length_1337_cov_4.540388	272	349	8	49	77	0.6363636
NODE_2981_length_1336_cov_28.161681	394	474	8	37	80	0.4625000
NODE_2981_length_1336_cov_28.161681	394	474	9	21	80	0.2625000
NODE_2981_length_1336_cov_28.161681	394	474	10	14	80	0.1750000
NODE_2981_length_1336_cov_28.161681	394	474	11	8	80	0.1000000
NODE_2981_length_1336_cov_28.161681	447	527	9	28	80	0.3500000
NODE_2981_length_1336_cov_28.161681	447	527	10	31	80	0.3875000
NODE_2981_length_1336_cov_28.161681	447	527	11	21	80	0.2625000
NODE_2981_length_1336_cov_28.161681	523	603	4	1	80	0.0125000
NODE_2981_length_1336_cov_28.161681	523	603	5	34	80	0.4250000
NODE_2981_length_1336_cov_28.161681	523	603	6	24	80	0.3000000
NODE_2981_length_1336_cov_28.161681	523	603	8	10	80	0.1250000
NODE_2981_length_1336_cov_28.161681	523	603	9	11	80	0.1375000
NODE_2981_length_1336_cov_28.161681	576	656	1	1	80	0.0125000
NODE_2981_length_1336_cov_28.161681	576	656	2	18	80	0.2250000
NODE_2981_length_1336_cov_28.161681	576	656	3	21	80	0.2625000
NODE_2981_length_1336_cov_28.161681	576	656	4	14	80	0.1750000
NODE_2981_length_1336_cov_28.161681	576	656	5	15	80	0.1875000
NODE_2981_length_1336_cov_28.161681	576	656	6	11	80	0.1375000
NODE_2982_length_1336_cov_7.860954	17	98	3	7	81	0.0864198
NODE_2982_length_1336_cov_7.860954	17	98	4	34	81	0.4197531
NODE_2982_length_1336_cov_7.860954	17	98	6	40	81	0.4938272
NODE_2984_length_1336_cov_1.689572	1229	1289	0	29	60	0.4833333
NODE_2984_length_1336_cov_1.689572	1229	1289	1	31	60	0.5166667
NODE_2984_length_1336_cov_1.689572	1262	1336	0	74	74	1.0000000
NODE_2985_length_1335_cov_19.547735	530	607	5	16	77	0.2077922
NODE_2985_length_1335_cov_19.547735	530	607	6	1	77	0.0129870
NODE_2985_length_1335_cov_19.547735	530	607	7	60	77	0.7792208
NODE_2985_length_1335_cov_19.547735	582	660	2	31	78	0.3974359
NODE_2985_length_1335_cov_19.547735	582	660	3	11	78	0.1410256
NODE_2985_length_1335_cov_19.547735	582	660	4	4	78	0.0512821
NODE_2985_length_1335_cov_19.547735	582	660	5	23	78	0.2948718
NODE_2985_length_1335_cov_19.547735	582	660	7	9	78	0.1153846
NODE_2985_length_1335_cov_19.547735	656	736	1	55	80	0.6875000
NODE_2985_length_1335_cov_19.547735	656	736	2	16	80	0.2000000
NODE_2985_length_1335_cov_19.547735	656	736	3	9	80	0.1125000
NODE_2985_length_1335_cov_19.547735	709	789	1	67	80	0.8375000
NODE_2985_length_1335_cov_19.547735	709	789	2	13	80	0.1625000
NODE_2986_length_1335_cov_15.383495	419	499	5	37	80	0.4625000
NODE_2986_length_1335_cov_15.383495	419	499	6	43	80	0.5375000
NODE_2986_length_1335_cov_15.383495	472	552	2	9	80	0.1125000
NODE_2986_length_1335_cov_15.383495	472	552	3	19	80	0.2375000
NODE_2986_length_1335_cov_15.383495	472	552	4	23	80	0.2875000
NODE_2986_length_1335_cov_15.383495	472	552	5	29	80	0.3625000
NODE_2986_length_1335_cov_15.383495	548	628	4	59	80	0.7375000
NODE_2986_length_1335_cov_15.383495	548	628	5	15	80	0.1875000
NODE_2986_length_1335_cov_15.383495	548	628	6	6	80	0.0750000
NODE_2986_length_1335_cov_15.383495	601	681	4	80	80	1.0000000
NODE_2991_length_1333_cov_27.372771	493	573	8	4	80	0.0500000
NODE_2991_length_1333_cov_27.372771	493	573	9	9	80	0.1125000
NODE_2991_length_1333_cov_27.372771	493	573	11	6	80	0.0750000
NODE_2991_length_1333_cov_27.372771	493	573	12	47	80	0.5875000
NODE_2991_length_1333_cov_27.372771	493	573	13	14	80	0.1750000
NODE_2991_length_1333_cov_27.372771	546	626	6	17	80	0.2125000
NODE_2991_length_1333_cov_27.372771	546	626	7	25	80	0.3125000
NODE_2991_length_1333_cov_27.372771	546	626	8	4	80	0.0500000
NODE_2991_length_1333_cov_27.372771	546	626	9	9	80	0.1125000
NODE_2991_length_1333_cov_27.372771	546	626	10	11	80	0.1375000
NODE_2991_length_1333_cov_27.372771	546	626	11	6	80	0.0750000
NODE_2991_length_1333_cov_27.372771	546	626	12	7	80	0.0875000
NODE_2991_length_1333_cov_27.372771	546	626	13	1	80	0.0125000
NODE_2996_length_1332_cov_18.978913	648	728	9	14	80	0.1750000
NODE_2996_length_1332_cov_18.978913	648	728	11	59	80	0.7375000
NODE_2996_length_1332_cov_18.978913	648	728	12	7	80	0.0875000
NODE_2996_length_1332_cov_18.978913	701	781	9	1	80	0.0125000
NODE_2996_length_1332_cov_18.978913	701	781	10	29	80	0.3625000
NODE_2996_length_1332_cov_18.978913	701	781	11	47	80	0.5875000
NODE_2996_length_1332_cov_18.978913	701	781	12	3	80	0.0375000
NODE_2996_length_1332_cov_18.978913	777	857	6	29	80	0.3625000
NODE_2996_length_1332_cov_18.978913	777	857	7	32	80	0.4000000
NODE_2996_length_1332_cov_18.978913	777	857	8	4	80	0.0500000
NODE_2996_length_1332_cov_18.978913	777	857	9	12	80	0.1500000
NODE_2996_length_1332_cov_18.978913	777	857	10	3	80	0.0375000
NODE_2996_length_1332_cov_18.978913	830	910	1	6	80	0.0750000
NODE_2996_length_1332_cov_18.978913	830	910	2	7	80	0.0875000
NODE_2996_length_1332_cov_18.978913	830	910	3	18	80	0.2250000
NODE_2996_length_1332_cov_18.978913	830	910	4	1	80	0.0125000
NODE_2996_length_1332_cov_18.978913	830	910	6	48	80	0.6000000
NODE_2997_length_1332_cov_3.112733	87	151	0	56	64	0.8750000
NODE_2997_length_1332_cov_3.112733	87	151	1	4	64	0.0625000
NODE_2997_length_1332_cov_3.112733	87	151	3	4	64	0.0625000
NODE_3000_length_1331_cov_16.831981	392	472	4	30	80	0.3750000
NODE_3000_length_1331_cov_16.831981	392	472	6	12	80	0.1500000
NODE_3000_length_1331_cov_16.831981	392	472	7	37	80	0.4625000
NODE_3000_length_1331_cov_16.831981	392	472	8	1	80	0.0125000
NODE_3000_length_1331_cov_16.831981	445	525	2	12	80	0.1500000
NODE_3000_length_1331_cov_16.831981	445	525	4	4	80	0.0500000
NODE_3000_length_1331_cov_16.831981	445	525	5	29	80	0.3625000
NODE_3000_length_1331_cov_16.831981	445	525	7	35	80	0.4375000
NODE_3000_length_1331_cov_16.831981	521	601	2	58	80	0.7250000
NODE_3000_length_1331_cov_16.831981	521	601	4	22	80	0.2750000
NODE_3000_length_1331_cov_16.831981	574	654	2	80	80	1.0000000
NODE_3001_length_1331_cov_12.841721	871	951	2	28	80	0.3500000
NODE_3001_length_1331_cov_12.841721	871	951	3	52	80	0.6500000
NODE_3001_length_1331_cov_12.841721	924	1004	1	10	80	0.1250000
NODE_3001_length_1331_cov_12.841721	924	1004	2	7	80	0.0875000
NODE_3001_length_1331_cov_12.841721	924	1004	3	63	80	0.7875000
NODE_3004_length_1331_cov_2.090097	0	76	0	76	76	1.0000000
NODE_3004_length_1331_cov_2.090097	49	98	0	49	49	1.0000000
NODE_3007_length_1330_cov_48.993501	278	358	5	18	80	0.2250000
NODE_3007_length_1330_cov_48.993501	278	358	6	42	80	0.5250000
NODE_3007_length_1330_cov_48.993501	278	358	7	12	80	0.1500000
NODE_3007_length_1330_cov_48.993501	278	358	8	8	80	0.1000000
NODE_3007_length_1330_cov_48.993501	331	411	5	7	80	0.0875000
NODE_3007_length_1330_cov_48.993501	331	411	7	12	80	0.1500000
NODE_3007_length_1330_cov_48.993501	331	411	8	13	80	0.1625000
NODE_3007_length_1330_cov_48.993501	331	411	9	48	80	0.6000000
NODE_3007_length_1330_cov_48.993501	742	822	10	5	80	0.0625000
NODE_3007_length_1330_cov_48.993501	742	822	11	1	80	0.0125000
NODE_3007_length_1330_cov_48.993501	742	822	13	8	80	0.1000000
NODE_3007_length_1330_cov_48.993501	742	822	14	48	80	0.6000000
NODE_3007_length_1330_cov_48.993501	742	822	15	11	80	0.1375000
NODE_3007_length_1330_cov_48.993501	742	822	17	7	80	0.0875000
NODE_3007_length_1330_cov_48.993501	795	875	10	3	80	0.0375000
NODE_3007_length_1330_cov_48.993501	795	875	12	8	80	0.1000000
NODE_3007_length_1330_cov_48.993501	795	875	13	1	80	0.0125000
NODE_3007_length_1330_cov_48.993501	795	875	14	56	80	0.7000000
NODE_3007_length_1330_cov_48.993501	795	875	15	12	80	0.1500000
NODE_3008_length_1330_cov_11.037368	407	487	4	1	80	0.0125000
NODE_3008_length_1330_cov_11.037368	407	487	5	15	80	0.1875000
NODE_3008_length_1330_cov_11.037368	407	487	6	39	80	0.4875000
NODE_3008_length_1330_cov_11.037368	407	487	7	25	80	0.3125000
NODE_3008_length_1330_cov_11.037368	460	540	2	9	80	0.1125000
NODE_3008_length_1330_cov_11.037368	460	540	3	35	80	0.4375000
NODE_3008_length_1330_cov_11.037368	460	540	4	10	80	0.1250000
NODE_3008_length_1330_cov_11.037368	460	540	5	15	80	0.1875000
NODE_3008_length_1330_cov_11.037368	460	540	7	11	80	0.1375000
NODE_3008_length_1330_cov_11.037368	536	617	1	20	81	0.2469136
NODE_3008_length_1330_cov_11.037368	536	617	2	61	81	0.7530864
NODE_3008_length_1330_cov_11.037368	590	670	1	73	80	0.9125000
NODE_3008_length_1330_cov_11.037368	590	670	2	7	80	0.0875000
NODE_3009_length_1330_cov_9.026807	551	631	3	39	80	0.4875000
NODE_3009_length_1330_cov_9.026807	551	631	4	26	80	0.3250000
NODE_3009_length_1330_cov_9.026807	551	631	6	15	80	0.1875000
NODE_3009_length_1330_cov_9.026807	604	684	3	10	80	0.1250000
NODE_3009_length_1330_cov_9.026807	604	684	4	2	80	0.0250000
NODE_3009_length_1330_cov_9.026807	604	684	5	20	80	0.2500000
NODE_3009_length_1330_cov_9.026807	604	684	6	48	80	0.6000000
NODE_3011_length_1329_cov_17.036585	691	771	1	80	80	1.0000000
NODE_3011_length_1329_cov_17.036585	744	824	0	30	80	0.3750000
NODE_3011_length_1329_cov_17.036585	744	824	1	50	80	0.6250000
NODE_3011_length_1329_cov_17.036585	820	900	1	25	80	0.3125000
NODE_3011_length_1329_cov_17.036585	820	900	3	55	80	0.6875000
NODE_3011_length_1329_cov_17.036585	873	953	3	80	80	1.0000000
NODE_3012_length_1329_cov_16.341463	428	476	5	1	48	0.0208333
NODE_3012_length_1329_cov_16.341463	428	476	6	1	48	0.0208333
NODE_3012_length_1329_cov_16.341463	428	476	7	2	48	0.0416667
NODE_3012_length_1329_cov_16.341463	428	476	8	6	48	0.1250000
NODE_3012_length_1329_cov_16.341463	428	476	9	6	48	0.1250000
NODE_3012_length_1329_cov_16.341463	428	476	11	3	48	0.0625000
NODE_3012_length_1329_cov_16.341463	428	476	13	9	48	0.1875000
NODE_3012_length_1329_cov_16.341463	428	476	14	4	48	0.0833333
NODE_3012_length_1329_cov_16.341463	428	476	15	5	48	0.1041667
NODE_3012_length_1329_cov_16.341463	428	476	16	3	48	0.0625000
NODE_3012_length_1329_cov_16.341463	428	476	17	2	48	0.0416667
NODE_3012_length_1329_cov_16.341463	428	476	19	6	48	0.1250000
NODE_3013_length_1329_cov_5.620325	888	955	0	67	67	1.0000000
NODE_3013_length_1329_cov_5.620325	941	999	0	58	58	1.0000000
NODE_3017_length_1328_cov_12.954434	794	874	7	59	80	0.7375000
NODE_3017_length_1328_cov_12.954434	794	874	8	16	80	0.2000000
NODE_3017_length_1328_cov_12.954434	794	874	9	5	80	0.0625000
NODE_3017_length_1328_cov_12.954434	847	927	7	12	80	0.1500000
NODE_3017_length_1328_cov_12.954434	847	927	8	24	80	0.3000000
NODE_3017_length_1328_cov_12.954434	847	927	9	32	80	0.4000000
NODE_3017_length_1328_cov_12.954434	847	927	10	12	80	0.1500000
NODE_3018_length_1328_cov_8.810415	762	842	2	24	80	0.3000000
NODE_3018_length_1328_cov_8.810415	762	842	4	56	80	0.7000000
NODE_3018_length_1328_cov_8.810415	815	895	0	24	80	0.3000000
NODE_3018_length_1328_cov_8.810415	815	895	1	25	80	0.3125000
NODE_3018_length_1328_cov_8.810415	815	895	2	28	80	0.3500000
NODE_3018_length_1328_cov_8.810415	815	895	4	3	80	0.0375000
NODE_3021_length_1327_cov_15.938925	260	340	7	21	80	0.2625000
NODE_3021_length_1327_cov_15.938925	260	340	8	59	80	0.7375000
NODE_3021_length_1327_cov_15.938925	313	393	5	8	80	0.1000000
NODE_3021_length_1327_cov_15.938925	313	393	6	3	80	0.0375000
NODE_3021_length_1327_cov_15.938925	313	393	7	36	80	0.4500000
NODE_3021_length_1327_cov_15.938925	313	393	8	27	80	0.3375000
NODE_3021_length_1327_cov_15.938925	313	393	9	6	80	0.0750000
NODE_3022_length_1327_cov_7.274430	159	235	0	76	76	1.0000000
NODE_3022_length_1327_cov_7.274430	774	854	2	11	80	0.1375000
NODE_3022_length_1327_cov_7.274430	774	854	4	69	80	0.8625000
NODE_3022_length_1327_cov_7.274430	827	890	2	47	63	0.7460318
NODE_3022_length_1327_cov_7.274430	827	890	4	16	63	0.2539683
NODE_3023_length_1327_cov_6.486156	896	976	2	37	80	0.4625000
NODE_3023_length_1327_cov_6.486156	896	976	3	1	80	0.0125000
NODE_3023_length_1327_cov_6.486156	896	976	4	42	80	0.5250000
NODE_3023_length_1327_cov_6.486156	949	1029	2	14	80	0.1750000
NODE_3023_length_1327_cov_6.486156	949	1029	4	66	80	0.8250000
NODE_3029_length_1326_cov_32.382233	571	651	0	80	80	1.0000000
NODE_3029_length_1326_cov_32.382233	624	704	0	80	80	1.0000000
NODE_3030_length_1326_cov_30.614507	760	840	4	16	80	0.2000000
NODE_3030_length_1326_cov_30.614507	760	840	5	61	80	0.7625000
NODE_3030_length_1326_cov_30.614507	760	840	7	3	80	0.0375000
NODE_3030_length_1326_cov_30.614507	813	893	4	6	80	0.0750000
NODE_3030_length_1326_cov_30.614507	813	893	5	36	80	0.4500000
NODE_3030_length_1326_cov_30.614507	813	893	6	31	80	0.3875000
NODE_3030_length_1326_cov_30.614507	813	893	7	7	80	0.0875000
NODE_3031_length_1326_cov_30.304808	488	568	5	5	80	0.0625000
NODE_3031_length_1326_cov_30.304808	488	568	7	24	80	0.3000000
NODE_3031_length_1326_cov_30.304808	488	568	8	2	80	0.0250000
NODE_3031_length_1326_cov_30.304808	488	568	11	27	80	0.3375000
NODE_3031_length_1326_cov_30.304808	488	568	12	22	80	0.2750000
NODE_3031_length_1326_cov_30.304808	541	621	8	2	80	0.0250000
NODE_3031_length_1326_cov_30.304808	541	621	9	22	80	0.2750000
NODE_3031_length_1326_cov_30.304808	541	621	10	18	80	0.2250000
NODE_3031_length_1326_cov_30.304808	541	621	11	37	80	0.4625000
NODE_3031_length_1326_cov_30.304808	541	621	12	1	80	0.0125000
NODE_3031_length_1326_cov_30.304808	617	697	7	31	80	0.3875000
NODE_3031_length_1326_cov_30.304808	617	697	8	3	80	0.0375000
NODE_3031_length_1326_cov_30.304808	617	697	9	12	80	0.1500000
NODE_3031_length_1326_cov_30.304808	617	697	10	20	80	0.2500000
NODE_3031_length_1326_cov_30.304808	617	697	11	14	80	0.1750000
NODE_3031_length_1326_cov_30.304808	670	750	7	17	80	0.2125000
NODE_3031_length_1326_cov_30.304808	670	750	8	6	80	0.0750000
NODE_3031_length_1326_cov_30.304808	670	750	9	17	80	0.2125000
NODE_3031_length_1326_cov_30.304808	670	750	10	40	80	0.5000000
NODE_3032_length_1326_cov_10.913610	238	318	8	22	80	0.2750000
NODE_3032_length_1326_cov_10.913610	238	318	9	58	80	0.7250000
NODE_3032_length_1326_cov_10.913610	291	371	4	19	80	0.2375000
NODE_3032_length_1326_cov_10.913610	291	371	6	19	80	0.2375000
NODE_3032_length_1326_cov_10.913610	291	371	7	9	80	0.1125000
NODE_3032_length_1326_cov_10.913610	291	371	9	33	80	0.4125000
NODE_3036_length_1325_cov_38.136215	0	46	1	46	46	1.0000000
NODE_3036_length_1325_cov_38.136215	19	99	1	78	80	0.9750000
NODE_3036_length_1325_cov_38.136215	19	99	3	1	80	0.0125000
NODE_3036_length_1325_cov_38.136215	19	99	4	1	80	0.0125000
NODE_3036_length_1325_cov_38.136215	948	1022	7	4	74	0.0540541
NODE_3036_length_1325_cov_38.136215	948	1022	8	4	74	0.0540541
NODE_3036_length_1325_cov_38.136215	948	1022	9	14	74	0.1891892
NODE_3036_length_1325_cov_38.136215	948	1022	11	4	74	0.0540541
NODE_3036_length_1325_cov_38.136215	948	1022	12	6	74	0.0810811
NODE_3036_length_1325_cov_38.136215	948	1022	14	4	74	0.0540541
NODE_3036_length_1325_cov_38.136215	948	1022	15	8	74	0.1081081
NODE_3036_length_1325_cov_38.136215	948	1022	16	19	74	0.2567568
NODE_3036_length_1325_cov_38.136215	948	1022	17	5	74	0.0675676
NODE_3036_length_1325_cov_38.136215	948	1022	18	6	74	0.0810811
NODE_3036_length_1325_cov_38.136215	1001	1063	15	2	62	0.0322581
NODE_3036_length_1325_cov_38.136215	1001	1063	16	11	62	0.1774193
NODE_3036_length_1325_cov_38.136215	1001	1063	17	14	62	0.2258064
NODE_3036_length_1325_cov_38.136215	1001	1063	18	10	62	0.1612903
NODE_3036_length_1325_cov_38.136215	1001	1063	19	2	62	0.0322581
NODE_3036_length_1325_cov_38.136215	1001	1063	20	1	62	0.0161290
NODE_3036_length_1325_cov_38.136215	1001	1063	22	9	62	0.1451613
NODE_3036_length_1325_cov_38.136215	1001	1063	23	3	62	0.0483871
NODE_3036_length_1325_cov_38.136215	1001	1063	24	1	62	0.0161290
NODE_3036_length_1325_cov_38.136215	1001	1063	25	1	62	0.0161290
NODE_3036_length_1325_cov_38.136215	1001	1063	26	5	62	0.0806452
NODE_3036_length_1325_cov_38.136215	1001	1063	27	3	62	0.0483871
NODE_3037_length_1325_cov_29.201468	613	693	3	50	80	0.6250000
NODE_3037_length_1325_cov_29.201468	613	693	4	30	80	0.3750000
NODE_3037_length_1325_cov_29.201468	666	746	1	48	80	0.6000000
NODE_3037_length_1325_cov_29.201468	666	746	3	17	80	0.2125000
NODE_3037_length_1325_cov_29.201468	666	746	4	15	80	0.1875000
NODE_3038_length_1325_cov_11.902121	697	777	2	35	80	0.4375000
NODE_3038_length_1325_cov_11.902121	697	777	3	8	80	0.1000000
NODE_3038_length_1325_cov_11.902121	697	777	4	12	80	0.1500000
NODE_3038_length_1325_cov_11.902121	697	777	5	6	80	0.0750000
NODE_3038_length_1325_cov_11.902121	697	777	6	19	80	0.2375000
NODE_3038_length_1325_cov_11.902121	750	830	4	41	80	0.5125000
NODE_3038_length_1325_cov_11.902121	750	830	5	6	80	0.0750000
NODE_3038_length_1325_cov_11.902121	750	830	6	33	80	0.4125000
NODE_3039_length_1325_cov_7.876835	645	725	1	6	80	0.0750000
NODE_3039_length_1325_cov_7.876835	645	725	2	74	80	0.9250000
NODE_3039_length_1325_cov_7.876835	698	778	2	80	80	1.0000000
NODE_3040_length_1325_cov_3.774062	1157	1218	0	58	61	0.9508197
NODE_3040_length_1325_cov_3.774062	1157	1218	1	1	61	0.0163934
NODE_3040_length_1325_cov_3.774062	1157	1218	3	2	61	0.0327869
NODE_3040_length_1325_cov_3.774062	1191	1271	0	80	80	1.0000000
NODE_3041_length_1325_cov_2.896411	0	58	0	28	58	0.4827586
NODE_3041_length_1325_cov_2.896411	0	58	1	30	58	0.5172414
NODE_3041_length_1325_cov_2.896411	8	67	0	20	59	0.3389831
NODE_3041_length_1325_cov_2.896411	8	67	1	39	59	0.6610169
NODE_3046_length_1324_cov_30.340408	939	1019	4	4	80	0.0500000
NODE_3046_length_1324_cov_30.340408	939	1019	6	52	80	0.6500000
NODE_3046_length_1324_cov_30.340408	939	1019	7	11	80	0.1375000
NODE_3046_length_1324_cov_30.340408	939	1019	8	13	80	0.1625000
NODE_3046_length_1324_cov_30.340408	992	1072	3	15	80	0.1875000
NODE_3046_length_1324_cov_30.340408	992	1072	5	16	80	0.2000000
NODE_3046_length_1324_cov_30.340408	992	1072	6	36	80	0.4500000
NODE_3046_length_1324_cov_30.340408	992	1072	7	10	80	0.1250000
NODE_3046_length_1324_cov_30.340408	992	1072	8	3	80	0.0375000
NODE_3047_length_1324_cov_7.391020	742	822	7	6	80	0.0750000
NODE_3047_length_1324_cov_7.391020	742	822	8	17	80	0.2125000
NODE_3047_length_1324_cov_7.391020	742	822	10	20	80	0.2500000
NODE_3047_length_1324_cov_7.391020	742	822	11	24	80	0.3000000
NODE_3047_length_1324_cov_7.391020	742	822	12	13	80	0.1625000
NODE_3047_length_1324_cov_7.391020	795	875	8	13	80	0.1625000
NODE_3047_length_1324_cov_7.391020	795	875	9	30	80	0.3750000
NODE_3047_length_1324_cov_7.391020	795	875	10	11	80	0.1375000
NODE_3047_length_1324_cov_7.391020	795	875	11	26	80	0.3250000
NODE_3053_length_1323_cov_30.600490	392	472	9	32	80	0.4000000
NODE_3053_length_1323_cov_30.600490	392	472	10	12	80	0.1500000
NODE_3053_length_1323_cov_30.600490	392	472	11	26	80	0.3250000
NODE_3053_length_1323_cov_30.600490	392	472	12	10	80	0.1250000
NODE_3053_length_1323_cov_30.600490	445	525	9	2	80	0.0250000
NODE_3053_length_1323_cov_30.600490	445	525	10	12	80	0.1500000
NODE_3053_length_1323_cov_30.600490	445	525	11	36	80	0.4500000
NODE_3053_length_1323_cov_30.600490	445	525	12	23	80	0.2875000
NODE_3053_length_1323_cov_30.600490	445	525	13	7	80	0.0875000
NODE_3053_length_1323_cov_30.600490	521	601	12	6	80	0.0750000
NODE_3053_length_1323_cov_30.600490	521	601	13	14	80	0.1750000
NODE_3053_length_1323_cov_30.600490	521	601	14	6	80	0.0750000
NODE_3053_length_1323_cov_30.600490	521	601	15	24	80	0.3000000
NODE_3053_length_1323_cov_30.600490	521	601	16	29	80	0.3625000
NODE_3053_length_1323_cov_30.600490	521	601	17	1	80	0.0125000
NODE_3053_length_1323_cov_30.600490	574	654	11	6	80	0.0750000
NODE_3053_length_1323_cov_30.600490	574	654	12	6	80	0.0750000
NODE_3053_length_1323_cov_30.600490	574	654	13	9	80	0.1125000
NODE_3053_length_1323_cov_30.600490	574	654	14	38	80	0.4750000
NODE_3053_length_1323_cov_30.600490	574	654	15	8	80	0.1000000
NODE_3053_length_1323_cov_30.600490	574	654	16	13	80	0.1625000
NODE_3054_length_1323_cov_20.888889	758	838	8	2	80	0.0250000
NODE_3054_length_1323_cov_20.888889	758	838	10	19	80	0.2375000
NODE_3054_length_1323_cov_20.888889	758	838	11	26	80	0.3250000
NODE_3054_length_1323_cov_20.888889	758	838	12	30	80	0.3750000
NODE_3054_length_1323_cov_20.888889	758	838	13	3	80	0.0375000
NODE_3054_length_1323_cov_20.888889	811	891	8	2	80	0.0250000
NODE_3054_length_1323_cov_20.888889	811	891	9	1	80	0.0125000
NODE_3054_length_1323_cov_20.888889	811	891	10	70	80	0.8750000
NODE_3054_length_1323_cov_20.888889	811	891	11	1	80	0.0125000
NODE_3054_length_1323_cov_20.888889	811	891	12	6	80	0.0750000
NODE_3061_length_1322_cov_8.988553	287	368	1	11	81	0.1358025
NODE_3061_length_1322_cov_8.988553	287	368	2	20	81	0.2469136
NODE_3061_length_1322_cov_8.988553	287	368	3	19	81	0.2345679
NODE_3061_length_1322_cov_8.988553	287	368	4	31	81	0.3827161
NODE_3061_length_1322_cov_8.988553	341	421	3	19	80	0.2375000
NODE_3061_length_1322_cov_8.988553	341	421	4	61	80	0.7625000
NODE_3061_length_1322_cov_8.988553	417	497	4	42	80	0.5250000
NODE_3061_length_1322_cov_8.988553	417	497	6	19	80	0.2375000
NODE_3061_length_1322_cov_8.988553	417	497	7	19	80	0.2375000
NODE_3061_length_1322_cov_8.988553	470	550	3	37	80	0.4625000
NODE_3061_length_1322_cov_8.988553	470	550	4	43	80	0.5375000
NODE_3068_length_1321_cov_57.885434	359	439	0	13	80	0.1625000
NODE_3068_length_1321_cov_57.885434	359	439	1	30	80	0.3750000
NODE_3068_length_1321_cov_57.885434	359	439	2	15	80	0.1875000
NODE_3068_length_1321_cov_57.885434	359	439	3	6	80	0.0750000
NODE_3068_length_1321_cov_57.885434	359	439	4	16	80	0.2000000
NODE_3068_length_1321_cov_57.885434	412	492	2	5	80	0.0625000
NODE_3068_length_1321_cov_57.885434	412	492	3	6	80	0.0750000
NODE_3068_length_1321_cov_57.885434	412	492	4	19	80	0.2375000
NODE_3068_length_1321_cov_57.885434	412	492	5	30	80	0.3750000
NODE_3068_length_1321_cov_57.885434	412	492	6	20	80	0.2500000
NODE_3068_length_1321_cov_57.885434	488	568	6	15	80	0.1875000
NODE_3068_length_1321_cov_57.885434	488	568	7	14	80	0.1750000
NODE_3068_length_1321_cov_57.885434	488	568	8	27	80	0.3375000
NODE_3068_length_1321_cov_57.885434	488	568	9	24	80	0.3000000
NODE_3068_length_1321_cov_57.885434	541	621	6	17	80	0.2125000
NODE_3068_length_1321_cov_57.885434	541	621	7	19	80	0.2375000
NODE_3068_length_1321_cov_57.885434	541	621	8	26	80	0.3250000
NODE_3068_length_1321_cov_57.885434	541	621	9	18	80	0.2250000
NODE_3071_length_1320_cov_70.753481	432	512	10	9	80	0.1125000
NODE_3071_length_1320_cov_70.753481	432	512	11	21	80	0.2625000
NODE_3071_length_1320_cov_70.753481	432	512	12	5	80	0.0625000
NODE_3071_length_1320_cov_70.753481	432	512	13	3	80	0.0375000
NODE_3071_length_1320_cov_70.753481	432	512	14	11	80	0.1375000
NODE_3071_length_1320_cov_70.753481	432	512	15	4	80	0.0500000
NODE_3071_length_1320_cov_70.753481	432	512	16	12	80	0.1500000
NODE_3071_length_1320_cov_70.753481	432	512	17	9	80	0.1125000
NODE_3071_length_1320_cov_70.753481	432	512	18	6	80	0.0750000
NODE_3071_length_1320_cov_70.753481	485	565	15	2	80	0.0250000
NODE_3071_length_1320_cov_70.753481	485	565	16	12	80	0.1500000
NODE_3071_length_1320_cov_70.753481	485	565	17	14	80	0.1750000
NODE_3071_length_1320_cov_70.753481	485	565	18	16	80	0.2000000
NODE_3071_length_1320_cov_70.753481	485	565	19	32	80	0.4000000
NODE_3071_length_1320_cov_70.753481	485	565	20	4	80	0.0500000
NODE_3071_length_1320_cov_70.753481	561	641	7	3	80	0.0375000
NODE_3071_length_1320_cov_70.753481	561	641	8	2	80	0.0250000
NODE_3071_length_1320_cov_70.753481	561	641	9	5	80	0.0625000
NODE_3071_length_1320_cov_70.753481	561	641	12	1	80	0.0125000
NODE_3071_length_1320_cov_70.753481	561	641	13	11	80	0.1375000
NODE_3071_length_1320_cov_70.753481	561	641	14	4	80	0.0500000
NODE_3071_length_1320_cov_70.753481	561	641	15	5	80	0.0625000
NODE_3071_length_1320_cov_70.753481	561	641	16	18	80	0.2250000
NODE_3071_length_1320_cov_70.753481	561	641	17	15	80	0.1875000
NODE_3071_length_1320_cov_70.753481	561	641	18	11	80	0.1375000
NODE_3071_length_1320_cov_70.753481	561	641	19	5	80	0.0625000
NODE_3071_length_1320_cov_70.753481	614	694	1	3	80	0.0375000
NODE_3071_length_1320_cov_70.753481	614	694	2	2	80	0.0250000
NODE_3071_length_1320_cov_70.753481	614	694	3	26	80	0.3250000
NODE_3071_length_1320_cov_70.753481	614	694	4	1	80	0.0125000
NODE_3071_length_1320_cov_70.753481	614	694	5	6	80	0.0750000
NODE_3071_length_1320_cov_70.753481	614	694	7	18	80	0.2250000
NODE_3071_length_1320_cov_70.753481	614	694	8	2	80	0.0250000
NODE_3071_length_1320_cov_70.753481	614	694	9	5	80	0.0625000
NODE_3071_length_1320_cov_70.753481	614	694	12	1	80	0.0125000
NODE_3071_length_1320_cov_70.753481	614	694	13	11	80	0.1375000
NODE_3071_length_1320_cov_70.753481	614	694	14	4	80	0.0500000
NODE_3071_length_1320_cov_70.753481	614	694	15	1	80	0.0125000
NODE_3072_length_1320_cov_39.149058	715	795	2	2	80	0.0250000
NODE_3072_length_1320_cov_39.149058	715	795	3	1	80	0.0125000
NODE_3072_length_1320_cov_39.149058	715	795	4	67	80	0.8375000
NODE_3072_length_1320_cov_39.149058	715	795	5	10	80	0.1250000
NODE_3072_length_1320_cov_39.149058	768	848	1	42	80	0.5250000
NODE_3072_length_1320_cov_39.149058	768	848	2	13	80	0.1625000
NODE_3072_length_1320_cov_39.149058	768	848	3	1	80	0.0125000
NODE_3072_length_1320_cov_39.149058	768	848	4	14	80	0.1750000
NODE_3072_length_1320_cov_39.149058	768	848	5	10	80	0.1250000
NODE_3072_length_1320_cov_39.149058	844	924	1	21	80	0.2625000
NODE_3072_length_1320_cov_39.149058	844	924	2	16	80	0.2000000
NODE_3072_length_1320_cov_39.149058	844	924	4	9	80	0.1125000
NODE_3072_length_1320_cov_39.149058	844	924	5	34	80	0.4250000
NODE_3072_length_1320_cov_39.149058	897	977	4	19	80	0.2375000
NODE_3072_length_1320_cov_39.149058	897	977	5	61	80	0.7625000
NODE_3073_length_1320_cov_19.175266	707	783	3	18	76	0.2368421
NODE_3073_length_1320_cov_19.175266	707	783	4	11	76	0.1447368
NODE_3073_length_1320_cov_19.175266	707	783	5	47	76	0.6184211
NODE_3073_length_1320_cov_19.175266	760	840	2	27	80	0.3375000
NODE_3073_length_1320_cov_19.175266	760	840	3	30	80	0.3750000
NODE_3073_length_1320_cov_19.175266	760	840	5	23	80	0.2875000
NODE_3074_length_1320_cov_11.224406	860	940	2	79	80	0.9875000
NODE_3074_length_1320_cov_11.224406	860	940	4	1	80	0.0125000
NODE_3074_length_1320_cov_11.224406	913	993	2	79	80	0.9875000
NODE_3074_length_1320_cov_11.224406	913	993	4	1	80	0.0125000
NODE_3075_length_1320_cov_11.036036	760	840	4	16	80	0.2000000
NODE_3075_length_1320_cov_11.036036	760	840	5	10	80	0.1250000
NODE_3075_length_1320_cov_11.036036	760	840	6	54	80	0.6750000
NODE_3075_length_1320_cov_11.036036	813	893	1	11	80	0.1375000
NODE_3075_length_1320_cov_11.036036	813	893	2	1	80	0.0125000
NODE_3075_length_1320_cov_11.036036	813	893	3	7	80	0.0875000
NODE_3075_length_1320_cov_11.036036	813	893	5	44	80	0.5500000
NODE_3075_length_1320_cov_11.036036	813	893	6	17	80	0.2125000
NODE_3076_length_1320_cov_8.357084	800	880	0	60	80	0.7500000
NODE_3076_length_1320_cov_8.357084	800	880	1	20	80	0.2500000
NODE_3076_length_1320_cov_8.357084	853	933	0	7	80	0.0875000
NODE_3076_length_1320_cov_8.357084	853	933	1	71	80	0.8875000
NODE_3076_length_1320_cov_8.357084	853	933	2	2	80	0.0250000
NODE_3080_length_1319_cov_27.098361	630	710	11	1	80	0.0125000
NODE_3080_length_1319_cov_27.098361	630	710	12	7	80	0.0875000
NODE_3080_length_1319_cov_27.098361	630	710	13	31	80	0.3875000
NODE_3080_length_1319_cov_27.098361	630	710	14	26	80	0.3250000
NODE_3080_length_1319_cov_27.098361	630	710	15	12	80	0.1500000
NODE_3080_length_1319_cov_27.098361	630	710	16	3	80	0.0375000
NODE_3080_length_1319_cov_27.098361	683	763	8	17	80	0.2125000
NODE_3080_length_1319_cov_27.098361	683	763	10	7	80	0.0875000
NODE_3080_length_1319_cov_27.098361	683	763	11	20	80	0.2500000
NODE_3080_length_1319_cov_27.098361	683	763	12	15	80	0.1875000
NODE_3080_length_1319_cov_27.098361	683	763	13	13	80	0.1625000
NODE_3080_length_1319_cov_27.098361	683	763	14	7	80	0.0875000
NODE_3080_length_1319_cov_27.098361	683	763	15	1	80	0.0125000
NODE_3081_length_1319_cov_22.992623	490	570	3	41	80	0.5125000
NODE_3081_length_1319_cov_22.992623	490	570	4	5	80	0.0625000
NODE_3081_length_1319_cov_22.992623	490	570	5	19	80	0.2375000
NODE_3081_length_1319_cov_22.992623	490	570	7	12	80	0.1500000
NODE_3081_length_1319_cov_22.992623	490	570	9	3	80	0.0375000
NODE_3081_length_1319_cov_22.992623	543	623	5	12	80	0.1500000
NODE_3081_length_1319_cov_22.992623	543	623	7	34	80	0.4250000
NODE_3081_length_1319_cov_22.992623	543	623	9	34	80	0.4250000
NODE_3086_length_1318_cov_13.624282	642	722	1	16	80	0.2000000
NODE_3086_length_1318_cov_13.624282	642	722	2	59	80	0.7375000
NODE_3086_length_1318_cov_13.624282	642	722	3	5	80	0.0625000
NODE_3086_length_1318_cov_13.624282	695	775	2	23	80	0.2875000
NODE_3086_length_1318_cov_13.624282	695	775	3	35	80	0.4375000
NODE_3086_length_1318_cov_13.624282	695	775	4	14	80	0.1750000
NODE_3086_length_1318_cov_13.624282	695	775	5	8	80	0.1000000
NODE_3086_length_1318_cov_13.624282	771	851	5	6	80	0.0750000
NODE_3086_length_1318_cov_13.624282	771	851	7	36	80	0.4500000
NODE_3086_length_1318_cov_13.624282	771	851	8	16	80	0.2000000
NODE_3086_length_1318_cov_13.624282	771	851	10	22	80	0.2750000
NODE_3086_length_1318_cov_13.624282	824	904	7	1	80	0.0125000
NODE_3086_length_1318_cov_13.624282	824	904	8	8	80	0.1000000
NODE_3086_length_1318_cov_13.624282	824	904	9	33	80	0.4125000
NODE_3086_length_1318_cov_13.624282	824	904	10	38	80	0.4750000
NODE_3089_length_1317_cov_162.041872	66	143	0	73	77	0.9480519
NODE_3089_length_1317_cov_162.041872	66	143	1	1	77	0.0129870
NODE_3089_length_1317_cov_162.041872	66	143	6	1	77	0.0129870
NODE_3089_length_1317_cov_162.041872	66	143	7	1	77	0.0129870
NODE_3089_length_1317_cov_162.041872	66	143	8	1	77	0.0129870
NODE_3090_length_1317_cov_19.736453	675	755	2	35	80	0.4375000
NODE_3090_length_1317_cov_19.736453	675	755	3	18	80	0.2250000
NODE_3090_length_1317_cov_19.736453	675	755	4	7	80	0.0875000
NODE_3090_length_1317_cov_19.736453	675	755	5	20	80	0.2500000
NODE_3090_length_1317_cov_19.736453	728	808	2	24	80	0.3000000
NODE_3090_length_1317_cov_19.736453	728	808	3	30	80	0.3750000
NODE_3090_length_1317_cov_19.736453	728	808	4	13	80	0.1625000
NODE_3090_length_1317_cov_19.736453	728	808	5	13	80	0.1625000
NODE_3090_length_1317_cov_19.736453	804	884	5	4	80	0.0500000
NODE_3090_length_1317_cov_19.736453	804	884	8	13	80	0.1625000
NODE_3090_length_1317_cov_19.736453	804	884	9	23	80	0.2875000
NODE_3090_length_1317_cov_19.736453	804	884	10	40	80	0.5000000
NODE_3090_length_1317_cov_19.736453	857	937	8	4	80	0.0500000
NODE_3090_length_1317_cov_19.736453	857	937	9	21	80	0.2625000
NODE_3090_length_1317_cov_19.736453	857	937	10	46	80	0.5750000
NODE_3090_length_1317_cov_19.736453	857	937	11	9	80	0.1125000
NODE_3092_length_1317_cov_2.203612	779	859	1	80	80	1.0000000
NODE_3095_length_1316_cov_25.377157	557	637	2	36	80	0.4500000
NODE_3095_length_1316_cov_25.377157	557	637	3	40	80	0.5000000
NODE_3095_length_1316_cov_25.377157	557	637	4	4	80	0.0500000
NODE_3095_length_1316_cov_25.377157	610	690	2	2	80	0.0250000
NODE_3095_length_1316_cov_25.377157	610	690	3	28	80	0.3500000
NODE_3095_length_1316_cov_25.377157	610	690	4	50	80	0.6250000
NODE_3096_length_1316_cov_15.891537	446	526	4	4	80	0.0500000
NODE_3096_length_1316_cov_15.891537	446	526	6	39	80	0.4875000
NODE_3096_length_1316_cov_15.891537	446	526	7	7	80	0.0875000
NODE_3096_length_1316_cov_15.891537	446	526	8	19	80	0.2375000
NODE_3096_length_1316_cov_15.891537	446	526	9	11	80	0.1375000
NODE_3096_length_1316_cov_15.891537	499	579	7	36	80	0.4500000
NODE_3096_length_1316_cov_15.891537	499	579	8	41	80	0.5125000
NODE_3096_length_1316_cov_15.891537	499	579	9	3	80	0.0375000
NODE_3096_length_1316_cov_15.891537	575	655	2	14	80	0.1750000
NODE_3096_length_1316_cov_15.891537	575	655	3	2	80	0.0250000
NODE_3096_length_1316_cov_15.891537	575	655	5	3	80	0.0375000
NODE_3096_length_1316_cov_15.891537	575	655	6	15	80	0.1875000
NODE_3096_length_1316_cov_15.891537	575	655	7	46	80	0.5750000
NODE_3096_length_1316_cov_15.891537	628	708	1	24	80	0.3000000
NODE_3096_length_1316_cov_15.891537	628	708	2	43	80	0.5375000
NODE_3096_length_1316_cov_15.891537	628	708	3	2	80	0.0250000
NODE_3096_length_1316_cov_15.891537	628	708	5	3	80	0.0375000
NODE_3096_length_1316_cov_15.891537	628	708	6	1	80	0.0125000
NODE_3096_length_1316_cov_15.891537	628	708	7	7	80	0.0875000
NODE_3101_length_1315_cov_24.136513	592	672	4	3	80	0.0375000
NODE_3101_length_1315_cov_24.136513	592	672	6	2	80	0.0250000
NODE_3101_length_1315_cov_24.136513	592	672	7	6	80	0.0750000
NODE_3101_length_1315_cov_24.136513	592	672	9	22	80	0.2750000
NODE_3101_length_1315_cov_24.136513	592	672	10	13	80	0.1625000
NODE_3101_length_1315_cov_24.136513	592	672	11	15	80	0.1875000
NODE_3101_length_1315_cov_24.136513	592	672	12	19	80	0.2375000
NODE_3101_length_1315_cov_24.136513	645	725	6	3	80	0.0375000
NODE_3101_length_1315_cov_24.136513	645	725	7	1	80	0.0125000
NODE_3101_length_1315_cov_24.136513	645	725	9	8	80	0.1000000
NODE_3101_length_1315_cov_24.136513	645	725	10	43	80	0.5375000
NODE_3101_length_1315_cov_24.136513	645	725	11	9	80	0.1125000
NODE_3101_length_1315_cov_24.136513	645	725	12	16	80	0.2000000
NODE_3105_length_1314_cov_38.391770	647	727	9	10	80	0.1250000
NODE_3105_length_1314_cov_38.391770	647	727	10	32	80	0.4000000
NODE_3105_length_1314_cov_38.391770	647	727	11	9	80	0.1125000
NODE_3105_length_1314_cov_38.391770	647	727	12	21	80	0.2625000
NODE_3105_length_1314_cov_38.391770	647	727	13	8	80	0.1000000
NODE_3105_length_1314_cov_38.391770	700	780	10	4	80	0.0500000
NODE_3105_length_1314_cov_38.391770	700	780	11	9	80	0.1125000
NODE_3105_length_1314_cov_38.391770	700	780	12	42	80	0.5250000
NODE_3105_length_1314_cov_38.391770	700	780	13	25	80	0.3125000
NODE_3105_length_1314_cov_38.391770	776	856	12	14	80	0.1750000
NODE_3105_length_1314_cov_38.391770	776	856	13	19	80	0.2375000
NODE_3105_length_1314_cov_38.391770	776	856	14	22	80	0.2750000
NODE_3105_length_1314_cov_38.391770	776	856	15	19	80	0.2375000
NODE_3105_length_1314_cov_38.391770	776	856	16	6	80	0.0750000
NODE_3105_length_1314_cov_38.391770	829	909	9	7	80	0.0875000
NODE_3105_length_1314_cov_38.391770	829	909	11	13	80	0.1625000
NODE_3105_length_1314_cov_38.391770	829	909	12	31	80	0.3875000
NODE_3105_length_1314_cov_38.391770	829	909	13	13	80	0.1625000
NODE_3105_length_1314_cov_38.391770	829	909	14	7	80	0.0875000
NODE_3105_length_1314_cov_38.391770	829	909	15	4	80	0.0500000
NODE_3105_length_1314_cov_38.391770	829	909	16	5	80	0.0625000
NODE_3106_length_1314_cov_30.167078	736	816	15	7	80	0.0875000
NODE_3106_length_1314_cov_30.167078	736	816	16	7	80	0.0875000
NODE_3106_length_1314_cov_30.167078	736	816	17	1	80	0.0125000
NODE_3106_length_1314_cov_30.167078	736	816	18	5	80	0.0625000
NODE_3106_length_1314_cov_30.167078	736	816	19	9	80	0.1125000
NODE_3106_length_1314_cov_30.167078	736	816	20	14	80	0.1750000
NODE_3106_length_1314_cov_30.167078	736	816	21	19	80	0.2375000
NODE_3106_length_1314_cov_30.167078	736	816	22	15	80	0.1875000
NODE_3106_length_1314_cov_30.167078	736	816	23	3	80	0.0375000
NODE_3106_length_1314_cov_30.167078	789	869	6	26	80	0.3250000
NODE_3106_length_1314_cov_30.167078	789	869	8	2	80	0.0250000
NODE_3106_length_1314_cov_30.167078	789	869	12	9	80	0.1125000
NODE_3106_length_1314_cov_30.167078	789	869	13	4	80	0.0500000
NODE_3106_length_1314_cov_30.167078	789	869	14	4	80	0.0500000
NODE_3106_length_1314_cov_30.167078	789	869	15	15	80	0.1875000
NODE_3106_length_1314_cov_30.167078	789	869	16	1	80	0.0125000
NODE_3106_length_1314_cov_30.167078	789	869	18	5	80	0.0625000
NODE_3106_length_1314_cov_30.167078	789	869	19	3	80	0.0375000
NODE_3106_length_1314_cov_30.167078	789	869	20	3	80	0.0375000
NODE_3106_length_1314_cov_30.167078	789	869	21	8	80	0.1000000
NODE_3107_length_1314_cov_11.221399	523	603	1	63	80	0.7875000
NODE_3107_length_1314_cov_11.221399	523	603	2	17	80	0.2125000
NODE_3107_length_1314_cov_11.221399	576	656	1	80	80	1.0000000
NODE_3114_length_1313_cov_29.315486	463	543	10	6	80	0.0750000
NODE_3114_length_1313_cov_29.315486	463	543	12	12	80	0.1500000
NODE_3114_length_1313_cov_29.315486	463	543	13	10	80	0.1250000
NODE_3114_length_1313_cov_29.315486	463	543	14	10	80	0.1250000
NODE_3114_length_1313_cov_29.315486	463	543	15	31	80	0.3875000
NODE_3114_length_1313_cov_29.315486	463	543	16	11	80	0.1375000
NODE_3114_length_1313_cov_29.315486	516	596	6	4	80	0.0500000
NODE_3114_length_1313_cov_29.315486	516	596	8	7	80	0.0875000
NODE_3114_length_1313_cov_29.315486	516	596	9	10	80	0.1250000
NODE_3114_length_1313_cov_29.315486	516	596	10	38	80	0.4750000
NODE_3114_length_1313_cov_29.315486	516	596	12	12	80	0.1500000
NODE_3114_length_1313_cov_29.315486	516	596	13	7	80	0.0875000
NODE_3114_length_1313_cov_29.315486	516	596	15	1	80	0.0125000
NODE_3114_length_1313_cov_29.315486	516	596	16	1	80	0.0125000
NODE_3115_length_1313_cov_25.144975	709	789	1	62	80	0.7750000
NODE_3115_length_1313_cov_25.144975	709	789	2	18	80	0.2250000
NODE_3115_length_1313_cov_25.144975	762	842	1	73	80	0.9125000
NODE_3115_length_1313_cov_25.144975	762	842	2	7	80	0.0875000
NODE_3115_length_1313_cov_25.144975	838	918	0	16	80	0.2000000
NODE_3115_length_1313_cov_25.144975	838	918	1	64	80	0.8000000
NODE_3115_length_1313_cov_25.144975	891	971	0	69	80	0.8625000
NODE_3115_length_1313_cov_25.144975	891	971	1	11	80	0.1375000
NODE_3118_length_1312_cov_20.378401	138	218	6	2	80	0.0250000
NODE_3118_length_1312_cov_20.378401	138	218	7	9	80	0.1125000
NODE_3118_length_1312_cov_20.378401	138	218	8	20	80	0.2500000
NODE_3118_length_1312_cov_20.378401	138	218	9	30	80	0.3750000
NODE_3118_length_1312_cov_20.378401	138	218	11	2	80	0.0250000
NODE_3118_length_1312_cov_20.378401	138	218	12	2	80	0.0250000
NODE_3118_length_1312_cov_20.378401	138	218	16	15	80	0.1875000
NODE_3118_length_1312_cov_20.378401	191	271	9	8	80	0.1000000
NODE_3118_length_1312_cov_20.378401	191	271	11	2	80	0.0250000
NODE_3118_length_1312_cov_20.378401	191	271	12	2	80	0.0250000
NODE_3118_length_1312_cov_20.378401	191	271	16	23	80	0.2875000
NODE_3118_length_1312_cov_20.378401	191	271	17	10	80	0.1250000
NODE_3118_length_1312_cov_20.378401	191	271	18	21	80	0.2625000
NODE_3118_length_1312_cov_20.378401	191	271	19	8	80	0.1000000
NODE_3118_length_1312_cov_20.378401	191	271	20	4	80	0.0500000
NODE_3118_length_1312_cov_20.378401	191	271	21	2	80	0.0250000
NODE_3121_length_1311_cov_38.468647	584	664	4	27	80	0.3375000
NODE_3121_length_1311_cov_38.468647	584	664	6	6	80	0.0750000
NODE_3121_length_1311_cov_38.468647	584	664	8	5	80	0.0625000
NODE_3121_length_1311_cov_38.468647	584	664	9	8	80	0.1000000
NODE_3121_length_1311_cov_38.468647	584	664	11	4	80	0.0500000
NODE_3121_length_1311_cov_38.468647	584	664	13	3	80	0.0375000
NODE_3121_length_1311_cov_38.468647	584	664	15	27	80	0.3375000
NODE_3121_length_1311_cov_38.468647	637	717	9	3	80	0.0375000
NODE_3121_length_1311_cov_38.468647	637	717	11	1	80	0.0125000
NODE_3121_length_1311_cov_38.468647	637	717	12	12	80	0.1500000
NODE_3121_length_1311_cov_38.468647	637	717	14	1	80	0.0125000
NODE_3121_length_1311_cov_38.468647	637	717	15	63	80	0.7875000
NODE_3121_length_1311_cov_38.468647	713	793	3	12	80	0.1500000
NODE_3121_length_1311_cov_38.468647	713	793	4	2	80	0.0250000
NODE_3121_length_1311_cov_38.468647	713	793	5	9	80	0.1125000
NODE_3121_length_1311_cov_38.468647	713	793	6	5	80	0.0625000
NODE_3121_length_1311_cov_38.468647	713	793	7	2	80	0.0250000
NODE_3121_length_1311_cov_38.468647	713	793	8	21	80	0.2625000
NODE_3121_length_1311_cov_38.468647	713	793	9	21	80	0.2625000
NODE_3121_length_1311_cov_38.468647	713	793	10	5	80	0.0625000
NODE_3121_length_1311_cov_38.468647	713	793	11	3	80	0.0375000
NODE_3121_length_1311_cov_38.468647	766	846	3	12	80	0.1500000
NODE_3121_length_1311_cov_38.468647	766	846	4	2	80	0.0250000
NODE_3121_length_1311_cov_38.468647	766	846	5	6	80	0.0750000
NODE_3121_length_1311_cov_38.468647	766	846	6	5	80	0.0625000
NODE_3121_length_1311_cov_38.468647	766	846	8	1	80	0.0125000
NODE_3121_length_1311_cov_38.468647	766	846	9	14	80	0.1750000
NODE_3121_length_1311_cov_38.468647	766	846	10	8	80	0.1000000
NODE_3121_length_1311_cov_38.468647	766	846	11	1	80	0.0125000
NODE_3121_length_1311_cov_38.468647	766	846	12	31	80	0.3875000
NODE_3125_length_1310_cov_37.739884	679	759	14	14	80	0.1750000
NODE_3125_length_1310_cov_37.739884	679	759	15	7	80	0.0875000
NODE_3125_length_1310_cov_37.739884	679	759	17	6	80	0.0750000
NODE_3125_length_1310_cov_37.739884	679	759	18	1	80	0.0125000
NODE_3125_length_1310_cov_37.739884	679	759	19	19	80	0.2375000
NODE_3125_length_1310_cov_37.739884	679	759	20	15	80	0.1875000
NODE_3125_length_1310_cov_37.739884	679	759	21	16	80	0.2000000
NODE_3125_length_1310_cov_37.739884	679	759	22	2	80	0.0250000
NODE_3125_length_1310_cov_37.739884	683	763	14	10	80	0.1250000
NODE_3125_length_1310_cov_37.739884	683	763	15	7	80	0.0875000
NODE_3125_length_1310_cov_37.739884	683	763	17	6	80	0.0750000
NODE_3125_length_1310_cov_37.739884	683	763	18	1	80	0.0125000
NODE_3125_length_1310_cov_37.739884	683	763	19	19	80	0.2375000
NODE_3125_length_1310_cov_37.739884	683	763	20	15	80	0.1875000
NODE_3125_length_1310_cov_37.739884	683	763	21	16	80	0.2000000
NODE_3125_length_1310_cov_37.739884	683	763	22	6	80	0.0750000
NODE_3125_length_1310_cov_37.739884	732	816	19	16	84	0.1904762
NODE_3125_length_1310_cov_37.739884	732	816	20	18	84	0.2142857
NODE_3125_length_1310_cov_37.739884	732	816	21	3	84	0.0357143
NODE_3125_length_1310_cov_37.739884	732	816	22	9	84	0.1071429
NODE_3125_length_1310_cov_37.739884	732	816	23	25	84	0.2976190
NODE_3125_length_1310_cov_37.739884	732	816	24	13	84	0.1547619
NODE_3125_length_1310_cov_37.739884	736	816	19	12	80	0.1500000
NODE_3125_length_1310_cov_37.739884	736	816	20	18	80	0.2250000
NODE_3125_length_1310_cov_37.739884	736	816	21	3	80	0.0375000
NODE_3125_length_1310_cov_37.739884	736	816	22	9	80	0.1125000
NODE_3125_length_1310_cov_37.739884	736	816	23	25	80	0.3125000
NODE_3125_length_1310_cov_37.739884	736	816	24	13	80	0.1625000
NODE_3125_length_1310_cov_37.739884	812	892	12	27	80	0.3375000
NODE_3125_length_1310_cov_37.739884	812	892	13	5	80	0.0625000
NODE_3125_length_1310_cov_37.739884	812	892	14	4	80	0.0500000
NODE_3125_length_1310_cov_37.739884	812	892	17	9	80	0.1125000
NODE_3125_length_1310_cov_37.739884	812	892	18	3	80	0.0375000
NODE_3125_length_1310_cov_37.739884	812	892	19	19	80	0.2375000
NODE_3125_length_1310_cov_37.739884	812	892	20	11	80	0.1375000
NODE_3125_length_1310_cov_37.739884	812	892	22	2	80	0.0250000
NODE_3125_length_1310_cov_37.739884	865	945	8	18	80	0.2250000
NODE_3125_length_1310_cov_37.739884	865	945	9	21	80	0.2625000
NODE_3125_length_1310_cov_37.739884	865	945	10	11	80	0.1375000
NODE_3125_length_1310_cov_37.739884	865	945	11	3	80	0.0375000
NODE_3125_length_1310_cov_37.739884	865	945	12	27	80	0.3375000
NODE_3126_length_1310_cov_12.245252	615	695	5	15	80	0.1875000
NODE_3126_length_1310_cov_12.245252	615	695	6	48	80	0.6000000
NODE_3126_length_1310_cov_12.245252	615	695	7	2	80	0.0250000
NODE_3126_length_1310_cov_12.245252	615	695	8	15	80	0.1875000
NODE_3126_length_1310_cov_12.245252	668	748	5	19	80	0.2375000
NODE_3126_length_1310_cov_12.245252	668	748	6	29	80	0.3625000
NODE_3126_length_1310_cov_12.245252	668	748	7	32	80	0.4000000
NODE_3127_length_1310_cov_10.184971	422	502	3	21	80	0.2625000
NODE_3127_length_1310_cov_10.184971	422	502	4	59	80	0.7375000
NODE_3127_length_1310_cov_10.184971	475	555	1	2	80	0.0250000
NODE_3127_length_1310_cov_10.184971	475	555	2	1	80	0.0125000
NODE_3127_length_1310_cov_10.184971	475	555	3	31	80	0.3875000
NODE_3127_length_1310_cov_10.184971	475	555	4	46	80	0.5750000
NODE_3128_length_1310_cov_3.186623	876	956	3	2	80	0.0250000
NODE_3128_length_1310_cov_3.186623	876	956	5	9	80	0.1125000
NODE_3128_length_1310_cov_3.186623	876	956	6	20	80	0.2500000
NODE_3128_length_1310_cov_3.186623	876	956	7	29	80	0.3625000
NODE_3128_length_1310_cov_3.186623	876	956	8	20	80	0.2500000
NODE_3128_length_1310_cov_3.186623	929	1009	3	55	80	0.6875000
NODE_3128_length_1310_cov_3.186623	929	1009	5	9	80	0.1125000
NODE_3128_length_1310_cov_3.186623	929	1009	6	1	80	0.0125000
NODE_3128_length_1310_cov_3.186623	929	1009	8	15	80	0.1875000
NODE_3131_length_1310_cov_0.757225	1255	1310	0	55	55	1.0000000
NODE_3132_length_1309_cov_34.942149	474	554	0	3	80	0.0375000
NODE_3132_length_1309_cov_34.942149	474	554	1	77	80	0.9625000
NODE_3132_length_1309_cov_34.942149	527	607	1	45	80	0.5625000
NODE_3132_length_1309_cov_34.942149	527	607	2	35	80	0.4375000
NODE_3132_length_1309_cov_34.942149	603	683	2	4	80	0.0500000
NODE_3132_length_1309_cov_34.942149	603	683	4	5	80	0.0625000
NODE_3132_length_1309_cov_34.942149	603	683	6	4	80	0.0500000
NODE_3132_length_1309_cov_34.942149	603	683	7	8	80	0.1000000
NODE_3132_length_1309_cov_34.942149	603	683	8	46	80	0.5750000
NODE_3132_length_1309_cov_34.942149	603	683	9	1	80	0.0125000
NODE_3132_length_1309_cov_34.942149	603	683	10	12	80	0.1500000
NODE_3132_length_1309_cov_34.942149	656	736	8	15	80	0.1875000
NODE_3132_length_1309_cov_34.942149	656	736	10	13	80	0.1625000
NODE_3132_length_1309_cov_34.942149	656	736	11	44	80	0.5500000
NODE_3132_length_1309_cov_34.942149	656	736	12	8	80	0.1000000
NODE_3133_length_1309_cov_10.571074	839	921	0	82	82	1.0000000
NODE_3133_length_1309_cov_10.571074	894	974	0	80	80	1.0000000
NODE_3135_length_1308_cov_43.461538	330	410	7	1	80	0.0125000
NODE_3135_length_1308_cov_43.461538	330	410	8	8	80	0.1000000
NODE_3135_length_1308_cov_43.461538	330	410	10	27	80	0.3375000
NODE_3135_length_1308_cov_43.461538	330	410	11	2	80	0.0250000
NODE_3135_length_1308_cov_43.461538	330	410	13	1	80	0.0125000
NODE_3135_length_1308_cov_43.461538	330	410	14	8	80	0.1000000
NODE_3135_length_1308_cov_43.461538	330	410	15	2	80	0.0250000
NODE_3135_length_1308_cov_43.461538	330	410	17	6	80	0.0750000
NODE_3135_length_1308_cov_43.461538	330	410	18	2	80	0.0250000
NODE_3135_length_1308_cov_43.461538	330	410	19	7	80	0.0875000
NODE_3135_length_1308_cov_43.461538	330	410	21	3	80	0.0375000
NODE_3135_length_1308_cov_43.461538	330	410	22	6	80	0.0750000
NODE_3135_length_1308_cov_43.461538	330	410	23	6	80	0.0750000
NODE_3135_length_1308_cov_43.461538	330	410	24	1	80	0.0125000
NODE_3135_length_1308_cov_43.461538	383	463	16	8	80	0.1000000
NODE_3135_length_1308_cov_43.461538	383	463	17	10	80	0.1250000
NODE_3135_length_1308_cov_43.461538	383	463	18	2	80	0.0250000
NODE_3135_length_1308_cov_43.461538	383	463	19	15	80	0.1875000
NODE_3135_length_1308_cov_43.461538	383	463	21	11	80	0.1375000
NODE_3135_length_1308_cov_43.461538	383	463	22	6	80	0.0750000
NODE_3135_length_1308_cov_43.461538	383	463	23	19	80	0.2375000
NODE_3135_length_1308_cov_43.461538	383	463	24	3	80	0.0375000
NODE_3135_length_1308_cov_43.461538	383	463	25	6	80	0.0750000
NODE_3145_length_1307_cov_11.290563	595	673	11	5	78	0.0641026
NODE_3145_length_1307_cov_11.290563	595	673	12	3	78	0.0384615
NODE_3145_length_1307_cov_11.290563	595	673	14	9	78	0.1153846
NODE_3145_length_1307_cov_11.290563	595	673	15	6	78	0.0769231
NODE_3145_length_1307_cov_11.290563	595	673	16	51	78	0.6538461
NODE_3145_length_1307_cov_11.290563	595	673	17	4	78	0.0512821
NODE_3145_length_1307_cov_11.290563	646	726	4	20	80	0.2500000
NODE_3145_length_1307_cov_11.290563	646	726	6	3	80	0.0375000
NODE_3145_length_1307_cov_11.290563	646	726	8	2	80	0.0250000
NODE_3145_length_1307_cov_11.290563	646	726	9	5	80	0.0625000
NODE_3145_length_1307_cov_11.290563	646	726	10	2	80	0.0250000
NODE_3145_length_1307_cov_11.290563	646	726	11	16	80	0.2000000
NODE_3145_length_1307_cov_11.290563	646	726	12	8	80	0.1000000
NODE_3145_length_1307_cov_11.290563	646	726	14	1	80	0.0125000
NODE_3145_length_1307_cov_11.290563	646	726	15	6	80	0.0750000
NODE_3145_length_1307_cov_11.290563	646	726	16	17	80	0.2125000
NODE_3146_length_1307_cov_8.653146	430	510	0	14	80	0.1750000
NODE_3146_length_1307_cov_8.653146	430	510	1	13	80	0.1625000
NODE_3146_length_1307_cov_8.653146	430	510	2	31	80	0.3875000
NODE_3146_length_1307_cov_8.653146	430	510	3	11	80	0.1375000
NODE_3146_length_1307_cov_8.653146	430	510	4	11	80	0.1375000
NODE_3146_length_1307_cov_8.653146	483	563	2	5	80	0.0625000
NODE_3146_length_1307_cov_8.653146	483	563	3	11	80	0.1375000
NODE_3146_length_1307_cov_8.653146	483	563	4	28	80	0.3500000
NODE_3146_length_1307_cov_8.653146	483	563	5	28	80	0.3500000
NODE_3146_length_1307_cov_8.653146	483	563	6	8	80	0.1000000
NODE_3153_length_1306_cov_26.813587	369	449	6	2	80	0.0250000
NODE_3153_length_1306_cov_26.813587	369	449	7	33	80	0.4125000
NODE_3153_length_1306_cov_26.813587	369	449	8	10	80	0.1250000
NODE_3153_length_1306_cov_26.813587	369	449	9	32	80	0.4000000
NODE_3153_length_1306_cov_26.813587	369	449	10	3	80	0.0375000
NODE_3153_length_1306_cov_26.813587	422	502	3	7	80	0.0875000
NODE_3153_length_1306_cov_26.813587	422	502	4	15	80	0.1875000
NODE_3153_length_1306_cov_26.813587	422	502	5	4	80	0.0500000
NODE_3153_length_1306_cov_26.813587	422	502	6	15	80	0.1875000
NODE_3153_length_1306_cov_26.813587	422	502	7	30	80	0.3750000
NODE_3153_length_1306_cov_26.813587	422	502	8	9	80	0.1125000
NODE_3153_length_1306_cov_26.813587	498	578	3	27	80	0.3375000
NODE_3153_length_1306_cov_26.813587	498	578	4	30	80	0.3750000
NODE_3153_length_1306_cov_26.813587	498	578	5	23	80	0.2875000
NODE_3153_length_1306_cov_26.813587	551	631	2	17	80	0.2125000
NODE_3153_length_1306_cov_26.813587	551	631	3	24	80	0.3000000
NODE_3153_length_1306_cov_26.813587	551	631	4	17	80	0.2125000
NODE_3153_length_1306_cov_26.813587	551	631	5	22	80	0.2750000
NODE_3154_length_1306_cov_24.904722	634	714	3	7	80	0.0875000
NODE_3154_length_1306_cov_24.904722	634	714	4	4	80	0.0500000
NODE_3154_length_1306_cov_24.904722	634	714	6	36	80	0.4500000
NODE_3154_length_1306_cov_24.904722	634	714	8	1	80	0.0125000
NODE_3154_length_1306_cov_24.904722	634	714	9	32	80	0.4000000
NODE_3154_length_1306_cov_24.904722	687	767	6	36	80	0.4500000
NODE_3154_length_1306_cov_24.904722	687	767	8	7	80	0.0875000
NODE_3154_length_1306_cov_24.904722	687	767	9	37	80	0.4625000
NODE_3155_length_1306_cov_18.274234	388	468	4	80	80	1.0000000
NODE_3155_length_1306_cov_18.274234	441	521	2	11	80	0.1375000
NODE_3155_length_1306_cov_18.274234	441	521	3	3	80	0.0375000
NODE_3155_length_1306_cov_18.274234	441	521	4	66	80	0.8250000
NODE_3156_length_1306_cov_15.176471	1214	1294	0	80	80	1.0000000
NODE_3157_length_1306_cov_12.699254	458	538	3	14	80	0.1750000
NODE_3157_length_1306_cov_12.699254	458	538	4	66	80	0.8250000
NODE_3157_length_1306_cov_12.699254	511	591	0	34	80	0.4250000
NODE_3157_length_1306_cov_12.699254	511	591	1	2	80	0.0250000
NODE_3157_length_1306_cov_12.699254	511	591	2	5	80	0.0625000
NODE_3157_length_1306_cov_12.699254	511	591	3	26	80	0.3250000
NODE_3157_length_1306_cov_12.699254	511	591	4	13	80	0.1625000
NODE_3158_length_1306_cov_9.958575	630	710	6	14	80	0.1750000
NODE_3158_length_1306_cov_9.958575	630	710	7	45	80	0.5625000
NODE_3158_length_1306_cov_9.958575	630	710	8	21	80	0.2625000
NODE_3158_length_1306_cov_9.958575	683	764	4	2	81	0.0246914
NODE_3158_length_1306_cov_9.958575	683	764	5	3	81	0.0370370
NODE_3158_length_1306_cov_9.958575	683	764	6	44	81	0.5432099
NODE_3158_length_1306_cov_9.958575	683	764	7	32	81	0.3950617
NODE_3159_length_1306_cov_2.739851	1206	1246	0	40	40	1.0000000
NODE_3168_length_1304_cov_28.444813	511	591	3	29	80	0.3625000
NODE_3168_length_1304_cov_28.444813	511	591	4	47	80	0.5875000
NODE_3168_length_1304_cov_28.444813	511	591	5	4	80	0.0500000
NODE_3168_length_1304_cov_28.444813	564	644	3	24	80	0.3000000
NODE_3168_length_1304_cov_28.444813	564	644	4	19	80	0.2375000
NODE_3168_length_1304_cov_28.444813	564	644	5	20	80	0.2500000
NODE_3168_length_1304_cov_28.444813	564	644	6	17	80	0.2125000
NODE_3168_length_1304_cov_28.444813	640	720	5	3	80	0.0375000
NODE_3168_length_1304_cov_28.444813	640	720	6	37	80	0.4625000
NODE_3168_length_1304_cov_28.444813	640	720	7	1	80	0.0125000
NODE_3168_length_1304_cov_28.444813	640	720	8	25	80	0.3125000
NODE_3168_length_1304_cov_28.444813	640	720	9	14	80	0.1750000
NODE_3168_length_1304_cov_28.444813	693	773	7	39	80	0.4875000
NODE_3168_length_1304_cov_28.444813	693	773	8	12	80	0.1500000
NODE_3168_length_1304_cov_28.444813	693	773	9	29	80	0.3625000
NODE_3169_length_1304_cov_27.137759	575	655	3	29	80	0.3625000
NODE_3169_length_1304_cov_27.137759	575	655	5	27	80	0.3375000
NODE_3169_length_1304_cov_27.137759	575	655	6	16	80	0.2000000
NODE_3169_length_1304_cov_27.137759	575	655	8	8	80	0.1000000
NODE_3169_length_1304_cov_27.137759	628	708	5	12	80	0.1500000
NODE_3169_length_1304_cov_27.137759	628	708	6	7	80	0.0875000
NODE_3169_length_1304_cov_27.137759	628	708	8	8	80	0.1000000
NODE_3169_length_1304_cov_27.137759	628	708	9	11	80	0.1375000
NODE_3169_length_1304_cov_27.137759	628	708	10	22	80	0.2750000
NODE_3169_length_1304_cov_27.137759	628	708	11	15	80	0.1875000
NODE_3169_length_1304_cov_27.137759	628	708	12	5	80	0.0625000
NODE_3169_length_1304_cov_27.137759	704	784	11	8	80	0.1000000
NODE_3169_length_1304_cov_27.137759	704	784	12	51	80	0.6375000
NODE_3169_length_1304_cov_27.137759	704	784	13	21	80	0.2625000
NODE_3169_length_1304_cov_27.137759	757	837	7	5	80	0.0625000
NODE_3169_length_1304_cov_27.137759	757	837	8	14	80	0.1750000
NODE_3169_length_1304_cov_27.137759	757	837	9	13	80	0.1625000
NODE_3169_length_1304_cov_27.137759	757	837	10	8	80	0.1000000
NODE_3169_length_1304_cov_27.137759	757	837	11	7	80	0.0875000
NODE_3169_length_1304_cov_27.137759	757	837	12	25	80	0.3125000
NODE_3169_length_1304_cov_27.137759	757	837	13	8	80	0.1000000
NODE_3171_length_1303_cov_36.546512	458	538	4	12	80	0.1500000
NODE_3171_length_1303_cov_36.546512	458	538	5	9	80	0.1125000
NODE_3171_length_1303_cov_36.546512	458	538	6	5	80	0.0625000
NODE_3171_length_1303_cov_36.546512	458	538	7	6	80	0.0750000
NODE_3171_length_1303_cov_36.546512	458	538	8	48	80	0.6000000
NODE_3171_length_1303_cov_36.546512	511	591	5	8	80	0.1000000
NODE_3171_length_1303_cov_36.546512	511	591	6	25	80	0.3125000
NODE_3171_length_1303_cov_36.546512	511	591	7	13	80	0.1625000
NODE_3171_length_1303_cov_36.546512	511	591	8	34	80	0.4250000
NODE_3171_length_1303_cov_36.546512	587	667	2	16	80	0.2000000
NODE_3171_length_1303_cov_36.546512	587	667	3	15	80	0.1875000
NODE_3171_length_1303_cov_36.546512	587	667	4	23	80	0.2875000
NODE_3171_length_1303_cov_36.546512	587	667	5	26	80	0.3250000
NODE_3171_length_1303_cov_36.546512	640	720	2	16	80	0.2000000
NODE_3171_length_1303_cov_36.546512	640	720	3	9	80	0.1125000
NODE_3171_length_1303_cov_36.546512	640	720	4	26	80	0.3250000
NODE_3171_length_1303_cov_36.546512	640	720	5	29	80	0.3625000
NODE_3174_length_1302_cov_22.265170	747	827	1	80	80	1.0000000
NODE_3174_length_1302_cov_22.265170	800	880	1	80	80	1.0000000
NODE_3175_length_1302_cov_16.199501	480	560	2	24	80	0.3000000
NODE_3175_length_1302_cov_16.199501	480	560	4	31	80	0.3875000
NODE_3175_length_1302_cov_16.199501	480	560	6	25	80	0.3125000
NODE_3175_length_1302_cov_16.199501	533	613	4	12	80	0.1500000
NODE_3175_length_1302_cov_16.199501	533	613	6	68	80	0.8500000
NODE_3176_length_1302_cov_6.953450	687	767	2	69	80	0.8625000
NODE_3176_length_1302_cov_6.953450	687	767	4	11	80	0.1375000
NODE_3176_length_1302_cov_6.953450	740	820	2	16	80	0.2000000
NODE_3176_length_1302_cov_6.953450	740	820	4	23	80	0.2875000
NODE_3176_length_1302_cov_6.953450	740	820	5	25	80	0.3125000
NODE_3176_length_1302_cov_6.953450	740	820	6	1	80	0.0125000
NODE_3176_length_1302_cov_6.953450	740	820	7	15	80	0.1875000
NODE_3179_length_1301_cov_31.711314	401	481	6	19	80	0.2375000
NODE_3179_length_1301_cov_31.711314	401	481	7	25	80	0.3125000
NODE_3179_length_1301_cov_31.711314	401	481	8	27	80	0.3375000
NODE_3179_length_1301_cov_31.711314	401	481	9	9	80	0.1125000
NODE_3179_length_1301_cov_31.711314	454	534	6	1	80	0.0125000
NODE_3179_length_1301_cov_31.711314	454	534	7	12	80	0.1500000
NODE_3179_length_1301_cov_31.711314	454	534	8	35	80	0.4375000
NODE_3179_length_1301_cov_31.711314	454	534	9	12	80	0.1500000
NODE_3179_length_1301_cov_31.711314	454	534	10	20	80	0.2500000
NODE_3181_length_1301_cov_5.529950	246	326	0	80	80	1.0000000
NODE_3181_length_1301_cov_5.529950	299	379	0	80	80	1.0000000
NODE_3186_length_1300_cov_39.109908	602	682	12	1	80	0.0125000
NODE_3186_length_1300_cov_39.109908	602	682	13	1	80	0.0125000
NODE_3186_length_1300_cov_39.109908	602	682	14	20	80	0.2500000
NODE_3186_length_1300_cov_39.109908	602	682	15	20	80	0.2500000
NODE_3186_length_1300_cov_39.109908	602	682	16	12	80	0.1500000
NODE_3186_length_1300_cov_39.109908	602	682	17	7	80	0.0875000
NODE_3186_length_1300_cov_39.109908	602	682	18	19	80	0.2375000
NODE_3186_length_1300_cov_39.109908	655	735	11	13	80	0.1625000
NODE_3186_length_1300_cov_39.109908	655	735	12	1	80	0.0125000
NODE_3186_length_1300_cov_39.109908	655	735	13	15	80	0.1875000
NODE_3186_length_1300_cov_39.109908	655	735	14	28	80	0.3500000
NODE_3186_length_1300_cov_39.109908	655	735	15	8	80	0.1000000
NODE_3186_length_1300_cov_39.109908	655	735	16	11	80	0.1375000
NODE_3186_length_1300_cov_39.109908	655	735	17	4	80	0.0500000
NODE_3187_length_1300_cov_34.360533	586	666	3	26	80	0.3250000
NODE_3187_length_1300_cov_34.360533	586	666	5	17	80	0.2125000
NODE_3187_length_1300_cov_34.360533	586	666	6	37	80	0.4625000
NODE_3187_length_1300_cov_34.360533	639	719	3	21	80	0.2625000
NODE_3187_length_1300_cov_34.360533	639	719	4	9	80	0.1125000
NODE_3187_length_1300_cov_34.360533	639	719	5	27	80	0.3375000
NODE_3187_length_1300_cov_34.360533	639	719	6	23	80	0.2875000
NODE_3188_length_1300_cov_4.659450	454	535	2	81	81	1.0000000
NODE_3188_length_1300_cov_4.659450	508	588	2	80	80	1.0000000
NODE_3189_length_1299_cov_29.071667	452	532	5	39	80	0.4875000
NODE_3189_length_1299_cov_29.071667	452	532	6	7	80	0.0875000
NODE_3189_length_1299_cov_29.071667	452	532	7	4	80	0.0500000
NODE_3189_length_1299_cov_29.071667	452	532	8	30	80	0.3750000
NODE_3190_length_1299_cov_23.600833	818	898	2	19	80	0.2375000
NODE_3190_length_1299_cov_23.600833	818	898	3	9	80	0.1125000
NODE_3190_length_1299_cov_23.600833	818	898	4	14	80	0.1750000
NODE_3190_length_1299_cov_23.600833	818	898	5	14	80	0.1750000
NODE_3190_length_1299_cov_23.600833	818	898	6	22	80	0.2750000
NODE_3190_length_1299_cov_23.600833	818	898	7	2	80	0.0250000
NODE_3190_length_1299_cov_23.600833	871	951	5	3	80	0.0375000
NODE_3190_length_1299_cov_23.600833	871	951	6	22	80	0.2750000
NODE_3190_length_1299_cov_23.600833	871	951	7	43	80	0.5375000
NODE_3190_length_1299_cov_23.600833	871	951	8	12	80	0.1500000
NODE_3191_length_1299_cov_23.169167	625	705	2	58	80	0.7250000
NODE_3191_length_1299_cov_23.169167	625	705	3	22	80	0.2750000
NODE_3191_length_1299_cov_23.169167	678	758	2	40	80	0.5000000
NODE_3191_length_1299_cov_23.169167	678	758	3	35	80	0.4375000
NODE_3191_length_1299_cov_23.169167	678	758	4	5	80	0.0625000
NODE_3191_length_1299_cov_23.169167	754	834	4	49	80	0.6125000
NODE_3191_length_1299_cov_23.169167	754	834	5	24	80	0.3000000
NODE_3191_length_1299_cov_23.169167	754	834	6	1	80	0.0125000
NODE_3191_length_1299_cov_23.169167	754	834	7	1	80	0.0125000
NODE_3191_length_1299_cov_23.169167	754	834	8	5	80	0.0625000
NODE_3191_length_1299_cov_23.169167	807	887	3	18	80	0.2250000
NODE_3191_length_1299_cov_23.169167	807	887	4	20	80	0.2500000
NODE_3191_length_1299_cov_23.169167	807	887	5	14	80	0.1750000
NODE_3191_length_1299_cov_23.169167	807	887	6	1	80	0.0125000
NODE_3191_length_1299_cov_23.169167	807	887	7	22	80	0.2750000
NODE_3191_length_1299_cov_23.169167	807	887	8	5	80	0.0625000
NODE_3192_length_1299_cov_19.315000	306	386	8	5	80	0.0625000
NODE_3192_length_1299_cov_19.315000	306	386	9	4	80	0.0500000
NODE_3192_length_1299_cov_19.315000	306	386	10	29	80	0.3625000
NODE_3192_length_1299_cov_19.315000	306	386	11	42	80	0.5250000
NODE_3192_length_1299_cov_19.315000	359	439	2	2	80	0.0250000
NODE_3192_length_1299_cov_19.315000	359	439	3	2	80	0.0250000
NODE_3192_length_1299_cov_19.315000	359	439	5	22	80	0.2750000
NODE_3192_length_1299_cov_19.315000	359	439	6	8	80	0.1000000
NODE_3192_length_1299_cov_19.315000	359	439	8	5	80	0.0625000
NODE_3192_length_1299_cov_19.315000	359	439	9	23	80	0.2875000
NODE_3192_length_1299_cov_19.315000	359	439	10	16	80	0.2000000
NODE_3192_length_1299_cov_19.315000	359	439	11	2	80	0.0250000
NODE_3192_length_1299_cov_19.315000	435	515	0	32	80	0.4000000
NODE_3192_length_1299_cov_19.315000	435	515	1	42	80	0.5250000
NODE_3192_length_1299_cov_19.315000	435	515	2	4	80	0.0500000
NODE_3192_length_1299_cov_19.315000	435	515	3	2	80	0.0250000
NODE_3192_length_1299_cov_19.315000	488	568	1	80	80	1.0000000
NODE_3193_length_1299_cov_13.691667	540	620	6	13	80	0.1625000
NODE_3193_length_1299_cov_13.691667	540	620	7	10	80	0.1250000
NODE_3193_length_1299_cov_13.691667	540	620	8	57	80	0.7125000
NODE_3193_length_1299_cov_13.691667	593	673	8	61	80	0.7625000
NODE_3193_length_1299_cov_13.691667	593	673	9	8	80	0.1000000
NODE_3193_length_1299_cov_13.691667	593	673	10	11	80	0.1375000
NODE_3195_length_1298_cov_58.277731	679	759	7	7	80	0.0875000
NODE_3195_length_1298_cov_58.277731	679	759	8	1	80	0.0125000
NODE_3195_length_1298_cov_58.277731	679	759	9	1	80	0.0125000
NODE_3195_length_1298_cov_58.277731	679	759	10	3	80	0.0375000
NODE_3195_length_1298_cov_58.277731	679	759	11	3	80	0.0375000
NODE_3195_length_1298_cov_58.277731	679	759	12	24	80	0.3000000
NODE_3195_length_1298_cov_58.277731	679	759	13	41	80	0.5125000
NODE_3195_length_1298_cov_58.277731	732	812	5	15	80	0.1875000
NODE_3195_length_1298_cov_58.277731	732	812	6	27	80	0.3375000
NODE_3195_length_1298_cov_58.277731	732	812	7	18	80	0.2250000
NODE_3195_length_1298_cov_58.277731	732	812	8	1	80	0.0125000
NODE_3195_length_1298_cov_58.277731	732	812	9	1	80	0.0125000
NODE_3195_length_1298_cov_58.277731	732	812	10	3	80	0.0375000
NODE_3195_length_1298_cov_58.277731	732	812	11	3	80	0.0375000
NODE_3195_length_1298_cov_58.277731	732	812	12	12	80	0.1500000
NODE_3195_length_1298_cov_58.277731	808	888	7	24	80	0.3000000
NODE_3195_length_1298_cov_58.277731	808	888	8	33	80	0.4125000
NODE_3195_length_1298_cov_58.277731	808	888	9	23	80	0.2875000
NODE_3195_length_1298_cov_58.277731	861	941	3	11	80	0.1375000
NODE_3195_length_1298_cov_58.277731	861	941	4	20	80	0.2500000
NODE_3195_length_1298_cov_58.277731	861	941	6	10	80	0.1250000
NODE_3195_length_1298_cov_58.277731	861	941	7	1	80	0.0125000
NODE_3195_length_1298_cov_58.277731	861	941	8	19	80	0.2375000
NODE_3195_length_1298_cov_58.277731	861	941	9	19	80	0.2375000
NODE_3196_length_1298_cov_31.319433	375	455	2	35	80	0.4375000
NODE_3196_length_1298_cov_31.319433	375	455	4	45	80	0.5625000
NODE_3196_length_1298_cov_31.319433	428	508	3	51	80	0.6375000
NODE_3196_length_1298_cov_31.319433	428	508	4	29	80	0.3625000
NODE_3196_length_1298_cov_31.319433	504	584	2	7	80	0.0875000
NODE_3196_length_1298_cov_31.319433	504	584	3	22	80	0.2750000
NODE_3196_length_1298_cov_31.319433	504	584	7	19	80	0.2375000
NODE_3196_length_1298_cov_31.319433	504	584	8	6	80	0.0750000
NODE_3196_length_1298_cov_31.319433	504	584	9	5	80	0.0625000
NODE_3196_length_1298_cov_31.319433	504	584	10	10	80	0.1250000
NODE_3196_length_1298_cov_31.319433	504	584	11	2	80	0.0250000
NODE_3196_length_1298_cov_31.319433	504	584	12	6	80	0.0750000
NODE_3196_length_1298_cov_31.319433	504	584	13	3	80	0.0375000
NODE_3196_length_1298_cov_31.319433	557	637	8	6	80	0.0750000
NODE_3196_length_1298_cov_31.319433	557	637	10	10	80	0.1250000
NODE_3196_length_1298_cov_31.319433	557	637	11	2	80	0.0250000
NODE_3196_length_1298_cov_31.319433	557	637	12	10	80	0.1250000
NODE_3196_length_1298_cov_31.319433	557	637	13	9	80	0.1125000
NODE_3196_length_1298_cov_31.319433	557	637	14	43	80	0.5375000
NODE_3197_length_1298_cov_2.158465	294	360	0	66	66	1.0000000
NODE_3201_length_1296_cov_34.778613	620	700	7	17	80	0.2125000
NODE_3201_length_1296_cov_34.778613	620	700	8	7	80	0.0875000
NODE_3201_length_1296_cov_34.778613	620	700	9	16	80	0.2000000
NODE_3201_length_1296_cov_34.778613	620	700	10	1	80	0.0125000
NODE_3201_length_1296_cov_34.778613	620	700	12	9	80	0.1125000
NODE_3201_length_1296_cov_34.778613	620	700	13	12	80	0.1500000
NODE_3201_length_1296_cov_34.778613	620	700	15	17	80	0.2125000
NODE_3201_length_1296_cov_34.778613	620	700	16	1	80	0.0125000
NODE_3201_length_1296_cov_34.778613	673	753	12	2	80	0.0250000
NODE_3201_length_1296_cov_34.778613	673	753	13	30	80	0.3750000
NODE_3201_length_1296_cov_34.778613	673	753	15	22	80	0.2750000
NODE_3201_length_1296_cov_34.778613	673	753	16	26	80	0.3250000
NODE_3202_length_1296_cov_28.726817	671	751	1	10	80	0.1250000
NODE_3202_length_1296_cov_28.726817	671	751	2	1	80	0.0125000
NODE_3202_length_1296_cov_28.726817	671	751	3	30	80	0.3750000
NODE_3202_length_1296_cov_28.726817	671	751	4	22	80	0.2750000
NODE_3202_length_1296_cov_28.726817	671	751	5	17	80	0.2125000
NODE_3202_length_1296_cov_28.726817	724	804	3	10	80	0.1250000
NODE_3202_length_1296_cov_28.726817	724	804	5	17	80	0.2125000
NODE_3202_length_1296_cov_28.726817	724	804	6	3	80	0.0375000
NODE_3202_length_1296_cov_28.726817	724	804	7	3	80	0.0375000
NODE_3202_length_1296_cov_28.726817	724	804	10	27	80	0.3375000
NODE_3202_length_1296_cov_28.726817	724	804	11	20	80	0.2500000
NODE_3202_length_1296_cov_28.726817	800	880	8	2	80	0.0250000
NODE_3202_length_1296_cov_28.726817	800	880	9	32	80	0.4000000
NODE_3202_length_1296_cov_28.726817	800	880	10	28	80	0.3500000
NODE_3202_length_1296_cov_28.726817	800	880	11	7	80	0.0875000
NODE_3202_length_1296_cov_28.726817	800	880	13	4	80	0.0500000
NODE_3202_length_1296_cov_28.726817	800	880	15	7	80	0.0875000
NODE_3202_length_1296_cov_28.726817	853	933	8	2	80	0.0250000
NODE_3202_length_1296_cov_28.726817	853	933	10	25	80	0.3125000
NODE_3202_length_1296_cov_28.726817	853	933	11	15	80	0.1875000
NODE_3202_length_1296_cov_28.726817	853	933	13	8	80	0.1000000
NODE_3202_length_1296_cov_28.726817	853	933	14	2	80	0.0250000
NODE_3202_length_1296_cov_28.726817	853	933	15	28	80	0.3500000
NODE_3205_length_1295_cov_10.661371	818	898	2	19	80	0.2375000
NODE_3205_length_1295_cov_10.661371	818	898	3	8	80	0.1000000
NODE_3205_length_1295_cov_10.661371	818	898	4	34	80	0.4250000
NODE_3205_length_1295_cov_10.661371	818	898	5	19	80	0.2375000
NODE_3205_length_1295_cov_10.661371	871	951	4	43	80	0.5375000
NODE_3205_length_1295_cov_10.661371	871	951	5	37	80	0.4625000
NODE_3211_length_1294_cov_15.098745	353	433	3	49	80	0.6125000
NODE_3211_length_1294_cov_15.098745	353	433	4	31	80	0.3875000
NODE_3211_length_1294_cov_15.098745	406	486	2	1	80	0.0125000
NODE_3211_length_1294_cov_15.098745	406	486	3	35	80	0.4375000
NODE_3211_length_1294_cov_15.098745	406	486	4	44	80	0.5500000
NODE_3216_length_1293_cov_26.580402	595	675	2	35	80	0.4375000
NODE_3216_length_1293_cov_26.580402	595	675	3	40	80	0.5000000
NODE_3216_length_1293_cov_26.580402	595	675	4	5	80	0.0625000
NODE_3216_length_1293_cov_26.580402	648	728	2	3	80	0.0375000
NODE_3216_length_1293_cov_26.580402	648	728	3	19	80	0.2375000
NODE_3216_length_1293_cov_26.580402	648	728	4	11	80	0.1375000
NODE_3216_length_1293_cov_26.580402	648	728	5	2	80	0.0250000
NODE_3216_length_1293_cov_26.580402	648	728	6	45	80	0.5625000
NODE_3216_length_1293_cov_26.580402	724	804	4	27	80	0.3375000
NODE_3216_length_1293_cov_26.580402	724	804	5	37	80	0.4625000
NODE_3216_length_1293_cov_26.580402	724	804	6	16	80	0.2000000
NODE_3216_length_1293_cov_26.580402	777	857	0	24	80	0.3000000
NODE_3216_length_1293_cov_26.580402	777	857	1	2	80	0.0250000
NODE_3216_length_1293_cov_26.580402	777	857	2	11	80	0.1375000
NODE_3216_length_1293_cov_26.580402	777	857	3	11	80	0.1375000
NODE_3216_length_1293_cov_26.580402	777	857	4	32	80	0.4000000
NODE_3217_length_1293_cov_9.252094	1187	1207	0	20	20	1.0000000
NODE_3220_length_1293_cov_2.118090	1131	1195	0	64	64	1.0000000
NODE_3220_length_1293_cov_2.118090	1184	1248	0	64	64	1.0000000
NODE_3224_length_1292_cov_50.158424	402	482	9	8	80	0.1000000
NODE_3224_length_1292_cov_50.158424	402	482	10	35	80	0.4375000
NODE_3224_length_1292_cov_50.158424	402	482	11	23	80	0.2875000
NODE_3224_length_1292_cov_50.158424	402	482	12	11	80	0.1375000
NODE_3224_length_1292_cov_50.158424	402	482	13	3	80	0.0375000
NODE_3224_length_1292_cov_50.158424	455	535	9	1	80	0.0125000
NODE_3224_length_1292_cov_50.158424	455	535	10	11	80	0.1375000
NODE_3224_length_1292_cov_50.158424	455	535	11	21	80	0.2625000
NODE_3224_length_1292_cov_50.158424	455	535	12	30	80	0.3750000
NODE_3224_length_1292_cov_50.158424	455	535	13	17	80	0.2125000
NODE_3224_length_1292_cov_50.158424	531	611	10	14	80	0.1750000
NODE_3224_length_1292_cov_50.158424	531	611	11	28	80	0.3500000
NODE_3224_length_1292_cov_50.158424	531	611	12	14	80	0.1750000
NODE_3224_length_1292_cov_50.158424	531	611	13	1	80	0.0125000
NODE_3224_length_1292_cov_50.158424	531	611	14	20	80	0.2500000
NODE_3224_length_1292_cov_50.158424	531	611	15	3	80	0.0375000
NODE_3224_length_1292_cov_50.158424	584	664	8	39	80	0.4875000
NODE_3224_length_1292_cov_50.158424	584	664	11	21	80	0.2625000
NODE_3224_length_1292_cov_50.158424	584	664	12	20	80	0.2500000
NODE_3225_length_1292_cov_36.535624	670	750	7	4	80	0.0500000
NODE_3225_length_1292_cov_36.535624	670	750	8	12	80	0.1500000
NODE_3225_length_1292_cov_36.535624	670	750	9	15	80	0.1875000
NODE_3225_length_1292_cov_36.535624	670	750	10	29	80	0.3625000
NODE_3225_length_1292_cov_36.535624	670	750	11	6	80	0.0750000
NODE_3225_length_1292_cov_36.535624	670	750	12	14	80	0.1750000
NODE_3225_length_1292_cov_36.535624	723	803	10	13	80	0.1625000
NODE_3225_length_1292_cov_36.535624	723	803	11	31	80	0.3875000
NODE_3225_length_1292_cov_36.535624	723	803	12	36	80	0.4500000
NODE_3226_length_1292_cov_24.523889	420	500	13	12	80	0.1500000
NODE_3226_length_1292_cov_24.523889	420	500	14	7	80	0.0875000
NODE_3226_length_1292_cov_24.523889	420	500	15	3	80	0.0375000
NODE_3226_length_1292_cov_24.523889	420	500	16	17	80	0.2125000
NODE_3226_length_1292_cov_24.523889	420	500	17	41	80	0.5125000
NODE_3226_length_1292_cov_24.523889	473	553	7	7	80	0.0875000
NODE_3226_length_1292_cov_24.523889	473	553	8	5	80	0.0625000
NODE_3226_length_1292_cov_24.523889	473	553	9	16	80	0.2000000
NODE_3226_length_1292_cov_24.523889	473	553	12	5	80	0.0625000
NODE_3226_length_1292_cov_24.523889	473	553	14	27	80	0.3375000
NODE_3226_length_1292_cov_24.523889	473	553	16	8	80	0.1000000
NODE_3226_length_1292_cov_24.523889	473	553	17	12	80	0.1500000
NODE_3232_length_1291_cov_8.734060	623	703	0	14	80	0.1750000
NODE_3232_length_1291_cov_8.734060	623	703	1	3	80	0.0375000
NODE_3232_length_1291_cov_8.734060	623	703	2	3	80	0.0375000
NODE_3232_length_1291_cov_8.734060	623	703	4	17	80	0.2125000
NODE_3232_length_1291_cov_8.734060	623	703	7	1	80	0.0125000
NODE_3232_length_1291_cov_8.734060	623	703	8	29	80	0.3625000
NODE_3232_length_1291_cov_8.734060	623	703	9	13	80	0.1625000
NODE_3232_length_1291_cov_8.734060	676	756	7	9	80	0.1125000
NODE_3232_length_1291_cov_8.734060	676	756	8	57	80	0.7125000
NODE_3232_length_1291_cov_8.734060	676	756	9	14	80	0.1750000
NODE_3233_length_1291_cov_8.625839	756	836	0	28	80	0.3500000
NODE_3233_length_1291_cov_8.625839	756	836	1	42	80	0.5250000
NODE_3233_length_1291_cov_8.625839	756	836	3	10	80	0.1250000
NODE_3233_length_1291_cov_8.625839	809	889	1	17	80	0.2125000
NODE_3233_length_1291_cov_8.625839	809	889	3	63	80	0.7875000
NODE_3236_length_1290_cov_24.120067	497	577	4	6	80	0.0750000
NODE_3236_length_1290_cov_24.120067	497	577	5	42	80	0.5250000
NODE_3236_length_1290_cov_24.120067	497	577	6	32	80	0.4000000
NODE_3236_length_1290_cov_24.120067	550	630	2	35	80	0.4375000
NODE_3236_length_1290_cov_24.120067	550	630	4	21	80	0.2625000
NODE_3236_length_1290_cov_24.120067	550	630	5	24	80	0.3000000
NODE_3236_length_1290_cov_24.120067	626	706	0	5	80	0.0625000
NODE_3236_length_1290_cov_24.120067	626	706	1	8	80	0.1000000
NODE_3236_length_1290_cov_24.120067	626	706	2	57	80	0.7125000
NODE_3236_length_1290_cov_24.120067	626	706	3	1	80	0.0125000
NODE_3236_length_1290_cov_24.120067	626	706	4	1	80	0.0125000
NODE_3236_length_1290_cov_24.120067	626	706	5	8	80	0.1000000
NODE_3236_length_1290_cov_24.120067	679	759	2	17	80	0.2125000
NODE_3236_length_1290_cov_24.120067	679	759	3	1	80	0.0125000
NODE_3236_length_1290_cov_24.120067	679	759	4	1	80	0.0125000
NODE_3236_length_1290_cov_24.120067	679	759	5	61	80	0.7625000
NODE_3237_length_1290_cov_18.874895	671	751	2	3	80	0.0375000
NODE_3237_length_1290_cov_18.874895	671	751	3	16	80	0.2000000
NODE_3237_length_1290_cov_18.874895	671	751	4	2	80	0.0250000
NODE_3237_length_1290_cov_18.874895	671	751	8	18	80	0.2250000
NODE_3237_length_1290_cov_18.874895	671	751	9	41	80	0.5125000
NODE_3237_length_1290_cov_18.874895	724	804	9	30	80	0.3750000
NODE_3237_length_1290_cov_18.874895	724	804	11	50	80	0.6250000
NODE_3238_length_1290_cov_11.627204	573	653	2	6	80	0.0750000
NODE_3238_length_1290_cov_11.627204	573	653	3	54	80	0.6750000
NODE_3238_length_1290_cov_11.627204	573	653	4	20	80	0.2500000
NODE_3238_length_1290_cov_11.627204	626	706	2	13	80	0.1625000
NODE_3238_length_1290_cov_11.627204	626	706	3	67	80	0.8375000
NODE_3239_length_1290_cov_11.215785	373	453	0	7	80	0.0875000
NODE_3239_length_1290_cov_11.215785	373	453	1	16	80	0.2000000
NODE_3239_length_1290_cov_11.215785	373	453	2	57	80	0.7125000
NODE_3239_length_1290_cov_11.215785	426	506	0	60	80	0.7500000
NODE_3239_length_1290_cov_11.215785	426	506	1	16	80	0.2000000
NODE_3239_length_1290_cov_11.215785	426	506	2	4	80	0.0500000
NODE_3240_length_1290_cov_8.752309	788	868	1	41	80	0.5125000
NODE_3240_length_1290_cov_8.752309	788	868	2	39	80	0.4875000
NODE_3240_length_1290_cov_8.752309	841	921	1	80	80	1.0000000
NODE_3242_length_1289_cov_47.476471	919	999	7	1	80	0.0125000
NODE_3242_length_1289_cov_47.476471	919	999	8	26	80	0.3250000
NODE_3242_length_1289_cov_47.476471	919	999	11	2	80	0.0250000
NODE_3242_length_1289_cov_47.476471	919	999	12	2	80	0.0250000
NODE_3242_length_1289_cov_47.476471	919	999	13	3	80	0.0375000
NODE_3242_length_1289_cov_47.476471	919	999	14	12	80	0.1500000
NODE_3242_length_1289_cov_47.476471	919	999	16	2	80	0.0250000
NODE_3242_length_1289_cov_47.476471	919	999	17	3	80	0.0375000
NODE_3242_length_1289_cov_47.476471	919	999	18	6	80	0.0750000
NODE_3242_length_1289_cov_47.476471	919	999	19	11	80	0.1375000
NODE_3242_length_1289_cov_47.476471	919	999	20	6	80	0.0750000
NODE_3242_length_1289_cov_47.476471	919	999	21	6	80	0.0750000
NODE_3242_length_1289_cov_47.476471	972	1052	14	19	80	0.2375000
NODE_3242_length_1289_cov_47.476471	972	1052	16	11	80	0.1375000
NODE_3242_length_1289_cov_47.476471	972	1052	17	4	80	0.0500000
NODE_3242_length_1289_cov_47.476471	972	1052	18	19	80	0.2375000
NODE_3242_length_1289_cov_47.476471	972	1052	19	15	80	0.1875000
NODE_3242_length_1289_cov_47.476471	972	1052	20	6	80	0.0750000
NODE_3242_length_1289_cov_47.476471	972	1052	21	6	80	0.0750000
NODE_3243_length_1289_cov_18.497479	688	768	1	12	80	0.1500000
NODE_3243_length_1289_cov_18.497479	688	768	2	17	80	0.2125000
NODE_3243_length_1289_cov_18.497479	688	768	3	51	80	0.6375000
NODE_3243_length_1289_cov_18.497479	741	821	0	51	80	0.6375000
NODE_3243_length_1289_cov_18.497479	741	821	2	19	80	0.2375000
NODE_3243_length_1289_cov_18.497479	741	821	3	10	80	0.1250000
NODE_3243_length_1289_cov_18.497479	817	893	0	76	76	1.0000000
NODE_3243_length_1289_cov_18.497479	878	958	0	80	80	1.0000000
NODE_3244_length_1289_cov_11.692437	574	654	11	13	80	0.1625000
NODE_3244_length_1289_cov_11.692437	574	654	12	50	80	0.6250000
NODE_3244_length_1289_cov_11.692437	574	654	13	17	80	0.2125000
NODE_3244_length_1289_cov_11.692437	627	707	8	4	80	0.0500000
NODE_3244_length_1289_cov_11.692437	627	707	9	5	80	0.0625000
NODE_3244_length_1289_cov_11.692437	627	707	10	11	80	0.1375000
NODE_3244_length_1289_cov_11.692437	627	707	11	24	80	0.3000000
NODE_3244_length_1289_cov_11.692437	627	707	12	18	80	0.2250000
NODE_3244_length_1289_cov_11.692437	627	707	13	18	80	0.2250000
NODE_3244_length_1289_cov_11.692437	703	783	4	5	80	0.0625000
NODE_3244_length_1289_cov_11.692437	703	783	5	29	80	0.3625000
NODE_3244_length_1289_cov_11.692437	703	783	6	20	80	0.2500000
NODE_3244_length_1289_cov_11.692437	703	783	7	13	80	0.1625000
NODE_3244_length_1289_cov_11.692437	703	783	8	13	80	0.1625000
NODE_3244_length_1289_cov_11.692437	756	836	0	8	80	0.1000000
NODE_3244_length_1289_cov_11.692437	756	836	1	9	80	0.1125000
NODE_3244_length_1289_cov_11.692437	756	836	2	3	80	0.0375000
NODE_3244_length_1289_cov_11.692437	756	836	3	5	80	0.0625000
NODE_3244_length_1289_cov_11.692437	756	836	4	33	80	0.4125000
NODE_3244_length_1289_cov_11.692437	756	836	5	22	80	0.2750000
NODE_3249_length_1288_cov_29.369218	711	791	7	21	80	0.2625000
NODE_3249_length_1288_cov_29.369218	711	791	8	23	80	0.2875000
NODE_3249_length_1288_cov_29.369218	711	791	11	17	80	0.2125000
NODE_3249_length_1288_cov_29.369218	711	791	12	19	80	0.2375000
NODE_3249_length_1288_cov_29.369218	764	844	8	8	80	0.1000000
NODE_3249_length_1288_cov_29.369218	764	844	10	25	80	0.3125000
NODE_3249_length_1288_cov_29.369218	764	844	11	19	80	0.2375000
NODE_3249_length_1288_cov_29.369218	764	844	12	28	80	0.3500000
NODE_3250_length_1288_cov_6.207738	735	815	0	80	80	1.0000000
NODE_3250_length_1288_cov_6.207738	788	868	0	80	80	1.0000000
NODE_3255_length_1288_cov_1.731707	1017	1095	0	78	78	1.0000000
NODE_3261_length_1287_cov_29.186027	730	810	9	26	80	0.3250000
NODE_3261_length_1287_cov_29.186027	730	810	10	2	80	0.0250000
NODE_3261_length_1287_cov_29.186027	730	810	11	42	80	0.5250000
NODE_3261_length_1287_cov_29.186027	730	810	12	2	80	0.0250000
NODE_3261_length_1287_cov_29.186027	730	810	13	7	80	0.0875000
NODE_3261_length_1287_cov_29.186027	730	810	15	1	80	0.0125000
NODE_3261_length_1287_cov_29.186027	783	863	8	18	80	0.2250000
NODE_3261_length_1287_cov_29.186027	783	863	9	6	80	0.0750000
NODE_3261_length_1287_cov_29.186027	783	863	11	47	80	0.5875000
NODE_3261_length_1287_cov_29.186027	783	863	12	1	80	0.0125000
NODE_3261_length_1287_cov_29.186027	783	863	13	7	80	0.0875000
NODE_3261_length_1287_cov_29.186027	783	863	15	1	80	0.0125000
NODE_3262_length_1287_cov_22.747475	168	248	7	5	80	0.0625000
NODE_3262_length_1287_cov_22.747475	168	248	8	3	80	0.0375000
NODE_3262_length_1287_cov_22.747475	168	248	10	4	80	0.0500000
NODE_3262_length_1287_cov_22.747475	168	248	11	2	80	0.0250000
NODE_3262_length_1287_cov_22.747475	168	248	12	66	80	0.8250000
NODE_3262_length_1287_cov_22.747475	221	301	6	5	80	0.0625000
NODE_3262_length_1287_cov_22.747475	221	301	7	8	80	0.1000000
NODE_3262_length_1287_cov_22.747475	221	301	8	9	80	0.1125000
NODE_3262_length_1287_cov_22.747475	221	301	9	1	80	0.0125000
NODE_3262_length_1287_cov_22.747475	221	301	10	12	80	0.1500000
NODE_3262_length_1287_cov_22.747475	221	301	11	15	80	0.1875000
NODE_3262_length_1287_cov_22.747475	221	301	12	30	80	0.3750000
NODE_3263_length_1287_cov_19.478956	575	655	7	16	80	0.2000000
NODE_3263_length_1287_cov_19.478956	575	655	8	14	80	0.1750000
NODE_3263_length_1287_cov_19.478956	575	655	9	16	80	0.2000000
NODE_3263_length_1287_cov_19.478956	575	655	10	9	80	0.1125000
NODE_3263_length_1287_cov_19.478956	575	655	11	25	80	0.3125000
NODE_3263_length_1287_cov_19.478956	628	708	4	3	80	0.0375000
NODE_3263_length_1287_cov_19.478956	628	708	5	16	80	0.2000000
NODE_3263_length_1287_cov_19.478956	628	708	6	12	80	0.1500000
NODE_3263_length_1287_cov_19.478956	628	708	7	28	80	0.3500000
NODE_3263_length_1287_cov_19.478956	628	708	8	5	80	0.0625000
NODE_3263_length_1287_cov_19.478956	628	708	10	3	80	0.0375000
NODE_3263_length_1287_cov_19.478956	628	708	11	13	80	0.1625000
NODE_3266_length_1286_cov_27.128054	428	508	2	21	80	0.2625000
NODE_3266_length_1286_cov_27.128054	428	508	3	59	80	0.7375000
NODE_3266_length_1286_cov_27.128054	481	561	2	37	80	0.4625000
NODE_3266_length_1286_cov_27.128054	481	561	3	12	80	0.1500000
NODE_3266_length_1286_cov_27.128054	481	561	4	23	80	0.2875000
NODE_3266_length_1286_cov_27.128054	481	561	5	8	80	0.1000000
NODE_3266_length_1286_cov_27.128054	557	637	4	9	80	0.1125000
NODE_3266_length_1286_cov_27.128054	557	637	5	18	80	0.2250000
NODE_3266_length_1286_cov_27.128054	557	637	6	21	80	0.2625000
NODE_3266_length_1286_cov_27.128054	557	637	7	1	80	0.0125000
NODE_3266_length_1286_cov_27.128054	557	637	9	7	80	0.0875000
NODE_3266_length_1286_cov_27.128054	557	637	10	4	80	0.0500000
NODE_3266_length_1286_cov_27.128054	557	637	12	8	80	0.1000000
NODE_3266_length_1286_cov_27.128054	557	637	13	2	80	0.0250000
NODE_3266_length_1286_cov_27.128054	557	637	14	10	80	0.1250000
NODE_3266_length_1286_cov_27.128054	610	690	9	3	80	0.0375000
NODE_3266_length_1286_cov_27.128054	610	690	10	4	80	0.0500000
NODE_3266_length_1286_cov_27.128054	610	690	11	16	80	0.2000000
NODE_3266_length_1286_cov_27.128054	610	690	12	8	80	0.1000000
NODE_3266_length_1286_cov_27.128054	610	690	13	3	80	0.0375000
NODE_3266_length_1286_cov_27.128054	610	690	14	46	80	0.5750000
NODE_3267_length_1286_cov_12.192081	647	727	0	80	80	1.0000000
NODE_3267_length_1286_cov_12.192081	700	780	0	80	80	1.0000000
NODE_3267_length_1286_cov_12.192081	776	856	0	80	80	1.0000000
NODE_3267_length_1286_cov_12.192081	829	909	0	80	80	1.0000000
NODE_3268_length_1286_cov_8.338669	577	657	3	36	80	0.4500000
NODE_3268_length_1286_cov_8.338669	577	657	5	44	80	0.5500000
NODE_3268_length_1286_cov_8.338669	630	710	1	9	80	0.1125000
NODE_3268_length_1286_cov_8.338669	630	710	3	18	80	0.2250000
NODE_3268_length_1286_cov_8.338669	630	710	5	53	80	0.6625000
NODE_3273_length_1285_cov_40.282462	751	831	4	32	80	0.4000000
NODE_3273_length_1285_cov_40.282462	751	831	5	29	80	0.3625000
NODE_3273_length_1285_cov_40.282462	751	831	6	19	80	0.2375000
NODE_3273_length_1285_cov_40.282462	804	884	2	2	80	0.0250000
NODE_3273_length_1285_cov_40.282462	804	884	3	25	80	0.3125000
NODE_3273_length_1285_cov_40.282462	804	884	5	53	80	0.6625000
NODE_3274_length_1285_cov_15.422428	647	727	9	25	80	0.3125000
NODE_3274_length_1285_cov_15.422428	647	727	10	32	80	0.4000000
NODE_3274_length_1285_cov_15.422428	647	727	11	7	80	0.0875000
NODE_3274_length_1285_cov_15.422428	647	727	12	16	80	0.2000000
NODE_3274_length_1285_cov_15.422428	700	780	3	11	80	0.1375000
NODE_3274_length_1285_cov_15.422428	700	780	5	9	80	0.1125000
NODE_3274_length_1285_cov_15.422428	700	780	7	1	80	0.0125000
NODE_3274_length_1285_cov_15.422428	700	780	9	33	80	0.4125000
NODE_3274_length_1285_cov_15.422428	700	780	10	11	80	0.1375000
NODE_3274_length_1285_cov_15.422428	700	780	11	7	80	0.0875000
NODE_3274_length_1285_cov_15.422428	700	780	12	8	80	0.1000000
NODE_3275_length_1285_cov_6.620573	589	669	2	24	80	0.3000000
NODE_3275_length_1285_cov_6.620573	589	669	3	12	80	0.1500000
NODE_3275_length_1285_cov_6.620573	589	669	4	44	80	0.5500000
NODE_3275_length_1285_cov_6.620573	642	722	3	7	80	0.0875000
NODE_3275_length_1285_cov_6.620573	642	722	4	73	80	0.9125000
NODE_3279_length_1284_cov_5.637975	294	374	0	67	80	0.8375000
NODE_3279_length_1284_cov_5.637975	294	374	2	13	80	0.1625000
NODE_3279_length_1284_cov_5.637975	347	427	0	80	80	1.0000000
NODE_3283_length_1283_cov_10.070101	408	488	3	29	80	0.3625000
NODE_3283_length_1283_cov_10.070101	408	488	4	51	80	0.6375000
NODE_3283_length_1283_cov_10.070101	461	541	2	10	80	0.1250000
NODE_3283_length_1283_cov_10.070101	461	541	3	48	80	0.6000000
NODE_3283_length_1283_cov_10.070101	461	541	4	22	80	0.2750000
NODE_3288_length_1282_cov_37.786137	649	729	3	1	80	0.0125000
NODE_3288_length_1282_cov_37.786137	649	729	4	10	80	0.1250000
NODE_3288_length_1282_cov_37.786137	649	729	5	29	80	0.3625000
NODE_3288_length_1282_cov_37.786137	649	729	6	40	80	0.5000000
NODE_3288_length_1282_cov_37.786137	702	782	4	2	80	0.0250000
NODE_3288_length_1282_cov_37.786137	702	782	5	59	80	0.7375000
NODE_3288_length_1282_cov_37.786137	702	782	6	17	80	0.2125000
NODE_3288_length_1282_cov_37.786137	702	782	7	2	80	0.0250000
NODE_3288_length_1282_cov_37.786137	778	858	4	11	80	0.1375000
NODE_3288_length_1282_cov_37.786137	778	858	5	37	80	0.4625000
NODE_3288_length_1282_cov_37.786137	778	858	6	12	80	0.1500000
NODE_3288_length_1282_cov_37.786137	778	858	7	20	80	0.2500000
NODE_3288_length_1282_cov_37.786137	831	911	4	10	80	0.1250000
NODE_3288_length_1282_cov_37.786137	831	911	5	63	80	0.7875000
NODE_3288_length_1282_cov_37.786137	831	911	6	7	80	0.0875000
NODE_3289_length_1282_cov_25.900254	85	167	2	18	82	0.2195122
NODE_3289_length_1282_cov_25.900254	85	167	3	64	82	0.7804878
NODE_3289_length_1282_cov_25.900254	140	183	2	34	43	0.7906977
NODE_3289_length_1282_cov_25.900254	140	183	3	9	43	0.2093023
NODE_3289_length_1282_cov_25.900254	1006	1086	8	14	80	0.1750000
NODE_3289_length_1282_cov_25.900254	1006	1086	9	35	80	0.4375000
NODE_3289_length_1282_cov_25.900254	1006	1086	10	27	80	0.3375000
NODE_3289_length_1282_cov_25.900254	1006	1086	11	4	80	0.0500000
NODE_3289_length_1282_cov_25.900254	1006	1086	8	14	80	0.1750000
NODE_3289_length_1282_cov_25.900254	1006	1086	9	35	80	0.4375000
NODE_3289_length_1282_cov_25.900254	1006	1086	10	27	80	0.3375000
NODE_3289_length_1282_cov_25.900254	1006	1086	11	4	80	0.0500000
NODE_3289_length_1282_cov_25.900254	1015	1086	8	14	71	0.1971831
NODE_3289_length_1282_cov_25.900254	1015	1086	9	35	71	0.4929577
NODE_3289_length_1282_cov_25.900254	1015	1086	10	22	71	0.3098592
NODE_3290_length_1282_cov_14.600169	429	477	0	48	48	1.0000000
NODE_3290_length_1282_cov_14.600169	708	788	4	8	80	0.1000000
NODE_3290_length_1282_cov_14.600169	708	788	5	22	80	0.2750000
NODE_3290_length_1282_cov_14.600169	708	788	6	40	80	0.5000000
NODE_3290_length_1282_cov_14.600169	708	788	7	10	80	0.1250000
NODE_3291_length_1282_cov_8.017751	343	420	0	10	77	0.1298701
NODE_3291_length_1282_cov_8.017751	343	420	1	55	77	0.7142857
NODE_3291_length_1282_cov_8.017751	343	420	2	12	77	0.1558442
NODE_3292_length_1282_cov_5.092984	239	319	2	80	80	1.0000000
NODE_3292_length_1282_cov_5.092984	292	372	0	30	80	0.3750000
NODE_3292_length_1282_cov_5.092984	292	372	1	10	80	0.1250000
NODE_3292_length_1282_cov_5.092984	292	372	2	40	80	0.5000000
NODE_3295_length_1281_cov_31.342640	470	550	3	3	80	0.0375000
NODE_3295_length_1281_cov_31.342640	470	550	4	69	80	0.8625000
NODE_3295_length_1281_cov_31.342640	470	550	6	8	80	0.1000000
NODE_3295_length_1281_cov_31.342640	523	603	1	12	80	0.1500000
NODE_3295_length_1281_cov_31.342640	523	603	2	34	80	0.4250000
NODE_3295_length_1281_cov_31.342640	523	603	3	10	80	0.1250000
NODE_3295_length_1281_cov_31.342640	523	603	4	24	80	0.3000000
NODE_3295_length_1281_cov_31.342640	599	679	0	76	80	0.9500000
NODE_3295_length_1281_cov_31.342640	599	679	1	4	80	0.0500000
NODE_3295_length_1281_cov_31.342640	652	732	0	80	80	1.0000000
NODE_3296_length_1281_cov_25.482234	474	554	14	3	80	0.0375000
NODE_3296_length_1281_cov_25.482234	474	554	15	4	80	0.0500000
NODE_3296_length_1281_cov_25.482234	474	554	16	11	80	0.1375000
NODE_3296_length_1281_cov_25.482234	474	554	17	13	80	0.1625000
NODE_3296_length_1281_cov_25.482234	474	554	18	13	80	0.1625000
NODE_3296_length_1281_cov_25.482234	474	554	19	36	80	0.4500000
NODE_3296_length_1281_cov_25.482234	527	607	2	15	80	0.1875000
NODE_3296_length_1281_cov_25.482234	527	607	4	4	80	0.0500000
NODE_3296_length_1281_cov_25.482234	527	607	6	11	80	0.1375000
NODE_3296_length_1281_cov_25.482234	527	607	8	2	80	0.0250000
NODE_3296_length_1281_cov_25.482234	527	607	9	4	80	0.0500000
NODE_3296_length_1281_cov_25.482234	527	607	10	1	80	0.0125000
NODE_3296_length_1281_cov_25.482234	527	607	11	6	80	0.0750000
NODE_3296_length_1281_cov_25.482234	527	607	12	9	80	0.1125000
NODE_3296_length_1281_cov_25.482234	527	607	14	4	80	0.0500000
NODE_3296_length_1281_cov_25.482234	527	607	15	4	80	0.0500000
NODE_3296_length_1281_cov_25.482234	527	607	16	11	80	0.1375000
NODE_3296_length_1281_cov_25.482234	527	607	17	7	80	0.0875000
NODE_3296_length_1281_cov_25.482234	527	607	18	2	80	0.0250000
NODE_3297_length_1281_cov_14.617597	809	887	0	49	78	0.6282051
NODE_3297_length_1281_cov_14.617597	809	887	1	23	78	0.2948718
NODE_3297_length_1281_cov_14.617597	809	887	2	6	78	0.0769231
NODE_3297_length_1281_cov_14.617597	860	940	0	80	80	1.0000000
NODE_3298_length_1281_cov_12.065144	655	735	5	3	80	0.0375000
NODE_3298_length_1281_cov_12.065144	655	735	7	18	80	0.2250000
NODE_3298_length_1281_cov_12.065144	655	735	8	59	80	0.7375000
NODE_3298_length_1281_cov_12.065144	708	788	2	10	80	0.1250000
NODE_3298_length_1281_cov_12.065144	708	788	3	12	80	0.1500000
NODE_3298_length_1281_cov_12.065144	708	788	4	4	80	0.0500000
NODE_3298_length_1281_cov_12.065144	708	788	6	2	80	0.0250000
NODE_3298_length_1281_cov_12.065144	708	788	7	6	80	0.0750000
NODE_3298_length_1281_cov_12.065144	708	788	8	46	80	0.5750000
NODE_3299_length_1281_cov_9.235195	408	488	3	1	80	0.0125000
NODE_3299_length_1281_cov_9.235195	408	488	4	79	80	0.9875000
NODE_3299_length_1281_cov_9.235195	461	541	1	2	80	0.0250000
NODE_3299_length_1281_cov_9.235195	461	541	2	24	80	0.3000000
NODE_3299_length_1281_cov_9.235195	461	541	3	7	80	0.0875000
NODE_3299_length_1281_cov_9.235195	461	541	4	47	80	0.5875000
NODE_3300_length_1281_cov_7.153976	469	549	0	66	80	0.8250000
NODE_3300_length_1281_cov_7.153976	469	549	2	14	80	0.1750000
NODE_3300_length_1281_cov_7.153976	522	602	0	13	80	0.1625000
NODE_3300_length_1281_cov_7.153976	522	602	2	67	80	0.8375000
NODE_3307_length_1280_cov_24.231160	418	498	6	1	80	0.0125000
NODE_3307_length_1280_cov_24.231160	418	498	7	9	80	0.1125000
NODE_3307_length_1280_cov_24.231160	418	498	8	2	80	0.0250000
NODE_3307_length_1280_cov_24.231160	418	498	9	6	80	0.0750000
NODE_3307_length_1280_cov_24.231160	418	498	10	59	80	0.7375000
NODE_3307_length_1280_cov_24.231160	418	498	11	3	80	0.0375000
NODE_3307_length_1280_cov_24.231160	471	551	3	3	80	0.0375000
NODE_3307_length_1280_cov_24.231160	471	551	4	3	80	0.0375000
NODE_3307_length_1280_cov_24.231160	471	551	5	26	80	0.3250000
NODE_3307_length_1280_cov_24.231160	471	551	6	9	80	0.1125000
NODE_3307_length_1280_cov_24.231160	471	551	8	14	80	0.1750000
NODE_3307_length_1280_cov_24.231160	471	551	10	25	80	0.3125000
NODE_3307_length_1280_cov_24.231160	547	627	5	14	80	0.1750000
NODE_3307_length_1280_cov_24.231160	547	627	6	13	80	0.1625000
NODE_3307_length_1280_cov_24.231160	547	627	7	31	80	0.3875000
NODE_3307_length_1280_cov_24.231160	547	627	8	16	80	0.2000000
NODE_3307_length_1280_cov_24.231160	547	627	9	6	80	0.0750000
NODE_3307_length_1280_cov_24.231160	600	680	4	3	80	0.0375000
NODE_3307_length_1280_cov_24.231160	600	680	5	33	80	0.4125000
NODE_3307_length_1280_cov_24.231160	600	680	6	30	80	0.3750000
NODE_3307_length_1280_cov_24.231160	600	680	7	14	80	0.1750000
NODE_3308_length_1280_cov_5.908552	1077	1138	3	4	61	0.0655738
NODE_3308_length_1280_cov_5.908552	1077	1138	4	13	61	0.2131148
NODE_3308_length_1280_cov_5.908552	1077	1138	5	3	61	0.0491803
NODE_3308_length_1280_cov_5.908552	1077	1138	6	10	61	0.1639344
NODE_3308_length_1280_cov_5.908552	1077	1138	7	2	61	0.0327869
NODE_3308_length_1280_cov_5.908552	1077	1138	8	5	61	0.0819672
NODE_3308_length_1280_cov_5.908552	1077	1138	9	1	61	0.0163934
NODE_3308_length_1280_cov_5.908552	1077	1138	11	6	61	0.0983607
NODE_3308_length_1280_cov_5.908552	1077	1138	13	2	61	0.0327869
NODE_3308_length_1280_cov_5.908552	1077	1138	15	1	61	0.0163934
NODE_3308_length_1280_cov_5.908552	1077	1138	17	14	61	0.2295082
NODE_3311_length_1279_cov_16.840678	749	829	8	14	80	0.1750000
NODE_3311_length_1279_cov_16.840678	749	829	9	7	80	0.0875000
NODE_3311_length_1279_cov_16.840678	749	829	10	59	80	0.7375000
NODE_3311_length_1279_cov_16.840678	802	882	5	13	80	0.1625000
NODE_3311_length_1279_cov_16.840678	802	882	6	15	80	0.1875000
NODE_3311_length_1279_cov_16.840678	802	882	7	15	80	0.1875000
NODE_3311_length_1279_cov_16.840678	802	882	8	14	80	0.1750000
NODE_3311_length_1279_cov_16.840678	802	882	10	23	80	0.2875000
NODE_3312_length_1279_cov_3.772881	951	981	0	30	30	1.0000000
NODE_3317_length_1278_cov_45.991518	411	491	0	80	80	1.0000000
NODE_3317_length_1278_cov_45.991518	464	530	0	66	66	1.0000000
NODE_3318_length_1278_cov_37.164546	447	527	2	41	80	0.5125000
NODE_3318_length_1278_cov_37.164546	447	527	3	7	80	0.0875000
NODE_3318_length_1278_cov_37.164546	447	527	4	21	80	0.2625000
NODE_3318_length_1278_cov_37.164546	447	527	5	11	80	0.1375000
NODE_3318_length_1278_cov_37.164546	500	580	3	6	80	0.0750000
NODE_3318_length_1278_cov_37.164546	500	580	4	23	80	0.2875000
NODE_3318_length_1278_cov_37.164546	500	580	5	26	80	0.3250000
NODE_3318_length_1278_cov_37.164546	500	580	6	10	80	0.1250000
NODE_3318_length_1278_cov_37.164546	500	580	7	5	80	0.0625000
NODE_3318_length_1278_cov_37.164546	500	580	9	9	80	0.1125000
NODE_3318_length_1278_cov_37.164546	500	580	11	1	80	0.0125000
NODE_3318_length_1278_cov_37.164546	576	656	9	3	80	0.0375000
NODE_3318_length_1278_cov_37.164546	576	656	11	19	80	0.2375000
NODE_3318_length_1278_cov_37.164546	576	656	12	13	80	0.1625000
NODE_3318_length_1278_cov_37.164546	576	656	13	7	80	0.0875000
NODE_3318_length_1278_cov_37.164546	576	656	15	17	80	0.2125000
NODE_3318_length_1278_cov_37.164546	576	656	16	8	80	0.1000000
NODE_3318_length_1278_cov_37.164546	576	656	17	1	80	0.0125000
NODE_3318_length_1278_cov_37.164546	576	656	18	12	80	0.1500000
NODE_3318_length_1278_cov_37.164546	629	709	10	1	80	0.0125000
NODE_3318_length_1278_cov_37.164546	629	709	11	11	80	0.1375000
NODE_3318_length_1278_cov_37.164546	629	709	13	18	80	0.2250000
NODE_3318_length_1278_cov_37.164546	629	709	14	9	80	0.1125000
NODE_3318_length_1278_cov_37.164546	629	709	15	31	80	0.3875000
NODE_3318_length_1278_cov_37.164546	629	709	17	1	80	0.0125000
NODE_3318_length_1278_cov_37.164546	629	709	18	9	80	0.1125000
NODE_3319_length_1278_cov_12.505513	522	602	7	18	80	0.2250000
NODE_3319_length_1278_cov_12.505513	522	602	8	9	80	0.1125000
NODE_3319_length_1278_cov_12.505513	522	602	9	17	80	0.2125000
NODE_3319_length_1278_cov_12.505513	522	602	10	4	80	0.0500000
NODE_3319_length_1278_cov_12.505513	522	602	11	32	80	0.4000000
NODE_3319_length_1278_cov_12.505513	575	655	4	20	80	0.2500000
NODE_3319_length_1278_cov_12.505513	575	655	5	18	80	0.2250000
NODE_3319_length_1278_cov_12.505513	575	655	7	28	80	0.3500000
NODE_3319_length_1278_cov_12.505513	575	655	8	14	80	0.1750000
NODE_3320_length_1278_cov_12.171332	212	292	2	18	80	0.2250000
NODE_3320_length_1278_cov_12.171332	212	292	3	17	80	0.2125000
NODE_3320_length_1278_cov_12.171332	212	292	4	45	80	0.5625000
NODE_3320_length_1278_cov_12.171332	265	344	0	28	79	0.3544304
NODE_3320_length_1278_cov_12.171332	265	344	2	25	79	0.3164557
NODE_3320_length_1278_cov_12.171332	265	344	3	17	79	0.2151899
NODE_3320_length_1278_cov_12.171332	265	344	4	9	79	0.1139240
NODE_3329_length_1277_cov_21.407470	667	717	10	9	50	0.1800000
NODE_3329_length_1277_cov_21.407470	667	717	11	21	50	0.4200000
NODE_3329_length_1277_cov_21.407470	667	717	12	20	50	0.4000000
NODE_3329_length_1277_cov_21.407470	690	770	8	11	80	0.1375000
NODE_3329_length_1277_cov_21.407470	690	770	9	5	80	0.0625000
NODE_3329_length_1277_cov_21.407470	690	770	10	32	80	0.4000000
NODE_3329_length_1277_cov_21.407470	690	770	11	14	80	0.1750000
NODE_3329_length_1277_cov_21.407470	690	770	12	18	80	0.2250000
NODE_3330_length_1277_cov_18.111205	834	914	6	17	80	0.2125000
NODE_3330_length_1277_cov_18.111205	834	914	7	4	80	0.0500000
NODE_3330_length_1277_cov_18.111205	834	914	8	7	80	0.0875000
NODE_3330_length_1277_cov_18.111205	834	914	9	52	80	0.6500000
NODE_3330_length_1277_cov_18.111205	887	967	2	13	80	0.1625000
NODE_3330_length_1277_cov_18.111205	887	967	3	31	80	0.3875000
NODE_3330_length_1277_cov_18.111205	887	967	4	5	80	0.0625000
NODE_3330_length_1277_cov_18.111205	887	967	6	21	80	0.2625000
NODE_3330_length_1277_cov_18.111205	887	967	7	4	80	0.0500000
NODE_3330_length_1277_cov_18.111205	887	967	8	6	80	0.0750000
NODE_3331_length_1277_cov_12.449066	276	356	3	52	80	0.6500000
NODE_3331_length_1277_cov_12.449066	276	356	4	28	80	0.3500000
NODE_3331_length_1277_cov_12.449066	329	409	3	23	80	0.2875000
NODE_3331_length_1277_cov_12.449066	329	409	4	53	80	0.6625000
NODE_3331_length_1277_cov_12.449066	329	409	5	4	80	0.0500000
NODE_3331_length_1277_cov_12.449066	405	485	3	32	80	0.4000000
NODE_3331_length_1277_cov_12.449066	405	485	4	42	80	0.5250000
NODE_3331_length_1277_cov_12.449066	405	485	5	6	80	0.0750000
NODE_3331_length_1277_cov_12.449066	458	538	3	6	80	0.0750000
NODE_3331_length_1277_cov_12.449066	458	538	4	20	80	0.2500000
NODE_3331_length_1277_cov_12.449066	458	538	5	54	80	0.6750000
NODE_3337_length_1276_cov_21.446899	526	606	3	50	80	0.6250000
NODE_3337_length_1276_cov_21.446899	526	606	4	8	80	0.1000000
NODE_3337_length_1276_cov_21.446899	526	606	5	1	80	0.0125000
NODE_3337_length_1276_cov_21.446899	526	606	6	3	80	0.0375000
NODE_3337_length_1276_cov_21.446899	526	606	7	3	80	0.0375000
NODE_3337_length_1276_cov_21.446899	526	606	8	5	80	0.0625000
NODE_3337_length_1276_cov_21.446899	526	606	9	10	80	0.1250000
NODE_3337_length_1276_cov_21.446899	579	659	4	5	80	0.0625000
NODE_3337_length_1276_cov_21.446899	579	659	5	1	80	0.0125000
NODE_3337_length_1276_cov_21.446899	579	659	6	3	80	0.0375000
NODE_3337_length_1276_cov_21.446899	579	659	7	3	80	0.0375000
NODE_3337_length_1276_cov_21.446899	579	659	8	5	80	0.0625000
NODE_3337_length_1276_cov_21.446899	579	659	9	37	80	0.4625000
NODE_3337_length_1276_cov_21.446899	579	659	10	9	80	0.1125000
NODE_3337_length_1276_cov_21.446899	579	659	12	4	80	0.0500000
NODE_3337_length_1276_cov_21.446899	579	659	13	13	80	0.1625000
NODE_3337_length_1276_cov_21.446899	655	735	11	43	80	0.5375000
NODE_3337_length_1276_cov_21.446899	655	735	12	35	80	0.4375000
NODE_3337_length_1276_cov_21.446899	655	735	13	2	80	0.0250000
NODE_3337_length_1276_cov_21.446899	708	788	3	5	80	0.0625000
NODE_3337_length_1276_cov_21.446899	708	788	4	35	80	0.4375000
NODE_3337_length_1276_cov_21.446899	708	788	5	7	80	0.0875000
NODE_3337_length_1276_cov_21.446899	708	788	7	3	80	0.0375000
NODE_3337_length_1276_cov_21.446899	708	788	8	2	80	0.0250000
NODE_3337_length_1276_cov_21.446899	708	788	10	1	80	0.0125000
NODE_3337_length_1276_cov_21.446899	708	788	11	9	80	0.1125000
NODE_3337_length_1276_cov_21.446899	708	788	12	18	80	0.2250000
NODE_3346_length_1275_cov_35.471939	632	712	5	2	80	0.0250000
NODE_3346_length_1275_cov_35.471939	632	712	6	17	80	0.2125000
NODE_3346_length_1275_cov_35.471939	632	712	7	1	80	0.0125000
NODE_3346_length_1275_cov_35.471939	632	712	8	1	80	0.0125000
NODE_3346_length_1275_cov_35.471939	632	712	9	26	80	0.3250000
NODE_3346_length_1275_cov_35.471939	632	712	10	1	80	0.0125000
NODE_3346_length_1275_cov_35.471939	632	712	15	4	80	0.0500000
NODE_3346_length_1275_cov_35.471939	632	712	17	5	80	0.0625000
NODE_3346_length_1275_cov_35.471939	632	712	18	18	80	0.2250000
NODE_3346_length_1275_cov_35.471939	632	712	19	5	80	0.0625000
NODE_3346_length_1275_cov_35.471939	685	765	17	4	80	0.0500000
NODE_3346_length_1275_cov_35.471939	685	765	18	37	80	0.4625000
NODE_3346_length_1275_cov_35.471939	685	765	19	39	80	0.4875000
NODE_3347_length_1275_cov_19.910714	361	441	3	10	80	0.1250000
NODE_3347_length_1275_cov_19.910714	361	441	4	41	80	0.5125000
NODE_3347_length_1275_cov_19.910714	361	441	6	29	80	0.3625000
NODE_3347_length_1275_cov_19.910714	414	494	6	42	80	0.5250000
NODE_3347_length_1275_cov_19.910714	414	494	7	38	80	0.4750000
NODE_3347_length_1275_cov_19.910714	879	949	0	70	70	1.0000000
NODE_3351_length_1274_cov_23.404255	427	507	1	9	80	0.1125000
NODE_3351_length_1274_cov_23.404255	427	507	2	49	80	0.6125000
NODE_3351_length_1274_cov_23.404255	427	507	3	22	80	0.2750000
NODE_3351_length_1274_cov_23.404255	480	560	2	5	80	0.0625000
NODE_3351_length_1274_cov_23.404255	480	560	3	67	80	0.8375000
NODE_3351_length_1274_cov_23.404255	480	560	4	8	80	0.1000000
NODE_3351_length_1274_cov_23.404255	556	636	3	4	80	0.0500000
NODE_3351_length_1274_cov_23.404255	556	636	5	25	80	0.3125000
NODE_3351_length_1274_cov_23.404255	556	636	6	45	80	0.5625000
NODE_3351_length_1274_cov_23.404255	556	636	7	6	80	0.0750000
NODE_3351_length_1274_cov_23.404255	609	689	4	40	80	0.5000000
NODE_3351_length_1274_cov_23.404255	609	689	5	2	80	0.0250000
NODE_3351_length_1274_cov_23.404255	609	689	6	35	80	0.4375000
NODE_3351_length_1274_cov_23.404255	609	689	7	3	80	0.0375000
NODE_3352_length_1274_cov_20.178723	545	625	0	80	80	1.0000000
NODE_3352_length_1274_cov_20.178723	598	678	0	80	80	1.0000000
NODE_3354_length_1274_cov_2.019574	841	907	0	66	66	1.0000000
NODE_3354_length_1274_cov_2.019574	894	961	0	67	67	1.0000000
NODE_3361_length_1273_cov_42.349233	337	417	5	8	80	0.1000000
NODE_3361_length_1273_cov_42.349233	337	417	7	4	80	0.0500000
NODE_3361_length_1273_cov_42.349233	337	417	8	2	80	0.0250000
NODE_3361_length_1273_cov_42.349233	337	417	9	6	80	0.0750000
NODE_3361_length_1273_cov_42.349233	337	417	10	7	80	0.0875000
NODE_3361_length_1273_cov_42.349233	337	417	13	18	80	0.2250000
NODE_3361_length_1273_cov_42.349233	337	417	15	10	80	0.1250000
NODE_3361_length_1273_cov_42.349233	337	417	16	6	80	0.0750000
NODE_3361_length_1273_cov_42.349233	337	417	17	18	80	0.2250000
NODE_3361_length_1273_cov_42.349233	337	417	18	1	80	0.0125000
NODE_3361_length_1273_cov_42.349233	390	470	15	2	80	0.0250000
NODE_3361_length_1273_cov_42.349233	390	470	16	6	80	0.0750000
NODE_3361_length_1273_cov_42.349233	390	470	17	21	80	0.2625000
NODE_3361_length_1273_cov_42.349233	390	470	18	8	80	0.1000000
NODE_3361_length_1273_cov_42.349233	390	470	19	8	80	0.1000000
NODE_3361_length_1273_cov_42.349233	390	470	20	11	80	0.1375000
NODE_3361_length_1273_cov_42.349233	390	470	21	7	80	0.0875000
NODE_3361_length_1273_cov_42.349233	390	470	24	13	80	0.1625000
NODE_3361_length_1273_cov_42.349233	390	470	25	4	80	0.0500000
NODE_3361_length_1273_cov_42.349233	466	546	16	25	80	0.3125000
NODE_3361_length_1273_cov_42.349233	466	546	17	2	80	0.0250000
NODE_3361_length_1273_cov_42.349233	466	546	18	6	80	0.0750000
NODE_3361_length_1273_cov_42.349233	466	546	19	1	80	0.0125000
NODE_3361_length_1273_cov_42.349233	466	546	20	5	80	0.0625000
NODE_3361_length_1273_cov_42.349233	466	546	21	8	80	0.1000000
NODE_3361_length_1273_cov_42.349233	466	546	22	14	80	0.1750000
NODE_3361_length_1273_cov_42.349233	466	546	23	4	80	0.0500000
NODE_3361_length_1273_cov_42.349233	466	546	24	12	80	0.1500000
NODE_3361_length_1273_cov_42.349233	466	546	25	3	80	0.0375000
NODE_3361_length_1273_cov_42.349233	519	599	12	10	80	0.1250000
NODE_3361_length_1273_cov_42.349233	519	599	13	14	80	0.1750000
NODE_3361_length_1273_cov_42.349233	519	599	14	16	80	0.2000000
NODE_3361_length_1273_cov_42.349233	519	599	15	3	80	0.0375000
NODE_3361_length_1273_cov_42.349233	519	599	16	30	80	0.3750000
NODE_3361_length_1273_cov_42.349233	519	599	17	2	80	0.0250000
NODE_3361_length_1273_cov_42.349233	519	599	18	5	80	0.0625000
NODE_3364_length_1273_cov_4.404600	407	487	5	18	80	0.2250000
NODE_3364_length_1273_cov_4.404600	407	487	7	52	80	0.6500000
NODE_3364_length_1273_cov_4.404600	407	487	8	10	80	0.1250000
NODE_3364_length_1273_cov_4.404600	460	540	1	19	80	0.2375000
NODE_3364_length_1273_cov_4.404600	460	540	2	3	80	0.0375000
NODE_3364_length_1273_cov_4.404600	460	540	4	9	80	0.1125000
NODE_3364_length_1273_cov_4.404600	460	540	6	14	80	0.1750000
NODE_3364_length_1273_cov_4.404600	460	540	7	35	80	0.4375000
NODE_3368_length_1272_cov_28.887468	588	668	4	1	80	0.0125000
NODE_3368_length_1272_cov_28.887468	588	668	5	7	80	0.0875000
NODE_3368_length_1272_cov_28.887468	588	668	6	19	80	0.2375000
NODE_3368_length_1272_cov_28.887468	588	668	7	34	80	0.4250000
NODE_3368_length_1272_cov_28.887468	588	668	8	19	80	0.2375000
NODE_3368_length_1272_cov_28.887468	641	721	4	3	80	0.0375000
NODE_3368_length_1272_cov_28.887468	641	721	5	23	80	0.2875000
NODE_3368_length_1272_cov_28.887468	641	721	7	33	80	0.4125000
NODE_3368_length_1272_cov_28.887468	641	721	8	21	80	0.2625000
NODE_3369_length_1272_cov_11.290708	366	447	0	2	81	0.0246914
NODE_3369_length_1272_cov_11.290708	366	447	1	29	81	0.3580247
NODE_3369_length_1272_cov_11.290708	366	447	2	13	81	0.1604938
NODE_3369_length_1272_cov_11.290708	366	447	3	5	81	0.0617284
NODE_3369_length_1272_cov_11.290708	366	447	4	32	81	0.3950617
NODE_3375_length_1270_cov_13.617421	365	445	3	44	80	0.5500000
NODE_3375_length_1270_cov_13.617421	365	445	4	32	80	0.4000000
NODE_3375_length_1270_cov_13.617421	365	445	5	2	80	0.0250000
NODE_3375_length_1270_cov_13.617421	365	445	6	2	80	0.0250000
NODE_3375_length_1270_cov_13.617421	396	473	3	13	77	0.1688312
NODE_3375_length_1270_cov_13.617421	396	473	4	35	77	0.4545455
NODE_3375_length_1270_cov_13.617421	396	473	5	27	77	0.3506494
NODE_3375_length_1270_cov_13.617421	396	473	6	2	77	0.0259740
NODE_3375_length_1270_cov_13.617421	418	498	4	26	80	0.3250000
NODE_3375_length_1270_cov_13.617421	418	498	5	52	80	0.6500000
NODE_3375_length_1270_cov_13.617421	418	498	6	2	80	0.0250000
NODE_3375_length_1270_cov_13.617421	449	473	5	24	24	1.0000000
NODE_3375_length_1270_cov_13.617421	465	498	5	33	33	1.0000000
NODE_3376_length_1270_cov_11.645602	294	374	0	36	80	0.4500000
NODE_3376_length_1270_cov_11.645602	294	374	2	44	80	0.5500000
NODE_3376_length_1270_cov_11.645602	347	427	1	8	80	0.1000000
NODE_3376_length_1270_cov_11.645602	347	427	2	53	80	0.6625000
NODE_3376_length_1270_cov_11.645602	347	427	3	19	80	0.2375000
NODE_3377_length_1270_cov_2.495303	74	131	6	2	57	0.0350877
NODE_3377_length_1270_cov_2.495303	74	131	7	16	57	0.2807018
NODE_3377_length_1270_cov_2.495303	74	131	9	19	57	0.3333333
NODE_3377_length_1270_cov_2.495303	74	131	10	20	57	0.3508772
NODE_3378_length_1269_cov_55.070940	492	569	5	9	77	0.1168831
NODE_3378_length_1269_cov_55.070940	492	569	6	25	77	0.3246753
NODE_3378_length_1269_cov_55.070940	492	569	10	3	77	0.0389610
NODE_3378_length_1269_cov_55.070940	492	569	11	35	77	0.4545455
NODE_3378_length_1269_cov_55.070940	492	569	13	5	77	0.0649351
NODE_3378_length_1269_cov_55.070940	545	625	10	36	80	0.4500000
NODE_3378_length_1269_cov_55.070940	545	625	11	25	80	0.3125000
NODE_3378_length_1269_cov_55.070940	545	625	13	19	80	0.2375000
NODE_3378_length_1269_cov_55.070940	621	701	4	3	80	0.0375000
NODE_3378_length_1269_cov_55.070940	621	701	5	1	80	0.0125000
NODE_3378_length_1269_cov_55.070940	621	701	6	19	80	0.2375000
NODE_3378_length_1269_cov_55.070940	621	701	7	4	80	0.0500000
NODE_3378_length_1269_cov_55.070940	621	701	10	26	80	0.3250000
NODE_3378_length_1269_cov_55.070940	621	701	11	15	80	0.1875000
NODE_3378_length_1269_cov_55.070940	621	701	12	12	80	0.1500000
NODE_3378_length_1269_cov_55.070940	674	754	4	3	80	0.0375000
NODE_3378_length_1269_cov_55.070940	674	754	5	1	80	0.0125000
NODE_3378_length_1269_cov_55.070940	674	754	6	36	80	0.4500000
NODE_3378_length_1269_cov_55.070940	674	754	7	6	80	0.0750000
NODE_3378_length_1269_cov_55.070940	674	754	8	34	80	0.4250000
NODE_3379_length_1269_cov_22.154701	1152	1216	0	64	64	1.0000000
NODE_3379_length_1269_cov_22.154701	1152	1216	0	64	64	1.0000000
NODE_3379_length_1269_cov_22.154701	1152	1216	0	64	64	1.0000000
NODE_3379_length_1269_cov_22.154701	1189	1269	0	80	80	1.0000000
NODE_3379_length_1269_cov_22.154701	1189	1269	0	80	80	1.0000000
NODE_3380_length_1269_cov_18.753846	317	398	0	12	81	0.1481481
NODE_3380_length_1269_cov_18.753846	317	398	2	69	81	0.8518519
NODE_3381_length_1269_cov_12.637607	580	660	0	17	80	0.2125000
NODE_3381_length_1269_cov_12.637607	580	660	2	13	80	0.1625000
NODE_3381_length_1269_cov_12.637607	580	660	3	50	80	0.6250000
NODE_3381_length_1269_cov_12.637607	633	713	3	80	80	1.0000000
NODE_3381_length_1269_cov_12.637607	709	729	3	20	20	1.0000000
NODE_3381_length_1269_cov_12.637607	709	789	2	24	80	0.3000000
NODE_3381_length_1269_cov_12.637607	709	789	3	38	80	0.4750000
NODE_3381_length_1269_cov_12.637607	709	789	4	1	80	0.0125000
NODE_3381_length_1269_cov_12.637607	709	789	5	17	80	0.2125000
NODE_3381_length_1269_cov_12.637607	762	842	2	22	80	0.2750000
NODE_3381_length_1269_cov_12.637607	762	842	3	4	80	0.0500000
NODE_3381_length_1269_cov_12.637607	762	842	4	54	80	0.6750000
NODE_3382_length_1269_cov_10.552137	765	845	3	29	80	0.3625000
NODE_3382_length_1269_cov_10.552137	765	845	4	49	80	0.6125000
NODE_3382_length_1269_cov_10.552137	765	845	5	2	80	0.0250000
NODE_3382_length_1269_cov_10.552137	818	898	3	48	80	0.6000000
NODE_3382_length_1269_cov_10.552137	818	898	4	32	80	0.4000000
NODE_3391_length_1268_cov_12.862275	300	350	6	3	50	0.0600000
NODE_3391_length_1268_cov_12.862275	300	350	7	2	50	0.0400000
NODE_3391_length_1268_cov_12.862275	300	350	8	1	50	0.0200000
NODE_3391_length_1268_cov_12.862275	300	350	9	2	50	0.0400000
NODE_3391_length_1268_cov_12.862275	300	350	13	1	50	0.0200000
NODE_3391_length_1268_cov_12.862275	300	350	14	2	50	0.0400000
NODE_3391_length_1268_cov_12.862275	300	350	16	4	50	0.0800000
NODE_3391_length_1268_cov_12.862275	300	350	18	3	50	0.0600000
NODE_3391_length_1268_cov_12.862275	300	350	21	5	50	0.1000000
NODE_3391_length_1268_cov_12.862275	300	350	22	1	50	0.0200000
NODE_3391_length_1268_cov_12.862275	300	350	25	4	50	0.0800000
NODE_3391_length_1268_cov_12.862275	300	350	26	2	50	0.0400000
NODE_3391_length_1268_cov_12.862275	300	350	27	2	50	0.0400000
NODE_3391_length_1268_cov_12.862275	300	350	29	5	50	0.1000000
NODE_3391_length_1268_cov_12.862275	300	350	30	4	50	0.0800000
NODE_3391_length_1268_cov_12.862275	300	350	31	5	50	0.1000000
NODE_3391_length_1268_cov_12.862275	300	350	32	2	50	0.0400000
NODE_3391_length_1268_cov_12.862275	300	350	33	2	50	0.0400000
NODE_3392_length_1268_cov_9.523524	265	345	1	80	80	1.0000000
NODE_3392_length_1268_cov_9.523524	318	398	0	50	80	0.6250000
NODE_3392_length_1268_cov_9.523524	318	398	1	30	80	0.3750000
NODE_3393_length_1267_cov_21.315068	299	379	3	17	80	0.2125000
NODE_3393_length_1267_cov_21.315068	299	379	5	21	80	0.2625000
NODE_3393_length_1267_cov_21.315068	299	379	7	2	80	0.0250000
NODE_3393_length_1267_cov_21.315068	299	379	8	25	80	0.3125000
NODE_3393_length_1267_cov_21.315068	299	379	10	12	80	0.1500000
NODE_3393_length_1267_cov_21.315068	299	379	11	3	80	0.0375000
NODE_3393_length_1267_cov_21.315068	352	432	8	12	80	0.1500000
NODE_3393_length_1267_cov_21.315068	352	432	9	11	80	0.1375000
NODE_3393_length_1267_cov_21.315068	352	432	10	43	80	0.5375000
NODE_3393_length_1267_cov_21.315068	352	432	11	14	80	0.1750000
NODE_3393_length_1267_cov_21.315068	698	778	0	80	80	1.0000000
NODE_3393_length_1267_cov_21.315068	751	831	0	80	80	1.0000000
NODE_3394_length_1267_cov_14.880137	606	686	4	7	80	0.0875000
NODE_3394_length_1267_cov_14.880137	606	686	5	33	80	0.4125000
NODE_3394_length_1267_cov_14.880137	606	686	6	40	80	0.5000000
NODE_3394_length_1267_cov_14.880137	659	739	3	4	80	0.0500000
NODE_3394_length_1267_cov_14.880137	659	739	4	25	80	0.3125000
NODE_3394_length_1267_cov_14.880137	659	739	5	35	80	0.4375000
NODE_3394_length_1267_cov_14.880137	659	739	6	16	80	0.2000000
NODE_3397_length_1266_cov_20.584404	357	437	4	15	80	0.1875000
NODE_3397_length_1266_cov_20.584404	357	437	6	45	80	0.5625000
NODE_3397_length_1266_cov_20.584404	357	437	7	7	80	0.0875000
NODE_3397_length_1266_cov_20.584404	357	437	8	13	80	0.1625000
NODE_3397_length_1266_cov_20.584404	410	490	5	48	80	0.6000000
NODE_3397_length_1266_cov_20.584404	410	490	6	31	80	0.3875000
NODE_3397_length_1266_cov_20.584404	410	490	8	1	80	0.0125000
NODE_3398_length_1266_cov_16.571551	359	435	5	6	76	0.0789474
NODE_3398_length_1266_cov_16.571551	359	435	6	4	76	0.0526316
NODE_3398_length_1266_cov_16.571551	359	435	7	28	76	0.3684210
NODE_3398_length_1266_cov_16.571551	359	435	8	16	76	0.2105263
NODE_3398_length_1266_cov_16.571551	359	435	9	1	76	0.0131579
NODE_3398_length_1266_cov_16.571551	359	435	10	8	76	0.1052632
NODE_3398_length_1266_cov_16.571551	359	435	12	3	76	0.0394737
NODE_3398_length_1266_cov_16.571551	359	435	14	10	76	0.1315790
NODE_3398_length_1266_cov_16.571551	408	488	8	6	80	0.0750000
NODE_3398_length_1266_cov_16.571551	408	488	10	8	80	0.1000000
NODE_3398_length_1266_cov_16.571551	408	488	11	13	80	0.1625000
NODE_3398_length_1266_cov_16.571551	408	488	12	8	80	0.1000000
NODE_3398_length_1266_cov_16.571551	408	488	13	1	80	0.0125000
NODE_3398_length_1266_cov_16.571551	408	488	14	36	80	0.4500000
NODE_3398_length_1266_cov_16.571551	408	488	15	8	80	0.1000000
NODE_3399_length_1266_cov_14.218509	517	595	2	57	78	0.7307692
NODE_3399_length_1266_cov_14.218509	517	595	4	21	78	0.2692308
NODE_3399_length_1266_cov_14.218509	568	648	2	51	80	0.6375000
NODE_3399_length_1266_cov_14.218509	568	648	4	29	80	0.3625000
NODE_3399_length_1266_cov_14.218509	644	724	2	13	80	0.1625000
NODE_3399_length_1266_cov_14.218509	644	724	4	67	80	0.8375000
NODE_3399_length_1266_cov_14.218509	697	777	1	27	80	0.3375000
NODE_3399_length_1266_cov_14.218509	697	777	2	27	80	0.3375000
NODE_3399_length_1266_cov_14.218509	697	777	3	3	80	0.0375000
NODE_3399_length_1266_cov_14.218509	697	777	4	23	80	0.2875000
NODE_3403_length_1265_cov_9.807890	429	509	7	3	80	0.0375000
NODE_3403_length_1265_cov_9.807890	429	509	8	11	80	0.1375000
NODE_3403_length_1265_cov_9.807890	429	509	9	53	80	0.6625000
NODE_3403_length_1265_cov_9.807890	429	509	10	13	80	0.1625000
NODE_3403_length_1265_cov_9.807890	482	562	2	2	80	0.0250000
NODE_3403_length_1265_cov_9.807890	482	562	3	2	80	0.0250000
NODE_3403_length_1265_cov_9.807890	482	562	5	20	80	0.2500000
NODE_3403_length_1265_cov_9.807890	482	562	7	32	80	0.4000000
NODE_3403_length_1265_cov_9.807890	482	562	8	11	80	0.1375000
NODE_3403_length_1265_cov_9.807890	482	562	9	11	80	0.1375000
NODE_3403_length_1265_cov_9.807890	482	562	10	2	80	0.0250000
NODE_3404_length_1265_cov_8.233276	160	207	0	29	47	0.6170213
NODE_3404_length_1265_cov_8.233276	160	207	2	18	47	0.3829787
NODE_3404_length_1265_cov_8.233276	1004	1058	0	54	54	1.0000000
NODE_3406_length_1265_cov_3.941681	503	583	0	43	80	0.5375000
NODE_3406_length_1265_cov_3.941681	503	583	1	37	80	0.4625000
NODE_3406_length_1265_cov_3.941681	556	636	1	80	80	1.0000000
NODE_3408_length_1264_cov_8.024034	290	370	8	18	80	0.2250000
NODE_3408_length_1264_cov_8.024034	290	370	9	29	80	0.3625000
NODE_3408_length_1264_cov_8.024034	290	370	10	31	80	0.3875000
NODE_3408_length_1264_cov_8.024034	290	370	11	2	80	0.0250000
NODE_3408_length_1264_cov_8.024034	343	423	7	10	80	0.1250000
NODE_3408_length_1264_cov_8.024034	343	423	9	28	80	0.3500000
NODE_3408_length_1264_cov_8.024034	343	423	10	38	80	0.4750000
NODE_3408_length_1264_cov_8.024034	343	423	11	4	80	0.0500000
NODE_3413_length_1263_cov_8.566151	698	778	0	80	80	1.0000000
NODE_3413_length_1263_cov_8.566151	751	831	0	80	80	1.0000000
NODE_3413_length_1263_cov_8.566151	833	910	0	77	77	1.0000000
NODE_3413_length_1263_cov_8.566151	883	963	0	80	80	1.0000000
NODE_3414_length_1263_cov_7.376289	1060	1140	5	48	80	0.6000000
NODE_3414_length_1263_cov_7.376289	1060	1140	6	32	80	0.4000000
NODE_3414_length_1263_cov_7.376289	1113	1213	1	21	100	0.2100000
NODE_3414_length_1263_cov_7.376289	1113	1213	2	5	100	0.0500000
NODE_3414_length_1263_cov_7.376289	1113	1213	3	6	100	0.0600000
NODE_3414_length_1263_cov_7.376289	1113	1213	4	30	100	0.3000000
NODE_3414_length_1263_cov_7.376289	1113	1213	5	4	100	0.0400000
NODE_3414_length_1263_cov_7.376289	1113	1213	6	34	100	0.3400000
NODE_3416_length_1263_cov_1.827320	227	307	0	80	80	1.0000000
NODE_3416_length_1263_cov_1.827320	280	360	0	80	80	1.0000000
NODE_3418_length_1262_cov_17.416165	404	484	7	22	80	0.2750000
NODE_3418_length_1262_cov_17.416165	404	484	8	30	80	0.3750000
NODE_3418_length_1262_cov_17.416165	404	484	9	24	80	0.3000000
NODE_3418_length_1262_cov_17.416165	404	484	10	4	80	0.0500000
NODE_3418_length_1262_cov_17.416165	457	537	4	2	80	0.0250000
NODE_3418_length_1262_cov_17.416165	457	537	5	31	80	0.3875000
NODE_3418_length_1262_cov_17.416165	457	537	6	16	80	0.2000000
NODE_3418_length_1262_cov_17.416165	457	537	7	10	80	0.1250000
NODE_3418_length_1262_cov_17.416165	457	537	8	21	80	0.2625000
NODE_3419_length_1262_cov_15.268272	648	728	9	12	80	0.1500000
NODE_3419_length_1262_cov_15.268272	648	728	10	9	80	0.1125000
NODE_3419_length_1262_cov_15.268272	648	728	11	21	80	0.2625000
NODE_3419_length_1262_cov_15.268272	648	728	12	12	80	0.1500000
NODE_3419_length_1262_cov_15.268272	648	728	13	4	80	0.0500000
NODE_3419_length_1262_cov_15.268272	648	728	14	22	80	0.2750000
NODE_3419_length_1262_cov_15.268272	701	781	9	7	80	0.0875000
NODE_3419_length_1262_cov_15.268272	701	781	10	16	80	0.2000000
NODE_3419_length_1262_cov_15.268272	701	781	11	6	80	0.0750000
NODE_3419_length_1262_cov_15.268272	701	781	12	5	80	0.0625000
NODE_3419_length_1262_cov_15.268272	701	781	13	4	80	0.0500000
NODE_3419_length_1262_cov_15.268272	701	781	14	42	80	0.5250000
NODE_3419_length_1262_cov_15.268272	777	857	4	1	80	0.0125000
NODE_3419_length_1262_cov_15.268272	777	857	6	30	80	0.3750000
NODE_3419_length_1262_cov_15.268272	777	857	7	13	80	0.1625000
NODE_3419_length_1262_cov_15.268272	777	857	8	6	80	0.0750000
NODE_3419_length_1262_cov_15.268272	777	857	9	20	80	0.2500000
NODE_3419_length_1262_cov_15.268272	777	857	10	10	80	0.1250000
NODE_3419_length_1262_cov_15.268272	830	910	3	1	80	0.0125000
NODE_3419_length_1262_cov_15.268272	830	910	4	47	80	0.5875000
NODE_3419_length_1262_cov_15.268272	830	910	6	32	80	0.4000000
NODE_3424_length_1261_cov_1.777969	272	318	0	46	46	1.0000000
NODE_3425_length_1260_cov_55.640827	499	579	4	2	80	0.0250000
NODE_3425_length_1260_cov_55.640827	499	579	5	18	80	0.2250000
NODE_3425_length_1260_cov_55.640827	499	579	6	55	80	0.6875000
NODE_3425_length_1260_cov_55.640827	499	579	7	5	80	0.0625000
NODE_3425_length_1260_cov_55.640827	552	632	4	25	80	0.3125000
NODE_3425_length_1260_cov_55.640827	552	632	5	31	80	0.3875000
NODE_3425_length_1260_cov_55.640827	552	632	6	12	80	0.1500000
NODE_3425_length_1260_cov_55.640827	552	632	7	3	80	0.0375000
NODE_3425_length_1260_cov_55.640827	552	632	9	2	80	0.0250000
NODE_3425_length_1260_cov_55.640827	552	632	11	1	80	0.0125000
NODE_3425_length_1260_cov_55.640827	552	632	12	5	80	0.0625000
NODE_3425_length_1260_cov_55.640827	552	632	13	1	80	0.0125000
NODE_3425_length_1260_cov_55.640827	628	708	11	26	80	0.3250000
NODE_3425_length_1260_cov_55.640827	628	708	12	53	80	0.6625000
NODE_3425_length_1260_cov_55.640827	628	708	13	1	80	0.0125000
NODE_3425_length_1260_cov_55.640827	681	761	11	27	80	0.3375000
NODE_3425_length_1260_cov_55.640827	681	761	12	36	80	0.4500000
NODE_3425_length_1260_cov_55.640827	681	761	13	11	80	0.1375000
NODE_3425_length_1260_cov_55.640827	681	761	15	6	80	0.0750000
NODE_3426_length_1260_cov_12.242894	427	507	3	24	80	0.3000000
NODE_3426_length_1260_cov_12.242894	427	507	6	19	80	0.2375000
NODE_3426_length_1260_cov_12.242894	427	507	7	37	80	0.4625000
NODE_3426_length_1260_cov_12.242894	480	560	0	12	80	0.1500000
NODE_3426_length_1260_cov_12.242894	480	560	4	13	80	0.1625000
NODE_3426_length_1260_cov_12.242894	480	560	5	2	80	0.0250000
NODE_3426_length_1260_cov_12.242894	480	560	6	45	80	0.5625000
NODE_3426_length_1260_cov_12.242894	480	560	7	8	80	0.1000000
NODE_3436_length_1259_cov_15.381897	509	589	0	28	80	0.3500000
NODE_3436_length_1259_cov_15.381897	509	589	1	52	80	0.6500000
NODE_3436_length_1259_cov_15.381897	562	642	1	55	80	0.6875000
NODE_3436_length_1259_cov_15.381897	562	642	3	11	80	0.1375000
NODE_3436_length_1259_cov_15.381897	562	642	6	14	80	0.1750000
NODE_3439_length_1258_cov_33.519413	608	688	7	27	80	0.3375000
NODE_3439_length_1258_cov_33.519413	608	688	9	32	80	0.4000000
NODE_3439_length_1258_cov_33.519413	608	688	10	9	80	0.1125000
NODE_3439_length_1258_cov_33.519413	608	688	11	9	80	0.1125000
NODE_3439_length_1258_cov_33.519413	608	688	12	3	80	0.0375000
NODE_3439_length_1258_cov_33.519413	661	741	5	8	80	0.1000000
NODE_3439_length_1258_cov_33.519413	661	741	7	6	80	0.0750000
NODE_3439_length_1258_cov_33.519413	661	741	9	9	80	0.1125000
NODE_3439_length_1258_cov_33.519413	661	741	10	9	80	0.1125000
NODE_3439_length_1258_cov_33.519413	661	741	11	15	80	0.1875000
NODE_3439_length_1258_cov_33.519413	661	741	12	6	80	0.0750000
NODE_3439_length_1258_cov_33.519413	661	741	13	27	80	0.3375000
NODE_3440_length_1258_cov_22.569456	583	663	8	20	80	0.2500000
NODE_3440_length_1258_cov_22.569456	583	663	9	17	80	0.2125000
NODE_3440_length_1258_cov_22.569456	583	663	10	43	80	0.5375000
NODE_3440_length_1258_cov_22.569456	636	716	4	7	80	0.0875000
NODE_3440_length_1258_cov_22.569456	636	716	5	15	80	0.1875000
NODE_3440_length_1258_cov_22.569456	636	716	6	5	80	0.0625000
NODE_3440_length_1258_cov_22.569456	636	716	7	3	80	0.0375000
NODE_3440_length_1258_cov_22.569456	636	716	9	29	80	0.3625000
NODE_3440_length_1258_cov_22.569456	636	716	10	21	80	0.2625000
NODE_3441_length_1258_cov_18.747196	308	388	2	3	80	0.0375000
NODE_3441_length_1258_cov_18.747196	308	388	3	9	80	0.1125000
NODE_3441_length_1258_cov_18.747196	308	388	4	9	80	0.1125000
NODE_3441_length_1258_cov_18.747196	308	388	5	4	80	0.0500000
NODE_3441_length_1258_cov_18.747196	308	388	7	4	80	0.0500000
NODE_3441_length_1258_cov_18.747196	308	388	8	51	80	0.6375000
NODE_3441_length_1258_cov_18.747196	361	441	6	25	80	0.3125000
NODE_3441_length_1258_cov_18.747196	361	441	8	50	80	0.6250000
NODE_3441_length_1258_cov_18.747196	361	441	10	5	80	0.0625000
NODE_3441_length_1258_cov_18.747196	437	517	0	8	80	0.1000000
NODE_3441_length_1258_cov_18.747196	437	517	2	22	80	0.2750000
NODE_3441_length_1258_cov_18.747196	437	517	3	8	80	0.1000000
NODE_3441_length_1258_cov_18.747196	437	517	4	9	80	0.1125000
NODE_3441_length_1258_cov_18.747196	437	517	5	9	80	0.1125000
NODE_3441_length_1258_cov_18.747196	437	517	6	24	80	0.3000000
NODE_3441_length_1258_cov_18.747196	490	570	0	61	80	0.7625000
NODE_3441_length_1258_cov_18.747196	490	570	2	19	80	0.2375000
NODE_3442_length_1258_cov_13.699741	332	412	5	12	80	0.1500000
NODE_3442_length_1258_cov_13.699741	332	412	6	26	80	0.3250000
NODE_3442_length_1258_cov_13.699741	332	412	7	19	80	0.2375000
NODE_3442_length_1258_cov_13.699741	332	412	8	23	80	0.2875000
NODE_3442_length_1258_cov_13.699741	385	465	3	7	80	0.0875000
NODE_3442_length_1258_cov_13.699741	385	465	4	10	80	0.1250000
NODE_3442_length_1258_cov_13.699741	385	465	5	22	80	0.2750000
NODE_3442_length_1258_cov_13.699741	385	465	7	27	80	0.3375000
NODE_3442_length_1258_cov_13.699741	385	465	8	14	80	0.1750000
NODE_3447_length_1257_cov_34.029361	567	647	5	13	80	0.1625000
NODE_3447_length_1257_cov_34.029361	567	647	6	56	80	0.7000000
NODE_3447_length_1257_cov_34.029361	567	647	7	4	80	0.0500000
NODE_3447_length_1257_cov_34.029361	567	647	9	7	80	0.0875000
NODE_3447_length_1257_cov_34.029361	620	700	5	1	80	0.0125000
NODE_3447_length_1257_cov_34.029361	620	700	6	15	80	0.1875000
NODE_3447_length_1257_cov_34.029361	620	700	7	21	80	0.2625000
NODE_3447_length_1257_cov_34.029361	620	700	8	7	80	0.0875000
NODE_3447_length_1257_cov_34.029361	620	700	9	17	80	0.2125000
NODE_3447_length_1257_cov_34.029361	620	700	10	9	80	0.1125000
NODE_3447_length_1257_cov_34.029361	620	700	11	10	80	0.1250000
NODE_3447_length_1257_cov_34.029361	696	776	11	9	80	0.1125000
NODE_3447_length_1257_cov_34.029361	696	776	13	4	80	0.0500000
NODE_3447_length_1257_cov_34.029361	696	776	14	13	80	0.1625000
NODE_3447_length_1257_cov_34.029361	696	776	16	13	80	0.1625000
NODE_3447_length_1257_cov_34.029361	696	776	17	5	80	0.0625000
NODE_3447_length_1257_cov_34.029361	696	776	18	5	80	0.0625000
NODE_3447_length_1257_cov_34.029361	696	776	19	4	80	0.0500000
NODE_3447_length_1257_cov_34.029361	696	776	20	2	80	0.0250000
NODE_3447_length_1257_cov_34.029361	696	776	21	19	80	0.2375000
NODE_3447_length_1257_cov_34.029361	696	776	22	6	80	0.0750000
NODE_3447_length_1257_cov_34.029361	749	829	12	2	80	0.0250000
NODE_3447_length_1257_cov_34.029361	749	829	13	6	80	0.0750000
NODE_3447_length_1257_cov_34.029361	749	829	14	1	80	0.0125000
NODE_3447_length_1257_cov_34.029361	749	829	16	6	80	0.0750000
NODE_3447_length_1257_cov_34.029361	749	829	17	29	80	0.3625000
NODE_3447_length_1257_cov_34.029361	749	829	18	2	80	0.0250000
NODE_3447_length_1257_cov_34.029361	749	829	20	3	80	0.0375000
NODE_3447_length_1257_cov_34.029361	749	829	21	19	80	0.2375000
NODE_3447_length_1257_cov_34.029361	749	829	22	12	80	0.1500000
NODE_3449_length_1257_cov_7.892919	317	397	0	80	80	1.0000000
NODE_3449_length_1257_cov_7.892919	370	450	0	80	80	1.0000000
NODE_3452_length_1256_cov_50.506482	389	469	0	8	80	0.1000000
NODE_3452_length_1256_cov_50.506482	389	469	1	3	80	0.0375000
NODE_3452_length_1256_cov_50.506482	389	469	3	4	80	0.0500000
NODE_3452_length_1256_cov_50.506482	389	469	4	21	80	0.2625000
NODE_3452_length_1256_cov_50.506482	389	469	5	4	80	0.0500000
NODE_3452_length_1256_cov_50.506482	389	469	7	6	80	0.0750000
NODE_3452_length_1256_cov_50.506482	389	469	9	4	80	0.0500000
NODE_3452_length_1256_cov_50.506482	389	469	10	17	80	0.2125000
NODE_3452_length_1256_cov_50.506482	389	469	13	7	80	0.0875000
NODE_3452_length_1256_cov_50.506482	389	469	14	6	80	0.0750000
NODE_3452_length_1256_cov_50.506482	442	522	10	14	80	0.1750000
NODE_3452_length_1256_cov_50.506482	442	522	13	7	80	0.0875000
NODE_3452_length_1256_cov_50.506482	442	522	14	15	80	0.1875000
NODE_3452_length_1256_cov_50.506482	442	522	15	1	80	0.0125000
NODE_3452_length_1256_cov_50.506482	442	522	16	6	80	0.0750000
NODE_3452_length_1256_cov_50.506482	442	522	17	2	80	0.0250000
NODE_3452_length_1256_cov_50.506482	442	522	18	2	80	0.0250000
NODE_3452_length_1256_cov_50.506482	442	522	20	30	80	0.3750000
NODE_3452_length_1256_cov_50.506482	442	522	21	3	80	0.0375000
NODE_3452_length_1256_cov_50.506482	518	598	17	2	80	0.0250000
NODE_3452_length_1256_cov_50.506482	518	598	18	10	80	0.1250000
NODE_3452_length_1256_cov_50.506482	518	598	19	16	80	0.2000000
NODE_3452_length_1256_cov_50.506482	518	598	20	3	80	0.0375000
NODE_3452_length_1256_cov_50.506482	518	598	21	8	80	0.1000000
NODE_3452_length_1256_cov_50.506482	518	598	22	17	80	0.2125000
NODE_3452_length_1256_cov_50.506482	518	598	23	21	80	0.2625000
NODE_3452_length_1256_cov_50.506482	518	598	24	3	80	0.0375000
NODE_3452_length_1256_cov_50.506482	571	651	12	14	80	0.1750000
NODE_3452_length_1256_cov_50.506482	571	651	13	2	80	0.0250000
NODE_3452_length_1256_cov_50.506482	571	651	14	6	80	0.0750000
NODE_3452_length_1256_cov_50.506482	571	651	15	2	80	0.0250000
NODE_3452_length_1256_cov_50.506482	571	651	16	2	80	0.0250000
NODE_3452_length_1256_cov_50.506482	571	651	17	20	80	0.2500000
NODE_3452_length_1256_cov_50.506482	571	651	18	19	80	0.2375000
NODE_3452_length_1256_cov_50.506482	571	651	19	8	80	0.1000000
NODE_3452_length_1256_cov_50.506482	571	651	20	2	80	0.0250000
NODE_3452_length_1256_cov_50.506482	571	651	22	1	80	0.0125000
NODE_3452_length_1256_cov_50.506482	571	651	23	4	80	0.0500000
NODE_3453_length_1256_cov_25.944685	754	834	4	15	80	0.1875000
NODE_3453_length_1256_cov_25.944685	754	834	6	33	80	0.4125000
NODE_3453_length_1256_cov_25.944685	754	834	7	10	80	0.1250000
NODE_3453_length_1256_cov_25.944685	754	834	8	22	80	0.2750000
NODE_3453_length_1256_cov_25.944685	807	887	2	13	80	0.1625000
NODE_3453_length_1256_cov_25.944685	807	887	4	10	80	0.1250000
NODE_3453_length_1256_cov_25.944685	807	887	6	25	80	0.3125000
NODE_3453_length_1256_cov_25.944685	807	887	7	11	80	0.1375000
NODE_3453_length_1256_cov_25.944685	807	887	8	21	80	0.2625000
NODE_3455_length_1256_cov_21.720830	713	793	7	24	80	0.3000000
NODE_3455_length_1256_cov_21.720830	713	793	8	16	80	0.2000000
NODE_3455_length_1256_cov_21.720830	713	793	9	35	80	0.4375000
NODE_3455_length_1256_cov_21.720830	713	793	10	5	80	0.0625000
NODE_3455_length_1256_cov_21.720830	766	846	6	3	80	0.0375000
NODE_3455_length_1256_cov_21.720830	766	846	8	48	80	0.6000000
NODE_3455_length_1256_cov_21.720830	766	846	9	29	80	0.3625000
NODE_3456_length_1256_cov_14.242005	595	675	6	12	80	0.1500000
NODE_3456_length_1256_cov_14.242005	595	675	8	11	80	0.1375000
NODE_3456_length_1256_cov_14.242005	595	675	9	1	80	0.0125000
NODE_3456_length_1256_cov_14.242005	595	675	10	56	80	0.7000000
NODE_3456_length_1256_cov_14.242005	648	728	5	3	80	0.0375000
NODE_3456_length_1256_cov_14.242005	648	728	6	62	80	0.7750000
NODE_3456_length_1256_cov_14.242005	648	728	8	11	80	0.1375000
NODE_3456_length_1256_cov_14.242005	648	728	10	4	80	0.0500000
NODE_3457_length_1256_cov_5.870354	879	959	0	27	80	0.3375000
NODE_3457_length_1256_cov_5.870354	879	959	1	53	80	0.6625000
NODE_3463_length_1255_cov_37.271626	458	538	1	6	80	0.0750000
NODE_3463_length_1255_cov_37.271626	458	538	2	32	80	0.4000000
NODE_3463_length_1255_cov_37.271626	458	538	4	9	80	0.1125000
NODE_3463_length_1255_cov_37.271626	458	538	6	33	80	0.4125000
NODE_3463_length_1255_cov_37.271626	511	591	6	36	80	0.4500000
NODE_3463_length_1255_cov_37.271626	511	591	7	1	80	0.0125000
NODE_3463_length_1255_cov_37.271626	511	591	9	15	80	0.1875000
NODE_3463_length_1255_cov_37.271626	511	591	10	23	80	0.2875000
NODE_3463_length_1255_cov_37.271626	511	591	11	5	80	0.0625000
NODE_3463_length_1255_cov_37.271626	587	667	7	20	80	0.2500000
NODE_3463_length_1255_cov_37.271626	587	667	9	20	80	0.2500000
NODE_3463_length_1255_cov_37.271626	587	667	10	40	80	0.5000000
NODE_3463_length_1255_cov_37.271626	640	720	1	5	80	0.0625000
NODE_3463_length_1255_cov_37.271626	640	720	2	8	80	0.1000000
NODE_3463_length_1255_cov_37.271626	640	720	3	15	80	0.1875000
NODE_3463_length_1255_cov_37.271626	640	720	4	3	80	0.0375000
NODE_3463_length_1255_cov_37.271626	640	720	5	15	80	0.1875000
NODE_3463_length_1255_cov_37.271626	640	720	7	27	80	0.3375000
NODE_3463_length_1255_cov_37.271626	640	720	9	7	80	0.0875000
NODE_3464_length_1255_cov_21.374567	516	596	4	27	80	0.3375000
NODE_3464_length_1255_cov_21.374567	516	596	6	8	80	0.1000000
NODE_3464_length_1255_cov_21.374567	516	596	8	5	80	0.0625000
NODE_3464_length_1255_cov_21.374567	516	596	9	32	80	0.4000000
NODE_3464_length_1255_cov_21.374567	516	596	10	8	80	0.1000000
NODE_3464_length_1255_cov_21.374567	569	649	7	4	80	0.0500000
NODE_3464_length_1255_cov_21.374567	569	649	8	12	80	0.1500000
NODE_3464_length_1255_cov_21.374567	569	649	9	39	80	0.4875000
NODE_3464_length_1255_cov_21.374567	569	649	10	25	80	0.3125000
NODE_3464_length_1255_cov_21.374567	645	725	4	21	80	0.2625000
NODE_3464_length_1255_cov_21.374567	645	725	5	13	80	0.1625000
NODE_3464_length_1255_cov_21.374567	645	725	6	30	80	0.3750000
NODE_3464_length_1255_cov_21.374567	645	725	8	16	80	0.2000000
NODE_3464_length_1255_cov_21.374567	698	778	4	23	80	0.2875000
NODE_3464_length_1255_cov_21.374567	698	778	5	49	80	0.6125000
NODE_3464_length_1255_cov_21.374567	698	778	6	8	80	0.1000000
NODE_3465_length_1255_cov_18.391869	521	601	5	34	80	0.4250000
NODE_3465_length_1255_cov_18.391869	521	601	6	36	80	0.4500000
NODE_3465_length_1255_cov_18.391869	521	601	7	8	80	0.1000000
NODE_3465_length_1255_cov_18.391869	521	601	8	2	80	0.0250000
NODE_3465_length_1255_cov_18.391869	574	654	2	17	80	0.2125000
NODE_3465_length_1255_cov_18.391869	574	654	4	26	80	0.3250000
NODE_3465_length_1255_cov_18.391869	574	654	5	22	80	0.2750000
NODE_3465_length_1255_cov_18.391869	574	654	6	15	80	0.1875000
NODE_3466_length_1255_cov_4.096021	1194	1242	0	48	48	1.0000000
NODE_3469_length_1254_cov_32.470996	612	692	6	19	80	0.2375000
NODE_3469_length_1254_cov_32.470996	612	692	7	12	80	0.1500000
NODE_3469_length_1254_cov_32.470996	612	692	8	49	80	0.6125000
NODE_3469_length_1254_cov_32.470996	665	745	2	12	80	0.1500000
NODE_3469_length_1254_cov_32.470996	665	745	3	16	80	0.2000000
NODE_3469_length_1254_cov_32.470996	665	745	4	2	80	0.0250000
NODE_3469_length_1254_cov_32.470996	665	745	6	18	80	0.2250000
NODE_3469_length_1254_cov_32.470996	665	745	7	1	80	0.0125000
NODE_3469_length_1254_cov_32.470996	665	745	8	31	80	0.3875000
NODE_3470_length_1254_cov_26.449351	488	568	15	12	80	0.1500000
NODE_3470_length_1254_cov_26.449351	488	568	16	11	80	0.1375000
NODE_3470_length_1254_cov_26.449351	488	568	17	1	80	0.0125000
NODE_3470_length_1254_cov_26.449351	488	568	18	4	80	0.0500000
NODE_3470_length_1254_cov_26.449351	488	568	19	19	80	0.2375000
NODE_3470_length_1254_cov_26.449351	488	568	20	23	80	0.2875000
NODE_3470_length_1254_cov_26.449351	488	568	21	10	80	0.1250000
NODE_3470_length_1254_cov_26.449351	541	621	10	26	80	0.3250000
NODE_3470_length_1254_cov_26.449351	541	621	13	9	80	0.1125000
NODE_3470_length_1254_cov_26.449351	541	621	15	3	80	0.0375000
NODE_3470_length_1254_cov_26.449351	541	621	16	7	80	0.0875000
NODE_3470_length_1254_cov_26.449351	541	621	17	3	80	0.0375000
NODE_3470_length_1254_cov_26.449351	541	621	18	2	80	0.0250000
NODE_3470_length_1254_cov_26.449351	541	621	19	4	80	0.0500000
NODE_3470_length_1254_cov_26.449351	541	621	20	16	80	0.2000000
NODE_3470_length_1254_cov_26.449351	541	621	21	10	80	0.1250000
NODE_3471_length_1254_cov_22.032035	531	611	6	25	80	0.3125000
NODE_3471_length_1254_cov_22.032035	531	611	7	1	80	0.0125000
NODE_3471_length_1254_cov_22.032035	531	611	8	17	80	0.2125000
NODE_3471_length_1254_cov_22.032035	531	611	11	1	80	0.0125000
NODE_3471_length_1254_cov_22.032035	531	611	12	2	80	0.0250000
NODE_3471_length_1254_cov_22.032035	531	611	13	7	80	0.0875000
NODE_3471_length_1254_cov_22.032035	531	611	15	9	80	0.1125000
NODE_3471_length_1254_cov_22.032035	531	611	16	7	80	0.0875000
NODE_3471_length_1254_cov_22.032035	531	611	18	11	80	0.1375000
NODE_3471_length_1254_cov_22.032035	584	664	15	9	80	0.1125000
NODE_3471_length_1254_cov_22.032035	584	664	16	7	80	0.0875000
NODE_3471_length_1254_cov_22.032035	584	664	17	8	80	0.1000000
NODE_3471_length_1254_cov_22.032035	584	664	18	17	80	0.2125000
NODE_3471_length_1254_cov_22.032035	584	664	20	39	80	0.4875000
NODE_3479_length_1253_cov_16.916811	651	731	1	35	80	0.4375000
NODE_3479_length_1253_cov_16.916811	651	731	2	19	80	0.2375000
NODE_3479_length_1253_cov_16.916811	651	731	3	26	80	0.3250000
NODE_3479_length_1253_cov_16.916811	704	784	1	53	80	0.6625000
NODE_3479_length_1253_cov_16.916811	704	784	2	17	80	0.2125000
NODE_3479_length_1253_cov_16.916811	704	784	4	10	80	0.1250000
NODE_3479_length_1253_cov_16.916811	780	860	3	30	80	0.3750000
NODE_3479_length_1253_cov_16.916811	780	860	4	50	80	0.6250000
NODE_3479_length_1253_cov_16.916811	833	913	1	15	80	0.1875000
NODE_3479_length_1253_cov_16.916811	833	913	2	1	80	0.0125000
NODE_3479_length_1253_cov_16.916811	833	913	3	64	80	0.8000000
NODE_3480_length_1253_cov_13.816291	811	891	0	12	80	0.1500000
NODE_3480_length_1253_cov_13.816291	811	891	2	68	80	0.8500000
NODE_3481_length_1253_cov_9.067591	306	386	0	80	80	1.0000000
NODE_3481_length_1253_cov_9.067591	359	439	0	80	80	1.0000000
NODE_3487_length_1252_cov_57.745880	477	557	4	36	80	0.4500000
NODE_3487_length_1252_cov_57.745880	477	557	5	5	80	0.0625000
NODE_3487_length_1252_cov_57.745880	477	557	6	5	80	0.0625000
NODE_3487_length_1252_cov_57.745880	477	557	7	6	80	0.0750000
NODE_3487_length_1252_cov_57.745880	477	557	8	5	80	0.0625000
NODE_3487_length_1252_cov_57.745880	477	557	9	23	80	0.2875000
NODE_3487_length_1252_cov_57.745880	530	610	8	4	80	0.0500000
NODE_3487_length_1252_cov_57.745880	530	610	9	44	80	0.5500000
NODE_3487_length_1252_cov_57.745880	530	610	10	6	80	0.0750000
NODE_3487_length_1252_cov_57.745880	530	610	11	7	80	0.0875000
NODE_3487_length_1252_cov_57.745880	530	610	13	2	80	0.0250000
NODE_3487_length_1252_cov_57.745880	530	610	14	5	80	0.0625000
NODE_3487_length_1252_cov_57.745880	530	610	15	12	80	0.1500000
NODE_3487_length_1252_cov_57.745880	606	686	10	2	80	0.0250000
NODE_3487_length_1252_cov_57.745880	606	686	11	15	80	0.1875000
NODE_3487_length_1252_cov_57.745880	606	686	13	42	80	0.5250000
NODE_3487_length_1252_cov_57.745880	606	686	14	21	80	0.2625000
NODE_3487_length_1252_cov_57.745880	659	739	5	6	80	0.0750000
NODE_3487_length_1252_cov_57.745880	659	739	6	5	80	0.0625000
NODE_3487_length_1252_cov_57.745880	659	739	8	1	80	0.0125000
NODE_3487_length_1252_cov_57.745880	659	739	9	20	80	0.2500000
NODE_3487_length_1252_cov_57.745880	659	739	10	2	80	0.0250000
NODE_3487_length_1252_cov_57.745880	659	739	11	27	80	0.3375000
NODE_3487_length_1252_cov_57.745880	659	739	13	10	80	0.1250000
NODE_3487_length_1252_cov_57.745880	659	739	14	9	80	0.1125000
NODE_3488_length_1252_cov_56.694709	594	674	5	9	80	0.1125000
NODE_3488_length_1252_cov_56.694709	594	674	6	13	80	0.1625000
NODE_3488_length_1252_cov_56.694709	594	674	7	28	80	0.3500000
NODE_3488_length_1252_cov_56.694709	594	674	8	27	80	0.3375000
NODE_3488_length_1252_cov_56.694709	594	674	9	3	80	0.0375000
NODE_3488_length_1252_cov_56.694709	647	727	6	5	80	0.0625000
NODE_3488_length_1252_cov_56.694709	647	727	7	62	80	0.7750000
NODE_3488_length_1252_cov_56.694709	647	727	8	13	80	0.1625000
NODE_3488_length_1252_cov_56.694709	723	803	4	13	80	0.1625000
NODE_3488_length_1252_cov_56.694709	723	803	5	30	80	0.3750000
NODE_3488_length_1252_cov_56.694709	723	803	6	1	80	0.0125000
NODE_3488_length_1252_cov_56.694709	723	803	7	16	80	0.2000000
NODE_3488_length_1252_cov_56.694709	723	803	8	10	80	0.1250000
NODE_3488_length_1252_cov_56.694709	723	803	9	10	80	0.1250000
NODE_3488_length_1252_cov_56.694709	785	847	4	20	62	0.3225806
NODE_3488_length_1252_cov_56.694709	785	847	5	5	62	0.0806452
NODE_3488_length_1252_cov_56.694709	785	847	6	3	62	0.0483871
NODE_3488_length_1252_cov_56.694709	785	847	7	34	62	0.5483871
NODE_3489_length_1252_cov_34.023417	468	548	9	7	80	0.0875000
NODE_3489_length_1252_cov_34.023417	468	548	10	33	80	0.4125000
NODE_3489_length_1252_cov_34.023417	468	548	11	8	80	0.1000000
NODE_3489_length_1252_cov_34.023417	468	548	12	10	80	0.1250000
NODE_3489_length_1252_cov_34.023417	468	548	13	3	80	0.0375000
NODE_3489_length_1252_cov_34.023417	468	548	14	9	80	0.1125000
NODE_3489_length_1252_cov_34.023417	468	548	15	2	80	0.0250000
NODE_3489_length_1252_cov_34.023417	468	548	17	8	80	0.1000000
NODE_3489_length_1252_cov_34.023417	521	601	12	5	80	0.0625000
NODE_3489_length_1252_cov_34.023417	521	601	13	3	80	0.0375000
NODE_3489_length_1252_cov_34.023417	521	601	14	9	80	0.1125000
NODE_3489_length_1252_cov_34.023417	521	601	15	18	80	0.2250000
NODE_3489_length_1252_cov_34.023417	521	601	16	11	80	0.1375000
NODE_3489_length_1252_cov_34.023417	521	601	17	32	80	0.4000000
NODE_3489_length_1252_cov_34.023417	521	601	19	2	80	0.0250000
NODE_3489_length_1252_cov_34.023417	597	677	9	3	80	0.0375000
NODE_3489_length_1252_cov_34.023417	597	677	11	4	80	0.0500000
NODE_3489_length_1252_cov_34.023417	597	677	12	10	80	0.1250000
NODE_3489_length_1252_cov_34.023417	597	677	14	5	80	0.0625000
NODE_3489_length_1252_cov_34.023417	597	677	15	28	80	0.3500000
NODE_3489_length_1252_cov_34.023417	597	677	16	1	80	0.0125000
NODE_3489_length_1252_cov_34.023417	597	677	17	28	80	0.3500000
NODE_3489_length_1252_cov_34.023417	597	677	19	1	80	0.0125000
NODE_3489_length_1252_cov_34.023417	650	730	3	1	80	0.0125000
NODE_3489_length_1252_cov_34.023417	650	730	4	28	80	0.3500000
NODE_3489_length_1252_cov_34.023417	650	730	5	11	80	0.1375000
NODE_3489_length_1252_cov_34.023417	650	730	7	2	80	0.0250000
NODE_3489_length_1252_cov_34.023417	650	730	8	3	80	0.0375000
NODE_3489_length_1252_cov_34.023417	650	730	9	11	80	0.1375000
NODE_3489_length_1252_cov_34.023417	650	730	11	4	80	0.0500000
NODE_3489_length_1252_cov_34.023417	650	730	12	10	80	0.1250000
NODE_3489_length_1252_cov_34.023417	650	730	14	5	80	0.0625000
NODE_3489_length_1252_cov_34.023417	650	730	15	5	80	0.0625000
NODE_3490_length_1252_cov_9.316565	573	653	1	9	80	0.1125000
NODE_3490_length_1252_cov_9.316565	573	653	2	20	80	0.2500000
NODE_3490_length_1252_cov_9.316565	573	653	3	33	80	0.4125000
NODE_3490_length_1252_cov_9.316565	573	653	4	18	80	0.2250000
NODE_3490_length_1252_cov_9.316565	626	706	3	9	80	0.1125000
NODE_3490_length_1252_cov_9.316565	626	706	4	40	80	0.5000000
NODE_3490_length_1252_cov_9.316565	626	706	5	25	80	0.3125000
NODE_3490_length_1252_cov_9.316565	626	706	6	6	80	0.0750000
NODE_3491_length_1252_cov_8.295750	602	682	4	80	80	1.0000000
NODE_3491_length_1252_cov_8.295750	655	735	0	8	80	0.1000000
NODE_3491_length_1252_cov_8.295750	655	735	1	23	80	0.2875000
NODE_3491_length_1252_cov_8.295750	655	735	2	10	80	0.1250000
NODE_3491_length_1252_cov_8.295750	655	735	4	39	80	0.4875000
NODE_3494_length_1251_cov_17.513889	579	659	4	22	80	0.2750000
NODE_3494_length_1251_cov_17.513889	579	659	5	29	80	0.3625000
NODE_3494_length_1251_cov_17.513889	579	659	7	11	80	0.1375000
NODE_3494_length_1251_cov_17.513889	579	659	8	18	80	0.2250000
NODE_3494_length_1251_cov_17.513889	632	712	6	10	80	0.1250000
NODE_3494_length_1251_cov_17.513889	632	712	7	9	80	0.1125000
NODE_3494_length_1251_cov_17.513889	632	712	8	51	80	0.6375000
NODE_3494_length_1251_cov_17.513889	632	712	10	10	80	0.1250000
NODE_3494_length_1251_cov_17.513889	708	788	4	37	80	0.4625000
NODE_3494_length_1251_cov_17.513889	708	788	5	12	80	0.1500000
NODE_3494_length_1251_cov_17.513889	708	788	6	19	80	0.2375000
NODE_3494_length_1251_cov_17.513889	708	788	7	12	80	0.1500000
NODE_3494_length_1251_cov_17.513889	761	841	0	5	80	0.0625000
NODE_3494_length_1251_cov_17.513889	761	841	2	22	80	0.2750000
NODE_3494_length_1251_cov_17.513889	761	841	3	23	80	0.2875000
NODE_3494_length_1251_cov_17.513889	761	841	4	30	80	0.3750000
NODE_3497_length_1251_cov_3.139757	0	76	0	76	76	1.0000000
NODE_3497_length_1251_cov_3.139757	49	98	0	49	49	1.0000000
NODE_3501_length_1250_cov_25.133797	325	405	0	16	80	0.2000000
NODE_3501_length_1250_cov_25.133797	325	405	2	64	80	0.8000000
NODE_3501_length_1250_cov_25.133797	378	458	0	20	80	0.2500000
NODE_3501_length_1250_cov_25.133797	378	458	2	60	80	0.7500000
NODE_3503_length_1250_cov_11.471764	652	733	5	5	81	0.0617284
NODE_3503_length_1250_cov_11.471764	652	733	6	17	81	0.2098765
NODE_3503_length_1250_cov_11.471764	652	733	7	39	81	0.4814815
NODE_3503_length_1250_cov_11.471764	652	733	8	20	81	0.2469136
NODE_3503_length_1250_cov_11.471764	706	786	0	5	80	0.0625000
NODE_3503_length_1250_cov_11.471764	706	786	1	27	80	0.3375000
NODE_3503_length_1250_cov_11.471764	706	786	3	7	80	0.0875000
NODE_3503_length_1250_cov_11.471764	706	786	5	19	80	0.2375000
NODE_3503_length_1250_cov_11.471764	706	786	7	22	80	0.2750000
NODE_3505_length_1249_cov_45.772174	543	623	6	60	80	0.7500000
NODE_3505_length_1249_cov_45.772174	543	623	7	4	80	0.0500000
NODE_3505_length_1249_cov_45.772174	543	623	8	16	80	0.2000000
NODE_3505_length_1249_cov_45.772174	596	676	5	1	80	0.0125000
NODE_3505_length_1249_cov_45.772174	596	676	6	62	80	0.7750000
NODE_3505_length_1249_cov_45.772174	596	676	7	7	80	0.0875000
NODE_3505_length_1249_cov_45.772174	596	676	8	5	80	0.0625000
NODE_3505_length_1249_cov_45.772174	596	676	11	3	80	0.0375000
NODE_3505_length_1249_cov_45.772174	596	676	12	2	80	0.0250000
NODE_3505_length_1249_cov_45.772174	672	749	11	2	77	0.0259740
NODE_3505_length_1249_cov_45.772174	672	749	12	6	77	0.0779221
NODE_3505_length_1249_cov_45.772174	672	749	13	5	77	0.0649351
NODE_3505_length_1249_cov_45.772174	672	749	15	6	77	0.0779221
NODE_3505_length_1249_cov_45.772174	672	749	16	22	77	0.2857143
NODE_3505_length_1249_cov_45.772174	672	749	18	16	77	0.2077922
NODE_3505_length_1249_cov_45.772174	672	749	20	3	77	0.0389610
NODE_3505_length_1249_cov_45.772174	672	749	21	7	77	0.0909091
NODE_3505_length_1249_cov_45.772174	672	749	22	10	77	0.1298701
NODE_3505_length_1249_cov_45.772174	729	802	20	3	73	0.0410959
NODE_3505_length_1249_cov_45.772174	729	802	21	8	73	0.1095890
NODE_3505_length_1249_cov_45.772174	729	802	22	44	73	0.6027398
NODE_3505_length_1249_cov_45.772174	729	802	23	8	73	0.1095890
NODE_3505_length_1249_cov_45.772174	729	802	24	8	73	0.1095890
NODE_3505_length_1249_cov_45.772174	729	802	25	2	73	0.0273973
NODE_3506_length_1249_cov_35.670435	515	595	5	1	80	0.0125000
NODE_3506_length_1249_cov_35.670435	515	595	6	10	80	0.1250000
NODE_3506_length_1249_cov_35.670435	515	595	7	1	80	0.0125000
NODE_3506_length_1249_cov_35.670435	515	595	8	45	80	0.5625000
NODE_3506_length_1249_cov_35.670435	515	595	9	23	80	0.2875000
NODE_3506_length_1249_cov_35.670435	568	648	3	8	80	0.1000000
NODE_3506_length_1249_cov_35.670435	568	648	4	21	80	0.2625000
NODE_3506_length_1249_cov_35.670435	568	648	5	25	80	0.3125000
NODE_3506_length_1249_cov_35.670435	568	648	6	10	80	0.1250000
NODE_3506_length_1249_cov_35.670435	568	648	7	1	80	0.0125000
NODE_3506_length_1249_cov_35.670435	568	648	9	15	80	0.1875000
NODE_3506_length_1249_cov_35.670435	644	724	2	14	80	0.1750000
NODE_3506_length_1249_cov_35.670435	644	724	3	52	80	0.6500000
NODE_3506_length_1249_cov_35.670435	644	724	4	14	80	0.1750000
NODE_3506_length_1249_cov_35.670435	697	777	2	67	80	0.8375000
NODE_3506_length_1249_cov_35.670435	697	777	3	13	80	0.1625000
NODE_3507_length_1249_cov_34.616522	576	656	7	16	80	0.2000000
NODE_3507_length_1249_cov_34.616522	576	656	8	20	80	0.2500000
NODE_3507_length_1249_cov_34.616522	576	656	9	42	80	0.5250000
NODE_3507_length_1249_cov_34.616522	576	656	10	2	80	0.0250000
NODE_3507_length_1249_cov_34.616522	629	709	1	20	80	0.2500000
NODE_3507_length_1249_cov_34.616522	629	709	2	1	80	0.0125000
NODE_3507_length_1249_cov_34.616522	629	709	3	16	80	0.2000000
NODE_3507_length_1249_cov_34.616522	629	709	5	12	80	0.1500000
NODE_3507_length_1249_cov_34.616522	629	709	7	20	80	0.2500000
NODE_3507_length_1249_cov_34.616522	629	709	8	11	80	0.1375000
NODE_3507_length_1249_cov_34.616522	705	785	0	45	80	0.5625000
NODE_3507_length_1249_cov_34.616522	705	785	1	35	80	0.4375000
NODE_3507_length_1249_cov_34.616522	758	838	0	41	80	0.5125000
NODE_3507_length_1249_cov_34.616522	758	838	2	36	80	0.4500000
NODE_3507_length_1249_cov_34.616522	758	838	4	3	80	0.0375000
NODE_3508_length_1249_cov_19.592174	461	541	0	3	80	0.0375000
NODE_3508_length_1249_cov_19.592174	461	541	2	77	80	0.9625000
NODE_3508_length_1249_cov_19.592174	514	594	2	80	80	1.0000000
NODE_3508_length_1249_cov_19.592174	860	940	0	3	80	0.0375000
NODE_3508_length_1249_cov_19.592174	860	940	1	10	80	0.1250000
NODE_3508_length_1249_cov_19.592174	860	940	2	67	80	0.8375000
NODE_3508_length_1249_cov_19.592174	913	993	2	80	80	1.0000000
NODE_3509_length_1249_cov_14.926957	1153	1219	0	66	66	1.0000000
NODE_3509_length_1249_cov_14.926957	1192	1249	0	57	57	1.0000000
NODE_3509_length_1249_cov_14.926957	1192	1247	0	55	55	1.0000000
NODE_3509_length_1249_cov_14.926957	1192	1249	0	57	57	1.0000000
NODE_3510_length_1249_cov_7.682609	757	837	2	30	80	0.3750000
NODE_3510_length_1249_cov_7.682609	757	837	3	50	80	0.6250000
NODE_3510_length_1249_cov_7.682609	810	890	2	67	80	0.8375000
NODE_3510_length_1249_cov_7.682609	810	890	3	13	80	0.1625000
NODE_3514_length_1248_cov_14.351610	469	549	3	7	80	0.0875000
NODE_3514_length_1248_cov_14.351610	469	549	4	33	80	0.4125000
NODE_3514_length_1248_cov_14.351610	469	549	5	40	80	0.5000000
NODE_3514_length_1248_cov_14.351610	522	602	2	21	80	0.2625000
NODE_3514_length_1248_cov_14.351610	522	602	3	12	80	0.1500000
NODE_3514_length_1248_cov_14.351610	522	602	4	47	80	0.5875000
NODE_3514_length_1248_cov_14.351610	598	678	2	56	80	0.7000000
NODE_3514_length_1248_cov_14.351610	598	678	4	24	80	0.3000000
NODE_3514_length_1248_cov_14.351610	651	731	1	3	80	0.0375000
NODE_3514_length_1248_cov_14.351610	651	731	2	52	80	0.6500000
NODE_3514_length_1248_cov_14.351610	651	731	3	25	80	0.3125000
NODE_3515_length_1248_cov_11.181027	303	383	0	18	80	0.2250000
NODE_3515_length_1248_cov_11.181027	303	383	2	62	80	0.7750000
NODE_3515_length_1248_cov_11.181027	356	436	2	27	80	0.3375000
NODE_3515_length_1248_cov_11.181027	356	436	3	51	80	0.6375000
NODE_3515_length_1248_cov_11.181027	356	436	5	2	80	0.0250000
NODE_3515_length_1248_cov_11.181027	432	512	3	2	80	0.0250000
NODE_3515_length_1248_cov_11.181027	432	512	5	33	80	0.4125000
NODE_3515_length_1248_cov_11.181027	432	512	7	27	80	0.3375000
NODE_3515_length_1248_cov_11.181027	432	512	8	18	80	0.2250000
NODE_3515_length_1248_cov_11.181027	485	565	7	41	80	0.5125000
NODE_3515_length_1248_cov_11.181027	485	565	8	39	80	0.4875000
NODE_3516_length_1248_cov_4.372498	17	98	0	81	81	1.0000000
NODE_3516_length_1248_cov_4.372498	94	152	0	58	58	1.0000000
NODE_3517_length_1248_cov_2.356832	952	1032	1	53	80	0.6625000
NODE_3517_length_1248_cov_2.356832	952	1032	2	27	80	0.3375000
NODE_3517_length_1248_cov_2.356832	1005	1085	0	26	80	0.3250000
NODE_3517_length_1248_cov_2.356832	1005	1085	1	54	80	0.6750000
NODE_3518_length_1248_cov_2.283725	1102	1151	0	49	49	1.0000000
NODE_3522_length_1247_cov_25.355401	487	567	0	8	80	0.1000000
NODE_3522_length_1247_cov_25.355401	487	567	1	72	80	0.9000000
NODE_3522_length_1247_cov_25.355401	540	620	1	34	80	0.4250000
NODE_3522_length_1247_cov_25.355401	540	620	2	14	80	0.1750000
NODE_3522_length_1247_cov_25.355401	540	620	3	20	80	0.2500000
NODE_3522_length_1247_cov_25.355401	540	620	4	2	80	0.0250000
NODE_3522_length_1247_cov_25.355401	540	620	5	10	80	0.1250000
NODE_3522_length_1247_cov_25.355401	616	696	5	4	80	0.0500000
NODE_3522_length_1247_cov_25.355401	616	696	6	37	80	0.4625000
NODE_3522_length_1247_cov_25.355401	616	696	7	30	80	0.3750000
NODE_3522_length_1247_cov_25.355401	616	696	8	9	80	0.1125000
NODE_3522_length_1247_cov_25.355401	669	749	5	11	80	0.1375000
NODE_3522_length_1247_cov_25.355401	669	749	6	21	80	0.2625000
NODE_3522_length_1247_cov_25.355401	669	749	7	11	80	0.1375000
NODE_3522_length_1247_cov_25.355401	669	749	8	37	80	0.4625000
NODE_3528_length_1246_cov_30.231909	433	513	3	38	80	0.4750000
NODE_3528_length_1246_cov_30.231909	433	513	5	16	80	0.2000000
NODE_3528_length_1246_cov_30.231909	433	513	6	11	80	0.1375000
NODE_3528_length_1246_cov_30.231909	433	513	7	12	80	0.1500000
NODE_3528_length_1246_cov_30.231909	433	513	8	3	80	0.0375000
NODE_3528_length_1246_cov_30.231909	486	566	5	13	80	0.1625000
NODE_3528_length_1246_cov_30.231909	486	566	6	11	80	0.1375000
NODE_3528_length_1246_cov_30.231909	486	566	7	37	80	0.4625000
NODE_3528_length_1246_cov_30.231909	486	566	8	11	80	0.1375000
NODE_3528_length_1246_cov_30.231909	486	566	9	8	80	0.1000000
NODE_3528_length_1246_cov_30.231909	562	642	5	2	80	0.0250000
NODE_3528_length_1246_cov_30.231909	562	642	7	38	80	0.4750000
NODE_3528_length_1246_cov_30.231909	562	642	8	39	80	0.4875000
NODE_3528_length_1246_cov_30.231909	562	642	9	1	80	0.0125000
NODE_3528_length_1246_cov_30.231909	615	695	4	1	80	0.0125000
NODE_3528_length_1246_cov_30.231909	615	695	5	4	80	0.0500000
NODE_3528_length_1246_cov_30.231909	615	695	6	28	80	0.3500000
NODE_3528_length_1246_cov_30.231909	615	695	7	4	80	0.0500000
NODE_3528_length_1246_cov_30.231909	615	695	8	34	80	0.4250000
NODE_3528_length_1246_cov_30.231909	615	695	9	9	80	0.1125000
NODE_3529_length_1246_cov_13.847428	497	577	5	9	80	0.1125000
NODE_3529_length_1246_cov_13.847428	497	577	6	65	80	0.8125000
NODE_3529_length_1246_cov_13.847428	497	577	7	6	80	0.0750000
NODE_3529_length_1246_cov_13.847428	550	630	2	35	80	0.4375000
NODE_3529_length_1246_cov_13.847428	550	630	4	12	80	0.1500000
NODE_3529_length_1246_cov_13.847428	550	630	6	33	80	0.4125000
NODE_3535_length_1245_cov_31.472949	443	523	21	7	80	0.0875000
NODE_3535_length_1245_cov_31.472949	443	523	23	7	80	0.0875000
NODE_3535_length_1245_cov_31.472949	443	523	24	6	80	0.0750000
NODE_3535_length_1245_cov_31.472949	443	523	25	8	80	0.1000000
NODE_3535_length_1245_cov_31.472949	443	523	26	7	80	0.0875000
NODE_3535_length_1245_cov_31.472949	443	523	29	3	80	0.0375000
NODE_3535_length_1245_cov_31.472949	443	523	30	20	80	0.2500000
NODE_3535_length_1245_cov_31.472949	443	523	31	15	80	0.1875000
NODE_3535_length_1245_cov_31.472949	443	523	32	7	80	0.0875000
NODE_3535_length_1245_cov_31.472949	496	576	10	1	80	0.0125000
NODE_3535_length_1245_cov_31.472949	496	576	12	3	80	0.0375000
NODE_3535_length_1245_cov_31.472949	496	576	13	5	80	0.0625000
NODE_3535_length_1245_cov_31.472949	496	576	14	10	80	0.1250000
NODE_3535_length_1245_cov_31.472949	496	576	15	4	80	0.0500000
NODE_3535_length_1245_cov_31.472949	496	576	16	1	80	0.0125000
NODE_3535_length_1245_cov_31.472949	496	576	18	5	80	0.0625000
NODE_3535_length_1245_cov_31.472949	496	576	19	3	80	0.0375000
NODE_3535_length_1245_cov_31.472949	496	576	21	5	80	0.0625000
NODE_3535_length_1245_cov_31.472949	496	576	25	3	80	0.0375000
NODE_3535_length_1245_cov_31.472949	496	576	26	4	80	0.0500000
NODE_3535_length_1245_cov_31.472949	496	576	27	1	80	0.0125000
NODE_3535_length_1245_cov_31.472949	496	576	29	6	80	0.0750000
NODE_3535_length_1245_cov_31.472949	496	576	30	5	80	0.0625000
NODE_3535_length_1245_cov_31.472949	496	576	31	17	80	0.2125000
NODE_3535_length_1245_cov_31.472949	496	576	32	7	80	0.0875000
NODE_3536_length_1245_cov_30.068935	771	841	0	70	70	1.0000000
NODE_3537_length_1245_cov_24.765271	668	748	3	27	80	0.3375000
NODE_3537_length_1245_cov_24.765271	668	748	5	19	80	0.2375000
NODE_3537_length_1245_cov_24.765271	668	748	6	29	80	0.3625000
NODE_3537_length_1245_cov_24.765271	668	748	7	4	80	0.0500000
NODE_3537_length_1245_cov_24.765271	668	748	8	1	80	0.0125000
NODE_3537_length_1245_cov_24.765271	721	801	6	22	80	0.2750000
NODE_3537_length_1245_cov_24.765271	721	801	7	4	80	0.0500000
NODE_3537_length_1245_cov_24.765271	721	801	8	5	80	0.0625000
NODE_3537_length_1245_cov_24.765271	721	801	9	19	80	0.2375000
NODE_3537_length_1245_cov_24.765271	721	801	11	5	80	0.0625000
NODE_3537_length_1245_cov_24.765271	721	801	12	1	80	0.0125000
NODE_3537_length_1245_cov_24.765271	721	801	13	7	80	0.0875000
NODE_3537_length_1245_cov_24.765271	721	801	14	8	80	0.1000000
NODE_3537_length_1245_cov_24.765271	721	801	16	6	80	0.0750000
NODE_3537_length_1245_cov_24.765271	721	801	17	3	80	0.0375000
NODE_3537_length_1245_cov_24.765271	797	877	14	18	80	0.2250000
NODE_3537_length_1245_cov_24.765271	797	877	15	2	80	0.0250000
NODE_3537_length_1245_cov_24.765271	797	877	16	12	80	0.1500000
NODE_3537_length_1245_cov_24.765271	797	877	17	6	80	0.0750000
NODE_3537_length_1245_cov_24.765271	797	877	19	6	80	0.0750000
NODE_3537_length_1245_cov_24.765271	797	877	20	4	80	0.0500000
NODE_3537_length_1245_cov_24.765271	797	877	21	1	80	0.0125000
NODE_3537_length_1245_cov_24.765271	797	877	22	25	80	0.3125000
NODE_3537_length_1245_cov_24.765271	797	877	23	6	80	0.0750000
NODE_3537_length_1245_cov_24.765271	850	930	12	3	80	0.0375000
NODE_3537_length_1245_cov_24.765271	850	930	13	2	80	0.0250000
NODE_3537_length_1245_cov_24.765271	850	930	14	22	80	0.2750000
NODE_3537_length_1245_cov_24.765271	850	930	15	1	80	0.0125000
NODE_3537_length_1245_cov_24.765271	850	930	16	6	80	0.0750000
NODE_3537_length_1245_cov_24.765271	850	930	17	3	80	0.0375000
NODE_3537_length_1245_cov_24.765271	850	930	18	1	80	0.0125000
NODE_3537_length_1245_cov_24.765271	850	930	20	19	80	0.2375000
NODE_3537_length_1245_cov_24.765271	850	930	22	17	80	0.2125000
NODE_3537_length_1245_cov_24.765271	850	930	23	6	80	0.0750000
NODE_3538_length_1245_cov_16.854276	655	735	0	80	80	1.0000000
NODE_3538_length_1245_cov_16.854276	701	771	0	70	70	1.0000000
NODE_3538_length_1245_cov_16.854276	708	788	0	80	80	1.0000000
NODE_3540_length_1245_cov_1.187609	1148	1194	0	46	46	1.0000000
NODE_3540_length_1245_cov_1.187609	1167	1245	0	78	78	1.0000000
NODE_3541_length_1244_cov_52.633188	501	581	2	12	80	0.1500000
NODE_3541_length_1244_cov_52.633188	501	581	3	36	80	0.4500000
NODE_3541_length_1244_cov_52.633188	501	581	4	24	80	0.3000000
NODE_3541_length_1244_cov_52.633188	501	581	5	8	80	0.1000000
NODE_3541_length_1244_cov_52.633188	554	634	3	30	80	0.3750000
NODE_3541_length_1244_cov_52.633188	554	634	4	42	80	0.5250000
NODE_3541_length_1244_cov_52.633188	554	634	5	8	80	0.1000000
NODE_3541_length_1244_cov_52.633188	630	710	3	6	80	0.0750000
NODE_3541_length_1244_cov_52.633188	630	710	4	1	80	0.0125000
NODE_3541_length_1244_cov_52.633188	630	710	6	28	80	0.3500000
NODE_3541_length_1244_cov_52.633188	630	710	7	5	80	0.0625000
NODE_3541_length_1244_cov_52.633188	630	710	8	8	80	0.1000000
NODE_3541_length_1244_cov_52.633188	630	710	9	32	80	0.4000000
NODE_3541_length_1244_cov_52.633188	683	763	7	56	80	0.7000000
NODE_3541_length_1244_cov_52.633188	683	763	8	8	80	0.1000000
NODE_3541_length_1244_cov_52.633188	683	763	9	16	80	0.2000000
NODE_3542_length_1244_cov_33.889956	445	525	5	54	80	0.6750000
NODE_3542_length_1244_cov_33.889956	445	525	6	26	80	0.3250000
NODE_3542_length_1244_cov_33.889956	498	578	2	12	80	0.1500000
NODE_3542_length_1244_cov_33.889956	498	578	3	4	80	0.0500000
NODE_3542_length_1244_cov_33.889956	498	578	4	19	80	0.2375000
NODE_3542_length_1244_cov_33.889956	498	578	5	21	80	0.2625000
NODE_3542_length_1244_cov_33.889956	498	578	6	24	80	0.3000000
NODE_3542_length_1244_cov_33.889956	574	654	2	5	80	0.0625000
NODE_3542_length_1244_cov_33.889956	574	654	3	11	80	0.1375000
NODE_3542_length_1244_cov_33.889956	574	654	5	11	80	0.1375000
NODE_3542_length_1244_cov_33.889956	574	654	6	5	80	0.0625000
NODE_3542_length_1244_cov_33.889956	574	654	7	19	80	0.2375000
NODE_3542_length_1244_cov_33.889956	574	654	9	29	80	0.3625000
NODE_3542_length_1244_cov_33.889956	627	707	8	33	80	0.4125000
NODE_3542_length_1244_cov_33.889956	627	707	9	43	80	0.5375000
NODE_3542_length_1244_cov_33.889956	627	707	11	4	80	0.0500000
NODE_3543_length_1244_cov_16.798253	644	724	7	13	80	0.1625000
NODE_3543_length_1244_cov_16.798253	644	724	8	26	80	0.3250000
NODE_3543_length_1244_cov_16.798253	644	724	10	41	80	0.5125000
NODE_3543_length_1244_cov_16.798253	697	777	8	18	80	0.2250000
NODE_3543_length_1244_cov_16.798253	697	777	9	21	80	0.2625000
NODE_3543_length_1244_cov_16.798253	697	777	10	41	80	0.5125000
NODE_3544_length_1244_cov_1.735371	276	347	0	71	71	1.0000000
NODE_3544_length_1244_cov_1.735371	276	347	0	71	71	1.0000000
NODE_3544_length_1244_cov_1.735371	320	400	0	80	80	1.0000000
NODE_3544_length_1244_cov_1.735371	320	400	0	80	80	1.0000000
NODE_3548_length_1243_cov_34.284965	774	854	4	4	80	0.0500000
NODE_3548_length_1243_cov_34.284965	774	854	7	2	80	0.0250000
NODE_3548_length_1243_cov_34.284965	774	854	8	58	80	0.7250000
NODE_3548_length_1243_cov_34.284965	774	854	9	16	80	0.2000000
NODE_3548_length_1243_cov_34.284965	827	907	5	4	80	0.0500000
NODE_3548_length_1243_cov_34.284965	827	907	6	12	80	0.1500000
NODE_3548_length_1243_cov_34.284965	827	907	7	27	80	0.3375000
NODE_3548_length_1243_cov_34.284965	827	907	8	20	80	0.2500000
NODE_3548_length_1243_cov_34.284965	827	907	9	17	80	0.2125000
NODE_3552_length_1242_cov_29.665792	539	619	0	80	80	1.0000000
NODE_3552_length_1242_cov_29.665792	592	672	0	80	80	1.0000000
NODE_3553_length_1242_cov_28.304462	506	586	3	44	80	0.5500000
NODE_3553_length_1242_cov_28.304462	506	586	4	36	80	0.4500000
NODE_3553_length_1242_cov_28.304462	559	639	2	11	80	0.1375000
NODE_3553_length_1242_cov_28.304462	559	639	3	52	80	0.6500000
NODE_3553_length_1242_cov_28.304462	559	639	4	13	80	0.1625000
NODE_3553_length_1242_cov_28.304462	559	639	5	4	80	0.0500000
NODE_3553_length_1242_cov_28.304462	635	715	2	4	80	0.0500000
NODE_3553_length_1242_cov_28.304462	635	715	3	9	80	0.1125000
NODE_3553_length_1242_cov_28.304462	635	715	4	6	80	0.0750000
NODE_3553_length_1242_cov_28.304462	635	715	6	17	80	0.2125000
NODE_3553_length_1242_cov_28.304462	635	715	8	38	80	0.4750000
NODE_3553_length_1242_cov_28.304462	635	715	9	6	80	0.0750000
NODE_3553_length_1242_cov_28.304462	688	768	8	33	80	0.4125000
NODE_3553_length_1242_cov_28.304462	688	768	9	24	80	0.3000000
NODE_3553_length_1242_cov_28.304462	688	768	10	23	80	0.2875000
NODE_3554_length_1242_cov_16.383202	704	784	11	2	80	0.0250000
NODE_3554_length_1242_cov_16.383202	704	784	12	17	80	0.2125000
NODE_3554_length_1242_cov_16.383202	704	784	13	41	80	0.5125000
NODE_3554_length_1242_cov_16.383202	704	784	14	18	80	0.2250000
NODE_3554_length_1242_cov_16.383202	704	784	15	2	80	0.0250000
NODE_3554_length_1242_cov_16.383202	757	837	8	10	80	0.1250000
NODE_3554_length_1242_cov_16.383202	757	837	9	1	80	0.0125000
NODE_3554_length_1242_cov_16.383202	757	837	10	1	80	0.0125000
NODE_3554_length_1242_cov_16.383202	757	837	12	7	80	0.0875000
NODE_3554_length_1242_cov_16.383202	757	837	13	40	80	0.5000000
NODE_3554_length_1242_cov_16.383202	757	837	14	19	80	0.2375000
NODE_3554_length_1242_cov_16.383202	757	837	15	2	80	0.0250000
NODE_3555_length_1242_cov_8.081365	688	768	2	18	80	0.2250000
NODE_3555_length_1242_cov_8.081365	688	768	3	62	80	0.7750000
NODE_3555_length_1242_cov_8.081365	741	821	3	36	80	0.4500000
NODE_3555_length_1242_cov_8.081365	741	821	4	24	80	0.3000000
NODE_3555_length_1242_cov_8.081365	741	821	5	20	80	0.2500000
NODE_3561_length_1241_cov_36.544658	602	682	1	13	80	0.1625000
NODE_3561_length_1241_cov_36.544658	602	682	2	7	80	0.0875000
NODE_3561_length_1241_cov_36.544658	602	682	4	1	80	0.0125000
NODE_3561_length_1241_cov_36.544658	602	682	5	32	80	0.4000000
NODE_3561_length_1241_cov_36.544658	602	682	6	27	80	0.3375000
NODE_3561_length_1241_cov_36.544658	655	735	1	66	80	0.8250000
NODE_3561_length_1241_cov_36.544658	655	735	2	7	80	0.0875000
NODE_3561_length_1241_cov_36.544658	655	735	4	1	80	0.0125000
NODE_3561_length_1241_cov_36.544658	655	735	5	6	80	0.0750000
NODE_3562_length_1241_cov_19.894921	676	756	1	16	80	0.2000000
NODE_3562_length_1241_cov_19.894921	676	756	4	18	80	0.2250000
NODE_3562_length_1241_cov_19.894921	676	756	5	3	80	0.0375000
NODE_3562_length_1241_cov_19.894921	676	756	7	43	80	0.5375000
NODE_3562_length_1241_cov_19.894921	729	809	6	27	80	0.3375000
NODE_3562_length_1241_cov_19.894921	729	809	7	53	80	0.6625000
NODE_3569_length_1240_cov_38.375110	483	563	4	8	80	0.1000000
NODE_3569_length_1240_cov_38.375110	483	563	5	2	80	0.0250000
NODE_3569_length_1240_cov_38.375110	483	563	6	70	80	0.8750000
NODE_3569_length_1240_cov_38.375110	536	616	2	7	80	0.0875000
NODE_3569_length_1240_cov_38.375110	536	616	3	31	80	0.3875000
NODE_3569_length_1240_cov_38.375110	536	616	5	4	80	0.0500000
NODE_3569_length_1240_cov_38.375110	536	616	6	38	80	0.4750000
NODE_3569_length_1240_cov_38.375110	612	692	3	26	80	0.3250000
NODE_3569_length_1240_cov_38.375110	612	692	4	15	80	0.1875000
NODE_3569_length_1240_cov_38.375110	612	692	5	14	80	0.1750000
NODE_3569_length_1240_cov_38.375110	612	692	6	25	80	0.3125000
NODE_3569_length_1240_cov_38.375110	665	745	5	3	80	0.0375000
NODE_3569_length_1240_cov_38.375110	665	745	6	65	80	0.8125000
NODE_3569_length_1240_cov_38.375110	665	745	7	12	80	0.1500000
NODE_3570_length_1240_cov_24.975460	625	705	2	1	80	0.0125000
NODE_3570_length_1240_cov_24.975460	625	705	4	4	80	0.0500000
NODE_3570_length_1240_cov_24.975460	625	705	5	5	80	0.0625000
NODE_3570_length_1240_cov_24.975460	625	705	7	55	80	0.6875000
NODE_3570_length_1240_cov_24.975460	625	705	9	15	80	0.1875000
NODE_3570_length_1240_cov_24.975460	678	758	7	12	80	0.1500000
NODE_3570_length_1240_cov_24.975460	678	758	8	28	80	0.3500000
NODE_3570_length_1240_cov_24.975460	678	758	9	33	80	0.4125000
NODE_3570_length_1240_cov_24.975460	678	758	10	5	80	0.0625000
NODE_3570_length_1240_cov_24.975460	678	758	11	2	80	0.0250000
NODE_3571_length_1240_cov_23.812445	731	811	1	41	80	0.5125000
NODE_3571_length_1240_cov_23.812445	731	811	2	38	80	0.4750000
NODE_3571_length_1240_cov_23.812445	731	811	3	1	80	0.0125000
NODE_3571_length_1240_cov_23.812445	784	864	0	12	80	0.1500000
NODE_3571_length_1240_cov_23.812445	784	864	2	68	80	0.8500000
NODE_3576_length_1239_cov_37.657895	399	479	0	6	80	0.0750000
NODE_3576_length_1239_cov_37.657895	399	479	1	7	80	0.0875000
NODE_3576_length_1239_cov_37.657895	399	479	3	7	80	0.0875000
NODE_3576_length_1239_cov_37.657895	399	479	4	41	80	0.5125000
NODE_3576_length_1239_cov_37.657895	399	479	5	18	80	0.2250000
NODE_3576_length_1239_cov_37.657895	399	479	7	1	80	0.0125000
NODE_3576_length_1239_cov_37.657895	452	532	4	8	80	0.1000000
NODE_3576_length_1239_cov_37.657895	452	532	5	18	80	0.2250000
NODE_3576_length_1239_cov_37.657895	452	532	7	29	80	0.3625000
NODE_3576_length_1239_cov_37.657895	452	532	8	1	80	0.0125000
NODE_3576_length_1239_cov_37.657895	452	532	9	11	80	0.1375000
NODE_3576_length_1239_cov_37.657895	452	532	10	13	80	0.1625000
NODE_3576_length_1239_cov_37.657895	528	608	7	26	80	0.3250000
NODE_3576_length_1239_cov_37.657895	528	608	8	20	80	0.2500000
NODE_3576_length_1239_cov_37.657895	528	608	9	31	80	0.3875000
NODE_3576_length_1239_cov_37.657895	528	608	10	3	80	0.0375000
NODE_3576_length_1239_cov_37.657895	581	661	6	3	80	0.0375000
NODE_3576_length_1239_cov_37.657895	581	661	7	25	80	0.3125000
NODE_3576_length_1239_cov_37.657895	581	661	8	21	80	0.2625000
NODE_3576_length_1239_cov_37.657895	581	661	9	31	80	0.3875000
NODE_3577_length_1239_cov_14.984211	398	478	2	4	80	0.0500000
NODE_3577_length_1239_cov_14.984211	398	478	4	76	80	0.9500000
NODE_3577_length_1239_cov_14.984211	451	531	2	32	80	0.4000000
NODE_3577_length_1239_cov_14.984211	451	531	4	48	80	0.6000000
NODE_3577_length_1239_cov_14.984211	771	825	1	54	54	1.0000000
NODE_3577_length_1239_cov_14.984211	798	878	1	80	80	1.0000000
NODE_3578_length_1239_cov_13.312281	806	886	1	33	80	0.4125000
NODE_3578_length_1239_cov_13.312281	806	886	2	39	80	0.4875000
NODE_3578_length_1239_cov_13.312281	806	886	3	8	80	0.1000000
NODE_3578_length_1239_cov_13.312281	859	939	2	19	80	0.2375000
NODE_3578_length_1239_cov_13.312281	859	939	3	59	80	0.7375000
NODE_3578_length_1239_cov_13.312281	859	939	4	2	80	0.0250000
NODE_3579_length_1239_cov_7.116667	444	524	3	16	80	0.2000000
NODE_3579_length_1239_cov_7.116667	444	524	4	4	80	0.0500000
NODE_3579_length_1239_cov_7.116667	444	524	6	60	80	0.7500000
NODE_3579_length_1239_cov_7.116667	497	577	1	1	80	0.0125000
NODE_3579_length_1239_cov_7.116667	497	577	2	12	80	0.1500000
NODE_3579_length_1239_cov_7.116667	497	577	3	38	80	0.4750000
NODE_3579_length_1239_cov_7.116667	497	577	4	22	80	0.2750000
NODE_3579_length_1239_cov_7.116667	497	577	6	7	80	0.0875000
NODE_3582_length_1238_cov_33.830553	625	705	3	16	80	0.2000000
NODE_3582_length_1238_cov_33.830553	625	705	4	2	80	0.0250000
NODE_3582_length_1238_cov_33.830553	625	705	6	62	80	0.7750000
NODE_3582_length_1238_cov_33.830553	678	758	6	41	80	0.5125000
NODE_3582_length_1238_cov_33.830553	678	758	8	39	80	0.4875000
NODE_3583_length_1238_cov_8.163301	664	744	8	18	80	0.2250000
NODE_3583_length_1238_cov_8.163301	664	744	9	15	80	0.1875000
NODE_3583_length_1238_cov_8.163301	664	744	11	5	80	0.0625000
NODE_3583_length_1238_cov_8.163301	664	744	12	5	80	0.0625000
NODE_3583_length_1238_cov_8.163301	664	744	13	3	80	0.0375000
NODE_3583_length_1238_cov_8.163301	664	744	14	29	80	0.3625000
NODE_3583_length_1238_cov_8.163301	664	744	15	5	80	0.0625000
NODE_3583_length_1238_cov_8.163301	717	797	8	7	80	0.0875000
NODE_3583_length_1238_cov_8.163301	717	797	9	3	80	0.0375000
NODE_3583_length_1238_cov_8.163301	717	797	10	5	80	0.0625000
NODE_3583_length_1238_cov_8.163301	717	797	11	4	80	0.0500000
NODE_3583_length_1238_cov_8.163301	717	797	13	33	80	0.4125000
NODE_3583_length_1238_cov_8.163301	717	797	14	19	80	0.2375000
NODE_3583_length_1238_cov_8.163301	717	797	15	9	80	0.1125000
NODE_3586_length_1237_cov_24.562390	447	527	3	22	80	0.2750000
NODE_3586_length_1237_cov_24.562390	447	527	5	58	80	0.7250000
NODE_3586_length_1237_cov_24.562390	500	580	2	27	80	0.3375000
NODE_3586_length_1237_cov_24.562390	500	580	3	10	80	0.1250000
NODE_3586_length_1237_cov_24.562390	500	580	4	12	80	0.1500000
NODE_3586_length_1237_cov_24.562390	500	580	5	31	80	0.3875000
NODE_3587_length_1237_cov_9.297012	515	595	0	14	80	0.1750000
NODE_3587_length_1237_cov_9.297012	515	595	1	34	80	0.4250000
NODE_3587_length_1237_cov_9.297012	515	595	2	32	80	0.4000000
NODE_3587_length_1237_cov_9.297012	568	648	2	36	80	0.4500000
NODE_3587_length_1237_cov_9.297012	568	648	3	44	80	0.5500000
NODE_3594_length_1236_cov_46.661390	632	712	10	3	80	0.0375000
NODE_3594_length_1236_cov_46.661390	632	712	12	1	80	0.0125000
NODE_3594_length_1236_cov_46.661390	632	712	14	38	80	0.4750000
NODE_3594_length_1236_cov_46.661390	632	712	15	3	80	0.0375000
NODE_3594_length_1236_cov_46.661390	632	712	16	10	80	0.1250000
NODE_3594_length_1236_cov_46.661390	632	712	17	25	80	0.3125000
NODE_3594_length_1236_cov_46.661390	685	765	12	12	80	0.1500000
NODE_3594_length_1236_cov_46.661390	685	765	13	17	80	0.2125000
NODE_3594_length_1236_cov_46.661390	685	765	14	11	80	0.1375000
NODE_3594_length_1236_cov_46.661390	685	765	15	1	80	0.0125000
NODE_3594_length_1236_cov_46.661390	685	765	16	9	80	0.1125000
NODE_3594_length_1236_cov_46.661390	685	765	17	30	80	0.3750000
NODE_3595_length_1236_cov_8.625330	735	815	5	16	80	0.2000000
NODE_3595_length_1236_cov_8.625330	735	815	6	64	80	0.8000000
NODE_3595_length_1236_cov_8.625330	788	868	2	7	80	0.0875000
NODE_3595_length_1236_cov_8.625330	788	868	3	39	80	0.4875000
NODE_3595_length_1236_cov_8.625330	788	868	5	18	80	0.2250000
NODE_3595_length_1236_cov_8.625330	788	868	6	16	80	0.2000000
NODE_3597_length_1235_cov_31.619718	331	411	9	3	80	0.0375000
NODE_3597_length_1235_cov_31.619718	331	411	10	41	80	0.5125000
NODE_3597_length_1235_cov_31.619718	331	411	12	25	80	0.3125000
NODE_3597_length_1235_cov_31.619718	331	411	13	11	80	0.1375000
NODE_3597_length_1235_cov_31.619718	384	464	9	4	80	0.0500000
NODE_3597_length_1235_cov_31.619718	384	464	10	21	80	0.2625000
NODE_3597_length_1235_cov_31.619718	384	464	11	24	80	0.3000000
NODE_3597_length_1235_cov_31.619718	384	464	12	20	80	0.2500000
NODE_3597_length_1235_cov_31.619718	384	464	13	11	80	0.1375000
NODE_3598_length_1235_cov_20.252641	559	639	13	1	80	0.0125000
NODE_3598_length_1235_cov_20.252641	559	639	14	1	80	0.0125000
NODE_3598_length_1235_cov_20.252641	559	639	15	3	80	0.0375000
NODE_3598_length_1235_cov_20.252641	559	639	16	40	80	0.5000000
NODE_3598_length_1235_cov_20.252641	559	639	17	10	80	0.1250000
NODE_3598_length_1235_cov_20.252641	559	639	18	18	80	0.2250000
NODE_3598_length_1235_cov_20.252641	559	639	19	7	80	0.0875000
NODE_3598_length_1235_cov_20.252641	612	692	5	4	80	0.0500000
NODE_3598_length_1235_cov_20.252641	612	692	8	12	80	0.1500000
NODE_3598_length_1235_cov_20.252641	612	692	10	4	80	0.0500000
NODE_3598_length_1235_cov_20.252641	612	692	11	18	80	0.2250000
NODE_3598_length_1235_cov_20.252641	612	692	13	14	80	0.1750000
NODE_3598_length_1235_cov_20.252641	612	692	15	4	80	0.0500000
NODE_3598_length_1235_cov_20.252641	612	692	16	10	80	0.1250000
NODE_3598_length_1235_cov_20.252641	612	692	17	9	80	0.1125000
NODE_3598_length_1235_cov_20.252641	612	692	18	5	80	0.0625000
NODE_3598_length_1235_cov_20.252641	688	768	1	15	80	0.1875000
NODE_3598_length_1235_cov_20.252641	688	768	2	11	80	0.1375000
NODE_3598_length_1235_cov_20.252641	688	768	3	1	80	0.0125000
NODE_3598_length_1235_cov_20.252641	688	768	4	31	80	0.3875000
NODE_3598_length_1235_cov_20.252641	688	768	5	22	80	0.2750000
NODE_3598_length_1235_cov_20.252641	741	821	0	44	80	0.5500000
NODE_3598_length_1235_cov_20.252641	741	821	1	24	80	0.3000000
NODE_3598_length_1235_cov_20.252641	741	821	2	11	80	0.1375000
NODE_3598_length_1235_cov_20.252641	741	821	3	1	80	0.0125000
NODE_3599_length_1235_cov_18.462148	695	775	5	40	80	0.5000000
NODE_3599_length_1235_cov_18.462148	695	775	6	38	80	0.4750000
NODE_3599_length_1235_cov_18.462148	695	775	7	2	80	0.0250000
NODE_3599_length_1235_cov_18.462148	748	828	2	47	80	0.5875000
NODE_3599_length_1235_cov_18.462148	748	828	3	2	80	0.0250000
NODE_3599_length_1235_cov_18.462148	748	828	5	24	80	0.3000000
NODE_3599_length_1235_cov_18.462148	748	828	6	7	80	0.0875000
NODE_3600_length_1235_cov_8.696303	765	845	3	3	80	0.0375000
NODE_3600_length_1235_cov_8.696303	765	845	4	29	80	0.3625000
NODE_3600_length_1235_cov_8.696303	765	845	5	2	80	0.0250000
NODE_3600_length_1235_cov_8.696303	765	845	7	8	80	0.1000000
NODE_3600_length_1235_cov_8.696303	765	845	8	11	80	0.1375000
NODE_3600_length_1235_cov_8.696303	765	845	10	1	80	0.0125000
NODE_3600_length_1235_cov_8.696303	765	845	11	26	80	0.3250000
NODE_3600_length_1235_cov_8.696303	818	898	5	1	80	0.0125000
NODE_3600_length_1235_cov_8.696303	818	898	6	9	80	0.1125000
NODE_3600_length_1235_cov_8.696303	818	898	8	4	80	0.0500000
NODE_3600_length_1235_cov_8.696303	818	898	10	13	80	0.1625000
NODE_3600_length_1235_cov_8.696303	818	898	11	53	80	0.6625000
NODE_3601_length_1235_cov_5.580106	544	624	0	80	80	1.0000000
NODE_3601_length_1235_cov_5.580106	597	677	0	67	80	0.8375000
NODE_3601_length_1235_cov_5.580106	597	677	1	13	80	0.1625000
NODE_3608_length_1234_cov_27.136564	528	608	12	8	80	0.1000000
NODE_3608_length_1234_cov_27.136564	528	608	13	17	80	0.2125000
NODE_3608_length_1234_cov_27.136564	528	608	14	1	80	0.0125000
NODE_3608_length_1234_cov_27.136564	528	608	15	14	80	0.1750000
NODE_3608_length_1234_cov_27.136564	528	608	17	3	80	0.0375000
NODE_3608_length_1234_cov_27.136564	528	608	19	26	80	0.3250000
NODE_3608_length_1234_cov_27.136564	528	608	20	11	80	0.1375000
NODE_3608_length_1234_cov_27.136564	581	661	10	1	80	0.0125000
NODE_3608_length_1234_cov_27.136564	581	661	11	16	80	0.2000000
NODE_3608_length_1234_cov_27.136564	581	661	12	2	80	0.0250000
NODE_3608_length_1234_cov_27.136564	581	661	14	1	80	0.0125000
NODE_3608_length_1234_cov_27.136564	581	661	16	4	80	0.0500000
NODE_3608_length_1234_cov_27.136564	581	661	17	7	80	0.0875000
NODE_3608_length_1234_cov_27.136564	581	661	18	14	80	0.1750000
NODE_3608_length_1234_cov_27.136564	581	661	19	29	80	0.3625000
NODE_3608_length_1234_cov_27.136564	581	661	20	6	80	0.0750000
NODE_3611_length_1233_cov_64.374780	497	577	5	6	80	0.0750000
NODE_3611_length_1233_cov_64.374780	497	577	6	10	80	0.1250000
NODE_3611_length_1233_cov_64.374780	497	577	7	1	80	0.0125000
NODE_3611_length_1233_cov_64.374780	497	577	8	6	80	0.0750000
NODE_3611_length_1233_cov_64.374780	497	577	10	25	80	0.3125000
NODE_3611_length_1233_cov_64.374780	497	577	13	1	80	0.0125000
NODE_3611_length_1233_cov_64.374780	497	577	14	6	80	0.0750000
NODE_3611_length_1233_cov_64.374780	497	577	15	9	80	0.1125000
NODE_3611_length_1233_cov_64.374780	497	577	16	9	80	0.1125000
NODE_3611_length_1233_cov_64.374780	497	577	17	7	80	0.0875000
NODE_3611_length_1233_cov_64.374780	550	630	14	2	80	0.0250000
NODE_3611_length_1233_cov_64.374780	550	630	15	9	80	0.1125000
NODE_3611_length_1233_cov_64.374780	550	630	16	18	80	0.2250000
NODE_3611_length_1233_cov_64.374780	550	630	17	8	80	0.1000000
NODE_3611_length_1233_cov_64.374780	550	630	18	25	80	0.3125000
NODE_3611_length_1233_cov_64.374780	550	630	19	15	80	0.1875000
NODE_3611_length_1233_cov_64.374780	550	630	20	3	80	0.0375000
NODE_3611_length_1233_cov_64.374780	626	706	19	10	80	0.1250000
NODE_3611_length_1233_cov_64.374780	626	706	20	21	80	0.2625000
NODE_3611_length_1233_cov_64.374780	626	706	21	3	80	0.0375000
NODE_3611_length_1233_cov_64.374780	626	706	23	17	80	0.2125000
NODE_3611_length_1233_cov_64.374780	626	706	24	26	80	0.3250000
NODE_3611_length_1233_cov_64.374780	626	706	25	3	80	0.0375000
NODE_3611_length_1233_cov_64.374780	679	759	8	27	80	0.3375000
NODE_3611_length_1233_cov_64.374780	679	759	10	1	80	0.0125000
NODE_3611_length_1233_cov_64.374780	679	759	13	2	80	0.0250000
NODE_3611_length_1233_cov_64.374780	679	759	15	9	80	0.1125000
NODE_3611_length_1233_cov_64.374780	679	759	18	11	80	0.1375000
NODE_3611_length_1233_cov_64.374780	679	759	19	3	80	0.0375000
NODE_3611_length_1233_cov_64.374780	679	759	20	6	80	0.0750000
NODE_3611_length_1233_cov_64.374780	679	759	21	1	80	0.0125000
NODE_3611_length_1233_cov_64.374780	679	759	23	7	80	0.0875000
NODE_3611_length_1233_cov_64.374780	679	759	24	13	80	0.1625000
NODE_3612_length_1233_cov_52.833333	654	734	6	1	80	0.0125000
NODE_3612_length_1233_cov_52.833333	654	734	7	3	80	0.0375000
NODE_3612_length_1233_cov_52.833333	654	734	8	5	80	0.0625000
NODE_3612_length_1233_cov_52.833333	654	734	9	6	80	0.0750000
NODE_3612_length_1233_cov_52.833333	654	734	10	15	80	0.1875000
NODE_3612_length_1233_cov_52.833333	654	734	11	15	80	0.1875000
NODE_3612_length_1233_cov_52.833333	654	734	12	26	80	0.3250000
NODE_3612_length_1233_cov_52.833333	654	734	14	9	80	0.1125000
NODE_3612_length_1233_cov_52.833333	707	787	11	5	80	0.0625000
NODE_3612_length_1233_cov_52.833333	707	787	12	13	80	0.1625000
NODE_3612_length_1233_cov_52.833333	707	787	14	25	80	0.3125000
NODE_3612_length_1233_cov_52.833333	707	787	15	18	80	0.2250000
NODE_3612_length_1233_cov_52.833333	707	787	16	1	80	0.0125000
NODE_3612_length_1233_cov_52.833333	707	787	17	18	80	0.2250000
NODE_3613_length_1233_cov_18.096120	522	602	1	39	80	0.4875000
NODE_3613_length_1233_cov_18.096120	522	602	3	41	80	0.5125000
NODE_3613_length_1233_cov_18.096120	575	655	1	9	80	0.1125000
NODE_3613_length_1233_cov_18.096120	575	655	3	71	80	0.8875000
NODE_3613_length_1233_cov_18.096120	651	731	0	45	80	0.5625000
NODE_3613_length_1233_cov_18.096120	651	731	1	18	80	0.2250000
NODE_3613_length_1233_cov_18.096120	651	731	2	17	80	0.2125000
NODE_3613_length_1233_cov_18.096120	704	784	1	10	80	0.1250000
NODE_3613_length_1233_cov_18.096120	704	784	2	70	80	0.8750000
NODE_3614_length_1233_cov_15.360670	585	656	4	11	71	0.1549296
NODE_3614_length_1233_cov_15.360670	585	656	6	1	71	0.0140845
NODE_3614_length_1233_cov_15.360670	585	656	8	2	71	0.0281690
NODE_3614_length_1233_cov_15.360670	585	656	9	57	71	0.8028169
NODE_3614_length_1233_cov_15.360670	631	709	3	17	78	0.2179487
NODE_3614_length_1233_cov_15.360670	631	709	4	10	78	0.1282051
NODE_3614_length_1233_cov_15.360670	631	709	6	4	78	0.0512821
NODE_3614_length_1233_cov_15.360670	631	709	8	14	78	0.1794872
NODE_3614_length_1233_cov_15.360670	631	709	9	33	78	0.4230769
NODE_3620_length_1232_cov_62.112974	552	632	20	8	80	0.1000000
NODE_3620_length_1232_cov_62.112974	552	632	21	6	80	0.0750000
NODE_3620_length_1232_cov_62.112974	552	632	22	10	80	0.1250000
NODE_3620_length_1232_cov_62.112974	552	632	23	2	80	0.0250000
NODE_3620_length_1232_cov_62.112974	552	632	24	1	80	0.0125000
NODE_3620_length_1232_cov_62.112974	552	632	25	2	80	0.0250000
NODE_3620_length_1232_cov_62.112974	552	632	28	25	80	0.3125000
NODE_3620_length_1232_cov_62.112974	552	632	29	18	80	0.2250000
NODE_3620_length_1232_cov_62.112974	552	632	30	5	80	0.0625000
NODE_3620_length_1232_cov_62.112974	552	632	31	3	80	0.0375000
NODE_3620_length_1232_cov_62.112974	605	694	21	2	89	0.0224719
NODE_3620_length_1232_cov_62.112974	605	694	22	4	89	0.0449438
NODE_3620_length_1232_cov_62.112974	605	694	23	2	89	0.0224719
NODE_3620_length_1232_cov_62.112974	605	694	24	16	89	0.1797753
NODE_3620_length_1232_cov_62.112974	605	694	25	4	89	0.0449438
NODE_3620_length_1232_cov_62.112974	605	694	26	1	89	0.0112360
NODE_3620_length_1232_cov_62.112974	605	694	28	41	89	0.4606742
NODE_3620_length_1232_cov_62.112974	605	694	29	11	89	0.1235955
NODE_3620_length_1232_cov_62.112974	605	694	30	5	89	0.0561798
NODE_3620_length_1232_cov_62.112974	605	694	31	3	89	0.0337079
NODE_3620_length_1232_cov_62.112974	690	770	8	25	80	0.3125000
NODE_3620_length_1232_cov_62.112974	690	770	9	7	80	0.0875000
NODE_3620_length_1232_cov_62.112974	690	770	10	1	80	0.0125000
NODE_3620_length_1232_cov_62.112974	690	770	11	1	80	0.0125000
NODE_3620_length_1232_cov_62.112974	690	770	13	2	80	0.0250000
NODE_3620_length_1232_cov_62.112974	690	770	15	1	80	0.0125000
NODE_3620_length_1232_cov_62.112974	690	770	16	15	80	0.1875000
NODE_3620_length_1232_cov_62.112974	690	770	17	5	80	0.0625000
NODE_3620_length_1232_cov_62.112974	690	770	18	5	80	0.0625000
NODE_3620_length_1232_cov_62.112974	690	770	19	4	80	0.0500000
NODE_3620_length_1232_cov_62.112974	690	770	20	8	80	0.1000000
NODE_3620_length_1232_cov_62.112974	690	770	21	2	80	0.0250000
NODE_3620_length_1232_cov_62.112974	690	770	22	4	80	0.0500000
NODE_3620_length_1232_cov_62.112974	743	823	4	38	80	0.4750000
NODE_3620_length_1232_cov_62.112974	743	823	5	13	80	0.1625000
NODE_3620_length_1232_cov_62.112974	743	823	6	1	80	0.0125000
NODE_3620_length_1232_cov_62.112974	743	823	8	23	80	0.2875000
NODE_3620_length_1232_cov_62.112974	743	823	9	5	80	0.0625000
NODE_3621_length_1232_cov_34.635481	469	549	4	8	80	0.1000000
NODE_3621_length_1232_cov_34.635481	469	549	6	1	80	0.0125000
NODE_3621_length_1232_cov_34.635481	469	549	7	16	80	0.2000000
NODE_3621_length_1232_cov_34.635481	469	549	8	1	80	0.0125000
NODE_3621_length_1232_cov_34.635481	469	549	10	9	80	0.1125000
NODE_3621_length_1232_cov_34.635481	469	549	11	7	80	0.0875000
NODE_3621_length_1232_cov_34.635481	469	549	12	25	80	0.3125000
NODE_3621_length_1232_cov_34.635481	469	549	15	13	80	0.1625000
NODE_3621_length_1232_cov_34.635481	522	602	12	14	80	0.1750000
NODE_3621_length_1232_cov_34.635481	522	602	14	8	80	0.1000000
NODE_3621_length_1232_cov_34.635481	522	602	15	23	80	0.2875000
NODE_3621_length_1232_cov_34.635481	522	602	16	30	80	0.3750000
NODE_3621_length_1232_cov_34.635481	522	602	17	5	80	0.0625000
NODE_3622_length_1232_cov_16.362754	774	854	0	80	80	1.0000000
NODE_3622_length_1232_cov_16.362754	827	907	0	80	80	1.0000000
NODE_3623_length_1232_cov_13.395410	234	315	0	81	81	1.0000000
NODE_3623_length_1232_cov_13.395410	287	368	0	81	81	1.0000000
NODE_3623_length_1232_cov_13.395410	364	444	0	80	80	1.0000000
NODE_3623_length_1232_cov_13.395410	417	497	0	80	80	1.0000000
NODE_3625_length_1231_cov_47.606890	509	589	0	29	80	0.3625000
NODE_3625_length_1231_cov_47.606890	509	589	1	25	80	0.3125000
NODE_3625_length_1231_cov_47.606890	509	589	3	26	80	0.3250000
NODE_3625_length_1231_cov_47.606890	562	642	1	1	80	0.0125000
NODE_3625_length_1231_cov_47.606890	562	642	3	70	80	0.8750000
NODE_3625_length_1231_cov_47.606890	562	642	5	5	80	0.0625000
NODE_3625_length_1231_cov_47.606890	562	642	6	4	80	0.0500000
NODE_3625_length_1231_cov_47.606890	638	718	6	14	80	0.1750000
NODE_3625_length_1231_cov_47.606890	638	718	7	1	80	0.0125000
NODE_3625_length_1231_cov_47.606890	638	718	8	12	80	0.1500000
NODE_3625_length_1231_cov_47.606890	638	718	12	1	80	0.0125000
NODE_3625_length_1231_cov_47.606890	638	718	13	20	80	0.2500000
NODE_3625_length_1231_cov_47.606890	638	718	14	21	80	0.2625000
NODE_3625_length_1231_cov_47.606890	638	718	15	11	80	0.1375000
NODE_3625_length_1231_cov_47.606890	691	771	13	13	80	0.1625000
NODE_3625_length_1231_cov_47.606890	691	771	14	3	80	0.0375000
NODE_3625_length_1231_cov_47.606890	691	771	15	46	80	0.5750000
NODE_3625_length_1231_cov_47.606890	691	771	16	6	80	0.0750000
NODE_3625_length_1231_cov_47.606890	691	771	17	12	80	0.1500000
NODE_3626_length_1231_cov_27.498233	698	777	2	79	79	1.0000000
NODE_3626_length_1231_cov_27.498233	750	830	1	28	80	0.3500000
NODE_3626_length_1231_cov_27.498233	750	830	2	52	80	0.6500000
NODE_3627_length_1231_cov_21.245583	673	753	3	2	80	0.0250000
NODE_3627_length_1231_cov_21.245583	673	753	4	16	80	0.2000000
NODE_3627_length_1231_cov_21.245583	673	753	5	5	80	0.0625000
NODE_3627_length_1231_cov_21.245583	673	753	6	1	80	0.0125000
NODE_3627_length_1231_cov_21.245583	673	753	7	56	80	0.7000000
NODE_3627_length_1231_cov_21.245583	726	806	6	12	80	0.1500000
NODE_3627_length_1231_cov_21.245583	726	806	7	34	80	0.4250000
NODE_3627_length_1231_cov_21.245583	726	806	8	34	80	0.4250000
NODE_3627_length_1231_cov_21.245583	802	882	1	28	80	0.3500000
NODE_3627_length_1231_cov_21.245583	802	882	2	8	80	0.1000000
NODE_3627_length_1231_cov_21.245583	802	882	3	5	80	0.0625000
NODE_3627_length_1231_cov_21.245583	802	882	4	8	80	0.1000000
NODE_3627_length_1231_cov_21.245583	802	882	5	14	80	0.1750000
NODE_3627_length_1231_cov_21.245583	802	882	6	17	80	0.2125000
NODE_3627_length_1231_cov_21.245583	860	935	1	24	75	0.3200000
NODE_3627_length_1231_cov_21.245583	860	935	2	21	75	0.2800000
NODE_3627_length_1231_cov_21.245583	860	935	6	30	75	0.4000000
NODE_3628_length_1231_cov_9.895760	515	595	2	42	80	0.5250000
NODE_3628_length_1231_cov_9.895760	515	595	4	38	80	0.4750000
NODE_3628_length_1231_cov_9.895760	568	648	2	29	80	0.3625000
NODE_3628_length_1231_cov_9.895760	568	648	4	51	80	0.6375000
NODE_3630_length_1230_cov_43.705570	412	492	7	15	80	0.1875000
NODE_3630_length_1230_cov_43.705570	412	492	8	65	80	0.8125000
NODE_3630_length_1230_cov_43.705570	465	545	2	33	80	0.4125000
NODE_3630_length_1230_cov_43.705570	465	545	3	6	80	0.0750000
NODE_3630_length_1230_cov_43.705570	465	545	5	1	80	0.0125000
NODE_3630_length_1230_cov_43.705570	465	545	6	11	80	0.1375000
NODE_3630_length_1230_cov_43.705570	465	545	7	17	80	0.2125000
NODE_3630_length_1230_cov_43.705570	465	545	8	12	80	0.1500000
NODE_3631_length_1230_cov_43.663130	501	581	1	1	80	0.0125000
NODE_3631_length_1230_cov_43.663130	501	581	2	4	80	0.0500000
NODE_3631_length_1230_cov_43.663130	501	581	3	13	80	0.1625000
NODE_3631_length_1230_cov_43.663130	501	581	5	49	80	0.6125000
NODE_3631_length_1230_cov_43.663130	501	581	6	13	80	0.1625000
NODE_3631_length_1230_cov_43.663130	554	634	5	14	80	0.1750000
NODE_3631_length_1230_cov_43.663130	554	634	6	63	80	0.7875000
NODE_3631_length_1230_cov_43.663130	554	634	7	3	80	0.0375000
NODE_3632_length_1230_cov_33.173298	315	395	8	6	80	0.0750000
NODE_3632_length_1230_cov_33.173298	315	395	9	4	80	0.0500000
NODE_3632_length_1230_cov_33.173298	315	395	10	2	80	0.0250000
NODE_3632_length_1230_cov_33.173298	315	395	11	1	80	0.0125000
NODE_3632_length_1230_cov_33.173298	315	395	12	6	80	0.0750000
NODE_3632_length_1230_cov_33.173298	315	395	14	17	80	0.2125000
NODE_3632_length_1230_cov_33.173298	315	395	15	11	80	0.1375000
NODE_3632_length_1230_cov_33.173298	315	395	16	2	80	0.0250000
NODE_3632_length_1230_cov_33.173298	315	395	18	12	80	0.1500000
NODE_3632_length_1230_cov_33.173298	315	395	20	3	80	0.0375000
NODE_3632_length_1230_cov_33.173298	315	395	22	16	80	0.2000000
NODE_3632_length_1230_cov_33.173298	368	448	17	1	80	0.0125000
NODE_3632_length_1230_cov_33.173298	368	448	18	8	80	0.1000000
NODE_3632_length_1230_cov_33.173298	368	448	20	14	80	0.1750000
NODE_3632_length_1230_cov_33.173298	368	448	21	6	80	0.0750000
NODE_3632_length_1230_cov_33.173298	368	448	22	51	80	0.6375000
NODE_3633_length_1230_cov_12.939876	201	281	0	33	80	0.4125000
NODE_3633_length_1230_cov_12.939876	201	281	1	1	80	0.0125000
NODE_3633_length_1230_cov_12.939876	201	281	2	46	80	0.5750000
NODE_3633_length_1230_cov_12.939876	218	273	0	25	55	0.4545455
NODE_3633_length_1230_cov_12.939876	218	273	1	1	55	0.0181818
NODE_3633_length_1230_cov_12.939876	218	273	2	29	55	0.5272727
NODE_3633_length_1230_cov_12.939876	254	334	0	60	80	0.7500000
NODE_3633_length_1230_cov_12.939876	254	334	1	20	80	0.2500000
NODE_3633_length_1230_cov_12.939876	330	410	1	13	80	0.1625000
NODE_3633_length_1230_cov_12.939876	330	410	2	21	80	0.2625000
NODE_3633_length_1230_cov_12.939876	330	410	3	22	80	0.2750000
NODE_3633_length_1230_cov_12.939876	330	410	4	24	80	0.3000000
NODE_3633_length_1230_cov_12.939876	383	463	3	3	80	0.0375000
NODE_3633_length_1230_cov_12.939876	383	463	4	77	80	0.9625000
NODE_3634_length_1230_cov_5.155615	248	328	0	50	80	0.6250000
NODE_3634_length_1230_cov_5.155615	248	328	2	13	80	0.1625000
NODE_3634_length_1230_cov_5.155615	248	328	3	17	80	0.2125000
NODE_3634_length_1230_cov_5.155615	301	381	0	80	80	1.0000000
NODE_3640_length_1229_cov_30.214159	341	421	0	56	80	0.7000000
NODE_3640_length_1229_cov_30.214159	341	421	4	24	80	0.3000000
NODE_3640_length_1229_cov_30.214159	394	474	0	4	80	0.0500000
NODE_3640_length_1229_cov_30.214159	394	474	4	76	80	0.9500000
NODE_3641_length_1229_cov_23.165487	376	456	3	17	80	0.2125000
NODE_3641_length_1229_cov_23.165487	376	456	4	51	80	0.6375000
NODE_3641_length_1229_cov_23.165487	376	456	5	12	80	0.1500000
NODE_3641_length_1229_cov_23.165487	429	509	3	29	80	0.3625000
NODE_3641_length_1229_cov_23.165487	429	509	4	12	80	0.1500000
NODE_3641_length_1229_cov_23.165487	429	509	5	34	80	0.4250000
NODE_3641_length_1229_cov_23.165487	429	509	6	1	80	0.0125000
NODE_3641_length_1229_cov_23.165487	429	509	8	4	80	0.0500000
NODE_3641_length_1229_cov_23.165487	505	585	8	14	80	0.1750000
NODE_3641_length_1229_cov_23.165487	505	585	9	14	80	0.1750000
NODE_3641_length_1229_cov_23.165487	505	585	10	20	80	0.2500000
NODE_3641_length_1229_cov_23.165487	505	585	12	32	80	0.4000000
NODE_3641_length_1229_cov_23.165487	558	638	4	2	80	0.0250000
NODE_3641_length_1229_cov_23.165487	558	638	6	5	80	0.0625000
NODE_3641_length_1229_cov_23.165487	558	638	8	29	80	0.3625000
NODE_3641_length_1229_cov_23.165487	558	638	9	11	80	0.1375000
NODE_3641_length_1229_cov_23.165487	558	638	11	5	80	0.0625000
NODE_3641_length_1229_cov_23.165487	558	638	12	28	80	0.3500000
NODE_3642_length_1229_cov_19.376991	484	564	17	18	80	0.2250000
NODE_3642_length_1229_cov_19.376991	484	564	19	8	80	0.1000000
NODE_3642_length_1229_cov_19.376991	484	564	20	12	80	0.1500000
NODE_3642_length_1229_cov_19.376991	484	564	21	16	80	0.2000000
NODE_3642_length_1229_cov_19.376991	484	564	22	16	80	0.2000000
NODE_3642_length_1229_cov_19.376991	484	564	23	10	80	0.1250000
NODE_3642_length_1229_cov_19.376991	537	614	15	2	77	0.0259740
NODE_3642_length_1229_cov_19.376991	537	614	17	11	77	0.1428571
NODE_3642_length_1229_cov_19.376991	537	614	18	1	77	0.0129870
NODE_3642_length_1229_cov_19.376991	537	614	19	6	77	0.0779221
NODE_3642_length_1229_cov_19.376991	537	614	20	9	77	0.1168831
NODE_3642_length_1229_cov_19.376991	537	614	21	9	77	0.1168831
NODE_3642_length_1229_cov_19.376991	537	614	22	9	77	0.1168831
NODE_3642_length_1229_cov_19.376991	537	614	23	30	77	0.3896104
NODE_3643_length_1229_cov_11.799115	670	748	7	7	78	0.0897436
NODE_3643_length_1229_cov_11.799115	670	748	10	1	78	0.0128205
NODE_3643_length_1229_cov_11.799115	670	748	11	23	78	0.2948718
NODE_3643_length_1229_cov_11.799115	670	748	12	47	78	0.6025641
NODE_3643_length_1229_cov_11.799115	728	801	3	25	73	0.3424658
NODE_3643_length_1229_cov_11.799115	728	801	5	4	73	0.0547945
NODE_3643_length_1229_cov_11.799115	728	801	6	2	73	0.0273973
NODE_3643_length_1229_cov_11.799115	728	801	10	3	73	0.0410959
NODE_3643_length_1229_cov_11.799115	728	801	11	39	73	0.5342466
NODE_3644_length_1229_cov_8.140708	970	1050	2	2	80	0.0250000
NODE_3644_length_1229_cov_8.140708	970	1050	3	45	80	0.5625000
NODE_3644_length_1229_cov_8.140708	970	1050	4	33	80	0.4125000
NODE_3644_length_1229_cov_8.140708	1023	1103	2	55	80	0.6875000
NODE_3644_length_1229_cov_8.140708	1023	1103	3	25	80	0.3125000
NODE_3646_length_1229_cov_3.654867	765	840	2	75	75	1.0000000
NODE_3646_length_1229_cov_3.654867	813	893	0	26	80	0.3250000
NODE_3646_length_1229_cov_3.654867	813	893	2	54	80	0.6750000
NODE_3652_length_1229_cov_0.949558	1034	1079	0	45	45	1.0000000
NODE_3652_length_1229_cov_0.949558	1090	1130	0	40	40	1.0000000
NODE_3654_length_1228_cov_22.622675	604	684	4	13	80	0.1625000
NODE_3654_length_1228_cov_22.622675	604	684	6	67	80	0.8375000
NODE_3654_length_1228_cov_22.622675	657	738	2	23	81	0.2839506
NODE_3654_length_1228_cov_22.622675	657	738	3	5	81	0.0617284
NODE_3654_length_1228_cov_22.622675	657	738	4	39	81	0.4814815
NODE_3654_length_1228_cov_22.622675	657	738	6	14	81	0.1728395
NODE_3655_length_1228_cov_17.900797	423	503	0	80	80	1.0000000
NODE_3655_length_1228_cov_17.900797	423	503	0	80	80	1.0000000
NODE_3655_length_1228_cov_17.900797	423	503	0	80	80	1.0000000
NODE_3655_length_1228_cov_17.900797	476	538	0	62	62	1.0000000
NODE_3655_length_1228_cov_17.900797	476	538	0	62	62	1.0000000
NODE_3655_length_1228_cov_17.900797	476	538	0	62	62	1.0000000
NODE_3655_length_1228_cov_17.900797	476	556	0	80	80	1.0000000
NODE_3656_length_1228_cov_14.554473	367	447	2	4	80	0.0500000
NODE_3656_length_1228_cov_14.554473	367	447	3	70	80	0.8750000
NODE_3656_length_1228_cov_14.554473	367	447	4	6	80	0.0750000
NODE_3656_length_1228_cov_14.554473	420	500	2	43	80	0.5375000
NODE_3656_length_1228_cov_14.554473	420	500	3	37	80	0.4625000
NODE_3657_length_1228_cov_10.021258	661	741	2	77	80	0.9625000
NODE_3657_length_1228_cov_10.021258	661	741	4	3	80	0.0375000
NODE_3657_length_1228_cov_10.021258	714	794	0	19	80	0.2375000
NODE_3657_length_1228_cov_10.021258	714	794	2	61	80	0.7625000
NODE_3660_length_1228_cov_3.987600	1139	1219	0	80	80	1.0000000
NODE_3662_length_1227_cov_29.002660	423	503	5	1	80	0.0125000
NODE_3662_length_1227_cov_29.002660	423	503	10	9	80	0.1125000
NODE_3662_length_1227_cov_29.002660	423	503	11	4	80	0.0500000
NODE_3662_length_1227_cov_29.002660	423	503	12	25	80	0.3125000
NODE_3662_length_1227_cov_29.002660	423	503	13	13	80	0.1625000
NODE_3662_length_1227_cov_29.002660	423	503	15	2	80	0.0250000
NODE_3662_length_1227_cov_29.002660	423	503	17	3	80	0.0375000
NODE_3662_length_1227_cov_29.002660	423	503	18	5	80	0.0625000
NODE_3662_length_1227_cov_29.002660	423	503	20	18	80	0.2250000
NODE_3662_length_1227_cov_29.002660	476	556	15	1	80	0.0125000
NODE_3662_length_1227_cov_29.002660	476	556	17	16	80	0.2000000
NODE_3662_length_1227_cov_29.002660	476	556	18	8	80	0.1000000
NODE_3662_length_1227_cov_29.002660	476	556	19	9	80	0.1125000
NODE_3662_length_1227_cov_29.002660	476	556	20	46	80	0.5750000
NODE_3663_length_1227_cov_17.479610	759	839	0	5	80	0.0625000
NODE_3663_length_1227_cov_17.479610	759	839	1	17	80	0.2125000
NODE_3663_length_1227_cov_17.479610	759	839	3	58	80	0.7250000
NODE_3663_length_1227_cov_17.479610	812	892	3	80	80	1.0000000
NODE_3666_length_1227_cov_3.808511	120	186	2	25	66	0.3787879
NODE_3666_length_1227_cov_3.808511	120	186	4	41	66	0.6212121
NODE_3666_length_1227_cov_3.808511	173	239	4	66	66	1.0000000
NODE_3666_length_1227_cov_3.808511	229	299	0	5	70	0.0714286
NODE_3666_length_1227_cov_3.808511	229	299	2	34	70	0.4857143
NODE_3666_length_1227_cov_3.808511	229	299	4	31	70	0.4428571
NODE_3672_length_1226_cov_23.792369	579	659	4	18	80	0.2250000
NODE_3672_length_1226_cov_23.792369	579	659	6	1	80	0.0125000
NODE_3672_length_1226_cov_23.792369	579	659	7	55	80	0.6875000
NODE_3672_length_1226_cov_23.792369	579	659	8	6	80	0.0750000
NODE_3672_length_1226_cov_23.792369	632	712	2	4	80	0.0500000
NODE_3672_length_1226_cov_23.792369	632	712	3	10	80	0.1250000
NODE_3672_length_1226_cov_23.792369	632	712	4	28	80	0.3500000
NODE_3672_length_1226_cov_23.792369	632	712	5	5	80	0.0625000
NODE_3672_length_1226_cov_23.792369	632	712	7	27	80	0.3375000
NODE_3672_length_1226_cov_23.792369	632	712	8	6	80	0.0750000
NODE_3672_length_1226_cov_23.792369	708	788	2	2	80	0.0250000
NODE_3672_length_1226_cov_23.792369	708	788	3	38	80	0.4750000
NODE_3672_length_1226_cov_23.792369	708	788	4	40	80	0.5000000
NODE_3672_length_1226_cov_23.792369	761	839	2	4	78	0.0512821
NODE_3672_length_1226_cov_23.792369	761	839	3	74	78	0.9487180
NODE_3673_length_1226_cov_5.620231	463	543	1	9	80	0.1125000
NODE_3673_length_1226_cov_5.620231	463	543	3	15	80	0.1875000
NODE_3673_length_1226_cov_5.620231	463	543	4	56	80	0.7000000
NODE_3673_length_1226_cov_5.620231	516	596	1	17	80	0.2125000
NODE_3673_length_1226_cov_5.620231	516	596	2	12	80	0.1500000
NODE_3673_length_1226_cov_5.620231	516	596	4	51	80	0.6375000
NODE_3674_length_1226_cov_4.881988	582	662	0	80	80	1.0000000
NODE_3674_length_1226_cov_4.881988	635	715	0	80	80	1.0000000
NODE_3682_length_1225_cov_55.596803	637	717	9	5	80	0.0625000
NODE_3682_length_1225_cov_55.596803	637	717	10	3	80	0.0375000
NODE_3682_length_1225_cov_55.596803	637	717	11	24	80	0.3000000
NODE_3682_length_1225_cov_55.596803	637	717	12	5	80	0.0625000
NODE_3682_length_1225_cov_55.596803	637	717	14	24	80	0.3000000
NODE_3682_length_1225_cov_55.596803	637	717	15	16	80	0.2000000
NODE_3682_length_1225_cov_55.596803	637	717	16	3	80	0.0375000
NODE_3682_length_1225_cov_55.596803	690	770	10	5	80	0.0625000
NODE_3682_length_1225_cov_55.596803	690	770	11	12	80	0.1500000
NODE_3682_length_1225_cov_55.596803	690	770	12	26	80	0.3250000
NODE_3682_length_1225_cov_55.596803	690	770	13	1	80	0.0125000
NODE_3682_length_1225_cov_55.596803	690	770	14	30	80	0.3750000
NODE_3682_length_1225_cov_55.596803	690	770	15	3	80	0.0375000
NODE_3682_length_1225_cov_55.596803	690	770	16	3	80	0.0375000
NODE_3682_length_1225_cov_55.596803	766	846	4	3	80	0.0375000
NODE_3682_length_1225_cov_55.596803	766	846	5	16	80	0.2000000
NODE_3682_length_1225_cov_55.596803	766	846	6	3	80	0.0375000
NODE_3682_length_1225_cov_55.596803	766	846	8	5	80	0.0625000
NODE_3682_length_1225_cov_55.596803	766	846	9	24	80	0.3000000
NODE_3682_length_1225_cov_55.596803	766	846	10	3	80	0.0375000
NODE_3682_length_1225_cov_55.596803	766	846	11	22	80	0.2750000
NODE_3682_length_1225_cov_55.596803	766	846	12	4	80	0.0500000
NODE_3682_length_1225_cov_55.596803	819	899	0	8	80	0.1000000
NODE_3682_length_1225_cov_55.596803	819	899	1	5	80	0.0625000
NODE_3682_length_1225_cov_55.596803	819	899	2	12	80	0.1500000
NODE_3682_length_1225_cov_55.596803	819	899	4	31	80	0.3875000
NODE_3682_length_1225_cov_55.596803	819	899	5	16	80	0.2000000
NODE_3682_length_1225_cov_55.596803	819	899	6	3	80	0.0375000
NODE_3682_length_1225_cov_55.596803	819	899	8	5	80	0.0625000
NODE_3683_length_1225_cov_35.189165	661	742	15	4	81	0.0493827
NODE_3683_length_1225_cov_35.189165	661	742	17	4	81	0.0493827
NODE_3683_length_1225_cov_35.189165	661	742	18	1	81	0.0123457
NODE_3683_length_1225_cov_35.189165	661	742	19	10	81	0.1234568
NODE_3683_length_1225_cov_35.189165	661	742	20	1	81	0.0123457
NODE_3683_length_1225_cov_35.189165	661	742	21	23	81	0.2839506
NODE_3683_length_1225_cov_35.189165	661	742	22	5	81	0.0617284
NODE_3683_length_1225_cov_35.189165	661	742	23	33	81	0.4074074
NODE_3683_length_1225_cov_35.189165	714	795	9	4	81	0.0493827
NODE_3683_length_1225_cov_35.189165	714	795	11	7	81	0.0864198
NODE_3683_length_1225_cov_35.189165	714	795	12	2	81	0.0246914
NODE_3683_length_1225_cov_35.189165	714	795	14	3	81	0.0370370
NODE_3683_length_1225_cov_35.189165	714	795	15	15	81	0.1851852
NODE_3683_length_1225_cov_35.189165	714	795	16	13	81	0.1604938
NODE_3683_length_1225_cov_35.189165	714	795	17	4	81	0.0493827
NODE_3683_length_1225_cov_35.189165	714	795	18	1	81	0.0123457
NODE_3683_length_1225_cov_35.189165	714	795	19	4	81	0.0493827
NODE_3683_length_1225_cov_35.189165	714	795	20	1	81	0.0123457
NODE_3683_length_1225_cov_35.189165	714	795	21	22	81	0.2716049
NODE_3683_length_1225_cov_35.189165	714	795	22	5	81	0.0617284
NODE_3684_length_1225_cov_33.755773	456	535	6	1	79	0.0126582
NODE_3684_length_1225_cov_33.755773	456	535	7	20	79	0.2531646
NODE_3684_length_1225_cov_33.755773	456	535	8	21	79	0.2658228
NODE_3684_length_1225_cov_33.755773	456	535	9	34	79	0.4303797
NODE_3684_length_1225_cov_33.755773	456	535	10	3	79	0.0379747
NODE_3684_length_1225_cov_33.755773	508	588	9	62	80	0.7750000
NODE_3684_length_1225_cov_33.755773	508	588	10	3	80	0.0375000
NODE_3684_length_1225_cov_33.755773	508	588	11	15	80	0.1875000
NODE_3685_length_1225_cov_30.116341	566	646	1	11	80	0.1375000
NODE_3685_length_1225_cov_30.116341	566	646	2	23	80	0.2875000
NODE_3685_length_1225_cov_30.116341	566	646	3	23	80	0.2875000
NODE_3685_length_1225_cov_30.116341	566	646	4	19	80	0.2375000
NODE_3685_length_1225_cov_30.116341	566	646	6	4	80	0.0500000
NODE_3685_length_1225_cov_30.116341	619	699	3	4	80	0.0500000
NODE_3685_length_1225_cov_30.116341	619	699	4	19	80	0.2375000
NODE_3685_length_1225_cov_30.116341	619	699	6	57	80	0.7125000
NODE_3685_length_1225_cov_30.116341	695	775	1	2	80	0.0250000
NODE_3685_length_1225_cov_30.116341	695	775	2	4	80	0.0500000
NODE_3685_length_1225_cov_30.116341	695	775	4	19	80	0.2375000
NODE_3685_length_1225_cov_30.116341	695	775	5	29	80	0.3625000
NODE_3685_length_1225_cov_30.116341	695	775	6	26	80	0.3250000
NODE_3685_length_1225_cov_30.116341	748	828	1	55	80	0.6875000
NODE_3685_length_1225_cov_30.116341	748	828	2	4	80	0.0500000
NODE_3685_length_1225_cov_30.116341	748	828	4	19	80	0.2375000
NODE_3685_length_1225_cov_30.116341	748	828	5	2	80	0.0250000
NODE_3686_length_1225_cov_29.177620	195	275	3	9	80	0.1125000
NODE_3686_length_1225_cov_29.177620	195	275	5	6	80	0.0750000
NODE_3686_length_1225_cov_29.177620	195	275	7	6	80	0.0750000
NODE_3686_length_1225_cov_29.177620	195	275	8	1	80	0.0125000
NODE_3686_length_1225_cov_29.177620	195	275	10	58	80	0.7250000
NODE_3686_length_1225_cov_29.177620	248	328	5	32	80	0.4000000
NODE_3686_length_1225_cov_29.177620	248	328	6	3	80	0.0375000
NODE_3686_length_1225_cov_29.177620	248	328	8	4	80	0.0500000
NODE_3686_length_1225_cov_29.177620	248	328	10	41	80	0.5125000
NODE_3687_length_1225_cov_26.849023	588	668	0	34	80	0.4250000
NODE_3687_length_1225_cov_26.849023	588	668	2	46	80	0.5750000
NODE_3687_length_1225_cov_26.849023	641	721	2	80	80	1.0000000
NODE_3687_length_1225_cov_26.849023	717	797	0	48	80	0.6000000
NODE_3687_length_1225_cov_26.849023	717	797	2	32	80	0.4000000
NODE_3687_length_1225_cov_26.849023	770	850	0	80	80	1.0000000
NODE_3688_length_1225_cov_24.444938	386	466	6	9	80	0.1125000
NODE_3688_length_1225_cov_24.444938	386	466	7	12	80	0.1500000
NODE_3688_length_1225_cov_24.444938	386	466	8	4	80	0.0500000
NODE_3688_length_1225_cov_24.444938	386	466	9	5	80	0.0625000
NODE_3688_length_1225_cov_24.444938	386	466	10	47	80	0.5875000
NODE_3688_length_1225_cov_24.444938	386	466	11	3	80	0.0375000
NODE_3688_length_1225_cov_24.444938	439	519	5	34	80	0.4250000
NODE_3688_length_1225_cov_24.444938	439	519	7	6	80	0.0750000
NODE_3688_length_1225_cov_24.444938	439	519	8	1	80	0.0125000
NODE_3688_length_1225_cov_24.444938	439	519	10	39	80	0.4875000
NODE_3690_length_1225_cov_19.369449	491	571	1	9	80	0.1125000
NODE_3690_length_1225_cov_19.369449	491	571	3	2	80	0.0250000
NODE_3690_length_1225_cov_19.369449	491	571	4	16	80	0.2000000
NODE_3690_length_1225_cov_19.369449	491	571	6	25	80	0.3125000
NODE_3690_length_1225_cov_19.369449	491	571	7	28	80	0.3500000
NODE_3690_length_1225_cov_19.369449	544	624	6	4	80	0.0500000
NODE_3690_length_1225_cov_19.369449	544	624	7	29	80	0.3625000
NODE_3690_length_1225_cov_19.369449	544	624	8	45	80	0.5625000
NODE_3690_length_1225_cov_19.369449	544	624	9	2	80	0.0250000
NODE_3690_length_1225_cov_19.369449	620	700	5	18	80	0.2250000
NODE_3690_length_1225_cov_19.369449	620	700	6	20	80	0.2500000
NODE_3690_length_1225_cov_19.369449	620	700	7	15	80	0.1875000
NODE_3690_length_1225_cov_19.369449	620	700	8	3	80	0.0375000
NODE_3690_length_1225_cov_19.369449	620	700	9	24	80	0.3000000
NODE_3690_length_1225_cov_19.369449	673	753	3	7	80	0.0875000
NODE_3690_length_1225_cov_19.369449	673	753	5	33	80	0.4125000
NODE_3690_length_1225_cov_19.369449	673	753	6	33	80	0.4125000
NODE_3690_length_1225_cov_19.369449	673	753	7	7	80	0.0875000
NODE_3691_length_1225_cov_13.281528	462	542	3	7	80	0.0875000
NODE_3691_length_1225_cov_13.281528	462	542	5	36	80	0.4500000
NODE_3691_length_1225_cov_13.281528	462	542	6	24	80	0.3000000
NODE_3691_length_1225_cov_13.281528	462	542	8	13	80	0.1625000
NODE_3691_length_1225_cov_13.281528	515	595	5	4	80	0.0500000
NODE_3691_length_1225_cov_13.281528	515	595	6	52	80	0.6500000
NODE_3691_length_1225_cov_13.281528	515	595	7	4	80	0.0500000
NODE_3691_length_1225_cov_13.281528	515	595	8	20	80	0.2500000
NODE_3691_length_1225_cov_13.281528	591	671	6	16	80	0.2000000
NODE_3691_length_1225_cov_13.281528	591	671	7	63	80	0.7875000
NODE_3691_length_1225_cov_13.281528	591	671	8	1	80	0.0125000
NODE_3691_length_1225_cov_13.281528	644	724	2	28	80	0.3500000
NODE_3691_length_1225_cov_13.281528	644	724	4	19	80	0.2375000
NODE_3691_length_1225_cov_13.281528	644	724	6	22	80	0.2750000
NODE_3691_length_1225_cov_13.281528	644	724	7	11	80	0.1375000
NODE_3692_length_1225_cov_10.887211	566	646	7	14	80	0.1750000
NODE_3692_length_1225_cov_10.887211	566	646	8	25	80	0.3125000
NODE_3692_length_1225_cov_10.887211	566	646	9	41	80	0.5125000
NODE_3692_length_1225_cov_10.887211	619	699	7	16	80	0.2000000
NODE_3692_length_1225_cov_10.887211	619	699	8	18	80	0.2250000
NODE_3692_length_1225_cov_10.887211	619	699	9	46	80	0.5750000
NODE_3696_length_1224_cov_24.568889	613	693	1	5	80	0.0625000
NODE_3696_length_1224_cov_24.568889	613	693	2	1	80	0.0125000
NODE_3696_length_1224_cov_24.568889	613	693	3	9	80	0.1125000
NODE_3696_length_1224_cov_24.568889	613	693	4	9	80	0.1125000
NODE_3696_length_1224_cov_24.568889	613	693	5	1	80	0.0125000
NODE_3696_length_1224_cov_24.568889	613	693	6	8	80	0.1000000
NODE_3696_length_1224_cov_24.568889	613	693	7	19	80	0.2375000
NODE_3696_length_1224_cov_24.568889	613	693	9	17	80	0.2125000
NODE_3696_length_1224_cov_24.568889	613	693	10	11	80	0.1375000
NODE_3696_length_1224_cov_24.568889	666	746	9	48	80	0.6000000
NODE_3696_length_1224_cov_24.568889	666	746	10	32	80	0.4000000
NODE_3697_length_1224_cov_17.538667	762	842	6	43	80	0.5375000
NODE_3697_length_1224_cov_17.538667	762	842	7	6	80	0.0750000
NODE_3697_length_1224_cov_17.538667	762	842	8	13	80	0.1625000
NODE_3697_length_1224_cov_17.538667	762	842	9	18	80	0.2250000
NODE_3697_length_1224_cov_17.538667	815	895	7	3	80	0.0375000
NODE_3697_length_1224_cov_17.538667	815	895	8	33	80	0.4125000
NODE_3697_length_1224_cov_17.538667	815	895	9	32	80	0.4000000
NODE_3697_length_1224_cov_17.538667	815	895	10	9	80	0.1125000
NODE_3697_length_1224_cov_17.538667	815	895	12	3	80	0.0375000
NODE_3698_length_1224_cov_14.138667	389	469	3	29	80	0.3625000
NODE_3698_length_1224_cov_14.138667	389	469	5	26	80	0.3250000
NODE_3698_length_1224_cov_14.138667	389	469	6	25	80	0.3125000
NODE_3698_length_1224_cov_14.138667	442	522	5	2	80	0.0250000
NODE_3698_length_1224_cov_14.138667	442	522	6	78	80	0.9750000
NODE_3699_length_1224_cov_11.358222	704	784	2	24	80	0.3000000
NODE_3699_length_1224_cov_11.358222	704	784	4	56	80	0.7000000
NODE_3699_length_1224_cov_11.358222	757	837	2	22	80	0.2750000
NODE_3699_length_1224_cov_11.358222	757	837	4	58	80	0.7250000
NODE_3700_length_1224_cov_6.963556	516	581	3	13	65	0.2000000
NODE_3700_length_1224_cov_6.963556	516	581	4	1	65	0.0153846
NODE_3700_length_1224_cov_6.963556	516	581	5	2	65	0.0307692
NODE_3700_length_1224_cov_6.963556	516	581	6	18	65	0.2769231
NODE_3700_length_1224_cov_6.963556	516	581	7	31	65	0.4769231
NODE_3705_length_1223_cov_44.608541	548	630	7	37	82	0.4512195
NODE_3705_length_1223_cov_44.608541	548	630	8	9	82	0.1097561
NODE_3705_length_1223_cov_44.608541	548	630	9	11	82	0.1341463
NODE_3705_length_1223_cov_44.608541	548	630	10	25	82	0.3048781
NODE_3705_length_1223_cov_44.608541	601	683	6	16	82	0.1951219
NODE_3705_length_1223_cov_44.608541	601	683	8	3	82	0.0365854
NODE_3705_length_1223_cov_44.608541	601	683	9	28	82	0.3414634
NODE_3705_length_1223_cov_44.608541	601	683	10	35	82	0.4268293
NODE_3705_length_1223_cov_44.608541	679	759	2	3	80	0.0375000
NODE_3705_length_1223_cov_44.608541	679	759	3	12	80	0.1500000
NODE_3705_length_1223_cov_44.608541	679	759	5	18	80	0.2250000
NODE_3705_length_1223_cov_44.608541	679	759	6	47	80	0.5875000
NODE_3705_length_1223_cov_44.608541	732	812	2	8	80	0.1000000
NODE_3705_length_1223_cov_44.608541	732	812	3	60	80	0.7500000
NODE_3705_length_1223_cov_44.608541	732	812	5	9	80	0.1125000
NODE_3705_length_1223_cov_44.608541	732	812	6	3	80	0.0375000
NODE_3706_length_1223_cov_26.730427	508	588	8	4	80	0.0500000
NODE_3706_length_1223_cov_26.730427	508	588	9	24	80	0.3000000
NODE_3706_length_1223_cov_26.730427	508	588	10	19	80	0.2375000
NODE_3706_length_1223_cov_26.730427	508	588	11	33	80	0.4125000
NODE_3706_length_1223_cov_26.730427	561	641	7	5	80	0.0625000
NODE_3706_length_1223_cov_26.730427	561	641	8	14	80	0.1750000
NODE_3706_length_1223_cov_26.730427	561	641	9	28	80	0.3500000
NODE_3706_length_1223_cov_26.730427	561	641	10	22	80	0.2750000
NODE_3706_length_1223_cov_26.730427	561	641	11	11	80	0.1375000
NODE_3707_length_1223_cov_18.902135	460	540	7	15	80	0.1875000
NODE_3707_length_1223_cov_18.902135	460	540	8	18	80	0.2250000
NODE_3707_length_1223_cov_18.902135	460	540	9	21	80	0.2625000
NODE_3707_length_1223_cov_18.902135	460	540	10	26	80	0.3250000
NODE_3707_length_1223_cov_18.902135	513	593	1	9	80	0.1125000
NODE_3707_length_1223_cov_18.902135	513	593	3	29	80	0.3625000
NODE_3707_length_1223_cov_18.902135	513	593	4	5	80	0.0625000
NODE_3707_length_1223_cov_18.902135	513	593	5	1	80	0.0125000
NODE_3707_length_1223_cov_18.902135	513	593	6	2	80	0.0250000
NODE_3707_length_1223_cov_18.902135	513	593	7	22	80	0.2750000
NODE_3707_length_1223_cov_18.902135	513	593	8	12	80	0.1500000
NODE_3708_length_1223_cov_6.989324	707	778	0	71	71	1.0000000
NODE_3710_length_1223_cov_5.251779	666	746	2	9	80	0.1125000
NODE_3710_length_1223_cov_5.251779	666	746	3	51	80	0.6375000
NODE_3710_length_1223_cov_5.251779	666	746	4	20	80	0.2500000
NODE_3710_length_1223_cov_5.251779	719	799	2	28	80	0.3500000
NODE_3710_length_1223_cov_5.251779	719	799	3	52	80	0.6500000
NODE_3710_length_1223_cov_5.251779	795	875	0	52	80	0.6500000
NODE_3710_length_1223_cov_5.251779	795	875	2	28	80	0.3500000
NODE_3710_length_1223_cov_5.251779	848	928	0	80	80	1.0000000
NODE_3716_length_1222_cov_18.406946	273	353	1	80	80	1.0000000
NODE_3716_length_1222_cov_18.406946	326	406	0	34	80	0.4250000
NODE_3716_length_1222_cov_18.406946	326	406	1	46	80	0.5750000
NODE_3720_length_1221_cov_33.261141	505	577	4	33	72	0.4583333
NODE_3720_length_1221_cov_33.261141	505	577	5	39	72	0.5416667
NODE_3720_length_1221_cov_33.261141	558	637	1	25	79	0.3164557
NODE_3720_length_1221_cov_33.261141	558	637	3	17	79	0.2151899
NODE_3720_length_1221_cov_33.261141	558	637	4	33	79	0.4177215
NODE_3720_length_1221_cov_33.261141	558	637	5	4	79	0.0506329
NODE_3720_length_1221_cov_33.261141	633	713	1	6	80	0.0750000
NODE_3720_length_1221_cov_33.261141	633	713	2	27	80	0.3375000
NODE_3720_length_1221_cov_33.261141	633	713	3	40	80	0.5000000
NODE_3720_length_1221_cov_33.261141	633	713	4	7	80	0.0875000
NODE_3720_length_1221_cov_33.261141	686	766	3	80	80	1.0000000
NODE_3721_length_1221_cov_19.466132	541	621	4	15	80	0.1875000
NODE_3721_length_1221_cov_19.466132	541	621	5	3	80	0.0375000
NODE_3721_length_1221_cov_19.466132	541	621	7	14	80	0.1750000
NODE_3721_length_1221_cov_19.466132	541	621	8	23	80	0.2875000
NODE_3721_length_1221_cov_19.466132	541	621	9	25	80	0.3125000
NODE_3721_length_1221_cov_19.466132	594	674	6	5	80	0.0625000
NODE_3721_length_1221_cov_19.466132	594	674	8	8	80	0.1000000
NODE_3721_length_1221_cov_19.466132	594	674	9	27	80	0.3375000
NODE_3721_length_1221_cov_19.466132	594	674	10	8	80	0.1000000
NODE_3721_length_1221_cov_19.466132	594	674	11	32	80	0.4000000
NODE_3722_length_1221_cov_15.940285	788	868	2	55	80	0.6875000
NODE_3722_length_1221_cov_15.940285	788	868	3	19	80	0.2375000
NODE_3722_length_1221_cov_15.940285	788	868	4	6	80	0.0750000
NODE_3722_length_1221_cov_15.940285	841	921	2	2	80	0.0250000
NODE_3722_length_1221_cov_15.940285	841	921	3	72	80	0.9000000
NODE_3722_length_1221_cov_15.940285	841	921	4	6	80	0.0750000
NODE_3722_length_1221_cov_15.940285	917	997	2	26	80	0.3250000
NODE_3722_length_1221_cov_15.940285	917	997	3	20	80	0.2500000
NODE_3722_length_1221_cov_15.940285	917	997	4	22	80	0.2750000
NODE_3722_length_1221_cov_15.940285	917	997	5	6	80	0.0750000
NODE_3722_length_1221_cov_15.940285	917	997	6	6	80	0.0750000
NODE_3722_length_1221_cov_15.940285	970	1050	4	64	80	0.8000000
NODE_3722_length_1221_cov_15.940285	970	1050	5	10	80	0.1250000
NODE_3722_length_1221_cov_15.940285	970	1050	6	6	80	0.0750000
NODE_3723_length_1221_cov_15.796791	484	564	1	8	80	0.1000000
NODE_3723_length_1221_cov_15.796791	484	564	3	24	80	0.3000000
NODE_3723_length_1221_cov_15.796791	484	564	5	4	80	0.0500000
NODE_3723_length_1221_cov_15.796791	484	564	6	25	80	0.3125000
NODE_3723_length_1221_cov_15.796791	484	564	7	19	80	0.2375000
NODE_3723_length_1221_cov_15.796791	537	617	2	2	80	0.0250000
NODE_3723_length_1221_cov_15.796791	537	617	4	16	80	0.2000000
NODE_3723_length_1221_cov_15.796791	537	617	5	10	80	0.1250000
NODE_3723_length_1221_cov_15.796791	537	617	6	33	80	0.4125000
NODE_3723_length_1221_cov_15.796791	537	617	7	19	80	0.2375000
NODE_3724_length_1221_cov_15.312834	342	415	6	10	73	0.1369863
NODE_3724_length_1221_cov_15.312834	342	415	7	12	73	0.1643836
NODE_3724_length_1221_cov_15.312834	342	415	8	7	73	0.0958904
NODE_3724_length_1221_cov_15.312834	342	415	11	19	73	0.2602740
NODE_3724_length_1221_cov_15.312834	342	415	12	8	73	0.1095890
NODE_3724_length_1221_cov_15.312834	342	415	13	10	73	0.1369863
NODE_3724_length_1221_cov_15.312834	342	415	14	7	73	0.0958904
NODE_3724_length_1221_cov_15.312834	395	474	9	3	79	0.0379747
NODE_3724_length_1221_cov_15.312834	395	474	11	4	79	0.0506329
NODE_3724_length_1221_cov_15.312834	395	474	12	14	79	0.1772152
NODE_3724_length_1221_cov_15.312834	395	474	13	40	79	0.5063291
NODE_3724_length_1221_cov_15.312834	395	474	14	18	79	0.2278481
NODE_3725_length_1221_cov_9.695187	988	1068	1	4	80	0.0500000
NODE_3725_length_1221_cov_9.695187	988	1068	2	4	80	0.0500000
NODE_3725_length_1221_cov_9.695187	988	1068	3	72	80	0.9000000
NODE_3725_length_1221_cov_9.695187	1041	1100	0	27	59	0.4576271
NODE_3725_length_1221_cov_9.695187	1041	1100	1	9	59	0.1525424
NODE_3725_length_1221_cov_9.695187	1041	1100	2	4	59	0.0677966
NODE_3725_length_1221_cov_9.695187	1041	1100	3	19	59	0.3220339
NODE_3726_length_1221_cov_9.043672	695	775	0	80	80	1.0000000
NODE_3726_length_1221_cov_9.043672	748	828	0	80	80	1.0000000
NODE_3727_length_1221_cov_7.946524	147	227	2	60	80	0.7500000
NODE_3727_length_1221_cov_7.946524	147	227	3	3	80	0.0375000
NODE_3727_length_1221_cov_7.946524	147	227	4	15	80	0.1875000
NODE_3727_length_1221_cov_7.946524	147	227	5	2	80	0.0250000
NODE_3727_length_1221_cov_7.946524	200	280	2	7	80	0.0875000
NODE_3727_length_1221_cov_7.946524	200	280	3	30	80	0.3750000
NODE_3727_length_1221_cov_7.946524	200	280	4	20	80	0.2500000
NODE_3727_length_1221_cov_7.946524	200	280	5	23	80	0.2875000
NODE_3728_length_1221_cov_5.122103	248	328	0	80	80	1.0000000
NODE_3728_length_1221_cov_5.122103	301	381	0	80	80	1.0000000
NODE_3736_length_1220_cov_44.501338	319	399	13	8	80	0.1000000
NODE_3736_length_1220_cov_44.501338	319	399	14	2	80	0.0250000
NODE_3736_length_1220_cov_44.501338	319	399	15	49	80	0.6125000
NODE_3736_length_1220_cov_44.501338	319	399	16	16	80	0.2000000
NODE_3736_length_1220_cov_44.501338	319	399	18	5	80	0.0625000
NODE_3736_length_1220_cov_44.501338	372	452	13	5	80	0.0625000
NODE_3736_length_1220_cov_44.501338	372	452	14	7	80	0.0875000
NODE_3736_length_1220_cov_44.501338	372	452	15	13	80	0.1625000
NODE_3736_length_1220_cov_44.501338	372	452	16	9	80	0.1125000
NODE_3736_length_1220_cov_44.501338	372	452	17	15	80	0.1875000
NODE_3736_length_1220_cov_44.501338	372	452	18	13	80	0.1625000
NODE_3736_length_1220_cov_44.501338	372	452	19	18	80	0.2250000
NODE_3736_length_1220_cov_44.501338	448	528	9	10	80	0.1250000
NODE_3736_length_1220_cov_44.501338	448	528	10	4	80	0.0500000
NODE_3736_length_1220_cov_44.501338	448	528	11	33	80	0.4125000
NODE_3736_length_1220_cov_44.501338	448	528	12	29	80	0.3625000
NODE_3736_length_1220_cov_44.501338	448	528	13	4	80	0.0500000
NODE_3736_length_1220_cov_44.501338	501	581	6	2	80	0.0250000
NODE_3736_length_1220_cov_44.501338	501	581	7	12	80	0.1500000
NODE_3736_length_1220_cov_44.501338	501	581	8	23	80	0.2875000
NODE_3736_length_1220_cov_44.501338	501	581	10	3	80	0.0375000
NODE_3736_length_1220_cov_44.501338	501	581	11	25	80	0.3125000
NODE_3736_length_1220_cov_44.501338	501	581	12	15	80	0.1875000
NODE_3737_length_1220_cov_43.868867	720	800	12	7	80	0.0875000
NODE_3737_length_1220_cov_43.868867	720	800	14	7	80	0.0875000
NODE_3737_length_1220_cov_43.868867	720	800	16	1	80	0.0125000
NODE_3737_length_1220_cov_43.868867	720	800	17	3	80	0.0375000
NODE_3737_length_1220_cov_43.868867	720	800	19	8	80	0.1000000
NODE_3737_length_1220_cov_43.868867	720	800	21	1	80	0.0125000
NODE_3737_length_1220_cov_43.868867	720	800	22	14	80	0.1750000
NODE_3737_length_1220_cov_43.868867	720	800	23	8	80	0.1000000
NODE_3737_length_1220_cov_43.868867	720	800	24	29	80	0.3625000
NODE_3737_length_1220_cov_43.868867	720	800	25	2	80	0.0250000
NODE_3737_length_1220_cov_43.868867	773	853	18	1	80	0.0125000
NODE_3737_length_1220_cov_43.868867	773	853	19	7	80	0.0875000
NODE_3737_length_1220_cov_43.868867	773	853	20	14	80	0.1750000
NODE_3737_length_1220_cov_43.868867	773	853	21	2	80	0.0250000
NODE_3737_length_1220_cov_43.868867	773	853	22	12	80	0.1500000
NODE_3737_length_1220_cov_43.868867	773	853	23	11	80	0.1375000
NODE_3737_length_1220_cov_43.868867	773	853	24	33	80	0.4125000
NODE_3738_length_1220_cov_41.900089	593	673	15	3	80	0.0375000
NODE_3738_length_1220_cov_41.900089	593	673	16	28	80	0.3500000
NODE_3738_length_1220_cov_41.900089	593	673	17	9	80	0.1125000
NODE_3738_length_1220_cov_41.900089	593	673	18	28	80	0.3500000
NODE_3738_length_1220_cov_41.900089	593	673	19	12	80	0.1500000
NODE_3738_length_1220_cov_41.900089	646	726	15	26	80	0.3250000
NODE_3738_length_1220_cov_41.900089	646	726	16	12	80	0.1500000
NODE_3738_length_1220_cov_41.900089	646	726	17	13	80	0.1625000
NODE_3738_length_1220_cov_41.900089	646	726	18	24	80	0.3000000
NODE_3738_length_1220_cov_41.900089	646	726	19	3	80	0.0375000
NODE_3738_length_1220_cov_41.900089	646	726	20	2	80	0.0250000
NODE_3738_length_1220_cov_41.900089	722	802	9	30	80	0.3750000
NODE_3738_length_1220_cov_41.900089	722	802	10	3	80	0.0375000
NODE_3738_length_1220_cov_41.900089	722	802	11	16	80	0.2000000
NODE_3738_length_1220_cov_41.900089	722	802	12	15	80	0.1875000
NODE_3738_length_1220_cov_41.900089	722	802	13	5	80	0.0625000
NODE_3738_length_1220_cov_41.900089	722	802	14	4	80	0.0500000
NODE_3738_length_1220_cov_41.900089	722	802	15	7	80	0.0875000
NODE_3738_length_1220_cov_41.900089	775	855	4	20	80	0.2500000
NODE_3738_length_1220_cov_41.900089	775	855	6	1	80	0.0125000
NODE_3738_length_1220_cov_41.900089	775	855	7	13	80	0.1625000
NODE_3738_length_1220_cov_41.900089	775	855	8	8	80	0.1000000
NODE_3738_length_1220_cov_41.900089	775	855	9	36	80	0.4500000
NODE_3738_length_1220_cov_41.900089	775	855	10	2	80	0.0250000
NODE_3739_length_1220_cov_15.485281	395	475	4	80	80	1.0000000
NODE_3739_length_1220_cov_15.485281	448	528	0	36	80	0.4500000
NODE_3739_length_1220_cov_15.485281	448	528	2	5	80	0.0625000
NODE_3739_length_1220_cov_15.485281	448	528	4	39	80	0.4875000
NODE_3745_length_1219_cov_30.493750	643	723	1	16	80	0.2000000
NODE_3745_length_1219_cov_30.493750	643	723	2	10	80	0.1250000
NODE_3745_length_1219_cov_30.493750	643	723	3	11	80	0.1375000
NODE_3745_length_1219_cov_30.493750	643	723	4	8	80	0.1000000
NODE_3745_length_1219_cov_30.493750	643	723	5	35	80	0.4375000
NODE_3745_length_1219_cov_30.493750	696	776	4	13	80	0.1625000
NODE_3745_length_1219_cov_30.493750	696	776	5	43	80	0.5375000
NODE_3745_length_1219_cov_30.493750	696	776	6	24	80	0.3000000
NODE_3745_length_1219_cov_30.493750	772	852	3	25	80	0.3125000
NODE_3745_length_1219_cov_30.493750	772	852	4	30	80	0.3750000
NODE_3745_length_1219_cov_30.493750	772	852	5	7	80	0.0875000
NODE_3745_length_1219_cov_30.493750	772	852	6	18	80	0.2250000
NODE_3745_length_1219_cov_30.493750	825	905	1	3	80	0.0375000
NODE_3745_length_1219_cov_30.493750	825	905	2	23	80	0.2875000
NODE_3745_length_1219_cov_30.493750	825	905	3	49	80	0.6125000
NODE_3745_length_1219_cov_30.493750	825	905	4	5	80	0.0625000
NODE_3746_length_1219_cov_24.991071	566	646	11	32	80	0.4000000
NODE_3746_length_1219_cov_24.991071	566	646	13	1	80	0.0125000
NODE_3746_length_1219_cov_24.991071	566	646	14	33	80	0.4125000
NODE_3746_length_1219_cov_24.991071	566	646	15	14	80	0.1750000
NODE_3746_length_1219_cov_24.991071	619	699	8	15	80	0.1875000
NODE_3746_length_1219_cov_24.991071	619	699	9	11	80	0.1375000
NODE_3746_length_1219_cov_24.991071	619	699	10	3	80	0.0375000
NODE_3746_length_1219_cov_24.991071	619	699	11	5	80	0.0625000
NODE_3746_length_1219_cov_24.991071	619	699	12	5	80	0.0625000
NODE_3746_length_1219_cov_24.991071	619	699	13	2	80	0.0250000
NODE_3746_length_1219_cov_24.991071	619	699	14	25	80	0.3125000
NODE_3746_length_1219_cov_24.991071	619	699	15	14	80	0.1750000
NODE_3746_length_1219_cov_24.991071	695	775	6	26	80	0.3250000
NODE_3746_length_1219_cov_24.991071	695	775	7	22	80	0.2750000
NODE_3746_length_1219_cov_24.991071	695	775	9	12	80	0.1500000
NODE_3746_length_1219_cov_24.991071	695	775	10	8	80	0.1000000
NODE_3746_length_1219_cov_24.991071	695	775	12	12	80	0.1500000
NODE_3746_length_1219_cov_24.991071	748	828	2	18	80	0.2250000
NODE_3746_length_1219_cov_24.991071	748	828	3	16	80	0.2000000
NODE_3746_length_1219_cov_24.991071	748	828	5	12	80	0.1500000
NODE_3746_length_1219_cov_24.991071	748	828	6	33	80	0.4125000
NODE_3746_length_1219_cov_24.991071	748	828	7	1	80	0.0125000
NODE_3747_length_1219_cov_24.728571	465	545	2	76	80	0.9500000
NODE_3747_length_1219_cov_24.728571	465	545	4	4	80	0.0500000
NODE_3747_length_1219_cov_24.728571	518	598	2	23	80	0.2875000
NODE_3747_length_1219_cov_24.728571	518	598	4	6	80	0.0750000
NODE_3747_length_1219_cov_24.728571	518	598	5	17	80	0.2125000
NODE_3747_length_1219_cov_24.728571	518	598	6	10	80	0.1250000
NODE_3747_length_1219_cov_24.728571	518	598	7	6	80	0.0750000
NODE_3747_length_1219_cov_24.728571	518	598	9	18	80	0.2250000
NODE_3747_length_1219_cov_24.728571	594	674	9	60	80	0.7500000
NODE_3747_length_1219_cov_24.728571	594	674	10	20	80	0.2500000
NODE_3747_length_1219_cov_24.728571	647	727	3	1	80	0.0125000
NODE_3747_length_1219_cov_24.728571	647	727	4	1	80	0.0125000
NODE_3747_length_1219_cov_24.728571	647	727	5	15	80	0.1875000
NODE_3747_length_1219_cov_24.728571	647	727	6	11	80	0.1375000
NODE_3747_length_1219_cov_24.728571	647	727	7	6	80	0.0750000
NODE_3747_length_1219_cov_24.728571	647	727	8	2	80	0.0250000
NODE_3747_length_1219_cov_24.728571	647	727	9	7	80	0.0875000
NODE_3747_length_1219_cov_24.728571	647	727	10	37	80	0.4625000
NODE_3748_length_1219_cov_11.130357	535	615	2	12	80	0.1500000
NODE_3748_length_1219_cov_11.130357	535	615	3	50	80	0.6250000
NODE_3748_length_1219_cov_11.130357	535	615	5	18	80	0.2250000
NODE_3748_length_1219_cov_11.130357	588	668	3	18	80	0.2250000
NODE_3748_length_1219_cov_11.130357	588	668	4	37	80	0.4625000
NODE_3748_length_1219_cov_11.130357	588	668	5	25	80	0.3125000
NODE_3749_length_1219_cov_9.696429	734	814	2	19	80	0.2375000
NODE_3749_length_1219_cov_9.696429	734	814	3	61	80	0.7625000
NODE_3749_length_1219_cov_9.696429	787	867	0	52	80	0.6500000
NODE_3749_length_1219_cov_9.696429	787	867	2	20	80	0.2500000
NODE_3749_length_1219_cov_9.696429	787	867	3	8	80	0.1000000
NODE_3754_length_1218_cov_40.159071	554	634	6	20	80	0.2500000
NODE_3754_length_1218_cov_40.159071	554	634	8	1	80	0.0125000
NODE_3754_length_1218_cov_40.159071	554	634	10	3	80	0.0375000
NODE_3754_length_1218_cov_40.159071	554	634	12	1	80	0.0125000
NODE_3754_length_1218_cov_40.159071	554	634	13	6	80	0.0750000
NODE_3754_length_1218_cov_40.159071	554	634	14	23	80	0.2875000
NODE_3754_length_1218_cov_40.159071	554	634	15	5	80	0.0625000
NODE_3754_length_1218_cov_40.159071	554	634	16	20	80	0.2500000
NODE_3754_length_1218_cov_40.159071	554	634	17	1	80	0.0125000
NODE_3754_length_1218_cov_40.159071	607	687	11	2	80	0.0250000
NODE_3754_length_1218_cov_40.159071	607	687	12	7	80	0.0875000
NODE_3754_length_1218_cov_40.159071	607	687	13	2	80	0.0250000
NODE_3754_length_1218_cov_40.159071	607	687	14	10	80	0.1250000
NODE_3754_length_1218_cov_40.159071	607	687	15	1	80	0.0125000
NODE_3754_length_1218_cov_40.159071	607	687	16	47	80	0.5875000
NODE_3754_length_1218_cov_40.159071	607	687	17	11	80	0.1375000
NODE_3754_length_1218_cov_40.159071	683	763	8	1	80	0.0125000
NODE_3754_length_1218_cov_40.159071	683	763	9	23	80	0.2875000
NODE_3754_length_1218_cov_40.159071	683	763	10	33	80	0.4125000
NODE_3754_length_1218_cov_40.159071	683	763	11	11	80	0.1375000
NODE_3754_length_1218_cov_40.159071	683	763	12	8	80	0.1000000
NODE_3754_length_1218_cov_40.159071	683	763	14	4	80	0.0500000
NODE_3754_length_1218_cov_40.159071	736	816	4	13	80	0.1625000
NODE_3754_length_1218_cov_40.159071	736	816	5	1	80	0.0125000
NODE_3754_length_1218_cov_40.159071	736	816	6	10	80	0.1250000
NODE_3754_length_1218_cov_40.159071	736	816	7	29	80	0.3625000
NODE_3754_length_1218_cov_40.159071	736	816	8	1	80	0.0125000
NODE_3754_length_1218_cov_40.159071	736	816	9	23	80	0.2875000
NODE_3754_length_1218_cov_40.159071	736	816	10	3	80	0.0375000
NODE_3765_length_1216_cov_99.538944	44	124	21	2	80	0.0250000
NODE_3765_length_1216_cov_99.538944	44	124	22	2	80	0.0250000
NODE_3765_length_1216_cov_99.538944	44	124	23	3	80	0.0375000
NODE_3765_length_1216_cov_99.538944	44	124	24	1	80	0.0125000
NODE_3765_length_1216_cov_99.538944	44	124	26	2	80	0.0250000
NODE_3765_length_1216_cov_99.538944	44	124	28	2	80	0.0250000
NODE_3765_length_1216_cov_99.538944	44	124	29	2	80	0.0250000
NODE_3765_length_1216_cov_99.538944	44	124	31	1	80	0.0125000
NODE_3765_length_1216_cov_99.538944	44	124	33	3	80	0.0375000
NODE_3765_length_1216_cov_99.538944	44	124	34	1	80	0.0125000
NODE_3765_length_1216_cov_99.538944	44	124	36	2	80	0.0250000
NODE_3765_length_1216_cov_99.538944	44	124	37	4	80	0.0500000
NODE_3765_length_1216_cov_99.538944	44	124	40	2	80	0.0250000
NODE_3765_length_1216_cov_99.538944	44	124	42	1	80	0.0125000
NODE_3765_length_1216_cov_99.538944	44	124	45	1	80	0.0125000
NODE_3765_length_1216_cov_99.538944	44	124	46	2	80	0.0250000
NODE_3765_length_1216_cov_99.538944	44	124	47	1	80	0.0125000
NODE_3765_length_1216_cov_99.538944	44	124	50	6	80	0.0750000
NODE_3765_length_1216_cov_99.538944	44	124	51	1	80	0.0125000
NODE_3765_length_1216_cov_99.538944	44	124	53	2	80	0.0250000
NODE_3765_length_1216_cov_99.538944	44	124	57	1	80	0.0125000
NODE_3765_length_1216_cov_99.538944	44	124	59	1	80	0.0125000
NODE_3765_length_1216_cov_99.538944	44	124	62	1	80	0.0125000
NODE_3765_length_1216_cov_99.538944	44	124	63	10	80	0.1250000
NODE_3765_length_1216_cov_99.538944	44	124	67	2	80	0.0250000
NODE_3765_length_1216_cov_99.538944	44	124	69	2	80	0.0250000
NODE_3765_length_1216_cov_99.538944	44	124	70	2	80	0.0250000
NODE_3765_length_1216_cov_99.538944	44	124	71	4	80	0.0500000
NODE_3765_length_1216_cov_99.538944	44	124	72	1	80	0.0125000
NODE_3765_length_1216_cov_99.538944	44	124	73	3	80	0.0375000
NODE_3765_length_1216_cov_99.538944	44	124	75	3	80	0.0375000
NODE_3765_length_1216_cov_99.538944	44	124	77	1	80	0.0125000
NODE_3765_length_1216_cov_99.538944	44	124	78	1	80	0.0125000
NODE_3765_length_1216_cov_99.538944	44	124	79	1	80	0.0125000
NODE_3765_length_1216_cov_99.538944	44	124	80	1	80	0.0125000
NODE_3765_length_1216_cov_99.538944	44	124	81	2	80	0.0250000
NODE_3765_length_1216_cov_99.538944	44	124	83	3	80	0.0375000
NODE_3765_length_1216_cov_99.538944	97	157	63	1	60	0.0166667
NODE_3765_length_1216_cov_99.538944	97	157	67	2	60	0.0333333
NODE_3765_length_1216_cov_99.538944	97	157	69	2	60	0.0333333
NODE_3765_length_1216_cov_99.538944	97	157	70	2	60	0.0333333
NODE_3765_length_1216_cov_99.538944	97	157	71	4	60	0.0666667
NODE_3765_length_1216_cov_99.538944	97	157	72	1	60	0.0166667
NODE_3765_length_1216_cov_99.538944	97	157	73	3	60	0.0500000
NODE_3765_length_1216_cov_99.538944	97	157	75	3	60	0.0500000
NODE_3765_length_1216_cov_99.538944	97	157	77	1	60	0.0166667
NODE_3765_length_1216_cov_99.538944	97	157	78	1	60	0.0166667
NODE_3765_length_1216_cov_99.538944	97	157	79	1	60	0.0166667
NODE_3765_length_1216_cov_99.538944	97	157	80	13	60	0.2166667
NODE_3765_length_1216_cov_99.538944	97	157	81	9	60	0.1500000
NODE_3765_length_1216_cov_99.538944	97	157	82	2	60	0.0333333
NODE_3765_length_1216_cov_99.538944	97	157	83	6	60	0.1000000
NODE_3765_length_1216_cov_99.538944	97	157	84	5	60	0.0833333
NODE_3765_length_1216_cov_99.538944	97	157	85	1	60	0.0166667
NODE_3765_length_1216_cov_99.538944	97	157	86	3	60	0.0500000
NODE_3765_length_1216_cov_99.538944	824	903	50	2	79	0.0253165
NODE_3765_length_1216_cov_99.538944	824	903	51	1	79	0.0126582
NODE_3765_length_1216_cov_99.538944	824	903	55	1	79	0.0126582
NODE_3765_length_1216_cov_99.538944	824	903	56	1	79	0.0126582
NODE_3765_length_1216_cov_99.538944	824	903	58	1	79	0.0126582
NODE_3765_length_1216_cov_99.538944	824	903	59	2	79	0.0253165
NODE_3765_length_1216_cov_99.538944	824	903	60	3	79	0.0379747
NODE_3765_length_1216_cov_99.538944	824	903	61	4	79	0.0506329
NODE_3765_length_1216_cov_99.538944	824	903	62	6	79	0.0759494
NODE_3765_length_1216_cov_99.538944	824	903	63	4	79	0.0506329
NODE_3765_length_1216_cov_99.538944	824	903	64	9	79	0.1139240
NODE_3765_length_1216_cov_99.538944	824	903	65	13	79	0.1645570
NODE_3765_length_1216_cov_99.538944	824	903	66	6	79	0.0759494
NODE_3765_length_1216_cov_99.538944	824	903	67	7	79	0.0886076
NODE_3765_length_1216_cov_99.538944	824	903	68	13	79	0.1645570
NODE_3765_length_1216_cov_99.538944	824	903	69	4	79	0.0506329
NODE_3765_length_1216_cov_99.538944	824	903	70	2	79	0.0253165
NODE_3766_length_1216_cov_15.855864	668	748	4	40	80	0.5000000
NODE_3766_length_1216_cov_15.855864	668	748	6	40	80	0.5000000
NODE_3766_length_1216_cov_15.855864	721	801	2	38	80	0.4750000
NODE_3766_length_1216_cov_15.855864	721	801	3	1	80	0.0125000
NODE_3766_length_1216_cov_15.855864	721	801	4	17	80	0.2125000
NODE_3766_length_1216_cov_15.855864	721	801	6	24	80	0.3000000
NODE_3767_length_1216_cov_4.128917	720	800	1	51	80	0.6375000
NODE_3767_length_1216_cov_4.128917	720	800	2	29	80	0.3625000
NODE_3767_length_1216_cov_4.128917	773	853	1	59	80	0.7375000
NODE_3767_length_1216_cov_4.128917	773	853	2	21	80	0.2625000
NODE_3774_length_1215_cov_32.293011	411	491	2	4	80	0.0500000
NODE_3774_length_1215_cov_32.293011	411	491	4	53	80	0.6625000
NODE_3774_length_1215_cov_32.293011	411	491	5	14	80	0.1750000
NODE_3774_length_1215_cov_32.293011	411	491	6	9	80	0.1125000
NODE_3774_length_1215_cov_32.293011	464	544	1	27	80	0.3375000
NODE_3774_length_1215_cov_32.293011	464	544	2	30	80	0.3750000
NODE_3774_length_1215_cov_32.293011	464	544	4	23	80	0.2875000
NODE_3775_length_1215_cov_24.177419	729	809	2	22	80	0.2750000
NODE_3775_length_1215_cov_24.177419	729	809	3	54	80	0.6750000
NODE_3775_length_1215_cov_24.177419	729	809	4	4	80	0.0500000
NODE_3775_length_1215_cov_24.177419	782	862	1	32	80	0.4000000
NODE_3775_length_1215_cov_24.177419	782	862	2	43	80	0.5375000
NODE_3775_length_1215_cov_24.177419	782	862	3	5	80	0.0625000
NODE_3776_length_1215_cov_21.566308	645	725	16	1	80	0.0125000
NODE_3776_length_1215_cov_21.566308	645	725	18	12	80	0.1500000
NODE_3776_length_1215_cov_21.566308	645	725	19	17	80	0.2125000
NODE_3776_length_1215_cov_21.566308	645	725	20	12	80	0.1500000
NODE_3776_length_1215_cov_21.566308	645	725	21	15	80	0.1875000
NODE_3776_length_1215_cov_21.566308	645	725	22	23	80	0.2875000
NODE_3776_length_1215_cov_21.566308	698	778	15	10	80	0.1250000
NODE_3776_length_1215_cov_21.566308	698	778	20	6	80	0.0750000
NODE_3776_length_1215_cov_21.566308	698	778	21	21	80	0.2625000
NODE_3776_length_1215_cov_21.566308	698	778	22	43	80	0.5375000
NODE_3777_length_1215_cov_19.278674	630	710	2	11	80	0.1375000
NODE_3777_length_1215_cov_19.278674	630	710	3	55	80	0.6875000
NODE_3777_length_1215_cov_19.278674	630	710	4	13	80	0.1625000
NODE_3777_length_1215_cov_19.278674	630	710	6	1	80	0.0125000
NODE_3777_length_1215_cov_19.278674	683	763	2	51	80	0.6375000
NODE_3777_length_1215_cov_19.278674	683	763	3	29	80	0.3625000
NODE_3778_length_1215_cov_15.074373	664	744	0	80	80	1.0000000
NODE_3778_length_1215_cov_15.074373	717	797	0	80	80	1.0000000
NODE_3779_length_1215_cov_5.932796	507	587	0	80	80	1.0000000
NODE_3779_length_1215_cov_5.932796	560	640	0	80	80	1.0000000
NODE_3787_length_1214_cov_26.771300	420	500	24	9	80	0.1125000
NODE_3787_length_1214_cov_26.771300	420	500	25	7	80	0.0875000
NODE_3787_length_1214_cov_26.771300	420	500	26	9	80	0.1125000
NODE_3787_length_1214_cov_26.771300	420	500	29	9	80	0.1125000
NODE_3787_length_1214_cov_26.771300	420	500	31	17	80	0.2125000
NODE_3787_length_1214_cov_26.771300	420	500	32	17	80	0.2125000
NODE_3787_length_1214_cov_26.771300	420	500	33	3	80	0.0375000
NODE_3787_length_1214_cov_26.771300	420	500	34	7	80	0.0875000
NODE_3787_length_1214_cov_26.771300	420	500	35	2	80	0.0250000
NODE_3787_length_1214_cov_26.771300	473	553	15	1	80	0.0125000
NODE_3787_length_1214_cov_26.771300	473	553	16	3	80	0.0375000
NODE_3787_length_1214_cov_26.771300	473	553	18	2	80	0.0250000
NODE_3787_length_1214_cov_26.771300	473	553	20	9	80	0.1125000
NODE_3787_length_1214_cov_26.771300	473	553	22	9	80	0.1125000
NODE_3787_length_1214_cov_26.771300	473	553	23	2	80	0.0250000
NODE_3787_length_1214_cov_26.771300	473	553	25	7	80	0.0875000
NODE_3787_length_1214_cov_26.771300	473	553	26	1	80	0.0125000
NODE_3787_length_1214_cov_26.771300	473	553	27	9	80	0.1125000
NODE_3787_length_1214_cov_26.771300	473	553	28	4	80	0.0500000
NODE_3787_length_1214_cov_26.771300	473	553	29	10	80	0.1250000
NODE_3787_length_1214_cov_26.771300	473	553	31	17	80	0.2125000
NODE_3787_length_1214_cov_26.771300	473	553	33	2	80	0.0250000
NODE_3787_length_1214_cov_26.771300	473	553	34	2	80	0.0250000
NODE_3787_length_1214_cov_26.771300	473	553	35	2	80	0.0250000
NODE_3788_length_1214_cov_24.555157	480	560	8	27	80	0.3375000
NODE_3788_length_1214_cov_24.555157	480	560	9	33	80	0.4125000
NODE_3788_length_1214_cov_24.555157	480	560	10	20	80	0.2500000
NODE_3788_length_1214_cov_24.555157	533	613	6	18	80	0.2250000
NODE_3788_length_1214_cov_24.555157	533	613	7	14	80	0.1750000
NODE_3788_length_1214_cov_24.555157	533	613	9	15	80	0.1875000
NODE_3788_length_1214_cov_24.555157	533	613	10	33	80	0.4125000
NODE_3789_length_1214_cov_23.167713	623	703	1	23	80	0.2875000
NODE_3789_length_1214_cov_23.167713	623	703	2	57	80	0.7125000
NODE_3789_length_1214_cov_23.167713	676	756	1	45	80	0.5625000
NODE_3789_length_1214_cov_23.167713	676	756	2	35	80	0.4375000
NODE_3790_length_1214_cov_18.452915	555	635	2	56	80	0.7000000
NODE_3790_length_1214_cov_18.452915	555	635	3	24	80	0.3000000
NODE_3790_length_1214_cov_18.452915	608	688	0	23	80	0.2875000
NODE_3790_length_1214_cov_18.452915	608	688	1	18	80	0.2250000
NODE_3790_length_1214_cov_18.452915	608	688	2	39	80	0.4875000
NODE_3790_length_1214_cov_18.452915	684	764	0	80	80	1.0000000
NODE_3790_length_1214_cov_18.452915	737	817	0	80	80	1.0000000
NODE_3791_length_1214_cov_8.906726	206	286	0	80	80	1.0000000
NODE_3791_length_1214_cov_8.906726	259	339	0	80	80	1.0000000
NODE_3792_length_1214_cov_3.686996	415	495	1	2	80	0.0250000
NODE_3792_length_1214_cov_3.686996	415	495	2	57	80	0.7125000
NODE_3792_length_1214_cov_3.686996	415	495	3	21	80	0.2625000
NODE_3792_length_1214_cov_3.686996	468	548	1	2	80	0.0250000
NODE_3792_length_1214_cov_3.686996	468	548	2	57	80	0.7125000
NODE_3792_length_1214_cov_3.686996	468	548	3	21	80	0.2625000
NODE_3799_length_1214_cov_0.967713	1049	1129	32	1	80	0.0125000
NODE_3799_length_1214_cov_0.967713	1049	1129	34	2	80	0.0250000
NODE_3799_length_1214_cov_0.967713	1049	1129	35	1	80	0.0125000
NODE_3799_length_1214_cov_0.967713	1049	1129	37	4	80	0.0500000
NODE_3799_length_1214_cov_0.967713	1049	1129	38	24	80	0.3000000
NODE_3799_length_1214_cov_0.967713	1049	1129	39	9	80	0.1125000
NODE_3799_length_1214_cov_0.967713	1049	1129	40	9	80	0.1125000
NODE_3799_length_1214_cov_0.967713	1049	1129	41	3	80	0.0375000
NODE_3799_length_1214_cov_0.967713	1049	1129	42	1	80	0.0125000
NODE_3799_length_1214_cov_0.967713	1049	1129	43	4	80	0.0500000
NODE_3799_length_1214_cov_0.967713	1049	1129	44	1	80	0.0125000
NODE_3799_length_1214_cov_0.967713	1049	1129	45	21	80	0.2625000
NODE_3800_length_1213_cov_19.524237	499	579	1	6	80	0.0750000
NODE_3800_length_1213_cov_19.524237	499	579	2	74	80	0.9250000
NODE_3800_length_1213_cov_19.524237	552	632	1	11	80	0.1375000
NODE_3800_length_1213_cov_19.524237	552	632	2	69	80	0.8625000
NODE_3806_length_1212_cov_32.663073	688	768	18	5	80	0.0625000
NODE_3806_length_1212_cov_32.663073	688	768	19	21	80	0.2625000
NODE_3806_length_1212_cov_32.663073	688	768	20	34	80	0.4250000
NODE_3806_length_1212_cov_32.663073	688	768	21	20	80	0.2500000
NODE_3806_length_1212_cov_32.663073	741	821	6	1	80	0.0125000
NODE_3806_length_1212_cov_32.663073	741	821	7	16	80	0.2000000
NODE_3806_length_1212_cov_32.663073	741	821	8	2	80	0.0250000
NODE_3806_length_1212_cov_32.663073	741	821	9	2	80	0.0250000
NODE_3806_length_1212_cov_32.663073	741	821	12	2	80	0.0250000
NODE_3806_length_1212_cov_32.663073	741	821	13	9	80	0.1125000
NODE_3806_length_1212_cov_32.663073	741	821	14	6	80	0.0750000
NODE_3806_length_1212_cov_32.663073	741	821	15	1	80	0.0125000
NODE_3806_length_1212_cov_32.663073	741	821	16	9	80	0.1125000
NODE_3806_length_1212_cov_32.663073	741	821	18	2	80	0.0250000
NODE_3806_length_1212_cov_32.663073	741	821	19	10	80	0.1250000
NODE_3806_length_1212_cov_32.663073	741	821	20	12	80	0.1500000
NODE_3806_length_1212_cov_32.663073	741	821	21	8	80	0.1000000
NODE_3807_length_1212_cov_15.981132	33	113	0	70	80	0.8750000
NODE_3807_length_1212_cov_15.981132	33	113	1	10	80	0.1250000
NODE_3807_length_1212_cov_15.981132	511	591	6	6	80	0.0750000
NODE_3807_length_1212_cov_15.981132	511	591	7	37	80	0.4625000
NODE_3807_length_1212_cov_15.981132	511	591	8	20	80	0.2500000
NODE_3807_length_1212_cov_15.981132	511	591	9	13	80	0.1625000
NODE_3807_length_1212_cov_15.981132	511	591	10	4	80	0.0500000
NODE_3807_length_1212_cov_15.981132	564	637	8	12	73	0.1643836
NODE_3807_length_1212_cov_15.981132	564	637	9	44	73	0.6027398
NODE_3807_length_1212_cov_15.981132	564	637	10	11	73	0.1506849
NODE_3807_length_1212_cov_15.981132	564	637	11	6	73	0.0821918
NODE_3813_length_1211_cov_30.513489	561	641	2	13	80	0.1625000
NODE_3813_length_1211_cov_30.513489	561	641	3	4	80	0.0500000
NODE_3813_length_1211_cov_30.513489	561	641	4	6	80	0.0750000
NODE_3813_length_1211_cov_30.513489	561	641	5	23	80	0.2875000
NODE_3813_length_1211_cov_30.513489	561	641	6	24	80	0.3000000
NODE_3813_length_1211_cov_30.513489	561	641	8	4	80	0.0500000
NODE_3813_length_1211_cov_30.513489	561	641	9	3	80	0.0375000
NODE_3813_length_1211_cov_30.513489	561	641	10	3	80	0.0375000
NODE_3813_length_1211_cov_30.513489	614	694	6	17	80	0.2125000
NODE_3813_length_1211_cov_30.513489	614	694	8	4	80	0.0500000
NODE_3813_length_1211_cov_30.513489	614	694	9	3	80	0.0375000
NODE_3813_length_1211_cov_30.513489	614	694	10	3	80	0.0375000
NODE_3813_length_1211_cov_30.513489	614	694	12	23	80	0.2875000
NODE_3813_length_1211_cov_30.513489	614	694	13	17	80	0.2125000
NODE_3813_length_1211_cov_30.513489	614	694	14	13	80	0.1625000
NODE_3813_length_1211_cov_30.513489	690	770	12	12	80	0.1500000
NODE_3813_length_1211_cov_30.513489	690	770	14	20	80	0.2500000
NODE_3813_length_1211_cov_30.513489	690	770	16	14	80	0.1750000
NODE_3813_length_1211_cov_30.513489	690	770	17	18	80	0.2250000
NODE_3813_length_1211_cov_30.513489	690	770	18	9	80	0.1125000
NODE_3813_length_1211_cov_30.513489	690	770	19	4	80	0.0500000
NODE_3813_length_1211_cov_30.513489	690	770	20	3	80	0.0375000
NODE_3813_length_1211_cov_30.513489	743	823	9	10	80	0.1250000
NODE_3813_length_1211_cov_30.513489	743	823	10	22	80	0.2750000
NODE_3813_length_1211_cov_30.513489	743	823	12	3	80	0.0375000
NODE_3813_length_1211_cov_30.513489	743	823	13	3	80	0.0375000
NODE_3813_length_1211_cov_30.513489	743	823	14	19	80	0.2375000
NODE_3813_length_1211_cov_30.513489	743	823	16	14	80	0.1750000
NODE_3813_length_1211_cov_30.513489	743	823	17	9	80	0.1125000
NODE_3815_length_1211_cov_10.073741	380	460	0	18	80	0.2250000
NODE_3815_length_1211_cov_10.073741	380	460	2	62	80	0.7750000
NODE_3815_length_1211_cov_10.073741	433	513	0	71	80	0.8875000
NODE_3815_length_1211_cov_10.073741	433	513	2	9	80	0.1125000
NODE_3816_length_1211_cov_7.561151	598	678	5	14	80	0.1750000
NODE_3816_length_1211_cov_7.561151	598	678	6	43	80	0.5375000
NODE_3816_length_1211_cov_7.561151	598	678	7	23	80	0.2875000
NODE_3816_length_1211_cov_7.561151	651	731	2	17	80	0.2125000
NODE_3816_length_1211_cov_7.561151	651	731	3	18	80	0.2250000
NODE_3816_length_1211_cov_7.561151	651	731	6	39	80	0.4875000
NODE_3816_length_1211_cov_7.561151	651	731	7	6	80	0.0750000
NODE_3820_length_1210_cov_49.743474	398	478	1	19	80	0.2375000
NODE_3820_length_1210_cov_49.743474	398	478	2	12	80	0.1500000
NODE_3820_length_1210_cov_49.743474	398	478	4	14	80	0.1750000
NODE_3820_length_1210_cov_49.743474	398	478	6	19	80	0.2375000
NODE_3820_length_1210_cov_49.743474	398	478	9	16	80	0.2000000
NODE_3820_length_1210_cov_49.743474	451	531	6	11	80	0.1375000
NODE_3820_length_1210_cov_49.743474	451	531	9	41	80	0.5125000
NODE_3820_length_1210_cov_49.743474	451	531	10	21	80	0.2625000
NODE_3820_length_1210_cov_49.743474	451	531	11	7	80	0.0875000
NODE_3821_length_1210_cov_15.647165	647	727	1	8	80	0.1000000
NODE_3821_length_1210_cov_15.647165	647	727	3	72	80	0.9000000
NODE_3821_length_1210_cov_15.647165	700	780	1	61	80	0.7625000
NODE_3821_length_1210_cov_15.647165	700	780	3	19	80	0.2375000
NODE_3822_length_1210_cov_11.194419	794	874	0	41	80	0.5125000
NODE_3822_length_1210_cov_11.194419	794	874	2	39	80	0.4875000
NODE_3822_length_1210_cov_11.194419	847	927	2	80	80	1.0000000
NODE_3826_length_1209_cov_24.504505	582	662	2	11	80	0.1375000
NODE_3826_length_1209_cov_24.504505	582	662	3	32	80	0.4000000
NODE_3826_length_1209_cov_24.504505	582	662	4	13	80	0.1625000
NODE_3826_length_1209_cov_24.504505	582	662	5	24	80	0.3000000
NODE_3826_length_1209_cov_24.504505	635	715	2	50	80	0.6250000
NODE_3826_length_1209_cov_24.504505	635	715	3	30	80	0.3750000
NODE_3826_length_1209_cov_24.504505	711	791	0	3	80	0.0375000
NODE_3826_length_1209_cov_24.504505	711	791	1	62	80	0.7750000
NODE_3826_length_1209_cov_24.504505	711	791	2	12	80	0.1500000
NODE_3826_length_1209_cov_24.504505	711	791	3	3	80	0.0375000
NODE_3826_length_1209_cov_24.504505	764	844	0	3	80	0.0375000
NODE_3826_length_1209_cov_24.504505	764	844	1	21	80	0.2625000
NODE_3826_length_1209_cov_24.504505	764	844	3	24	80	0.3000000
NODE_3826_length_1209_cov_24.504505	764	844	5	32	80	0.4000000
NODE_3827_length_1209_cov_21.846847	520	600	2	24	80	0.3000000
NODE_3827_length_1209_cov_21.846847	520	600	3	18	80	0.2250000
NODE_3827_length_1209_cov_21.846847	520	600	4	33	80	0.4125000
NODE_3827_length_1209_cov_21.846847	520	600	6	5	80	0.0625000
NODE_3827_length_1209_cov_21.846847	573	653	2	31	80	0.3875000
NODE_3827_length_1209_cov_21.846847	573	653	3	4	80	0.0500000
NODE_3827_length_1209_cov_21.846847	573	653	4	7	80	0.0875000
NODE_3827_length_1209_cov_21.846847	573	653	5	2	80	0.0250000
NODE_3827_length_1209_cov_21.846847	573	653	6	3	80	0.0375000
NODE_3827_length_1209_cov_21.846847	573	653	8	15	80	0.1875000
NODE_3827_length_1209_cov_21.846847	573	653	9	18	80	0.2250000
NODE_3827_length_1209_cov_21.846847	649	729	8	31	80	0.3875000
NODE_3827_length_1209_cov_21.846847	649	729	9	21	80	0.2625000
NODE_3827_length_1209_cov_21.846847	649	729	12	18	80	0.2250000
NODE_3827_length_1209_cov_21.846847	649	729	13	10	80	0.1250000
NODE_3827_length_1209_cov_21.846847	702	782	6	3	80	0.0375000
NODE_3827_length_1209_cov_21.846847	702	782	7	12	80	0.1500000
NODE_3827_length_1209_cov_21.846847	702	782	8	5	80	0.0625000
NODE_3827_length_1209_cov_21.846847	702	782	9	10	80	0.1250000
NODE_3827_length_1209_cov_21.846847	702	782	10	9	80	0.1125000
NODE_3827_length_1209_cov_21.846847	702	782	12	31	80	0.3875000
NODE_3827_length_1209_cov_21.846847	702	782	13	10	80	0.1250000
NODE_3828_length_1209_cov_9.026126	782	862	2	80	80	1.0000000
NODE_3828_length_1209_cov_9.026126	835	915	0	16	80	0.2000000
NODE_3828_length_1209_cov_9.026126	835	915	2	64	80	0.8000000
NODE_3830_length_1209_cov_5.721622	926	1006	0	18	80	0.2250000
NODE_3830_length_1209_cov_5.721622	926	1006	2	10	80	0.1250000
NODE_3830_length_1209_cov_5.721622	926	1006	4	1	80	0.0125000
NODE_3830_length_1209_cov_5.721622	926	1006	6	51	80	0.6375000
NODE_3830_length_1209_cov_5.721622	979	1059	0	71	80	0.8875000
NODE_3830_length_1209_cov_5.721622	979	1059	2	9	80	0.1125000
NODE_3833_length_1208_cov_40.717764	886	966	34	1	80	0.0125000
NODE_3833_length_1208_cov_40.717764	886	966	35	3	80	0.0375000
NODE_3833_length_1208_cov_40.717764	886	966	36	1	80	0.0125000
NODE_3833_length_1208_cov_40.717764	886	966	37	1	80	0.0125000
NODE_3833_length_1208_cov_40.717764	886	966	39	3	80	0.0375000
NODE_3833_length_1208_cov_40.717764	886	966	41	3	80	0.0375000
NODE_3833_length_1208_cov_40.717764	886	966	43	3	80	0.0375000
NODE_3833_length_1208_cov_40.717764	886	966	44	10	80	0.1250000
NODE_3833_length_1208_cov_40.717764	886	966	45	3	80	0.0375000
NODE_3833_length_1208_cov_40.717764	886	966	46	2	80	0.0250000
NODE_3833_length_1208_cov_40.717764	886	966	47	2	80	0.0250000
NODE_3833_length_1208_cov_40.717764	886	966	52	6	80	0.0750000
NODE_3833_length_1208_cov_40.717764	886	966	54	1	80	0.0125000
NODE_3833_length_1208_cov_40.717764	886	966	55	1	80	0.0125000
NODE_3833_length_1208_cov_40.717764	886	966	56	4	80	0.0500000
NODE_3833_length_1208_cov_40.717764	886	966	57	1	80	0.0125000
NODE_3833_length_1208_cov_40.717764	886	966	59	2	80	0.0250000
NODE_3833_length_1208_cov_40.717764	886	966	61	1	80	0.0125000
NODE_3833_length_1208_cov_40.717764	886	966	62	4	80	0.0500000
NODE_3833_length_1208_cov_40.717764	886	966	64	3	80	0.0375000
NODE_3833_length_1208_cov_40.717764	886	966	66	2	80	0.0250000
NODE_3833_length_1208_cov_40.717764	886	966	67	1	80	0.0125000
NODE_3833_length_1208_cov_40.717764	886	966	69	1	80	0.0125000
NODE_3833_length_1208_cov_40.717764	886	966	70	2	80	0.0250000
NODE_3833_length_1208_cov_40.717764	886	966	72	1	80	0.0125000
NODE_3833_length_1208_cov_40.717764	886	966	73	1	80	0.0125000
NODE_3833_length_1208_cov_40.717764	886	966	74	13	80	0.1625000
NODE_3833_length_1208_cov_40.717764	886	966	75	1	80	0.0125000
NODE_3833_length_1208_cov_40.717764	886	966	77	1	80	0.0125000
NODE_3833_length_1208_cov_40.717764	886	966	79	1	80	0.0125000
NODE_3833_length_1208_cov_40.717764	886	966	82	1	80	0.0125000
NODE_3833_length_1208_cov_40.717764	939	985	62	1	46	0.0217391
NODE_3833_length_1208_cov_40.717764	939	985	64	1	46	0.0217391
NODE_3833_length_1208_cov_40.717764	939	985	66	2	46	0.0434783
NODE_3833_length_1208_cov_40.717764	939	985	67	1	46	0.0217391
NODE_3833_length_1208_cov_40.717764	939	985	69	1	46	0.0217391
NODE_3833_length_1208_cov_40.717764	939	985	70	2	46	0.0434783
NODE_3833_length_1208_cov_40.717764	939	985	72	1	46	0.0217391
NODE_3833_length_1208_cov_40.717764	939	985	73	1	46	0.0217391
NODE_3833_length_1208_cov_40.717764	939	985	74	13	46	0.2826087
NODE_3833_length_1208_cov_40.717764	939	985	75	1	46	0.0217391
NODE_3833_length_1208_cov_40.717764	939	985	77	1	46	0.0217391
NODE_3833_length_1208_cov_40.717764	939	985	79	1	46	0.0217391
NODE_3833_length_1208_cov_40.717764	939	985	82	2	46	0.0434783
NODE_3833_length_1208_cov_40.717764	939	985	83	1	46	0.0217391
NODE_3833_length_1208_cov_40.717764	939	985	84	1	46	0.0217391
NODE_3833_length_1208_cov_40.717764	939	985	86	1	46	0.0217391
NODE_3833_length_1208_cov_40.717764	939	985	89	4	46	0.0869565
NODE_3833_length_1208_cov_40.717764	939	985	90	2	46	0.0434783
NODE_3833_length_1208_cov_40.717764	939	985	91	2	46	0.0434783
NODE_3833_length_1208_cov_40.717764	939	985	96	1	46	0.0217391
NODE_3833_length_1208_cov_40.717764	939	985	99	4	46	0.0869565
NODE_3833_length_1208_cov_40.717764	939	985	102	1	46	0.0217391
NODE_3833_length_1208_cov_40.717764	939	985	103	1	46	0.0217391
NODE_3834_length_1208_cov_28.528404	614	694	1	10	80	0.1250000
NODE_3834_length_1208_cov_28.528404	614	694	4	8	80	0.1000000
NODE_3834_length_1208_cov_28.528404	614	694	5	38	80	0.4750000
NODE_3834_length_1208_cov_28.528404	614	694	6	20	80	0.2500000
NODE_3834_length_1208_cov_28.528404	614	694	7	4	80	0.0500000
NODE_3834_length_1208_cov_28.528404	667	747	5	3	80	0.0375000
NODE_3834_length_1208_cov_28.528404	667	747	6	63	80	0.7875000
NODE_3834_length_1208_cov_28.528404	667	747	7	4	80	0.0500000
NODE_3834_length_1208_cov_28.528404	667	747	8	10	80	0.1250000
NODE_3835_length_1208_cov_19.688007	682	762	0	80	80	1.0000000
NODE_3835_length_1208_cov_19.688007	735	815	0	80	80	1.0000000
NODE_3836_length_1208_cov_18.577096	455	535	1	1	80	0.0125000
NODE_3836_length_1208_cov_18.577096	455	535	2	75	80	0.9375000
NODE_3836_length_1208_cov_18.577096	455	535	3	4	80	0.0500000
NODE_3836_length_1208_cov_18.577096	508	588	1	8	80	0.1000000
NODE_3836_length_1208_cov_18.577096	508	588	2	68	80	0.8500000
NODE_3836_length_1208_cov_18.577096	508	588	3	4	80	0.0500000
NODE_3836_length_1208_cov_18.577096	584	664	2	80	80	1.0000000
NODE_3836_length_1208_cov_18.577096	637	717	0	25	80	0.3125000
NODE_3836_length_1208_cov_18.577096	637	717	1	12	80	0.1500000
NODE_3836_length_1208_cov_18.577096	637	717	2	43	80	0.5375000
NODE_3837_length_1208_cov_12.733995	766	846	3	10	80	0.1250000
NODE_3837_length_1208_cov_12.733995	766	846	4	56	80	0.7000000
NODE_3837_length_1208_cov_12.733995	766	846	5	14	80	0.1750000
NODE_3837_length_1208_cov_12.733995	819	899	3	32	80	0.4000000
NODE_3837_length_1208_cov_12.733995	819	899	4	34	80	0.4250000
NODE_3837_length_1208_cov_12.733995	819	899	5	14	80	0.1750000
NODE_3837_length_1208_cov_12.733995	895	975	2	44	80	0.5500000
NODE_3837_length_1208_cov_12.733995	895	975	3	17	80	0.2125000
NODE_3837_length_1208_cov_12.733995	895	975	4	19	80	0.2375000
NODE_3837_length_1208_cov_12.733995	948	1028	2	32	80	0.4000000
NODE_3837_length_1208_cov_12.733995	948	1028	3	48	80	0.6000000
NODE_3838_length_1207_cov_20.461191	874	954	9	22	80	0.2750000
NODE_3838_length_1207_cov_20.461191	874	954	10	7	80	0.0875000
NODE_3838_length_1207_cov_20.461191	874	954	11	17	80	0.2125000
NODE_3838_length_1207_cov_20.461191	874	954	13	10	80	0.1250000
NODE_3838_length_1207_cov_20.461191	874	954	14	10	80	0.1250000
NODE_3838_length_1207_cov_20.461191	874	954	15	11	80	0.1375000
NODE_3838_length_1207_cov_20.461191	874	954	16	3	80	0.0375000
NODE_3838_length_1207_cov_20.461191	927	1007	4	4	80	0.0500000
NODE_3838_length_1207_cov_20.461191	927	1007	5	13	80	0.1625000
NODE_3838_length_1207_cov_20.461191	927	1007	6	12	80	0.1500000
NODE_3838_length_1207_cov_20.461191	927	1007	7	10	80	0.1250000
NODE_3838_length_1207_cov_20.461191	927	1007	8	5	80	0.0625000
NODE_3838_length_1207_cov_20.461191	927	1007	9	31	80	0.3875000
NODE_3838_length_1207_cov_20.461191	927	1007	10	5	80	0.0625000
NODE_3846_length_1206_cov_59.851852	540	620	4	3	80	0.0375000
NODE_3846_length_1206_cov_59.851852	540	620	6	4	80	0.0500000
NODE_3846_length_1206_cov_59.851852	540	620	8	4	80	0.0500000
NODE_3846_length_1206_cov_59.851852	540	620	9	2	80	0.0250000
NODE_3846_length_1206_cov_59.851852	540	620	10	3	80	0.0375000
NODE_3846_length_1206_cov_59.851852	540	620	11	17	80	0.2125000
NODE_3846_length_1206_cov_59.851852	540	620	12	1	80	0.0125000
NODE_3846_length_1206_cov_59.851852	540	620	13	28	80	0.3500000
NODE_3846_length_1206_cov_59.851852	540	620	14	10	80	0.1250000
NODE_3846_length_1206_cov_59.851852	540	620	16	8	80	0.1000000
NODE_3846_length_1206_cov_59.851852	593	673	11	5	80	0.0625000
NODE_3846_length_1206_cov_59.851852	593	673	12	14	80	0.1750000
NODE_3846_length_1206_cov_59.851852	593	673	13	8	80	0.1000000
NODE_3846_length_1206_cov_59.851852	593	673	14	15	80	0.1875000
NODE_3846_length_1206_cov_59.851852	593	673	15	2	80	0.0250000
NODE_3846_length_1206_cov_59.851852	593	673	16	36	80	0.4500000
NODE_3846_length_1206_cov_59.851852	669	749	6	28	80	0.3500000
NODE_3846_length_1206_cov_59.851852	669	749	7	13	80	0.1625000
NODE_3846_length_1206_cov_59.851852	669	749	8	14	80	0.1750000
NODE_3846_length_1206_cov_59.851852	669	749	9	3	80	0.0375000
NODE_3846_length_1206_cov_59.851852	669	749	10	2	80	0.0250000
NODE_3846_length_1206_cov_59.851852	669	749	11	20	80	0.2500000
NODE_3846_length_1206_cov_59.851852	722	802	2	48	80	0.6000000
NODE_3846_length_1206_cov_59.851852	722	802	4	1	80	0.0125000
NODE_3846_length_1206_cov_59.851852	722	802	6	18	80	0.2250000
NODE_3846_length_1206_cov_59.851852	722	802	7	13	80	0.1625000
NODE_3847_length_1206_cov_23.752484	669	749	11	36	80	0.4500000
NODE_3847_length_1206_cov_23.752484	669	749	12	25	80	0.3125000
NODE_3847_length_1206_cov_23.752484	669	749	13	19	80	0.2375000
NODE_3847_length_1206_cov_23.752484	722	802	11	31	80	0.3875000
NODE_3847_length_1206_cov_23.752484	722	802	12	31	80	0.3875000
NODE_3847_length_1206_cov_23.752484	722	802	14	18	80	0.2250000
NODE_3848_length_1206_cov_21.226739	585	665	2	1	80	0.0125000
NODE_3848_length_1206_cov_21.226739	585	665	4	18	80	0.2250000
NODE_3848_length_1206_cov_21.226739	585	665	5	61	80	0.7625000
NODE_3848_length_1206_cov_21.226739	638	718	5	64	80	0.8000000
NODE_3848_length_1206_cov_21.226739	638	718	6	16	80	0.2000000
NODE_3855_length_1205_cov_23.990054	355	435	2	52	80	0.6500000
NODE_3855_length_1205_cov_23.990054	355	435	4	28	80	0.3500000
NODE_3855_length_1205_cov_23.990054	408	488	4	61	80	0.7625000
NODE_3855_length_1205_cov_23.990054	408	488	5	4	80	0.0500000
NODE_3855_length_1205_cov_23.990054	408	488	6	15	80	0.1875000
NODE_3856_length_1205_cov_10.473779	780	860	0	14	80	0.1750000
NODE_3856_length_1205_cov_10.473779	780	860	2	55	80	0.6875000
NODE_3856_length_1205_cov_10.473779	780	860	3	11	80	0.1375000
NODE_3856_length_1205_cov_10.473779	833	913	2	16	80	0.2000000
NODE_3856_length_1205_cov_10.473779	833	913	3	13	80	0.1625000
NODE_3856_length_1205_cov_10.473779	833	913	4	51	80	0.6375000
NODE_3863_length_1204_cov_19.396380	537	617	5	10	80	0.1250000
NODE_3863_length_1204_cov_19.396380	537	617	6	51	80	0.6375000
NODE_3863_length_1204_cov_19.396380	537	617	7	14	80	0.1750000
NODE_3863_length_1204_cov_19.396380	537	617	8	5	80	0.0625000
NODE_3863_length_1204_cov_19.396380	590	670	1	17	80	0.2125000
NODE_3863_length_1204_cov_19.396380	590	670	2	28	80	0.3500000
NODE_3863_length_1204_cov_19.396380	590	670	3	8	80	0.1000000
NODE_3863_length_1204_cov_19.396380	590	670	5	10	80	0.1250000
NODE_3863_length_1204_cov_19.396380	590	670	6	17	80	0.2125000
NODE_3864_length_1204_cov_17.716742	448	528	8	6	80	0.0750000
NODE_3864_length_1204_cov_17.716742	448	528	10	23	80	0.2875000
NODE_3864_length_1204_cov_17.716742	448	528	11	10	80	0.1250000
NODE_3864_length_1204_cov_17.716742	448	528	12	30	80	0.3750000
NODE_3864_length_1204_cov_17.716742	448	528	13	11	80	0.1375000
NODE_3864_length_1204_cov_17.716742	501	581	7	36	80	0.4500000
NODE_3864_length_1204_cov_17.716742	501	581	8	23	80	0.2875000
NODE_3864_length_1204_cov_17.716742	501	581	10	6	80	0.0750000
NODE_3864_length_1204_cov_17.716742	501	581	12	14	80	0.1750000
NODE_3864_length_1204_cov_17.716742	501	581	13	1	80	0.0125000
NODE_3865_length_1204_cov_15.206335	426	506	2	6	80	0.0750000
NODE_3865_length_1204_cov_15.206335	426	506	3	74	80	0.9250000
NODE_3865_length_1204_cov_15.206335	479	559	0	26	80	0.3250000
NODE_3865_length_1204_cov_15.206335	479	559	1	8	80	0.1000000
NODE_3865_length_1204_cov_15.206335	479	559	2	25	80	0.3125000
NODE_3865_length_1204_cov_15.206335	479	559	3	21	80	0.2625000
NODE_3866_length_1204_cov_14.097738	632	712	4	23	80	0.2875000
NODE_3866_length_1204_cov_14.097738	632	712	5	10	80	0.1250000
NODE_3866_length_1204_cov_14.097738	632	712	6	18	80	0.2250000
NODE_3866_length_1204_cov_14.097738	632	712	7	22	80	0.2750000
NODE_3866_length_1204_cov_14.097738	632	712	8	7	80	0.0875000
NODE_3866_length_1204_cov_14.097738	685	765	5	35	80	0.4375000
NODE_3866_length_1204_cov_14.097738	685	765	7	29	80	0.3625000
NODE_3866_length_1204_cov_14.097738	685	765	8	16	80	0.2000000
NODE_3867_length_1204_cov_11.971946	549	629	0	32	80	0.4000000
NODE_3867_length_1204_cov_11.971946	549	629	2	48	80	0.6000000
NODE_3867_length_1204_cov_11.971946	602	682	0	20	80	0.2500000
NODE_3867_length_1204_cov_11.971946	602	682	1	17	80	0.2125000
NODE_3867_length_1204_cov_11.971946	602	682	2	43	80	0.5375000
NODE_3867_length_1204_cov_11.971946	678	758	1	45	80	0.5625000
NODE_3867_length_1204_cov_11.971946	678	758	2	35	80	0.4375000
NODE_3867_length_1204_cov_11.971946	731	811	2	80	80	1.0000000
NODE_3868_length_1204_cov_11.665158	499	579	1	48	80	0.6000000
NODE_3868_length_1204_cov_11.665158	499	579	2	32	80	0.4000000
NODE_3868_length_1204_cov_11.665158	552	632	2	80	80	1.0000000
NODE_3869_length_1204_cov_7.028959	637	717	1	28	80	0.3500000
NODE_3869_length_1204_cov_7.028959	637	717	3	4	80	0.0500000
NODE_3869_length_1204_cov_7.028959	637	717	4	48	80	0.6000000
NODE_3869_length_1204_cov_7.028959	690	770	2	35	80	0.4375000
NODE_3869_length_1204_cov_7.028959	690	770	4	45	80	0.5625000
NODE_3870_length_1204_cov_4.677828	807	887	0	80	80	1.0000000
NODE_3870_length_1204_cov_4.677828	860	940	0	80	80	1.0000000
NODE_3873_length_1203_cov_46.789855	515	595	15	6	80	0.0750000
NODE_3873_length_1203_cov_46.789855	515	595	16	27	80	0.3375000
NODE_3873_length_1203_cov_46.789855	515	595	17	44	80	0.5500000
NODE_3873_length_1203_cov_46.789855	515	595	18	3	80	0.0375000
NODE_3873_length_1203_cov_46.789855	568	648	11	3	80	0.0375000
NODE_3873_length_1203_cov_46.789855	568	648	12	18	80	0.2250000
NODE_3873_length_1203_cov_46.789855	568	648	13	8	80	0.1000000
NODE_3873_length_1203_cov_46.789855	568	648	14	8	80	0.1000000
NODE_3873_length_1203_cov_46.789855	568	648	15	6	80	0.0750000
NODE_3873_length_1203_cov_46.789855	568	648	16	25	80	0.3125000
NODE_3873_length_1203_cov_46.789855	568	648	17	4	80	0.0500000
NODE_3873_length_1203_cov_46.789855	568	648	18	8	80	0.1000000
NODE_3873_length_1203_cov_46.789855	644	724	11	8	80	0.1000000
NODE_3873_length_1203_cov_46.789855	644	724	12	3	80	0.0375000
NODE_3873_length_1203_cov_46.789855	644	724	13	34	80	0.4250000
NODE_3873_length_1203_cov_46.789855	644	724	14	14	80	0.1750000
NODE_3873_length_1203_cov_46.789855	644	724	15	21	80	0.2625000
NODE_3873_length_1203_cov_46.789855	697	777	8	18	80	0.2250000
NODE_3873_length_1203_cov_46.789855	697	777	9	10	80	0.1250000
NODE_3873_length_1203_cov_46.789855	697	777	10	6	80	0.0750000
NODE_3873_length_1203_cov_46.789855	697	777	11	8	80	0.1000000
NODE_3873_length_1203_cov_46.789855	697	777	12	22	80	0.2750000
NODE_3873_length_1203_cov_46.789855	697	777	14	8	80	0.1000000
NODE_3873_length_1203_cov_46.789855	697	777	15	8	80	0.1000000
NODE_3874_length_1203_cov_44.029891	471	551	1	18	80	0.2250000
NODE_3874_length_1203_cov_44.029891	471	551	2	60	80	0.7500000
NODE_3874_length_1203_cov_44.029891	471	551	3	2	80	0.0250000
NODE_3874_length_1203_cov_44.029891	524	604	2	37	80	0.4625000
NODE_3874_length_1203_cov_44.029891	524	604	3	14	80	0.1750000
NODE_3874_length_1203_cov_44.029891	524	604	4	10	80	0.1250000
NODE_3874_length_1203_cov_44.029891	524	604	5	19	80	0.2375000
NODE_3874_length_1203_cov_44.029891	600	680	5	41	80	0.5125000
NODE_3874_length_1203_cov_44.029891	600	680	6	25	80	0.3125000
NODE_3874_length_1203_cov_44.029891	600	680	7	14	80	0.1750000
NODE_3874_length_1203_cov_44.029891	653	733	5	5	80	0.0625000
NODE_3874_length_1203_cov_44.029891	653	733	6	51	80	0.6375000
NODE_3874_length_1203_cov_44.029891	653	733	7	24	80	0.3000000
NODE_3875_length_1203_cov_23.790761	308	388	2	23	80	0.2875000
NODE_3875_length_1203_cov_23.790761	308	388	3	23	80	0.2875000
NODE_3875_length_1203_cov_23.790761	308	388	4	34	80	0.4250000
NODE_3875_length_1203_cov_23.790761	361	441	4	35	80	0.4375000
NODE_3875_length_1203_cov_23.790761	361	441	6	32	80	0.4000000
NODE_3875_length_1203_cov_23.790761	361	441	7	13	80	0.1625000
NODE_3875_length_1203_cov_23.790761	437	517	6	19	80	0.2375000
NODE_3875_length_1203_cov_23.790761	437	517	7	10	80	0.1250000
NODE_3875_length_1203_cov_23.790761	437	517	8	31	80	0.3875000
NODE_3875_length_1203_cov_23.790761	437	517	9	17	80	0.2125000
NODE_3875_length_1203_cov_23.790761	437	517	10	3	80	0.0375000
NODE_3875_length_1203_cov_23.790761	490	570	3	8	80	0.1000000
NODE_3875_length_1203_cov_23.790761	490	570	5	15	80	0.1875000
NODE_3875_length_1203_cov_23.790761	490	570	6	43	80	0.5375000
NODE_3875_length_1203_cov_23.790761	490	570	7	6	80	0.0750000
NODE_3875_length_1203_cov_23.790761	490	570	9	8	80	0.1000000
NODE_3876_length_1203_cov_19.498188	336	416	2	47	80	0.5875000
NODE_3876_length_1203_cov_19.498188	336	416	3	33	80	0.4125000
NODE_3876_length_1203_cov_19.498188	389	469	2	27	80	0.3375000
NODE_3876_length_1203_cov_19.498188	389	469	3	53	80	0.6625000
NODE_3877_length_1203_cov_10.996377	317	397	8	2	80	0.0250000
NODE_3877_length_1203_cov_10.996377	317	397	9	19	80	0.2375000
NODE_3877_length_1203_cov_10.996377	317	397	10	12	80	0.1500000
NODE_3877_length_1203_cov_10.996377	317	397	11	47	80	0.5875000
NODE_3877_length_1203_cov_10.996377	370	450	7	1	80	0.0125000
NODE_3877_length_1203_cov_10.996377	370	450	8	9	80	0.1125000
NODE_3877_length_1203_cov_10.996377	370	450	9	2	80	0.0250000
NODE_3877_length_1203_cov_10.996377	370	450	10	14	80	0.1750000
NODE_3877_length_1203_cov_10.996377	370	450	11	42	80	0.5250000
NODE_3877_length_1203_cov_10.996377	370	450	12	12	80	0.1500000
NODE_3878_length_1203_cov_5.747283	725	805	1	33	80	0.4125000
NODE_3878_length_1203_cov_5.747283	725	805	2	47	80	0.5875000
NODE_3878_length_1203_cov_5.747283	778	858	1	78	80	0.9750000
NODE_3878_length_1203_cov_5.747283	778	858	3	2	80	0.0250000
NODE_3881_length_1202_cov_39.333636	475	555	4	6	80	0.0750000
NODE_3881_length_1202_cov_39.333636	475	555	6	13	80	0.1625000
NODE_3881_length_1202_cov_39.333636	475	555	7	60	80	0.7500000
NODE_3881_length_1202_cov_39.333636	475	555	8	1	80	0.0125000
NODE_3881_length_1202_cov_39.333636	528	608	1	6	80	0.0750000
NODE_3881_length_1202_cov_39.333636	528	608	2	31	80	0.3875000
NODE_3881_length_1202_cov_39.333636	528	608	3	8	80	0.1000000
NODE_3881_length_1202_cov_39.333636	528	608	4	14	80	0.1750000
NODE_3881_length_1202_cov_39.333636	528	608	6	13	80	0.1625000
NODE_3881_length_1202_cov_39.333636	528	608	7	8	80	0.1000000
NODE_3881_length_1202_cov_39.333636	604	684	1	13	80	0.1625000
NODE_3881_length_1202_cov_39.333636	604	684	3	26	80	0.3250000
NODE_3881_length_1202_cov_39.333636	604	684	4	13	80	0.1625000
NODE_3881_length_1202_cov_39.333636	604	684	5	28	80	0.3500000
NODE_3881_length_1202_cov_39.333636	657	737	4	8	80	0.1000000
NODE_3881_length_1202_cov_39.333636	657	737	5	72	80	0.9000000
NODE_3882_length_1202_cov_17.556664	599	679	4	12	80	0.1500000
NODE_3882_length_1202_cov_17.556664	599	679	5	45	80	0.5625000
NODE_3882_length_1202_cov_17.556664	599	679	6	23	80	0.2875000
NODE_3882_length_1202_cov_17.556664	652	732	2	3	80	0.0375000
NODE_3882_length_1202_cov_17.556664	652	732	3	28	80	0.3500000
NODE_3882_length_1202_cov_17.556664	652	732	4	2	80	0.0250000
NODE_3882_length_1202_cov_17.556664	652	732	5	6	80	0.0750000
NODE_3882_length_1202_cov_17.556664	652	732	6	41	80	0.5125000
NODE_3883_length_1202_cov_12.338169	634	714	6	1	80	0.0125000
NODE_3883_length_1202_cov_12.338169	634	714	7	6	80	0.0750000
NODE_3883_length_1202_cov_12.338169	634	714	8	32	80	0.4000000
NODE_3883_length_1202_cov_12.338169	634	714	9	41	80	0.5125000
NODE_3883_length_1202_cov_12.338169	687	767	2	6	80	0.0750000
NODE_3883_length_1202_cov_12.338169	687	767	3	45	80	0.5625000
NODE_3883_length_1202_cov_12.338169	687	767	5	1	80	0.0125000
NODE_3883_length_1202_cov_12.338169	687	767	6	2	80	0.0250000
NODE_3883_length_1202_cov_12.338169	687	767	7	2	80	0.0250000
NODE_3883_length_1202_cov_12.338169	687	767	8	24	80	0.3000000
NODE_3884_length_1202_cov_11.800544	520	600	1	3	80	0.0375000
NODE_3884_length_1202_cov_11.800544	520	600	2	77	80	0.9625000
NODE_3884_length_1202_cov_11.800544	573	653	1	56	80	0.7000000
NODE_3884_length_1202_cov_11.800544	573	653	2	24	80	0.3000000
NODE_3887_length_1201_cov_12.161525	434	514	9	1	80	0.0125000
NODE_3887_length_1201_cov_12.161525	434	514	10	12	80	0.1500000
NODE_3887_length_1201_cov_12.161525	434	514	12	3	80	0.0375000
NODE_3887_length_1201_cov_12.161525	434	514	13	1	80	0.0125000
NODE_3887_length_1201_cov_12.161525	434	514	14	2	80	0.0250000
NODE_3887_length_1201_cov_12.161525	434	514	16	21	80	0.2625000
NODE_3887_length_1201_cov_12.161525	434	514	18	9	80	0.1125000
NODE_3887_length_1201_cov_12.161525	434	514	19	18	80	0.2250000
NODE_3887_length_1201_cov_12.161525	434	514	20	10	80	0.1250000
NODE_3887_length_1201_cov_12.161525	434	514	21	3	80	0.0375000
NODE_3887_length_1201_cov_12.161525	487	567	16	11	80	0.1375000
NODE_3887_length_1201_cov_12.161525	487	567	18	26	80	0.3250000
NODE_3887_length_1201_cov_12.161525	487	567	19	18	80	0.2250000
NODE_3887_length_1201_cov_12.161525	487	567	20	13	80	0.1625000
NODE_3887_length_1201_cov_12.161525	487	567	21	12	80	0.1500000
NODE_3888_length_1201_cov_12.046279	643	723	0	80	80	1.0000000
NODE_3888_length_1201_cov_12.046279	696	776	0	80	80	1.0000000
NODE_3891_length_1200_cov_76.694823	630	710	11	6	80	0.0750000
NODE_3891_length_1200_cov_76.694823	630	710	13	2	80	0.0250000
NODE_3891_length_1200_cov_76.694823	630	710	15	31	80	0.3875000
NODE_3891_length_1200_cov_76.694823	630	710	16	12	80	0.1500000
NODE_3891_length_1200_cov_76.694823	630	710	17	9	80	0.1125000
NODE_3891_length_1200_cov_76.694823	630	710	18	13	80	0.1625000
NODE_3891_length_1200_cov_76.694823	630	710	19	7	80	0.0875000
NODE_3891_length_1200_cov_76.694823	683	763	8	4	80	0.0500000
NODE_3891_length_1200_cov_76.694823	683	763	9	8	80	0.1000000
NODE_3891_length_1200_cov_76.694823	683	763	11	18	80	0.2250000
NODE_3891_length_1200_cov_76.694823	683	763	12	5	80	0.0625000
NODE_3891_length_1200_cov_76.694823	683	763	15	3	80	0.0375000
NODE_3891_length_1200_cov_76.694823	683	763	16	5	80	0.0625000
NODE_3891_length_1200_cov_76.694823	683	763	17	11	80	0.1375000
NODE_3891_length_1200_cov_76.694823	683	763	18	19	80	0.2375000
NODE_3891_length_1200_cov_76.694823	683	763	19	7	80	0.0875000
NODE_3891_length_1200_cov_76.694823	759	839	8	11	80	0.1375000
NODE_3891_length_1200_cov_76.694823	759	839	9	6	80	0.0750000
NODE_3891_length_1200_cov_76.694823	759	839	12	1	80	0.0125000
NODE_3891_length_1200_cov_76.694823	759	839	13	17	80	0.2125000
NODE_3891_length_1200_cov_76.694823	759	839	14	9	80	0.1125000
NODE_3891_length_1200_cov_76.694823	759	839	16	6	80	0.0750000
NODE_3891_length_1200_cov_76.694823	759	839	17	9	80	0.1125000
NODE_3891_length_1200_cov_76.694823	759	839	18	4	80	0.0500000
NODE_3891_length_1200_cov_76.694823	759	839	19	11	80	0.1375000
NODE_3891_length_1200_cov_76.694823	759	839	21	6	80	0.0750000
NODE_3891_length_1200_cov_76.694823	812	892	16	4	80	0.0500000
NODE_3891_length_1200_cov_76.694823	812	892	17	2	80	0.0250000
NODE_3891_length_1200_cov_76.694823	812	892	18	20	80	0.2500000
NODE_3891_length_1200_cov_76.694823	812	892	19	27	80	0.3375000
NODE_3891_length_1200_cov_76.694823	812	892	20	11	80	0.1375000
NODE_3891_length_1200_cov_76.694823	812	892	21	16	80	0.2000000
NODE_3892_length_1200_cov_16.881926	827	902	5	25	75	0.3333333
NODE_3892_length_1200_cov_16.881926	827	902	6	4	75	0.0533333
NODE_3892_length_1200_cov_16.881926	827	902	8	23	75	0.3066667
NODE_3892_length_1200_cov_16.881926	827	902	9	9	75	0.1200000
NODE_3892_length_1200_cov_16.881926	827	902	10	14	75	0.1866667
NODE_3892_length_1200_cov_16.881926	828	904	5	24	76	0.3157895
NODE_3892_length_1200_cov_16.881926	828	904	6	4	76	0.0526316
NODE_3892_length_1200_cov_16.881926	828	904	8	23	76	0.3026316
NODE_3892_length_1200_cov_16.881926	828	904	9	9	76	0.1184211
NODE_3892_length_1200_cov_16.881926	828	904	10	16	76	0.2105263
NODE_3892_length_1200_cov_16.881926	841	907	5	11	66	0.1666667
NODE_3892_length_1200_cov_16.881926	841	907	6	4	66	0.0606061
NODE_3892_length_1200_cov_16.881926	841	907	8	23	66	0.3484848
NODE_3892_length_1200_cov_16.881926	841	907	9	9	66	0.1363636
NODE_3892_length_1200_cov_16.881926	841	907	10	17	66	0.2575758
NODE_3892_length_1200_cov_16.881926	841	907	11	2	66	0.0303030
NODE_3892_length_1200_cov_16.881926	880	957	8	20	77	0.2597403
NODE_3892_length_1200_cov_16.881926	880	957	9	20	77	0.2597403
NODE_3892_length_1200_cov_16.881926	880	957	10	25	77	0.3246753
NODE_3892_length_1200_cov_16.881926	880	957	11	12	77	0.1558442
NODE_3892_length_1200_cov_16.881926	880	957	8	20	77	0.2597403
NODE_3892_length_1200_cov_16.881926	880	957	9	20	77	0.2597403
NODE_3892_length_1200_cov_16.881926	880	957	10	25	77	0.3246753
NODE_3892_length_1200_cov_16.881926	880	957	11	12	77	0.1558442
NODE_3892_length_1200_cov_16.881926	880	957	8	20	77	0.2597403
NODE_3892_length_1200_cov_16.881926	880	957	9	20	77	0.2597403
NODE_3892_length_1200_cov_16.881926	880	957	10	25	77	0.3246753
NODE_3892_length_1200_cov_16.881926	880	957	11	12	77	0.1558442
NODE_3893_length_1200_cov_15.374205	605	685	7	13	80	0.1625000
NODE_3893_length_1200_cov_15.374205	605	685	8	28	80	0.3500000
NODE_3893_length_1200_cov_15.374205	605	685	9	38	80	0.4750000
NODE_3893_length_1200_cov_15.374205	605	685	10	1	80	0.0125000
NODE_3893_length_1200_cov_15.374205	658	738	6	51	80	0.6375000
NODE_3893_length_1200_cov_15.374205	658	738	7	10	80	0.1250000
NODE_3893_length_1200_cov_15.374205	658	738	8	6	80	0.0750000
NODE_3893_length_1200_cov_15.374205	658	738	9	13	80	0.1625000
NODE_3894_length_1200_cov_12.953678	486	550	1	38	64	0.5937500
NODE_3894_length_1200_cov_12.953678	486	550	3	26	64	0.4062500
NODE_3899_length_1199_cov_14.843636	222	302	11	10	80	0.1250000
NODE_3899_length_1199_cov_14.843636	222	302	12	4	80	0.0500000
NODE_3899_length_1199_cov_14.843636	222	302	13	22	80	0.2750000
NODE_3899_length_1199_cov_14.843636	222	302	14	26	80	0.3250000
NODE_3899_length_1199_cov_14.843636	222	302	15	18	80	0.2250000
NODE_3899_length_1199_cov_14.843636	275	355	7	15	80	0.1875000
NODE_3899_length_1199_cov_14.843636	275	355	8	2	80	0.0250000
NODE_3899_length_1199_cov_14.843636	275	355	10	2	80	0.0250000
NODE_3899_length_1199_cov_14.843636	275	355	13	25	80	0.3125000
NODE_3899_length_1199_cov_14.843636	275	355	14	23	80	0.2875000
NODE_3899_length_1199_cov_14.843636	275	355	15	13	80	0.1625000
NODE_3900_length_1199_cov_12.005455	383	463	3	2	80	0.0250000
NODE_3900_length_1199_cov_12.005455	383	463	4	24	80	0.3000000
NODE_3900_length_1199_cov_12.005455	383	463	5	54	80	0.6750000
NODE_3900_length_1199_cov_12.005455	436	516	3	4	80	0.0500000
NODE_3900_length_1199_cov_12.005455	436	516	4	4	80	0.0500000
NODE_3900_length_1199_cov_12.005455	436	516	5	35	80	0.4375000
NODE_3900_length_1199_cov_12.005455	436	516	6	14	80	0.1750000
NODE_3900_length_1199_cov_12.005455	436	516	7	6	80	0.0750000
NODE_3900_length_1199_cov_12.005455	436	516	8	17	80	0.2125000
NODE_3900_length_1199_cov_12.005455	512	592	6	44	80	0.5500000
NODE_3900_length_1199_cov_12.005455	512	592	7	34	80	0.4250000
NODE_3900_length_1199_cov_12.005455	512	592	8	2	80	0.0250000
NODE_3900_length_1199_cov_12.005455	565	645	3	4	80	0.0500000
NODE_3900_length_1199_cov_12.005455	565	645	4	17	80	0.2125000
NODE_3900_length_1199_cov_12.005455	565	645	5	1	80	0.0125000
NODE_3900_length_1199_cov_12.005455	565	645	6	50	80	0.6250000
NODE_3900_length_1199_cov_12.005455	565	645	7	8	80	0.1000000
NODE_3902_length_1198_cov_36.830755	619	699	13	1	80	0.0125000
NODE_3902_length_1198_cov_36.830755	619	699	14	10	80	0.1250000
NODE_3902_length_1198_cov_36.830755	619	699	15	12	80	0.1500000
NODE_3902_length_1198_cov_36.830755	619	699	16	34	80	0.4250000
NODE_3902_length_1198_cov_36.830755	619	699	17	18	80	0.2250000
NODE_3902_length_1198_cov_36.830755	619	699	18	5	80	0.0625000
NODE_3902_length_1198_cov_36.830755	672	752	10	25	80	0.3125000
NODE_3902_length_1198_cov_36.830755	672	752	11	17	80	0.2125000
NODE_3902_length_1198_cov_36.830755	672	752	13	7	80	0.0875000
NODE_3902_length_1198_cov_36.830755	672	752	14	6	80	0.0750000
NODE_3902_length_1198_cov_36.830755	672	752	15	12	80	0.1500000
NODE_3902_length_1198_cov_36.830755	672	752	16	2	80	0.0250000
NODE_3902_length_1198_cov_36.830755	672	752	17	11	80	0.1375000
NODE_3903_length_1198_cov_22.864422	719	799	5	6	80	0.0750000
NODE_3903_length_1198_cov_22.864422	719	799	6	43	80	0.5375000
NODE_3903_length_1198_cov_22.864422	719	799	7	9	80	0.1125000
NODE_3903_length_1198_cov_22.864422	719	799	8	22	80	0.2750000
NODE_3903_length_1198_cov_22.864422	772	852	4	19	80	0.2375000
NODE_3903_length_1198_cov_22.864422	772	852	5	40	80	0.5000000
NODE_3903_length_1198_cov_22.864422	772	852	6	21	80	0.2625000
NODE_3904_length_1198_cov_17.619654	260	340	3	36	80	0.4500000
NODE_3904_length_1198_cov_17.619654	260	340	4	44	80	0.5500000
NODE_3904_length_1198_cov_17.619654	313	392	2	4	79	0.0506329
NODE_3904_length_1198_cov_17.619654	313	392	3	64	79	0.8101266
NODE_3904_length_1198_cov_17.619654	313	392	4	11	79	0.1392405
NODE_3905_length_1198_cov_10.148317	718	798	5	5	80	0.0625000
NODE_3905_length_1198_cov_10.148317	718	798	6	10	80	0.1250000
NODE_3905_length_1198_cov_10.148317	718	798	8	7	80	0.0875000
NODE_3905_length_1198_cov_10.148317	718	798	9	39	80	0.4875000
NODE_3905_length_1198_cov_10.148317	718	798	10	19	80	0.2375000
NODE_3905_length_1198_cov_10.148317	771	851	3	34	80	0.4250000
NODE_3905_length_1198_cov_10.148317	771	851	4	12	80	0.1500000
NODE_3905_length_1198_cov_10.148317	771	851	5	12	80	0.1500000
NODE_3905_length_1198_cov_10.148317	771	851	6	10	80	0.1250000
NODE_3905_length_1198_cov_10.148317	771	851	8	2	80	0.0250000
NODE_3905_length_1198_cov_10.148317	771	851	9	10	80	0.1250000
NODE_3906_length_1198_cov_6.733394	549	629	0	9	80	0.1125000
NODE_3906_length_1198_cov_6.733394	549	629	1	3	80	0.0375000
NODE_3906_length_1198_cov_6.733394	549	629	2	1	80	0.0125000
NODE_3906_length_1198_cov_6.733394	549	629	3	67	80	0.8375000
NODE_3906_length_1198_cov_6.733394	602	682	0	19	80	0.2375000
NODE_3906_length_1198_cov_6.733394	602	682	3	61	80	0.7625000
NODE_3912_length_1197_cov_27.653005	417	497	0	12	80	0.1500000
NODE_3912_length_1197_cov_27.653005	417	497	1	68	80	0.8500000
NODE_3912_length_1197_cov_27.653005	470	550	1	43	80	0.5375000
NODE_3912_length_1197_cov_27.653005	470	550	2	5	80	0.0625000
NODE_3912_length_1197_cov_27.653005	470	550	3	17	80	0.2125000
NODE_3912_length_1197_cov_27.653005	470	550	4	2	80	0.0250000
NODE_3912_length_1197_cov_27.653005	470	550	5	4	80	0.0500000
NODE_3912_length_1197_cov_27.653005	470	550	6	9	80	0.1125000
NODE_3912_length_1197_cov_27.653005	546	626	6	6	80	0.0750000
NODE_3912_length_1197_cov_27.653005	546	626	7	20	80	0.2500000
NODE_3912_length_1197_cov_27.653005	546	626	8	47	80	0.5875000
NODE_3912_length_1197_cov_27.653005	546	626	9	7	80	0.0875000
NODE_3912_length_1197_cov_27.653005	599	679	7	8	80	0.1000000
NODE_3912_length_1197_cov_27.653005	599	679	8	38	80	0.4750000
NODE_3912_length_1197_cov_27.653005	599	679	9	6	80	0.0750000
NODE_3912_length_1197_cov_27.653005	599	679	10	17	80	0.2125000
NODE_3912_length_1197_cov_27.653005	599	679	11	11	80	0.1375000
NODE_3913_length_1197_cov_14.653916	490	570	3	48	80	0.6000000
NODE_3913_length_1197_cov_14.653916	490	570	4	32	80	0.4000000
NODE_3913_length_1197_cov_14.653916	543	623	3	12	80	0.1500000
NODE_3913_length_1197_cov_14.653916	543	623	4	44	80	0.5500000
NODE_3913_length_1197_cov_14.653916	543	623	5	17	80	0.2125000
NODE_3913_length_1197_cov_14.653916	543	623	6	7	80	0.0875000
NODE_3921_length_1196_cov_26.169553	298	378	4	21	80	0.2625000
NODE_3921_length_1196_cov_26.169553	298	378	5	59	80	0.7375000
NODE_3921_length_1196_cov_26.169553	351	431	1	14	80	0.1750000
NODE_3921_length_1196_cov_26.169553	351	431	3	3	80	0.0375000
NODE_3921_length_1196_cov_26.169553	351	431	4	20	80	0.2500000
NODE_3921_length_1196_cov_26.169553	351	431	5	43	80	0.5375000
NODE_3921_length_1196_cov_26.169553	427	507	1	63	80	0.7875000
NODE_3921_length_1196_cov_26.169553	427	507	2	17	80	0.2125000
NODE_3921_length_1196_cov_26.169553	480	560	1	80	80	1.0000000
NODE_3922_length_1196_cov_21.755697	521	601	6	15	80	0.1875000
NODE_3922_length_1196_cov_21.755697	521	601	8	59	80	0.7375000
NODE_3922_length_1196_cov_21.755697	521	601	9	6	80	0.0750000
NODE_3922_length_1196_cov_21.755697	574	654	7	3	80	0.0375000
NODE_3922_length_1196_cov_21.755697	574	654	8	56	80	0.7000000
NODE_3922_length_1196_cov_21.755697	574	654	9	17	80	0.2125000
NODE_3922_length_1196_cov_21.755697	574	654	10	4	80	0.0500000
NODE_3922_length_1196_cov_21.755697	650	730	6	4	80	0.0500000
NODE_3922_length_1196_cov_21.755697	650	730	8	10	80	0.1250000
NODE_3922_length_1196_cov_21.755697	650	730	9	3	80	0.0375000
NODE_3922_length_1196_cov_21.755697	650	730	10	9	80	0.1125000
NODE_3922_length_1196_cov_21.755697	650	730	11	48	80	0.6000000
NODE_3922_length_1196_cov_21.755697	650	730	12	3	80	0.0375000
NODE_3922_length_1196_cov_21.755697	650	730	13	3	80	0.0375000
NODE_3922_length_1196_cov_21.755697	703	783	6	8	80	0.1000000
NODE_3922_length_1196_cov_21.755697	703	783	7	3	80	0.0375000
NODE_3922_length_1196_cov_21.755697	703	783	8	1	80	0.0125000
NODE_3922_length_1196_cov_21.755697	703	783	9	25	80	0.3125000
NODE_3922_length_1196_cov_21.755697	703	783	11	43	80	0.5375000
NODE_3923_length_1196_cov_5.966272	556	636	0	40	80	0.5000000
NODE_3923_length_1196_cov_5.966272	556	636	2	40	80	0.5000000
NODE_3923_length_1196_cov_5.966272	609	689	2	80	80	1.0000000
NODE_3927_length_1195_cov_69.056569	474	554	2	9	80	0.1125000
NODE_3927_length_1195_cov_69.056569	474	554	4	1	80	0.0125000
NODE_3927_length_1195_cov_69.056569	474	554	5	11	80	0.1375000
NODE_3927_length_1195_cov_69.056569	474	554	6	1	80	0.0125000
NODE_3927_length_1195_cov_69.056569	474	554	8	30	80	0.3750000
NODE_3927_length_1195_cov_69.056569	474	554	9	6	80	0.0750000
NODE_3927_length_1195_cov_69.056569	474	554	10	21	80	0.2625000
NODE_3927_length_1195_cov_69.056569	474	554	11	1	80	0.0125000
NODE_3927_length_1195_cov_69.056569	527	607	9	5	80	0.0625000
NODE_3927_length_1195_cov_69.056569	527	607	10	59	80	0.7375000
NODE_3927_length_1195_cov_69.056569	527	607	11	7	80	0.0875000
NODE_3927_length_1195_cov_69.056569	527	607	12	9	80	0.1125000
NODE_3927_length_1195_cov_69.056569	603	683	6	3	80	0.0375000
NODE_3927_length_1195_cov_69.056569	603	683	7	36	80	0.4500000
NODE_3927_length_1195_cov_69.056569	603	683	8	23	80	0.2875000
NODE_3927_length_1195_cov_69.056569	603	683	10	5	80	0.0625000
NODE_3927_length_1195_cov_69.056569	603	683	11	13	80	0.1625000
NODE_3927_length_1195_cov_69.056569	656	736	3	21	80	0.2625000
NODE_3927_length_1195_cov_69.056569	656	736	5	12	80	0.1500000
NODE_3927_length_1195_cov_69.056569	656	736	6	21	80	0.2625000
NODE_3927_length_1195_cov_69.056569	656	736	7	16	80	0.2000000
NODE_3927_length_1195_cov_69.056569	656	736	8	10	80	0.1250000
NODE_3928_length_1195_cov_65.062044	579	659	3	26	80	0.3250000
NODE_3928_length_1195_cov_65.062044	579	659	4	33	80	0.4125000
NODE_3928_length_1195_cov_65.062044	579	659	5	11	80	0.1375000
NODE_3928_length_1195_cov_65.062044	579	659	7	10	80	0.1250000
NODE_3928_length_1195_cov_65.062044	632	712	4	6	80	0.0750000
NODE_3928_length_1195_cov_65.062044	632	712	5	11	80	0.1375000
NODE_3928_length_1195_cov_65.062044	632	712	7	14	80	0.1750000
NODE_3928_length_1195_cov_65.062044	632	712	8	3	80	0.0375000
NODE_3928_length_1195_cov_65.062044	632	712	9	2	80	0.0250000
NODE_3928_length_1195_cov_65.062044	632	712	10	37	80	0.4625000
NODE_3928_length_1195_cov_65.062044	632	712	11	4	80	0.0500000
NODE_3928_length_1195_cov_65.062044	632	712	12	3	80	0.0375000
NODE_3928_length_1195_cov_65.062044	708	788	10	1	80	0.0125000
NODE_3928_length_1195_cov_65.062044	708	788	12	3	80	0.0375000
NODE_3928_length_1195_cov_65.062044	708	788	13	3	80	0.0375000
NODE_3928_length_1195_cov_65.062044	708	788	17	12	80	0.1500000
NODE_3928_length_1195_cov_65.062044	708	788	18	39	80	0.4875000
NODE_3928_length_1195_cov_65.062044	708	788	20	22	80	0.2750000
NODE_3928_length_1195_cov_65.062044	761	841	5	9	80	0.1125000
NODE_3928_length_1195_cov_65.062044	761	841	6	8	80	0.1000000
NODE_3928_length_1195_cov_65.062044	761	841	7	1	80	0.0125000
NODE_3928_length_1195_cov_65.062044	761	841	11	1	80	0.0125000
NODE_3928_length_1195_cov_65.062044	761	841	12	5	80	0.0625000
NODE_3928_length_1195_cov_65.062044	761	841	13	1	80	0.0125000
NODE_3928_length_1195_cov_65.062044	761	841	14	1	80	0.0125000
NODE_3928_length_1195_cov_65.062044	761	841	16	2	80	0.0250000
NODE_3928_length_1195_cov_65.062044	761	841	17	24	80	0.3000000
NODE_3928_length_1195_cov_65.062044	761	841	18	5	80	0.0625000
NODE_3928_length_1195_cov_65.062044	761	841	20	23	80	0.2875000
NODE_3929_length_1195_cov_23.187044	460	540	2	75	80	0.9375000
NODE_3929_length_1195_cov_23.187044	460	540	4	5	80	0.0625000
NODE_3929_length_1195_cov_23.187044	513	593	2	80	80	1.0000000
NODE_3930_length_1195_cov_18.983577	521	601	2	7	80	0.0875000
NODE_3930_length_1195_cov_18.983577	521	601	3	25	80	0.3125000
NODE_3930_length_1195_cov_18.983577	521	601	5	9	80	0.1125000
NODE_3930_length_1195_cov_18.983577	521	601	6	23	80	0.2875000
NODE_3930_length_1195_cov_18.983577	521	601	7	16	80	0.2000000
NODE_3930_length_1195_cov_18.983577	574	654	6	29	80	0.3625000
NODE_3930_length_1195_cov_18.983577	574	654	7	51	80	0.6375000
NODE_3931_length_1195_cov_14.119526	726	806	0	80	80	1.0000000
NODE_3931_length_1195_cov_14.119526	779	859	0	37	80	0.4625000
NODE_3931_length_1195_cov_14.119526	779	859	1	43	80	0.5375000
NODE_3931_length_1195_cov_14.119526	855	935	1	6	80	0.0750000
NODE_3931_length_1195_cov_14.119526	855	935	2	74	80	0.9250000
NODE_3931_length_1195_cov_14.119526	908	988	1	22	80	0.2750000
NODE_3931_length_1195_cov_14.119526	908	988	2	58	80	0.7250000
NODE_3932_length_1195_cov_13.805657	759	839	2	80	80	1.0000000
NODE_3932_length_1195_cov_13.805657	812	892	0	5	80	0.0625000
NODE_3932_length_1195_cov_13.805657	812	892	1	14	80	0.1750000
NODE_3932_length_1195_cov_13.805657	812	892	2	61	80	0.7625000
NODE_3938_length_1195_cov_1.969891	912	992	0	80	80	1.0000000
NODE_3938_length_1195_cov_1.969891	912	992	0	80	80	1.0000000
NODE_3941_length_1194_cov_40.157991	237	317	8	8	80	0.1000000
NODE_3941_length_1194_cov_40.157991	237	317	9	17	80	0.2125000
NODE_3941_length_1194_cov_40.157991	237	317	10	20	80	0.2500000
NODE_3941_length_1194_cov_40.157991	237	317	12	1	80	0.0125000
NODE_3941_length_1194_cov_40.157991	237	317	13	34	80	0.4250000
NODE_3941_length_1194_cov_40.157991	290	370	7	4	80	0.0500000
NODE_3941_length_1194_cov_40.157991	290	370	9	15	80	0.1875000
NODE_3941_length_1194_cov_40.157991	290	370	10	12	80	0.1500000
NODE_3941_length_1194_cov_40.157991	290	370	12	12	80	0.1500000
NODE_3941_length_1194_cov_40.157991	290	370	13	37	80	0.4625000
NODE_3946_length_1193_cov_34.295247	443	523	7	4	80	0.0500000
NODE_3946_length_1193_cov_34.295247	443	523	9	16	80	0.2000000
NODE_3946_length_1193_cov_34.295247	443	523	11	29	80	0.3625000
NODE_3946_length_1193_cov_34.295247	443	523	15	31	80	0.3875000
NODE_3946_length_1193_cov_34.295247	496	576	6	4	80	0.0500000
NODE_3946_length_1193_cov_34.295247	496	576	10	13	80	0.1625000
NODE_3946_length_1193_cov_34.295247	496	576	14	26	80	0.3250000
NODE_3946_length_1193_cov_34.295247	496	576	15	36	80	0.4500000
NODE_3946_length_1193_cov_34.295247	496	576	16	1	80	0.0125000
NODE_3947_length_1193_cov_16.930530	124	154	0	29	30	0.9666666
NODE_3947_length_1193_cov_16.930530	124	154	2	1	30	0.0333333
NODE_3947_length_1193_cov_16.930530	390	470	5	5	80	0.0625000
NODE_3947_length_1193_cov_16.930530	390	470	7	46	80	0.5750000
NODE_3947_length_1193_cov_16.930530	390	470	8	18	80	0.2250000
NODE_3947_length_1193_cov_16.930530	390	470	9	11	80	0.1375000
NODE_3947_length_1193_cov_16.930530	443	523	4	3	80	0.0375000
NODE_3947_length_1193_cov_16.930530	443	523	5	13	80	0.1625000
NODE_3947_length_1193_cov_16.930530	443	523	7	36	80	0.4500000
NODE_3947_length_1193_cov_16.930530	443	523	8	16	80	0.2000000
NODE_3947_length_1193_cov_16.930530	443	523	9	12	80	0.1500000
NODE_3949_length_1192_cov_26.803294	205	285	2	11	80	0.1375000
NODE_3949_length_1192_cov_26.803294	205	285	3	17	80	0.2125000
NODE_3949_length_1192_cov_26.803294	205	285	6	11	80	0.1375000
NODE_3949_length_1192_cov_26.803294	205	285	8	27	80	0.3375000
NODE_3949_length_1192_cov_26.803294	205	285	9	14	80	0.1750000
NODE_3949_length_1192_cov_26.803294	258	338	8	26	80	0.3250000
NODE_3949_length_1192_cov_26.803294	258	338	9	8	80	0.1000000
NODE_3949_length_1192_cov_26.803294	258	338	11	19	80	0.2375000
NODE_3949_length_1192_cov_26.803294	258	338	12	5	80	0.0625000
NODE_3949_length_1192_cov_26.803294	258	338	13	2	80	0.0250000
NODE_3949_length_1192_cov_26.803294	258	338	16	10	80	0.1250000
NODE_3949_length_1192_cov_26.803294	258	338	17	2	80	0.0250000
NODE_3949_length_1192_cov_26.803294	258	338	18	8	80	0.1000000
NODE_3949_length_1192_cov_26.803294	334	414	13	1	80	0.0125000
NODE_3949_length_1192_cov_26.803294	334	414	15	19	80	0.2375000
NODE_3949_length_1192_cov_26.803294	334	414	16	11	80	0.1375000
NODE_3949_length_1192_cov_26.803294	334	414	17	2	80	0.0250000
NODE_3949_length_1192_cov_26.803294	334	414	18	21	80	0.2625000
NODE_3949_length_1192_cov_26.803294	334	414	19	26	80	0.3250000
NODE_3949_length_1192_cov_26.803294	387	467	4	8	80	0.1000000
NODE_3949_length_1192_cov_26.803294	387	467	7	11	80	0.1375000
NODE_3949_length_1192_cov_26.803294	387	467	9	2	80	0.0250000
NODE_3949_length_1192_cov_26.803294	387	467	10	12	80	0.1500000
NODE_3949_length_1192_cov_26.803294	387	467	11	11	80	0.1375000
NODE_3949_length_1192_cov_26.803294	387	467	13	10	80	0.1250000
NODE_3949_length_1192_cov_26.803294	387	467	15	19	80	0.2375000
NODE_3949_length_1192_cov_26.803294	387	467	16	7	80	0.0875000
NODE_3950_length_1192_cov_23.228728	487	567	1	12	80	0.1500000
NODE_3950_length_1192_cov_23.228728	487	567	2	13	80	0.1625000
NODE_3950_length_1192_cov_23.228728	487	567	3	43	80	0.5375000
NODE_3950_length_1192_cov_23.228728	487	567	4	3	80	0.0375000
NODE_3950_length_1192_cov_23.228728	487	567	6	8	80	0.1000000
NODE_3950_length_1192_cov_23.228728	487	567	7	1	80	0.0125000
NODE_3950_length_1192_cov_23.228728	540	620	2	5	80	0.0625000
NODE_3950_length_1192_cov_23.228728	540	620	3	10	80	0.1250000
NODE_3950_length_1192_cov_23.228728	540	620	4	3	80	0.0375000
NODE_3950_length_1192_cov_23.228728	540	620	6	8	80	0.1000000
NODE_3950_length_1192_cov_23.228728	540	620	7	28	80	0.3500000
NODE_3950_length_1192_cov_23.228728	540	620	8	5	80	0.0625000
NODE_3950_length_1192_cov_23.228728	540	620	10	21	80	0.2625000
NODE_3950_length_1192_cov_23.228728	616	696	9	39	80	0.4875000
NODE_3950_length_1192_cov_23.228728	616	696	10	23	80	0.2875000
NODE_3950_length_1192_cov_23.228728	616	696	11	18	80	0.2250000
NODE_3950_length_1192_cov_23.228728	669	749	1	5	80	0.0625000
NODE_3950_length_1192_cov_23.228728	669	749	2	5	80	0.0625000
NODE_3950_length_1192_cov_23.228728	669	749	4	23	80	0.2875000
NODE_3950_length_1192_cov_23.228728	669	749	5	8	80	0.1000000
NODE_3950_length_1192_cov_23.228728	669	749	7	3	80	0.0375000
NODE_3950_length_1192_cov_23.228728	669	749	8	4	80	0.0500000
NODE_3950_length_1192_cov_23.228728	669	749	9	32	80	0.4000000
NODE_3951_length_1192_cov_18.314730	613	693	0	1	80	0.0125000
NODE_3951_length_1192_cov_18.314730	613	693	1	79	80	0.9875000
NODE_3951_length_1192_cov_18.314730	666	746	1	30	80	0.3750000
NODE_3951_length_1192_cov_18.314730	666	746	2	14	80	0.1750000
NODE_3951_length_1192_cov_18.314730	666	746	3	1	80	0.0125000
NODE_3951_length_1192_cov_18.314730	666	746	4	13	80	0.1625000
NODE_3951_length_1192_cov_18.314730	666	746	5	2	80	0.0250000
NODE_3951_length_1192_cov_18.314730	666	746	6	20	80	0.2500000
NODE_3951_length_1192_cov_18.314730	742	822	5	17	80	0.2125000
NODE_3951_length_1192_cov_18.314730	742	822	6	22	80	0.2750000
NODE_3951_length_1192_cov_18.314730	742	822	7	17	80	0.2125000
NODE_3951_length_1192_cov_18.314730	742	822	8	24	80	0.3000000
NODE_3951_length_1192_cov_18.314730	795	875	4	2	80	0.0250000
NODE_3951_length_1192_cov_18.314730	795	875	5	12	80	0.1500000
NODE_3951_length_1192_cov_18.314730	795	875	6	1	80	0.0125000
NODE_3951_length_1192_cov_18.314730	795	875	7	17	80	0.2125000
NODE_3951_length_1192_cov_18.314730	795	875	8	48	80	0.6000000
NODE_3952_length_1192_cov_14.888381	622	702	2	1	80	0.0125000
NODE_3952_length_1192_cov_14.888381	622	702	3	26	80	0.3250000
NODE_3952_length_1192_cov_14.888381	622	702	4	53	80	0.6625000
NODE_3952_length_1192_cov_14.888381	675	755	2	34	80	0.4250000
NODE_3952_length_1192_cov_14.888381	675	755	3	42	80	0.5250000
NODE_3952_length_1192_cov_14.888381	675	755	4	4	80	0.0500000
NODE_3952_length_1192_cov_14.888381	751	831	0	5	80	0.0625000
NODE_3952_length_1192_cov_14.888381	751	831	2	75	80	0.9375000
NODE_3952_length_1192_cov_14.888381	804	884	0	58	80	0.7250000
NODE_3952_length_1192_cov_14.888381	804	884	2	22	80	0.2750000
NODE_3953_length_1192_cov_9.995425	161	241	6	17	80	0.2125000
NODE_3953_length_1192_cov_9.995425	161	241	7	21	80	0.2625000
NODE_3953_length_1192_cov_9.995425	161	241	8	42	80	0.5250000
NODE_3953_length_1192_cov_9.995425	214	294	6	4	80	0.0500000
NODE_3953_length_1192_cov_9.995425	214	294	7	30	80	0.3750000
NODE_3953_length_1192_cov_9.995425	214	294	8	46	80	0.5750000
NODE_3954_length_1192_cov_5.078683	749	829	2	24	80	0.3000000
NODE_3954_length_1192_cov_5.078683	749	829	4	25	80	0.3125000
NODE_3954_length_1192_cov_5.078683	749	829	5	31	80	0.3875000
NODE_3954_length_1192_cov_5.078683	802	882	1	24	80	0.3000000
NODE_3954_length_1192_cov_5.078683	802	882	2	2	80	0.0250000
NODE_3954_length_1192_cov_5.078683	802	882	4	27	80	0.3375000
NODE_3954_length_1192_cov_5.078683	802	882	5	27	80	0.3375000
NODE_3960_length_1192_cov_0.614822	1046	1126	0	80	80	1.0000000
NODE_3961_length_1191_cov_55.466117	392	472	2	24	80	0.3000000
NODE_3961_length_1191_cov_55.466117	392	472	3	16	80	0.2000000
NODE_3961_length_1191_cov_55.466117	392	472	6	26	80	0.3250000
NODE_3961_length_1191_cov_55.466117	392	472	7	1	80	0.0125000
NODE_3961_length_1191_cov_55.466117	392	472	8	13	80	0.1625000
NODE_3961_length_1191_cov_55.466117	445	525	6	13	80	0.1625000
NODE_3961_length_1191_cov_55.466117	445	525	7	1	80	0.0125000
NODE_3961_length_1191_cov_55.466117	445	525	8	18	80	0.2250000
NODE_3961_length_1191_cov_55.466117	445	525	9	42	80	0.5250000
NODE_3961_length_1191_cov_55.466117	445	525	10	6	80	0.0750000
NODE_3961_length_1191_cov_55.466117	521	601	8	3	80	0.0375000
NODE_3961_length_1191_cov_55.466117	521	601	9	3	80	0.0375000
NODE_3961_length_1191_cov_55.466117	521	601	10	37	80	0.4625000
NODE_3961_length_1191_cov_55.466117	521	601	11	32	80	0.4000000
NODE_3961_length_1191_cov_55.466117	521	601	12	2	80	0.0250000
NODE_3961_length_1191_cov_55.466117	521	601	13	2	80	0.0250000
NODE_3961_length_1191_cov_55.466117	521	601	14	1	80	0.0125000
NODE_3961_length_1191_cov_55.466117	574	654	10	27	80	0.3375000
NODE_3961_length_1191_cov_55.466117	574	654	11	46	80	0.5750000
NODE_3961_length_1191_cov_55.466117	574	654	12	3	80	0.0375000
NODE_3961_length_1191_cov_55.466117	574	654	13	3	80	0.0375000
NODE_3961_length_1191_cov_55.466117	574	654	14	1	80	0.0125000
NODE_3963_length_1191_cov_20.677656	695	775	8	26	80	0.3250000
NODE_3963_length_1191_cov_20.677656	695	775	9	8	80	0.1000000
NODE_3963_length_1191_cov_20.677656	695	775	10	12	80	0.1500000
NODE_3963_length_1191_cov_20.677656	695	775	11	14	80	0.1750000
NODE_3963_length_1191_cov_20.677656	695	775	12	15	80	0.1875000
NODE_3963_length_1191_cov_20.677656	695	775	13	2	80	0.0250000
NODE_3963_length_1191_cov_20.677656	695	775	14	3	80	0.0375000
NODE_3963_length_1191_cov_20.677656	748	828	7	17	80	0.2125000
NODE_3963_length_1191_cov_20.677656	748	828	8	41	80	0.5125000
NODE_3963_length_1191_cov_20.677656	748	828	9	3	80	0.0375000
NODE_3963_length_1191_cov_20.677656	748	828	11	11	80	0.1375000
NODE_3963_length_1191_cov_20.677656	748	828	12	6	80	0.0750000
NODE_3963_length_1191_cov_20.677656	748	828	14	2	80	0.0250000
NODE_3964_length_1191_cov_9.074176	420	500	3	1	80	0.0125000
NODE_3964_length_1191_cov_9.074176	420	500	4	20	80	0.2500000
NODE_3964_length_1191_cov_9.074176	420	500	5	59	80	0.7375000
NODE_3964_length_1191_cov_9.074176	473	553	2	29	80	0.3625000
NODE_3964_length_1191_cov_9.074176	473	553	3	2	80	0.0250000
NODE_3964_length_1191_cov_9.074176	473	553	4	42	80	0.5250000
NODE_3964_length_1191_cov_9.074176	473	553	5	7	80	0.0875000
NODE_3968_length_1190_cov_40.916590	521	601	6	4	80	0.0500000
NODE_3968_length_1190_cov_40.916590	521	601	7	4	80	0.0500000
NODE_3968_length_1190_cov_40.916590	521	601	9	4	80	0.0500000
NODE_3968_length_1190_cov_40.916590	521	601	12	1	80	0.0125000
NODE_3968_length_1190_cov_40.916590	521	601	14	1	80	0.0125000
NODE_3968_length_1190_cov_40.916590	521	601	15	8	80	0.1000000
NODE_3968_length_1190_cov_40.916590	521	601	17	10	80	0.1250000
NODE_3968_length_1190_cov_40.916590	521	601	18	41	80	0.5125000
NODE_3968_length_1190_cov_40.916590	521	601	19	7	80	0.0875000
NODE_3968_length_1190_cov_40.916590	574	654	2	8	80	0.1000000
NODE_3968_length_1190_cov_40.916590	574	654	3	15	80	0.1875000
NODE_3968_length_1190_cov_40.916590	574	654	4	15	80	0.1875000
NODE_3968_length_1190_cov_40.916590	574	654	5	11	80	0.1375000
NODE_3968_length_1190_cov_40.916590	574	654	6	8	80	0.1000000
NODE_3968_length_1190_cov_40.916590	574	654	7	4	80	0.0500000
NODE_3968_length_1190_cov_40.916590	574	654	9	4	80	0.0500000
NODE_3968_length_1190_cov_40.916590	574	654	12	1	80	0.0125000
NODE_3968_length_1190_cov_40.916590	574	654	14	1	80	0.0125000
NODE_3968_length_1190_cov_40.916590	574	654	15	8	80	0.1000000
NODE_3968_length_1190_cov_40.916590	574	654	17	5	80	0.0625000
NODE_3968_length_1190_cov_40.916590	650	730	4	13	80	0.1625000
NODE_3968_length_1190_cov_40.916590	650	730	5	12	80	0.1500000
NODE_3968_length_1190_cov_40.916590	650	730	6	55	80	0.6875000
NODE_3968_length_1190_cov_40.916590	703	783	2	17	80	0.2125000
NODE_3968_length_1190_cov_40.916590	703	783	4	39	80	0.4875000
NODE_3968_length_1190_cov_40.916590	703	783	6	24	80	0.3000000
NODE_3969_length_1190_cov_20.715857	257	337	2	15	80	0.1875000
NODE_3969_length_1190_cov_20.715857	257	337	4	20	80	0.2500000
NODE_3969_length_1190_cov_20.715857	257	337	5	5	80	0.0625000
NODE_3969_length_1190_cov_20.715857	257	337	6	40	80	0.5000000
NODE_3969_length_1190_cov_20.715857	310	390	2	6	80	0.0750000
NODE_3969_length_1190_cov_20.715857	310	390	4	16	80	0.2000000
NODE_3969_length_1190_cov_20.715857	310	390	6	58	80	0.7250000
NODE_3970_length_1190_cov_19.724106	296	376	4	4	80	0.0500000
NODE_3970_length_1190_cov_19.724106	296	376	5	4	80	0.0500000
NODE_3970_length_1190_cov_19.724106	296	376	6	29	80	0.3625000
NODE_3970_length_1190_cov_19.724106	296	376	7	10	80	0.1250000
NODE_3970_length_1190_cov_19.724106	296	376	8	30	80	0.3750000
NODE_3970_length_1190_cov_19.724106	296	376	9	3	80	0.0375000
NODE_3970_length_1190_cov_19.724106	349	429	6	1	80	0.0125000
NODE_3970_length_1190_cov_19.724106	349	429	7	62	80	0.7750000
NODE_3970_length_1190_cov_19.724106	349	429	8	17	80	0.2125000
NODE_3973_length_1190_cov_2.698442	1022	1070	0	28	48	0.5833333
NODE_3973_length_1190_cov_2.698442	1022	1070	2	20	48	0.4166667
NODE_3973_length_1190_cov_2.698442	1075	1123	2	48	48	1.0000000
NODE_3977_length_1189_cov_29.193578	576	656	4	4	80	0.0500000
NODE_3977_length_1189_cov_29.193578	576	656	6	27	80	0.3375000
NODE_3977_length_1189_cov_29.193578	576	656	7	13	80	0.1625000
NODE_3977_length_1189_cov_29.193578	576	656	8	4	80	0.0500000
NODE_3977_length_1189_cov_29.193578	576	656	9	21	80	0.2625000
NODE_3977_length_1189_cov_29.193578	576	656	10	11	80	0.1375000
NODE_3977_length_1189_cov_29.193578	629	709	8	8	80	0.1000000
NODE_3977_length_1189_cov_29.193578	629	709	9	12	80	0.1500000
NODE_3977_length_1189_cov_29.193578	629	709	10	60	80	0.7500000
NODE_3978_length_1189_cov_13.484404	315	341	0	26	26	1.0000000
NODE_3978_length_1189_cov_13.484404	366	446	0	80	80	1.0000000
NODE_3984_length_1188_cov_19.278237	396	476	4	11	80	0.1375000
NODE_3984_length_1188_cov_19.278237	396	476	5	1	80	0.0125000
NODE_3984_length_1188_cov_19.278237	396	476	6	33	80	0.4125000
NODE_3984_length_1188_cov_19.278237	396	476	8	8	80	0.1000000
NODE_3984_length_1188_cov_19.278237	396	476	10	2	80	0.0250000
NODE_3984_length_1188_cov_19.278237	396	476	11	6	80	0.0750000
NODE_3984_length_1188_cov_19.278237	396	476	12	19	80	0.2375000
NODE_3984_length_1188_cov_19.278237	449	529	10	23	80	0.2875000
NODE_3984_length_1188_cov_19.278237	449	529	11	31	80	0.3875000
NODE_3984_length_1188_cov_19.278237	449	529	12	19	80	0.2375000
NODE_3984_length_1188_cov_19.278237	449	529	13	7	80	0.0875000
NODE_3990_length_1187_cov_63.185662	529	609	7	16	80	0.2000000
NODE_3990_length_1187_cov_63.185662	529	609	8	18	80	0.2250000
NODE_3990_length_1187_cov_63.185662	529	609	9	19	80	0.2375000
NODE_3990_length_1187_cov_63.185662	529	609	10	27	80	0.3375000
NODE_3990_length_1187_cov_63.185662	582	662	6	6	80	0.0750000
NODE_3990_length_1187_cov_63.185662	582	662	7	14	80	0.1750000
NODE_3990_length_1187_cov_63.185662	582	662	8	35	80	0.4375000
NODE_3990_length_1187_cov_63.185662	582	662	9	25	80	0.3125000
NODE_3990_length_1187_cov_63.185662	658	738	8	3	80	0.0375000
NODE_3990_length_1187_cov_63.185662	658	738	9	31	80	0.3875000
NODE_3990_length_1187_cov_63.185662	658	738	10	12	80	0.1500000
NODE_3990_length_1187_cov_63.185662	658	738	12	5	80	0.0625000
NODE_3990_length_1187_cov_63.185662	658	738	13	4	80	0.0500000
NODE_3990_length_1187_cov_63.185662	658	738	14	19	80	0.2375000
NODE_3990_length_1187_cov_63.185662	658	738	15	6	80	0.0750000
NODE_3990_length_1187_cov_63.185662	711	791	11	4	80	0.0500000
NODE_3990_length_1187_cov_63.185662	711	791	12	4	80	0.0500000
NODE_3990_length_1187_cov_63.185662	711	791	13	37	80	0.4625000
NODE_3990_length_1187_cov_63.185662	711	791	14	27	80	0.3375000
NODE_3990_length_1187_cov_63.185662	711	791	15	8	80	0.1000000
NODE_3991_length_1187_cov_36.926471	432	512	4	4	80	0.0500000
NODE_3991_length_1187_cov_36.926471	432	512	5	2	80	0.0250000
NODE_3991_length_1187_cov_36.926471	432	512	6	29	80	0.3625000
NODE_3991_length_1187_cov_36.926471	432	512	7	5	80	0.0625000
NODE_3991_length_1187_cov_36.926471	432	512	8	31	80	0.3875000
NODE_3991_length_1187_cov_36.926471	432	512	9	9	80	0.1125000
NODE_3991_length_1187_cov_36.926471	485	565	8	30	80	0.3750000
NODE_3991_length_1187_cov_36.926471	485	565	9	30	80	0.3750000
NODE_3991_length_1187_cov_36.926471	485	565	10	20	80	0.2500000
NODE_3991_length_1187_cov_36.926471	561	641	4	1	80	0.0125000
NODE_3991_length_1187_cov_36.926471	561	641	5	18	80	0.2250000
NODE_3991_length_1187_cov_36.926471	561	641	6	5	80	0.0625000
NODE_3991_length_1187_cov_36.926471	561	641	7	42	80	0.5250000
NODE_3991_length_1187_cov_36.926471	561	641	8	8	80	0.1000000
NODE_3991_length_1187_cov_36.926471	561	641	9	3	80	0.0375000
NODE_3991_length_1187_cov_36.926471	561	641	10	3	80	0.0375000
NODE_3991_length_1187_cov_36.926471	614	694	4	42	80	0.5250000
NODE_3991_length_1187_cov_36.926471	614	694	5	30	80	0.3750000
NODE_3991_length_1187_cov_36.926471	614	694	6	5	80	0.0625000
NODE_3991_length_1187_cov_36.926471	614	694	7	3	80	0.0375000
NODE_3992_length_1187_cov_20.383272	492	572	3	15	80	0.1875000
NODE_3992_length_1187_cov_20.383272	492	572	4	65	80	0.8125000
NODE_3992_length_1187_cov_20.383272	545	625	1	8	80	0.1000000
NODE_3992_length_1187_cov_20.383272	545	625	2	33	80	0.4125000
NODE_3992_length_1187_cov_20.383272	545	625	3	4	80	0.0500000
NODE_3992_length_1187_cov_20.383272	545	625	4	35	80	0.4375000
NODE_3993_length_1187_cov_17.941176	377	457	0	80	80	1.0000000
NODE_3993_length_1187_cov_17.941176	430	510	0	43	80	0.5375000
NODE_3993_length_1187_cov_17.941176	430	510	2	37	80	0.4625000
NODE_3993_length_1187_cov_17.941176	506	586	2	80	80	1.0000000
NODE_3993_length_1187_cov_17.941176	559	639	0	16	80	0.2000000
NODE_3993_length_1187_cov_17.941176	559	639	2	64	80	0.8000000
NODE_3997_length_1186_cov_59.606256	338	418	14	13	80	0.1625000
NODE_3997_length_1186_cov_59.606256	338	418	15	13	80	0.1625000
NODE_3997_length_1186_cov_59.606256	338	418	16	4	80	0.0500000
NODE_3997_length_1186_cov_59.606256	338	418	17	2	80	0.0250000
NODE_3997_length_1186_cov_59.606256	338	418	18	9	80	0.1125000
NODE_3997_length_1186_cov_59.606256	338	418	19	7	80	0.0875000
NODE_3997_length_1186_cov_59.606256	338	418	22	19	80	0.2375000
NODE_3997_length_1186_cov_59.606256	338	418	23	6	80	0.0750000
NODE_3997_length_1186_cov_59.606256	338	418	24	7	80	0.0875000
NODE_3997_length_1186_cov_59.606256	391	471	21	4	80	0.0500000
NODE_3997_length_1186_cov_59.606256	391	471	22	45	80	0.5625000
NODE_3997_length_1186_cov_59.606256	391	471	23	8	80	0.1000000
NODE_3997_length_1186_cov_59.606256	391	471	24	10	80	0.1250000
NODE_3997_length_1186_cov_59.606256	391	471	25	6	80	0.0750000
NODE_3997_length_1186_cov_59.606256	391	471	26	1	80	0.0125000
NODE_3997_length_1186_cov_59.606256	391	471	27	6	80	0.0750000
NODE_3997_length_1186_cov_59.606256	480	551	13	3	71	0.0422535
NODE_3997_length_1186_cov_59.606256	480	551	14	9	71	0.1267606
NODE_3997_length_1186_cov_59.606256	480	551	15	7	71	0.0985916
NODE_3997_length_1186_cov_59.606256	480	551	16	8	71	0.1126761
NODE_3997_length_1186_cov_59.606256	480	551	18	24	71	0.3380282
NODE_3997_length_1186_cov_59.606256	480	551	19	2	71	0.0281690
NODE_3997_length_1186_cov_59.606256	480	551	20	5	71	0.0704225
NODE_3997_length_1186_cov_59.606256	480	551	21	7	71	0.0985916
NODE_3997_length_1186_cov_59.606256	480	551	22	2	71	0.0281690
NODE_3997_length_1186_cov_59.606256	480	551	23	4	71	0.0563380
NODE_3997_length_1186_cov_59.606256	524	604	11	11	80	0.1375000
NODE_3997_length_1186_cov_59.606256	524	604	12	8	80	0.1000000
NODE_3997_length_1186_cov_59.606256	524	604	13	9	80	0.1125000
NODE_3997_length_1186_cov_59.606256	524	604	14	26	80	0.3250000
NODE_3997_length_1186_cov_59.606256	524	604	15	18	80	0.2250000
NODE_3997_length_1186_cov_59.606256	524	604	16	8	80	0.1000000
NODE_3998_length_1186_cov_34.937443	582	662	13	27	80	0.3375000
NODE_3998_length_1186_cov_34.937443	582	662	14	7	80	0.0875000
NODE_3998_length_1186_cov_34.937443	582	662	15	11	80	0.1375000
NODE_3998_length_1186_cov_34.937443	582	662	16	13	80	0.1625000
NODE_3998_length_1186_cov_34.937443	582	662	17	19	80	0.2375000
NODE_3998_length_1186_cov_34.937443	582	662	18	3	80	0.0375000
NODE_3998_length_1186_cov_34.937443	635	715	11	1	80	0.0125000
NODE_3998_length_1186_cov_34.937443	635	715	12	13	80	0.1625000
NODE_3998_length_1186_cov_34.937443	635	715	13	45	80	0.5625000
NODE_3998_length_1186_cov_34.937443	635	715	14	5	80	0.0625000
NODE_3998_length_1186_cov_34.937443	635	715	15	6	80	0.0750000
NODE_3998_length_1186_cov_34.937443	635	715	17	10	80	0.1250000
NODE_3998_length_1186_cov_34.937443	711	791	6	30	80	0.3750000
NODE_3998_length_1186_cov_34.937443	711	791	7	4	80	0.0500000
NODE_3998_length_1186_cov_34.937443	711	791	8	3	80	0.0375000
NODE_3998_length_1186_cov_34.937443	711	791	9	5	80	0.0625000
NODE_3998_length_1186_cov_34.937443	711	791	10	1	80	0.0125000
NODE_3998_length_1186_cov_34.937443	711	791	11	19	80	0.2375000
NODE_3998_length_1186_cov_34.937443	711	791	13	11	80	0.1375000
NODE_3998_length_1186_cov_34.937443	711	791	15	7	80	0.0875000
NODE_3998_length_1186_cov_34.937443	764	844	5	22	80	0.2750000
NODE_3998_length_1186_cov_34.937443	764	844	6	32	80	0.4000000
NODE_3998_length_1186_cov_34.937443	764	844	7	26	80	0.3250000
NODE_3999_length_1186_cov_29.840846	511	591	2	54	80	0.6750000
NODE_3999_length_1186_cov_29.840846	511	591	3	26	80	0.3250000
NODE_3999_length_1186_cov_29.840846	564	644	0	41	80	0.5125000
NODE_3999_length_1186_cov_29.840846	564	644	1	4	80	0.0500000
NODE_3999_length_1186_cov_29.840846	564	644	2	35	80	0.4375000
NODE_3999_length_1186_cov_29.840846	640	720	0	80	80	1.0000000
NODE_3999_length_1186_cov_29.840846	693	773	0	80	80	1.0000000
NODE_4000_length_1186_cov_13.108556	578	658	3	73	80	0.9125000
NODE_4000_length_1186_cov_13.108556	578	658	4	7	80	0.0875000
NODE_4000_length_1186_cov_13.108556	631	711	1	14	80	0.1750000
NODE_4000_length_1186_cov_13.108556	631	711	2	12	80	0.1500000
NODE_4000_length_1186_cov_13.108556	631	711	3	29	80	0.3625000
NODE_4000_length_1186_cov_13.108556	631	711	4	25	80	0.3125000
NODE_4001_length_1186_cov_12.867525	404	484	0	10	80	0.1250000
NODE_4001_length_1186_cov_12.867525	404	484	1	70	80	0.8750000
NODE_4001_length_1186_cov_12.867525	457	534	1	77	77	1.0000000
NODE_4001_length_1186_cov_12.867525	536	613	1	34	77	0.4415585
NODE_4001_length_1186_cov_12.867525	536	613	2	38	77	0.4935065
NODE_4001_length_1186_cov_12.867525	536	613	3	5	77	0.0649351
NODE_4001_length_1186_cov_12.867525	586	666	2	22	80	0.2750000
NODE_4001_length_1186_cov_12.867525	586	666	3	7	80	0.0875000
NODE_4001_length_1186_cov_12.867525	586	666	4	51	80	0.6375000
NODE_4002_length_1186_cov_12.135235	643	723	2	36	80	0.4500000
NODE_4002_length_1186_cov_12.135235	643	723	3	6	80	0.0750000
NODE_4002_length_1186_cov_12.135235	643	723	4	38	80	0.4750000
NODE_4002_length_1186_cov_12.135235	696	776	1	13	80	0.1625000
NODE_4002_length_1186_cov_12.135235	696	776	2	7	80	0.0875000
NODE_4002_length_1186_cov_12.135235	696	776	3	6	80	0.0750000
NODE_4002_length_1186_cov_12.135235	696	776	4	54	80	0.6750000
NODE_4012_length_1185_cov_36.974217	423	503	13	20	80	0.2500000
NODE_4012_length_1185_cov_36.974217	423	503	14	2	80	0.0250000
NODE_4012_length_1185_cov_36.974217	423	503	15	41	80	0.5125000
NODE_4012_length_1185_cov_36.974217	423	503	17	17	80	0.2125000
NODE_4012_length_1185_cov_36.974217	476	556	8	1	80	0.0125000
NODE_4012_length_1185_cov_36.974217	476	556	10	19	80	0.2375000
NODE_4012_length_1185_cov_36.974217	476	556	11	10	80	0.1250000
NODE_4012_length_1185_cov_36.974217	476	556	13	14	80	0.1750000
NODE_4012_length_1185_cov_36.974217	476	556	14	3	80	0.0375000
NODE_4012_length_1185_cov_36.974217	476	556	15	14	80	0.1750000
NODE_4012_length_1185_cov_36.974217	476	556	16	19	80	0.2375000
NODE_4013_length_1185_cov_28.410681	448	528	1	22	80	0.2750000
NODE_4013_length_1185_cov_28.410681	448	528	2	15	80	0.1875000
NODE_4013_length_1185_cov_28.410681	448	528	3	10	80	0.1250000
NODE_4013_length_1185_cov_28.410681	448	528	4	33	80	0.4125000
NODE_4013_length_1185_cov_28.410681	501	581	3	63	80	0.7875000
NODE_4013_length_1185_cov_28.410681	501	581	4	17	80	0.2125000
NODE_4014_length_1185_cov_19.768877	411	491	0	13	80	0.1625000
NODE_4014_length_1185_cov_19.768877	411	491	1	29	80	0.3625000
NODE_4014_length_1185_cov_19.768877	411	491	2	38	80	0.4750000
NODE_4014_length_1185_cov_19.768877	464	544	2	27	80	0.3375000
NODE_4014_length_1185_cov_19.768877	464	544	3	14	80	0.1750000
NODE_4014_length_1185_cov_19.768877	464	544	4	9	80	0.1125000
NODE_4014_length_1185_cov_19.768877	464	544	5	4	80	0.0500000
NODE_4014_length_1185_cov_19.768877	464	544	7	5	80	0.0625000
NODE_4014_length_1185_cov_19.768877	464	544	9	5	80	0.0625000
NODE_4014_length_1185_cov_19.768877	464	544	10	16	80	0.2000000
NODE_4014_length_1185_cov_19.768877	540	620	9	17	80	0.2125000
NODE_4014_length_1185_cov_19.768877	540	620	10	55	80	0.6875000
NODE_4014_length_1185_cov_19.768877	540	620	11	8	80	0.1000000
NODE_4014_length_1185_cov_19.768877	593	673	3	7	80	0.0875000
NODE_4014_length_1185_cov_19.768877	593	673	5	2	80	0.0250000
NODE_4014_length_1185_cov_19.768877	593	673	6	2	80	0.0250000
NODE_4014_length_1185_cov_19.768877	593	673	8	16	80	0.2000000
NODE_4014_length_1185_cov_19.768877	593	673	9	43	80	0.5375000
NODE_4014_length_1185_cov_19.768877	593	673	10	10	80	0.1250000
NODE_4015_length_1185_cov_14.490792	379	459	4	13	80	0.1625000
NODE_4015_length_1185_cov_14.490792	379	459	5	67	80	0.8375000
NODE_4015_length_1185_cov_14.490792	432	512	1	6	80	0.0750000
NODE_4015_length_1185_cov_14.490792	432	512	2	14	80	0.1750000
NODE_4015_length_1185_cov_14.490792	432	512	3	8	80	0.1000000
NODE_4015_length_1185_cov_14.490792	432	512	4	34	80	0.4250000
NODE_4015_length_1185_cov_14.490792	432	512	5	18	80	0.2250000
NODE_4016_length_1185_cov_13.686004	677	757	2	47	80	0.5875000
NODE_4016_length_1185_cov_13.686004	677	757	3	33	80	0.4125000
NODE_4016_length_1185_cov_13.686004	730	810	2	8	80	0.1000000
NODE_4016_length_1185_cov_13.686004	730	810	3	72	80	0.9000000
NODE_4017_length_1185_cov_12.362799	711	791	2	44	80	0.5500000
NODE_4017_length_1185_cov_12.362799	711	791	3	8	80	0.1000000
NODE_4017_length_1185_cov_12.362799	711	791	4	4	80	0.0500000
NODE_4017_length_1185_cov_12.362799	711	791	5	24	80	0.3000000
NODE_4017_length_1185_cov_12.362799	764	844	4	46	80	0.5750000
NODE_4017_length_1185_cov_12.362799	764	844	5	34	80	0.4250000
NODE_4024_length_1184_cov_30.061751	416	497	7	19	81	0.2345679
NODE_4024_length_1184_cov_30.061751	416	497	9	13	81	0.1604938
NODE_4024_length_1184_cov_30.061751	416	497	10	5	81	0.0617284
NODE_4024_length_1184_cov_30.061751	416	497	11	2	81	0.0246914
NODE_4024_length_1184_cov_30.061751	416	497	12	5	81	0.0617284
NODE_4024_length_1184_cov_30.061751	416	497	14	1	81	0.0123457
NODE_4024_length_1184_cov_30.061751	416	497	15	34	81	0.4197531
NODE_4024_length_1184_cov_30.061751	416	497	16	2	81	0.0246914
NODE_4024_length_1184_cov_30.061751	470	550	15	25	80	0.3125000
NODE_4024_length_1184_cov_30.061751	470	550	16	22	80	0.2750000
NODE_4024_length_1184_cov_30.061751	470	550	17	21	80	0.2625000
NODE_4024_length_1184_cov_30.061751	470	550	18	12	80	0.1500000
NODE_4024_length_1184_cov_30.061751	546	627	9	7	81	0.0864198
NODE_4024_length_1184_cov_30.061751	546	627	10	5	81	0.0617284
NODE_4024_length_1184_cov_30.061751	546	627	11	4	81	0.0493827
NODE_4024_length_1184_cov_30.061751	546	627	12	17	81	0.2098765
NODE_4024_length_1184_cov_30.061751	546	627	13	27	81	0.3333333
NODE_4024_length_1184_cov_30.061751	546	627	14	8	81	0.0987654
NODE_4024_length_1184_cov_30.061751	546	627	15	3	81	0.0370370
NODE_4024_length_1184_cov_30.061751	546	627	16	4	81	0.0493827
NODE_4024_length_1184_cov_30.061751	546	627	17	6	81	0.0740741
NODE_4024_length_1184_cov_30.061751	600	680	8	10	80	0.1250000
NODE_4024_length_1184_cov_30.061751	600	680	9	7	80	0.0875000
NODE_4024_length_1184_cov_30.061751	600	680	10	20	80	0.2500000
NODE_4024_length_1184_cov_30.061751	600	680	11	11	80	0.1375000
NODE_4024_length_1184_cov_30.061751	600	680	12	27	80	0.3375000
NODE_4024_length_1184_cov_30.061751	600	680	13	2	80	0.0250000
NODE_4024_length_1184_cov_30.061751	600	680	14	3	80	0.0375000
NODE_4025_length_1184_cov_19.544700	550	630	3	1	80	0.0125000
NODE_4025_length_1184_cov_19.544700	550	630	4	4	80	0.0500000
NODE_4025_length_1184_cov_19.544700	550	630	5	29	80	0.3625000
NODE_4025_length_1184_cov_19.544700	550	630	6	18	80	0.2250000
NODE_4025_length_1184_cov_19.544700	550	630	7	28	80	0.3500000
NODE_4025_length_1184_cov_19.544700	603	683	6	28	80	0.3500000
NODE_4025_length_1184_cov_19.544700	603	683	7	52	80	0.6500000
NODE_4025_length_1184_cov_19.544700	679	759	0	32	80	0.4000000
NODE_4025_length_1184_cov_19.544700	679	759	1	22	80	0.2750000
NODE_4025_length_1184_cov_19.544700	679	759	2	4	80	0.0500000
NODE_4025_length_1184_cov_19.544700	679	759	3	1	80	0.0125000
NODE_4025_length_1184_cov_19.544700	679	759	5	4	80	0.0500000
NODE_4025_length_1184_cov_19.544700	679	759	6	17	80	0.2125000
NODE_4025_length_1184_cov_19.544700	732	812	0	80	80	1.0000000
NODE_4026_length_1184_cov_9.129954	624	704	4	22	80	0.2750000
NODE_4026_length_1184_cov_9.129954	624	704	5	1	80	0.0125000
NODE_4026_length_1184_cov_9.129954	624	704	6	25	80	0.3125000
NODE_4026_length_1184_cov_9.129954	624	704	7	20	80	0.2500000
NODE_4026_length_1184_cov_9.129954	624	704	8	12	80	0.1500000
NODE_4026_length_1184_cov_9.129954	677	757	4	52	80	0.6500000
NODE_4026_length_1184_cov_9.129954	677	757	6	10	80	0.1250000
NODE_4026_length_1184_cov_9.129954	677	757	7	18	80	0.2250000
NODE_4031_length_1183_cov_17.260148	545	625	3	11	80	0.1375000
NODE_4031_length_1183_cov_17.260148	545	625	5	13	80	0.1625000
NODE_4031_length_1183_cov_17.260148	545	625	6	56	80	0.7000000
NODE_4031_length_1183_cov_17.260148	598	678	5	28	80	0.3500000
NODE_4031_length_1183_cov_17.260148	598	678	6	20	80	0.2500000
NODE_4031_length_1183_cov_17.260148	598	678	8	2	80	0.0250000
NODE_4031_length_1183_cov_17.260148	598	678	9	7	80	0.0875000
NODE_4031_length_1183_cov_17.260148	598	678	10	1	80	0.0125000
NODE_4031_length_1183_cov_17.260148	598	678	11	17	80	0.2125000
NODE_4031_length_1183_cov_17.260148	598	678	12	5	80	0.0625000
NODE_4031_length_1183_cov_17.260148	674	754	7	45	80	0.5625000
NODE_4031_length_1183_cov_17.260148	674	754	8	27	80	0.3375000
NODE_4031_length_1183_cov_17.260148	674	754	10	1	80	0.0125000
NODE_4031_length_1183_cov_17.260148	674	754	12	7	80	0.0875000
NODE_4031_length_1183_cov_17.260148	727	807	2	1	80	0.0125000
NODE_4031_length_1183_cov_17.260148	727	807	3	1	80	0.0125000
NODE_4031_length_1183_cov_17.260148	727	807	4	7	80	0.0875000
NODE_4031_length_1183_cov_17.260148	727	807	5	9	80	0.1125000
NODE_4031_length_1183_cov_17.260148	727	807	6	3	80	0.0375000
NODE_4031_length_1183_cov_17.260148	727	807	7	59	80	0.7375000
NODE_4032_length_1183_cov_9.777675	484	564	2	14	80	0.1750000
NODE_4032_length_1183_cov_9.777675	484	564	3	8	80	0.1000000
NODE_4032_length_1183_cov_9.777675	484	564	4	58	80	0.7250000
NODE_4032_length_1183_cov_9.777675	537	617	2	53	80	0.6625000
NODE_4032_length_1183_cov_9.777675	537	617	4	27	80	0.3375000
NODE_4033_length_1183_cov_6.847786	711	791	2	10	80	0.1250000
NODE_4033_length_1183_cov_6.847786	711	791	3	44	80	0.5500000
NODE_4033_length_1183_cov_6.847786	711	791	4	26	80	0.3250000
NODE_4033_length_1183_cov_6.847786	764	844	1	41	80	0.5125000
NODE_4033_length_1183_cov_6.847786	764	844	2	22	80	0.2750000
NODE_4033_length_1183_cov_6.847786	764	844	3	6	80	0.0750000
NODE_4033_length_1183_cov_6.847786	764	844	4	11	80	0.1375000
NODE_4033_length_1183_cov_6.847786	840	920	1	44	80	0.5500000
NODE_4033_length_1183_cov_6.847786	840	920	2	36	80	0.4500000
NODE_4033_length_1183_cov_6.847786	893	973	1	74	80	0.9250000
NODE_4033_length_1183_cov_6.847786	893	973	2	6	80	0.0750000
NODE_4035_length_1183_cov_2.680812	59	139	0	80	80	1.0000000
NODE_4040_length_1182_cov_64.600185	588	668	23	12	80	0.1500000
NODE_4040_length_1182_cov_64.600185	588	668	24	6	80	0.0750000
NODE_4040_length_1182_cov_64.600185	588	668	25	9	80	0.1125000
NODE_4040_length_1182_cov_64.600185	588	668	26	8	80	0.1000000
NODE_4040_length_1182_cov_64.600185	588	668	27	17	80	0.2125000
NODE_4040_length_1182_cov_64.600185	588	668	28	4	80	0.0500000
NODE_4040_length_1182_cov_64.600185	588	668	29	8	80	0.1000000
NODE_4040_length_1182_cov_64.600185	588	668	30	1	80	0.0125000
NODE_4040_length_1182_cov_64.600185	588	668	31	15	80	0.1875000
NODE_4040_length_1182_cov_64.600185	641	721	13	3	80	0.0375000
NODE_4040_length_1182_cov_64.600185	641	721	14	7	80	0.0875000
NODE_4040_length_1182_cov_64.600185	641	721	15	11	80	0.1375000
NODE_4040_length_1182_cov_64.600185	641	721	16	2	80	0.0250000
NODE_4040_length_1182_cov_64.600185	641	721	17	18	80	0.2250000
NODE_4040_length_1182_cov_64.600185	641	721	18	3	80	0.0375000
NODE_4040_length_1182_cov_64.600185	641	721	21	1	80	0.0125000
NODE_4040_length_1182_cov_64.600185	641	721	22	2	80	0.0250000
NODE_4040_length_1182_cov_64.600185	641	721	23	18	80	0.2250000
NODE_4040_length_1182_cov_64.600185	641	721	24	5	80	0.0625000
NODE_4040_length_1182_cov_64.600185	641	721	25	3	80	0.0375000
NODE_4040_length_1182_cov_64.600185	641	721	26	2	80	0.0250000
NODE_4040_length_1182_cov_64.600185	641	721	27	5	80	0.0625000
NODE_4040_length_1182_cov_64.600185	717	797	13	4	80	0.0500000
NODE_4040_length_1182_cov_64.600185	717	797	14	5	80	0.0625000
NODE_4040_length_1182_cov_64.600185	717	797	15	16	80	0.2000000
NODE_4040_length_1182_cov_64.600185	717	797	16	26	80	0.3250000
NODE_4040_length_1182_cov_64.600185	717	797	17	24	80	0.3000000
NODE_4040_length_1182_cov_64.600185	717	797	18	5	80	0.0625000
NODE_4040_length_1182_cov_64.600185	770	849	14	18	79	0.2278481
NODE_4040_length_1182_cov_64.600185	770	849	15	6	79	0.0759494
NODE_4040_length_1182_cov_64.600185	770	849	16	17	79	0.2151899
NODE_4040_length_1182_cov_64.600185	770	849	17	16	79	0.2025317
NODE_4040_length_1182_cov_64.600185	770	849	18	22	79	0.2784810
NODE_4041_length_1182_cov_18.584488	487	557	6	54	70	0.7714286
NODE_4041_length_1182_cov_18.584488	487	557	8	16	70	0.2285714
NODE_4041_length_1182_cov_18.584488	536	612	5	1	76	0.0131579
NODE_4041_length_1182_cov_18.584488	536	612	6	35	76	0.4605263
NODE_4041_length_1182_cov_18.584488	536	612	8	40	76	0.5263158
NODE_4041_length_1182_cov_18.584488	608	688	2	29	80	0.3625000
NODE_4041_length_1182_cov_18.584488	608	688	4	38	80	0.4750000
NODE_4041_length_1182_cov_18.584488	608	688	5	7	80	0.0875000
NODE_4041_length_1182_cov_18.584488	608	688	6	3	80	0.0375000
NODE_4041_length_1182_cov_18.584488	608	688	7	3	80	0.0375000
NODE_4041_length_1182_cov_18.584488	671	741	0	35	70	0.5000000
NODE_4041_length_1182_cov_18.584488	671	741	2	35	70	0.5000000
NODE_4042_length_1182_cov_18.075716	598	678	1	80	80	1.0000000
NODE_4042_length_1182_cov_18.075716	651	731	1	67	80	0.8375000
NODE_4042_length_1182_cov_18.075716	651	731	2	13	80	0.1625000
NODE_4042_length_1182_cov_18.075716	727	807	1	80	80	1.0000000
NODE_4042_length_1182_cov_18.075716	780	860	0	19	80	0.2375000
NODE_4042_length_1182_cov_18.075716	780	860	1	61	80	0.7625000
NODE_4043_length_1182_cov_8.716528	464	544	2	1	80	0.0125000
NODE_4043_length_1182_cov_8.716528	464	544	4	26	80	0.3250000
NODE_4043_length_1182_cov_8.716528	464	544	5	4	80	0.0500000
NODE_4043_length_1182_cov_8.716528	464	544	6	49	80	0.6125000
NODE_4043_length_1182_cov_8.716528	517	597	5	9	80	0.1125000
NODE_4043_length_1182_cov_8.716528	517	597	6	46	80	0.5750000
NODE_4043_length_1182_cov_8.716528	517	597	7	18	80	0.2250000
NODE_4043_length_1182_cov_8.716528	517	597	8	7	80	0.0875000
NODE_4044_length_1182_cov_4.109880	793	873	2	24	80	0.3000000
NODE_4044_length_1182_cov_4.109880	793	873	3	25	80	0.3125000
NODE_4044_length_1182_cov_4.109880	793	873	4	27	80	0.3375000
NODE_4044_length_1182_cov_4.109880	793	873	5	4	80	0.0500000
NODE_4044_length_1182_cov_4.109880	846	926	3	4	80	0.0500000
NODE_4044_length_1182_cov_4.109880	846	926	4	72	80	0.9000000
NODE_4044_length_1182_cov_4.109880	846	926	5	4	80	0.0500000
NODE_4045_length_1182_cov_3.433980	1052	1100	0	48	48	1.0000000
NODE_4050_length_1181_cov_13.856747	687	767	4	6	80	0.0750000
NODE_4050_length_1181_cov_13.856747	687	767	6	6	80	0.0750000
NODE_4050_length_1181_cov_13.856747	687	767	7	17	80	0.2125000
NODE_4050_length_1181_cov_13.856747	687	767	9	44	80	0.5500000
NODE_4050_length_1181_cov_13.856747	687	767	11	3	80	0.0375000
NODE_4050_length_1181_cov_13.856747	687	767	15	4	80	0.0500000
NODE_4050_length_1181_cov_13.856747	740	820	9	20	80	0.2500000
NODE_4050_length_1181_cov_13.856747	740	820	11	3	80	0.0375000
NODE_4050_length_1181_cov_13.856747	740	820	14	8	80	0.1000000
NODE_4050_length_1181_cov_13.856747	740	820	15	49	80	0.6125000
NODE_4051_length_1181_cov_8.239372	735	815	5	80	80	1.0000000
NODE_4059_length_1180_cov_46.345051	695	775	4	9	80	0.1125000
NODE_4059_length_1180_cov_46.345051	695	775	5	21	80	0.2625000
NODE_4059_length_1180_cov_46.345051	695	775	6	1	80	0.0125000
NODE_4059_length_1180_cov_46.345051	695	775	7	19	80	0.2375000
NODE_4059_length_1180_cov_46.345051	695	775	8	30	80	0.3750000
NODE_4059_length_1180_cov_46.345051	748	828	6	9	80	0.1125000
NODE_4059_length_1180_cov_46.345051	748	828	7	47	80	0.5875000
NODE_4059_length_1180_cov_46.345051	748	828	8	24	80	0.3000000
NODE_4066_length_1179_cov_93.272222	660	740	21	6	80	0.0750000
NODE_4066_length_1179_cov_93.272222	660	740	24	21	80	0.2625000
NODE_4066_length_1179_cov_93.272222	660	740	25	21	80	0.2625000
NODE_4066_length_1179_cov_93.272222	660	740	26	9	80	0.1125000
NODE_4066_length_1179_cov_93.272222	660	740	27	12	80	0.1500000
NODE_4066_length_1179_cov_93.272222	660	740	28	7	80	0.0875000
NODE_4066_length_1179_cov_93.272222	660	740	29	2	80	0.0250000
NODE_4066_length_1179_cov_93.272222	660	740	30	2	80	0.0250000
NODE_4066_length_1179_cov_93.272222	713	793	12	1	80	0.0125000
NODE_4066_length_1179_cov_93.272222	713	793	13	6	80	0.0750000
NODE_4066_length_1179_cov_93.272222	713	793	14	7	80	0.0875000
NODE_4066_length_1179_cov_93.272222	713	793	15	2	80	0.0250000
NODE_4066_length_1179_cov_93.272222	713	793	16	5	80	0.0625000
NODE_4066_length_1179_cov_93.272222	713	793	18	3	80	0.0375000
NODE_4066_length_1179_cov_93.272222	713	793	19	18	80	0.2250000
NODE_4066_length_1179_cov_93.272222	713	793	20	11	80	0.1375000
NODE_4066_length_1179_cov_93.272222	713	793	21	6	80	0.0750000
NODE_4066_length_1179_cov_93.272222	713	793	24	21	80	0.2625000
NODE_4067_length_1179_cov_55.355556	547	627	15	6	80	0.0750000
NODE_4067_length_1179_cov_55.355556	547	627	16	2	80	0.0250000
NODE_4067_length_1179_cov_55.355556	547	627	17	19	80	0.2375000
NODE_4067_length_1179_cov_55.355556	547	627	18	3	80	0.0375000
NODE_4067_length_1179_cov_55.355556	547	627	19	2	80	0.0250000
NODE_4067_length_1179_cov_55.355556	547	627	20	1	80	0.0125000
NODE_4067_length_1179_cov_55.355556	547	627	21	3	80	0.0375000
NODE_4067_length_1179_cov_55.355556	547	627	22	2	80	0.0250000
NODE_4067_length_1179_cov_55.355556	547	627	23	6	80	0.0750000
NODE_4067_length_1179_cov_55.355556	547	627	24	18	80	0.2250000
NODE_4067_length_1179_cov_55.355556	547	627	26	5	80	0.0625000
NODE_4067_length_1179_cov_55.355556	547	627	28	13	80	0.1625000
NODE_4067_length_1179_cov_55.355556	600	680	21	9	80	0.1125000
NODE_4067_length_1179_cov_55.355556	600	680	22	4	80	0.0500000
NODE_4067_length_1179_cov_55.355556	600	680	23	14	80	0.1750000
NODE_4067_length_1179_cov_55.355556	600	680	24	17	80	0.2125000
NODE_4067_length_1179_cov_55.355556	600	680	25	2	80	0.0250000
NODE_4067_length_1179_cov_55.355556	600	680	26	14	80	0.1750000
NODE_4067_length_1179_cov_55.355556	600	680	27	3	80	0.0375000
NODE_4067_length_1179_cov_55.355556	600	680	28	17	80	0.2125000
NODE_4068_length_1179_cov_29.712037	613	693	2	5	80	0.0625000
NODE_4068_length_1179_cov_29.712037	613	693	3	38	80	0.4750000
NODE_4068_length_1179_cov_29.712037	613	693	5	37	80	0.4625000
NODE_4068_length_1179_cov_29.712037	666	746	4	50	80	0.6250000
NODE_4068_length_1179_cov_29.712037	666	746	5	30	80	0.3750000
NODE_4069_length_1179_cov_26.767593	483	563	0	3	80	0.0375000
NODE_4069_length_1179_cov_26.767593	483	563	1	2	80	0.0250000
NODE_4069_length_1179_cov_26.767593	483	563	2	16	80	0.2000000
NODE_4069_length_1179_cov_26.767593	483	563	3	35	80	0.4375000
NODE_4069_length_1179_cov_26.767593	483	563	5	20	80	0.2500000
NODE_4069_length_1179_cov_26.767593	483	563	6	4	80	0.0500000
NODE_4069_length_1179_cov_26.767593	536	616	3	3	80	0.0375000
NODE_4069_length_1179_cov_26.767593	536	616	5	20	80	0.2500000
NODE_4069_length_1179_cov_26.767593	536	616	6	14	80	0.1750000
NODE_4069_length_1179_cov_26.767593	536	616	7	26	80	0.3250000
NODE_4069_length_1179_cov_26.767593	536	616	9	5	80	0.0625000
NODE_4069_length_1179_cov_26.767593	536	616	10	2	80	0.0250000
NODE_4069_length_1179_cov_26.767593	536	616	11	3	80	0.0375000
NODE_4069_length_1179_cov_26.767593	536	616	12	1	80	0.0125000
NODE_4069_length_1179_cov_26.767593	536	616	14	6	80	0.0750000
NODE_4069_length_1179_cov_26.767593	612	692	11	9	80	0.1125000
NODE_4069_length_1179_cov_26.767593	612	692	12	2	80	0.0250000
NODE_4069_length_1179_cov_26.767593	612	692	13	47	80	0.5875000
NODE_4069_length_1179_cov_26.767593	612	692	14	12	80	0.1500000
NODE_4069_length_1179_cov_26.767593	612	692	15	10	80	0.1250000
NODE_4069_length_1179_cov_26.767593	665	745	9	15	80	0.1875000
NODE_4069_length_1179_cov_26.767593	665	745	11	7	80	0.0875000
NODE_4069_length_1179_cov_26.767593	665	745	12	14	80	0.1750000
NODE_4069_length_1179_cov_26.767593	665	745	13	44	80	0.5500000
NODE_4070_length_1179_cov_22.249074	581	661	0	80	80	1.0000000
NODE_4070_length_1179_cov_22.249074	634	714	0	80	80	1.0000000
NODE_4071_length_1179_cov_16.538889	498	568	12	7	70	0.1000000
NODE_4071_length_1179_cov_16.538889	498	568	15	6	70	0.0857143
NODE_4071_length_1179_cov_16.538889	498	568	17	6	70	0.0857143
NODE_4071_length_1179_cov_16.538889	498	568	19	22	70	0.3142857
NODE_4071_length_1179_cov_16.538889	498	568	20	7	70	0.1000000
NODE_4071_length_1179_cov_16.538889	498	568	21	8	70	0.1142857
NODE_4071_length_1179_cov_16.538889	498	568	22	14	70	0.2000000
NODE_4072_length_1179_cov_15.442593	535	615	8	21	80	0.2625000
NODE_4072_length_1179_cov_15.442593	535	615	9	55	80	0.6875000
NODE_4072_length_1179_cov_15.442593	535	615	10	4	80	0.0500000
NODE_4072_length_1179_cov_15.442593	588	668	5	1	80	0.0125000
NODE_4072_length_1179_cov_15.442593	588	668	6	7	80	0.0875000
NODE_4072_length_1179_cov_15.442593	588	668	7	20	80	0.2500000
NODE_4072_length_1179_cov_15.442593	588	668	8	20	80	0.2500000
NODE_4072_length_1179_cov_15.442593	588	668	9	32	80	0.4000000
NODE_4076_length_1179_cov_2.419444	1108	1155	0	47	47	1.0000000
NODE_4078_length_1179_cov_1.009259	944	1024	0	80	80	1.0000000
NODE_4078_length_1179_cov_1.009259	997	1077	0	80	80	1.0000000
NODE_4079_length_1178_cov_42.484708	423	503	9	4	80	0.0500000
NODE_4079_length_1178_cov_42.484708	423	503	10	50	80	0.6250000
NODE_4079_length_1178_cov_42.484708	423	503	11	26	80	0.3250000
NODE_4079_length_1178_cov_42.484708	476	556	3	9	80	0.1125000
NODE_4079_length_1178_cov_42.484708	476	556	4	9	80	0.1125000
NODE_4079_length_1178_cov_42.484708	476	556	5	1	80	0.0125000
NODE_4079_length_1178_cov_42.484708	476	556	6	9	80	0.1125000
NODE_4079_length_1178_cov_42.484708	476	556	7	5	80	0.0625000
NODE_4079_length_1178_cov_42.484708	476	556	8	9	80	0.1125000
NODE_4079_length_1178_cov_42.484708	476	556	9	7	80	0.0875000
NODE_4079_length_1178_cov_42.484708	476	556	10	30	80	0.3750000
NODE_4079_length_1178_cov_42.484708	476	556	11	1	80	0.0125000
NODE_4079_length_1178_cov_42.484708	552	632	3	10	80	0.1250000
NODE_4079_length_1178_cov_42.484708	552	632	4	23	80	0.2875000
NODE_4079_length_1178_cov_42.484708	552	632	6	9	80	0.1125000
NODE_4079_length_1178_cov_42.484708	552	632	7	4	80	0.0500000
NODE_4079_length_1178_cov_42.484708	552	632	8	6	80	0.0750000
NODE_4079_length_1178_cov_42.484708	552	632	9	28	80	0.3500000
NODE_4079_length_1178_cov_42.484708	605	685	6	14	80	0.1750000
NODE_4079_length_1178_cov_42.484708	605	685	8	20	80	0.2500000
NODE_4079_length_1178_cov_42.484708	605	685	9	46	80	0.5750000
NODE_4080_length_1178_cov_15.332715	215	295	1	10	80	0.1250000
NODE_4080_length_1178_cov_15.332715	215	295	2	70	80	0.8750000
NODE_4080_length_1178_cov_15.332715	268	348	1	6	80	0.0750000
NODE_4080_length_1178_cov_15.332715	268	348	2	74	80	0.9250000
NODE_4081_length_1178_cov_11.403151	527	607	1	50	80	0.6250000
NODE_4081_length_1178_cov_11.403151	527	607	2	30	80	0.3750000
NODE_4081_length_1178_cov_11.403151	580	660	1	80	80	1.0000000
NODE_4084_length_1177_cov_34.920223	369	449	2	9	80	0.1125000
NODE_4084_length_1177_cov_34.920223	369	449	3	45	80	0.5625000
NODE_4084_length_1177_cov_34.920223	369	449	5	13	80	0.1625000
NODE_4084_length_1177_cov_34.920223	369	449	6	13	80	0.1625000
NODE_4084_length_1177_cov_34.920223	422	502	3	1	80	0.0125000
NODE_4084_length_1177_cov_34.920223	422	502	4	16	80	0.2000000
NODE_4084_length_1177_cov_34.920223	422	502	5	27	80	0.3375000
NODE_4084_length_1177_cov_34.920223	422	502	6	36	80	0.4500000
NODE_4084_length_1177_cov_34.920223	498	578	3	8	80	0.1000000
NODE_4084_length_1177_cov_34.920223	498	578	4	23	80	0.2875000
NODE_4084_length_1177_cov_34.920223	498	578	6	19	80	0.2375000
NODE_4084_length_1177_cov_34.920223	498	578	7	23	80	0.2875000
NODE_4084_length_1177_cov_34.920223	498	578	9	7	80	0.0875000
NODE_4084_length_1177_cov_34.920223	551	631	7	20	80	0.2500000
NODE_4084_length_1177_cov_34.920223	551	631	8	21	80	0.2625000
NODE_4084_length_1177_cov_34.920223	551	631	9	12	80	0.1500000
NODE_4084_length_1177_cov_34.920223	551	631	10	27	80	0.3375000
NODE_4085_length_1177_cov_12.186456	481	561	2	80	80	1.0000000
NODE_4085_length_1177_cov_12.186456	534	614	2	73	80	0.9125000
NODE_4085_length_1177_cov_12.186456	534	614	4	7	80	0.0875000
NODE_4085_length_1177_cov_12.186456	610	690	2	60	80	0.7500000
NODE_4085_length_1177_cov_12.186456	610	690	4	20	80	0.2500000
NODE_4085_length_1177_cov_12.186456	663	743	2	80	80	1.0000000
NODE_4086_length_1177_cov_11.926716	443	523	0	72	80	0.9000000
NODE_4086_length_1177_cov_11.926716	443	523	1	8	80	0.1000000
NODE_4086_length_1177_cov_11.926716	496	578	0	34	82	0.4146341
NODE_4086_length_1177_cov_11.926716	496	578	2	48	82	0.5853658
NODE_4088_length_1177_cov_5.923933	358	438	4	10	80	0.1250000
NODE_4088_length_1177_cov_5.923933	358	438	8	28	80	0.3500000
NODE_4088_length_1177_cov_5.923933	358	438	9	12	80	0.1500000
NODE_4088_length_1177_cov_5.923933	358	438	10	30	80	0.3750000
NODE_4088_length_1177_cov_5.923933	411	491	3	11	80	0.1375000
NODE_4088_length_1177_cov_5.923933	411	491	4	52	80	0.6500000
NODE_4088_length_1177_cov_5.923933	411	491	8	17	80	0.2125000
NODE_4089_length_1177_cov_5.775510	760	840	0	80	80	1.0000000
NODE_4089_length_1177_cov_5.775510	813	893	0	80	80	1.0000000
NODE_4096_length_1176_cov_26.994429	377	457	3	7	80	0.0875000
NODE_4096_length_1176_cov_26.994429	377	457	4	32	80	0.4000000
NODE_4096_length_1176_cov_26.994429	377	457	5	33	80	0.4125000
NODE_4096_length_1176_cov_26.994429	377	457	6	8	80	0.1000000
NODE_4096_length_1176_cov_26.994429	430	510	4	7	80	0.0875000
NODE_4096_length_1176_cov_26.994429	430	510	5	58	80	0.7250000
NODE_4096_length_1176_cov_26.994429	430	510	6	15	80	0.1875000
NODE_4096_length_1176_cov_26.994429	506	586	3	12	80	0.1500000
NODE_4096_length_1176_cov_26.994429	506	586	4	28	80	0.3500000
NODE_4096_length_1176_cov_26.994429	506	586	5	35	80	0.4375000
NODE_4096_length_1176_cov_26.994429	506	586	6	5	80	0.0625000
NODE_4096_length_1176_cov_26.994429	559	639	2	22	80	0.2750000
NODE_4096_length_1176_cov_26.994429	559	639	4	21	80	0.2625000
NODE_4096_length_1176_cov_26.994429	559	639	5	32	80	0.4000000
NODE_4096_length_1176_cov_26.994429	559	639	6	5	80	0.0625000
NODE_4097_length_1176_cov_15.766945	531	611	5	2	80	0.0250000
NODE_4097_length_1176_cov_15.766945	531	611	6	3	80	0.0375000
NODE_4097_length_1176_cov_15.766945	531	611	7	31	80	0.3875000
NODE_4097_length_1176_cov_15.766945	531	611	8	3	80	0.0375000
NODE_4097_length_1176_cov_15.766945	531	611	9	41	80	0.5125000
NODE_4097_length_1176_cov_15.766945	584	664	4	3	80	0.0375000
NODE_4097_length_1176_cov_15.766945	584	664	5	40	80	0.5000000
NODE_4097_length_1176_cov_15.766945	584	664	7	16	80	0.2000000
NODE_4097_length_1176_cov_15.766945	584	664	9	21	80	0.2625000
NODE_4098_length_1176_cov_14.882080	628	708	4	34	80	0.4250000
NODE_4098_length_1176_cov_14.882080	628	708	5	46	80	0.5750000
NODE_4098_length_1176_cov_14.882080	681	761	0	19	80	0.2375000
NODE_4098_length_1176_cov_14.882080	681	761	3	8	80	0.1000000
NODE_4098_length_1176_cov_14.882080	681	761	4	53	80	0.6625000
NODE_4099_length_1176_cov_10.692665	392	472	1	4	80	0.0500000
NODE_4099_length_1176_cov_10.692665	392	472	2	67	80	0.8375000
NODE_4099_length_1176_cov_10.692665	392	472	3	9	80	0.1125000
NODE_4099_length_1176_cov_10.692665	445	525	2	80	80	1.0000000
NODE_4106_length_1175_cov_50.754647	526	606	6	6	80	0.0750000
NODE_4106_length_1175_cov_50.754647	526	606	7	31	80	0.3875000
NODE_4106_length_1175_cov_50.754647	526	606	8	8	80	0.1000000
NODE_4106_length_1175_cov_50.754647	526	606	10	11	80	0.1375000
NODE_4106_length_1175_cov_50.754647	526	606	11	7	80	0.0875000
NODE_4106_length_1175_cov_50.754647	526	606	12	13	80	0.1625000
NODE_4106_length_1175_cov_50.754647	526	606	13	4	80	0.0500000
NODE_4106_length_1175_cov_50.754647	579	659	10	3	80	0.0375000
NODE_4106_length_1175_cov_50.754647	579	659	11	13	80	0.1625000
NODE_4106_length_1175_cov_50.754647	579	659	12	26	80	0.3250000
NODE_4106_length_1175_cov_50.754647	579	659	13	4	80	0.0500000
NODE_4106_length_1175_cov_50.754647	579	659	14	20	80	0.2500000
NODE_4106_length_1175_cov_50.754647	579	659	15	13	80	0.1625000
NODE_4106_length_1175_cov_50.754647	579	659	16	1	80	0.0125000
NODE_4107_length_1175_cov_42.638476	327	407	4	8	80	0.1000000
NODE_4107_length_1175_cov_42.638476	327	407	5	24	80	0.3000000
NODE_4107_length_1175_cov_42.638476	327	407	6	6	80	0.0750000
NODE_4107_length_1175_cov_42.638476	327	407	7	4	80	0.0500000
NODE_4107_length_1175_cov_42.638476	327	407	8	16	80	0.2000000
NODE_4107_length_1175_cov_42.638476	327	407	10	22	80	0.2750000
NODE_4107_length_1175_cov_42.638476	380	460	8	12	80	0.1500000
NODE_4107_length_1175_cov_42.638476	380	460	9	7	80	0.0875000
NODE_4107_length_1175_cov_42.638476	380	460	10	44	80	0.5500000
NODE_4107_length_1175_cov_42.638476	380	460	11	3	80	0.0375000
NODE_4107_length_1175_cov_42.638476	380	460	12	14	80	0.1750000
NODE_4107_length_1175_cov_42.638476	456	536	4	17	80	0.2125000
NODE_4107_length_1175_cov_42.638476	456	536	5	4	80	0.0500000
NODE_4107_length_1175_cov_42.638476	456	536	8	6	80	0.0750000
NODE_4107_length_1175_cov_42.638476	456	536	9	21	80	0.2625000
NODE_4107_length_1175_cov_42.638476	456	536	10	32	80	0.4000000
NODE_4107_length_1175_cov_42.638476	509	589	2	21	80	0.2625000
NODE_4107_length_1175_cov_42.638476	509	589	3	2	80	0.0250000
NODE_4107_length_1175_cov_42.638476	509	589	4	47	80	0.5875000
NODE_4107_length_1175_cov_42.638476	509	589	5	4	80	0.0500000
NODE_4107_length_1175_cov_42.638476	509	589	8	6	80	0.0750000
NODE_4108_length_1175_cov_40.217472	437	517	5	6	80	0.0750000
NODE_4108_length_1175_cov_40.217472	437	517	7	4	80	0.0500000
NODE_4108_length_1175_cov_40.217472	437	517	9	3	80	0.0375000
NODE_4108_length_1175_cov_40.217472	437	517	10	45	80	0.5625000
NODE_4108_length_1175_cov_40.217472	437	517	13	15	80	0.1875000
NODE_4108_length_1175_cov_40.217472	437	517	14	7	80	0.0875000
NODE_4108_length_1175_cov_40.217472	490	570	10	5	80	0.0625000
NODE_4108_length_1175_cov_40.217472	490	570	11	3	80	0.0375000
NODE_4108_length_1175_cov_40.217472	490	570	12	7	80	0.0875000
NODE_4108_length_1175_cov_40.217472	490	570	13	18	80	0.2250000
NODE_4108_length_1175_cov_40.217472	490	570	14	21	80	0.2625000
NODE_4108_length_1175_cov_40.217472	490	570	15	11	80	0.1375000
NODE_4108_length_1175_cov_40.217472	490	570	16	15	80	0.1875000
NODE_4108_length_1175_cov_40.217472	566	646	11	9	80	0.1125000
NODE_4108_length_1175_cov_40.217472	566	646	12	6	80	0.0750000
NODE_4108_length_1175_cov_40.217472	566	646	13	16	80	0.2000000
NODE_4108_length_1175_cov_40.217472	566	646	14	30	80	0.3750000
NODE_4108_length_1175_cov_40.217472	566	646	15	19	80	0.2375000
NODE_4108_length_1175_cov_40.217472	619	699	7	3	80	0.0375000
NODE_4108_length_1175_cov_40.217472	619	699	8	17	80	0.2125000
NODE_4108_length_1175_cov_40.217472	619	699	9	9	80	0.1125000
NODE_4108_length_1175_cov_40.217472	619	699	10	11	80	0.1375000
NODE_4108_length_1175_cov_40.217472	619	699	11	5	80	0.0625000
NODE_4108_length_1175_cov_40.217472	619	699	12	9	80	0.1125000
NODE_4108_length_1175_cov_40.217472	619	699	13	6	80	0.0750000
NODE_4108_length_1175_cov_40.217472	619	699	14	1	80	0.0125000
NODE_4108_length_1175_cov_40.217472	619	699	15	19	80	0.2375000
NODE_4109_length_1175_cov_12.834572	775	855	1	3	80	0.0375000
NODE_4109_length_1175_cov_12.834572	775	855	2	1	80	0.0125000
NODE_4109_length_1175_cov_12.834572	775	855	3	35	80	0.4375000
NODE_4109_length_1175_cov_12.834572	775	855	4	1	80	0.0125000
NODE_4109_length_1175_cov_12.834572	775	855	5	5	80	0.0625000
NODE_4109_length_1175_cov_12.834572	775	855	6	35	80	0.4375000
NODE_4109_length_1175_cov_12.834572	828	908	1	56	80	0.7000000
NODE_4109_length_1175_cov_12.834572	828	908	2	1	80	0.0125000
NODE_4109_length_1175_cov_12.834572	828	908	3	23	80	0.2875000
NODE_4115_length_1174_cov_20.569302	433	513	2	21	80	0.2625000
NODE_4115_length_1174_cov_20.569302	433	513	4	7	80	0.0875000
NODE_4115_length_1174_cov_20.569302	433	513	5	30	80	0.3750000
NODE_4115_length_1174_cov_20.569302	433	513	6	20	80	0.2500000
NODE_4115_length_1174_cov_20.569302	433	513	7	2	80	0.0250000
NODE_4115_length_1174_cov_20.569302	486	566	5	35	80	0.4375000
NODE_4115_length_1174_cov_20.569302	486	566	6	20	80	0.2500000
NODE_4115_length_1174_cov_20.569302	486	566	7	25	80	0.3125000
NODE_4115_length_1174_cov_20.569302	562	642	6	28	80	0.3500000
NODE_4115_length_1174_cov_20.569302	562	642	7	46	80	0.5750000
NODE_4115_length_1174_cov_20.569302	562	642	8	2	80	0.0250000
NODE_4115_length_1174_cov_20.569302	562	642	9	4	80	0.0500000
NODE_4115_length_1174_cov_20.569302	615	695	4	11	80	0.1375000
NODE_4115_length_1174_cov_20.569302	615	695	6	47	80	0.5875000
NODE_4115_length_1174_cov_20.569302	615	695	7	21	80	0.2625000
NODE_4115_length_1174_cov_20.569302	615	695	8	1	80	0.0125000
NODE_4116_length_1174_cov_18.797209	578	658	1	43	80	0.5375000
NODE_4116_length_1174_cov_18.797209	578	658	2	6	80	0.0750000
NODE_4116_length_1174_cov_18.797209	578	658	3	31	80	0.3875000
NODE_4116_length_1174_cov_18.797209	631	711	0	11	80	0.1375000
NODE_4116_length_1174_cov_18.797209	631	711	1	69	80	0.8625000
NODE_4117_length_1174_cov_17.486512	589	669	3	5	80	0.0625000
NODE_4117_length_1174_cov_17.486512	589	669	5	1	80	0.0125000
NODE_4117_length_1174_cov_17.486512	589	669	6	4	80	0.0500000
NODE_4117_length_1174_cov_17.486512	589	669	7	4	80	0.0500000
NODE_4117_length_1174_cov_17.486512	589	669	9	9	80	0.1125000
NODE_4117_length_1174_cov_17.486512	589	669	11	6	80	0.0750000
NODE_4117_length_1174_cov_17.486512	589	669	12	51	80	0.6375000
NODE_4117_length_1174_cov_17.486512	642	722	9	22	80	0.2750000
NODE_4117_length_1174_cov_17.486512	642	722	10	8	80	0.1000000
NODE_4117_length_1174_cov_17.486512	642	722	11	1	80	0.0125000
NODE_4117_length_1174_cov_17.486512	642	722	12	49	80	0.6125000
NODE_4118_length_1174_cov_15.888372	570	650	4	18	80	0.2250000
NODE_4118_length_1174_cov_15.888372	570	650	6	33	80	0.4125000
NODE_4118_length_1174_cov_15.888372	570	650	8	29	80	0.3625000
NODE_4118_length_1174_cov_15.888372	623	703	2	16	80	0.2000000
NODE_4118_length_1174_cov_15.888372	623	703	4	9	80	0.1125000
NODE_4118_length_1174_cov_15.888372	623	703	6	28	80	0.3500000
NODE_4118_length_1174_cov_15.888372	623	703	8	27	80	0.3375000
NODE_4118_length_1174_cov_15.888372	699	779	0	14	80	0.1750000
NODE_4118_length_1174_cov_15.888372	699	779	2	34	80	0.4250000
NODE_4118_length_1174_cov_15.888372	699	779	3	17	80	0.2125000
NODE_4118_length_1174_cov_15.888372	699	779	4	15	80	0.1875000
NODE_4118_length_1174_cov_15.888372	752	832	3	12	80	0.1500000
NODE_4118_length_1174_cov_15.888372	752	832	4	68	80	0.8500000
NODE_4124_length_1174_cov_1.536744	1066	1115	0	42	49	0.8571429
NODE_4124_length_1174_cov_1.536744	1066	1115	2	2	49	0.0408163
NODE_4124_length_1174_cov_1.536744	1066	1115	3	5	49	0.1020408
NODE_4124_length_1174_cov_1.536744	1088	1168	0	80	80	1.0000000
NODE_4128_length_1173_cov_29.562384	455	535	1	9	80	0.1125000
NODE_4128_length_1173_cov_29.562384	455	535	2	71	80	0.8875000
NODE_4128_length_1173_cov_29.562384	508	588	2	80	80	1.0000000
NODE_4128_length_1173_cov_29.562384	584	664	0	50	80	0.6250000
NODE_4128_length_1173_cov_29.562384	584	664	1	23	80	0.2875000
NODE_4128_length_1173_cov_29.562384	584	664	2	7	80	0.0875000
NODE_4128_length_1173_cov_29.562384	637	717	0	80	80	1.0000000
NODE_4129_length_1173_cov_25.206704	395	475	5	4	80	0.0500000
NODE_4129_length_1173_cov_25.206704	395	475	6	76	80	0.9500000
NODE_4129_length_1173_cov_25.206704	448	528	5	19	80	0.2375000
NODE_4129_length_1173_cov_25.206704	448	528	6	56	80	0.7000000
NODE_4129_length_1173_cov_25.206704	448	528	7	5	80	0.0625000
NODE_4130_length_1173_cov_9.486965	693	773	1	31	80	0.3875000
NODE_4130_length_1173_cov_9.486965	693	773	3	10	80	0.1250000
NODE_4130_length_1173_cov_9.486965	693	773	4	39	80	0.4875000
NODE_4130_length_1173_cov_9.486965	746	826	0	33	80	0.4125000
NODE_4130_length_1173_cov_9.486965	746	826	1	47	80	0.5875000
NODE_4131_length_1173_cov_7.946927	201	281	4	1	80	0.0125000
NODE_4131_length_1173_cov_7.946927	201	281	6	10	80	0.1250000
NODE_4131_length_1173_cov_7.946927	201	281	7	15	80	0.1875000
NODE_4131_length_1173_cov_7.946927	201	281	9	37	80	0.4625000
NODE_4131_length_1173_cov_7.946927	201	281	11	13	80	0.1625000
NODE_4131_length_1173_cov_7.946927	201	281	12	4	80	0.0500000
NODE_4131_length_1173_cov_7.946927	254	334	6	3	80	0.0375000
NODE_4131_length_1173_cov_7.946927	254	334	7	18	80	0.2250000
NODE_4131_length_1173_cov_7.946927	254	334	8	1	80	0.0125000
NODE_4131_length_1173_cov_7.946927	254	334	9	22	80	0.2750000
NODE_4131_length_1173_cov_7.946927	254	334	11	32	80	0.4000000
NODE_4131_length_1173_cov_7.946927	254	334	12	4	80	0.0500000
NODE_4136_length_1172_cov_37.177074	527	607	6	6	80	0.0750000
NODE_4136_length_1172_cov_37.177074	527	607	7	4	80	0.0500000
NODE_4136_length_1172_cov_37.177074	527	607	8	6	80	0.0750000
NODE_4136_length_1172_cov_37.177074	527	607	9	2	80	0.0250000
NODE_4136_length_1172_cov_37.177074	527	607	10	19	80	0.2375000
NODE_4136_length_1172_cov_37.177074	527	607	12	33	80	0.4125000
NODE_4136_length_1172_cov_37.177074	527	607	14	9	80	0.1125000
NODE_4136_length_1172_cov_37.177074	527	607	15	1	80	0.0125000
NODE_4136_length_1172_cov_37.177074	580	660	12	17	80	0.2125000
NODE_4136_length_1172_cov_37.177074	580	660	13	7	80	0.0875000
NODE_4136_length_1172_cov_37.177074	580	660	14	10	80	0.1250000
NODE_4136_length_1172_cov_37.177074	580	660	15	9	80	0.1125000
NODE_4136_length_1172_cov_37.177074	580	660	16	28	80	0.3500000
NODE_4136_length_1172_cov_37.177074	580	660	17	9	80	0.1125000
NODE_4137_length_1172_cov_20.397018	677	757	4	1	80	0.0125000
NODE_4137_length_1172_cov_20.397018	677	757	5	18	80	0.2250000
NODE_4137_length_1172_cov_20.397018	677	757	8	55	80	0.6875000
NODE_4137_length_1172_cov_20.397018	677	757	9	3	80	0.0375000
NODE_4137_length_1172_cov_20.397018	677	757	10	3	80	0.0375000
NODE_4137_length_1172_cov_20.397018	730	810	6	8	80	0.1000000
NODE_4137_length_1172_cov_20.397018	730	810	7	6	80	0.0750000
NODE_4137_length_1172_cov_20.397018	730	810	8	60	80	0.7500000
NODE_4137_length_1172_cov_20.397018	730	810	9	3	80	0.0375000
NODE_4137_length_1172_cov_20.397018	730	810	10	3	80	0.0375000
NODE_4138_length_1172_cov_15.018639	460	540	10	2	80	0.0250000
NODE_4138_length_1172_cov_15.018639	460	540	11	8	80	0.1000000
NODE_4138_length_1172_cov_15.018639	460	540	12	36	80	0.4500000
NODE_4138_length_1172_cov_15.018639	460	540	13	13	80	0.1625000
NODE_4138_length_1172_cov_15.018639	460	540	14	17	80	0.2125000
NODE_4138_length_1172_cov_15.018639	460	540	16	4	80	0.0500000
NODE_4138_length_1172_cov_15.018639	513	593	8	15	80	0.1875000
NODE_4138_length_1172_cov_15.018639	513	593	9	7	80	0.0875000
NODE_4138_length_1172_cov_15.018639	513	593	10	6	80	0.0750000
NODE_4138_length_1172_cov_15.018639	513	593	11	5	80	0.0625000
NODE_4138_length_1172_cov_15.018639	513	593	12	20	80	0.2500000
NODE_4138_length_1172_cov_15.018639	513	593	13	8	80	0.1000000
NODE_4138_length_1172_cov_15.018639	513	593	14	15	80	0.1875000
NODE_4138_length_1172_cov_15.018639	513	593	16	4	80	0.0500000
NODE_4139_length_1172_cov_13.199441	622	702	4	1	80	0.0125000
NODE_4139_length_1172_cov_13.199441	622	702	6	22	80	0.2750000
NODE_4139_length_1172_cov_13.199441	622	702	7	6	80	0.0750000
NODE_4139_length_1172_cov_13.199441	622	702	8	51	80	0.6375000
NODE_4139_length_1172_cov_13.199441	675	755	6	1	80	0.0125000
NODE_4139_length_1172_cov_13.199441	675	755	7	21	80	0.2625000
NODE_4139_length_1172_cov_13.199441	675	755	8	56	80	0.7000000
NODE_4139_length_1172_cov_13.199441	675	755	9	2	80	0.0250000
NODE_4140_length_1172_cov_10.720410	499	579	2	45	80	0.5625000
NODE_4140_length_1172_cov_10.720410	499	579	3	35	80	0.4375000
NODE_4140_length_1172_cov_10.720410	552	632	1	12	80	0.1500000
NODE_4140_length_1172_cov_10.720410	552	632	3	52	80	0.6500000
NODE_4140_length_1172_cov_10.720410	552	632	4	16	80	0.2000000
NODE_4140_length_1172_cov_10.720410	628	708	1	12	80	0.1500000
NODE_4140_length_1172_cov_10.720410	628	708	2	68	80	0.8500000
NODE_4140_length_1172_cov_10.720410	681	761	1	8	80	0.1000000
NODE_4140_length_1172_cov_10.720410	681	761	2	72	80	0.9000000
NODE_4141_length_1172_cov_10.574091	951	1021	1	70	70	1.0000000
NODE_4142_length_1172_cov_9.204101	276	356	3	11	80	0.1375000
NODE_4142_length_1172_cov_9.204101	276	356	4	69	80	0.8625000
NODE_4142_length_1172_cov_9.204101	329	409	1	3	80	0.0375000
NODE_4142_length_1172_cov_9.204101	329	409	2	25	80	0.3125000
NODE_4142_length_1172_cov_9.204101	329	409	4	52	80	0.6500000
NODE_4148_length_1171_cov_13.311567	666	746	2	22	80	0.2750000
NODE_4148_length_1171_cov_13.311567	666	746	3	9	80	0.1125000
NODE_4148_length_1171_cov_13.311567	666	746	4	2	80	0.0250000
NODE_4148_length_1171_cov_13.311567	666	746	5	47	80	0.5875000
NODE_4148_length_1171_cov_13.311567	719	803	4	53	84	0.6309524
NODE_4148_length_1171_cov_13.311567	719	803	5	31	84	0.3690476
NODE_4149_length_1171_cov_9.154851	198	278	3	50	80	0.6250000
NODE_4149_length_1171_cov_9.154851	198	278	4	30	80	0.3750000
NODE_4149_length_1171_cov_9.154851	251	331	1	22	80	0.2750000
NODE_4149_length_1171_cov_9.154851	251	331	2	17	80	0.2125000
NODE_4149_length_1171_cov_9.154851	251	331	3	41	80	0.5125000
NODE_4157_length_1170_cov_65.480859	402	482	9	3	80	0.0375000
NODE_4157_length_1170_cov_65.480859	402	482	11	1	80	0.0125000
NODE_4157_length_1170_cov_65.480859	402	482	12	7	80	0.0875000
NODE_4157_length_1170_cov_65.480859	402	482	13	34	80	0.4250000
NODE_4157_length_1170_cov_65.480859	402	482	14	15	80	0.1875000
NODE_4157_length_1170_cov_65.480859	402	482	15	20	80	0.2500000
NODE_4157_length_1170_cov_65.480859	455	535	4	4	80	0.0500000
NODE_4157_length_1170_cov_65.480859	455	535	6	1	80	0.0125000
NODE_4157_length_1170_cov_65.480859	455	535	8	18	80	0.2250000
NODE_4157_length_1170_cov_65.480859	455	535	10	11	80	0.1375000
NODE_4157_length_1170_cov_65.480859	455	535	12	18	80	0.2250000
NODE_4157_length_1170_cov_65.480859	455	535	13	4	80	0.0500000
NODE_4157_length_1170_cov_65.480859	455	535	14	4	80	0.0500000
NODE_4157_length_1170_cov_65.480859	455	535	15	20	80	0.2500000
NODE_4158_length_1170_cov_35.283847	704	784	2	14	80	0.1750000
NODE_4158_length_1170_cov_35.283847	704	784	3	23	80	0.2875000
NODE_4158_length_1170_cov_35.283847	704	784	4	2	80	0.0250000
NODE_4158_length_1170_cov_35.283847	704	784	5	41	80	0.5125000
NODE_4158_length_1170_cov_35.283847	757	837	3	60	80	0.7500000
NODE_4158_length_1170_cov_35.283847	757	837	4	2	80	0.0250000
NODE_4158_length_1170_cov_35.283847	757	837	5	18	80	0.2250000
NODE_4159_length_1170_cov_23.600373	450	530	4	32	80	0.4000000
NODE_4159_length_1170_cov_23.600373	450	530	5	33	80	0.4125000
NODE_4159_length_1170_cov_23.600373	450	530	6	15	80	0.1875000
NODE_4159_length_1170_cov_23.600373	503	583	5	19	80	0.2375000
NODE_4159_length_1170_cov_23.600373	503	583	6	61	80	0.7625000
NODE_4159_length_1170_cov_23.600373	579	659	1	27	80	0.3375000
NODE_4159_length_1170_cov_23.600373	579	659	2	36	80	0.4500000
NODE_4159_length_1170_cov_23.600373	579	659	3	3	80	0.0375000
NODE_4159_length_1170_cov_23.600373	579	659	4	9	80	0.1125000
NODE_4159_length_1170_cov_23.600373	579	659	5	5	80	0.0625000
NODE_4159_length_1170_cov_23.600373	632	705	0	46	73	0.6301370
NODE_4159_length_1170_cov_23.600373	632	705	1	27	73	0.3698630
NODE_4160_length_1170_cov_19.783380	325	405	6	16	80	0.2000000
NODE_4160_length_1170_cov_19.783380	325	405	7	2	80	0.0250000
NODE_4160_length_1170_cov_19.783380	325	405	8	8	80	0.1000000
NODE_4160_length_1170_cov_19.783380	325	405	9	11	80	0.1375000
NODE_4160_length_1170_cov_19.783380	325	405	11	2	80	0.0250000
NODE_4160_length_1170_cov_19.783380	325	405	12	26	80	0.3250000
NODE_4160_length_1170_cov_19.783380	325	405	13	15	80	0.1875000
NODE_4160_length_1170_cov_19.783380	378	458	2	6	80	0.0750000
NODE_4160_length_1170_cov_19.783380	378	458	3	8	80	0.1000000
NODE_4160_length_1170_cov_19.783380	378	458	4	22	80	0.2750000
NODE_4160_length_1170_cov_19.783380	378	458	5	5	80	0.0625000
NODE_4160_length_1170_cov_19.783380	378	458	6	28	80	0.3500000
NODE_4160_length_1170_cov_19.783380	378	458	7	2	80	0.0250000
NODE_4160_length_1170_cov_19.783380	378	458	8	8	80	0.1000000
NODE_4160_length_1170_cov_19.783380	378	458	9	1	80	0.0125000
NODE_4168_length_1169_cov_61.689720	464	544	4	10	80	0.1250000
NODE_4168_length_1169_cov_61.689720	464	544	5	3	80	0.0375000
NODE_4168_length_1169_cov_61.689720	464	544	7	2	80	0.0250000
NODE_4168_length_1169_cov_61.689720	464	544	8	5	80	0.0625000
NODE_4168_length_1169_cov_61.689720	464	544	10	19	80	0.2375000
NODE_4168_length_1169_cov_61.689720	464	544	11	9	80	0.1125000
NODE_4168_length_1169_cov_61.689720	464	544	13	1	80	0.0125000
NODE_4168_length_1169_cov_61.689720	464	544	14	2	80	0.0250000
NODE_4168_length_1169_cov_61.689720	464	544	16	1	80	0.0125000
NODE_4168_length_1169_cov_61.689720	464	544	17	5	80	0.0625000
NODE_4168_length_1169_cov_61.689720	464	544	18	16	80	0.2000000
NODE_4168_length_1169_cov_61.689720	464	544	19	7	80	0.0875000
NODE_4168_length_1169_cov_61.689720	517	597	17	4	80	0.0500000
NODE_4168_length_1169_cov_61.689720	517	597	18	22	80	0.2750000
NODE_4168_length_1169_cov_61.689720	517	597	19	33	80	0.4125000
NODE_4168_length_1169_cov_61.689720	517	597	20	13	80	0.1625000
NODE_4168_length_1169_cov_61.689720	517	597	21	8	80	0.1000000
NODE_4168_length_1169_cov_61.689720	593	673	13	3	80	0.0375000
NODE_4168_length_1169_cov_61.689720	593	673	14	6	80	0.0750000
NODE_4168_length_1169_cov_61.689720	593	673	15	3	80	0.0375000
NODE_4168_length_1169_cov_61.689720	593	673	16	24	80	0.3000000
NODE_4168_length_1169_cov_61.689720	593	673	17	9	80	0.1125000
NODE_4168_length_1169_cov_61.689720	593	673	18	23	80	0.2875000
NODE_4168_length_1169_cov_61.689720	593	673	19	8	80	0.1000000
NODE_4168_length_1169_cov_61.689720	593	673	21	4	80	0.0500000
NODE_4168_length_1169_cov_61.689720	646	726	9	33	80	0.4125000
NODE_4168_length_1169_cov_61.689720	646	726	10	10	80	0.1250000
NODE_4168_length_1169_cov_61.689720	646	726	11	3	80	0.0375000
NODE_4168_length_1169_cov_61.689720	646	726	13	10	80	0.1250000
NODE_4168_length_1169_cov_61.689720	646	726	14	6	80	0.0750000
NODE_4168_length_1169_cov_61.689720	646	726	15	2	80	0.0250000
NODE_4168_length_1169_cov_61.689720	646	726	16	9	80	0.1125000
NODE_4168_length_1169_cov_61.689720	646	726	17	7	80	0.0875000
NODE_4169_length_1169_cov_55.247664	640	720	3	10	80	0.1250000
NODE_4169_length_1169_cov_55.247664	640	720	4	69	80	0.8625000
NODE_4169_length_1169_cov_55.247664	640	720	5	1	80	0.0125000
NODE_4169_length_1169_cov_55.247664	693	773	3	7	80	0.0875000
NODE_4169_length_1169_cov_55.247664	693	773	4	50	80	0.6250000
NODE_4169_length_1169_cov_55.247664	693	773	5	23	80	0.2875000
NODE_4170_length_1169_cov_39.016822	447	527	9	27	80	0.3375000
NODE_4170_length_1169_cov_39.016822	447	527	10	43	80	0.5375000
NODE_4170_length_1169_cov_39.016822	447	527	11	4	80	0.0500000
NODE_4170_length_1169_cov_39.016822	447	527	12	6	80	0.0750000
NODE_4170_length_1169_cov_39.016822	500	580	6	11	80	0.1375000
NODE_4170_length_1169_cov_39.016822	500	580	7	19	80	0.2375000
NODE_4170_length_1169_cov_39.016822	500	580	8	1	80	0.0125000
NODE_4170_length_1169_cov_39.016822	500	580	9	41	80	0.5125000
NODE_4170_length_1169_cov_39.016822	500	580	10	5	80	0.0625000
NODE_4170_length_1169_cov_39.016822	500	580	11	3	80	0.0375000
NODE_4170_length_1169_cov_39.016822	576	656	4	28	80	0.3500000
NODE_4170_length_1169_cov_39.016822	576	656	5	1	80	0.0125000
NODE_4170_length_1169_cov_39.016822	576	656	6	16	80	0.2000000
NODE_4170_length_1169_cov_39.016822	576	656	8	32	80	0.4000000
NODE_4170_length_1169_cov_39.016822	576	656	9	3	80	0.0375000
NODE_4170_length_1169_cov_39.016822	629	709	4	80	80	1.0000000
NODE_4171_length_1169_cov_35.383178	582	662	3	12	80	0.1500000
NODE_4171_length_1169_cov_35.383178	582	662	4	3	80	0.0375000
NODE_4171_length_1169_cov_35.383178	582	662	5	3	80	0.0375000
NODE_4171_length_1169_cov_35.383178	582	662	6	17	80	0.2125000
NODE_4171_length_1169_cov_35.383178	582	662	7	45	80	0.5625000
NODE_4171_length_1169_cov_35.383178	635	715	3	14	80	0.1750000
NODE_4171_length_1169_cov_35.383178	635	715	4	3	80	0.0375000
NODE_4171_length_1169_cov_35.383178	635	715	5	3	80	0.0375000
NODE_4171_length_1169_cov_35.383178	635	715	6	2	80	0.0250000
NODE_4171_length_1169_cov_35.383178	635	715	7	27	80	0.3375000
NODE_4171_length_1169_cov_35.383178	635	715	8	9	80	0.1125000
NODE_4171_length_1169_cov_35.383178	635	715	9	4	80	0.0500000
NODE_4171_length_1169_cov_35.383178	635	715	10	18	80	0.2250000
NODE_4173_length_1169_cov_12.010280	338	418	0	80	80	1.0000000
NODE_4173_length_1169_cov_12.010280	391	471	0	43	80	0.5375000
NODE_4173_length_1169_cov_12.010280	391	471	3	37	80	0.4625000
NODE_4175_length_1169_cov_4.172897	74	135	0	61	61	1.0000000
NODE_4175_length_1169_cov_4.172897	74	135	0	61	61	1.0000000
NODE_4175_length_1169_cov_4.172897	74	135	0	61	61	1.0000000
NODE_4183_length_1168_cov_27.350795	517	597	5	31	80	0.3875000
NODE_4183_length_1168_cov_27.350795	517	597	7	49	80	0.6125000
NODE_4183_length_1168_cov_27.350795	570	650	3	7	80	0.0875000
NODE_4183_length_1168_cov_27.350795	570	650	5	12	80	0.1500000
NODE_4183_length_1168_cov_27.350795	570	650	6	17	80	0.2125000
NODE_4183_length_1168_cov_27.350795	570	650	7	27	80	0.3375000
NODE_4183_length_1168_cov_27.350795	570	650	8	14	80	0.1750000
NODE_4183_length_1168_cov_27.350795	570	650	9	3	80	0.0375000
NODE_4183_length_1168_cov_27.350795	646	726	2	2	80	0.0250000
NODE_4183_length_1168_cov_27.350795	646	726	3	19	80	0.2375000
NODE_4183_length_1168_cov_27.350795	646	726	4	41	80	0.5125000
NODE_4183_length_1168_cov_27.350795	646	726	5	14	80	0.1750000
NODE_4183_length_1168_cov_27.350795	646	726	6	4	80	0.0500000
NODE_4183_length_1168_cov_27.350795	699	779	2	2	80	0.0250000
NODE_4183_length_1168_cov_27.350795	699	779	4	35	80	0.4375000
NODE_4183_length_1168_cov_27.350795	699	779	5	18	80	0.2250000
NODE_4183_length_1168_cov_27.350795	699	779	6	25	80	0.3125000
NODE_4184_length_1168_cov_25.777362	672	752	4	16	80	0.2000000
NODE_4184_length_1168_cov_25.777362	672	752	5	2	80	0.0250000
NODE_4184_length_1168_cov_25.777362	672	752	7	10	80	0.1250000
NODE_4184_length_1168_cov_25.777362	672	752	8	7	80	0.0875000
NODE_4184_length_1168_cov_25.777362	672	752	9	4	80	0.0500000
NODE_4184_length_1168_cov_25.777362	672	752	10	20	80	0.2500000
NODE_4184_length_1168_cov_25.777362	672	752	11	20	80	0.2500000
NODE_4184_length_1168_cov_25.777362	672	752	12	1	80	0.0125000
NODE_4184_length_1168_cov_25.777362	725	805	9	4	80	0.0500000
NODE_4184_length_1168_cov_25.777362	725	805	10	12	80	0.1500000
NODE_4184_length_1168_cov_25.777362	725	805	11	22	80	0.2750000
NODE_4184_length_1168_cov_25.777362	725	805	12	4	80	0.0500000
NODE_4184_length_1168_cov_25.777362	725	805	13	38	80	0.4750000
NODE_4185_length_1168_cov_25.295603	543	623	4	6	80	0.0750000
NODE_4185_length_1168_cov_25.295603	543	623	5	27	80	0.3375000
NODE_4185_length_1168_cov_25.295603	543	623	6	10	80	0.1250000
NODE_4185_length_1168_cov_25.295603	543	623	7	37	80	0.4625000
NODE_4185_length_1168_cov_25.295603	596	676	4	5	80	0.0625000
NODE_4185_length_1168_cov_25.295603	596	676	5	23	80	0.2875000
NODE_4185_length_1168_cov_25.295603	596	676	6	20	80	0.2500000
NODE_4185_length_1168_cov_25.295603	596	676	7	32	80	0.4000000
NODE_4185_length_1168_cov_25.295603	672	752	6	48	80	0.6000000
NODE_4185_length_1168_cov_25.295603	672	752	7	12	80	0.1500000
NODE_4185_length_1168_cov_25.295603	672	752	8	12	80	0.1500000
NODE_4185_length_1168_cov_25.295603	672	752	9	8	80	0.1000000
NODE_4185_length_1168_cov_25.295603	725	804	2	7	79	0.0886076
NODE_4185_length_1168_cov_25.295603	725	804	3	12	79	0.1518987
NODE_4185_length_1168_cov_25.295603	725	804	4	7	79	0.0886076
NODE_4185_length_1168_cov_25.295603	725	804	5	4	79	0.0506329
NODE_4185_length_1168_cov_25.295603	725	804	6	49	79	0.6202531
NODE_4186_length_1168_cov_20.202058	434	514	3	6	80	0.0750000
NODE_4186_length_1168_cov_20.202058	434	514	4	1	80	0.0125000
NODE_4186_length_1168_cov_20.202058	434	514	5	12	80	0.1500000
NODE_4186_length_1168_cov_20.202058	434	514	6	25	80	0.3125000
NODE_4186_length_1168_cov_20.202058	434	514	7	36	80	0.4500000
NODE_4186_length_1168_cov_20.202058	487	567	7	42	80	0.5250000
NODE_4186_length_1168_cov_20.202058	487	567	8	38	80	0.4750000
NODE_4187_length_1168_cov_16.787652	405	485	1	15	80	0.1875000
NODE_4187_length_1168_cov_16.787652	405	485	3	11	80	0.1375000
NODE_4187_length_1168_cov_16.787652	405	485	5	5	80	0.0625000
NODE_4187_length_1168_cov_16.787652	405	485	7	2	80	0.0250000
NODE_4187_length_1168_cov_16.787652	405	485	8	10	80	0.1250000
NODE_4187_length_1168_cov_16.787652	405	485	9	27	80	0.3375000
NODE_4187_length_1168_cov_16.787652	405	485	10	10	80	0.1250000
NODE_4187_length_1168_cov_16.787652	458	538	9	17	80	0.2125000
NODE_4187_length_1168_cov_16.787652	458	538	10	14	80	0.1750000
NODE_4187_length_1168_cov_16.787652	458	538	11	27	80	0.3375000
NODE_4187_length_1168_cov_16.787652	458	538	12	22	80	0.2750000
NODE_4188_length_1168_cov_10.079514	722	802	0	80	80	1.0000000
NODE_4188_length_1168_cov_10.079514	775	855	0	80	80	1.0000000
NODE_4198_length_1167_cov_27.961610	591	671	2	18	80	0.2250000
NODE_4198_length_1167_cov_27.961610	591	671	3	11	80	0.1375000
NODE_4198_length_1167_cov_27.961610	591	671	4	2	80	0.0250000
NODE_4198_length_1167_cov_27.961610	591	671	5	4	80	0.0500000
NODE_4198_length_1167_cov_27.961610	591	671	6	26	80	0.3250000
NODE_4198_length_1167_cov_27.961610	591	671	7	5	80	0.0625000
NODE_4198_length_1167_cov_27.961610	591	671	8	6	80	0.0750000
NODE_4198_length_1167_cov_27.961610	591	671	9	8	80	0.1000000
NODE_4198_length_1167_cov_27.961610	644	724	6	8	80	0.1000000
NODE_4198_length_1167_cov_27.961610	644	724	7	5	80	0.0625000
NODE_4198_length_1167_cov_27.961610	644	724	8	6	80	0.0750000
NODE_4198_length_1167_cov_27.961610	644	724	9	46	80	0.5750000
NODE_4198_length_1167_cov_27.961610	644	724	10	15	80	0.1875000
NODE_4199_length_1167_cov_12.393258	670	750	2	14	80	0.1750000
NODE_4199_length_1167_cov_12.393258	670	750	3	16	80	0.2000000
NODE_4199_length_1167_cov_12.393258	670	750	4	15	80	0.1875000
NODE_4199_length_1167_cov_12.393258	670	750	6	35	80	0.4375000
NODE_4199_length_1167_cov_12.393258	723	803	4	4	80	0.0500000
NODE_4199_length_1167_cov_12.393258	723	803	6	76	80	0.9500000
NODE_4200_length_1167_cov_11.189139	434	514	2	80	80	1.0000000
NODE_4200_length_1167_cov_11.189139	487	567	2	80	80	1.0000000
NODE_4201_length_1167_cov_7.998127	711	791	1	3	80	0.0375000
NODE_4201_length_1167_cov_7.998127	711	791	5	34	80	0.4250000
NODE_4201_length_1167_cov_7.998127	711	791	6	43	80	0.5375000
NODE_4201_length_1167_cov_7.998127	764	844	5	29	80	0.3625000
NODE_4201_length_1167_cov_7.998127	764	844	6	51	80	0.6375000
NODE_4206_length_1166_cov_313.815370	444	524	21	3	80	0.0375000
NODE_4206_length_1166_cov_313.815370	444	524	22	10	80	0.1250000
NODE_4206_length_1166_cov_313.815370	444	524	23	3	80	0.0375000
NODE_4206_length_1166_cov_313.815370	444	524	25	1	80	0.0125000
NODE_4206_length_1166_cov_313.815370	444	524	26	2	80	0.0250000
NODE_4206_length_1166_cov_313.815370	444	524	27	3	80	0.0375000
NODE_4206_length_1166_cov_313.815370	444	524	29	6	80	0.0750000
NODE_4206_length_1166_cov_313.815370	444	524	31	4	80	0.0500000
NODE_4206_length_1166_cov_313.815370	444	524	32	4	80	0.0500000
NODE_4206_length_1166_cov_313.815370	444	524	34	4	80	0.0500000
NODE_4206_length_1166_cov_313.815370	444	524	35	1	80	0.0125000
NODE_4206_length_1166_cov_313.815370	444	524	37	2	80	0.0250000
NODE_4206_length_1166_cov_313.815370	444	524	38	1	80	0.0125000
NODE_4206_length_1166_cov_313.815370	444	524	39	6	80	0.0750000
NODE_4206_length_1166_cov_313.815370	444	524	48	1	80	0.0125000
NODE_4206_length_1166_cov_313.815370	444	524	50	14	80	0.1750000
NODE_4206_length_1166_cov_313.815370	444	524	51	9	80	0.1125000
NODE_4206_length_1166_cov_313.815370	444	524	52	4	80	0.0500000
NODE_4206_length_1166_cov_313.815370	444	524	54	1	80	0.0125000
NODE_4206_length_1166_cov_313.815370	444	524	55	1	80	0.0125000
NODE_4206_length_1166_cov_313.815370	444	524	21	3	80	0.0375000
NODE_4206_length_1166_cov_313.815370	444	524	22	10	80	0.1250000
NODE_4206_length_1166_cov_313.815370	444	524	23	3	80	0.0375000
NODE_4206_length_1166_cov_313.815370	444	524	25	1	80	0.0125000
NODE_4206_length_1166_cov_313.815370	444	524	26	2	80	0.0250000
NODE_4206_length_1166_cov_313.815370	444	524	27	3	80	0.0375000
NODE_4206_length_1166_cov_313.815370	444	524	29	6	80	0.0750000
NODE_4206_length_1166_cov_313.815370	444	524	31	4	80	0.0500000
NODE_4206_length_1166_cov_313.815370	444	524	32	4	80	0.0500000
NODE_4206_length_1166_cov_313.815370	444	524	34	4	80	0.0500000
NODE_4206_length_1166_cov_313.815370	444	524	35	1	80	0.0125000
NODE_4206_length_1166_cov_313.815370	444	524	37	2	80	0.0250000
NODE_4206_length_1166_cov_313.815370	444	524	38	1	80	0.0125000
NODE_4206_length_1166_cov_313.815370	444	524	39	6	80	0.0750000
NODE_4206_length_1166_cov_313.815370	444	524	48	1	80	0.0125000
NODE_4206_length_1166_cov_313.815370	444	524	50	14	80	0.1750000
NODE_4206_length_1166_cov_313.815370	444	524	51	9	80	0.1125000
NODE_4206_length_1166_cov_313.815370	444	524	52	4	80	0.0500000
NODE_4206_length_1166_cov_313.815370	444	524	54	1	80	0.0125000
NODE_4206_length_1166_cov_313.815370	444	524	55	1	80	0.0125000
NODE_4206_length_1166_cov_313.815370	444	524	21	3	80	0.0375000
NODE_4206_length_1166_cov_313.815370	444	524	22	10	80	0.1250000
NODE_4206_length_1166_cov_313.815370	444	524	23	3	80	0.0375000
NODE_4206_length_1166_cov_313.815370	444	524	25	1	80	0.0125000
NODE_4206_length_1166_cov_313.815370	444	524	26	2	80	0.0250000
NODE_4206_length_1166_cov_313.815370	444	524	27	3	80	0.0375000
NODE_4206_length_1166_cov_313.815370	444	524	29	6	80	0.0750000
NODE_4206_length_1166_cov_313.815370	444	524	31	4	80	0.0500000
NODE_4206_length_1166_cov_313.815370	444	524	32	4	80	0.0500000
NODE_4206_length_1166_cov_313.815370	444	524	34	4	80	0.0500000
NODE_4206_length_1166_cov_313.815370	444	524	35	1	80	0.0125000
NODE_4206_length_1166_cov_313.815370	444	524	37	2	80	0.0250000
NODE_4206_length_1166_cov_313.815370	444	524	38	1	80	0.0125000
NODE_4206_length_1166_cov_313.815370	444	524	39	6	80	0.0750000
NODE_4206_length_1166_cov_313.815370	444	524	48	1	80	0.0125000
NODE_4206_length_1166_cov_313.815370	444	524	50	14	80	0.1750000
NODE_4206_length_1166_cov_313.815370	444	524	51	9	80	0.1125000
NODE_4206_length_1166_cov_313.815370	444	524	52	4	80	0.0500000
NODE_4206_length_1166_cov_313.815370	444	524	54	1	80	0.0125000
NODE_4206_length_1166_cov_313.815370	444	524	55	1	80	0.0125000
NODE_4206_length_1166_cov_313.815370	444	524	21	3	80	0.0375000
NODE_4206_length_1166_cov_313.815370	444	524	22	10	80	0.1250000
NODE_4206_length_1166_cov_313.815370	444	524	23	3	80	0.0375000
NODE_4206_length_1166_cov_313.815370	444	524	25	1	80	0.0125000
NODE_4206_length_1166_cov_313.815370	444	524	26	2	80	0.0250000
NODE_4206_length_1166_cov_313.815370	444	524	27	3	80	0.0375000
NODE_4206_length_1166_cov_313.815370	444	524	29	6	80	0.0750000
NODE_4206_length_1166_cov_313.815370	444	524	31	4	80	0.0500000
NODE_4206_length_1166_cov_313.815370	444	524	32	4	80	0.0500000
NODE_4206_length_1166_cov_313.815370	444	524	34	4	80	0.0500000
NODE_4206_length_1166_cov_313.815370	444	524	35	1	80	0.0125000
NODE_4206_length_1166_cov_313.815370	444	524	37	2	80	0.0250000
NODE_4206_length_1166_cov_313.815370	444	524	38	1	80	0.0125000
NODE_4206_length_1166_cov_313.815370	444	524	39	6	80	0.0750000
NODE_4206_length_1166_cov_313.815370	444	524	48	1	80	0.0125000
NODE_4206_length_1166_cov_313.815370	444	524	50	14	80	0.1750000
NODE_4206_length_1166_cov_313.815370	444	524	51	9	80	0.1125000
NODE_4206_length_1166_cov_313.815370	444	524	52	4	80	0.0500000
NODE_4206_length_1166_cov_313.815370	444	524	54	1	80	0.0125000
NODE_4206_length_1166_cov_313.815370	444	524	55	1	80	0.0125000
NODE_4206_length_1166_cov_313.815370	444	524	21	3	80	0.0375000
NODE_4206_length_1166_cov_313.815370	444	524	22	10	80	0.1250000
NODE_4206_length_1166_cov_313.815370	444	524	23	3	80	0.0375000
NODE_4206_length_1166_cov_313.815370	444	524	25	1	80	0.0125000
NODE_4206_length_1166_cov_313.815370	444	524	26	2	80	0.0250000
NODE_4206_length_1166_cov_313.815370	444	524	27	3	80	0.0375000
NODE_4206_length_1166_cov_313.815370	444	524	29	6	80	0.0750000
NODE_4206_length_1166_cov_313.815370	444	524	31	4	80	0.0500000
NODE_4206_length_1166_cov_313.815370	444	524	32	4	80	0.0500000
NODE_4206_length_1166_cov_313.815370	444	524	34	4	80	0.0500000
NODE_4206_length_1166_cov_313.815370	444	524	35	1	80	0.0125000
NODE_4206_length_1166_cov_313.815370	444	524	37	2	80	0.0250000
NODE_4206_length_1166_cov_313.815370	444	524	38	1	80	0.0125000
NODE_4206_length_1166_cov_313.815370	444	524	39	6	80	0.0750000
NODE_4206_length_1166_cov_313.815370	444	524	48	1	80	0.0125000
NODE_4206_length_1166_cov_313.815370	444	524	50	14	80	0.1750000
NODE_4206_length_1166_cov_313.815370	444	524	51	9	80	0.1125000
NODE_4206_length_1166_cov_313.815370	444	524	52	4	80	0.0500000
NODE_4206_length_1166_cov_313.815370	444	524	54	1	80	0.0125000
NODE_4206_length_1166_cov_313.815370	444	524	55	1	80	0.0125000
NODE_4206_length_1166_cov_313.815370	444	524	21	3	80	0.0375000
NODE_4206_length_1166_cov_313.815370	444	524	22	10	80	0.1250000
NODE_4206_length_1166_cov_313.815370	444	524	23	3	80	0.0375000
NODE_4206_length_1166_cov_313.815370	444	524	25	1	80	0.0125000
NODE_4206_length_1166_cov_313.815370	444	524	26	2	80	0.0250000
NODE_4206_length_1166_cov_313.815370	444	524	27	3	80	0.0375000
NODE_4206_length_1166_cov_313.815370	444	524	29	6	80	0.0750000
NODE_4206_length_1166_cov_313.815370	444	524	31	4	80	0.0500000
NODE_4206_length_1166_cov_313.815370	444	524	32	4	80	0.0500000
NODE_4206_length_1166_cov_313.815370	444	524	34	4	80	0.0500000
NODE_4206_length_1166_cov_313.815370	444	524	35	1	80	0.0125000
NODE_4206_length_1166_cov_313.815370	444	524	37	2	80	0.0250000
NODE_4206_length_1166_cov_313.815370	444	524	38	1	80	0.0125000
NODE_4206_length_1166_cov_313.815370	444	524	39	6	80	0.0750000
NODE_4206_length_1166_cov_313.815370	444	524	48	1	80	0.0125000
NODE_4206_length_1166_cov_313.815370	444	524	50	14	80	0.1750000
NODE_4206_length_1166_cov_313.815370	444	524	51	9	80	0.1125000
NODE_4206_length_1166_cov_313.815370	444	524	52	4	80	0.0500000
NODE_4206_length_1166_cov_313.815370	444	524	54	1	80	0.0125000
NODE_4206_length_1166_cov_313.815370	444	524	55	1	80	0.0125000
NODE_4206_length_1166_cov_313.815370	497	577	48	1	80	0.0125000
NODE_4206_length_1166_cov_313.815370	497	577	50	12	80	0.1500000
NODE_4206_length_1166_cov_313.815370	497	577	51	8	80	0.1000000
NODE_4206_length_1166_cov_313.815370	497	577	52	4	80	0.0500000
NODE_4206_length_1166_cov_313.815370	497	577	54	1	80	0.0125000
NODE_4206_length_1166_cov_313.815370	497	577	55	1	80	0.0125000
NODE_4206_length_1166_cov_313.815370	497	577	56	1	80	0.0125000
NODE_4206_length_1166_cov_313.815370	497	577	58	1	80	0.0125000
NODE_4206_length_1166_cov_313.815370	497	577	59	10	80	0.1250000
NODE_4206_length_1166_cov_313.815370	497	577	60	5	80	0.0625000
NODE_4206_length_1166_cov_313.815370	497	577	61	20	80	0.2500000
NODE_4206_length_1166_cov_313.815370	497	577	62	12	80	0.1500000
NODE_4206_length_1166_cov_313.815370	497	577	63	4	80	0.0500000
NODE_4206_length_1166_cov_313.815370	497	577	48	1	80	0.0125000
NODE_4206_length_1166_cov_313.815370	497	577	50	12	80	0.1500000
NODE_4206_length_1166_cov_313.815370	497	577	51	8	80	0.1000000
NODE_4206_length_1166_cov_313.815370	497	577	52	4	80	0.0500000
NODE_4206_length_1166_cov_313.815370	497	577	54	1	80	0.0125000
NODE_4206_length_1166_cov_313.815370	497	577	55	1	80	0.0125000
NODE_4206_length_1166_cov_313.815370	497	577	56	1	80	0.0125000
NODE_4206_length_1166_cov_313.815370	497	577	58	1	80	0.0125000
NODE_4206_length_1166_cov_313.815370	497	577	59	10	80	0.1250000
NODE_4206_length_1166_cov_313.815370	497	577	60	5	80	0.0625000
NODE_4206_length_1166_cov_313.815370	497	577	61	20	80	0.2500000
NODE_4206_length_1166_cov_313.815370	497	577	62	12	80	0.1500000
NODE_4206_length_1166_cov_313.815370	497	577	63	4	80	0.0500000
NODE_4206_length_1166_cov_313.815370	497	577	48	1	80	0.0125000
NODE_4206_length_1166_cov_313.815370	497	577	50	12	80	0.1500000
NODE_4206_length_1166_cov_313.815370	497	577	51	8	80	0.1000000
NODE_4206_length_1166_cov_313.815370	497	577	52	4	80	0.0500000
NODE_4206_length_1166_cov_313.815370	497	577	54	1	80	0.0125000
NODE_4206_length_1166_cov_313.815370	497	577	55	1	80	0.0125000
NODE_4206_length_1166_cov_313.815370	497	577	56	1	80	0.0125000
NODE_4206_length_1166_cov_313.815370	497	577	58	1	80	0.0125000
NODE_4206_length_1166_cov_313.815370	497	577	59	10	80	0.1250000
NODE_4206_length_1166_cov_313.815370	497	577	60	5	80	0.0625000
NODE_4206_length_1166_cov_313.815370	497	577	61	20	80	0.2500000
NODE_4206_length_1166_cov_313.815370	497	577	62	12	80	0.1500000
NODE_4206_length_1166_cov_313.815370	497	577	63	4	80	0.0500000
NODE_4206_length_1166_cov_313.815370	497	577	48	1	80	0.0125000
NODE_4206_length_1166_cov_313.815370	497	577	50	12	80	0.1500000
NODE_4206_length_1166_cov_313.815370	497	577	51	8	80	0.1000000
NODE_4206_length_1166_cov_313.815370	497	577	52	4	80	0.0500000
NODE_4206_length_1166_cov_313.815370	497	577	54	1	80	0.0125000
NODE_4206_length_1166_cov_313.815370	497	577	55	1	80	0.0125000
NODE_4206_length_1166_cov_313.815370	497	577	56	1	80	0.0125000
NODE_4206_length_1166_cov_313.815370	497	577	58	1	80	0.0125000
NODE_4206_length_1166_cov_313.815370	497	577	59	10	80	0.1250000
NODE_4206_length_1166_cov_313.815370	497	577	60	5	80	0.0625000
NODE_4206_length_1166_cov_313.815370	497	577	61	20	80	0.2500000
NODE_4206_length_1166_cov_313.815370	497	577	62	12	80	0.1500000
NODE_4206_length_1166_cov_313.815370	497	577	63	4	80	0.0500000
NODE_4206_length_1166_cov_313.815370	497	577	48	1	80	0.0125000
NODE_4206_length_1166_cov_313.815370	497	577	50	12	80	0.1500000
NODE_4206_length_1166_cov_313.815370	497	577	51	8	80	0.1000000
NODE_4206_length_1166_cov_313.815370	497	577	52	4	80	0.0500000
NODE_4206_length_1166_cov_313.815370	497	577	54	1	80	0.0125000
NODE_4206_length_1166_cov_313.815370	497	577	55	1	80	0.0125000
NODE_4206_length_1166_cov_313.815370	497	577	56	1	80	0.0125000
NODE_4206_length_1166_cov_313.815370	497	577	58	1	80	0.0125000
NODE_4206_length_1166_cov_313.815370	497	577	59	10	80	0.1250000
NODE_4206_length_1166_cov_313.815370	497	577	60	5	80	0.0625000
NODE_4206_length_1166_cov_313.815370	497	577	61	20	80	0.2500000
NODE_4206_length_1166_cov_313.815370	497	577	62	12	80	0.1500000
NODE_4206_length_1166_cov_313.815370	497	577	63	4	80	0.0500000
NODE_4206_length_1166_cov_313.815370	497	577	48	1	80	0.0125000
NODE_4206_length_1166_cov_313.815370	497	577	50	12	80	0.1500000
NODE_4206_length_1166_cov_313.815370	497	577	51	8	80	0.1000000
NODE_4206_length_1166_cov_313.815370	497	577	52	4	80	0.0500000
NODE_4206_length_1166_cov_313.815370	497	577	54	1	80	0.0125000
NODE_4206_length_1166_cov_313.815370	497	577	55	1	80	0.0125000
NODE_4206_length_1166_cov_313.815370	497	577	56	1	80	0.0125000
NODE_4206_length_1166_cov_313.815370	497	577	58	1	80	0.0125000
NODE_4206_length_1166_cov_313.815370	497	577	59	10	80	0.1250000
NODE_4206_length_1166_cov_313.815370	497	577	60	5	80	0.0625000
NODE_4206_length_1166_cov_313.815370	497	577	61	20	80	0.2500000
NODE_4206_length_1166_cov_313.815370	497	577	62	12	80	0.1500000
NODE_4206_length_1166_cov_313.815370	497	577	63	4	80	0.0500000
NODE_4206_length_1166_cov_313.815370	497	568	48	1	71	0.0140845
NODE_4206_length_1166_cov_313.815370	497	568	50	12	71	0.1690141
NODE_4206_length_1166_cov_313.815370	497	568	51	8	71	0.1126761
NODE_4206_length_1166_cov_313.815370	497	568	52	4	71	0.0563380
NODE_4206_length_1166_cov_313.815370	497	568	54	1	71	0.0140845
NODE_4206_length_1166_cov_313.815370	497	568	55	1	71	0.0140845
NODE_4206_length_1166_cov_313.815370	497	568	56	1	71	0.0140845
NODE_4206_length_1166_cov_313.815370	497	568	58	1	71	0.0140845
NODE_4206_length_1166_cov_313.815370	497	568	59	10	71	0.1408451
NODE_4206_length_1166_cov_313.815370	497	568	60	5	71	0.0704225
NODE_4206_length_1166_cov_313.815370	497	568	61	11	71	0.1549296
NODE_4206_length_1166_cov_313.815370	497	568	62	12	71	0.1690141
NODE_4206_length_1166_cov_313.815370	497	568	63	4	71	0.0563380
NODE_4206_length_1166_cov_313.815370	500	570	48	1	70	0.0142857
NODE_4206_length_1166_cov_313.815370	500	570	50	12	70	0.1714286
NODE_4206_length_1166_cov_313.815370	500	570	51	5	70	0.0714286
NODE_4206_length_1166_cov_313.815370	500	570	52	4	70	0.0571429
NODE_4206_length_1166_cov_313.815370	500	570	54	1	70	0.0142857
NODE_4206_length_1166_cov_313.815370	500	570	55	1	70	0.0142857
NODE_4206_length_1166_cov_313.815370	500	570	56	1	70	0.0142857
NODE_4206_length_1166_cov_313.815370	500	570	58	1	70	0.0142857
NODE_4206_length_1166_cov_313.815370	500	570	59	10	70	0.1428571
NODE_4206_length_1166_cov_313.815370	500	570	60	5	70	0.0714286
NODE_4206_length_1166_cov_313.815370	500	570	61	13	70	0.1857143
NODE_4206_length_1166_cov_313.815370	500	570	62	12	70	0.1714286
NODE_4206_length_1166_cov_313.815370	500	570	63	4	70	0.0571429
NODE_4206_length_1166_cov_313.815370	997	1077	4	80	80	1.0000000
NODE_4206_length_1166_cov_313.815370	1050	1130	2	47	80	0.5875000
NODE_4206_length_1166_cov_313.815370	1050	1130	4	33	80	0.4125000
NODE_4206_length_1166_cov_313.815370	1050	1130	2	47	80	0.5875000
NODE_4206_length_1166_cov_313.815370	1050	1130	4	33	80	0.4125000
NODE_4206_length_1166_cov_313.815370	1050	1121	2	38	71	0.5352113
NODE_4206_length_1166_cov_313.815370	1050	1121	4	33	71	0.4647887
NODE_4207_length_1166_cov_25.107779	561	641	2	15	80	0.1875000
NODE_4207_length_1166_cov_25.107779	561	641	4	5	80	0.0625000
NODE_4207_length_1166_cov_25.107779	561	641	5	27	80	0.3375000
NODE_4207_length_1166_cov_25.107779	561	641	6	20	80	0.2500000
NODE_4207_length_1166_cov_25.107779	561	641	7	13	80	0.1625000
NODE_4207_length_1166_cov_25.107779	614	694	5	11	80	0.1375000
NODE_4207_length_1166_cov_25.107779	614	694	6	42	80	0.5250000
NODE_4207_length_1166_cov_25.107779	614	694	7	27	80	0.3375000
NODE_4209_length_1166_cov_18.820056	325	405	10	4	80	0.0500000
NODE_4209_length_1166_cov_18.820056	325	405	11	23	80	0.2875000
NODE_4209_length_1166_cov_18.820056	325	405	12	7	80	0.0875000
NODE_4209_length_1166_cov_18.820056	325	405	13	22	80	0.2750000
NODE_4209_length_1166_cov_18.820056	325	405	14	7	80	0.0875000
NODE_4209_length_1166_cov_18.820056	325	405	15	16	80	0.2000000
NODE_4209_length_1166_cov_18.820056	325	405	16	1	80	0.0125000
NODE_4209_length_1166_cov_18.820056	378	458	10	1	80	0.0125000
NODE_4209_length_1166_cov_18.820056	378	458	11	17	80	0.2125000
NODE_4209_length_1166_cov_18.820056	378	458	13	14	80	0.1750000
NODE_4209_length_1166_cov_18.820056	378	458	14	26	80	0.3250000
NODE_4209_length_1166_cov_18.820056	378	458	15	20	80	0.2500000
NODE_4209_length_1166_cov_18.820056	378	458	16	2	80	0.0250000
NODE_4210_length_1166_cov_18.404873	676	756	5	6	80	0.0750000
NODE_4210_length_1166_cov_18.404873	676	756	6	12	80	0.1500000
NODE_4210_length_1166_cov_18.404873	676	756	7	30	80	0.3750000
NODE_4210_length_1166_cov_18.404873	676	756	8	7	80	0.0875000
NODE_4210_length_1166_cov_18.404873	676	756	9	25	80	0.3125000
NODE_4210_length_1166_cov_18.404873	729	809	7	7	80	0.0875000
NODE_4210_length_1166_cov_18.404873	729	809	8	9	80	0.1125000
NODE_4210_length_1166_cov_18.404873	729	809	9	64	80	0.8000000
NODE_4214_length_1166_cov_1.893158	0	71	0	71	71	1.0000000
NODE_4214_length_1166_cov_1.893158	44	99	0	55	55	1.0000000
NODE_4218_length_1165_cov_29.402439	497	577	2	23	80	0.2875000
NODE_4218_length_1165_cov_29.402439	497	577	4	10	80	0.1250000
NODE_4218_length_1165_cov_29.402439	497	577	5	34	80	0.4250000
NODE_4218_length_1165_cov_29.402439	497	577	6	13	80	0.1625000
NODE_4218_length_1165_cov_29.402439	550	630	4	6	80	0.0750000
NODE_4218_length_1165_cov_29.402439	550	630	5	25	80	0.3125000
NODE_4218_length_1165_cov_29.402439	550	630	6	49	80	0.6125000
NODE_4218_length_1165_cov_29.402439	626	706	4	57	80	0.7125000
NODE_4218_length_1165_cov_29.402439	626	706	5	17	80	0.2125000
NODE_4218_length_1165_cov_29.402439	626	706	7	6	80	0.0750000
NODE_4218_length_1165_cov_29.402439	679	759	3	45	80	0.5625000
NODE_4218_length_1165_cov_29.402439	679	759	4	34	80	0.4250000
NODE_4218_length_1165_cov_29.402439	679	759	5	1	80	0.0125000
NODE_4219_length_1165_cov_28.366792	663	743	10	8	80	0.1000000
NODE_4219_length_1165_cov_28.366792	663	743	12	7	80	0.0875000
NODE_4219_length_1165_cov_28.366792	663	743	13	5	80	0.0625000
NODE_4219_length_1165_cov_28.366792	663	743	14	5	80	0.0625000
NODE_4219_length_1165_cov_28.366792	663	743	15	45	80	0.5625000
NODE_4219_length_1165_cov_28.366792	663	743	16	10	80	0.1250000
NODE_4219_length_1165_cov_28.366792	716	796	7	9	80	0.1125000
NODE_4219_length_1165_cov_28.366792	716	796	9	7	80	0.0875000
NODE_4219_length_1165_cov_28.366792	716	796	11	2	80	0.0250000
NODE_4219_length_1165_cov_28.366792	716	796	12	14	80	0.1750000
NODE_4219_length_1165_cov_28.366792	716	796	13	22	80	0.2750000
NODE_4219_length_1165_cov_28.366792	716	796	14	5	80	0.0625000
NODE_4219_length_1165_cov_28.366792	716	796	15	11	80	0.1375000
NODE_4219_length_1165_cov_28.366792	716	796	16	10	80	0.1250000
NODE_4220_length_1165_cov_23.841463	631	711	0	24	80	0.3000000
NODE_4220_length_1165_cov_23.841463	631	711	1	56	80	0.7000000
NODE_4220_length_1165_cov_23.841463	684	765	1	49	81	0.6049383
NODE_4220_length_1165_cov_23.841463	684	765	2	9	81	0.1111111
NODE_4220_length_1165_cov_23.841463	684	765	3	5	81	0.0617284
NODE_4220_length_1165_cov_23.841463	684	765	4	8	81	0.0987654
NODE_4220_length_1165_cov_23.841463	684	765	5	6	81	0.0740741
NODE_4220_length_1165_cov_23.841463	684	765	7	1	81	0.0123457
NODE_4220_length_1165_cov_23.841463	684	765	8	3	81	0.0370370
NODE_4220_length_1165_cov_23.841463	761	841	7	1	80	0.0125000
NODE_4220_length_1165_cov_23.841463	761	841	8	17	80	0.2125000
NODE_4220_length_1165_cov_23.841463	761	841	9	53	80	0.6625000
NODE_4220_length_1165_cov_23.841463	761	841	10	9	80	0.1125000
NODE_4220_length_1165_cov_23.841463	814	894	8	2	80	0.0250000
NODE_4220_length_1165_cov_23.841463	814	894	9	16	80	0.2000000
NODE_4220_length_1165_cov_23.841463	814	894	10	11	80	0.1375000
NODE_4220_length_1165_cov_23.841463	814	894	11	15	80	0.1875000
NODE_4220_length_1165_cov_23.841463	814	894	12	12	80	0.1500000
NODE_4220_length_1165_cov_23.841463	814	894	13	24	80	0.3000000
NODE_4221_length_1165_cov_21.883677	482	562	10	51	80	0.6375000
NODE_4221_length_1165_cov_21.883677	482	562	11	17	80	0.2125000
NODE_4221_length_1165_cov_21.883677	482	562	12	12	80	0.1500000
NODE_4221_length_1165_cov_21.883677	535	615	9	11	80	0.1375000
NODE_4221_length_1165_cov_21.883677	535	615	10	17	80	0.2125000
NODE_4221_length_1165_cov_21.883677	535	615	11	29	80	0.3625000
NODE_4221_length_1165_cov_21.883677	535	615	12	23	80	0.2875000
NODE_4222_length_1165_cov_14.591932	295	375	4	24	80	0.3000000
NODE_4222_length_1165_cov_14.591932	295	375	5	4	80	0.0500000
NODE_4222_length_1165_cov_14.591932	295	375	6	23	80	0.2875000
NODE_4222_length_1165_cov_14.591932	295	375	7	18	80	0.2250000
NODE_4222_length_1165_cov_14.591932	295	375	8	11	80	0.1375000
NODE_4222_length_1165_cov_14.591932	348	428	4	36	80	0.4500000
NODE_4222_length_1165_cov_14.591932	348	428	5	44	80	0.5500000
NODE_4223_length_1165_cov_13.683865	502	582	6	25	80	0.3125000
NODE_4223_length_1165_cov_13.683865	502	582	8	55	80	0.6875000
NODE_4223_length_1165_cov_13.683865	555	635	4	40	80	0.5000000
NODE_4223_length_1165_cov_13.683865	555	635	5	12	80	0.1500000
NODE_4223_length_1165_cov_13.683865	555	635	6	21	80	0.2625000
NODE_4223_length_1165_cov_13.683865	555	635	8	7	80	0.0875000
NODE_4224_length_1165_cov_7.915572	383	463	5	45	80	0.5625000
NODE_4224_length_1165_cov_7.915572	383	463	6	35	80	0.4375000
NODE_4224_length_1165_cov_7.915572	436	516	2	11	80	0.1375000
NODE_4224_length_1165_cov_7.915572	436	516	3	7	80	0.0875000
NODE_4224_length_1165_cov_7.915572	436	516	4	24	80	0.3000000
NODE_4224_length_1165_cov_7.915572	436	516	6	38	80	0.4750000
NODE_4225_length_1165_cov_7.466229	552	632	1	80	80	1.0000000
NODE_4225_length_1165_cov_7.466229	605	685	1	80	80	1.0000000
NODE_4226_length_1165_cov_5.617261	676	756	2	80	80	1.0000000
NODE_4226_length_1165_cov_5.617261	729	809	0	22	80	0.2750000
NODE_4226_length_1165_cov_5.617261	729	809	1	14	80	0.1750000
NODE_4226_length_1165_cov_5.617261	729	809	2	44	80	0.5500000
NODE_4227_length_1165_cov_3.658537	554	602	0	48	48	1.0000000
NODE_4233_length_1164_cov_55.273239	459	539	7	36	80	0.4500000
NODE_4233_length_1164_cov_55.273239	459	539	9	1	80	0.0125000
NODE_4233_length_1164_cov_55.273239	459	539	11	13	80	0.1625000
NODE_4233_length_1164_cov_55.273239	459	539	12	11	80	0.1375000
NODE_4233_length_1164_cov_55.273239	459	539	13	19	80	0.2375000
NODE_4233_length_1164_cov_55.273239	512	592	10	9	80	0.1125000
NODE_4233_length_1164_cov_55.273239	512	592	11	21	80	0.2625000
NODE_4233_length_1164_cov_55.273239	512	592	12	23	80	0.2875000
NODE_4233_length_1164_cov_55.273239	512	592	13	27	80	0.3375000
NODE_4234_length_1164_cov_44.183099	571	651	8	11	80	0.1375000
NODE_4234_length_1164_cov_44.183099	571	651	10	1	80	0.0125000
NODE_4234_length_1164_cov_44.183099	571	651	11	28	80	0.3500000
NODE_4234_length_1164_cov_44.183099	571	651	13	40	80	0.5000000
NODE_4234_length_1164_cov_44.183099	624	704	10	1	80	0.0125000
NODE_4234_length_1164_cov_44.183099	624	704	11	39	80	0.4875000
NODE_4234_length_1164_cov_44.183099	624	704	12	6	80	0.0750000
NODE_4234_length_1164_cov_44.183099	624	704	13	34	80	0.4250000
NODE_4234_length_1164_cov_44.183099	700	780	4	14	80	0.1750000
NODE_4234_length_1164_cov_44.183099	700	780	5	1	80	0.0125000
NODE_4234_length_1164_cov_44.183099	700	780	7	46	80	0.5750000
NODE_4234_length_1164_cov_44.183099	700	780	8	4	80	0.0500000
NODE_4234_length_1164_cov_44.183099	700	780	9	8	80	0.1000000
NODE_4234_length_1164_cov_44.183099	700	780	11	7	80	0.0875000
NODE_4234_length_1164_cov_44.183099	753	833	5	8	80	0.1000000
NODE_4234_length_1164_cov_44.183099	753	833	6	22	80	0.2750000
NODE_4234_length_1164_cov_44.183099	753	833	7	37	80	0.4625000
NODE_4234_length_1164_cov_44.183099	753	833	8	13	80	0.1625000
NODE_4235_length_1164_cov_14.277934	1029	1109	2	1	80	0.0125000
NODE_4235_length_1164_cov_14.277934	1029	1109	3	79	80	0.9875000
NODE_4235_length_1164_cov_14.277934	1097	1162	0	14	65	0.2153846
NODE_4235_length_1164_cov_14.277934	1097	1162	1	1	65	0.0153846
NODE_4235_length_1164_cov_14.277934	1097	1162	2	39	65	0.6000000
NODE_4235_length_1164_cov_14.277934	1097	1162	3	11	65	0.1692308
NODE_4236_length_1164_cov_12.880751	415	495	6	4	80	0.0500000
NODE_4236_length_1164_cov_12.880751	415	495	7	9	80	0.1125000
NODE_4236_length_1164_cov_12.880751	415	495	9	19	80	0.2375000
NODE_4236_length_1164_cov_12.880751	415	495	10	42	80	0.5250000
NODE_4236_length_1164_cov_12.880751	415	495	11	1	80	0.0125000
NODE_4236_length_1164_cov_12.880751	415	495	12	5	80	0.0625000
NODE_4236_length_1164_cov_12.880751	468	548	5	13	80	0.1625000
NODE_4236_length_1164_cov_12.880751	468	548	6	3	80	0.0375000
NODE_4236_length_1164_cov_12.880751	468	548	7	21	80	0.2625000
NODE_4236_length_1164_cov_12.880751	468	548	8	5	80	0.0625000
NODE_4236_length_1164_cov_12.880751	468	548	9	4	80	0.0500000
NODE_4236_length_1164_cov_12.880751	468	548	10	28	80	0.3500000
NODE_4236_length_1164_cov_12.880751	468	548	11	1	80	0.0125000
NODE_4236_length_1164_cov_12.880751	468	548	12	5	80	0.0625000
NODE_4237_length_1164_cov_6.924883	415	495	0	80	80	1.0000000
NODE_4237_length_1164_cov_6.924883	468	548	0	80	80	1.0000000
NODE_4245_length_1163_cov_36.315789	458	538	0	16	80	0.2000000
NODE_4245_length_1163_cov_36.315789	458	538	1	15	80	0.1875000
NODE_4245_length_1163_cov_36.315789	458	538	2	12	80	0.1500000
NODE_4245_length_1163_cov_36.315789	458	538	3	32	80	0.4000000
NODE_4245_length_1163_cov_36.315789	458	538	4	5	80	0.0625000
NODE_4245_length_1163_cov_36.315789	511	591	3	22	80	0.2750000
NODE_4245_length_1163_cov_36.315789	511	591	4	9	80	0.1125000
NODE_4245_length_1163_cov_36.315789	511	591	5	14	80	0.1750000
NODE_4245_length_1163_cov_36.315789	511	591	7	5	80	0.0625000
NODE_4245_length_1163_cov_36.315789	511	591	8	1	80	0.0125000
NODE_4245_length_1163_cov_36.315789	511	591	9	6	80	0.0750000
NODE_4245_length_1163_cov_36.315789	511	591	10	17	80	0.2125000
NODE_4245_length_1163_cov_36.315789	511	591	11	6	80	0.0750000
NODE_4245_length_1163_cov_36.315789	587	667	11	26	80	0.3250000
NODE_4245_length_1163_cov_36.315789	587	667	12	20	80	0.2500000
NODE_4245_length_1163_cov_36.315789	587	667	13	13	80	0.1625000
NODE_4245_length_1163_cov_36.315789	587	667	14	21	80	0.2625000
NODE_4245_length_1163_cov_36.315789	640	720	6	2	80	0.0250000
NODE_4245_length_1163_cov_36.315789	640	720	7	6	80	0.0750000
NODE_4245_length_1163_cov_36.315789	640	720	8	1	80	0.0125000
NODE_4245_length_1163_cov_36.315789	640	720	9	5	80	0.0625000
NODE_4245_length_1163_cov_36.315789	640	720	10	4	80	0.0500000
NODE_4245_length_1163_cov_36.315789	640	720	11	19	80	0.2375000
NODE_4245_length_1163_cov_36.315789	640	720	12	34	80	0.4250000
NODE_4245_length_1163_cov_36.315789	640	720	13	9	80	0.1125000
NODE_4246_length_1163_cov_29.466165	542	622	3	9	80	0.1125000
NODE_4246_length_1163_cov_29.466165	542	622	4	3	80	0.0375000
NODE_4246_length_1163_cov_29.466165	542	622	6	66	80	0.8250000
NODE_4246_length_1163_cov_29.466165	542	622	8	2	80	0.0250000
NODE_4246_length_1163_cov_29.466165	595	675	1	20	80	0.2500000
NODE_4246_length_1163_cov_29.466165	595	675	2	30	80	0.3750000
NODE_4246_length_1163_cov_29.466165	595	675	3	12	80	0.1500000
NODE_4246_length_1163_cov_29.466165	595	675	4	3	80	0.0375000
NODE_4246_length_1163_cov_29.466165	595	675	6	15	80	0.1875000
NODE_4246_length_1163_cov_29.466165	671	751	1	80	80	1.0000000
NODE_4246_length_1163_cov_29.466165	724	804	1	79	80	0.9875000
NODE_4246_length_1163_cov_29.466165	724	804	2	1	80	0.0125000
NODE_4247_length_1163_cov_15.107143	668	748	0	31	80	0.3875000
NODE_4247_length_1163_cov_15.107143	668	748	1	37	80	0.4625000
NODE_4247_length_1163_cov_15.107143	668	748	2	12	80	0.1500000
NODE_4247_length_1163_cov_15.107143	721	801	1	15	80	0.1875000
NODE_4247_length_1163_cov_15.107143	721	801	2	65	80	0.8125000
NODE_4248_length_1163_cov_14.347744	540	620	2	12	80	0.1500000
NODE_4248_length_1163_cov_14.347744	540	620	3	68	80	0.8500000
NODE_4248_length_1163_cov_14.347744	593	673	2	40	80	0.5000000
NODE_4248_length_1163_cov_14.347744	593	673	3	40	80	0.5000000
NODE_4249_length_1163_cov_11.650376	354	434	3	17	80	0.2125000
NODE_4249_length_1163_cov_11.650376	354	434	4	49	80	0.6125000
NODE_4249_length_1163_cov_11.650376	354	434	5	14	80	0.1750000
NODE_4249_length_1163_cov_11.650376	407	487	1	1	80	0.0125000
NODE_4249_length_1163_cov_11.650376	407	487	3	69	80	0.8625000
NODE_4249_length_1163_cov_11.650376	407	487	4	10	80	0.1250000
NODE_4249_length_1163_cov_11.650376	738	818	4	26	80	0.3250000
NODE_4249_length_1163_cov_11.650376	738	818	6	2	80	0.0250000
NODE_4249_length_1163_cov_11.650376	738	818	7	20	80	0.2500000
NODE_4249_length_1163_cov_11.650376	738	818	8	32	80	0.4000000
NODE_4249_length_1163_cov_11.650376	791	871	4	5	80	0.0625000
NODE_4249_length_1163_cov_11.650376	791	871	5	6	80	0.0750000
NODE_4249_length_1163_cov_11.650376	791	871	6	4	80	0.0500000
NODE_4249_length_1163_cov_11.650376	791	871	7	55	80	0.6875000
NODE_4249_length_1163_cov_11.650376	791	871	8	10	80	0.1250000
NODE_4253_length_1162_cov_30.049859	359	439	3	13	80	0.1625000
NODE_4253_length_1162_cov_30.049859	359	439	4	64	80	0.8000000
NODE_4253_length_1162_cov_30.049859	359	439	6	3	80	0.0375000
NODE_4253_length_1162_cov_30.049859	412	492	3	6	80	0.0750000
NODE_4253_length_1162_cov_30.049859	412	492	4	23	80	0.2875000
NODE_4253_length_1162_cov_30.049859	412	492	5	12	80	0.1500000
NODE_4253_length_1162_cov_30.049859	412	492	6	39	80	0.4875000
NODE_4254_length_1162_cov_25.960489	440	520	0	5	80	0.0625000
NODE_4254_length_1162_cov_25.960489	440	520	3	46	80	0.5750000
NODE_4254_length_1162_cov_25.960489	440	520	4	29	80	0.3625000
NODE_4254_length_1162_cov_25.960489	493	573	2	3	80	0.0375000
NODE_4254_length_1162_cov_25.960489	493	573	3	16	80	0.2000000
NODE_4254_length_1162_cov_25.960489	493	573	4	29	80	0.3625000
NODE_4254_length_1162_cov_25.960489	493	573	5	5	80	0.0625000
NODE_4254_length_1162_cov_25.960489	493	573	7	9	80	0.1125000
NODE_4254_length_1162_cov_25.960489	493	573	8	18	80	0.2250000
NODE_4254_length_1162_cov_25.960489	569	649	7	8	80	0.1000000
NODE_4254_length_1162_cov_25.960489	569	649	8	15	80	0.1875000
NODE_4254_length_1162_cov_25.960489	569	649	9	46	80	0.5750000
NODE_4254_length_1162_cov_25.960489	569	649	10	8	80	0.1000000
NODE_4254_length_1162_cov_25.960489	569	649	11	3	80	0.0375000
NODE_4254_length_1162_cov_25.960489	622	702	5	10	80	0.1250000
NODE_4254_length_1162_cov_25.960489	622	702	6	19	80	0.2375000
NODE_4254_length_1162_cov_25.960489	622	702	8	10	80	0.1250000
NODE_4254_length_1162_cov_25.960489	622	702	9	16	80	0.2000000
NODE_4254_length_1162_cov_25.960489	622	702	10	22	80	0.2750000
NODE_4254_length_1162_cov_25.960489	622	702	11	3	80	0.0375000
NODE_4255_length_1162_cov_24.843838	523	603	7	4	80	0.0500000
NODE_4255_length_1162_cov_24.843838	523	603	11	44	80	0.5500000
NODE_4255_length_1162_cov_24.843838	523	603	12	3	80	0.0375000
NODE_4255_length_1162_cov_24.843838	523	603	14	26	80	0.3250000
NODE_4255_length_1162_cov_24.843838	523	603	15	3	80	0.0375000
NODE_4255_length_1162_cov_24.843838	576	656	5	6	80	0.0750000
NODE_4255_length_1162_cov_24.843838	576	656	7	1	80	0.0125000
NODE_4255_length_1162_cov_24.843838	576	656	8	10	80	0.1250000
NODE_4255_length_1162_cov_24.843838	576	656	10	19	80	0.2375000
NODE_4255_length_1162_cov_24.843838	576	656	12	20	80	0.2500000
NODE_4255_length_1162_cov_24.843838	576	656	14	21	80	0.2625000
NODE_4255_length_1162_cov_24.843838	576	656	15	3	80	0.0375000
NODE_4255_length_1162_cov_24.843838	652	732	4	7	80	0.0875000
NODE_4255_length_1162_cov_24.843838	652	732	5	13	80	0.1625000
NODE_4255_length_1162_cov_24.843838	652	732	6	32	80	0.4000000
NODE_4255_length_1162_cov_24.843838	652	732	7	11	80	0.1375000
NODE_4255_length_1162_cov_24.843838	652	732	8	9	80	0.1125000
NODE_4255_length_1162_cov_24.843838	652	732	9	8	80	0.1000000
NODE_4255_length_1162_cov_24.843838	705	785	5	37	80	0.4625000
NODE_4255_length_1162_cov_24.843838	705	785	7	27	80	0.3375000
NODE_4255_length_1162_cov_24.843838	705	785	8	8	80	0.1000000
NODE_4255_length_1162_cov_24.843838	705	785	9	8	80	0.1000000
NODE_4257_length_1162_cov_17.131703	302	382	2	16	80	0.2000000
NODE_4257_length_1162_cov_17.131703	302	382	3	64	80	0.8000000
NODE_4257_length_1162_cov_17.131703	355	435	1	25	80	0.3125000
NODE_4257_length_1162_cov_17.131703	355	435	2	22	80	0.2750000
NODE_4257_length_1162_cov_17.131703	355	435	3	33	80	0.4125000
NODE_4257_length_1162_cov_17.131703	431	511	1	80	80	1.0000000
NODE_4257_length_1162_cov_17.131703	484	564	0	49	80	0.6125000
NODE_4257_length_1162_cov_17.131703	484	564	1	31	80	0.3875000
NODE_4258_length_1162_cov_14.766698	630	710	6	24	80	0.3000000
NODE_4258_length_1162_cov_14.766698	630	710	7	21	80	0.2625000
NODE_4258_length_1162_cov_14.766698	630	710	8	19	80	0.2375000
NODE_4258_length_1162_cov_14.766698	630	710	9	16	80	0.2000000
NODE_4258_length_1162_cov_14.766698	683	763	5	15	80	0.1875000
NODE_4258_length_1162_cov_14.766698	683	763	6	8	80	0.1000000
NODE_4258_length_1162_cov_14.766698	683	763	7	11	80	0.1375000
NODE_4258_length_1162_cov_14.766698	683	763	8	11	80	0.1375000
NODE_4258_length_1162_cov_14.766698	683	763	9	35	80	0.4375000
NODE_4259_length_1162_cov_13.968015	423	503	12	27	80	0.3375000
NODE_4259_length_1162_cov_13.968015	423	503	13	34	80	0.4250000
NODE_4259_length_1162_cov_13.968015	423	503	15	19	80	0.2375000
NODE_4259_length_1162_cov_13.968015	476	556	1	3	80	0.0375000
NODE_4259_length_1162_cov_13.968015	476	556	2	1	80	0.0125000
NODE_4259_length_1162_cov_13.968015	476	556	5	10	80	0.1250000
NODE_4259_length_1162_cov_13.968015	476	556	7	2	80	0.0250000
NODE_4259_length_1162_cov_13.968015	476	556	9	2	80	0.0250000
NODE_4259_length_1162_cov_13.968015	476	556	10	2	80	0.0250000
NODE_4259_length_1162_cov_13.968015	476	556	11	30	80	0.3750000
NODE_4259_length_1162_cov_13.968015	476	556	12	11	80	0.1375000
NODE_4259_length_1162_cov_13.968015	476	556	13	19	80	0.2375000
NODE_4264_length_1162_cov_1.977422	855	926	1	57	71	0.8028169
NODE_4264_length_1162_cov_1.977422	855	926	2	14	71	0.1971831
NODE_4264_length_1162_cov_1.977422	908	977	1	69	69	1.0000000
NODE_4264_length_1162_cov_1.977422	908	977	1	69	69	1.0000000
NODE_4266_length_1161_cov_33.312618	456	536	7	7	80	0.0875000
NODE_4266_length_1161_cov_33.312618	456	536	8	11	80	0.1375000
NODE_4266_length_1161_cov_33.312618	456	536	9	4	80	0.0500000
NODE_4266_length_1161_cov_33.312618	456	536	10	25	80	0.3125000
NODE_4266_length_1161_cov_33.312618	456	536	11	6	80	0.0750000
NODE_4266_length_1161_cov_33.312618	456	536	13	4	80	0.0500000
NODE_4266_length_1161_cov_33.312618	456	536	15	11	80	0.1375000
NODE_4266_length_1161_cov_33.312618	456	536	17	12	80	0.1500000
NODE_4266_length_1161_cov_33.312618	509	587	9	10	78	0.1282051
NODE_4266_length_1161_cov_33.312618	509	587	10	5	78	0.0641026
NODE_4266_length_1161_cov_33.312618	509	587	11	6	78	0.0769231
NODE_4266_length_1161_cov_33.312618	509	587	12	1	78	0.0128205
NODE_4266_length_1161_cov_33.312618	509	587	13	11	78	0.1410256
NODE_4266_length_1161_cov_33.312618	509	587	14	17	78	0.2179487
NODE_4266_length_1161_cov_33.312618	509	587	15	16	78	0.2051282
NODE_4266_length_1161_cov_33.312618	509	587	17	12	78	0.1538462
NODE_4267_length_1161_cov_30.466102	594	674	2	2	80	0.0250000
NODE_4267_length_1161_cov_30.466102	594	674	3	4	80	0.0500000
NODE_4267_length_1161_cov_30.466102	594	674	4	4	80	0.0500000
NODE_4267_length_1161_cov_30.466102	594	674	5	38	80	0.4750000
NODE_4267_length_1161_cov_30.466102	594	674	6	32	80	0.4000000
NODE_4267_length_1161_cov_30.466102	647	727	5	16	80	0.2000000
NODE_4267_length_1161_cov_30.466102	647	727	6	64	80	0.8000000
NODE_4268_length_1161_cov_29.628060	426	506	4	32	80	0.4000000
NODE_4268_length_1161_cov_29.628060	426	506	5	42	80	0.5250000
NODE_4268_length_1161_cov_29.628060	426	506	6	6	80	0.0750000
NODE_4268_length_1161_cov_29.628060	479	559	3	4	80	0.0500000
NODE_4268_length_1161_cov_29.628060	479	559	4	36	80	0.4500000
NODE_4268_length_1161_cov_29.628060	479	559	5	18	80	0.2250000
NODE_4268_length_1161_cov_29.628060	479	559	6	22	80	0.2750000
NODE_4268_length_1161_cov_29.628060	603	683	6	24	80	0.3000000
NODE_4268_length_1161_cov_29.628060	603	683	7	1	80	0.0125000
NODE_4268_length_1161_cov_29.628060	603	683	9	16	80	0.2000000
NODE_4268_length_1161_cov_29.628060	603	683	10	38	80	0.4750000
NODE_4268_length_1161_cov_29.628060	603	683	11	1	80	0.0125000
NODE_4268_length_1161_cov_29.628060	656	736	6	27	80	0.3375000
NODE_4268_length_1161_cov_29.628060	656	736	7	1	80	0.0125000
NODE_4268_length_1161_cov_29.628060	656	736	8	22	80	0.2750000
NODE_4268_length_1161_cov_29.628060	656	736	9	9	80	0.1125000
NODE_4268_length_1161_cov_29.628060	656	736	10	21	80	0.2625000
NODE_4269_length_1161_cov_22.923729	492	572	6	3	80	0.0375000
NODE_4269_length_1161_cov_22.923729	492	572	7	63	80	0.7875000
NODE_4269_length_1161_cov_22.923729	492	572	8	14	80	0.1750000
NODE_4269_length_1161_cov_22.923729	545	625	3	30	80	0.3750000
NODE_4269_length_1161_cov_22.923729	545	625	4	6	80	0.0750000
NODE_4269_length_1161_cov_22.923729	545	625	5	9	80	0.1125000
NODE_4269_length_1161_cov_22.923729	545	625	6	5	80	0.0625000
NODE_4269_length_1161_cov_22.923729	545	625	7	30	80	0.3750000
NODE_4269_length_1161_cov_22.923729	621	701	4	21	80	0.2625000
NODE_4269_length_1161_cov_22.923729	621	701	5	36	80	0.4500000
NODE_4269_length_1161_cov_22.923729	621	701	6	16	80	0.2000000
NODE_4269_length_1161_cov_22.923729	621	701	7	7	80	0.0875000
NODE_4269_length_1161_cov_22.923729	674	754	5	5	80	0.0625000
NODE_4269_length_1161_cov_22.923729	674	754	6	15	80	0.1875000
NODE_4269_length_1161_cov_22.923729	674	754	7	55	80	0.6875000
NODE_4269_length_1161_cov_22.923729	674	754	8	5	80	0.0625000
NODE_4270_length_1161_cov_20.184557	480	560	1	9	80	0.1125000
NODE_4270_length_1161_cov_20.184557	480	560	2	63	80	0.7875000
NODE_4270_length_1161_cov_20.184557	480	560	4	8	80	0.1000000
NODE_4270_length_1161_cov_20.184557	533	613	2	19	80	0.2375000
NODE_4270_length_1161_cov_20.184557	533	613	4	21	80	0.2625000
NODE_4270_length_1161_cov_20.184557	533	613	5	12	80	0.1500000
NODE_4270_length_1161_cov_20.184557	533	613	6	28	80	0.3500000
NODE_4271_length_1161_cov_17.437853	375	455	2	15	80	0.1875000
NODE_4271_length_1161_cov_17.437853	375	455	3	14	80	0.1750000
NODE_4271_length_1161_cov_17.437853	375	455	4	20	80	0.2500000
NODE_4271_length_1161_cov_17.437853	375	455	6	19	80	0.2375000
NODE_4271_length_1161_cov_17.437853	375	455	7	10	80	0.1250000
NODE_4271_length_1161_cov_17.437853	375	455	9	2	80	0.0250000
NODE_4271_length_1161_cov_17.437853	428	508	6	15	80	0.1875000
NODE_4271_length_1161_cov_17.437853	428	508	7	23	80	0.2875000
NODE_4271_length_1161_cov_17.437853	428	508	8	28	80	0.3500000
NODE_4271_length_1161_cov_17.437853	428	508	9	14	80	0.1750000
NODE_4272_length_1161_cov_14.062147	375	455	9	24	80	0.3000000
NODE_4272_length_1161_cov_14.062147	375	455	10	22	80	0.2750000
NODE_4272_length_1161_cov_14.062147	375	455	12	9	80	0.1125000
NODE_4272_length_1161_cov_14.062147	375	455	14	25	80	0.3125000
NODE_4272_length_1161_cov_14.062147	428	508	8	16	80	0.2000000
NODE_4272_length_1161_cov_14.062147	428	508	9	6	80	0.0750000
NODE_4272_length_1161_cov_14.062147	428	508	10	32	80	0.4000000
NODE_4272_length_1161_cov_14.062147	428	508	12	7	80	0.0875000
NODE_4272_length_1161_cov_14.062147	428	508	14	19	80	0.2375000
NODE_4273_length_1161_cov_12.304143	381	461	0	80	80	1.0000000
NODE_4273_length_1161_cov_12.304143	434	514	0	80	80	1.0000000
NODE_4274_length_1161_cov_10.297552	598	678	1	16	80	0.2000000
NODE_4274_length_1161_cov_10.297552	598	678	2	18	80	0.2250000
NODE_4274_length_1161_cov_10.297552	598	678	3	46	80	0.5750000
NODE_4274_length_1161_cov_10.297552	651	731	0	5	80	0.0625000
NODE_4274_length_1161_cov_10.297552	651	731	1	3	80	0.0375000
NODE_4274_length_1161_cov_10.297552	651	731	3	72	80	0.9000000
NODE_4283_length_1160_cov_86.515551	613	693	6	4	80	0.0500000
NODE_4283_length_1160_cov_86.515551	613	693	7	15	80	0.1875000
NODE_4283_length_1160_cov_86.515551	613	693	8	33	80	0.4125000
NODE_4283_length_1160_cov_86.515551	613	693	9	20	80	0.2500000
NODE_4283_length_1160_cov_86.515551	613	693	10	8	80	0.1000000
NODE_4283_length_1160_cov_86.515551	666	746	4	1	80	0.0125000
NODE_4283_length_1160_cov_86.515551	666	746	5	18	80	0.2250000
NODE_4283_length_1160_cov_86.515551	666	746	6	23	80	0.2875000
NODE_4283_length_1160_cov_86.515551	666	746	7	15	80	0.1875000
NODE_4283_length_1160_cov_86.515551	666	746	8	21	80	0.2625000
NODE_4283_length_1160_cov_86.515551	666	746	10	2	80	0.0250000
NODE_4284_length_1160_cov_29.272385	526	606	2	3	80	0.0375000
NODE_4284_length_1160_cov_29.272385	526	606	3	2	80	0.0250000
NODE_4284_length_1160_cov_29.272385	526	606	5	41	80	0.5125000
NODE_4284_length_1160_cov_29.272385	526	606	6	1	80	0.0125000
NODE_4284_length_1160_cov_29.272385	526	606	7	33	80	0.4125000
NODE_4284_length_1160_cov_29.272385	579	659	4	4	80	0.0500000
NODE_4284_length_1160_cov_29.272385	579	659	5	51	80	0.6375000
NODE_4284_length_1160_cov_29.272385	579	659	7	25	80	0.3125000
NODE_4285_length_1160_cov_21.391140	767	847	6	3	80	0.0375000
NODE_4285_length_1160_cov_21.391140	767	847	7	77	80	0.9625000
NODE_4296_length_1159_cov_147.794340	911	991	69	1	80	0.0125000
NODE_4296_length_1159_cov_147.794340	911	991	70	8	80	0.1000000
NODE_4296_length_1159_cov_147.794340	911	991	71	11	80	0.1375000
NODE_4296_length_1159_cov_147.794340	911	991	72	7	80	0.0875000
NODE_4296_length_1159_cov_147.794340	911	991	73	7	80	0.0875000
NODE_4296_length_1159_cov_147.794340	911	991	74	4	80	0.0500000
NODE_4296_length_1159_cov_147.794340	911	991	75	4	80	0.0500000
NODE_4296_length_1159_cov_147.794340	911	991	76	8	80	0.1000000
NODE_4296_length_1159_cov_147.794340	911	991	77	9	80	0.1125000
NODE_4296_length_1159_cov_147.794340	911	991	78	8	80	0.1000000
NODE_4296_length_1159_cov_147.794340	911	991	79	6	80	0.0750000
NODE_4296_length_1159_cov_147.794340	911	991	80	7	80	0.0875000
NODE_4296_length_1159_cov_147.794340	964	1044	45	2	80	0.0250000
NODE_4296_length_1159_cov_147.794340	964	1044	46	1	80	0.0125000
NODE_4296_length_1159_cov_147.794340	964	1044	47	3	80	0.0375000
NODE_4296_length_1159_cov_147.794340	964	1044	48	3	80	0.0375000
NODE_4296_length_1159_cov_147.794340	964	1044	51	1	80	0.0125000
NODE_4296_length_1159_cov_147.794340	964	1044	52	1	80	0.0125000
NODE_4296_length_1159_cov_147.794340	964	1044	53	2	80	0.0250000
NODE_4296_length_1159_cov_147.794340	964	1044	55	2	80	0.0250000
NODE_4296_length_1159_cov_147.794340	964	1044	60	10	80	0.1250000
NODE_4296_length_1159_cov_147.794340	964	1044	61	7	80	0.0875000
NODE_4296_length_1159_cov_147.794340	964	1044	62	1	80	0.0125000
NODE_4296_length_1159_cov_147.794340	964	1044	63	2	80	0.0250000
NODE_4296_length_1159_cov_147.794340	964	1044	66	2	80	0.0250000
NODE_4296_length_1159_cov_147.794340	964	1044	67	6	80	0.0750000
NODE_4296_length_1159_cov_147.794340	964	1044	68	2	80	0.0250000
NODE_4296_length_1159_cov_147.794340	964	1044	69	7	80	0.0875000
NODE_4296_length_1159_cov_147.794340	964	1044	70	1	80	0.0125000
NODE_4296_length_1159_cov_147.794340	964	1044	71	4	80	0.0500000
NODE_4296_length_1159_cov_147.794340	964	1044	72	1	80	0.0125000
NODE_4296_length_1159_cov_147.794340	964	1044	74	1	80	0.0125000
NODE_4296_length_1159_cov_147.794340	964	1044	75	1	80	0.0125000
NODE_4296_length_1159_cov_147.794340	964	1044	76	3	80	0.0375000
NODE_4296_length_1159_cov_147.794340	964	1044	77	6	80	0.0750000
NODE_4296_length_1159_cov_147.794340	964	1044	78	6	80	0.0750000
NODE_4296_length_1159_cov_147.794340	964	1044	79	2	80	0.0250000
NODE_4296_length_1159_cov_147.794340	964	1044	80	3	80	0.0375000
NODE_4297_length_1159_cov_57.566981	457	537	7	20	80	0.2500000
NODE_4297_length_1159_cov_57.566981	457	537	8	4	80	0.0500000
NODE_4297_length_1159_cov_57.566981	457	537	9	20	80	0.2500000
NODE_4297_length_1159_cov_57.566981	457	537	10	4	80	0.0500000
NODE_4297_length_1159_cov_57.566981	457	537	12	29	80	0.3625000
NODE_4297_length_1159_cov_57.566981	457	537	13	3	80	0.0375000
NODE_4297_length_1159_cov_57.566981	510	590	9	2	80	0.0250000
NODE_4297_length_1159_cov_57.566981	510	590	10	20	80	0.2500000
NODE_4297_length_1159_cov_57.566981	510	590	11	18	80	0.2250000
NODE_4297_length_1159_cov_57.566981	510	590	12	37	80	0.4625000
NODE_4297_length_1159_cov_57.566981	510	590	13	3	80	0.0375000
NODE_4297_length_1159_cov_57.566981	586	666	9	4	80	0.0500000
NODE_4297_length_1159_cov_57.566981	586	666	10	3	80	0.0375000
NODE_4297_length_1159_cov_57.566981	586	666	11	10	80	0.1250000
NODE_4297_length_1159_cov_57.566981	586	666	12	1	80	0.0125000
NODE_4297_length_1159_cov_57.566981	586	666	13	11	80	0.1375000
NODE_4297_length_1159_cov_57.566981	586	666	14	2	80	0.0250000
NODE_4297_length_1159_cov_57.566981	586	666	15	1	80	0.0125000
NODE_4297_length_1159_cov_57.566981	586	666	16	30	80	0.3750000
NODE_4297_length_1159_cov_57.566981	586	666	17	18	80	0.2250000
NODE_4297_length_1159_cov_57.566981	639	719	12	8	80	0.1000000
NODE_4297_length_1159_cov_57.566981	639	719	13	22	80	0.2750000
NODE_4297_length_1159_cov_57.566981	639	719	14	8	80	0.1000000
NODE_4297_length_1159_cov_57.566981	639	719	15	2	80	0.0250000
NODE_4297_length_1159_cov_57.566981	639	719	16	30	80	0.3750000
NODE_4297_length_1159_cov_57.566981	639	719	17	10	80	0.1250000
NODE_4298_length_1159_cov_44.053774	329	409	0	1	80	0.0125000
NODE_4298_length_1159_cov_44.053774	329	409	1	30	80	0.3750000
NODE_4298_length_1159_cov_44.053774	329	409	3	46	80	0.5750000
NODE_4298_length_1159_cov_44.053774	329	409	4	3	80	0.0375000
NODE_4298_length_1159_cov_44.053774	382	462	3	24	80	0.3000000
NODE_4298_length_1159_cov_44.053774	382	462	4	19	80	0.2375000
NODE_4298_length_1159_cov_44.053774	382	462	5	9	80	0.1125000
NODE_4298_length_1159_cov_44.053774	382	462	6	2	80	0.0250000
NODE_4298_length_1159_cov_44.053774	382	462	7	26	80	0.3250000
NODE_4298_length_1159_cov_44.053774	458	538	6	3	80	0.0375000
NODE_4298_length_1159_cov_44.053774	458	538	7	22	80	0.2750000
NODE_4298_length_1159_cov_44.053774	458	538	8	54	80	0.6750000
NODE_4298_length_1159_cov_44.053774	458	538	10	1	80	0.0125000
NODE_4298_length_1159_cov_44.053774	511	591	2	5	80	0.0625000
NODE_4298_length_1159_cov_44.053774	511	591	3	2	80	0.0250000
NODE_4298_length_1159_cov_44.053774	511	591	4	5	80	0.0625000
NODE_4298_length_1159_cov_44.053774	511	591	6	4	80	0.0500000
NODE_4298_length_1159_cov_44.053774	511	591	7	25	80	0.3125000
NODE_4298_length_1159_cov_44.053774	511	591	8	39	80	0.4875000
NODE_4299_length_1159_cov_40.194340	391	471	5	25	80	0.3125000
NODE_4299_length_1159_cov_40.194340	391	471	6	35	80	0.4375000
NODE_4299_length_1159_cov_40.194340	391	471	7	20	80	0.2500000
NODE_4299_length_1159_cov_40.194340	444	524	4	43	80	0.5375000
NODE_4299_length_1159_cov_40.194340	444	524	5	10	80	0.1250000
NODE_4299_length_1159_cov_40.194340	444	524	6	27	80	0.3375000
NODE_4301_length_1159_cov_25.919811	456	536	3	52	80	0.6500000
NODE_4301_length_1159_cov_25.919811	456	536	5	28	80	0.3500000
NODE_4301_length_1159_cov_25.919811	509	591	2	20	82	0.2439024
NODE_4301_length_1159_cov_25.919811	509	591	3	4	82	0.0487805
NODE_4301_length_1159_cov_25.919811	509	591	5	58	82	0.7073171
NODE_4302_length_1159_cov_18.306604	538	618	3	5	80	0.0625000
NODE_4302_length_1159_cov_18.306604	538	618	4	9	80	0.1125000
NODE_4302_length_1159_cov_18.306604	538	618	7	10	80	0.1250000
NODE_4302_length_1159_cov_18.306604	538	618	8	3	80	0.0375000
NODE_4302_length_1159_cov_18.306604	538	618	9	8	80	0.1000000
NODE_4302_length_1159_cov_18.306604	538	618	10	6	80	0.0750000
NODE_4302_length_1159_cov_18.306604	538	618	11	39	80	0.4875000
NODE_4302_length_1159_cov_18.306604	591	671	7	5	80	0.0625000
NODE_4302_length_1159_cov_18.306604	591	671	8	8	80	0.1000000
NODE_4302_length_1159_cov_18.306604	591	671	9	8	80	0.1000000
NODE_4302_length_1159_cov_18.306604	591	671	10	18	80	0.2250000
NODE_4302_length_1159_cov_18.306604	591	671	11	41	80	0.5125000
NODE_4303_length_1159_cov_14.457547	358	438	3	17	80	0.2125000
NODE_4303_length_1159_cov_14.457547	358	438	4	6	80	0.0750000
NODE_4303_length_1159_cov_14.457547	358	438	5	3	80	0.0375000
NODE_4303_length_1159_cov_14.457547	358	438	6	5	80	0.0625000
NODE_4303_length_1159_cov_14.457547	358	438	7	5	80	0.0625000
NODE_4303_length_1159_cov_14.457547	358	438	8	8	80	0.1000000
NODE_4303_length_1159_cov_14.457547	358	438	9	20	80	0.2500000
NODE_4303_length_1159_cov_14.457547	358	438	10	16	80	0.2000000
NODE_4303_length_1159_cov_14.457547	411	491	8	27	80	0.3375000
NODE_4303_length_1159_cov_14.457547	411	491	9	33	80	0.4125000
NODE_4303_length_1159_cov_14.457547	411	491	10	20	80	0.2500000
NODE_4304_length_1159_cov_11.566981	625	705	7	6	80	0.0750000
NODE_4304_length_1159_cov_11.566981	625	705	8	29	80	0.3625000
NODE_4304_length_1159_cov_11.566981	625	705	9	2	80	0.0250000
NODE_4304_length_1159_cov_11.566981	625	705	10	43	80	0.5375000
NODE_4304_length_1159_cov_11.566981	678	758	3	3	80	0.0375000
NODE_4304_length_1159_cov_11.566981	678	758	4	4	80	0.0500000
NODE_4304_length_1159_cov_11.566981	678	758	5	6	80	0.0750000
NODE_4304_length_1159_cov_11.566981	678	758	6	8	80	0.1000000
NODE_4304_length_1159_cov_11.566981	678	758	7	9	80	0.1125000
NODE_4304_length_1159_cov_11.566981	678	758	8	33	80	0.4125000
NODE_4304_length_1159_cov_11.566981	678	758	10	17	80	0.2125000
NODE_4305_length_1159_cov_9.927358	278	358	3	31	80	0.3875000
NODE_4305_length_1159_cov_9.927358	278	358	5	10	80	0.1250000
NODE_4305_length_1159_cov_9.927358	278	358	7	33	80	0.4125000
NODE_4305_length_1159_cov_9.927358	278	358	8	6	80	0.0750000
NODE_4305_length_1159_cov_9.927358	331	411	5	4	80	0.0500000
NODE_4305_length_1159_cov_9.927358	331	411	7	37	80	0.4625000
NODE_4305_length_1159_cov_9.927358	331	411	8	39	80	0.4875000
NODE_4314_length_1159_cov_1.568868	513	562	3	35	49	0.7142857
NODE_4314_length_1159_cov_1.568868	513	562	4	2	49	0.0408163
NODE_4314_length_1159_cov_1.568868	513	562	6	12	49	0.2448980
NODE_4316_length_1158_cov_33.529745	357	437	5	14	80	0.1750000
NODE_4316_length_1158_cov_33.529745	357	437	7	10	80	0.1250000
NODE_4316_length_1158_cov_33.529745	357	437	9	44	80	0.5500000
NODE_4316_length_1158_cov_33.529745	357	437	12	5	80	0.0625000
NODE_4316_length_1158_cov_33.529745	357	437	13	4	80	0.0500000
NODE_4316_length_1158_cov_33.529745	357	437	14	3	80	0.0375000
NODE_4316_length_1158_cov_33.529745	410	490	9	15	80	0.1875000
NODE_4316_length_1158_cov_33.529745	410	490	11	3	80	0.0375000
NODE_4316_length_1158_cov_33.529745	410	490	12	5	80	0.0625000
NODE_4316_length_1158_cov_33.529745	410	490	13	34	80	0.4250000
NODE_4316_length_1158_cov_33.529745	410	490	14	17	80	0.2125000
NODE_4316_length_1158_cov_33.529745	410	490	15	6	80	0.0750000
NODE_4316_length_1158_cov_33.529745	486	566	13	2	80	0.0250000
NODE_4316_length_1158_cov_33.529745	486	566	14	2	80	0.0250000
NODE_4316_length_1158_cov_33.529745	486	566	15	18	80	0.2250000
NODE_4316_length_1158_cov_33.529745	486	566	16	15	80	0.1875000
NODE_4316_length_1158_cov_33.529745	486	566	17	43	80	0.5375000
NODE_4316_length_1158_cov_33.529745	539	619	7	2	80	0.0250000
NODE_4316_length_1158_cov_33.529745	539	619	8	1	80	0.0125000
NODE_4316_length_1158_cov_33.529745	539	619	9	32	80	0.4000000
NODE_4316_length_1158_cov_33.529745	539	619	11	8	80	0.1000000
NODE_4316_length_1158_cov_33.529745	539	619	13	1	80	0.0125000
NODE_4316_length_1158_cov_33.529745	539	619	14	3	80	0.0375000
NODE_4316_length_1158_cov_33.529745	539	619	16	1	80	0.0125000
NODE_4316_length_1158_cov_33.529745	539	619	17	32	80	0.4000000
NODE_4317_length_1158_cov_31.368272	416	496	3	66	80	0.8250000
NODE_4317_length_1158_cov_31.368272	416	496	4	6	80	0.0750000
NODE_4317_length_1158_cov_31.368272	416	496	5	7	80	0.0875000
NODE_4317_length_1158_cov_31.368272	416	496	6	1	80	0.0125000
NODE_4317_length_1158_cov_31.368272	469	549	3	13	80	0.1625000
NODE_4317_length_1158_cov_31.368272	469	549	4	6	80	0.0750000
NODE_4317_length_1158_cov_31.368272	469	549	5	7	80	0.0875000
NODE_4317_length_1158_cov_31.368272	469	549	6	26	80	0.3250000
NODE_4317_length_1158_cov_31.368272	469	549	7	28	80	0.3500000
NODE_4317_length_1158_cov_31.368272	545	626	6	9	81	0.1111111
NODE_4317_length_1158_cov_31.368272	545	626	7	40	81	0.4938272
NODE_4317_length_1158_cov_31.368272	545	626	9	32	81	0.3950617
NODE_4317_length_1158_cov_31.368272	599	679	5	30	80	0.3750000
NODE_4317_length_1158_cov_31.368272	599	679	6	1	80	0.0125000
NODE_4317_length_1158_cov_31.368272	599	679	7	7	80	0.0875000
NODE_4317_length_1158_cov_31.368272	599	679	8	6	80	0.0750000
NODE_4317_length_1158_cov_31.368272	599	679	9	36	80	0.4500000
NODE_4318_length_1158_cov_31.240793	430	510	0	48	80	0.6000000
NODE_4318_length_1158_cov_31.240793	430	510	2	32	80	0.4000000
NODE_4318_length_1158_cov_31.240793	483	563	1	9	80	0.1125000
NODE_4318_length_1158_cov_31.240793	483	563	2	70	80	0.8750000
NODE_4318_length_1158_cov_31.240793	483	563	3	1	80	0.0125000
NODE_4318_length_1158_cov_31.240793	559	639	1	21	80	0.2625000
NODE_4318_length_1158_cov_31.240793	559	639	3	24	80	0.3000000
NODE_4318_length_1158_cov_31.240793	559	639	5	35	80	0.4375000
NODE_4318_length_1158_cov_31.240793	612	692	5	80	80	1.0000000
NODE_4319_length_1158_cov_29.216242	405	485	5	16	80	0.2000000
NODE_4319_length_1158_cov_29.216242	405	485	6	4	80	0.0500000
NODE_4319_length_1158_cov_29.216242	405	485	7	19	80	0.2375000
NODE_4319_length_1158_cov_29.216242	405	485	9	1	80	0.0125000
NODE_4319_length_1158_cov_29.216242	405	485	10	7	80	0.0875000
NODE_4319_length_1158_cov_29.216242	405	485	11	2	80	0.0250000
NODE_4319_length_1158_cov_29.216242	405	485	12	15	80	0.1875000
NODE_4319_length_1158_cov_29.216242	405	485	13	16	80	0.2000000
NODE_4319_length_1158_cov_29.216242	458	538	12	11	80	0.1375000
NODE_4319_length_1158_cov_29.216242	458	538	13	26	80	0.3250000
NODE_4319_length_1158_cov_29.216242	458	538	14	24	80	0.3000000
NODE_4319_length_1158_cov_29.216242	458	538	15	7	80	0.0875000
NODE_4319_length_1158_cov_29.216242	458	538	16	12	80	0.1500000
NODE_4320_length_1158_cov_25.245515	500	580	1	32	80	0.4000000
NODE_4320_length_1158_cov_25.245515	500	580	3	8	80	0.1000000
NODE_4320_length_1158_cov_25.245515	500	580	5	5	80	0.0625000
NODE_4320_length_1158_cov_25.245515	500	580	6	5	80	0.0625000
NODE_4320_length_1158_cov_25.245515	500	580	7	21	80	0.2625000
NODE_4320_length_1158_cov_25.245515	500	580	8	9	80	0.1125000
NODE_4320_length_1158_cov_25.245515	553	633	7	18	80	0.2250000
NODE_4320_length_1158_cov_25.245515	553	633	8	36	80	0.4500000
NODE_4320_length_1158_cov_25.245515	553	633	9	26	80	0.3250000
NODE_4320_length_1158_cov_25.245515	629	709	4	4	80	0.0500000
NODE_4320_length_1158_cov_25.245515	629	709	5	9	80	0.1125000
NODE_4320_length_1158_cov_25.245515	629	709	6	49	80	0.6125000
NODE_4320_length_1158_cov_25.245515	629	709	7	5	80	0.0625000
NODE_4320_length_1158_cov_25.245515	629	709	8	13	80	0.1625000
NODE_4320_length_1158_cov_25.245515	682	762	3	13	80	0.1625000
NODE_4320_length_1158_cov_25.245515	682	762	4	35	80	0.4375000
NODE_4320_length_1158_cov_25.245515	682	762	5	14	80	0.1750000
NODE_4320_length_1158_cov_25.245515	682	762	6	13	80	0.1625000
NODE_4320_length_1158_cov_25.245515	682	762	7	5	80	0.0625000
NODE_4321_length_1158_cov_16.566572	396	476	2	62	80	0.7750000
NODE_4321_length_1158_cov_16.566572	396	476	3	18	80	0.2250000
NODE_4321_length_1158_cov_16.566572	449	529	1	37	80	0.4625000
NODE_4321_length_1158_cov_16.566572	449	529	2	9	80	0.1125000
NODE_4321_length_1158_cov_16.566572	449	529	3	34	80	0.4250000
NODE_4322_length_1158_cov_13.092540	372	452	3	4	80	0.0500000
NODE_4322_length_1158_cov_13.092540	372	452	4	76	80	0.9500000
NODE_4322_length_1158_cov_13.092540	425	505	0	33	80	0.4125000
NODE_4322_length_1158_cov_13.092540	425	505	1	9	80	0.1125000
NODE_4322_length_1158_cov_13.092540	425	505	3	15	80	0.1875000
NODE_4322_length_1158_cov_13.092540	425	505	4	23	80	0.2875000
NODE_4322_length_1158_cov_13.092540	735	815	0	39	80	0.4875000
NODE_4322_length_1158_cov_13.092540	735	815	1	41	80	0.5125000
NODE_4322_length_1158_cov_13.092540	788	868	1	80	80	1.0000000
NODE_4323_length_1158_cov_7.408876	656	736	2	44	80	0.5500000
NODE_4323_length_1158_cov_7.408876	656	736	4	36	80	0.4500000
NODE_4323_length_1158_cov_7.408876	709	789	2	1	80	0.0125000
NODE_4323_length_1158_cov_7.408876	709	789	3	16	80	0.2000000
NODE_4323_length_1158_cov_7.408876	709	789	4	63	80	0.7875000
NODE_4324_length_1158_cov_6.242682	239	310	1	19	71	0.2676056
NODE_4324_length_1158_cov_6.242682	239	310	2	23	71	0.3239437
NODE_4324_length_1158_cov_6.242682	239	310	3	29	71	0.4084507
NODE_4325_length_1158_cov_6.043437	531	611	0	80	80	1.0000000
NODE_4325_length_1158_cov_6.043437	584	634	0	50	50	1.0000000
NODE_4326_length_1158_cov_5.855524	324	404	2	5	80	0.0625000
NODE_4326_length_1158_cov_5.855524	324	404	3	30	80	0.3750000
NODE_4326_length_1158_cov_5.855524	324	404	4	45	80	0.5625000
NODE_4326_length_1158_cov_5.855524	377	457	2	36	80	0.4500000
NODE_4326_length_1158_cov_5.855524	377	457	3	44	80	0.5500000
NODE_4329_length_1157_cov_32.233459	472	552	9	1	80	0.0125000
NODE_4329_length_1157_cov_32.233459	472	552	10	44	80	0.5500000
NODE_4329_length_1157_cov_32.233459	472	552	11	7	80	0.0875000
NODE_4329_length_1157_cov_32.233459	472	552	12	10	80	0.1250000
NODE_4329_length_1157_cov_32.233459	472	552	13	3	80	0.0375000
NODE_4329_length_1157_cov_32.233459	472	552	14	9	80	0.1125000
NODE_4329_length_1157_cov_32.233459	472	552	15	6	80	0.0750000
NODE_4329_length_1157_cov_32.233459	525	605	9	13	80	0.1625000
NODE_4329_length_1157_cov_32.233459	525	605	10	7	80	0.0875000
NODE_4329_length_1157_cov_32.233459	525	605	11	13	80	0.1625000
NODE_4329_length_1157_cov_32.233459	525	605	12	30	80	0.3750000
NODE_4329_length_1157_cov_32.233459	525	605	13	2	80	0.0250000
NODE_4329_length_1157_cov_32.233459	525	605	14	9	80	0.1125000
NODE_4329_length_1157_cov_32.233459	525	605	15	6	80	0.0750000
NODE_4329_length_1157_cov_32.233459	601	681	5	1	80	0.0125000
NODE_4329_length_1157_cov_32.233459	601	681	6	3	80	0.0375000
NODE_4329_length_1157_cov_32.233459	601	681	7	3	80	0.0375000
NODE_4329_length_1157_cov_32.233459	601	681	8	17	80	0.2125000
NODE_4329_length_1157_cov_32.233459	601	681	9	35	80	0.4375000
NODE_4329_length_1157_cov_32.233459	601	681	10	10	80	0.1250000
NODE_4329_length_1157_cov_32.233459	601	681	11	11	80	0.1375000
NODE_4329_length_1157_cov_32.233459	654	734	5	54	80	0.6750000
NODE_4329_length_1157_cov_32.233459	654	734	6	3	80	0.0375000
NODE_4329_length_1157_cov_32.233459	654	734	7	3	80	0.0375000
NODE_4329_length_1157_cov_32.233459	654	734	10	9	80	0.1125000
NODE_4329_length_1157_cov_32.233459	654	734	11	11	80	0.1375000
NODE_4330_length_1157_cov_6.438563	765	788	0	23	23	1.0000000
NODE_4332_length_1157_cov_4.068053	221	292	0	71	71	1.0000000
NODE_4333_length_1156_cov_46.381268	328	408	4	41	80	0.5125000
NODE_4333_length_1156_cov_46.381268	328	408	6	26	80	0.3250000
NODE_4333_length_1156_cov_46.381268	328	408	7	9	80	0.1125000
NODE_4333_length_1156_cov_46.381268	328	408	8	4	80	0.0500000
NODE_4333_length_1156_cov_46.381268	381	461	6	14	80	0.1750000
NODE_4333_length_1156_cov_46.381268	381	461	7	9	80	0.1125000
NODE_4333_length_1156_cov_46.381268	381	461	8	25	80	0.3125000
NODE_4333_length_1156_cov_46.381268	381	461	9	21	80	0.2625000
NODE_4333_length_1156_cov_46.381268	381	461	10	1	80	0.0125000
NODE_4333_length_1156_cov_46.381268	381	461	11	10	80	0.1250000
NODE_4333_length_1156_cov_46.381268	457	537	11	11	80	0.1375000
NODE_4333_length_1156_cov_46.381268	457	537	13	12	80	0.1500000
NODE_4333_length_1156_cov_46.381268	457	537	14	21	80	0.2625000
NODE_4333_length_1156_cov_46.381268	457	537	15	11	80	0.1375000
NODE_4333_length_1156_cov_46.381268	457	537	16	4	80	0.0500000
NODE_4333_length_1156_cov_46.381268	457	537	17	8	80	0.1000000
NODE_4333_length_1156_cov_46.381268	457	537	18	4	80	0.0500000
NODE_4333_length_1156_cov_46.381268	457	537	19	9	80	0.1125000
NODE_4333_length_1156_cov_46.381268	510	590	13	11	80	0.1375000
NODE_4333_length_1156_cov_46.381268	510	590	14	11	80	0.1375000
NODE_4333_length_1156_cov_46.381268	510	590	15	1	80	0.0125000
NODE_4333_length_1156_cov_46.381268	510	590	16	5	80	0.0625000
NODE_4333_length_1156_cov_46.381268	510	590	17	22	80	0.2750000
NODE_4333_length_1156_cov_46.381268	510	590	18	13	80	0.1625000
NODE_4333_length_1156_cov_46.381268	510	590	19	17	80	0.2125000
NODE_4334_length_1156_cov_32.198675	378	458	4	2	80	0.0250000
NODE_4334_length_1156_cov_32.198675	378	458	5	59	80	0.7375000
NODE_4334_length_1156_cov_32.198675	378	458	9	5	80	0.0625000
NODE_4334_length_1156_cov_32.198675	378	458	10	14	80	0.1750000
NODE_4334_length_1156_cov_32.198675	431	511	5	8	80	0.1000000
NODE_4334_length_1156_cov_32.198675	431	511	9	8	80	0.1000000
NODE_4334_length_1156_cov_32.198675	431	511	10	38	80	0.4750000
NODE_4334_length_1156_cov_32.198675	431	511	11	26	80	0.3250000
NODE_4334_length_1156_cov_32.198675	507	587	7	7	80	0.0875000
NODE_4334_length_1156_cov_32.198675	507	587	9	9	80	0.1125000
NODE_4334_length_1156_cov_32.198675	507	587	10	12	80	0.1500000
NODE_4334_length_1156_cov_32.198675	507	587	11	52	80	0.6500000
NODE_4334_length_1156_cov_32.198675	560	641	5	5	81	0.0617284
NODE_4334_length_1156_cov_32.198675	560	641	6	42	81	0.5185185
NODE_4334_length_1156_cov_32.198675	560	641	7	14	81	0.1728395
NODE_4334_length_1156_cov_32.198675	560	641	11	20	81	0.2469136
NODE_4335_length_1156_cov_12.683065	593	673	2	3	80	0.0375000
NODE_4335_length_1156_cov_12.683065	593	673	3	11	80	0.1375000
NODE_4335_length_1156_cov_12.683065	593	673	4	21	80	0.2625000
NODE_4335_length_1156_cov_12.683065	593	673	5	45	80	0.5625000
NODE_4335_length_1156_cov_12.683065	646	726	4	7	80	0.0875000
NODE_4335_length_1156_cov_12.683065	646	726	5	73	80	0.9125000
NODE_4336_length_1156_cov_9.287606	680	760	0	5	80	0.0625000
NODE_4336_length_1156_cov_9.287606	680	760	1	64	80	0.8000000
NODE_4336_length_1156_cov_9.287606	680	760	3	11	80	0.1375000
NODE_4336_length_1156_cov_9.287606	733	813	0	1	80	0.0125000
NODE_4336_length_1156_cov_9.287606	733	813	1	15	80	0.1875000
NODE_4336_length_1156_cov_9.287606	733	813	3	64	80	0.8000000
NODE_4339_length_1155_cov_19.570076	437	517	7	10	80	0.1250000
NODE_4339_length_1155_cov_19.570076	437	517	9	7	80	0.0875000
NODE_4339_length_1155_cov_19.570076	437	517	10	29	80	0.3625000
NODE_4339_length_1155_cov_19.570076	437	517	11	6	80	0.0750000
NODE_4339_length_1155_cov_19.570076	437	517	12	19	80	0.2375000
NODE_4339_length_1155_cov_19.570076	437	517	13	3	80	0.0375000
NODE_4339_length_1155_cov_19.570076	437	517	14	6	80	0.0750000
NODE_4339_length_1155_cov_19.570076	490	570	8	3	80	0.0375000
NODE_4339_length_1155_cov_19.570076	490	570	10	8	80	0.1000000
NODE_4339_length_1155_cov_19.570076	490	570	11	48	80	0.6000000
NODE_4339_length_1155_cov_19.570076	490	570	12	12	80	0.1500000
NODE_4339_length_1155_cov_19.570076	490	570	13	3	80	0.0375000
NODE_4339_length_1155_cov_19.570076	490	570	14	6	80	0.0750000
NODE_4340_length_1155_cov_18.666667	332	412	4	14	80	0.1750000
NODE_4340_length_1155_cov_18.666667	332	412	5	8	80	0.1000000
NODE_4340_length_1155_cov_18.666667	332	412	6	28	80	0.3500000
NODE_4340_length_1155_cov_18.666667	332	412	7	7	80	0.0875000
NODE_4340_length_1155_cov_18.666667	332	412	8	8	80	0.1000000
NODE_4340_length_1155_cov_18.666667	332	412	11	4	80	0.0500000
NODE_4340_length_1155_cov_18.666667	332	412	12	11	80	0.1375000
NODE_4340_length_1155_cov_18.666667	385	465	7	4	80	0.0500000
NODE_4340_length_1155_cov_18.666667	385	465	8	8	80	0.1000000
NODE_4340_length_1155_cov_18.666667	385	465	11	13	80	0.1625000
NODE_4340_length_1155_cov_18.666667	385	465	12	28	80	0.3500000
NODE_4340_length_1155_cov_18.666667	385	465	13	27	80	0.3375000
NODE_4346_length_1154_cov_61.769668	488	568	14	36	80	0.4500000
NODE_4346_length_1154_cov_61.769668	488	568	15	7	80	0.0875000
NODE_4346_length_1154_cov_61.769668	488	568	16	11	80	0.1375000
NODE_4346_length_1154_cov_61.769668	488	568	17	1	80	0.0125000
NODE_4346_length_1154_cov_61.769668	488	568	18	7	80	0.0875000
NODE_4346_length_1154_cov_61.769668	488	568	19	18	80	0.2250000
NODE_4346_length_1154_cov_61.769668	541	621	10	2	80	0.0250000
NODE_4346_length_1154_cov_61.769668	541	621	11	2	80	0.0250000
NODE_4346_length_1154_cov_61.769668	541	621	12	11	80	0.1375000
NODE_4346_length_1154_cov_61.769668	541	621	14	2	80	0.0250000
NODE_4346_length_1154_cov_61.769668	541	621	15	22	80	0.2750000
NODE_4346_length_1154_cov_61.769668	541	621	16	5	80	0.0625000
NODE_4346_length_1154_cov_61.769668	541	621	17	6	80	0.0750000
NODE_4346_length_1154_cov_61.769668	541	621	18	7	80	0.0875000
NODE_4346_length_1154_cov_61.769668	541	621	19	23	80	0.2875000
NODE_4347_length_1154_cov_50.909005	409	489	5	18	80	0.2250000
NODE_4347_length_1154_cov_50.909005	409	489	7	1	80	0.0125000
NODE_4347_length_1154_cov_50.909005	409	489	9	23	80	0.2875000
NODE_4347_length_1154_cov_50.909005	409	489	10	4	80	0.0500000
NODE_4347_length_1154_cov_50.909005	409	489	11	6	80	0.0750000
NODE_4347_length_1154_cov_50.909005	409	489	12	28	80	0.3500000
NODE_4347_length_1154_cov_50.909005	462	542	9	10	80	0.1250000
NODE_4347_length_1154_cov_50.909005	462	542	10	2	80	0.0250000
NODE_4347_length_1154_cov_50.909005	462	542	11	11	80	0.1375000
NODE_4347_length_1154_cov_50.909005	462	542	12	48	80	0.6000000
NODE_4347_length_1154_cov_50.909005	462	542	13	9	80	0.1125000
NODE_4347_length_1154_cov_50.909005	538	618	9	13	80	0.1625000
NODE_4347_length_1154_cov_50.909005	538	618	10	17	80	0.2125000
NODE_4347_length_1154_cov_50.909005	538	618	11	9	80	0.1125000
NODE_4347_length_1154_cov_50.909005	538	618	12	28	80	0.3500000
NODE_4347_length_1154_cov_50.909005	538	618	13	13	80	0.1625000
NODE_4347_length_1154_cov_50.909005	591	671	4	19	80	0.2375000
NODE_4347_length_1154_cov_50.909005	591	671	5	11	80	0.1375000
NODE_4347_length_1154_cov_50.909005	591	671	7	5	80	0.0625000
NODE_4347_length_1154_cov_50.909005	591	671	9	9	80	0.1125000
NODE_4347_length_1154_cov_50.909005	591	671	10	5	80	0.0625000
NODE_4347_length_1154_cov_50.909005	591	671	11	2	80	0.0250000
NODE_4347_length_1154_cov_50.909005	591	671	12	23	80	0.2875000
NODE_4347_length_1154_cov_50.909005	591	671	13	6	80	0.0750000
NODE_4348_length_1154_cov_28.941232	695	775	1	10	80	0.1250000
NODE_4348_length_1154_cov_28.941232	695	775	3	70	80	0.8750000
NODE_4348_length_1154_cov_28.941232	748	828	0	11	80	0.1375000
NODE_4348_length_1154_cov_28.941232	748	828	1	4	80	0.0500000
NODE_4348_length_1154_cov_28.941232	748	828	3	65	80	0.8125000
NODE_4349_length_1154_cov_13.765877	322	402	2	1	80	0.0125000
NODE_4349_length_1154_cov_13.765877	322	402	4	15	80	0.1875000
NODE_4349_length_1154_cov_13.765877	322	402	5	30	80	0.3750000
NODE_4349_length_1154_cov_13.765877	322	402	6	34	80	0.4250000
NODE_4349_length_1154_cov_13.765877	375	455	4	26	80	0.3250000
NODE_4349_length_1154_cov_13.765877	375	455	6	54	80	0.6750000
NODE_4351_length_1154_cov_5.930806	497	577	1	76	80	0.9500000
NODE_4351_length_1154_cov_5.930806	497	577	2	4	80	0.0500000
NODE_4351_length_1154_cov_5.930806	550	622	1	34	72	0.4722222
NODE_4351_length_1154_cov_5.930806	550	622	2	38	72	0.5277778
NODE_4357_length_1153_cov_65.486717	416	496	7	24	80	0.3000000
NODE_4357_length_1153_cov_65.486717	416	496	8	6	80	0.0750000
NODE_4357_length_1153_cov_65.486717	416	496	9	20	80	0.2500000
NODE_4357_length_1153_cov_65.486717	416	496	10	20	80	0.2500000
NODE_4357_length_1153_cov_65.486717	416	496	11	10	80	0.1250000
NODE_4357_length_1153_cov_65.486717	469	549	10	21	80	0.2625000
NODE_4357_length_1153_cov_65.486717	469	549	11	11	80	0.1375000
NODE_4357_length_1153_cov_65.486717	469	549	12	12	80	0.1500000
NODE_4357_length_1153_cov_65.486717	469	549	13	7	80	0.0875000
NODE_4357_length_1153_cov_65.486717	469	549	14	7	80	0.0875000
NODE_4357_length_1153_cov_65.486717	469	549	15	5	80	0.0625000
NODE_4357_length_1153_cov_65.486717	469	549	16	9	80	0.1125000
NODE_4357_length_1153_cov_65.486717	469	549	17	8	80	0.1000000
NODE_4357_length_1153_cov_65.486717	545	625	14	8	80	0.1000000
NODE_4357_length_1153_cov_65.486717	545	625	15	27	80	0.3375000
NODE_4357_length_1153_cov_65.486717	545	625	16	41	80	0.5125000
NODE_4357_length_1153_cov_65.486717	545	625	17	4	80	0.0500000
NODE_4357_length_1153_cov_65.486717	598	678	5	7	80	0.0875000
NODE_4357_length_1153_cov_65.486717	598	678	7	2	80	0.0250000
NODE_4357_length_1153_cov_65.486717	598	678	8	1	80	0.0125000
NODE_4357_length_1153_cov_65.486717	598	678	9	6	80	0.0750000
NODE_4357_length_1153_cov_65.486717	598	678	11	8	80	0.1000000
NODE_4357_length_1153_cov_65.486717	598	678	12	3	80	0.0375000
NODE_4357_length_1153_cov_65.486717	598	678	13	1	80	0.0125000
NODE_4357_length_1153_cov_65.486717	598	678	14	19	80	0.2375000
NODE_4357_length_1153_cov_65.486717	598	678	15	33	80	0.4125000
NODE_4358_length_1153_cov_50.733397	404	484	8	19	80	0.2375000
NODE_4358_length_1153_cov_50.733397	404	484	9	14	80	0.1750000
NODE_4358_length_1153_cov_50.733397	404	484	10	7	80	0.0875000
NODE_4358_length_1153_cov_50.733397	404	484	11	12	80	0.1500000
NODE_4358_length_1153_cov_50.733397	404	484	12	11	80	0.1375000
NODE_4358_length_1153_cov_50.733397	404	484	13	12	80	0.1500000
NODE_4358_length_1153_cov_50.733397	404	484	14	5	80	0.0625000
NODE_4358_length_1153_cov_50.733397	457	537	7	7	80	0.0875000
NODE_4358_length_1153_cov_50.733397	457	537	8	17	80	0.2125000
NODE_4358_length_1153_cov_50.733397	457	537	9	6	80	0.0750000
NODE_4358_length_1153_cov_50.733397	457	537	10	11	80	0.1375000
NODE_4358_length_1153_cov_50.733397	457	537	11	24	80	0.3000000
NODE_4358_length_1153_cov_50.733397	457	537	13	10	80	0.1250000
NODE_4358_length_1153_cov_50.733397	457	537	14	5	80	0.0625000
NODE_4358_length_1153_cov_50.733397	533	613	9	5	80	0.0625000
NODE_4358_length_1153_cov_50.733397	533	613	10	6	80	0.0750000
NODE_4358_length_1153_cov_50.733397	533	613	11	14	80	0.1750000
NODE_4358_length_1153_cov_50.733397	533	613	12	13	80	0.1625000
NODE_4358_length_1153_cov_50.733397	533	613	13	9	80	0.1125000
NODE_4358_length_1153_cov_50.733397	533	613	14	30	80	0.3750000
NODE_4358_length_1153_cov_50.733397	533	613	15	3	80	0.0375000
NODE_4358_length_1153_cov_50.733397	586	666	11	1	80	0.0125000
NODE_4358_length_1153_cov_50.733397	586	666	12	56	80	0.7000000
NODE_4358_length_1153_cov_50.733397	586	666	13	5	80	0.0625000
NODE_4358_length_1153_cov_50.733397	586	666	14	18	80	0.2250000
NODE_4359_length_1153_cov_26.131879	493	573	8	18	80	0.2250000
NODE_4359_length_1153_cov_26.131879	493	573	9	53	80	0.6625000
NODE_4359_length_1153_cov_26.131879	493	573	10	5	80	0.0625000
NODE_4359_length_1153_cov_26.131879	493	573	11	4	80	0.0500000
NODE_4359_length_1153_cov_26.131879	546	626	6	2	80	0.0250000
NODE_4359_length_1153_cov_26.131879	546	626	7	16	80	0.2000000
NODE_4359_length_1153_cov_26.131879	546	626	8	32	80	0.4000000
NODE_4359_length_1153_cov_26.131879	546	626	9	30	80	0.3750000
NODE_4360_length_1153_cov_10.195446	500	580	5	67	80	0.8375000
NODE_4360_length_1153_cov_10.195446	500	580	6	13	80	0.1625000
NODE_4360_length_1153_cov_10.195446	553	633	1	45	80	0.5625000
NODE_4360_length_1153_cov_10.195446	553	633	2	2	80	0.0250000
NODE_4360_length_1153_cov_10.195446	553	633	4	4	80	0.0500000
NODE_4360_length_1153_cov_10.195446	553	633	5	14	80	0.1750000
NODE_4360_length_1153_cov_10.195446	553	633	6	15	80	0.1875000
NODE_4361_length_1153_cov_8.286528	558	638	1	8	80	0.1000000
NODE_4361_length_1153_cov_8.286528	558	638	2	34	80	0.4250000
NODE_4361_length_1153_cov_8.286528	558	638	3	33	80	0.4125000
NODE_4361_length_1153_cov_8.286528	558	638	4	5	80	0.0625000
NODE_4361_length_1153_cov_8.286528	611	691	2	13	80	0.1625000
NODE_4361_length_1153_cov_8.286528	611	691	3	9	80	0.1125000
NODE_4361_length_1153_cov_8.286528	611	691	4	5	80	0.0625000
NODE_4361_length_1153_cov_8.286528	611	691	5	53	80	0.6625000
NODE_4368_length_1152_cov_19.800570	553	633	3	14	80	0.1750000
NODE_4368_length_1152_cov_19.800570	553	633	4	66	80	0.8250000
NODE_4368_length_1152_cov_19.800570	606	686	0	20	80	0.2500000
NODE_4368_length_1152_cov_19.800570	606	686	2	9	80	0.1125000
NODE_4368_length_1152_cov_19.800570	606	686	3	38	80	0.4750000
NODE_4368_length_1152_cov_19.800570	606	686	4	13	80	0.1625000
NODE_4369_length_1152_cov_19.365622	490	570	4	44	80	0.5500000
NODE_4369_length_1152_cov_19.365622	490	570	5	15	80	0.1875000
NODE_4369_length_1152_cov_19.365622	490	570	6	21	80	0.2625000
NODE_4369_length_1152_cov_19.365622	543	623	4	20	80	0.2500000
NODE_4369_length_1152_cov_19.365622	543	623	6	32	80	0.4000000
NODE_4369_length_1152_cov_19.365622	543	623	7	28	80	0.3500000
NODE_4370_length_1152_cov_18.654321	594	674	7	1	80	0.0125000
NODE_4370_length_1152_cov_18.654321	594	674	8	2	80	0.0250000
NODE_4370_length_1152_cov_18.654321	594	674	10	9	80	0.1125000
NODE_4370_length_1152_cov_18.654321	594	674	11	1	80	0.0125000
NODE_4370_length_1152_cov_18.654321	594	674	13	34	80	0.4250000
NODE_4370_length_1152_cov_18.654321	594	674	14	33	80	0.4125000
NODE_4370_length_1152_cov_18.654321	647	727	1	32	80	0.4000000
NODE_4370_length_1152_cov_18.654321	647	727	3	3	80	0.0375000
NODE_4370_length_1152_cov_18.654321	647	727	4	6	80	0.0750000
NODE_4370_length_1152_cov_18.654321	647	727	6	6	80	0.0750000
NODE_4370_length_1152_cov_18.654321	647	727	7	7	80	0.0875000
NODE_4370_length_1152_cov_18.654321	647	727	8	2	80	0.0250000
NODE_4370_length_1152_cov_18.654321	647	727	10	9	80	0.1125000
NODE_4370_length_1152_cov_18.654321	647	727	11	1	80	0.0125000
NODE_4370_length_1152_cov_18.654321	647	727	13	14	80	0.1750000
NODE_4371_length_1152_cov_18.075024	377	457	2	49	80	0.6125000
NODE_4371_length_1152_cov_18.075024	377	457	3	11	80	0.1375000
NODE_4371_length_1152_cov_18.075024	377	457	4	15	80	0.1875000
NODE_4371_length_1152_cov_18.075024	377	457	5	5	80	0.0625000
NODE_4371_length_1152_cov_18.075024	430	510	3	7	80	0.0875000
NODE_4371_length_1152_cov_18.075024	430	510	4	25	80	0.3125000
NODE_4371_length_1152_cov_18.075024	430	510	5	21	80	0.2625000
NODE_4371_length_1152_cov_18.075024	430	510	6	19	80	0.2375000
NODE_4371_length_1152_cov_18.075024	430	510	7	8	80	0.1000000
NODE_4371_length_1152_cov_18.075024	506	586	5	10	80	0.1250000
NODE_4371_length_1152_cov_18.075024	506	586	6	56	80	0.7000000
NODE_4371_length_1152_cov_18.075024	506	586	7	14	80	0.1750000
NODE_4371_length_1152_cov_18.075024	559	639	1	6	80	0.0750000
NODE_4371_length_1152_cov_18.075024	559	639	2	15	80	0.1875000
NODE_4371_length_1152_cov_18.075024	559	639	3	16	80	0.2000000
NODE_4371_length_1152_cov_18.075024	559	639	4	15	80	0.1875000
NODE_4371_length_1152_cov_18.075024	559	639	5	11	80	0.1375000
NODE_4371_length_1152_cov_18.075024	559	639	6	17	80	0.2125000
NODE_4373_length_1152_cov_16.047483	543	623	3	25	80	0.3125000
NODE_4373_length_1152_cov_16.047483	543	623	4	12	80	0.1500000
NODE_4373_length_1152_cov_16.047483	543	623	5	16	80	0.2000000
NODE_4373_length_1152_cov_16.047483	543	623	7	4	80	0.0500000
NODE_4373_length_1152_cov_16.047483	543	623	8	23	80	0.2875000
NODE_4373_length_1152_cov_16.047483	596	676	7	16	80	0.2000000
NODE_4373_length_1152_cov_16.047483	596	676	8	64	80	0.8000000
NODE_4373_length_1152_cov_16.047483	672	752	3	2	80	0.0250000
NODE_4373_length_1152_cov_16.047483	672	752	4	20	80	0.2500000
NODE_4373_length_1152_cov_16.047483	672	752	5	1	80	0.0125000
NODE_4373_length_1152_cov_16.047483	672	752	7	49	80	0.6125000
NODE_4373_length_1152_cov_16.047483	672	752	8	8	80	0.1000000
NODE_4373_length_1152_cov_16.047483	725	805	3	55	80	0.6875000
NODE_4373_length_1152_cov_16.047483	725	805	4	20	80	0.2500000
NODE_4373_length_1152_cov_16.047483	725	805	5	1	80	0.0125000
NODE_4373_length_1152_cov_16.047483	725	805	7	4	80	0.0500000
NODE_4374_length_1152_cov_13.981007	583	663	3	23	80	0.2875000
NODE_4374_length_1152_cov_13.981007	583	663	4	8	80	0.1000000
NODE_4374_length_1152_cov_13.981007	583	663	5	11	80	0.1375000
NODE_4374_length_1152_cov_13.981007	583	663	6	38	80	0.4750000
NODE_4374_length_1152_cov_13.981007	636	716	3	23	80	0.2875000
NODE_4374_length_1152_cov_13.981007	636	716	4	38	80	0.4750000
NODE_4374_length_1152_cov_13.981007	636	716	5	19	80	0.2375000
NODE_4380_length_1151_cov_30.469582	479	559	5	43	80	0.5375000
NODE_4380_length_1151_cov_30.469582	479	559	7	8	80	0.1000000
NODE_4380_length_1151_cov_30.469582	479	559	8	4	80	0.0500000
NODE_4380_length_1151_cov_30.469582	479	559	9	8	80	0.1000000
NODE_4380_length_1151_cov_30.469582	479	559	10	2	80	0.0250000
NODE_4380_length_1151_cov_30.469582	479	559	11	15	80	0.1875000
NODE_4380_length_1151_cov_30.469582	532	612	6	18	80	0.2250000
NODE_4380_length_1151_cov_30.469582	532	612	7	10	80	0.1250000
NODE_4380_length_1151_cov_30.469582	532	612	8	17	80	0.2125000
NODE_4380_length_1151_cov_30.469582	532	612	9	18	80	0.2250000
NODE_4380_length_1151_cov_30.469582	532	612	10	2	80	0.0250000
NODE_4380_length_1151_cov_30.469582	532	612	11	15	80	0.1875000
NODE_4381_length_1151_cov_26.650190	567	647	4	3	80	0.0375000
NODE_4381_length_1151_cov_26.650190	567	647	5	3	80	0.0375000
NODE_4381_length_1151_cov_26.650190	567	647	6	4	80	0.0500000
NODE_4381_length_1151_cov_26.650190	567	647	7	21	80	0.2625000
NODE_4381_length_1151_cov_26.650190	567	647	9	12	80	0.1500000
NODE_4381_length_1151_cov_26.650190	567	647	10	1	80	0.0125000
NODE_4381_length_1151_cov_26.650190	567	647	12	3	80	0.0375000
NODE_4381_length_1151_cov_26.650190	567	647	15	9	80	0.1125000
NODE_4381_length_1151_cov_26.650190	567	647	17	5	80	0.0625000
NODE_4381_length_1151_cov_26.650190	567	647	18	8	80	0.1000000
NODE_4381_length_1151_cov_26.650190	567	647	19	11	80	0.1375000
NODE_4381_length_1151_cov_26.650190	620	700	13	34	80	0.4250000
NODE_4381_length_1151_cov_26.650190	620	700	14	8	80	0.1000000
NODE_4381_length_1151_cov_26.650190	620	700	15	3	80	0.0375000
NODE_4381_length_1151_cov_26.650190	620	700	16	1	80	0.0125000
NODE_4381_length_1151_cov_26.650190	620	700	17	5	80	0.0625000
NODE_4381_length_1151_cov_26.650190	620	700	18	15	80	0.1875000
NODE_4381_length_1151_cov_26.650190	620	700	19	14	80	0.1750000
NODE_4382_length_1151_cov_26.375475	441	521	3	74	80	0.9250000
NODE_4382_length_1151_cov_26.375475	441	521	4	6	80	0.0750000
NODE_4382_length_1151_cov_26.375475	494	574	3	80	80	1.0000000
NODE_4382_length_1151_cov_26.375475	570	650	0	25	80	0.3125000
NODE_4382_length_1151_cov_26.375475	570	650	1	37	80	0.4625000
NODE_4382_length_1151_cov_26.375475	570	650	2	2	80	0.0250000
NODE_4382_length_1151_cov_26.375475	570	650	3	16	80	0.2000000
NODE_4382_length_1151_cov_26.375475	623	703	0	78	80	0.9750000
NODE_4382_length_1151_cov_26.375475	623	703	1	2	80	0.0250000
NODE_4383_length_1151_cov_23.614068	590	670	6	54	80	0.6750000
NODE_4383_length_1151_cov_23.614068	590	670	8	26	80	0.3250000
NODE_4383_length_1151_cov_23.614068	643	721	6	47	78	0.6025641
NODE_4383_length_1151_cov_23.614068	643	721	8	31	78	0.3974359
NODE_4384_length_1151_cov_18.693916	355	435	3	5	80	0.0625000
NODE_4384_length_1151_cov_18.693916	355	435	4	32	80	0.4000000
NODE_4384_length_1151_cov_18.693916	355	435	5	43	80	0.5375000
NODE_4384_length_1151_cov_18.693916	408	491	2	13	83	0.1566265
NODE_4384_length_1151_cov_18.693916	408	491	3	24	83	0.2891566
NODE_4384_length_1151_cov_18.693916	408	491	4	44	83	0.5301205
NODE_4384_length_1151_cov_18.693916	408	491	5	2	83	0.0240964
NODE_4385_length_1151_cov_16.093156	474	554	0	4	80	0.0500000
NODE_4385_length_1151_cov_16.093156	474	554	2	76	80	0.9500000
NODE_4385_length_1151_cov_16.093156	527	607	0	21	80	0.2625000
NODE_4385_length_1151_cov_16.093156	527	607	1	1	80	0.0125000
NODE_4385_length_1151_cov_16.093156	527	607	2	58	80	0.7250000
NODE_4386_length_1151_cov_13.782319	400	482	5	31	82	0.3780488
NODE_4386_length_1151_cov_13.782319	400	482	7	25	82	0.3048781
NODE_4386_length_1151_cov_13.782319	400	482	10	13	82	0.1585366
NODE_4386_length_1151_cov_13.782319	400	482	11	13	82	0.1585366
NODE_4386_length_1151_cov_13.782319	450	535	7	6	85	0.0705882
NODE_4386_length_1151_cov_13.782319	450	535	8	1	85	0.0117647
NODE_4386_length_1151_cov_13.782319	450	535	9	16	85	0.1882353
NODE_4386_length_1151_cov_13.782319	450	535	10	30	85	0.3529412
NODE_4386_length_1151_cov_13.782319	450	535	11	32	85	0.3764706
NODE_4392_length_1150_cov_38.601332	563	643	4	10	80	0.1250000
NODE_4392_length_1150_cov_38.601332	563	643	5	20	80	0.2500000
NODE_4392_length_1150_cov_38.601332	563	643	6	1	80	0.0125000
NODE_4392_length_1150_cov_38.601332	563	643	7	45	80	0.5625000
NODE_4392_length_1150_cov_38.601332	563	643	8	4	80	0.0500000
NODE_4392_length_1150_cov_38.601332	616	696	5	18	80	0.2250000
NODE_4392_length_1150_cov_38.601332	616	696	6	9	80	0.1125000
NODE_4392_length_1150_cov_38.601332	616	696	7	26	80	0.3250000
NODE_4392_length_1150_cov_38.601332	616	696	8	22	80	0.2750000
NODE_4392_length_1150_cov_38.601332	616	696	9	5	80	0.0625000
NODE_4392_length_1150_cov_38.601332	692	772	4	14	80	0.1750000
NODE_4392_length_1150_cov_38.601332	692	772	5	31	80	0.3875000
NODE_4392_length_1150_cov_38.601332	692	772	6	35	80	0.4375000
NODE_4392_length_1150_cov_38.601332	745	825	4	43	80	0.5375000
NODE_4392_length_1150_cov_38.601332	745	825	5	37	80	0.4625000
NODE_4393_length_1150_cov_15.741199	497	578	4	1	81	0.0123457
NODE_4393_length_1150_cov_15.741199	497	578	6	41	81	0.5061728
NODE_4393_length_1150_cov_15.741199	497	578	7	27	81	0.3333333
NODE_4393_length_1150_cov_15.741199	497	578	8	12	81	0.1481481
NODE_4393_length_1150_cov_15.741199	550	631	3	1	81	0.0123457
NODE_4393_length_1150_cov_15.741199	550	631	4	4	81	0.0493827
NODE_4393_length_1150_cov_15.741199	550	631	6	1	81	0.0123457
NODE_4393_length_1150_cov_15.741199	550	631	7	59	81	0.7283950
NODE_4393_length_1150_cov_15.741199	550	631	8	16	81	0.1975309
NODE_4394_length_1150_cov_11.132255	795	875	3	22	80	0.2750000
NODE_4394_length_1150_cov_11.132255	795	875	4	58	80	0.7250000
NODE_4394_length_1150_cov_11.132255	848	928	2	40	80	0.5000000
NODE_4394_length_1150_cov_11.132255	848	928	4	40	80	0.5000000
NODE_4395_length_1150_cov_9.253092	583	663	6	26	80	0.3250000
NODE_4395_length_1150_cov_9.253092	583	663	7	20	80	0.2500000
NODE_4395_length_1150_cov_9.253092	583	663	8	34	80	0.4250000
NODE_4395_length_1150_cov_9.253092	636	716	3	12	80	0.1500000
NODE_4395_length_1150_cov_9.253092	636	716	5	10	80	0.1250000
NODE_4395_length_1150_cov_9.253092	636	716	6	26	80	0.3250000
NODE_4395_length_1150_cov_9.253092	636	716	7	25	80	0.3125000
NODE_4395_length_1150_cov_9.253092	636	716	8	7	80	0.0875000
NODE_4398_length_1149_cov_17.289524	644	695	0	51	51	1.0000000
NODE_4399_length_1149_cov_13.805714	584	664	1	18	80	0.2250000
NODE_4399_length_1149_cov_13.805714	584	664	2	26	80	0.3250000
NODE_4399_length_1149_cov_13.805714	584	664	3	36	80	0.4500000
NODE_4399_length_1149_cov_13.805714	637	717	3	36	80	0.4500000
NODE_4399_length_1149_cov_13.805714	637	717	5	34	80	0.4250000
NODE_4399_length_1149_cov_13.805714	637	717	6	10	80	0.1250000
NODE_4399_length_1149_cov_13.805714	713	793	4	15	80	0.1875000
NODE_4399_length_1149_cov_13.805714	713	793	5	21	80	0.2625000
NODE_4399_length_1149_cov_13.805714	713	793	6	5	80	0.0625000
NODE_4399_length_1149_cov_13.805714	713	793	7	35	80	0.4375000
NODE_4399_length_1149_cov_13.805714	713	793	8	4	80	0.0500000
NODE_4399_length_1149_cov_13.805714	766	846	3	15	80	0.1875000
NODE_4399_length_1149_cov_13.805714	766	846	4	53	80	0.6625000
NODE_4399_length_1149_cov_13.805714	766	846	7	12	80	0.1500000
NODE_4407_length_1148_cov_27.674929	387	467	3	64	80	0.8000000
NODE_4407_length_1148_cov_27.674929	387	467	4	16	80	0.2000000
NODE_4407_length_1148_cov_27.674929	440	520	2	28	80	0.3500000
NODE_4407_length_1148_cov_27.674929	440	520	3	52	80	0.6500000
NODE_4408_length_1148_cov_13.275500	136	216	5	10	80	0.1250000
NODE_4408_length_1148_cov_13.275500	136	216	6	7	80	0.0875000
NODE_4408_length_1148_cov_13.275500	136	216	7	25	80	0.3125000
NODE_4408_length_1148_cov_13.275500	136	216	8	38	80	0.4750000
NODE_4408_length_1148_cov_13.275500	189	268	4	22	79	0.2784810
NODE_4408_length_1148_cov_13.275500	189	268	5	5	79	0.0632911
NODE_4408_length_1148_cov_13.275500	189	268	6	19	79	0.2405063
NODE_4408_length_1148_cov_13.275500	189	268	7	31	79	0.3924051
NODE_4408_length_1148_cov_13.275500	189	268	8	2	79	0.0253165
NODE_4409_length_1148_cov_10.613918	506	586	0	80	80	1.0000000
NODE_4409_length_1148_cov_10.613918	559	639	0	80	80	1.0000000
NODE_4415_length_1147_cov_33.543893	378	458	2	15	80	0.1875000
NODE_4415_length_1147_cov_33.543893	378	458	3	1	80	0.0125000
NODE_4415_length_1147_cov_33.543893	378	458	6	6	80	0.0750000
NODE_4415_length_1147_cov_33.543893	378	458	7	1	80	0.0125000
NODE_4415_length_1147_cov_33.543893	378	458	8	34	80	0.4250000
NODE_4415_length_1147_cov_33.543893	378	458	9	23	80	0.2875000
NODE_4415_length_1147_cov_33.543893	431	511	8	11	80	0.1375000
NODE_4415_length_1147_cov_33.543893	431	511	9	25	80	0.3125000
NODE_4415_length_1147_cov_33.543893	431	511	10	40	80	0.5000000
NODE_4415_length_1147_cov_33.543893	431	511	11	4	80	0.0500000
NODE_4416_length_1147_cov_26.858779	254	334	0	80	80	1.0000000
NODE_4416_length_1147_cov_26.858779	307	387	0	35	80	0.4375000
NODE_4416_length_1147_cov_26.858779	307	387	1	45	80	0.5625000
NODE_4416_length_1147_cov_26.858779	383	463	1	9	80	0.1125000
NODE_4416_length_1147_cov_26.858779	383	463	4	3	80	0.0375000
NODE_4416_length_1147_cov_26.858779	383	463	5	18	80	0.2250000
NODE_4416_length_1147_cov_26.858779	383	463	7	13	80	0.1625000
NODE_4416_length_1147_cov_26.858779	383	463	8	21	80	0.2625000
NODE_4416_length_1147_cov_26.858779	383	463	9	9	80	0.1125000
NODE_4416_length_1147_cov_26.858779	383	463	10	4	80	0.0500000
NODE_4416_length_1147_cov_26.858779	383	463	11	3	80	0.0375000
NODE_4416_length_1147_cov_26.858779	436	516	8	11	80	0.1375000
NODE_4416_length_1147_cov_26.858779	436	516	9	9	80	0.1125000
NODE_4416_length_1147_cov_26.858779	436	516	10	4	80	0.0500000
NODE_4416_length_1147_cov_26.858779	436	516	11	33	80	0.4125000
NODE_4416_length_1147_cov_26.858779	436	516	12	23	80	0.2875000
NODE_4417_length_1147_cov_24.227099	606	686	3	11	80	0.1375000
NODE_4417_length_1147_cov_24.227099	606	686	4	22	80	0.2750000
NODE_4417_length_1147_cov_24.227099	606	686	5	47	80	0.5875000
NODE_4417_length_1147_cov_24.227099	659	739	2	28	80	0.3500000
NODE_4417_length_1147_cov_24.227099	659	739	3	36	80	0.4500000
NODE_4417_length_1147_cov_24.227099	659	739	4	16	80	0.2000000
NODE_4417_length_1147_cov_24.227099	735	815	2	13	80	0.1625000
NODE_4417_length_1147_cov_24.227099	735	815	3	13	80	0.1625000
NODE_4417_length_1147_cov_24.227099	735	815	4	54	80	0.6750000
NODE_4417_length_1147_cov_24.227099	788	868	3	65	80	0.8125000
NODE_4417_length_1147_cov_24.227099	788	868	4	15	80	0.1875000
NODE_4418_length_1147_cov_16.559160	417	497	0	1	80	0.0125000
NODE_4418_length_1147_cov_16.559160	417	497	1	9	80	0.1125000
NODE_4418_length_1147_cov_16.559160	417	497	2	70	80	0.8750000
NODE_4418_length_1147_cov_16.559160	470	550	0	5	80	0.0625000
NODE_4418_length_1147_cov_16.559160	470	550	1	9	80	0.1125000
NODE_4418_length_1147_cov_16.559160	470	550	2	66	80	0.8250000
NODE_4428_length_1146_cov_52.393505	411	491	5	14	80	0.1750000
NODE_4428_length_1146_cov_52.393505	411	491	6	53	80	0.6625000
NODE_4428_length_1146_cov_52.393505	411	491	7	13	80	0.1625000
NODE_4428_length_1146_cov_52.393505	464	544	5	20	80	0.2500000
NODE_4428_length_1146_cov_52.393505	464	544	6	31	80	0.3875000
NODE_4428_length_1146_cov_52.393505	464	544	7	25	80	0.3125000
NODE_4428_length_1146_cov_52.393505	464	544	9	4	80	0.0500000
NODE_4428_length_1146_cov_52.393505	540	620	7	9	80	0.1125000
NODE_4428_length_1146_cov_52.393505	540	620	8	12	80	0.1500000
NODE_4428_length_1146_cov_52.393505	540	620	9	29	80	0.3625000
NODE_4428_length_1146_cov_52.393505	540	620	10	24	80	0.3000000
NODE_4428_length_1146_cov_52.393505	540	620	11	6	80	0.0750000
NODE_4428_length_1146_cov_52.393505	593	673	4	12	80	0.1500000
NODE_4428_length_1146_cov_52.393505	593	673	5	6	80	0.0750000
NODE_4428_length_1146_cov_52.393505	593	673	6	18	80	0.2250000
NODE_4428_length_1146_cov_52.393505	593	673	8	29	80	0.3625000
NODE_4428_length_1146_cov_52.393505	593	673	10	15	80	0.1875000
NODE_4429_length_1146_cov_46.364852	233	313	6	11	80	0.1375000
NODE_4429_length_1146_cov_46.364852	233	313	7	1	80	0.0125000
NODE_4429_length_1146_cov_46.364852	233	313	8	34	80	0.4250000
NODE_4429_length_1146_cov_46.364852	233	313	9	10	80	0.1250000
NODE_4429_length_1146_cov_46.364852	233	313	10	14	80	0.1750000
NODE_4429_length_1146_cov_46.364852	233	313	12	10	80	0.1250000
NODE_4429_length_1146_cov_46.364852	286	366	8	3	80	0.0375000
NODE_4429_length_1146_cov_46.364852	286	366	10	14	80	0.1750000
NODE_4429_length_1146_cov_46.364852	286	366	11	40	80	0.5000000
NODE_4429_length_1146_cov_46.364852	286	366	12	16	80	0.2000000
NODE_4429_length_1146_cov_46.364852	286	366	13	7	80	0.0875000
NODE_4430_length_1146_cov_26.159503	476	556	2	33	80	0.4125000
NODE_4430_length_1146_cov_26.159503	476	556	4	1	80	0.0125000
NODE_4430_length_1146_cov_26.159503	476	556	5	9	80	0.1125000
NODE_4430_length_1146_cov_26.159503	476	556	6	37	80	0.4625000
NODE_4430_length_1146_cov_26.159503	529	609	1	16	80	0.2000000
NODE_4430_length_1146_cov_26.159503	529	609	2	64	80	0.8000000
NODE_4430_length_1146_cov_26.159503	605	685	1	54	80	0.6750000
NODE_4430_length_1146_cov_26.159503	605	685	2	26	80	0.3250000
NODE_4430_length_1146_cov_26.159503	658	738	1	80	80	1.0000000
NODE_4431_length_1146_cov_14.210124	343	423	6	27	80	0.3375000
NODE_4431_length_1146_cov_14.210124	343	423	7	41	80	0.5125000
NODE_4431_length_1146_cov_14.210124	343	423	8	12	80	0.1500000
NODE_4431_length_1146_cov_14.210124	396	476	4	11	80	0.1375000
NODE_4431_length_1146_cov_14.210124	396	476	5	2	80	0.0250000
NODE_4431_length_1146_cov_14.210124	396	476	6	5	80	0.0625000
NODE_4431_length_1146_cov_14.210124	396	476	7	40	80	0.5000000
NODE_4431_length_1146_cov_14.210124	396	476	8	22	80	0.2750000
NODE_4432_length_1146_cov_13.479465	425	501	1	15	76	0.1973684
NODE_4432_length_1146_cov_13.479465	425	501	2	61	76	0.8026316
NODE_4432_length_1146_cov_13.479465	505	565	1	41	60	0.6833333
NODE_4432_length_1146_cov_13.479465	505	565	2	19	60	0.3166667
NODE_4432_length_1146_cov_13.479465	561	641	1	45	80	0.5625000
NODE_4432_length_1146_cov_13.479465	561	641	2	35	80	0.4375000
NODE_4432_length_1146_cov_13.479465	614	694	1	6	80	0.0750000
NODE_4432_length_1146_cov_13.479465	614	694	2	74	80	0.9250000
NODE_4438_length_1145_cov_49.566922	395	470	7	6	75	0.0800000
NODE_4438_length_1145_cov_49.566922	395	470	8	4	75	0.0533333
NODE_4438_length_1145_cov_49.566922	395	470	9	1	75	0.0133333
NODE_4438_length_1145_cov_49.566922	395	470	11	2	75	0.0266667
NODE_4438_length_1145_cov_49.566922	395	470	12	3	75	0.0400000
NODE_4438_length_1145_cov_49.566922	395	470	13	35	75	0.4666667
NODE_4438_length_1145_cov_49.566922	395	470	14	24	75	0.3200000
NODE_4438_length_1145_cov_49.566922	443	523	12	37	80	0.4625000
NODE_4438_length_1145_cov_49.566922	443	523	13	19	80	0.2375000
NODE_4438_length_1145_cov_49.566922	443	523	14	24	80	0.3000000
NODE_4439_length_1145_cov_38.191205	497	576	3	6	79	0.0759494
NODE_4439_length_1145_cov_38.191205	497	576	5	16	79	0.2025317
NODE_4439_length_1145_cov_38.191205	497	576	7	13	79	0.1645570
NODE_4439_length_1145_cov_38.191205	497	576	10	26	79	0.3291139
NODE_4439_length_1145_cov_38.191205	497	576	11	3	79	0.0379747
NODE_4439_length_1145_cov_38.191205	497	576	12	14	79	0.1772152
NODE_4439_length_1145_cov_38.191205	497	576	14	1	79	0.0126582
NODE_4439_length_1145_cov_38.191205	549	629	10	9	80	0.1125000
NODE_4439_length_1145_cov_38.191205	549	629	11	3	80	0.0375000
NODE_4439_length_1145_cov_38.191205	549	629	12	14	80	0.1750000
NODE_4439_length_1145_cov_38.191205	549	629	14	6	80	0.0750000
NODE_4439_length_1145_cov_38.191205	549	629	15	11	80	0.1375000
NODE_4439_length_1145_cov_38.191205	549	629	16	2	80	0.0250000
NODE_4439_length_1145_cov_38.191205	549	629	17	1	80	0.0125000
NODE_4439_length_1145_cov_38.191205	549	629	18	34	80	0.4250000
NODE_4440_length_1145_cov_26.929254	468	548	1	9	80	0.1125000
NODE_4440_length_1145_cov_26.929254	468	548	2	49	80	0.6125000
NODE_4440_length_1145_cov_26.929254	468	548	3	22	80	0.2750000
NODE_4440_length_1145_cov_26.929254	521	601	2	25	80	0.3125000
NODE_4440_length_1145_cov_26.929254	521	601	3	55	80	0.6875000
NODE_4441_length_1145_cov_20.121415	508	588	3	31	80	0.3875000
NODE_4441_length_1145_cov_20.121415	508	588	4	47	80	0.5875000
NODE_4441_length_1145_cov_20.121415	508	588	6	2	80	0.0250000
NODE_4441_length_1145_cov_20.121415	561	641	3	22	80	0.2750000
NODE_4441_length_1145_cov_20.121415	561	641	4	56	80	0.7000000
NODE_4441_length_1145_cov_20.121415	561	641	6	2	80	0.0250000
NODE_4442_length_1145_cov_11.753346	527	605	0	20	78	0.2564103
NODE_4442_length_1145_cov_11.753346	527	605	2	58	78	0.7435898
NODE_4442_length_1145_cov_11.753346	578	659	0	11	81	0.1358025
NODE_4442_length_1145_cov_11.753346	578	659	2	70	81	0.8641976
NODE_4443_length_1145_cov_9.571702	93	173	2	80	80	1.0000000
NODE_4443_length_1145_cov_9.571702	146	226	2	32	80	0.4000000
NODE_4443_length_1145_cov_9.571702	146	226	3	48	80	0.6000000
NODE_4455_length_1143_cov_42.255747	380	460	0	10	80	0.1250000
NODE_4455_length_1143_cov_42.255747	380	460	1	16	80	0.2000000
NODE_4455_length_1143_cov_42.255747	380	460	2	8	80	0.1000000
NODE_4455_length_1143_cov_42.255747	380	460	3	28	80	0.3500000
NODE_4455_length_1143_cov_42.255747	380	460	4	18	80	0.2250000
NODE_4455_length_1143_cov_42.255747	433	513	3	9	80	0.1125000
NODE_4455_length_1143_cov_42.255747	433	513	4	19	80	0.2375000
NODE_4455_length_1143_cov_42.255747	433	513	5	27	80	0.3375000
NODE_4455_length_1143_cov_42.255747	433	513	6	12	80	0.1500000
NODE_4455_length_1143_cov_42.255747	433	513	8	13	80	0.1625000
NODE_4455_length_1143_cov_42.255747	509	589	4	9	80	0.1125000
NODE_4455_length_1143_cov_42.255747	509	589	6	14	80	0.1750000
NODE_4455_length_1143_cov_42.255747	509	589	7	2	80	0.0250000
NODE_4455_length_1143_cov_42.255747	509	589	8	32	80	0.4000000
NODE_4455_length_1143_cov_42.255747	509	589	9	23	80	0.2875000
NODE_4455_length_1143_cov_42.255747	562	642	3	35	80	0.4375000
NODE_4455_length_1143_cov_42.255747	562	642	4	27	80	0.3375000
NODE_4455_length_1143_cov_42.255747	562	642	6	14	80	0.1750000
NODE_4455_length_1143_cov_42.255747	562	642	7	2	80	0.0250000
NODE_4455_length_1143_cov_42.255747	562	642	8	2	80	0.0250000
NODE_4456_length_1143_cov_22.076628	526	606	4	3	80	0.0375000
NODE_4456_length_1143_cov_22.076628	526	606	6	45	80	0.5625000
NODE_4456_length_1143_cov_22.076628	526	606	7	32	80	0.4000000
NODE_4456_length_1143_cov_22.076628	579	659	4	13	80	0.1625000
NODE_4456_length_1143_cov_22.076628	579	659	6	39	80	0.4875000
NODE_4456_length_1143_cov_22.076628	579	659	7	28	80	0.3500000
NODE_4457_length_1143_cov_19.106322	565	645	1	2	80	0.0250000
NODE_4457_length_1143_cov_19.106322	565	645	2	3	80	0.0375000
NODE_4457_length_1143_cov_19.106322	565	645	3	3	80	0.0375000
NODE_4457_length_1143_cov_19.106322	565	645	4	1	80	0.0125000
NODE_4457_length_1143_cov_19.106322	565	645	5	1	80	0.0125000
NODE_4457_length_1143_cov_19.106322	565	645	6	42	80	0.5250000
NODE_4457_length_1143_cov_19.106322	565	645	7	20	80	0.2500000
NODE_4457_length_1143_cov_19.106322	565	645	8	3	80	0.0375000
NODE_4457_length_1143_cov_19.106322	565	645	9	5	80	0.0625000
NODE_4457_length_1143_cov_19.106322	618	698	7	19	80	0.2375000
NODE_4457_length_1143_cov_19.106322	618	698	8	11	80	0.1375000
NODE_4457_length_1143_cov_19.106322	618	698	9	50	80	0.6250000
NODE_4458_length_1143_cov_16.223180	638	719	6	15	81	0.1851852
NODE_4458_length_1143_cov_16.223180	638	719	8	4	81	0.0493827
NODE_4458_length_1143_cov_16.223180	638	719	9	4	81	0.0493827
NODE_4458_length_1143_cov_16.223180	638	719	10	7	81	0.0864198
NODE_4458_length_1143_cov_16.223180	638	719	11	8	81	0.0987654
NODE_4458_length_1143_cov_16.223180	638	719	12	43	81	0.5308642
NODE_4458_length_1143_cov_16.223180	692	772	5	4	80	0.0500000
NODE_4458_length_1143_cov_16.223180	692	772	6	9	80	0.1125000
NODE_4458_length_1143_cov_16.223180	692	772	8	2	80	0.0250000
NODE_4458_length_1143_cov_16.223180	692	772	9	24	80	0.3000000
NODE_4458_length_1143_cov_16.223180	692	772	10	10	80	0.1250000
NODE_4458_length_1143_cov_16.223180	692	772	11	11	80	0.1375000
NODE_4458_length_1143_cov_16.223180	692	772	12	20	80	0.2500000
NODE_4459_length_1143_cov_13.961686	634	714	0	80	80	1.0000000
NODE_4459_length_1143_cov_13.961686	687	767	0	80	80	1.0000000
NODE_4459_length_1143_cov_13.961686	763	843	0	80	80	1.0000000
NODE_4459_length_1143_cov_13.961686	816	896	0	80	80	1.0000000
NODE_4460_length_1143_cov_12.782567	328	409	0	18	81	0.2222222
NODE_4460_length_1143_cov_12.782567	328	409	1	63	81	0.7777778
NODE_4460_length_1143_cov_12.782567	381	462	1	81	81	1.0000000
NODE_4460_length_1143_cov_12.782567	458	538	1	14	80	0.1750000
NODE_4460_length_1143_cov_12.782567	458	538	2	6	80	0.0750000
NODE_4460_length_1143_cov_12.782567	458	538	3	60	80	0.7500000
NODE_4460_length_1143_cov_12.782567	511	591	1	12	80	0.1500000
NODE_4460_length_1143_cov_12.782567	511	591	3	68	80	0.8500000
NODE_4461_length_1143_cov_8.287356	692	772	0	15	80	0.1875000
NODE_4461_length_1143_cov_8.287356	692	772	1	65	80	0.8125000
NODE_4461_length_1143_cov_8.287356	745	825	1	80	80	1.0000000
NODE_4463_length_1143_cov_2.197318	988	1057	2	51	69	0.7391304
NODE_4463_length_1143_cov_2.197318	988	1057	6	18	69	0.2608696
NODE_4466_length_1142_cov_28.364334	613	693	0	3	80	0.0375000
NODE_4466_length_1142_cov_28.364334	613	693	1	12	80	0.1500000
NODE_4466_length_1142_cov_28.364334	613	693	2	65	80	0.8125000
NODE_4466_length_1142_cov_28.364334	666	746	0	56	80	0.7000000
NODE_4466_length_1142_cov_28.364334	666	746	1	12	80	0.1500000
NODE_4466_length_1142_cov_28.364334	666	746	2	12	80	0.1500000
NODE_4467_length_1142_cov_21.669223	518	598	4	4	80	0.0500000
NODE_4467_length_1142_cov_21.669223	518	598	5	14	80	0.1750000
NODE_4467_length_1142_cov_21.669223	518	598	6	8	80	0.1000000
NODE_4467_length_1142_cov_21.669223	518	598	7	8	80	0.1000000
NODE_4467_length_1142_cov_21.669223	518	598	9	3	80	0.0375000
NODE_4467_length_1142_cov_21.669223	518	598	11	9	80	0.1125000
NODE_4467_length_1142_cov_21.669223	518	598	12	30	80	0.3750000
NODE_4467_length_1142_cov_21.669223	518	598	13	4	80	0.0500000
NODE_4467_length_1142_cov_21.669223	571	651	9	3	80	0.0375000
NODE_4467_length_1142_cov_21.669223	571	651	10	11	80	0.1375000
NODE_4467_length_1142_cov_21.669223	571	651	11	4	80	0.0500000
NODE_4467_length_1142_cov_21.669223	571	651	12	58	80	0.7250000
NODE_4467_length_1142_cov_21.669223	571	651	13	4	80	0.0500000
NODE_4468_length_1142_cov_19.007670	411	491	3	2	80	0.0250000
NODE_4468_length_1142_cov_19.007670	411	491	4	60	80	0.7500000
NODE_4468_length_1142_cov_19.007670	411	491	6	14	80	0.1750000
NODE_4468_length_1142_cov_19.007670	411	491	7	4	80	0.0500000
NODE_4468_length_1142_cov_19.007670	464	544	4	9	80	0.1125000
NODE_4468_length_1142_cov_19.007670	464	544	5	32	80	0.4000000
NODE_4468_length_1142_cov_19.007670	464	544	6	14	80	0.1750000
NODE_4468_length_1142_cov_19.007670	464	544	7	12	80	0.1500000
NODE_4468_length_1142_cov_19.007670	464	544	8	13	80	0.1625000
NODE_4474_length_1141_cov_12.500960	17	97	1	12	80	0.1500000
NODE_4474_length_1141_cov_12.500960	17	97	3	10	80	0.1250000
NODE_4474_length_1141_cov_12.500960	17	97	5	58	80	0.7250000
NODE_4474_length_1141_cov_12.500960	17	97	1	12	80	0.1500000
NODE_4474_length_1141_cov_12.500960	17	97	3	10	80	0.1250000
NODE_4474_length_1141_cov_12.500960	17	97	5	58	80	0.7250000
NODE_4474_length_1141_cov_12.500960	17	97	1	12	80	0.1500000
NODE_4474_length_1141_cov_12.500960	17	97	3	10	80	0.1250000
NODE_4474_length_1141_cov_12.500960	17	97	5	58	80	0.7250000
NODE_4474_length_1141_cov_12.500960	17	97	1	12	80	0.1500000
NODE_4474_length_1141_cov_12.500960	17	97	3	10	80	0.1250000
NODE_4474_length_1141_cov_12.500960	17	97	5	58	80	0.7250000
NODE_4474_length_1141_cov_12.500960	70	132	3	10	62	0.1612903
NODE_4474_length_1141_cov_12.500960	70	132	4	1	62	0.0161290
NODE_4474_length_1141_cov_12.500960	70	132	5	51	62	0.8225806
NODE_4474_length_1141_cov_12.500960	70	132	3	10	62	0.1612903
NODE_4474_length_1141_cov_12.500960	70	132	4	1	62	0.0161290
NODE_4474_length_1141_cov_12.500960	70	132	5	51	62	0.8225806
NODE_4474_length_1141_cov_12.500960	70	132	3	10	62	0.1612903
NODE_4474_length_1141_cov_12.500960	70	132	4	1	62	0.0161290
NODE_4474_length_1141_cov_12.500960	70	132	5	51	62	0.8225806
NODE_4474_length_1141_cov_12.500960	70	132	3	10	62	0.1612903
NODE_4474_length_1141_cov_12.500960	70	132	4	1	62	0.0161290
NODE_4474_length_1141_cov_12.500960	70	132	5	51	62	0.8225806
NODE_4475_length_1141_cov_7.197697	54	134	0	80	80	1.0000000
NODE_4475_length_1141_cov_7.197697	107	187	0	80	80	1.0000000
NODE_4475_length_1141_cov_7.197697	573	653	1	37	80	0.4625000
NODE_4475_length_1141_cov_7.197697	573	653	3	43	80	0.5375000
NODE_4475_length_1141_cov_7.197697	626	707	1	56	81	0.6913580
NODE_4475_length_1141_cov_7.197697	626	707	2	25	81	0.3086420
NODE_4476_length_1141_cov_5.428023	411	491	1	5	80	0.0625000
NODE_4476_length_1141_cov_5.428023	411	491	2	4	80	0.0500000
NODE_4476_length_1141_cov_5.428023	411	491	3	46	80	0.5750000
NODE_4476_length_1141_cov_5.428023	411	491	4	25	80	0.3125000
NODE_4476_length_1141_cov_5.428023	464	544	3	7	80	0.0875000
NODE_4476_length_1141_cov_5.428023	464	544	4	73	80	0.9125000
NODE_4482_length_1140_cov_39.383285	451	531	10	21	80	0.2625000
NODE_4482_length_1140_cov_39.383285	451	531	11	15	80	0.1875000
NODE_4482_length_1140_cov_39.383285	451	531	12	30	80	0.3750000
NODE_4482_length_1140_cov_39.383285	451	531	13	12	80	0.1500000
NODE_4482_length_1140_cov_39.383285	451	531	14	2	80	0.0250000
NODE_4482_length_1140_cov_39.383285	504	584	8	7	80	0.0875000
NODE_4482_length_1140_cov_39.383285	504	584	9	4	80	0.0500000
NODE_4482_length_1140_cov_39.383285	504	584	10	10	80	0.1250000
NODE_4482_length_1140_cov_39.383285	504	584	11	21	80	0.2625000
NODE_4482_length_1140_cov_39.383285	504	584	12	33	80	0.4125000
NODE_4482_length_1140_cov_39.383285	504	584	13	5	80	0.0625000
NODE_4482_length_1140_cov_39.383285	580	660	8	8	80	0.1000000
NODE_4482_length_1140_cov_39.383285	580	660	9	11	80	0.1375000
NODE_4482_length_1140_cov_39.383285	580	660	10	24	80	0.3000000
NODE_4482_length_1140_cov_39.383285	580	660	11	37	80	0.4625000
NODE_4482_length_1140_cov_39.383285	633	713	7	9	80	0.1125000
NODE_4482_length_1140_cov_39.383285	633	713	8	20	80	0.2500000
NODE_4482_length_1140_cov_39.383285	633	713	9	5	80	0.0625000
NODE_4482_length_1140_cov_39.383285	633	713	10	9	80	0.1125000
NODE_4482_length_1140_cov_39.383285	633	713	11	37	80	0.4625000
NODE_4483_length_1140_cov_19.493756	543	623	4	10	80	0.1250000
NODE_4483_length_1140_cov_19.493756	543	623	6	23	80	0.2875000
NODE_4483_length_1140_cov_19.493756	543	623	7	47	80	0.5875000
NODE_4483_length_1140_cov_19.493756	596	676	2	6	80	0.0750000
NODE_4483_length_1140_cov_19.493756	596	676	3	25	80	0.3125000
NODE_4483_length_1140_cov_19.493756	596	676	4	11	80	0.1375000
NODE_4483_length_1140_cov_19.493756	596	676	6	13	80	0.1625000
NODE_4483_length_1140_cov_19.493756	596	676	7	25	80	0.3125000
NODE_4484_length_1140_cov_18.341018	347	427	2	21	80	0.2625000
NODE_4484_length_1140_cov_18.341018	347	427	3	7	80	0.0875000
NODE_4484_length_1140_cov_18.341018	347	427	4	29	80	0.3625000
NODE_4484_length_1140_cov_18.341018	347	427	6	23	80	0.2875000
NODE_4484_length_1140_cov_18.341018	400	480	4	42	80	0.5250000
NODE_4484_length_1140_cov_18.341018	400	480	5	4	80	0.0500000
NODE_4484_length_1140_cov_18.341018	400	480	6	34	80	0.4250000
NODE_4484_length_1140_cov_18.341018	476	556	1	31	80	0.3875000
NODE_4484_length_1140_cov_18.341018	476	556	2	7	80	0.0875000
NODE_4484_length_1140_cov_18.341018	476	556	3	35	80	0.4375000
NODE_4484_length_1140_cov_18.341018	476	556	5	7	80	0.0875000
NODE_4484_length_1140_cov_18.341018	529	609	1	80	80	1.0000000
NODE_4494_length_1139_cov_26.812500	410	490	2	32	80	0.4000000
NODE_4494_length_1139_cov_26.812500	410	490	3	48	80	0.6000000
NODE_4494_length_1139_cov_26.812500	463	543	2	4	80	0.0500000
NODE_4494_length_1139_cov_26.812500	463	543	3	28	80	0.3500000
NODE_4494_length_1139_cov_26.812500	463	543	4	48	80	0.6000000
NODE_4494_length_1139_cov_26.812500	539	619	2	4	80	0.0500000
NODE_4494_length_1139_cov_26.812500	539	619	6	9	80	0.1125000
NODE_4494_length_1139_cov_26.812500	539	619	7	27	80	0.3375000
NODE_4494_length_1139_cov_26.812500	539	619	8	40	80	0.5000000
NODE_4494_length_1139_cov_26.812500	592	672	2	20	80	0.2500000
NODE_4494_length_1139_cov_26.812500	592	672	4	11	80	0.1375000
NODE_4494_length_1139_cov_26.812500	592	672	5	16	80	0.2000000
NODE_4494_length_1139_cov_26.812500	592	672	7	33	80	0.4125000
NODE_4495_length_1139_cov_26.323077	308	388	4	7	80	0.0875000
NODE_4495_length_1139_cov_26.323077	308	388	5	73	80	0.9125000
NODE_4495_length_1139_cov_26.323077	361	441	3	27	80	0.3375000
NODE_4495_length_1139_cov_26.323077	361	441	4	8	80	0.1000000
NODE_4495_length_1139_cov_26.323077	361	441	5	45	80	0.5625000
NODE_4495_length_1139_cov_26.323077	437	517	3	53	80	0.6625000
NODE_4495_length_1139_cov_26.323077	437	517	4	18	80	0.2250000
NODE_4495_length_1139_cov_26.323077	437	517	5	9	80	0.1125000
NODE_4495_length_1139_cov_26.323077	490	570	3	38	80	0.4750000
NODE_4495_length_1139_cov_26.323077	490	570	4	42	80	0.5250000
NODE_4496_length_1139_cov_15.223077	530	610	2	26	80	0.3250000
NODE_4496_length_1139_cov_15.223077	530	610	3	30	80	0.3750000
NODE_4496_length_1139_cov_15.223077	530	610	5	24	80	0.3000000
NODE_4496_length_1139_cov_15.223077	583	663	3	3	80	0.0375000
NODE_4496_length_1139_cov_15.223077	583	663	4	26	80	0.3250000
NODE_4496_length_1139_cov_15.223077	583	663	5	41	80	0.5125000
NODE_4496_length_1139_cov_15.223077	583	663	6	10	80	0.1250000
NODE_4505_length_1138_cov_74.599615	480	560	3	11	80	0.1375000
NODE_4505_length_1138_cov_74.599615	480	560	4	5	80	0.0625000
NODE_4505_length_1138_cov_74.599615	480	560	6	41	80	0.5125000
NODE_4505_length_1138_cov_74.599615	480	560	7	23	80	0.2875000
NODE_4505_length_1138_cov_74.599615	533	613	6	11	80	0.1375000
NODE_4505_length_1138_cov_74.599615	533	613	7	69	80	0.8625000
NODE_4505_length_1138_cov_74.599615	609	689	6	2	80	0.0250000
NODE_4505_length_1138_cov_74.599615	609	689	7	9	80	0.1125000
NODE_4505_length_1138_cov_74.599615	609	689	8	4	80	0.0500000
NODE_4505_length_1138_cov_74.599615	609	689	9	4	80	0.0500000
NODE_4505_length_1138_cov_74.599615	609	689	10	2	80	0.0250000
NODE_4505_length_1138_cov_74.599615	609	689	11	45	80	0.5625000
NODE_4505_length_1138_cov_74.599615	609	689	13	9	80	0.1125000
NODE_4505_length_1138_cov_74.599615	609	689	14	5	80	0.0625000
NODE_4505_length_1138_cov_74.599615	662	742	9	10	80	0.1250000
NODE_4505_length_1138_cov_74.599615	662	742	10	45	80	0.5625000
NODE_4505_length_1138_cov_74.599615	662	742	11	25	80	0.3125000
NODE_4506_length_1138_cov_29.407122	559	639	6	33	80	0.4125000
NODE_4506_length_1138_cov_29.407122	559	639	7	27	80	0.3375000
NODE_4506_length_1138_cov_29.407122	559	639	8	20	80	0.2500000
NODE_4506_length_1138_cov_29.407122	612	692	2	8	80	0.1000000
NODE_4506_length_1138_cov_29.407122	612	692	3	6	80	0.0750000
NODE_4506_length_1138_cov_29.407122	612	692	4	1	80	0.0125000
NODE_4506_length_1138_cov_29.407122	612	692	5	8	80	0.1000000
NODE_4506_length_1138_cov_29.407122	612	692	6	31	80	0.3875000
NODE_4506_length_1138_cov_29.407122	612	692	7	26	80	0.3250000
NODE_4506_length_1138_cov_29.407122	688	768	1	59	80	0.7375000
NODE_4506_length_1138_cov_29.407122	688	768	2	21	80	0.2625000
NODE_4506_length_1138_cov_29.407122	741	821	0	25	80	0.3125000
NODE_4506_length_1138_cov_29.407122	741	821	1	55	80	0.6875000
NODE_4507_length_1138_cov_18.326275	454	534	1	4	80	0.0500000
NODE_4507_length_1138_cov_18.326275	454	534	2	26	80	0.3250000
NODE_4507_length_1138_cov_18.326275	454	534	3	47	80	0.5875000
NODE_4507_length_1138_cov_18.326275	454	534	4	3	80	0.0375000
NODE_4507_length_1138_cov_18.326275	507	587	1	10	80	0.1250000
NODE_4507_length_1138_cov_18.326275	507	587	2	70	80	0.8750000
NODE_4507_length_1138_cov_18.326275	583	663	2	24	80	0.3000000
NODE_4507_length_1138_cov_18.326275	583	663	3	56	80	0.7000000
NODE_4507_length_1138_cov_18.326275	636	716	2	44	80	0.5500000
NODE_4507_length_1138_cov_18.326275	636	716	3	36	80	0.4500000
NODE_4509_length_1138_cov_11.834456	291	371	0	18	80	0.2250000
NODE_4509_length_1138_cov_11.834456	291	371	1	8	80	0.1000000
NODE_4509_length_1138_cov_11.834456	291	371	2	20	80	0.2500000
NODE_4509_length_1138_cov_11.834456	291	371	4	34	80	0.4250000
NODE_4509_length_1138_cov_11.834456	344	424	3	1	80	0.0125000
NODE_4509_length_1138_cov_11.834456	344	424	4	28	80	0.3500000
NODE_4509_length_1138_cov_11.834456	344	424	5	51	80	0.6375000
NODE_4510_length_1138_cov_10.923003	318	398	3	1	80	0.0125000
NODE_4510_length_1138_cov_10.923003	318	398	4	11	80	0.1375000
NODE_4510_length_1138_cov_10.923003	318	398	5	38	80	0.4750000
NODE_4510_length_1138_cov_10.923003	318	398	7	6	80	0.0750000
NODE_4510_length_1138_cov_10.923003	318	398	8	8	80	0.1000000
NODE_4510_length_1138_cov_10.923003	318	398	9	16	80	0.2000000
NODE_4510_length_1138_cov_10.923003	371	451	7	5	80	0.0625000
NODE_4510_length_1138_cov_10.923003	371	451	8	39	80	0.4875000
NODE_4510_length_1138_cov_10.923003	371	451	9	36	80	0.4500000
NODE_4517_length_1137_cov_23.983622	470	550	6	32	80	0.4000000
NODE_4517_length_1137_cov_23.983622	470	550	7	10	80	0.1250000
NODE_4517_length_1137_cov_23.983622	470	550	8	19	80	0.2375000
NODE_4517_length_1137_cov_23.983622	470	550	9	19	80	0.2375000
NODE_4517_length_1137_cov_23.983622	523	603	6	15	80	0.1875000
NODE_4517_length_1137_cov_23.983622	523	603	7	13	80	0.1625000
NODE_4517_length_1137_cov_23.983622	523	603	8	35	80	0.4375000
NODE_4517_length_1137_cov_23.983622	523	603	9	17	80	0.2125000
NODE_4517_length_1137_cov_23.983622	599	679	4	8	80	0.1000000
NODE_4517_length_1137_cov_23.983622	599	679	5	9	80	0.1125000
NODE_4517_length_1137_cov_23.983622	599	679	6	13	80	0.1625000
NODE_4517_length_1137_cov_23.983622	599	679	7	6	80	0.0750000
NODE_4517_length_1137_cov_23.983622	599	679	8	37	80	0.4625000
NODE_4517_length_1137_cov_23.983622	599	679	9	7	80	0.0875000
NODE_4517_length_1137_cov_23.983622	652	732	2	9	80	0.1125000
NODE_4517_length_1137_cov_23.983622	652	732	3	13	80	0.1625000
NODE_4517_length_1137_cov_23.983622	652	732	4	39	80	0.4875000
NODE_4517_length_1137_cov_23.983622	652	732	5	9	80	0.1125000
NODE_4517_length_1137_cov_23.983622	652	732	6	10	80	0.1250000
NODE_4518_length_1137_cov_22.877649	405	485	0	14	80	0.1750000
NODE_4518_length_1137_cov_22.877649	405	485	2	8	80	0.1000000
NODE_4518_length_1137_cov_22.877649	405	485	3	9	80	0.1125000
NODE_4518_length_1137_cov_22.877649	405	485	5	42	80	0.5250000
NODE_4518_length_1137_cov_22.877649	405	485	6	7	80	0.0875000
NODE_4518_length_1137_cov_22.877649	458	538	5	20	80	0.2500000
NODE_4518_length_1137_cov_22.877649	458	538	6	60	80	0.7500000
NODE_4518_length_1137_cov_22.877649	534	614	1	37	80	0.4625000
NODE_4518_length_1137_cov_22.877649	534	614	2	21	80	0.2625000
NODE_4518_length_1137_cov_22.877649	534	614	4	9	80	0.1125000
NODE_4518_length_1137_cov_22.877649	534	614	6	13	80	0.1625000
NODE_4518_length_1137_cov_22.877649	587	667	0	40	80	0.5000000
NODE_4518_length_1137_cov_22.877649	587	667	1	40	80	0.5000000
NODE_4519_length_1137_cov_21.570328	383	463	4	40	80	0.5000000
NODE_4519_length_1137_cov_21.570328	383	463	5	40	80	0.5000000
NODE_4519_length_1137_cov_21.570328	436	516	3	10	80	0.1250000
NODE_4519_length_1137_cov_21.570328	436	516	4	70	80	0.8750000
NODE_4520_length_1137_cov_18.560694	665	745	6	18	80	0.2250000
NODE_4520_length_1137_cov_18.560694	665	745	7	16	80	0.2000000
NODE_4520_length_1137_cov_18.560694	665	745	9	14	80	0.1750000
NODE_4520_length_1137_cov_18.560694	665	745	10	32	80	0.4000000
NODE_4520_length_1137_cov_18.560694	718	798	5	3	80	0.0375000
NODE_4520_length_1137_cov_18.560694	718	798	6	12	80	0.1500000
NODE_4520_length_1137_cov_18.560694	718	798	7	7	80	0.0875000
NODE_4520_length_1137_cov_18.560694	718	798	8	25	80	0.3125000
NODE_4520_length_1137_cov_18.560694	718	798	10	33	80	0.4125000
NODE_4521_length_1137_cov_18.505780	557	637	0	61	80	0.7625000
NODE_4521_length_1137_cov_18.505780	557	637	1	19	80	0.2375000
NODE_4521_length_1137_cov_18.505780	610	690	0	8	80	0.1000000
NODE_4521_length_1137_cov_18.505780	610	690	1	63	80	0.7875000
NODE_4521_length_1137_cov_18.505780	610	690	3	9	80	0.1125000
NODE_4521_length_1137_cov_18.505780	686	766	3	80	80	1.0000000
NODE_4521_length_1137_cov_18.505780	739	819	0	44	80	0.5500000
NODE_4521_length_1137_cov_18.505780	739	819	1	8	80	0.1000000
NODE_4521_length_1137_cov_18.505780	739	819	3	28	80	0.3500000
NODE_4523_length_1137_cov_11.866089	313	393	0	2	80	0.0250000
NODE_4523_length_1137_cov_11.866089	313	393	1	6	80	0.0750000
NODE_4523_length_1137_cov_11.866089	313	393	2	61	80	0.7625000
NODE_4523_length_1137_cov_11.866089	313	393	3	1	80	0.0125000
NODE_4523_length_1137_cov_11.866089	313	393	4	10	80	0.1250000
NODE_4523_length_1137_cov_11.866089	366	446	2	16	80	0.2000000
NODE_4523_length_1137_cov_11.866089	366	446	3	1	80	0.0125000
NODE_4523_length_1137_cov_11.866089	366	446	4	46	80	0.5750000
NODE_4523_length_1137_cov_11.866089	366	446	5	17	80	0.2125000
NODE_4523_length_1137_cov_11.866089	442	522	5	4	80	0.0500000
NODE_4523_length_1137_cov_11.866089	442	522	6	1	80	0.0125000
NODE_4523_length_1137_cov_11.866089	442	522	7	17	80	0.2125000
NODE_4523_length_1137_cov_11.866089	442	522	8	58	80	0.7250000
NODE_4523_length_1137_cov_11.866089	495	575	4	10	80	0.1250000
NODE_4523_length_1137_cov_11.866089	495	575	6	32	80	0.4000000
NODE_4523_length_1137_cov_11.866089	495	575	7	1	80	0.0125000
NODE_4523_length_1137_cov_11.866089	495	575	8	37	80	0.4625000
NODE_4524_length_1137_cov_5.594412	144	224	1	34	80	0.4250000
NODE_4524_length_1137_cov_5.594412	144	224	2	46	80	0.5750000
NODE_4524_length_1137_cov_5.594412	197	277	2	80	80	1.0000000
NODE_4532_length_1136_cov_42.827387	445	525	1	10	80	0.1250000
NODE_4532_length_1136_cov_42.827387	445	525	3	70	80	0.8750000
NODE_4532_length_1136_cov_42.827387	498	578	3	50	80	0.6250000
NODE_4532_length_1136_cov_42.827387	498	578	8	4	80	0.0500000
NODE_4532_length_1136_cov_42.827387	498	578	9	26	80	0.3250000
NODE_4532_length_1136_cov_42.827387	574	654	6	3	80	0.0375000
NODE_4532_length_1136_cov_42.827387	574	654	7	13	80	0.1625000
NODE_4532_length_1136_cov_42.827387	574	654	8	24	80	0.3000000
NODE_4532_length_1136_cov_42.827387	574	654	9	12	80	0.1500000
NODE_4532_length_1136_cov_42.827387	574	654	10	28	80	0.3500000
NODE_4532_length_1136_cov_42.827387	627	707	4	5	80	0.0625000
NODE_4532_length_1136_cov_42.827387	627	707	5	31	80	0.3875000
NODE_4532_length_1136_cov_42.827387	627	707	9	1	80	0.0125000
NODE_4532_length_1136_cov_42.827387	627	707	10	43	80	0.5375000
NODE_4533_length_1136_cov_30.940212	534	614	1	42	80	0.5250000
NODE_4533_length_1136_cov_30.940212	534	614	2	38	80	0.4750000
NODE_4533_length_1136_cov_30.940212	587	667	1	43	80	0.5375000
NODE_4533_length_1136_cov_30.940212	587	667	2	11	80	0.1375000
NODE_4533_length_1136_cov_30.940212	587	667	3	21	80	0.2625000
NODE_4533_length_1136_cov_30.940212	587	667	4	5	80	0.0625000
NODE_4533_length_1136_cov_30.940212	663	743	3	26	80	0.3250000
NODE_4533_length_1136_cov_30.940212	663	743	4	41	80	0.5125000
NODE_4533_length_1136_cov_30.940212	663	743	5	13	80	0.1625000
NODE_4533_length_1136_cov_30.940212	716	796	3	10	80	0.1250000
NODE_4533_length_1136_cov_30.940212	716	796	4	4	80	0.0500000
NODE_4533_length_1136_cov_30.940212	716	796	5	17	80	0.2125000
NODE_4533_length_1136_cov_30.940212	716	796	6	8	80	0.1000000
NODE_4533_length_1136_cov_30.940212	716	796	7	5	80	0.0625000
NODE_4533_length_1136_cov_30.940212	716	796	8	36	80	0.4500000
NODE_4534_length_1136_cov_30.797493	557	637	13	23	80	0.2875000
NODE_4534_length_1136_cov_30.797493	557	637	14	17	80	0.2125000
NODE_4534_length_1136_cov_30.797493	557	637	15	19	80	0.2375000
NODE_4534_length_1136_cov_30.797493	557	637	16	15	80	0.1875000
NODE_4534_length_1136_cov_30.797493	557	637	17	6	80	0.0750000
NODE_4534_length_1136_cov_30.797493	610	691	12	38	81	0.4691358
NODE_4534_length_1136_cov_30.797493	610	691	14	10	81	0.1234568
NODE_4534_length_1136_cov_30.797493	610	691	15	26	81	0.3209876
NODE_4534_length_1136_cov_30.797493	610	691	16	7	81	0.0864198
NODE_4534_length_1136_cov_30.797493	687	767	2	1	80	0.0125000
NODE_4534_length_1136_cov_30.797493	687	767	3	16	80	0.2000000
NODE_4534_length_1136_cov_30.797493	687	767	4	9	80	0.1125000
NODE_4534_length_1136_cov_30.797493	687	767	5	11	80	0.1375000
NODE_4534_length_1136_cov_30.797493	687	767	6	9	80	0.1125000
NODE_4534_length_1136_cov_30.797493	687	767	8	9	80	0.1125000
NODE_4534_length_1136_cov_30.797493	687	767	9	13	80	0.1625000
NODE_4534_length_1136_cov_30.797493	687	767	11	8	80	0.1000000
NODE_4534_length_1136_cov_30.797493	687	767	12	4	80	0.0500000
NODE_4534_length_1136_cov_30.797493	740	820	1	34	80	0.4250000
NODE_4534_length_1136_cov_30.797493	740	820	2	20	80	0.2500000
NODE_4534_length_1136_cov_30.797493	740	820	3	16	80	0.2000000
NODE_4534_length_1136_cov_30.797493	740	820	4	9	80	0.1125000
NODE_4534_length_1136_cov_30.797493	740	820	5	1	80	0.0125000
NODE_4535_length_1136_cov_23.142719	704	784	7	11	80	0.1375000
NODE_4535_length_1136_cov_23.142719	704	784	9	2	80	0.0250000
NODE_4535_length_1136_cov_23.142719	704	784	10	57	80	0.7125000
NODE_4535_length_1136_cov_23.142719	704	784	11	8	80	0.1000000
NODE_4535_length_1136_cov_23.142719	704	784	13	2	80	0.0250000
NODE_4535_length_1136_cov_23.142719	757	837	8	25	80	0.3125000
NODE_4535_length_1136_cov_23.142719	757	837	9	5	80	0.0625000
NODE_4535_length_1136_cov_23.142719	757	837	10	29	80	0.3625000
NODE_4535_length_1136_cov_23.142719	757	837	11	21	80	0.2625000
NODE_4536_length_1136_cov_21.798457	570	651	2	11	81	0.1358025
NODE_4536_length_1136_cov_21.798457	570	651	3	33	81	0.4074074
NODE_4536_length_1136_cov_21.798457	570	651	4	37	81	0.4567901
NODE_4536_length_1136_cov_21.798457	624	704	3	64	80	0.8000000
NODE_4536_length_1136_cov_21.798457	624	704	4	16	80	0.2000000
NODE_4537_length_1136_cov_21.109932	460	532	0	29	72	0.4027778
NODE_4537_length_1136_cov_21.109932	460	532	1	41	72	0.5694444
NODE_4537_length_1136_cov_21.109932	460	532	2	2	72	0.0277778
NODE_4537_length_1136_cov_21.109932	505	585	0	25	80	0.3125000
NODE_4537_length_1136_cov_21.109932	505	585	2	16	80	0.2000000
NODE_4537_length_1136_cov_21.109932	505	585	4	4	80	0.0500000
NODE_4537_length_1136_cov_21.109932	505	585	5	8	80	0.1000000
NODE_4537_length_1136_cov_21.109932	505	585	6	27	80	0.3375000
NODE_4538_length_1136_cov_20.528447	19	99	0	14	80	0.1750000
NODE_4538_length_1136_cov_20.528447	19	99	2	9	80	0.1125000
NODE_4538_length_1136_cov_20.528447	19	99	4	25	80	0.3125000
NODE_4538_length_1136_cov_20.528447	19	99	5	10	80	0.1250000
NODE_4538_length_1136_cov_20.528447	19	99	6	22	80	0.2750000
NODE_4538_length_1136_cov_20.528447	19	99	0	14	80	0.1750000
NODE_4538_length_1136_cov_20.528447	19	99	2	9	80	0.1125000
NODE_4538_length_1136_cov_20.528447	19	99	4	25	80	0.3125000
NODE_4538_length_1136_cov_20.528447	19	99	5	10	80	0.1250000
NODE_4538_length_1136_cov_20.528447	19	99	6	22	80	0.2750000
NODE_4538_length_1136_cov_20.528447	28	99	0	5	71	0.0704225
NODE_4538_length_1136_cov_20.528447	28	99	2	9	71	0.1267606
NODE_4538_length_1136_cov_20.528447	28	99	4	25	71	0.3521127
NODE_4538_length_1136_cov_20.528447	28	99	5	10	71	0.1408451
NODE_4538_length_1136_cov_20.528447	28	99	6	22	71	0.3098592
NODE_4538_length_1136_cov_20.528447	877	912	0	16	35	0.4571429
NODE_4538_length_1136_cov_20.528447	877	912	1	19	35	0.5428572
NODE_4538_length_1136_cov_20.528447	879	921	0	14	42	0.3333333
NODE_4538_length_1136_cov_20.528447	879	921	1	27	42	0.6428571
NODE_4538_length_1136_cov_20.528447	879	921	2	1	42	0.0238095
NODE_4539_length_1136_cov_14.921890	657	737	0	80	80	1.0000000
NODE_4539_length_1136_cov_14.921890	710	790	0	80	80	1.0000000
NODE_4556_length_1135_cov_100.121622	454	534	9	22	80	0.2750000
NODE_4556_length_1135_cov_100.121622	454	534	10	9	80	0.1125000
NODE_4556_length_1135_cov_100.121622	454	534	12	29	80	0.3625000
NODE_4556_length_1135_cov_100.121622	454	534	13	18	80	0.2250000
NODE_4556_length_1135_cov_100.121622	454	534	14	2	80	0.0250000
NODE_4556_length_1135_cov_100.121622	507	587	9	27	80	0.3375000
NODE_4556_length_1135_cov_100.121622	507	587	10	5	80	0.0625000
NODE_4556_length_1135_cov_100.121622	507	587	13	7	80	0.0875000
NODE_4556_length_1135_cov_100.121622	507	587	14	20	80	0.2500000
NODE_4556_length_1135_cov_100.121622	507	587	15	21	80	0.2625000
NODE_4556_length_1135_cov_100.121622	583	663	10	4	80	0.0500000
NODE_4556_length_1135_cov_100.121622	583	663	11	21	80	0.2625000
NODE_4556_length_1135_cov_100.121622	583	663	12	3	80	0.0375000
NODE_4556_length_1135_cov_100.121622	583	663	13	20	80	0.2500000
NODE_4556_length_1135_cov_100.121622	583	663	14	21	80	0.2625000
NODE_4556_length_1135_cov_100.121622	583	663	15	3	80	0.0375000
NODE_4556_length_1135_cov_100.121622	583	663	16	8	80	0.1000000
NODE_4556_length_1135_cov_100.121622	636	719	9	17	83	0.2048193
NODE_4556_length_1135_cov_100.121622	636	719	10	4	83	0.0481928
NODE_4556_length_1135_cov_100.121622	636	719	11	40	83	0.4819277
NODE_4556_length_1135_cov_100.121622	636	719	12	5	83	0.0602410
NODE_4556_length_1135_cov_100.121622	636	719	13	15	83	0.1807229
NODE_4556_length_1135_cov_100.121622	636	719	14	2	83	0.0240964
NODE_4557_length_1135_cov_34.523166	313	393	11	11	80	0.1375000
NODE_4557_length_1135_cov_34.523166	313	393	12	32	80	0.4000000
NODE_4557_length_1135_cov_34.523166	313	393	13	4	80	0.0500000
NODE_4557_length_1135_cov_34.523166	313	393	14	4	80	0.0500000
NODE_4557_length_1135_cov_34.523166	313	393	15	29	80	0.3625000
NODE_4557_length_1135_cov_34.523166	366	446	4	4	80	0.0500000
NODE_4557_length_1135_cov_34.523166	366	446	8	3	80	0.0375000
NODE_4557_length_1135_cov_34.523166	366	446	9	25	80	0.3125000
NODE_4557_length_1135_cov_34.523166	366	446	10	13	80	0.1625000
NODE_4557_length_1135_cov_34.523166	366	446	11	19	80	0.2375000
NODE_4557_length_1135_cov_34.523166	366	446	12	16	80	0.2000000
NODE_4558_length_1135_cov_20.735521	484	564	8	48	80	0.6000000
NODE_4558_length_1135_cov_20.735521	484	564	9	32	80	0.4000000
NODE_4558_length_1135_cov_20.735521	537	617	5	14	80	0.1750000
NODE_4558_length_1135_cov_20.735521	537	617	7	5	80	0.0625000
NODE_4558_length_1135_cov_20.735521	537	617	8	6	80	0.0750000
NODE_4558_length_1135_cov_20.735521	537	617	9	43	80	0.5375000
NODE_4558_length_1135_cov_20.735521	537	617	10	12	80	0.1500000
NODE_4558_length_1135_cov_20.735521	613	693	2	12	80	0.1500000
NODE_4558_length_1135_cov_20.735521	613	693	3	63	80	0.7875000
NODE_4558_length_1135_cov_20.735521	613	693	5	5	80	0.0625000
NODE_4558_length_1135_cov_20.735521	666	746	0	15	80	0.1875000
NODE_4558_length_1135_cov_20.735521	666	746	1	25	80	0.3125000
NODE_4558_length_1135_cov_20.735521	666	746	2	25	80	0.3125000
NODE_4558_length_1135_cov_20.735521	666	746	3	15	80	0.1875000
NODE_4559_length_1135_cov_9.644788	620	700	6	45	80	0.5625000
NODE_4559_length_1135_cov_9.644788	620	700	7	35	80	0.4375000
NODE_4559_length_1135_cov_9.644788	673	753	2	32	80	0.4000000
NODE_4559_length_1135_cov_9.644788	673	753	3	1	80	0.0125000
NODE_4559_length_1135_cov_9.644788	673	753	4	9	80	0.1125000
NODE_4559_length_1135_cov_9.644788	673	753	6	37	80	0.4625000
NODE_4559_length_1135_cov_9.644788	673	753	7	1	80	0.0125000
NODE_4562_length_1135_cov_2.990347	349	429	1	80	80	1.0000000
NODE_4562_length_1135_cov_2.990347	402	482	1	37	80	0.4625000
NODE_4562_length_1135_cov_2.990347	402	482	3	43	80	0.5375000
NODE_4571_length_1134_cov_34.784541	478	558	3	20	80	0.2500000
NODE_4571_length_1134_cov_34.784541	478	558	4	59	80	0.7375000
NODE_4571_length_1134_cov_34.784541	478	558	5	1	80	0.0125000
NODE_4571_length_1134_cov_34.784541	531	611	3	11	80	0.1375000
NODE_4571_length_1134_cov_34.784541	531	611	4	41	80	0.5125000
NODE_4571_length_1134_cov_34.784541	531	611	5	28	80	0.3500000
NODE_4571_length_1134_cov_34.784541	607	687	4	4	80	0.0500000
NODE_4571_length_1134_cov_34.784541	607	687	5	7	80	0.0875000
NODE_4571_length_1134_cov_34.784541	607	687	6	6	80	0.0750000
NODE_4571_length_1134_cov_34.784541	607	687	7	4	80	0.0500000
NODE_4571_length_1134_cov_34.784541	607	687	8	42	80	0.5250000
NODE_4571_length_1134_cov_34.784541	607	687	9	17	80	0.2125000
NODE_4571_length_1134_cov_34.784541	660	740	6	23	80	0.2875000
NODE_4571_length_1134_cov_34.784541	660	740	7	7	80	0.0875000
NODE_4571_length_1134_cov_34.784541	660	740	8	35	80	0.4375000
NODE_4571_length_1134_cov_34.784541	660	740	9	15	80	0.1875000
NODE_4572_length_1134_cov_28.524638	511	591	11	8	80	0.1000000
NODE_4572_length_1134_cov_28.524638	511	591	13	72	80	0.9000000
NODE_4572_length_1134_cov_28.524638	564	644	5	14	80	0.1750000
NODE_4572_length_1134_cov_28.524638	564	644	6	11	80	0.1375000
NODE_4572_length_1134_cov_28.524638	564	644	7	3	80	0.0375000
NODE_4572_length_1134_cov_28.524638	564	644	8	3	80	0.0375000
NODE_4572_length_1134_cov_28.524638	564	644	9	4	80	0.0500000
NODE_4572_length_1134_cov_28.524638	564	644	11	26	80	0.3250000
NODE_4572_length_1134_cov_28.524638	564	644	13	19	80	0.2375000
NODE_4572_length_1134_cov_28.524638	640	720	6	27	80	0.3375000
NODE_4572_length_1134_cov_28.524638	640	720	8	14	80	0.1750000
NODE_4572_length_1134_cov_28.524638	640	720	9	39	80	0.4875000
NODE_4572_length_1134_cov_28.524638	693	773	0	4	80	0.0500000
NODE_4572_length_1134_cov_28.524638	693	773	1	9	80	0.1125000
NODE_4572_length_1134_cov_28.524638	693	773	7	13	80	0.1625000
NODE_4572_length_1134_cov_28.524638	693	773	9	54	80	0.6750000
NODE_4576_length_1134_cov_2.619324	606	686	1	9	80	0.1125000
NODE_4576_length_1134_cov_2.619324	606	686	2	53	80	0.6625000
NODE_4576_length_1134_cov_2.619324	606	686	3	18	80	0.2250000
NODE_4576_length_1134_cov_2.619324	659	739	1	9	80	0.1125000
NODE_4576_length_1134_cov_2.619324	659	739	2	50	80	0.6250000
NODE_4576_length_1134_cov_2.619324	659	739	3	21	80	0.2625000
NODE_4584_length_1133_cov_5.563830	292	372	0	7	80	0.0875000
NODE_4584_length_1133_cov_5.563830	292	372	2	73	80	0.9125000
NODE_4584_length_1133_cov_5.563830	345	425	0	4	80	0.0500000
NODE_4584_length_1133_cov_5.563830	345	425	2	76	80	0.9500000
NODE_4584_length_1133_cov_5.563830	904	966	0	62	62	1.0000000
NODE_4592_length_1132_cov_23.121007	485	565	0	63	80	0.7875000
NODE_4592_length_1132_cov_23.121007	485	565	1	17	80	0.2125000
NODE_4592_length_1132_cov_23.121007	538	618	0	10	80	0.1250000
NODE_4592_length_1132_cov_23.121007	538	618	1	70	80	0.8750000
NODE_4592_length_1132_cov_23.121007	618	664	1	46	46	1.0000000
NODE_4592_length_1132_cov_23.121007	700	751	0	51	51	1.0000000
NODE_4593_length_1132_cov_19.377541	595	675	2	41	80	0.5125000
NODE_4593_length_1132_cov_19.377541	595	675	3	12	80	0.1500000
NODE_4593_length_1132_cov_19.377541	595	675	4	27	80	0.3375000
NODE_4593_length_1132_cov_19.377541	648	728	4	49	80	0.6125000
NODE_4593_length_1132_cov_19.377541	648	728	6	31	80	0.3875000
NODE_4594_length_1132_cov_18.872217	363	443	2	7	80	0.0875000
NODE_4594_length_1132_cov_18.872217	363	443	4	2	80	0.0250000
NODE_4594_length_1132_cov_18.872217	363	443	5	36	80	0.4500000
NODE_4594_length_1132_cov_18.872217	363	443	8	4	80	0.0500000
NODE_4594_length_1132_cov_18.872217	363	443	10	31	80	0.3875000
NODE_4594_length_1132_cov_18.872217	416	496	9	39	80	0.4875000
NODE_4594_length_1132_cov_18.872217	416	496	10	41	80	0.5125000
NODE_4595_length_1132_cov_11.242982	474	554	2	80	80	1.0000000
NODE_4595_length_1132_cov_11.242982	527	607	0	8	80	0.1000000
NODE_4595_length_1132_cov_11.242982	527	607	2	72	80	0.9000000
NODE_4596_length_1132_cov_7.356244	354	434	2	26	80	0.3250000
NODE_4596_length_1132_cov_7.356244	354	434	3	13	80	0.1625000
NODE_4596_length_1132_cov_7.356244	354	434	4	26	80	0.3250000
NODE_4596_length_1132_cov_7.356244	354	434	6	15	80	0.1875000
NODE_4596_length_1132_cov_7.356244	407	487	4	12	80	0.1500000
NODE_4596_length_1132_cov_7.356244	407	487	6	68	80	0.8500000
NODE_4597_length_1132_cov_6.214908	269	349	2	80	80	1.0000000
NODE_4597_length_1132_cov_6.214908	322	402	1	6	80	0.0750000
NODE_4597_length_1132_cov_6.214908	322	402	2	74	80	0.9250000
NODE_4606_length_1131_cov_36.161822	478	558	3	6	80	0.0750000
NODE_4606_length_1131_cov_36.161822	478	558	5	19	80	0.2375000
NODE_4606_length_1131_cov_36.161822	478	558	6	2	80	0.0250000
NODE_4606_length_1131_cov_36.161822	478	558	7	29	80	0.3625000
NODE_4606_length_1131_cov_36.161822	478	558	8	3	80	0.0375000
NODE_4606_length_1131_cov_36.161822	478	558	10	14	80	0.1750000
NODE_4606_length_1131_cov_36.161822	478	558	11	7	80	0.0875000
NODE_4606_length_1131_cov_36.161822	531	611	6	2	80	0.0250000
NODE_4606_length_1131_cov_36.161822	531	611	7	3	80	0.0375000
NODE_4606_length_1131_cov_36.161822	531	611	8	5	80	0.0625000
NODE_4606_length_1131_cov_36.161822	531	611	10	57	80	0.7125000
NODE_4606_length_1131_cov_36.161822	531	611	11	13	80	0.1625000
NODE_4606_length_1131_cov_36.161822	607	687	4	11	80	0.1375000
NODE_4606_length_1131_cov_36.161822	607	687	6	34	80	0.4250000
NODE_4606_length_1131_cov_36.161822	607	687	7	2	80	0.0250000
NODE_4606_length_1131_cov_36.161822	607	687	8	33	80	0.4125000
NODE_4606_length_1131_cov_36.161822	660	740	3	39	80	0.4875000
NODE_4606_length_1131_cov_36.161822	660	740	4	25	80	0.3125000
NODE_4606_length_1131_cov_36.161822	660	740	6	16	80	0.2000000
NODE_4607_length_1131_cov_31.907946	390	470	0	80	80	1.0000000
NODE_4607_length_1131_cov_31.907946	443	523	0	80	80	1.0000000
NODE_4607_length_1131_cov_31.907946	519	599	0	80	80	1.0000000
NODE_4607_length_1131_cov_31.907946	572	652	0	80	80	1.0000000
NODE_4608_length_1131_cov_26.827519	464	544	6	80	80	1.0000000
NODE_4608_length_1131_cov_26.827519	517	597	0	15	80	0.1875000
NODE_4608_length_1131_cov_26.827519	517	597	1	1	80	0.0125000
NODE_4608_length_1131_cov_26.827519	517	597	5	4	80	0.0500000
NODE_4608_length_1131_cov_26.827519	517	597	6	60	80	0.7500000
NODE_4609_length_1131_cov_20.441860	555	635	3	5	80	0.0625000
NODE_4609_length_1131_cov_20.441860	555	635	7	75	80	0.9375000
NODE_4609_length_1131_cov_20.441860	608	688	2	48	80	0.6000000
NODE_4609_length_1131_cov_20.441860	608	688	3	10	80	0.1250000
NODE_4609_length_1131_cov_20.441860	608	688	7	22	80	0.2750000
NODE_4610_length_1131_cov_12.517442	420	500	0	80	80	1.0000000
NODE_4610_length_1131_cov_12.517442	473	553	0	80	80	1.0000000
NODE_4611_length_1131_cov_10.912791	429	509	1	34	80	0.4250000
NODE_4611_length_1131_cov_10.912791	429	509	2	46	80	0.5750000
NODE_4611_length_1131_cov_10.912791	482	562	1	68	80	0.8500000
NODE_4611_length_1131_cov_10.912791	482	562	2	12	80	0.1500000
NODE_4620_length_1130_cov_43.354995	742	822	5	30	80	0.3750000
NODE_4620_length_1130_cov_43.354995	742	822	6	29	80	0.3625000
NODE_4620_length_1130_cov_43.354995	742	822	7	21	80	0.2625000
NODE_4620_length_1130_cov_43.354995	795	875	0	4	80	0.0500000
NODE_4620_length_1130_cov_43.354995	795	875	1	4	80	0.0500000
NODE_4620_length_1130_cov_43.354995	795	875	3	5	80	0.0625000
NODE_4620_length_1130_cov_43.354995	795	875	4	5	80	0.0625000
NODE_4620_length_1130_cov_43.354995	795	875	5	8	80	0.1000000
NODE_4620_length_1130_cov_43.354995	795	875	6	54	80	0.6750000
NODE_4621_length_1130_cov_13.097963	642	722	5	18	80	0.2250000
NODE_4621_length_1130_cov_13.097963	642	722	6	19	80	0.2375000
NODE_4621_length_1130_cov_13.097963	642	722	10	21	80	0.2625000
NODE_4621_length_1130_cov_13.097963	642	722	14	5	80	0.0625000
NODE_4621_length_1130_cov_13.097963	642	722	15	4	80	0.0500000
NODE_4621_length_1130_cov_13.097963	642	722	16	3	80	0.0375000
NODE_4621_length_1130_cov_13.097963	642	722	18	3	80	0.0375000
NODE_4621_length_1130_cov_13.097963	642	722	19	7	80	0.0875000
NODE_4621_length_1130_cov_13.097963	695	775	10	5	80	0.0625000
NODE_4621_length_1130_cov_13.097963	695	775	14	5	80	0.0625000
NODE_4621_length_1130_cov_13.097963	695	775	15	4	80	0.0500000
NODE_4621_length_1130_cov_13.097963	695	775	16	3	80	0.0375000
NODE_4621_length_1130_cov_13.097963	695	775	18	13	80	0.1625000
NODE_4621_length_1130_cov_13.097963	695	775	19	11	80	0.1375000
NODE_4621_length_1130_cov_13.097963	695	775	20	24	80	0.3000000
NODE_4621_length_1130_cov_13.097963	695	775	21	15	80	0.1875000
NODE_4626_length_1129_cov_31.088350	396	476	12	6	80	0.0750000
NODE_4626_length_1129_cov_31.088350	396	476	13	14	80	0.1750000
NODE_4626_length_1129_cov_31.088350	396	476	14	13	80	0.1625000
NODE_4626_length_1129_cov_31.088350	396	476	15	3	80	0.0375000
NODE_4626_length_1129_cov_31.088350	396	476	16	10	80	0.1250000
NODE_4626_length_1129_cov_31.088350	396	476	17	34	80	0.4250000
NODE_4626_length_1129_cov_31.088350	449	529	1	12	80	0.1500000
NODE_4626_length_1129_cov_31.088350	449	529	3	8	80	0.1000000
NODE_4626_length_1129_cov_31.088350	449	529	5	9	80	0.1125000
NODE_4626_length_1129_cov_31.088350	449	529	6	1	80	0.0125000
NODE_4626_length_1129_cov_31.088350	449	529	7	13	80	0.1625000
NODE_4626_length_1129_cov_31.088350	449	529	9	4	80	0.0500000
NODE_4626_length_1129_cov_31.088350	449	529	11	3	80	0.0375000
NODE_4626_length_1129_cov_31.088350	449	529	12	9	80	0.1125000
NODE_4626_length_1129_cov_31.088350	449	529	13	5	80	0.0625000
NODE_4626_length_1129_cov_31.088350	449	529	14	13	80	0.1625000
NODE_4626_length_1129_cov_31.088350	449	529	16	3	80	0.0375000
NODE_4627_length_1129_cov_20.591262	450	530	0	73	80	0.9125000
NODE_4627_length_1129_cov_20.591262	450	530	1	7	80	0.0875000
NODE_4627_length_1129_cov_20.591262	503	583	0	20	80	0.2500000
NODE_4627_length_1129_cov_20.591262	503	583	1	60	80	0.7500000
NODE_4628_length_1129_cov_16.934951	261	341	4	29	80	0.3625000
NODE_4628_length_1129_cov_16.934951	261	341	6	3	80	0.0375000
NODE_4628_length_1129_cov_16.934951	261	341	7	25	80	0.3125000
NODE_4628_length_1129_cov_16.934951	261	341	8	23	80	0.2875000
NODE_4628_length_1129_cov_16.934951	314	394	6	45	80	0.5625000
NODE_4628_length_1129_cov_16.934951	314	394	7	21	80	0.2625000
NODE_4628_length_1129_cov_16.934951	314	394	8	14	80	0.1750000
NODE_4629_length_1129_cov_9.441748	665	738	0	73	73	1.0000000
NODE_4629_length_1129_cov_9.441748	711	791	0	80	80	1.0000000
NODE_4630_length_1129_cov_9.260194	658	738	0	16	80	0.2000000
NODE_4630_length_1129_cov_9.260194	658	738	2	64	80	0.8000000
NODE_4630_length_1129_cov_9.260194	711	791	0	19	80	0.2375000
NODE_4630_length_1129_cov_9.260194	711	791	2	61	80	0.7625000
NODE_4631_length_1129_cov_5.055340	759	839	2	30	80	0.3750000
NODE_4631_length_1129_cov_5.055340	759	839	3	33	80	0.4125000
NODE_4631_length_1129_cov_5.055340	759	839	4	17	80	0.2125000
NODE_4638_length_1128_cov_48.099125	588	668	4	10	80	0.1250000
NODE_4638_length_1128_cov_48.099125	588	668	5	9	80	0.1125000
NODE_4638_length_1128_cov_48.099125	588	668	6	1	80	0.0125000
NODE_4638_length_1128_cov_48.099125	588	668	7	19	80	0.2375000
NODE_4638_length_1128_cov_48.099125	588	668	8	23	80	0.2875000
NODE_4638_length_1128_cov_48.099125	588	668	10	6	80	0.0750000
NODE_4638_length_1128_cov_48.099125	588	668	12	12	80	0.1500000
NODE_4638_length_1128_cov_48.099125	641	721	8	62	80	0.7750000
NODE_4638_length_1128_cov_48.099125	641	721	10	6	80	0.0750000
NODE_4638_length_1128_cov_48.099125	641	721	12	12	80	0.1500000
NODE_4640_length_1128_cov_26.230321	455	535	2	25	80	0.3125000
NODE_4640_length_1128_cov_26.230321	455	535	3	17	80	0.2125000
NODE_4640_length_1128_cov_26.230321	455	535	4	38	80	0.4750000
NODE_4640_length_1128_cov_26.230321	508	588	2	14	80	0.1750000
NODE_4640_length_1128_cov_26.230321	508	588	3	4	80	0.0500000
NODE_4640_length_1128_cov_26.230321	508	588	4	26	80	0.3250000
NODE_4640_length_1128_cov_26.230321	508	588	5	23	80	0.2875000
NODE_4640_length_1128_cov_26.230321	508	588	7	13	80	0.1625000
NODE_4640_length_1128_cov_26.230321	584	664	6	5	80	0.0625000
NODE_4640_length_1128_cov_26.230321	584	664	7	67	80	0.8375000
NODE_4640_length_1128_cov_26.230321	584	664	8	8	80	0.1000000
NODE_4640_length_1128_cov_26.230321	637	718	2	6	81	0.0740741
NODE_4640_length_1128_cov_26.230321	637	718	3	16	81	0.1975309
NODE_4640_length_1128_cov_26.230321	637	718	4	9	81	0.1111111
NODE_4640_length_1128_cov_26.230321	637	718	5	19	81	0.2345679
NODE_4640_length_1128_cov_26.230321	637	718	7	31	81	0.3827161
NODE_4641_length_1128_cov_26.031098	594	674	3	12	80	0.1500000
NODE_4641_length_1128_cov_26.031098	594	674	4	12	80	0.1500000
NODE_4641_length_1128_cov_26.031098	594	674	8	9	80	0.1125000
NODE_4641_length_1128_cov_26.031098	594	674	10	19	80	0.2375000
NODE_4641_length_1128_cov_26.031098	594	674	11	28	80	0.3500000
NODE_4641_length_1128_cov_26.031098	647	727	9	27	80	0.3375000
NODE_4641_length_1128_cov_26.031098	647	727	10	21	80	0.2625000
NODE_4641_length_1128_cov_26.031098	647	727	11	32	80	0.4000000
NODE_4642_length_1128_cov_25.869776	465	538	0	6	73	0.0821918
NODE_4642_length_1128_cov_25.869776	465	538	1	10	73	0.1369863
NODE_4642_length_1128_cov_25.869776	465	538	2	23	73	0.3150685
NODE_4642_length_1128_cov_25.869776	465	538	3	34	73	0.4657534
NODE_4642_length_1128_cov_25.869776	601	674	2	20	73	0.2739726
NODE_4642_length_1128_cov_25.869776	601	674	3	26	73	0.3561644
NODE_4642_length_1128_cov_25.869776	601	674	4	10	73	0.1369863
NODE_4642_length_1128_cov_25.869776	601	674	5	17	73	0.2328767
NODE_4642_length_1128_cov_25.869776	647	723	2	69	76	0.9078947
NODE_4642_length_1128_cov_25.869776	647	723	3	7	76	0.0921053
NODE_4643_length_1128_cov_24.185617	350	430	6	2	80	0.0250000
NODE_4643_length_1128_cov_24.185617	350	430	8	65	80	0.8125000
NODE_4643_length_1128_cov_24.185617	350	430	9	13	80	0.1625000
NODE_4643_length_1128_cov_24.185617	403	483	5	12	80	0.1500000
NODE_4643_length_1128_cov_24.185617	403	483	6	31	80	0.3875000
NODE_4643_length_1128_cov_24.185617	403	483	8	37	80	0.4625000
NODE_4644_length_1128_cov_18.537415	335	415	1	34	80	0.4250000
NODE_4644_length_1128_cov_18.537415	335	415	2	46	80	0.5750000
NODE_4644_length_1128_cov_18.537415	388	468	1	8	80	0.1000000
NODE_4644_length_1128_cov_18.537415	388	468	2	72	80	0.9000000
NODE_4645_length_1128_cov_9.345967	690	770	0	80	80	1.0000000
NODE_4645_length_1128_cov_9.345967	743	823	0	80	80	1.0000000
NODE_4647_length_1128_cov_3.920311	675	725	0	50	50	1.0000000
NODE_4647_length_1128_cov_3.920311	698	778	0	80	80	1.0000000
NODE_4648_length_1128_cov_3.631681	613	693	1	80	80	1.0000000
NODE_4648_length_1128_cov_3.631681	666	746	0	51	80	0.6375000
NODE_4648_length_1128_cov_3.631681	666	746	1	29	80	0.3625000
NODE_4650_length_1128_cov_3.091351	519	599	2	18	80	0.2250000
NODE_4650_length_1128_cov_3.091351	519	599	3	1	80	0.0125000
NODE_4650_length_1128_cov_3.091351	519	599	4	61	80	0.7625000
NODE_4650_length_1128_cov_3.091351	572	652	2	38	80	0.4750000
NODE_4650_length_1128_cov_3.091351	572	652	4	42	80	0.5250000
NODE_4660_length_1127_cov_38.932879	405	485	4	5	80	0.0625000
NODE_4660_length_1127_cov_38.932879	405	485	5	48	80	0.6000000
NODE_4660_length_1127_cov_38.932879	405	485	6	18	80	0.2250000
NODE_4660_length_1127_cov_38.932879	405	485	7	5	80	0.0625000
NODE_4660_length_1127_cov_38.932879	405	485	8	4	80	0.0500000
NODE_4660_length_1127_cov_38.932879	458	538	6	18	80	0.2250000
NODE_4660_length_1127_cov_38.932879	458	538	7	5	80	0.0625000
NODE_4660_length_1127_cov_38.932879	458	538	8	10	80	0.1250000
NODE_4660_length_1127_cov_38.932879	458	538	9	7	80	0.0875000
NODE_4660_length_1127_cov_38.932879	458	538	10	13	80	0.1625000
NODE_4660_length_1127_cov_38.932879	458	538	11	6	80	0.0750000
NODE_4660_length_1127_cov_38.932879	458	538	12	21	80	0.2625000
NODE_4660_length_1127_cov_38.932879	534	614	11	10	80	0.1250000
NODE_4660_length_1127_cov_38.932879	534	614	12	10	80	0.1250000
NODE_4660_length_1127_cov_38.932879	534	614	13	10	80	0.1250000
NODE_4660_length_1127_cov_38.932879	534	614	14	2	80	0.0250000
NODE_4660_length_1127_cov_38.932879	534	614	15	13	80	0.1625000
NODE_4660_length_1127_cov_38.932879	534	614	16	18	80	0.2250000
NODE_4660_length_1127_cov_38.932879	534	614	17	1	80	0.0125000
NODE_4660_length_1127_cov_38.932879	534	614	18	16	80	0.2000000
NODE_4660_length_1127_cov_38.932879	587	667	11	8	80	0.1000000
NODE_4660_length_1127_cov_38.932879	587	667	12	10	80	0.1250000
NODE_4660_length_1127_cov_38.932879	587	667	13	6	80	0.0750000
NODE_4660_length_1127_cov_38.932879	587	667	14	12	80	0.1500000
NODE_4660_length_1127_cov_38.932879	587	667	15	5	80	0.0625000
NODE_4660_length_1127_cov_38.932879	587	667	16	22	80	0.2750000
NODE_4660_length_1127_cov_38.932879	587	667	17	1	80	0.0125000
NODE_4660_length_1127_cov_38.932879	587	667	18	16	80	0.2000000
NODE_4661_length_1127_cov_37.721790	236	316	8	4	80	0.0500000
NODE_4661_length_1127_cov_37.721790	236	316	9	68	80	0.8500000
NODE_4661_length_1127_cov_37.721790	236	316	10	8	80	0.1000000
NODE_4661_length_1127_cov_37.721790	289	369	3	11	80	0.1375000
NODE_4661_length_1127_cov_37.721790	289	369	4	27	80	0.3375000
NODE_4661_length_1127_cov_37.721790	289	369	6	15	80	0.1875000
NODE_4661_length_1127_cov_37.721790	289	369	8	1	80	0.0125000
NODE_4661_length_1127_cov_37.721790	289	369	9	18	80	0.2250000
NODE_4661_length_1127_cov_37.721790	289	369	10	8	80	0.1000000
NODE_4661_length_1127_cov_37.721790	365	445	2	3	80	0.0375000
NODE_4661_length_1127_cov_37.721790	365	445	3	11	80	0.1375000
NODE_4661_length_1127_cov_37.721790	365	445	4	55	80	0.6875000
NODE_4661_length_1127_cov_37.721790	365	445	5	11	80	0.1375000
NODE_4661_length_1127_cov_37.721790	418	498	2	10	80	0.1250000
NODE_4661_length_1127_cov_37.721790	418	498	4	57	80	0.7125000
NODE_4661_length_1127_cov_37.721790	418	498	5	13	80	0.1625000
NODE_4662_length_1127_cov_31.866732	444	523	8	20	79	0.2531646
NODE_4662_length_1127_cov_31.866732	444	523	9	22	79	0.2784810
NODE_4662_length_1127_cov_31.866732	444	523	10	9	79	0.1139240
NODE_4662_length_1127_cov_31.866732	444	523	11	28	79	0.3544304
NODE_4662_length_1127_cov_31.866732	496	576	8	10	80	0.1250000
NODE_4662_length_1127_cov_31.866732	496	576	9	5	80	0.0625000
NODE_4662_length_1127_cov_31.866732	496	576	10	31	80	0.3875000
NODE_4662_length_1127_cov_31.866732	496	576	11	25	80	0.3125000
NODE_4662_length_1127_cov_31.866732	496	576	12	9	80	0.1125000
NODE_4662_length_1127_cov_31.866732	572	652	7	9	80	0.1125000
NODE_4662_length_1127_cov_31.866732	572	652	8	17	80	0.2125000
NODE_4662_length_1127_cov_31.866732	572	652	9	37	80	0.4625000
NODE_4662_length_1127_cov_31.866732	572	652	10	14	80	0.1750000
NODE_4662_length_1127_cov_31.866732	572	652	12	3	80	0.0375000
NODE_4662_length_1127_cov_31.866732	625	705	7	62	80	0.7750000
NODE_4662_length_1127_cov_31.866732	625	705	8	1	80	0.0125000
NODE_4662_length_1127_cov_31.866732	625	705	9	3	80	0.0375000
NODE_4662_length_1127_cov_31.866732	625	705	10	14	80	0.1750000
NODE_4663_length_1127_cov_25.616732	430	510	6	25	80	0.3125000
NODE_4663_length_1127_cov_25.616732	430	510	8	30	80	0.3750000
NODE_4663_length_1127_cov_25.616732	430	510	9	12	80	0.1500000
NODE_4663_length_1127_cov_25.616732	430	510	10	13	80	0.1625000
NODE_4663_length_1127_cov_25.616732	483	563	8	2	80	0.0250000
NODE_4663_length_1127_cov_25.616732	483	563	9	37	80	0.4625000
NODE_4663_length_1127_cov_25.616732	483	563	10	41	80	0.5125000
NODE_4664_length_1127_cov_21.838521	338	418	4	11	80	0.1375000
NODE_4664_length_1127_cov_21.838521	338	418	5	45	80	0.5625000
NODE_4664_length_1127_cov_21.838521	338	418	6	16	80	0.2000000
NODE_4664_length_1127_cov_21.838521	338	418	7	8	80	0.1000000
NODE_4664_length_1127_cov_21.838521	391	471	4	3	80	0.0375000
NODE_4664_length_1127_cov_21.838521	391	471	6	16	80	0.2000000
NODE_4664_length_1127_cov_21.838521	391	471	7	8	80	0.1000000
NODE_4664_length_1127_cov_21.838521	391	471	8	23	80	0.2875000
NODE_4664_length_1127_cov_21.838521	391	471	9	20	80	0.2500000
NODE_4664_length_1127_cov_21.838521	391	471	10	6	80	0.0750000
NODE_4664_length_1127_cov_21.838521	391	471	11	4	80	0.0500000
NODE_4664_length_1127_cov_21.838521	467	547	8	1	80	0.0125000
NODE_4664_length_1127_cov_21.838521	467	547	9	19	80	0.2375000
NODE_4664_length_1127_cov_21.838521	467	547	10	9	80	0.1125000
NODE_4664_length_1127_cov_21.838521	467	547	11	3	80	0.0375000
NODE_4664_length_1127_cov_21.838521	467	547	12	48	80	0.6000000
NODE_4664_length_1127_cov_21.838521	520	600	1	7	80	0.0875000
NODE_4664_length_1127_cov_21.838521	520	600	3	9	80	0.1125000
NODE_4664_length_1127_cov_21.838521	520	600	5	14	80	0.1750000
NODE_4664_length_1127_cov_21.838521	520	600	7	2	80	0.0250000
NODE_4664_length_1127_cov_21.838521	520	600	9	9	80	0.1125000
NODE_4664_length_1127_cov_21.838521	520	600	10	15	80	0.1875000
NODE_4664_length_1127_cov_21.838521	520	600	11	1	80	0.0125000
NODE_4664_length_1127_cov_21.838521	520	600	12	23	80	0.2875000
NODE_4665_length_1127_cov_15.024319	711	800	6	3	89	0.0337079
NODE_4665_length_1127_cov_15.024319	711	800	8	21	89	0.2359551
NODE_4665_length_1127_cov_15.024319	711	800	10	9	89	0.1011236
NODE_4665_length_1127_cov_15.024319	711	800	11	13	89	0.1460674
NODE_4665_length_1127_cov_15.024319	711	800	12	12	89	0.1348315
NODE_4665_length_1127_cov_15.024319	711	800	13	6	89	0.0674157
NODE_4665_length_1127_cov_15.024319	711	800	15	9	89	0.1011236
NODE_4665_length_1127_cov_15.024319	711	800	16	10	89	0.1123596
NODE_4665_length_1127_cov_15.024319	711	800	17	6	89	0.0674157
NODE_4665_length_1127_cov_15.024319	773	853	12	27	80	0.3375000
NODE_4665_length_1127_cov_15.024319	773	853	13	2	80	0.0250000
NODE_4665_length_1127_cov_15.024319	773	853	14	2	80	0.0250000
NODE_4665_length_1127_cov_15.024319	773	853	15	33	80	0.4125000
NODE_4665_length_1127_cov_15.024319	773	853	16	10	80	0.1250000
NODE_4665_length_1127_cov_15.024319	773	853	17	6	80	0.0750000
NODE_4667_length_1127_cov_4.786965	386	466	0	80	80	1.0000000
NODE_4667_length_1127_cov_4.786965	439	519	0	80	80	1.0000000
NODE_4672_length_1126_cov_51.699124	448	528	1	65	80	0.8125000
NODE_4672_length_1126_cov_51.699124	448	528	2	15	80	0.1875000
NODE_4672_length_1126_cov_51.699124	501	581	1	80	80	1.0000000
NODE_4673_length_1126_cov_38.135346	427	507	9	1	80	0.0125000
NODE_4673_length_1126_cov_38.135346	427	507	10	13	80	0.1625000
NODE_4673_length_1126_cov_38.135346	427	507	11	8	80	0.1000000
NODE_4673_length_1126_cov_38.135346	427	507	12	14	80	0.1750000
NODE_4673_length_1126_cov_38.135346	427	507	13	12	80	0.1500000
NODE_4673_length_1126_cov_38.135346	427	507	14	32	80	0.4000000
NODE_4673_length_1126_cov_38.135346	480	560	8	7	80	0.0875000
NODE_4673_length_1126_cov_38.135346	480	560	9	8	80	0.1000000
NODE_4673_length_1126_cov_38.135346	480	560	10	36	80	0.4500000
NODE_4673_length_1126_cov_38.135346	480	560	11	9	80	0.1125000
NODE_4673_length_1126_cov_38.135346	480	560	12	5	80	0.0625000
NODE_4673_length_1126_cov_38.135346	480	560	14	15	80	0.1875000
NODE_4673_length_1126_cov_38.135346	556	638	9	4	82	0.0487805
NODE_4673_length_1126_cov_38.135346	556	638	10	4	82	0.0487805
NODE_4673_length_1126_cov_38.135346	556	638	14	5	82	0.0609756
NODE_4673_length_1126_cov_38.135346	556	638	15	23	82	0.2804878
NODE_4673_length_1126_cov_38.135346	556	638	16	7	82	0.0853659
NODE_4673_length_1126_cov_38.135346	556	638	17	8	82	0.0975610
NODE_4673_length_1126_cov_38.135346	556	638	18	31	82	0.3780488
NODE_4673_length_1126_cov_38.135346	611	691	15	1	80	0.0125000
NODE_4673_length_1126_cov_38.135346	611	691	16	2	80	0.0250000
NODE_4673_length_1126_cov_38.135346	611	691	17	34	80	0.4250000
NODE_4673_length_1126_cov_38.135346	611	691	18	39	80	0.4875000
NODE_4673_length_1126_cov_38.135346	611	691	19	4	80	0.0500000
NODE_4674_length_1126_cov_34.637780	23	97	2	32	74	0.4324324
NODE_4674_length_1126_cov_34.637780	23	97	3	9	74	0.1216216
NODE_4674_length_1126_cov_34.637780	23	97	5	21	74	0.2837838
NODE_4674_length_1126_cov_34.637780	23	97	6	12	74	0.1621622
NODE_4674_length_1126_cov_34.637780	146	226	6	21	80	0.2625000
NODE_4674_length_1126_cov_34.637780	146	226	7	14	80	0.1750000
NODE_4674_length_1126_cov_34.637780	146	226	8	16	80	0.2000000
NODE_4674_length_1126_cov_34.637780	146	226	9	10	80	0.1250000
NODE_4674_length_1126_cov_34.637780	146	226	10	6	80	0.0750000
NODE_4674_length_1126_cov_34.637780	146	226	11	10	80	0.1250000
NODE_4674_length_1126_cov_34.637780	146	226	13	3	80	0.0375000
NODE_4674_length_1126_cov_34.637780	146	226	6	21	80	0.2625000
NODE_4674_length_1126_cov_34.637780	146	226	7	14	80	0.1750000
NODE_4674_length_1126_cov_34.637780	146	226	8	16	80	0.2000000
NODE_4674_length_1126_cov_34.637780	146	226	9	10	80	0.1250000
NODE_4674_length_1126_cov_34.637780	146	226	10	6	80	0.0750000
NODE_4674_length_1126_cov_34.637780	146	226	11	10	80	0.1250000
NODE_4674_length_1126_cov_34.637780	146	226	13	3	80	0.0375000
NODE_4674_length_1126_cov_34.637780	146	208	6	3	62	0.0483871
NODE_4674_length_1126_cov_34.637780	146	208	7	14	62	0.2258064
NODE_4674_length_1126_cov_34.637780	146	208	8	16	62	0.2580645
NODE_4674_length_1126_cov_34.637780	146	208	9	10	62	0.1612903
NODE_4674_length_1126_cov_34.637780	146	208	10	6	62	0.0967742
NODE_4674_length_1126_cov_34.637780	146	208	11	10	62	0.1612903
NODE_4674_length_1126_cov_34.637780	146	208	13	3	62	0.0483871
NODE_4674_length_1126_cov_34.637780	146	217	6	12	71	0.1690141
NODE_4674_length_1126_cov_34.637780	146	217	7	14	71	0.1971831
NODE_4674_length_1126_cov_34.637780	146	217	8	16	71	0.2253521
NODE_4674_length_1126_cov_34.637780	146	217	9	10	71	0.1408451
NODE_4674_length_1126_cov_34.637780	146	217	10	6	71	0.0845070
NODE_4674_length_1126_cov_34.637780	146	217	11	10	71	0.1408451
NODE_4674_length_1126_cov_34.637780	146	217	13	3	71	0.0422535
NODE_4675_length_1126_cov_21.360273	595	675	1	16	80	0.2000000
NODE_4675_length_1126_cov_21.360273	595	675	2	40	80	0.5000000
NODE_4675_length_1126_cov_21.360273	595	675	3	24	80	0.3000000
NODE_4675_length_1126_cov_21.360273	648	728	2	75	80	0.9375000
NODE_4675_length_1126_cov_21.360273	648	728	3	5	80	0.0625000
NODE_4676_length_1126_cov_17.420643	422	502	5	23	80	0.2875000
NODE_4676_length_1126_cov_17.420643	422	502	6	8	80	0.1000000
NODE_4676_length_1126_cov_17.420643	422	502	7	49	80	0.6125000
NODE_4676_length_1126_cov_17.420643	475	555	4	3	80	0.0375000
NODE_4676_length_1126_cov_17.420643	475	555	5	12	80	0.1500000
NODE_4676_length_1126_cov_17.420643	475	555	7	50	80	0.6250000
NODE_4676_length_1126_cov_17.420643	475	555	9	15	80	0.1875000
NODE_4677_length_1126_cov_15.896787	383	463	2	14	80	0.1750000
NODE_4677_length_1126_cov_15.896787	383	463	3	66	80	0.8250000
NODE_4677_length_1126_cov_15.896787	436	516	1	10	80	0.1250000
NODE_4677_length_1126_cov_15.896787	436	516	2	57	80	0.7125000
NODE_4677_length_1126_cov_15.896787	436	516	3	13	80	0.1625000
NODE_4678_length_1126_cov_8.525803	174	254	0	80	80	1.0000000
NODE_4678_length_1126_cov_8.525803	227	307	0	80	80	1.0000000
NODE_4679_length_1126_cov_5.805258	463	543	2	24	80	0.3000000
NODE_4679_length_1126_cov_5.805258	463	543	4	6	80	0.0750000
NODE_4679_length_1126_cov_5.805258	463	543	6	50	80	0.6250000
NODE_4679_length_1126_cov_5.805258	516	596	2	18	80	0.2250000
NODE_4679_length_1126_cov_5.805258	516	596	3	9	80	0.1125000
NODE_4679_length_1126_cov_5.805258	516	596	5	12	80	0.1500000
NODE_4679_length_1126_cov_5.805258	516	596	6	41	80	0.5125000
NODE_4685_length_1126_cov_1.502434	6	86	0	80	80	1.0000000
NODE_4685_length_1126_cov_1.502434	59	108	0	49	49	1.0000000
NODE_4689_length_1125_cov_34.314815	405	485	8	1	80	0.0125000
NODE_4689_length_1125_cov_34.314815	405	485	9	3	80	0.0375000
NODE_4689_length_1125_cov_34.314815	405	485	10	20	80	0.2500000
NODE_4689_length_1125_cov_34.314815	405	485	11	25	80	0.3125000
NODE_4689_length_1125_cov_34.314815	405	485	12	13	80	0.1625000
NODE_4689_length_1125_cov_34.314815	405	485	13	18	80	0.2250000
NODE_4689_length_1125_cov_34.314815	458	538	8	2	80	0.0250000
NODE_4689_length_1125_cov_34.314815	458	538	9	30	80	0.3750000
NODE_4689_length_1125_cov_34.314815	458	538	10	38	80	0.4750000
NODE_4689_length_1125_cov_34.314815	458	538	11	7	80	0.0875000
NODE_4689_length_1125_cov_34.314815	458	538	12	3	80	0.0375000
NODE_4689_length_1125_cov_34.314815	534	614	3	10	80	0.1250000
NODE_4689_length_1125_cov_34.314815	534	614	4	9	80	0.1125000
NODE_4689_length_1125_cov_34.314815	534	614	6	13	80	0.1625000
NODE_4689_length_1125_cov_34.314815	534	614	7	29	80	0.3625000
NODE_4689_length_1125_cov_34.314815	534	614	8	13	80	0.1625000
NODE_4689_length_1125_cov_34.314815	534	614	9	2	80	0.0250000
NODE_4689_length_1125_cov_34.314815	534	614	10	4	80	0.0500000
NODE_4689_length_1125_cov_34.314815	587	667	3	54	80	0.6750000
NODE_4689_length_1125_cov_34.314815	587	667	4	9	80	0.1125000
NODE_4689_length_1125_cov_34.314815	587	667	5	7	80	0.0875000
NODE_4689_length_1125_cov_34.314815	587	667	6	10	80	0.1250000
NODE_4690_length_1125_cov_33.553606	458	538	10	11	80	0.1375000
NODE_4690_length_1125_cov_33.553606	458	538	11	2	80	0.0250000
NODE_4690_length_1125_cov_33.553606	458	538	13	5	80	0.0625000
NODE_4690_length_1125_cov_33.553606	458	538	14	12	80	0.1500000
NODE_4690_length_1125_cov_33.553606	458	538	15	13	80	0.1625000
NODE_4690_length_1125_cov_33.553606	458	538	16	18	80	0.2250000
NODE_4690_length_1125_cov_33.553606	458	538	17	5	80	0.0625000
NODE_4690_length_1125_cov_33.553606	458	538	18	14	80	0.1750000
NODE_4690_length_1125_cov_33.553606	511	591	10	8	80	0.1000000
NODE_4690_length_1125_cov_33.553606	511	591	11	3	80	0.0375000
NODE_4690_length_1125_cov_33.553606	511	591	12	6	80	0.0750000
NODE_4690_length_1125_cov_33.553606	511	591	14	4	80	0.0500000
NODE_4690_length_1125_cov_33.553606	511	591	15	11	80	0.1375000
NODE_4690_length_1125_cov_33.553606	511	591	16	5	80	0.0625000
NODE_4690_length_1125_cov_33.553606	511	591	17	13	80	0.1625000
NODE_4690_length_1125_cov_33.553606	511	591	18	30	80	0.3750000
NODE_4690_length_1125_cov_33.553606	587	667	4	3	80	0.0375000
NODE_4690_length_1125_cov_33.553606	587	667	5	16	80	0.2000000
NODE_4690_length_1125_cov_33.553606	587	667	6	10	80	0.1250000
NODE_4690_length_1125_cov_33.553606	587	667	7	12	80	0.1500000
NODE_4690_length_1125_cov_33.553606	587	667	8	17	80	0.2125000
NODE_4690_length_1125_cov_33.553606	587	667	9	16	80	0.2000000
NODE_4690_length_1125_cov_33.553606	587	667	10	6	80	0.0750000
NODE_4690_length_1125_cov_33.553606	640	720	1	46	80	0.5750000
NODE_4690_length_1125_cov_33.553606	640	720	2	4	80	0.0500000
NODE_4690_length_1125_cov_33.553606	640	720	3	2	80	0.0250000
NODE_4690_length_1125_cov_33.553606	640	720	4	4	80	0.0500000
NODE_4690_length_1125_cov_33.553606	640	720	5	16	80	0.2000000
NODE_4690_length_1125_cov_33.553606	640	720	6	8	80	0.1000000
NODE_4691_length_1125_cov_33.371345	408	488	4	54	80	0.6750000
NODE_4691_length_1125_cov_33.371345	408	488	5	26	80	0.3250000
NODE_4691_length_1125_cov_33.371345	461	541	2	20	80	0.2500000
NODE_4691_length_1125_cov_33.371345	461	541	4	49	80	0.6125000
NODE_4691_length_1125_cov_33.371345	461	541	5	11	80	0.1375000
NODE_4691_length_1125_cov_33.371345	537	617	1	13	80	0.1625000
NODE_4691_length_1125_cov_33.371345	537	617	2	58	80	0.7250000
NODE_4691_length_1125_cov_33.371345	537	617	4	7	80	0.0875000
NODE_4691_length_1125_cov_33.371345	537	617	5	2	80	0.0250000
NODE_4691_length_1125_cov_33.371345	590	670	2	18	80	0.2250000
NODE_4691_length_1125_cov_33.371345	590	670	4	30	80	0.3750000
NODE_4691_length_1125_cov_33.371345	590	670	5	32	80	0.4000000
NODE_4692_length_1125_cov_22.580897	279	359	2	16	80	0.2000000
NODE_4692_length_1125_cov_22.580897	279	359	3	16	80	0.2000000
NODE_4692_length_1125_cov_22.580897	279	359	4	6	80	0.0750000
NODE_4692_length_1125_cov_22.580897	279	359	5	42	80	0.5250000
NODE_4692_length_1125_cov_22.580897	332	412	5	51	80	0.6375000
NODE_4692_length_1125_cov_22.580897	332	412	6	29	80	0.3625000
NODE_4692_length_1125_cov_22.580897	408	488	3	21	80	0.2625000
NODE_4692_length_1125_cov_22.580897	408	488	4	6	80	0.0750000
NODE_4692_length_1125_cov_22.580897	408	488	5	16	80	0.2000000
NODE_4692_length_1125_cov_22.580897	408	488	6	37	80	0.4625000
NODE_4692_length_1125_cov_22.580897	461	541	0	16	80	0.2000000
NODE_4692_length_1125_cov_22.580897	461	541	2	11	80	0.1375000
NODE_4692_length_1125_cov_22.580897	461	541	3	47	80	0.5875000
NODE_4692_length_1125_cov_22.580897	461	541	4	6	80	0.0750000
NODE_4705_length_1124_cov_52.278049	616	696	1	43	80	0.5375000
NODE_4705_length_1124_cov_52.278049	616	696	2	37	80	0.4625000
NODE_4705_length_1124_cov_52.278049	669	749	1	47	80	0.5875000
NODE_4705_length_1124_cov_52.278049	669	749	3	33	80	0.4125000
NODE_4706_length_1124_cov_25.280000	444	524	4	14	80	0.1750000
NODE_4706_length_1124_cov_25.280000	444	524	5	6	80	0.0750000
NODE_4706_length_1124_cov_25.280000	444	524	6	60	80	0.7500000
NODE_4706_length_1124_cov_25.280000	497	577	5	29	80	0.3625000
NODE_4706_length_1124_cov_25.280000	497	577	6	46	80	0.5750000
NODE_4706_length_1124_cov_25.280000	497	577	7	5	80	0.0625000
NODE_4706_length_1124_cov_25.280000	573	653	3	4	80	0.0500000
NODE_4706_length_1124_cov_25.280000	573	653	4	18	80	0.2250000
NODE_4706_length_1124_cov_25.280000	573	653	5	23	80	0.2875000
NODE_4706_length_1124_cov_25.280000	573	653	6	21	80	0.2625000
NODE_4706_length_1124_cov_25.280000	573	653	7	14	80	0.1750000
NODE_4706_length_1124_cov_25.280000	626	706	3	34	80	0.4250000
NODE_4706_length_1124_cov_25.280000	626	706	4	41	80	0.5125000
NODE_4706_length_1124_cov_25.280000	626	706	5	5	80	0.0625000
NODE_4707_length_1124_cov_18.700488	114	194	0	52	80	0.6500000
NODE_4707_length_1124_cov_18.700488	114	194	1	17	80	0.2125000
NODE_4707_length_1124_cov_18.700488	114	194	2	11	80	0.1375000
NODE_4707_length_1124_cov_18.700488	167	247	1	16	80	0.2000000
NODE_4707_length_1124_cov_18.700488	167	247	2	42	80	0.5250000
NODE_4707_length_1124_cov_18.700488	167	247	3	22	80	0.2750000
NODE_4717_length_1123_cov_26.445312	388	468	1	7	80	0.0875000
NODE_4717_length_1123_cov_26.445312	388	468	2	2	80	0.0250000
NODE_4717_length_1123_cov_26.445312	388	468	3	6	80	0.0750000
NODE_4717_length_1123_cov_26.445312	388	468	4	10	80	0.1250000
NODE_4717_length_1123_cov_26.445312	388	468	6	53	80	0.6625000
NODE_4717_length_1123_cov_26.445312	388	468	7	2	80	0.0250000
NODE_4717_length_1123_cov_26.445312	441	521	6	25	80	0.3125000
NODE_4717_length_1123_cov_26.445312	441	521	7	18	80	0.2250000
NODE_4717_length_1123_cov_26.445312	441	521	8	24	80	0.3000000
NODE_4717_length_1123_cov_26.445312	441	521	9	13	80	0.1625000
NODE_4717_length_1123_cov_26.445312	517	597	6	7	80	0.0875000
NODE_4717_length_1123_cov_26.445312	517	597	7	4	80	0.0500000
NODE_4717_length_1123_cov_26.445312	517	597	8	27	80	0.3375000
NODE_4717_length_1123_cov_26.445312	517	597	9	30	80	0.3750000
NODE_4717_length_1123_cov_26.445312	517	597	10	12	80	0.1500000
NODE_4717_length_1123_cov_26.445312	570	650	7	4	80	0.0500000
NODE_4717_length_1123_cov_26.445312	570	650	8	38	80	0.4750000
NODE_4717_length_1123_cov_26.445312	570	650	9	35	80	0.4375000
NODE_4717_length_1123_cov_26.445312	570	650	10	3	80	0.0375000
NODE_4718_length_1123_cov_18.677734	522	602	3	45	80	0.5625000
NODE_4718_length_1123_cov_18.677734	522	602	5	35	80	0.4375000
NODE_4718_length_1123_cov_18.677734	575	655	3	9	80	0.1125000
NODE_4718_length_1123_cov_18.677734	575	655	4	14	80	0.1750000
NODE_4718_length_1123_cov_18.677734	575	655	5	57	80	0.7125000
NODE_4718_length_1123_cov_18.677734	651	731	3	1	80	0.0125000
NODE_4718_length_1123_cov_18.677734	651	731	4	43	80	0.5375000
NODE_4718_length_1123_cov_18.677734	651	731	5	36	80	0.4500000
NODE_4718_length_1123_cov_18.677734	704	784	3	1	80	0.0125000
NODE_4718_length_1123_cov_18.677734	704	784	4	33	80	0.4125000
NODE_4718_length_1123_cov_18.677734	704	784	5	28	80	0.3500000
NODE_4718_length_1123_cov_18.677734	704	784	6	18	80	0.2250000
NODE_4728_length_1122_cov_38.688172	295	375	3	4	80	0.0500000
NODE_4728_length_1122_cov_38.688172	295	375	5	1	80	0.0125000
NODE_4728_length_1122_cov_38.688172	295	375	6	21	80	0.2625000
NODE_4728_length_1122_cov_38.688172	295	375	7	6	80	0.0750000
NODE_4728_length_1122_cov_38.688172	295	375	8	47	80	0.5875000
NODE_4728_length_1122_cov_38.688172	295	375	9	1	80	0.0125000
NODE_4728_length_1122_cov_38.688172	348	428	8	57	80	0.7125000
NODE_4728_length_1122_cov_38.688172	348	428	9	21	80	0.2625000
NODE_4728_length_1122_cov_38.688172	348	428	10	2	80	0.0250000
NODE_4728_length_1122_cov_38.688172	424	504	6	6	80	0.0750000
NODE_4728_length_1122_cov_38.688172	424	504	7	27	80	0.3375000
NODE_4728_length_1122_cov_38.688172	424	504	8	42	80	0.5250000
NODE_4728_length_1122_cov_38.688172	424	504	9	5	80	0.0625000
NODE_4728_length_1122_cov_38.688172	477	557	4	10	80	0.1250000
NODE_4728_length_1122_cov_38.688172	477	557	5	12	80	0.1500000
NODE_4728_length_1122_cov_38.688172	477	557	6	30	80	0.3750000
NODE_4728_length_1122_cov_38.688172	477	557	7	23	80	0.2875000
NODE_4728_length_1122_cov_38.688172	477	557	8	5	80	0.0625000
NODE_4729_length_1122_cov_32.827957	232	312	5	1	80	0.0125000
NODE_4729_length_1122_cov_32.827957	232	312	6	17	80	0.2125000
NODE_4729_length_1122_cov_32.827957	232	312	7	19	80	0.2375000
NODE_4729_length_1122_cov_32.827957	232	312	8	43	80	0.5375000
NODE_4729_length_1122_cov_32.827957	285	365	4	9	80	0.1125000
NODE_4729_length_1122_cov_32.827957	285	365	5	1	80	0.0125000
NODE_4729_length_1122_cov_32.827957	285	365	6	22	80	0.2750000
NODE_4729_length_1122_cov_32.827957	285	365	7	48	80	0.6000000
NODE_4729_length_1122_cov_32.827957	361	441	3	11	80	0.1375000
NODE_4729_length_1122_cov_32.827957	361	441	4	6	80	0.0750000
NODE_4729_length_1122_cov_32.827957	361	441	5	5	80	0.0625000
NODE_4729_length_1122_cov_32.827957	361	441	6	5	80	0.0625000
NODE_4729_length_1122_cov_32.827957	361	441	7	22	80	0.2750000
NODE_4729_length_1122_cov_32.827957	361	441	8	1	80	0.0125000
NODE_4729_length_1122_cov_32.827957	361	441	9	30	80	0.3750000
NODE_4729_length_1122_cov_32.827957	414	494	5	10	80	0.1250000
NODE_4729_length_1122_cov_32.827957	414	494	7	38	80	0.4750000
NODE_4729_length_1122_cov_32.827957	414	494	8	2	80	0.0250000
NODE_4729_length_1122_cov_32.827957	414	494	9	30	80	0.3750000
NODE_4730_length_1122_cov_12.574780	396	476	0	74	80	0.9250000
NODE_4730_length_1122_cov_12.574780	396	476	2	6	80	0.0750000
NODE_4730_length_1122_cov_12.574780	449	529	0	21	80	0.2625000
NODE_4730_length_1122_cov_12.574780	449	529	2	23	80	0.2875000
NODE_4730_length_1122_cov_12.574780	449	529	3	36	80	0.4500000
NODE_4730_length_1122_cov_12.574780	525	605	3	57	80	0.7125000
NODE_4730_length_1122_cov_12.574780	525	605	4	13	80	0.1625000
NODE_4730_length_1122_cov_12.574780	525	605	5	10	80	0.1250000
NODE_4730_length_1122_cov_12.574780	578	658	3	48	80	0.6000000
NODE_4730_length_1122_cov_12.574780	578	658	4	20	80	0.2500000
NODE_4730_length_1122_cov_12.574780	578	658	5	12	80	0.1500000
NODE_4731_length_1122_cov_8.582600	586	666	2	27	80	0.3375000
NODE_4731_length_1122_cov_8.582600	586	666	4	53	80	0.6625000
NODE_4731_length_1122_cov_8.582600	639	719	2	8	80	0.1000000
NODE_4731_length_1122_cov_8.582600	639	719	3	38	80	0.4750000
NODE_4731_length_1122_cov_8.582600	639	719	4	34	80	0.4250000
NODE_4733_length_1122_cov_3.714565	284	364	3	34	80	0.4250000
NODE_4733_length_1122_cov_3.714565	284	364	4	46	80	0.5750000
NODE_4733_length_1122_cov_3.714565	337	417	2	17	80	0.2125000
NODE_4733_length_1122_cov_3.714565	337	417	3	26	80	0.3250000
NODE_4733_length_1122_cov_3.714565	337	417	4	37	80	0.4625000
NODE_4738_length_1122_cov_1.757576	25	87	0	62	62	1.0000000
NODE_4742_length_1121_cov_39.595890	507	587	10	7	80	0.0875000
NODE_4742_length_1121_cov_39.595890	507	587	11	28	80	0.3500000
NODE_4742_length_1121_cov_39.595890	507	587	12	10	80	0.1250000
NODE_4742_length_1121_cov_39.595890	507	587	13	19	80	0.2375000
NODE_4742_length_1121_cov_39.595890	507	587	14	5	80	0.0625000
NODE_4742_length_1121_cov_39.595890	507	587	15	9	80	0.1125000
NODE_4742_length_1121_cov_39.595890	507	587	16	2	80	0.0250000
NODE_4742_length_1121_cov_39.595890	560	640	10	6	80	0.0750000
NODE_4742_length_1121_cov_39.595890	560	640	11	25	80	0.3125000
NODE_4742_length_1121_cov_39.595890	560	640	12	5	80	0.0625000
NODE_4742_length_1121_cov_39.595890	560	640	13	6	80	0.0750000
NODE_4742_length_1121_cov_39.595890	560	640	14	9	80	0.1125000
NODE_4742_length_1121_cov_39.595890	560	640	15	4	80	0.0500000
NODE_4742_length_1121_cov_39.595890	560	640	17	16	80	0.2000000
NODE_4742_length_1121_cov_39.595890	560	640	18	9	80	0.1125000
NODE_4742_length_1121_cov_39.595890	636	716	13	1	80	0.0125000
NODE_4742_length_1121_cov_39.595890	636	716	14	23	80	0.2875000
NODE_4742_length_1121_cov_39.595890	636	716	15	18	80	0.2250000
NODE_4742_length_1121_cov_39.595890	636	716	16	18	80	0.2250000
NODE_4742_length_1121_cov_39.595890	636	716	17	7	80	0.0875000
NODE_4742_length_1121_cov_39.595890	636	716	18	9	80	0.1125000
NODE_4742_length_1121_cov_39.595890	636	716	19	4	80	0.0500000
NODE_4742_length_1121_cov_39.595890	689	769	9	8	80	0.1000000
NODE_4742_length_1121_cov_39.595890	689	769	10	9	80	0.1125000
NODE_4742_length_1121_cov_39.595890	689	769	11	2	80	0.0250000
NODE_4742_length_1121_cov_39.595890	689	769	12	3	80	0.0375000
NODE_4742_length_1121_cov_39.595890	689	769	13	6	80	0.0750000
NODE_4742_length_1121_cov_39.595890	689	769	14	26	80	0.3250000
NODE_4742_length_1121_cov_39.595890	689	769	15	16	80	0.2000000
NODE_4742_length_1121_cov_39.595890	689	769	16	10	80	0.1250000
NODE_4743_length_1121_cov_23.832681	525	605	2	20	80	0.2500000
NODE_4743_length_1121_cov_23.832681	525	605	3	26	80	0.3250000
NODE_4743_length_1121_cov_23.832681	525	605	4	34	80	0.4250000
NODE_4743_length_1121_cov_23.832681	578	658	4	57	80	0.7125000
NODE_4743_length_1121_cov_23.832681	578	658	5	23	80	0.2875000
NODE_4744_length_1121_cov_18.033268	1	42	0	41	41	1.0000000
NODE_4744_length_1121_cov_18.033268	671	751	0	12	80	0.1500000
NODE_4744_length_1121_cov_18.033268	671	751	1	14	80	0.1750000
NODE_4744_length_1121_cov_18.033268	671	751	2	54	80	0.6750000
NODE_4744_length_1121_cov_18.033268	724	804	0	65	80	0.8125000
NODE_4744_length_1121_cov_18.033268	724	804	1	14	80	0.1750000
NODE_4744_length_1121_cov_18.033268	724	804	2	1	80	0.0125000
NODE_4745_length_1121_cov_8.633072	610	690	2	19	80	0.2375000
NODE_4745_length_1121_cov_8.633072	610	690	3	12	80	0.1500000
NODE_4745_length_1121_cov_8.633072	610	690	4	11	80	0.1375000
NODE_4745_length_1121_cov_8.633072	610	690	5	38	80	0.4750000
NODE_4745_length_1121_cov_8.633072	663	743	4	24	80	0.3000000
NODE_4745_length_1121_cov_8.633072	663	743	5	56	80	0.7000000
NODE_4751_length_1120_cov_34.281097	377	457	4	16	80	0.2000000
NODE_4751_length_1120_cov_34.281097	377	457	5	7	80	0.0875000
NODE_4751_length_1120_cov_34.281097	377	457	6	13	80	0.1625000
NODE_4751_length_1120_cov_34.281097	377	457	7	42	80	0.5250000
NODE_4751_length_1120_cov_34.281097	377	457	8	2	80	0.0250000
NODE_4751_length_1120_cov_34.281097	430	510	4	4	80	0.0500000
NODE_4751_length_1120_cov_34.281097	430	510	5	1	80	0.0125000
NODE_4751_length_1120_cov_34.281097	430	510	6	25	80	0.3125000
NODE_4751_length_1120_cov_34.281097	430	510	7	25	80	0.3125000
NODE_4751_length_1120_cov_34.281097	430	510	8	25	80	0.3125000
NODE_4751_length_1120_cov_34.281097	506	586	4	12	80	0.1500000
NODE_4751_length_1120_cov_34.281097	506	586	8	12	80	0.1500000
NODE_4751_length_1120_cov_34.281097	506	586	9	25	80	0.3125000
NODE_4751_length_1120_cov_34.281097	506	586	10	25	80	0.3125000
NODE_4751_length_1120_cov_34.281097	506	586	11	6	80	0.0750000
NODE_4751_length_1120_cov_34.281097	559	639	4	18	80	0.2250000
NODE_4751_length_1120_cov_34.281097	559	639	8	16	80	0.2000000
NODE_4751_length_1120_cov_34.281097	559	639	9	43	80	0.5375000
NODE_4751_length_1120_cov_34.281097	559	639	10	3	80	0.0375000
NODE_4752_length_1120_cov_31.468168	401	481	0	6	80	0.0750000
NODE_4752_length_1120_cov_31.468168	401	481	1	44	80	0.5500000
NODE_4752_length_1120_cov_31.468168	401	481	3	12	80	0.1500000
NODE_4752_length_1120_cov_31.468168	401	481	4	12	80	0.1500000
NODE_4752_length_1120_cov_31.468168	401	481	6	6	80	0.0750000
NODE_4752_length_1120_cov_31.468168	454	534	3	9	80	0.1125000
NODE_4752_length_1120_cov_31.468168	454	534	4	12	80	0.1500000
NODE_4752_length_1120_cov_31.468168	454	534	6	11	80	0.1375000
NODE_4752_length_1120_cov_31.468168	454	534	7	24	80	0.3000000
NODE_4752_length_1120_cov_31.468168	454	534	8	6	80	0.0750000
NODE_4752_length_1120_cov_31.468168	454	534	9	18	80	0.2250000
NODE_4752_length_1120_cov_31.468168	530	610	9	13	80	0.1625000
NODE_4752_length_1120_cov_31.468168	530	610	11	47	80	0.5875000
NODE_4752_length_1120_cov_31.468168	530	610	12	14	80	0.1750000
NODE_4752_length_1120_cov_31.468168	530	610	13	6	80	0.0750000
NODE_4752_length_1120_cov_31.468168	583	663	8	5	80	0.0625000
NODE_4752_length_1120_cov_31.468168	583	663	9	13	80	0.1625000
NODE_4752_length_1120_cov_31.468168	583	663	10	25	80	0.3125000
NODE_4752_length_1120_cov_31.468168	583	663	11	31	80	0.3875000
NODE_4752_length_1120_cov_31.468168	583	663	13	6	80	0.0750000
NODE_4753_length_1120_cov_28.182174	418	498	7	4	80	0.0500000
NODE_4753_length_1120_cov_28.182174	418	498	8	66	80	0.8250000
NODE_4753_length_1120_cov_28.182174	418	498	9	10	80	0.1250000
NODE_4753_length_1120_cov_28.182174	471	551	3	19	80	0.2375000
NODE_4753_length_1120_cov_28.182174	471	551	5	6	80	0.0750000
NODE_4753_length_1120_cov_28.182174	471	551	6	5	80	0.0625000
NODE_4753_length_1120_cov_28.182174	471	551	7	11	80	0.1375000
NODE_4753_length_1120_cov_28.182174	471	551	8	39	80	0.4875000
NODE_4754_length_1120_cov_25.423115	405	485	4	27	80	0.3375000
NODE_4754_length_1120_cov_25.423115	405	485	5	53	80	0.6625000
NODE_4754_length_1120_cov_25.423115	458	538	4	35	80	0.4375000
NODE_4754_length_1120_cov_25.423115	458	538	5	43	80	0.5375000
NODE_4754_length_1120_cov_25.423115	458	538	6	2	80	0.0250000
NODE_4754_length_1120_cov_25.423115	534	614	5	16	80	0.2000000
NODE_4754_length_1120_cov_25.423115	534	614	6	28	80	0.3500000
NODE_4754_length_1120_cov_25.423115	534	614	7	10	80	0.1250000
NODE_4754_length_1120_cov_25.423115	534	614	8	26	80	0.3250000
NODE_4754_length_1120_cov_25.423115	587	667	6	1	80	0.0125000
NODE_4754_length_1120_cov_25.423115	587	667	7	11	80	0.1375000
NODE_4754_length_1120_cov_25.423115	587	667	8	65	80	0.8125000
NODE_4754_length_1120_cov_25.423115	587	667	9	3	80	0.0375000
NODE_4755_length_1120_cov_24.441724	589	662	7	16	73	0.2191781
NODE_4755_length_1120_cov_24.441724	589	662	9	8	73	0.1095890
NODE_4755_length_1120_cov_24.441724	589	662	10	18	73	0.2465753
NODE_4755_length_1120_cov_24.441724	589	662	11	3	73	0.0410959
NODE_4755_length_1120_cov_24.441724	589	662	12	4	73	0.0547945
NODE_4755_length_1120_cov_24.441724	589	662	13	24	73	0.3287671
NODE_4755_length_1120_cov_24.441724	636	716	7	3	80	0.0375000
NODE_4755_length_1120_cov_24.441724	636	716	8	5	80	0.0625000
NODE_4755_length_1120_cov_24.441724	636	716	9	19	80	0.2375000
NODE_4755_length_1120_cov_24.441724	636	716	10	2	80	0.0250000
NODE_4755_length_1120_cov_24.441724	636	716	11	3	80	0.0375000
NODE_4755_length_1120_cov_24.441724	636	716	12	2	80	0.0250000
NODE_4755_length_1120_cov_24.441724	636	716	13	46	80	0.5750000
NODE_4756_length_1120_cov_18.966699	406	486	2	52	80	0.6500000
NODE_4756_length_1120_cov_18.966699	406	486	4	27	80	0.3375000
NODE_4756_length_1120_cov_18.966699	406	486	5	1	80	0.0125000
NODE_4756_length_1120_cov_18.966699	459	539	4	67	80	0.8375000
NODE_4756_length_1120_cov_18.966699	459	539	5	13	80	0.1625000
NODE_4757_length_1120_cov_16.136141	508	588	0	30	80	0.3750000
NODE_4757_length_1120_cov_16.136141	508	588	2	50	80	0.6250000
NODE_4757_length_1120_cov_16.136141	561	641	2	80	80	1.0000000
NODE_4758_length_1120_cov_15.492654	460	540	0	80	80	1.0000000
NODE_4758_length_1120_cov_15.492654	460	540	0	80	80	1.0000000
NODE_4758_length_1120_cov_15.492654	513	593	0	80	80	1.0000000
NODE_4759_length_1120_cov_8.696376	646	726	2	47	80	0.5875000
NODE_4759_length_1120_cov_8.696376	646	726	3	33	80	0.4125000
NODE_4759_length_1120_cov_8.696376	699	779	1	29	80	0.3625000
NODE_4759_length_1120_cov_8.696376	699	779	2	31	80	0.3875000
NODE_4759_length_1120_cov_8.696376	699	779	3	20	80	0.2500000
NODE_4760_length_1120_cov_7.916748	304	384	6	1	80	0.0125000
NODE_4760_length_1120_cov_7.916748	304	384	7	3	80	0.0375000
NODE_4760_length_1120_cov_7.916748	304	384	8	1	80	0.0125000
NODE_4760_length_1120_cov_7.916748	304	384	9	28	80	0.3500000
NODE_4760_length_1120_cov_7.916748	304	384	10	2	80	0.0250000
NODE_4760_length_1120_cov_7.916748	304	384	12	15	80	0.1875000
NODE_4760_length_1120_cov_7.916748	304	384	13	30	80	0.3750000
NODE_4760_length_1120_cov_7.916748	357	437	9	14	80	0.1750000
NODE_4760_length_1120_cov_7.916748	357	437	10	19	80	0.2375000
NODE_4760_length_1120_cov_7.916748	357	437	11	5	80	0.0625000
NODE_4760_length_1120_cov_7.916748	357	437	12	19	80	0.2375000
NODE_4760_length_1120_cov_7.916748	357	437	13	23	80	0.2875000
NODE_4772_length_1119_cov_32.617647	425	505	6	10	80	0.1250000
NODE_4772_length_1119_cov_32.617647	425	505	7	13	80	0.1625000
NODE_4772_length_1119_cov_32.617647	425	505	8	57	80	0.7125000
NODE_4772_length_1119_cov_32.617647	478	558	6	10	80	0.1250000
NODE_4772_length_1119_cov_32.617647	478	558	7	8	80	0.1000000
NODE_4772_length_1119_cov_32.617647	478	558	8	12	80	0.1500000
NODE_4772_length_1119_cov_32.617647	478	558	9	41	80	0.5125000
NODE_4772_length_1119_cov_32.617647	478	558	10	9	80	0.1125000
NODE_4773_length_1119_cov_24.944118	455	535	7	36	80	0.4500000
NODE_4773_length_1119_cov_24.944118	455	535	10	3	80	0.0375000
NODE_4773_length_1119_cov_24.944118	455	535	11	41	80	0.5125000
NODE_4773_length_1119_cov_24.944118	508	588	5	7	80	0.0875000
NODE_4773_length_1119_cov_24.944118	508	588	8	23	80	0.2875000
NODE_4773_length_1119_cov_24.944118	508	588	10	19	80	0.2375000
NODE_4773_length_1119_cov_24.944118	508	588	11	31	80	0.3875000
NODE_4774_length_1119_cov_22.214706	614	694	5	1	80	0.0125000
NODE_4774_length_1119_cov_22.214706	614	694	6	17	80	0.2125000
NODE_4774_length_1119_cov_22.214706	614	694	7	62	80	0.7750000
NODE_4774_length_1119_cov_22.214706	667	747	5	18	80	0.2250000
NODE_4774_length_1119_cov_22.214706	667	747	6	39	80	0.4875000
NODE_4774_length_1119_cov_22.214706	667	747	7	23	80	0.2875000
NODE_4775_length_1119_cov_21.115686	431	511	3	19	80	0.2375000
NODE_4775_length_1119_cov_21.115686	431	511	4	11	80	0.1375000
NODE_4775_length_1119_cov_21.115686	431	511	5	50	80	0.6250000
NODE_4775_length_1119_cov_21.115686	484	564	1	10	80	0.1250000
NODE_4775_length_1119_cov_21.115686	484	564	2	29	80	0.3625000
NODE_4775_length_1119_cov_21.115686	484	564	3	28	80	0.3500000
NODE_4775_length_1119_cov_21.115686	484	564	4	13	80	0.1625000
NODE_4777_length_1119_cov_11.895098	565	645	7	2	80	0.0250000
NODE_4777_length_1119_cov_11.895098	565	645	9	13	80	0.1625000
NODE_4777_length_1119_cov_11.895098	565	645	10	42	80	0.5250000
NODE_4777_length_1119_cov_11.895098	565	645	11	15	80	0.1875000
NODE_4777_length_1119_cov_11.895098	565	645	12	4	80	0.0500000
NODE_4777_length_1119_cov_11.895098	565	645	13	4	80	0.0500000
NODE_4777_length_1119_cov_11.895098	618	698	4	11	80	0.1375000
NODE_4777_length_1119_cov_11.895098	618	698	5	14	80	0.1750000
NODE_4777_length_1119_cov_11.895098	618	698	7	16	80	0.2000000
NODE_4777_length_1119_cov_11.895098	618	698	9	20	80	0.2500000
NODE_4777_length_1119_cov_11.895098	618	698	10	9	80	0.1125000
NODE_4777_length_1119_cov_11.895098	618	698	11	10	80	0.1250000
NODE_4782_length_1119_cov_2.783333	37	99	0	62	62	1.0000000
NODE_4789_length_1118_cov_35.214917	555	635	3	80	80	1.0000000
NODE_4789_length_1118_cov_35.214917	608	688	2	4	80	0.0500000
NODE_4789_length_1118_cov_35.214917	608	688	3	63	80	0.7875000
NODE_4789_length_1118_cov_35.214917	608	688	4	3	80	0.0375000
NODE_4789_length_1118_cov_35.214917	608	688	5	10	80	0.1250000
NODE_4789_length_1118_cov_35.214917	684	764	2	4	80	0.0500000
NODE_4789_length_1118_cov_35.214917	684	764	3	11	80	0.1375000
NODE_4789_length_1118_cov_35.214917	684	764	5	5	80	0.0625000
NODE_4789_length_1118_cov_35.214917	684	764	6	8	80	0.1000000
NODE_4789_length_1118_cov_35.214917	684	764	7	9	80	0.1125000
NODE_4789_length_1118_cov_35.214917	684	764	8	8	80	0.1000000
NODE_4789_length_1118_cov_35.214917	684	764	9	35	80	0.4375000
NODE_4789_length_1118_cov_35.214917	737	817	7	10	80	0.1250000
NODE_4789_length_1118_cov_35.214917	737	817	9	70	80	0.8750000
NODE_4790_length_1118_cov_23.114818	602	682	2	16	80	0.2000000
NODE_4790_length_1118_cov_23.114818	602	682	3	64	80	0.8000000
NODE_4790_length_1118_cov_23.114818	655	735	0	51	80	0.6375000
NODE_4790_length_1118_cov_23.114818	655	735	2	18	80	0.2250000
NODE_4790_length_1118_cov_23.114818	655	735	3	11	80	0.1375000
NODE_4790_length_1118_cov_23.114818	731	811	0	14	80	0.1750000
NODE_4790_length_1118_cov_23.114818	731	811	1	66	80	0.8250000
NODE_4790_length_1118_cov_23.114818	784	864	1	80	80	1.0000000
NODE_4791_length_1118_cov_18.293425	388	463	3	2	75	0.0266667
NODE_4791_length_1118_cov_18.293425	388	463	4	4	75	0.0533333
NODE_4791_length_1118_cov_18.293425	388	463	6	54	75	0.7200000
NODE_4791_length_1118_cov_18.293425	388	463	7	15	75	0.2000000
NODE_4791_length_1118_cov_18.293425	436	516	3	24	80	0.3000000
NODE_4791_length_1118_cov_18.293425	436	516	4	5	80	0.0625000
NODE_4791_length_1118_cov_18.293425	436	516	6	51	80	0.6375000
NODE_4791_length_1118_cov_18.293425	512	592	1	36	80	0.4500000
NODE_4791_length_1118_cov_18.293425	512	592	2	16	80	0.2000000
NODE_4791_length_1118_cov_18.293425	512	592	3	22	80	0.2750000
NODE_4791_length_1118_cov_18.293425	512	592	4	6	80	0.0750000
NODE_4791_length_1118_cov_18.293425	565	645	1	80	80	1.0000000
NODE_4792_length_1118_cov_17.228656	480	560	2	26	80	0.3250000
NODE_4792_length_1118_cov_17.228656	480	560	3	34	80	0.4250000
NODE_4792_length_1118_cov_17.228656	480	560	4	3	80	0.0375000
NODE_4792_length_1118_cov_17.228656	480	560	5	17	80	0.2125000
NODE_4792_length_1118_cov_17.228656	533	613	3	7	80	0.0875000
NODE_4792_length_1118_cov_17.228656	533	613	4	3	80	0.0375000
NODE_4792_length_1118_cov_17.228656	533	613	5	32	80	0.4000000
NODE_4792_length_1118_cov_17.228656	533	613	6	13	80	0.1625000
NODE_4792_length_1118_cov_17.228656	533	613	7	14	80	0.1750000
NODE_4792_length_1118_cov_17.228656	533	613	8	11	80	0.1375000
NODE_4794_length_1118_cov_14.299313	468	548	0	41	80	0.5125000
NODE_4794_length_1118_cov_14.299313	468	548	2	17	80	0.2125000
NODE_4794_length_1118_cov_14.299313	468	548	3	8	80	0.1000000
NODE_4794_length_1118_cov_14.299313	468	548	4	14	80	0.1750000
NODE_4794_length_1118_cov_14.299313	521	601	2	14	80	0.1750000
NODE_4794_length_1118_cov_14.299313	521	601	3	9	80	0.1125000
NODE_4794_length_1118_cov_14.299313	521	601	4	57	80	0.7125000
NODE_4795_length_1118_cov_10.203140	306	386	3	1	80	0.0125000
NODE_4795_length_1118_cov_10.203140	306	386	6	79	80	0.9875000
NODE_4795_length_1118_cov_10.203140	359	439	3	31	80	0.3875000
NODE_4795_length_1118_cov_10.203140	359	439	5	2	80	0.0250000
NODE_4795_length_1118_cov_10.203140	359	439	6	47	80	0.5875000
NODE_4795_length_1118_cov_10.203140	435	515	0	58	80	0.7250000
NODE_4795_length_1118_cov_10.203140	435	515	3	22	80	0.2750000
NODE_4795_length_1118_cov_10.203140	488	568	0	80	80	1.0000000
NODE_4796_length_1118_cov_2.885182	471	551	0	80	80	1.0000000
NODE_4796_length_1118_cov_2.885182	524	604	0	80	80	1.0000000
NODE_4805_length_1117_cov_19.425344	541	621	4	4	80	0.0500000
NODE_4805_length_1117_cov_19.425344	541	621	5	5	80	0.0625000
NODE_4805_length_1117_cov_19.425344	541	621	6	71	80	0.8875000
NODE_4805_length_1117_cov_19.425344	594	674	1	22	80	0.2750000
NODE_4805_length_1117_cov_19.425344	594	674	2	22	80	0.2750000
NODE_4805_length_1117_cov_19.425344	594	674	3	1	80	0.0125000
NODE_4805_length_1117_cov_19.425344	594	674	5	13	80	0.1625000
NODE_4805_length_1117_cov_19.425344	594	674	6	22	80	0.2750000
NODE_4806_length_1117_cov_16.386051	385	465	0	11	80	0.1375000
NODE_4806_length_1117_cov_16.386051	385	465	1	69	80	0.8625000
NODE_4806_length_1117_cov_16.386051	438	518	1	80	80	1.0000000
NODE_4807_length_1117_cov_10.353635	294	374	3	11	80	0.1375000
NODE_4807_length_1117_cov_10.353635	294	374	4	69	80	0.8625000
NODE_4807_length_1117_cov_10.353635	347	427	1	7	80	0.0875000
NODE_4807_length_1117_cov_10.353635	347	427	3	23	80	0.2875000
NODE_4807_length_1117_cov_10.353635	347	427	4	50	80	0.6250000
NODE_4808_length_1117_cov_7.492141	417	497	2	4	80	0.0500000
NODE_4808_length_1117_cov_7.492141	417	497	3	59	80	0.7375000
NODE_4808_length_1117_cov_7.492141	417	497	4	17	80	0.2125000
NODE_4808_length_1117_cov_7.492141	470	550	2	34	80	0.4250000
NODE_4808_length_1117_cov_7.492141	470	550	3	10	80	0.1250000
NODE_4808_length_1117_cov_7.492141	470	550	4	36	80	0.4500000
NODE_4812_length_1117_cov_3.225933	666	728	0	62	62	1.0000000
NODE_4819_length_1116_cov_30.106195	457	537	6	3	80	0.0375000
NODE_4819_length_1116_cov_30.106195	457	537	7	26	80	0.3250000
NODE_4819_length_1116_cov_30.106195	457	537	8	11	80	0.1375000
NODE_4819_length_1116_cov_30.106195	457	537	9	8	80	0.1000000
NODE_4819_length_1116_cov_30.106195	457	537	10	17	80	0.2125000
NODE_4819_length_1116_cov_30.106195	457	537	11	15	80	0.1875000
NODE_4819_length_1116_cov_30.106195	510	590	3	13	80	0.1625000
NODE_4819_length_1116_cov_30.106195	510	590	4	15	80	0.1875000
NODE_4819_length_1116_cov_30.106195	510	590	6	28	80	0.3500000
NODE_4819_length_1116_cov_30.106195	510	590	7	5	80	0.0625000
NODE_4819_length_1116_cov_30.106195	510	590	8	11	80	0.1375000
NODE_4819_length_1116_cov_30.106195	510	590	9	8	80	0.1000000
NODE_4820_length_1116_cov_25.518191	831	911	2	19	80	0.2375000
NODE_4820_length_1116_cov_25.518191	831	911	3	9	80	0.1125000
NODE_4820_length_1116_cov_25.518191	831	911	4	52	80	0.6500000
NODE_4820_length_1116_cov_25.518191	884	964	3	49	80	0.6125000
NODE_4820_length_1116_cov_25.518191	884	964	4	21	80	0.2625000
NODE_4820_length_1116_cov_25.518191	884	964	5	10	80	0.1250000
NODE_4821_length_1116_cov_20.629302	500	580	6	2	80	0.0250000
NODE_4821_length_1116_cov_20.629302	500	580	7	33	80	0.4125000
NODE_4821_length_1116_cov_20.629302	500	580	8	35	80	0.4375000
NODE_4821_length_1116_cov_20.629302	500	580	9	10	80	0.1250000
NODE_4821_length_1116_cov_20.629302	553	633	1	9	80	0.1125000
NODE_4821_length_1116_cov_20.629302	553	633	3	37	80	0.4625000
NODE_4821_length_1116_cov_20.629302	553	633	4	7	80	0.0875000
NODE_4821_length_1116_cov_20.629302	553	633	6	2	80	0.0250000
NODE_4821_length_1116_cov_20.629302	553	633	7	25	80	0.3125000
NODE_4822_length_1116_cov_16.723697	345	425	5	15	80	0.1875000
NODE_4822_length_1116_cov_16.723697	345	425	6	44	80	0.5500000
NODE_4822_length_1116_cov_16.723697	345	425	7	21	80	0.2625000
NODE_4822_length_1116_cov_16.723697	398	478	3	15	80	0.1875000
NODE_4822_length_1116_cov_16.723697	398	478	4	23	80	0.2875000
NODE_4822_length_1116_cov_16.723697	398	478	6	27	80	0.3375000
NODE_4822_length_1116_cov_16.723697	398	478	7	15	80	0.1875000
NODE_4823_length_1116_cov_16.046214	735	815	5	6	80	0.0750000
NODE_4823_length_1116_cov_16.046214	735	815	6	5	80	0.0625000
NODE_4823_length_1116_cov_16.046214	735	815	8	48	80	0.6000000
NODE_4823_length_1116_cov_16.046214	735	815	9	21	80	0.2625000
NODE_4823_length_1116_cov_16.046214	788	868	2	33	80	0.4125000
NODE_4823_length_1116_cov_16.046214	788	868	4	15	80	0.1875000
NODE_4823_length_1116_cov_16.046214	788	868	5	11	80	0.1375000
NODE_4823_length_1116_cov_16.046214	788	868	6	5	80	0.0625000
NODE_4823_length_1116_cov_16.046214	788	868	8	10	80	0.1250000
NODE_4823_length_1116_cov_16.046214	788	868	9	6	80	0.0750000
NODE_4828_length_1116_cov_1.379548	800	880	0	80	80	1.0000000
NODE_4828_length_1116_cov_1.379548	853	933	0	80	80	1.0000000
NODE_4832_length_1115_cov_30.584646	549	629	8	3	80	0.0375000
NODE_4832_length_1115_cov_30.584646	549	629	10	24	80	0.3000000
NODE_4832_length_1115_cov_30.584646	549	629	12	30	80	0.3750000
NODE_4832_length_1115_cov_30.584646	549	629	13	18	80	0.2250000
NODE_4832_length_1115_cov_30.584646	549	629	14	5	80	0.0625000
NODE_4832_length_1115_cov_30.584646	602	682	5	1	80	0.0125000
NODE_4832_length_1115_cov_30.584646	602	682	6	3	80	0.0375000
NODE_4832_length_1115_cov_30.584646	602	682	8	18	80	0.2250000
NODE_4832_length_1115_cov_30.584646	602	682	10	7	80	0.0875000
NODE_4832_length_1115_cov_30.584646	602	682	11	8	80	0.1000000
NODE_4832_length_1115_cov_30.584646	602	682	12	10	80	0.1250000
NODE_4832_length_1115_cov_30.584646	602	682	13	28	80	0.3500000
NODE_4832_length_1115_cov_30.584646	602	682	14	5	80	0.0625000
NODE_4833_length_1115_cov_15.871063	454	534	4	51	80	0.6375000
NODE_4833_length_1115_cov_15.871063	454	534	5	29	80	0.3625000
NODE_4833_length_1115_cov_15.871063	507	587	2	34	80	0.4250000
NODE_4833_length_1115_cov_15.871063	507	587	3	12	80	0.1500000
NODE_4833_length_1115_cov_15.871063	507	587	4	34	80	0.4250000
NODE_4833_length_1115_cov_15.871063	583	663	2	10	80	0.1250000
NODE_4833_length_1115_cov_15.871063	583	663	3	69	80	0.8625000
NODE_4833_length_1115_cov_15.871063	583	663	4	1	80	0.0125000
NODE_4833_length_1115_cov_15.871063	636	716	3	80	80	1.0000000
NODE_4840_length_1114_cov_20.633498	1034	1114	0	80	80	1.0000000
NODE_4840_length_1114_cov_20.633498	1034	1114	0	80	80	1.0000000
NODE_4840_length_1114_cov_20.633498	1034	1114	0	80	80	1.0000000
NODE_4840_length_1114_cov_20.633498	1034	1114	0	80	80	1.0000000
NODE_4840_length_1114_cov_20.633498	1034	1114	0	80	80	1.0000000
NODE_4840_length_1114_cov_20.633498	1043	1114	0	71	71	1.0000000
NODE_4841_length_1114_cov_17.383251	516	601	6	3	85	0.0352941
NODE_4841_length_1114_cov_17.383251	516	601	7	35	85	0.4117647
NODE_4841_length_1114_cov_17.383251	516	601	8	18	85	0.2117647
NODE_4841_length_1114_cov_17.383251	516	601	9	29	85	0.3411765
NODE_4841_length_1114_cov_17.383251	574	653	2	15	79	0.1898734
NODE_4841_length_1114_cov_17.383251	574	653	3	7	79	0.0886076
NODE_4841_length_1114_cov_17.383251	574	653	4	14	79	0.1772152
NODE_4841_length_1114_cov_17.383251	574	653	5	15	79	0.1898734
NODE_4841_length_1114_cov_17.383251	574	653	6	4	79	0.0506329
NODE_4841_length_1114_cov_17.383251	574	653	7	24	79	0.3037975
NODE_4841_length_1114_cov_17.383251	649	729	3	72	80	0.9000000
NODE_4841_length_1114_cov_17.383251	649	729	4	8	80	0.1000000
NODE_4841_length_1114_cov_17.383251	702	782	3	26	80	0.3250000
NODE_4841_length_1114_cov_17.383251	702	782	4	54	80	0.6750000
NODE_4842_length_1114_cov_5.562562	563	643	0	45	80	0.5625000
NODE_4842_length_1114_cov_5.562562	563	643	4	35	80	0.4375000
NODE_4842_length_1114_cov_5.562562	616	696	4	80	80	1.0000000
NODE_4847_length_1113_cov_51.988166	343	423	11	1	80	0.0125000
NODE_4847_length_1113_cov_51.988166	343	423	12	6	80	0.0750000
NODE_4847_length_1113_cov_51.988166	343	423	13	3	80	0.0375000
NODE_4847_length_1113_cov_51.988166	343	423	14	14	80	0.1750000
NODE_4847_length_1113_cov_51.988166	343	423	15	9	80	0.1125000
NODE_4847_length_1113_cov_51.988166	343	423	16	38	80	0.4750000
NODE_4847_length_1113_cov_51.988166	343	423	17	9	80	0.1125000
NODE_4847_length_1113_cov_51.988166	396	476	9	11	80	0.1375000
NODE_4847_length_1113_cov_51.988166	396	476	10	17	80	0.2125000
NODE_4847_length_1113_cov_51.988166	396	476	11	1	80	0.0125000
NODE_4847_length_1113_cov_51.988166	396	476	12	21	80	0.2625000
NODE_4847_length_1113_cov_51.988166	396	476	13	9	80	0.1125000
NODE_4847_length_1113_cov_51.988166	396	476	14	8	80	0.1000000
NODE_4847_length_1113_cov_51.988166	396	476	15	9	80	0.1125000
NODE_4847_length_1113_cov_51.988166	396	476	16	4	80	0.0500000
NODE_4847_length_1113_cov_51.988166	472	552	12	6	80	0.0750000
NODE_4847_length_1113_cov_51.988166	472	552	14	18	80	0.2250000
NODE_4847_length_1113_cov_51.988166	472	552	15	25	80	0.3125000
NODE_4847_length_1113_cov_51.988166	472	552	16	20	80	0.2500000
NODE_4847_length_1113_cov_51.988166	472	552	17	11	80	0.1375000
NODE_4847_length_1113_cov_51.988166	525	605	7	2	80	0.0250000
NODE_4847_length_1113_cov_51.988166	525	605	8	22	80	0.2750000
NODE_4847_length_1113_cov_51.988166	525	605	10	8	80	0.1000000
NODE_4847_length_1113_cov_51.988166	525	605	12	6	80	0.0750000
NODE_4847_length_1113_cov_51.988166	525	605	13	11	80	0.1375000
NODE_4847_length_1113_cov_51.988166	525	605	14	11	80	0.1375000
NODE_4847_length_1113_cov_51.988166	525	605	15	3	80	0.0375000
NODE_4847_length_1113_cov_51.988166	525	605	16	17	80	0.2125000
NODE_4848_length_1113_cov_35.005917	359	439	6	50	80	0.6250000
NODE_4848_length_1113_cov_35.005917	359	439	8	30	80	0.3750000
NODE_4848_length_1113_cov_35.005917	412	492	2	45	80	0.5625000
NODE_4848_length_1113_cov_35.005917	412	492	6	12	80	0.1500000
NODE_4848_length_1113_cov_35.005917	412	492	8	23	80	0.2875000
NODE_4849_length_1113_cov_28.106509	570	650	6	35	80	0.4375000
NODE_4849_length_1113_cov_28.106509	570	650	7	25	80	0.3125000
NODE_4849_length_1113_cov_28.106509	570	650	8	20	80	0.2500000
NODE_4849_length_1113_cov_28.106509	623	703	3	22	80	0.2750000
NODE_4849_length_1113_cov_28.106509	623	703	6	6	80	0.0750000
NODE_4849_length_1113_cov_28.106509	623	703	7	39	80	0.4875000
NODE_4849_length_1113_cov_28.106509	623	703	8	13	80	0.1625000
NODE_4849_length_1113_cov_28.106509	699	779	2	13	80	0.1625000
NODE_4849_length_1113_cov_28.106509	699	779	3	35	80	0.4375000
NODE_4849_length_1113_cov_28.106509	699	779	4	8	80	0.1000000
NODE_4849_length_1113_cov_28.106509	699	779	5	24	80	0.3000000
NODE_4849_length_1113_cov_28.106509	752	832	0	24	80	0.3000000
NODE_4849_length_1113_cov_28.106509	752	832	2	42	80	0.5250000
NODE_4849_length_1113_cov_28.106509	752	832	3	3	80	0.0375000
NODE_4849_length_1113_cov_28.106509	752	832	4	8	80	0.1000000
NODE_4849_length_1113_cov_28.106509	752	832	5	3	80	0.0375000
NODE_4850_length_1113_cov_18.636095	512	592	5	3	80	0.0375000
NODE_4850_length_1113_cov_18.636095	512	592	6	10	80	0.1250000
NODE_4850_length_1113_cov_18.636095	512	592	9	15	80	0.1875000
NODE_4850_length_1113_cov_18.636095	512	592	11	7	80	0.0875000
NODE_4850_length_1113_cov_18.636095	512	592	12	2	80	0.0250000
NODE_4850_length_1113_cov_18.636095	512	592	13	11	80	0.1375000
NODE_4850_length_1113_cov_18.636095	512	592	14	19	80	0.2375000
NODE_4850_length_1113_cov_18.636095	512	592	15	13	80	0.1625000
NODE_4850_length_1113_cov_18.636095	565	645	11	4	80	0.0500000
NODE_4850_length_1113_cov_18.636095	565	645	12	21	80	0.2625000
NODE_4850_length_1113_cov_18.636095	565	645	13	3	80	0.0375000
NODE_4850_length_1113_cov_18.636095	565	645	14	26	80	0.3250000
NODE_4850_length_1113_cov_18.636095	565	645	15	26	80	0.3250000
NODE_4851_length_1113_cov_16.664694	352	432	0	49	80	0.6125000
NODE_4851_length_1113_cov_16.664694	352	432	1	23	80	0.2875000
NODE_4851_length_1113_cov_16.664694	352	432	2	8	80	0.1000000
NODE_4851_length_1113_cov_16.664694	405	485	1	19	80	0.2375000
NODE_4851_length_1113_cov_16.664694	405	485	2	61	80	0.7625000
NODE_4851_length_1113_cov_16.664694	481	561	1	10	80	0.1250000
NODE_4851_length_1113_cov_16.664694	481	561	2	70	80	0.8750000
NODE_4851_length_1113_cov_16.664694	534	614	0	40	80	0.5000000
NODE_4851_length_1113_cov_16.664694	534	614	1	23	80	0.2875000
NODE_4851_length_1113_cov_16.664694	534	614	2	17	80	0.2125000
NODE_4852_length_1113_cov_14.155819	454	512	8	8	58	0.1379310
NODE_4852_length_1113_cov_14.155819	454	512	9	6	58	0.1034483
NODE_4852_length_1113_cov_14.155819	454	512	10	6	58	0.1034483
NODE_4852_length_1113_cov_14.155819	454	512	12	14	58	0.2413793
NODE_4852_length_1113_cov_14.155819	454	512	13	24	58	0.4137931
NODE_4852_length_1113_cov_14.155819	511	575	6	7	64	0.1093750
NODE_4852_length_1113_cov_14.155819	511	575	7	11	64	0.1718750
NODE_4852_length_1113_cov_14.155819	511	575	8	8	64	0.1250000
NODE_4852_length_1113_cov_14.155819	511	575	9	11	64	0.1718750
NODE_4852_length_1113_cov_14.155819	511	575	10	12	64	0.1875000
NODE_4852_length_1113_cov_14.155819	511	575	11	14	64	0.2187500
NODE_4852_length_1113_cov_14.155819	511	575	13	1	64	0.0156250
NODE_4853_length_1113_cov_10.185404	494	574	2	22	80	0.2750000
NODE_4853_length_1113_cov_10.185404	494	574	4	58	80	0.7250000
NODE_4853_length_1113_cov_10.185404	547	627	3	11	80	0.1375000
NODE_4853_length_1113_cov_10.185404	547	627	4	69	80	0.8625000
NODE_4855_length_1113_cov_4.005917	700	780	0	39	80	0.4875000
NODE_4855_length_1113_cov_4.005917	700	780	2	41	80	0.5125000
NODE_4855_length_1113_cov_4.005917	753	833	0	27	80	0.3375000
NODE_4855_length_1113_cov_4.005917	753	833	1	53	80	0.6625000
NODE_4866_length_1112_cov_14.961500	427	507	4	10	80	0.1250000
NODE_4866_length_1112_cov_14.961500	427	507	6	8	80	0.1000000
NODE_4866_length_1112_cov_14.961500	427	507	10	20	80	0.2500000
NODE_4866_length_1112_cov_14.961500	427	507	11	27	80	0.3375000
NODE_4866_length_1112_cov_14.961500	427	507	12	11	80	0.1375000
NODE_4866_length_1112_cov_14.961500	427	507	13	4	80	0.0500000
NODE_4866_length_1112_cov_14.961500	480	560	5	2	80	0.0250000
NODE_4866_length_1112_cov_14.961500	480	560	7	2	80	0.0250000
NODE_4866_length_1112_cov_14.961500	480	560	9	18	80	0.2250000
NODE_4866_length_1112_cov_14.961500	480	560	11	43	80	0.5375000
NODE_4866_length_1112_cov_14.961500	480	560	12	11	80	0.1375000
NODE_4866_length_1112_cov_14.961500	480	560	13	4	80	0.0500000
NODE_4866_length_1112_cov_14.961500	556	636	3	22	80	0.2750000
NODE_4866_length_1112_cov_14.961500	556	636	4	19	80	0.2375000
NODE_4866_length_1112_cov_14.961500	556	636	5	37	80	0.4625000
NODE_4866_length_1112_cov_14.961500	556	636	7	2	80	0.0250000
NODE_4866_length_1112_cov_14.961500	609	689	2	21	80	0.2625000
NODE_4866_length_1112_cov_14.961500	609	689	3	49	80	0.6125000
NODE_4866_length_1112_cov_14.961500	609	689	4	10	80	0.1250000
NODE_4875_length_1112_cov_1.655479	45	123	0	78	78	1.0000000
NODE_4875_length_1112_cov_1.655479	98	166	0	68	68	1.0000000
NODE_4880_length_1111_cov_37.999012	473	553	3	10	80	0.1250000
NODE_4880_length_1111_cov_37.999012	473	553	4	10	80	0.1250000
NODE_4880_length_1111_cov_37.999012	473	553	6	1	80	0.0125000
NODE_4880_length_1111_cov_37.999012	473	553	7	4	80	0.0500000
NODE_4880_length_1111_cov_37.999012	473	553	8	20	80	0.2500000
NODE_4880_length_1111_cov_37.999012	473	553	9	15	80	0.1875000
NODE_4880_length_1111_cov_37.999012	473	553	10	20	80	0.2500000
NODE_4880_length_1111_cov_37.999012	526	606	9	13	80	0.1625000
NODE_4880_length_1111_cov_37.999012	526	606	10	39	80	0.4875000
NODE_4880_length_1111_cov_37.999012	526	606	11	6	80	0.0750000
NODE_4880_length_1111_cov_37.999012	526	606	12	20	80	0.2500000
NODE_4880_length_1111_cov_37.999012	526	606	13	2	80	0.0250000
NODE_4880_length_1111_cov_37.999012	602	682	7	4	80	0.0500000
NODE_4880_length_1111_cov_37.999012	602	682	8	6	80	0.0750000
NODE_4880_length_1111_cov_37.999012	602	682	9	28	80	0.3500000
NODE_4880_length_1111_cov_37.999012	602	682	10	1	80	0.0125000
NODE_4880_length_1111_cov_37.999012	602	682	11	2	80	0.0250000
NODE_4880_length_1111_cov_37.999012	602	682	12	10	80	0.1250000
NODE_4880_length_1111_cov_37.999012	602	682	13	29	80	0.3625000
NODE_4880_length_1111_cov_37.999012	655	735	2	6	80	0.0750000
NODE_4880_length_1111_cov_37.999012	655	735	4	13	80	0.1625000
NODE_4880_length_1111_cov_37.999012	655	735	5	9	80	0.1125000
NODE_4880_length_1111_cov_37.999012	655	735	6	24	80	0.3000000
NODE_4880_length_1111_cov_37.999012	655	735	7	5	80	0.0625000
NODE_4880_length_1111_cov_37.999012	655	735	9	23	80	0.2875000
NODE_4881_length_1111_cov_24.394269	644	724	5	2	80	0.0250000
NODE_4881_length_1111_cov_24.394269	644	724	6	2	80	0.0250000
NODE_4881_length_1111_cov_24.394269	644	724	7	17	80	0.2125000
NODE_4881_length_1111_cov_24.394269	644	724	8	50	80	0.6250000
NODE_4881_length_1111_cov_24.394269	644	724	9	9	80	0.1125000
NODE_4881_length_1111_cov_24.394269	697	777	4	16	80	0.2000000
NODE_4881_length_1111_cov_24.394269	697	777	5	2	80	0.0250000
NODE_4881_length_1111_cov_24.394269	697	777	6	8	80	0.1000000
NODE_4881_length_1111_cov_24.394269	697	777	8	42	80	0.5250000
NODE_4881_length_1111_cov_24.394269	697	777	9	12	80	0.1500000
NODE_4882_length_1111_cov_23.676877	374	454	0	27	80	0.3375000
NODE_4882_length_1111_cov_23.676877	374	454	1	29	80	0.3625000
NODE_4882_length_1111_cov_23.676877	374	454	3	24	80	0.3000000
NODE_4882_length_1111_cov_23.676877	427	507	0	41	80	0.5125000
NODE_4882_length_1111_cov_23.676877	427	507	1	39	80	0.4875000
NODE_4883_length_1111_cov_17.522727	383	463	0	2	80	0.0250000
NODE_4883_length_1111_cov_17.522727	383	463	2	78	80	0.9750000
NODE_4883_length_1111_cov_17.522727	436	516	2	39	80	0.4875000
NODE_4883_length_1111_cov_17.522727	436	516	3	41	80	0.5125000
NODE_4884_length_1111_cov_16.495059	388	468	2	14	80	0.1750000
NODE_4884_length_1111_cov_16.495059	388	468	4	2	80	0.0250000
NODE_4884_length_1111_cov_16.495059	388	468	5	54	80	0.6750000
NODE_4884_length_1111_cov_16.495059	388	468	6	10	80	0.1250000
NODE_4884_length_1111_cov_16.495059	441	521	5	25	80	0.3125000
NODE_4884_length_1111_cov_16.495059	441	521	6	53	80	0.6625000
NODE_4884_length_1111_cov_16.495059	441	521	7	2	80	0.0250000
NODE_4885_length_1111_cov_15.366601	555	635	2	22	80	0.2750000
NODE_4885_length_1111_cov_15.366601	555	635	3	58	80	0.7250000
NODE_4885_length_1111_cov_15.366601	608	688	2	5	80	0.0625000
NODE_4885_length_1111_cov_15.366601	608	688	3	75	80	0.9375000
NODE_4886_length_1111_cov_15.314229	809	889	5	1	80	0.0125000
NODE_4886_length_1111_cov_15.314229	809	889	6	55	80	0.6875000
NODE_4886_length_1111_cov_15.314229	809	889	7	24	80	0.3000000
NODE_4886_length_1111_cov_15.314229	862	942	2	4	80	0.0500000
NODE_4886_length_1111_cov_15.314229	862	942	3	4	80	0.0500000
NODE_4886_length_1111_cov_15.314229	862	942	4	32	80	0.4000000
NODE_4886_length_1111_cov_15.314229	862	942	5	14	80	0.1750000
NODE_4886_length_1111_cov_15.314229	862	942	6	26	80	0.3250000
NODE_4887_length_1111_cov_9.732213	443	523	2	80	80	1.0000000
NODE_4887_length_1111_cov_9.732213	496	576	1	26	80	0.3250000
NODE_4887_length_1111_cov_9.732213	496	576	2	54	80	0.6750000
NODE_4888_length_1111_cov_4.907115	606	686	1	4	80	0.0500000
NODE_4888_length_1111_cov_4.907115	606	686	2	76	80	0.9500000
NODE_4888_length_1111_cov_4.907115	659	739	2	80	80	1.0000000
NODE_4892_length_1110_cov_23.012859	453	533	16	12	80	0.1500000
NODE_4892_length_1110_cov_23.012859	453	533	17	11	80	0.1375000
NODE_4892_length_1110_cov_23.012859	453	533	18	12	80	0.1500000
NODE_4892_length_1110_cov_23.012859	453	533	19	16	80	0.2000000
NODE_4892_length_1110_cov_23.012859	453	533	20	5	80	0.0625000
NODE_4892_length_1110_cov_23.012859	453	533	21	4	80	0.0500000
NODE_4892_length_1110_cov_23.012859	453	533	22	20	80	0.2500000
NODE_4892_length_1110_cov_23.012859	506	586	5	1	80	0.0125000
NODE_4892_length_1110_cov_23.012859	506	586	6	9	80	0.1125000
NODE_4892_length_1110_cov_23.012859	506	586	7	8	80	0.1000000
NODE_4892_length_1110_cov_23.012859	506	586	9	18	80	0.2250000
NODE_4892_length_1110_cov_23.012859	506	586	10	1	80	0.0125000
NODE_4892_length_1110_cov_23.012859	506	586	11	8	80	0.1000000
NODE_4892_length_1110_cov_23.012859	506	586	12	1	80	0.0125000
NODE_4892_length_1110_cov_23.012859	506	586	14	7	80	0.0875000
NODE_4892_length_1110_cov_23.012859	506	586	16	12	80	0.1500000
NODE_4892_length_1110_cov_23.012859	506	586	18	1	80	0.0125000
NODE_4892_length_1110_cov_23.012859	506	586	19	5	80	0.0625000
NODE_4892_length_1110_cov_23.012859	506	586	21	2	80	0.0250000
NODE_4892_length_1110_cov_23.012859	506	586	22	7	80	0.0875000
NODE_4892_length_1110_cov_23.012859	582	662	2	19	80	0.2375000
NODE_4892_length_1110_cov_23.012859	582	662	3	2	80	0.0250000
NODE_4892_length_1110_cov_23.012859	582	662	4	5	80	0.0625000
NODE_4892_length_1110_cov_23.012859	582	662	5	11	80	0.1375000
NODE_4892_length_1110_cov_23.012859	582	662	6	4	80	0.0500000
NODE_4892_length_1110_cov_23.012859	582	662	7	39	80	0.4875000
NODE_4892_length_1110_cov_23.012859	635	715	1	18	80	0.2250000
NODE_4892_length_1110_cov_23.012859	635	715	2	54	80	0.6750000
NODE_4892_length_1110_cov_23.012859	635	715	3	2	80	0.0250000
NODE_4892_length_1110_cov_23.012859	635	715	4	5	80	0.0625000
NODE_4892_length_1110_cov_23.012859	635	715	5	1	80	0.0125000
NODE_4895_length_1110_cov_5.305638	754	834	0	1	80	0.0125000
NODE_4895_length_1110_cov_5.305638	754	834	2	79	80	0.9875000
NODE_4895_length_1110_cov_5.305638	807	887	0	54	80	0.6750000
NODE_4895_length_1110_cov_5.305638	807	887	2	26	80	0.3250000
NODE_4896_length_1110_cov_3.698318	642	685	0	43	43	1.0000000
NODE_4899_length_1110_cov_1.871414	15	86	0	71	71	1.0000000
NODE_4903_length_1109_cov_35.307921	413	493	3	6	80	0.0750000
NODE_4903_length_1109_cov_35.307921	413	493	5	54	80	0.6750000
NODE_4903_length_1109_cov_35.307921	413	493	6	16	80	0.2000000
NODE_4903_length_1109_cov_35.307921	413	493	8	4	80	0.0500000
NODE_4903_length_1109_cov_35.307921	466	546	4	19	80	0.2375000
NODE_4903_length_1109_cov_35.307921	466	546	5	7	80	0.0875000
NODE_4903_length_1109_cov_35.307921	466	546	6	23	80	0.2875000
NODE_4903_length_1109_cov_35.307921	466	546	7	16	80	0.2000000
NODE_4903_length_1109_cov_35.307921	466	546	8	15	80	0.1875000
NODE_4903_length_1109_cov_35.307921	542	622	4	21	80	0.2625000
NODE_4903_length_1109_cov_35.307921	542	622	5	2	80	0.0250000
NODE_4903_length_1109_cov_35.307921	542	622	6	29	80	0.3625000
NODE_4903_length_1109_cov_35.307921	542	622	7	28	80	0.3500000
NODE_4903_length_1109_cov_35.307921	595	675	4	9	80	0.1125000
NODE_4903_length_1109_cov_35.307921	595	675	5	33	80	0.4125000
NODE_4903_length_1109_cov_35.307921	595	675	7	38	80	0.4750000
NODE_4904_length_1109_cov_27.880198	501	581	5	3	80	0.0375000
NODE_4904_length_1109_cov_27.880198	501	581	6	27	80	0.3375000
NODE_4904_length_1109_cov_27.880198	501	581	7	50	80	0.6250000
NODE_4904_length_1109_cov_27.880198	554	634	2	2	80	0.0250000
NODE_4904_length_1109_cov_27.880198	554	634	3	8	80	0.1000000
NODE_4904_length_1109_cov_27.880198	554	634	4	7	80	0.0875000
NODE_4904_length_1109_cov_27.880198	554	634	5	39	80	0.4875000
NODE_4904_length_1109_cov_27.880198	554	634	6	10	80	0.1250000
NODE_4904_length_1109_cov_27.880198	554	634	7	14	80	0.1750000
NODE_4904_length_1109_cov_27.880198	630	710	1	24	80	0.3000000
NODE_4904_length_1109_cov_27.880198	630	710	2	23	80	0.2875000
NODE_4904_length_1109_cov_27.880198	630	710	3	33	80	0.4125000
NODE_4904_length_1109_cov_27.880198	683	763	1	77	80	0.9625000
NODE_4904_length_1109_cov_27.880198	683	763	2	3	80	0.0375000
NODE_4905_length_1109_cov_21.858416	571	651	3	18	80	0.2250000
NODE_4905_length_1109_cov_21.858416	571	651	4	1	80	0.0125000
NODE_4905_length_1109_cov_21.858416	571	651	5	2	80	0.0250000
NODE_4905_length_1109_cov_21.858416	571	651	6	7	80	0.0875000
NODE_4905_length_1109_cov_21.858416	571	651	7	18	80	0.2250000
NODE_4905_length_1109_cov_21.858416	571	651	9	20	80	0.2500000
NODE_4905_length_1109_cov_21.858416	571	651	10	14	80	0.1750000
NODE_4905_length_1109_cov_21.858416	624	704	6	14	80	0.1750000
NODE_4905_length_1109_cov_21.858416	624	704	8	1	80	0.0125000
NODE_4905_length_1109_cov_21.858416	624	704	9	38	80	0.4750000
NODE_4905_length_1109_cov_21.858416	624	704	10	27	80	0.3375000
NODE_4912_length_1108_cov_59.921705	386	466	5	5	80	0.0625000
NODE_4912_length_1108_cov_59.921705	386	466	6	30	80	0.3750000
NODE_4912_length_1108_cov_59.921705	386	466	7	14	80	0.1750000
NODE_4912_length_1108_cov_59.921705	386	466	8	8	80	0.1000000
NODE_4912_length_1108_cov_59.921705	386	466	9	23	80	0.2875000
NODE_4912_length_1108_cov_59.921705	439	519	7	41	80	0.5125000
NODE_4912_length_1108_cov_59.921705	439	519	8	10	80	0.1250000
NODE_4912_length_1108_cov_59.921705	439	519	9	29	80	0.3625000
NODE_4912_length_1108_cov_59.921705	515	595	6	4	80	0.0500000
NODE_4912_length_1108_cov_59.921705	515	595	7	2	80	0.0250000
NODE_4912_length_1108_cov_59.921705	515	595	8	11	80	0.1375000
NODE_4912_length_1108_cov_59.921705	515	595	9	48	80	0.6000000
NODE_4912_length_1108_cov_59.921705	515	595	10	10	80	0.1250000
NODE_4912_length_1108_cov_59.921705	515	595	11	5	80	0.0625000
NODE_4912_length_1108_cov_59.921705	568	648	5	1	80	0.0125000
NODE_4912_length_1108_cov_59.921705	568	648	6	2	80	0.0250000
NODE_4912_length_1108_cov_59.921705	568	648	7	37	80	0.4625000
NODE_4912_length_1108_cov_59.921705	568	648	8	8	80	0.1000000
NODE_4912_length_1108_cov_59.921705	568	648	9	29	80	0.3625000
NODE_4912_length_1108_cov_59.921705	568	648	10	2	80	0.0250000
NODE_4912_length_1108_cov_59.921705	568	648	11	1	80	0.0125000
NODE_4914_length_1108_cov_16.069376	513	593	3	5	80	0.0625000
NODE_4914_length_1108_cov_16.069376	513	593	4	19	80	0.2375000
NODE_4914_length_1108_cov_16.069376	513	593	5	10	80	0.1250000
NODE_4914_length_1108_cov_16.069376	513	593	6	46	80	0.5750000
NODE_4914_length_1108_cov_16.069376	566	646	1	4	80	0.0500000
NODE_4914_length_1108_cov_16.069376	566	646	3	5	80	0.0625000
NODE_4914_length_1108_cov_16.069376	566	646	4	62	80	0.7750000
NODE_4914_length_1108_cov_16.069376	566	646	5	9	80	0.1125000
NODE_4916_length_1108_cov_11.656095	333	413	1	33	80	0.4125000
NODE_4916_length_1108_cov_11.656095	333	413	2	3	80	0.0375000
NODE_4916_length_1108_cov_11.656095	333	413	3	44	80	0.5500000
NODE_4916_length_1108_cov_11.656095	386	466	2	56	80	0.7000000
NODE_4916_length_1108_cov_11.656095	386	466	3	24	80	0.3000000
NODE_4917_length_1108_cov_10.266601	431	511	2	24	80	0.3000000
NODE_4917_length_1108_cov_10.266601	431	511	3	56	80	0.7000000
NODE_4917_length_1108_cov_10.266601	484	564	1	40	80	0.5000000
NODE_4917_length_1108_cov_10.266601	484	564	3	40	80	0.5000000
NODE_4918_length_1108_cov_8.895937	635	715	1	31	80	0.3875000
NODE_4918_length_1108_cov_8.895937	635	715	3	15	80	0.1875000
NODE_4918_length_1108_cov_8.895937	635	715	4	34	80	0.4250000
NODE_4918_length_1108_cov_8.895937	688	768	4	80	80	1.0000000
NODE_4920_length_1108_cov_5.682854	577	657	1	72	80	0.9000000
NODE_4920_length_1108_cov_5.682854	577	657	2	8	80	0.1000000
NODE_4920_length_1108_cov_5.682854	630	710	1	80	80	1.0000000
NODE_4927_length_1107_cov_35.050595	423	503	2	7	80	0.0875000
NODE_4927_length_1107_cov_35.050595	423	503	3	23	80	0.2875000
NODE_4927_length_1107_cov_35.050595	423	503	4	43	80	0.5375000
NODE_4927_length_1107_cov_35.050595	423	503	5	7	80	0.0875000
NODE_4927_length_1107_cov_35.050595	476	556	1	38	80	0.4750000
NODE_4927_length_1107_cov_35.050595	476	556	3	38	80	0.4750000
NODE_4927_length_1107_cov_35.050595	476	556	5	4	80	0.0500000
NODE_4927_length_1107_cov_35.050595	552	632	1	18	80	0.2250000
NODE_4927_length_1107_cov_35.050595	552	632	2	9	80	0.1125000
NODE_4927_length_1107_cov_35.050595	552	632	3	53	80	0.6625000
NODE_4927_length_1107_cov_35.050595	605	685	2	62	80	0.7750000
NODE_4927_length_1107_cov_35.050595	605	685	3	18	80	0.2250000
NODE_4928_length_1107_cov_31.386905	422	502	7	5	80	0.0625000
NODE_4928_length_1107_cov_31.386905	422	502	8	1	80	0.0125000
NODE_4928_length_1107_cov_31.386905	422	502	9	31	80	0.3875000
NODE_4928_length_1107_cov_31.386905	422	502	11	2	80	0.0250000
NODE_4928_length_1107_cov_31.386905	422	502	12	8	80	0.1000000
NODE_4928_length_1107_cov_31.386905	422	502	13	20	80	0.2500000
NODE_4928_length_1107_cov_31.386905	422	502	15	10	80	0.1250000
NODE_4928_length_1107_cov_31.386905	422	502	16	3	80	0.0375000
NODE_4928_length_1107_cov_31.386905	475	555	13	14	80	0.1750000
NODE_4928_length_1107_cov_31.386905	475	555	15	26	80	0.3250000
NODE_4928_length_1107_cov_31.386905	475	555	16	40	80	0.5000000
NODE_4929_length_1107_cov_29.178571	577	657	7	2	80	0.0250000
NODE_4929_length_1107_cov_29.178571	577	657	8	15	80	0.1875000
NODE_4929_length_1107_cov_29.178571	577	657	9	1	80	0.0125000
NODE_4929_length_1107_cov_29.178571	577	657	10	23	80	0.2875000
NODE_4929_length_1107_cov_29.178571	577	657	11	39	80	0.4875000
NODE_4929_length_1107_cov_29.178571	630	710	0	9	80	0.1125000
NODE_4929_length_1107_cov_29.178571	630	710	2	4	80	0.0500000
NODE_4929_length_1107_cov_29.178571	630	710	4	8	80	0.1000000
NODE_4929_length_1107_cov_29.178571	630	710	5	24	80	0.3000000
NODE_4929_length_1107_cov_29.178571	630	710	7	10	80	0.1250000
NODE_4929_length_1107_cov_29.178571	630	710	8	15	80	0.1875000
NODE_4929_length_1107_cov_29.178571	630	710	10	10	80	0.1250000
NODE_4929_length_1107_cov_29.178571	934	1000	0	28	66	0.4242424
NODE_4929_length_1107_cov_29.178571	934	1000	2	38	66	0.5757576
NODE_4929_length_1107_cov_29.178571	934	1005	0	28	71	0.3943662
NODE_4929_length_1107_cov_29.178571	934	1005	2	43	71	0.6056338
NODE_4930_length_1107_cov_16.038690	574	654	7	5	80	0.0625000
NODE_4930_length_1107_cov_16.038690	574	654	8	15	80	0.1875000
NODE_4930_length_1107_cov_16.038690	574	654	9	15	80	0.1875000
NODE_4930_length_1107_cov_16.038690	574	654	11	14	80	0.1750000
NODE_4930_length_1107_cov_16.038690	574	654	12	9	80	0.1125000
NODE_4930_length_1107_cov_16.038690	574	654	13	22	80	0.2750000
NODE_4930_length_1107_cov_16.038690	627	707	8	13	80	0.1625000
NODE_4930_length_1107_cov_16.038690	627	707	10	5	80	0.0625000
NODE_4930_length_1107_cov_16.038690	627	707	12	8	80	0.1000000
NODE_4930_length_1107_cov_16.038690	627	707	13	50	80	0.6250000
NODE_4930_length_1107_cov_16.038690	627	707	15	4	80	0.0500000
NODE_4931_length_1107_cov_15.472222	78	158	24	3	80	0.0375000
NODE_4931_length_1107_cov_15.472222	78	158	26	1	80	0.0125000
NODE_4931_length_1107_cov_15.472222	78	158	27	1	80	0.0125000
NODE_4931_length_1107_cov_15.472222	78	158	28	3	80	0.0375000
NODE_4931_length_1107_cov_15.472222	78	158	29	11	80	0.1375000
NODE_4931_length_1107_cov_15.472222	78	158	30	13	80	0.1625000
NODE_4931_length_1107_cov_15.472222	78	158	31	1	80	0.0125000
NODE_4931_length_1107_cov_15.472222	78	158	32	10	80	0.1250000
NODE_4931_length_1107_cov_15.472222	78	158	33	25	80	0.3125000
NODE_4931_length_1107_cov_15.472222	78	158	34	12	80	0.1500000
NODE_4931_length_1107_cov_15.472222	131	194	5	9	63	0.1428571
NODE_4931_length_1107_cov_15.472222	131	194	6	1	63	0.0158730
NODE_4931_length_1107_cov_15.472222	131	194	7	2	63	0.0317460
NODE_4931_length_1107_cov_15.472222	131	194	8	2	63	0.0317460
NODE_4931_length_1107_cov_15.472222	131	194	13	1	63	0.0158730
NODE_4931_length_1107_cov_15.472222	131	194	14	9	63	0.1428571
NODE_4931_length_1107_cov_15.472222	131	194	16	1	63	0.0158730
NODE_4931_length_1107_cov_15.472222	131	194	17	1	63	0.0158730
NODE_4931_length_1107_cov_15.472222	131	194	19	2	63	0.0317460
NODE_4931_length_1107_cov_15.472222	131	194	20	1	63	0.0158730
NODE_4931_length_1107_cov_15.472222	131	194	22	2	63	0.0317460
NODE_4931_length_1107_cov_15.472222	131	194	24	8	63	0.1269841
NODE_4931_length_1107_cov_15.472222	131	194	26	1	63	0.0158730
NODE_4931_length_1107_cov_15.472222	131	194	27	1	63	0.0158730
NODE_4931_length_1107_cov_15.472222	131	194	28	3	63	0.0476190
NODE_4931_length_1107_cov_15.472222	131	194	29	11	63	0.1746032
NODE_4931_length_1107_cov_15.472222	131	194	30	7	63	0.1111111
NODE_4931_length_1107_cov_15.472222	131	194	31	1	63	0.0158730
NODE_4931_length_1107_cov_15.472222	952	995	0	41	43	0.9534883
NODE_4931_length_1107_cov_15.472222	952	995	1	2	43	0.0465116
NODE_4931_length_1107_cov_15.472222	968	1052	0	84	84	1.0000000
NODE_4932_length_1107_cov_13.911706	502	582	2	57	80	0.7125000
NODE_4932_length_1107_cov_13.911706	502	582	3	23	80	0.2875000
NODE_4932_length_1107_cov_13.911706	555	635	1	52	80	0.6500000
NODE_4932_length_1107_cov_13.911706	555	635	2	22	80	0.2750000
NODE_4932_length_1107_cov_13.911706	555	635	3	6	80	0.0750000
NODE_4933_length_1107_cov_11.701389	520	600	2	23	80	0.2875000
NODE_4933_length_1107_cov_11.701389	520	600	4	11	80	0.1375000
NODE_4933_length_1107_cov_11.701389	520	600	5	26	80	0.3250000
NODE_4933_length_1107_cov_11.701389	520	600	6	20	80	0.2500000
NODE_4933_length_1107_cov_11.701389	573	653	2	7	80	0.0875000
NODE_4933_length_1107_cov_11.701389	573	653	4	23	80	0.2875000
NODE_4933_length_1107_cov_11.701389	573	653	5	7	80	0.0875000
NODE_4933_length_1107_cov_11.701389	573	653	6	43	80	0.5375000
NODE_4944_length_1106_cov_59.617676	452	532	11	8	80	0.1000000
NODE_4944_length_1106_cov_59.617676	452	532	12	10	80	0.1250000
NODE_4944_length_1106_cov_59.617676	452	532	16	1	80	0.0125000
NODE_4944_length_1106_cov_59.617676	452	532	18	2	80	0.0250000
NODE_4944_length_1106_cov_59.617676	452	532	19	36	80	0.4500000
NODE_4944_length_1106_cov_59.617676	452	532	20	6	80	0.0750000
NODE_4944_length_1106_cov_59.617676	452	532	21	10	80	0.1250000
NODE_4944_length_1106_cov_59.617676	452	532	22	7	80	0.0875000
NODE_4944_length_1106_cov_59.617676	505	585	15	12	80	0.1500000
NODE_4944_length_1106_cov_59.617676	505	585	16	5	80	0.0625000
NODE_4944_length_1106_cov_59.617676	505	585	17	20	80	0.2500000
NODE_4944_length_1106_cov_59.617676	505	585	19	10	80	0.1250000
NODE_4944_length_1106_cov_59.617676	505	585	20	6	80	0.0750000
NODE_4944_length_1106_cov_59.617676	505	585	21	11	80	0.1375000
NODE_4944_length_1106_cov_59.617676	505	585	22	16	80	0.2000000
NODE_4944_length_1106_cov_59.617676	581	661	14	3	80	0.0375000
NODE_4944_length_1106_cov_59.617676	581	661	15	8	80	0.1000000
NODE_4944_length_1106_cov_59.617676	581	661	16	10	80	0.1250000
NODE_4944_length_1106_cov_59.617676	581	661	17	26	80	0.3250000
NODE_4944_length_1106_cov_59.617676	581	661	18	3	80	0.0375000
NODE_4944_length_1106_cov_59.617676	581	661	19	14	80	0.1750000
NODE_4944_length_1106_cov_59.617676	581	661	20	13	80	0.1625000
NODE_4944_length_1106_cov_59.617676	581	661	21	3	80	0.0375000
NODE_4944_length_1106_cov_59.617676	634	714	9	5	80	0.0625000
NODE_4944_length_1106_cov_59.617676	634	714	10	3	80	0.0375000
NODE_4944_length_1106_cov_59.617676	634	714	11	8	80	0.1000000
NODE_4944_length_1106_cov_59.617676	634	714	12	20	80	0.2500000
NODE_4944_length_1106_cov_59.617676	634	714	13	1	80	0.0125000
NODE_4944_length_1106_cov_59.617676	634	714	14	9	80	0.1125000
NODE_4944_length_1106_cov_59.617676	634	714	15	3	80	0.0375000
NODE_4944_length_1106_cov_59.617676	634	714	16	6	80	0.0750000
NODE_4944_length_1106_cov_59.617676	634	714	17	25	80	0.3125000
NODE_4945_length_1106_cov_40.808342	439	504	5	46	65	0.7076923
NODE_4945_length_1106_cov_40.808342	439	504	6	19	65	0.2923077
NODE_4945_length_1106_cov_40.808342	471	511	5	40	40	1.0000000
NODE_4945_length_1106_cov_40.808342	503	569	1	10	66	0.1515152
NODE_4945_length_1106_cov_40.808342	503	569	2	1	66	0.0151515
NODE_4945_length_1106_cov_40.808342	503	569	3	2	66	0.0303030
NODE_4945_length_1106_cov_40.808342	503	569	4	8	66	0.1212121
NODE_4945_length_1106_cov_40.808342	503	569	5	21	66	0.3181818
NODE_4945_length_1106_cov_40.808342	503	569	7	13	66	0.1969697
NODE_4945_length_1106_cov_40.808342	503	569	8	11	66	0.1666667
NODE_4945_length_1106_cov_40.808342	536	601	4	4	65	0.0615385
NODE_4945_length_1106_cov_40.808342	536	601	5	5	65	0.0769231
NODE_4945_length_1106_cov_40.808342	536	601	7	13	65	0.2000000
NODE_4945_length_1106_cov_40.808342	536	601	8	31	65	0.4769231
NODE_4945_length_1106_cov_40.808342	536	601	9	1	65	0.0153846
NODE_4945_length_1106_cov_40.808342	536	601	10	1	65	0.0153846
NODE_4945_length_1106_cov_40.808342	536	601	11	6	65	0.0923077
NODE_4945_length_1106_cov_40.808342	536	601	12	4	65	0.0615385
NODE_4945_length_1106_cov_40.808342	568	648	8	21	80	0.2625000
NODE_4945_length_1106_cov_40.808342	568	648	9	1	80	0.0125000
NODE_4945_length_1106_cov_40.808342	568	648	10	1	80	0.0125000
NODE_4945_length_1106_cov_40.808342	568	648	11	6	80	0.0750000
NODE_4945_length_1106_cov_40.808342	568	648	12	51	80	0.6375000
NODE_4945_length_1106_cov_40.808342	621	682	6	1	61	0.0163934
NODE_4945_length_1106_cov_40.808342	621	682	8	13	61	0.2131148
NODE_4945_length_1106_cov_40.808342	621	682	9	2	61	0.0327869
NODE_4945_length_1106_cov_40.808342	621	682	10	4	61	0.0655738
NODE_4945_length_1106_cov_40.808342	621	682	12	41	61	0.6721311
NODE_4946_length_1106_cov_23.186693	560	640	6	1	80	0.0125000
NODE_4946_length_1106_cov_23.186693	560	640	8	22	80	0.2750000
NODE_4946_length_1106_cov_23.186693	560	640	9	41	80	0.5125000
NODE_4946_length_1106_cov_23.186693	560	640	10	16	80	0.2000000
NODE_4946_length_1106_cov_23.186693	613	693	5	4	80	0.0500000
NODE_4946_length_1106_cov_23.186693	613	693	7	23	80	0.2875000
NODE_4946_length_1106_cov_23.186693	613	693	8	3	80	0.0375000
NODE_4946_length_1106_cov_23.186693	613	693	9	31	80	0.3875000
NODE_4946_length_1106_cov_23.186693	613	693	10	19	80	0.2375000
NODE_4947_length_1106_cov_14.570010	466	546	3	2	80	0.0250000
NODE_4947_length_1106_cov_14.570010	466	546	4	8	80	0.1000000
NODE_4947_length_1106_cov_14.570010	466	546	5	24	80	0.3000000
NODE_4947_length_1106_cov_14.570010	466	546	7	9	80	0.1125000
NODE_4947_length_1106_cov_14.570010	466	546	8	6	80	0.0750000
NODE_4947_length_1106_cov_14.570010	466	546	9	4	80	0.0500000
NODE_4947_length_1106_cov_14.570010	466	546	10	27	80	0.3375000
NODE_4947_length_1106_cov_14.570010	519	599	7	2	80	0.0250000
NODE_4947_length_1106_cov_14.570010	519	599	8	7	80	0.0875000
NODE_4947_length_1106_cov_14.570010	519	599	9	34	80	0.4250000
NODE_4947_length_1106_cov_14.570010	519	599	10	37	80	0.4625000
NODE_4948_length_1106_cov_14.039722	487	567	7	4	80	0.0500000
NODE_4948_length_1106_cov_14.039722	487	567	8	6	80	0.0750000
NODE_4948_length_1106_cov_14.039722	487	567	9	7	80	0.0875000
NODE_4948_length_1106_cov_14.039722	487	567	10	63	80	0.7875000
NODE_4948_length_1106_cov_14.039722	540	620	3	3	80	0.0375000
NODE_4948_length_1106_cov_14.039722	540	620	4	1	80	0.0125000
NODE_4948_length_1106_cov_14.039722	540	620	5	17	80	0.2125000
NODE_4948_length_1106_cov_14.039722	540	620	6	18	80	0.2250000
NODE_4948_length_1106_cov_14.039722	540	620	7	18	80	0.2250000
NODE_4948_length_1106_cov_14.039722	540	620	8	6	80	0.0750000
NODE_4948_length_1106_cov_14.039722	540	620	10	17	80	0.2125000
NODE_4949_length_1106_cov_8.872890	328	408	1	42	80	0.5250000
NODE_4949_length_1106_cov_8.872890	328	408	2	38	80	0.4750000
NODE_4949_length_1106_cov_8.872890	381	461	1	49	80	0.6125000
NODE_4949_length_1106_cov_8.872890	381	461	2	31	80	0.3875000
NODE_4950_length_1106_cov_7.157895	332	412	2	29	80	0.3625000
NODE_4950_length_1106_cov_7.157895	332	412	4	51	80	0.6375000
NODE_4950_length_1106_cov_7.157895	385	465	1	23	80	0.2875000
NODE_4950_length_1106_cov_7.157895	385	465	3	9	80	0.1125000
NODE_4950_length_1106_cov_7.157895	385	465	4	48	80	0.6000000
NODE_4951_length_1106_cov_6.530288	513	593	0	80	80	1.0000000
NODE_4951_length_1106_cov_6.530288	566	646	0	80	80	1.0000000
NODE_4959_length_1105_cov_28.126243	253	333	3	9	80	0.1125000
NODE_4959_length_1105_cov_28.126243	253	333	4	17	80	0.2125000
NODE_4959_length_1105_cov_28.126243	253	333	6	14	80	0.1750000
NODE_4959_length_1105_cov_28.126243	253	333	8	10	80	0.1250000
NODE_4959_length_1105_cov_28.126243	253	333	9	1	80	0.0125000
NODE_4959_length_1105_cov_28.126243	253	333	12	8	80	0.1000000
NODE_4959_length_1105_cov_28.126243	253	333	13	4	80	0.0500000
NODE_4959_length_1105_cov_28.126243	253	333	14	8	80	0.1000000
NODE_4959_length_1105_cov_28.126243	253	333	15	9	80	0.1125000
NODE_4959_length_1105_cov_28.126243	306	386	12	6	80	0.0750000
NODE_4959_length_1105_cov_28.126243	306	386	13	13	80	0.1625000
NODE_4959_length_1105_cov_28.126243	306	386	14	30	80	0.3750000
NODE_4959_length_1105_cov_28.126243	306	386	15	15	80	0.1875000
NODE_4959_length_1105_cov_28.126243	306	386	16	6	80	0.0750000
NODE_4959_length_1105_cov_28.126243	306	386	17	8	80	0.1000000
NODE_4959_length_1105_cov_28.126243	306	386	18	2	80	0.0250000
NODE_4960_length_1105_cov_24.994036	549	629	3	26	80	0.3250000
NODE_4960_length_1105_cov_24.994036	549	629	5	54	80	0.6750000
NODE_4960_length_1105_cov_24.994036	602	682	1	4	80	0.0500000
NODE_4960_length_1105_cov_24.994036	602	682	2	18	80	0.2250000
NODE_4960_length_1105_cov_24.994036	602	682	3	5	80	0.0625000
NODE_4960_length_1105_cov_24.994036	602	682	4	16	80	0.2000000
NODE_4960_length_1105_cov_24.994036	602	682	5	37	80	0.4625000
NODE_4961_length_1105_cov_17.635189	442	522	7	80	80	1.0000000
NODE_4961_length_1105_cov_17.635189	495	575	1	3	80	0.0375000
NODE_4961_length_1105_cov_17.635189	495	575	2	24	80	0.3000000
NODE_4961_length_1105_cov_17.635189	495	575	3	9	80	0.1125000
NODE_4961_length_1105_cov_17.635189	495	575	5	2	80	0.0250000
NODE_4961_length_1105_cov_17.635189	495	575	7	42	80	0.5250000
NODE_4963_length_1105_cov_10.114314	438	518	4	6	80	0.0750000
NODE_4963_length_1105_cov_10.114314	438	518	6	74	80	0.9250000
NODE_4963_length_1105_cov_10.114314	491	571	2	8	80	0.1000000
NODE_4963_length_1105_cov_10.114314	491	571	3	22	80	0.2750000
NODE_4963_length_1105_cov_10.114314	491	571	4	22	80	0.2750000
NODE_4963_length_1105_cov_10.114314	491	571	6	28	80	0.3500000
NODE_4964_length_1105_cov_8.403579	507	587	0	5	80	0.0625000
NODE_4964_length_1105_cov_8.403579	507	587	1	23	80	0.2875000
NODE_4964_length_1105_cov_8.403579	507	587	3	9	80	0.1125000
NODE_4964_length_1105_cov_8.403579	507	587	4	11	80	0.1375000
NODE_4964_length_1105_cov_8.403579	507	587	5	28	80	0.3500000
NODE_4964_length_1105_cov_8.403579	507	587	6	4	80	0.0500000
NODE_4964_length_1105_cov_8.403579	560	640	5	35	80	0.4375000
NODE_4964_length_1105_cov_8.403579	560	640	6	18	80	0.2250000
NODE_4964_length_1105_cov_8.403579	560	640	7	27	80	0.3375000
NODE_4966_length_1105_cov_6.682903	467	547	3	17	80	0.2125000
NODE_4966_length_1105_cov_6.682903	467	547	4	63	80	0.7875000
NODE_4966_length_1105_cov_6.682903	520	600	1	10	80	0.1250000
NODE_4966_length_1105_cov_6.682903	520	600	2	1	80	0.0125000
NODE_4966_length_1105_cov_6.682903	520	600	3	19	80	0.2375000
NODE_4966_length_1105_cov_6.682903	520	600	4	50	80	0.6250000
NODE_4966_length_1105_cov_6.682903	596	676	1	2	80	0.0250000
NODE_4966_length_1105_cov_6.682903	596	676	3	43	80	0.5375000
NODE_4966_length_1105_cov_6.682903	596	676	4	31	80	0.3875000
NODE_4966_length_1105_cov_6.682903	596	676	5	4	80	0.0500000
NODE_4966_length_1105_cov_6.682903	649	729	3	2	80	0.0250000
NODE_4966_length_1105_cov_6.682903	649	729	4	21	80	0.2625000
NODE_4966_length_1105_cov_6.682903	649	729	5	57	80	0.7125000
NODE_4974_length_1104_cov_27.599005	388	468	2	4	80	0.0500000
NODE_4974_length_1104_cov_27.599005	388	468	3	9	80	0.1125000
NODE_4974_length_1104_cov_27.599005	388	468	4	4	80	0.0500000
NODE_4974_length_1104_cov_27.599005	388	468	5	3	80	0.0375000
NODE_4974_length_1104_cov_27.599005	388	468	6	30	80	0.3750000
NODE_4974_length_1104_cov_27.599005	388	468	7	30	80	0.3750000
NODE_4974_length_1104_cov_27.599005	441	521	5	56	80	0.7000000
NODE_4974_length_1104_cov_27.599005	441	521	6	19	80	0.2375000
NODE_4974_length_1104_cov_27.599005	441	521	7	5	80	0.0625000
NODE_4984_length_1103_cov_2.787849	620	682	3	41	62	0.6612903
NODE_4984_length_1103_cov_2.787849	620	682	4	21	62	0.3387097
NODE_4986_length_1102_cov_34.484546	667	747	9	12	80	0.1500000
NODE_4986_length_1102_cov_34.484546	667	747	10	4	80	0.0500000
NODE_4986_length_1102_cov_34.484546	667	747	12	27	80	0.3375000
NODE_4986_length_1102_cov_34.484546	667	747	13	36	80	0.4500000
NODE_4986_length_1102_cov_34.484546	667	747	14	1	80	0.0125000
NODE_4986_length_1102_cov_34.484546	720	800	8	3	80	0.0375000
NODE_4986_length_1102_cov_34.484546	720	800	9	29	80	0.3625000
NODE_4986_length_1102_cov_34.484546	720	800	10	8	80	0.1000000
NODE_4986_length_1102_cov_34.484546	720	800	12	33	80	0.4125000
NODE_4986_length_1102_cov_34.484546	720	800	13	7	80	0.0875000
NODE_4987_length_1102_cov_17.631107	511	587	5	19	76	0.2500000
NODE_4987_length_1102_cov_17.631107	511	587	7	11	76	0.1447368
NODE_4987_length_1102_cov_17.631107	511	587	8	20	76	0.2631579
NODE_4987_length_1102_cov_17.631107	511	587	10	1	76	0.0131579
NODE_4987_length_1102_cov_17.631107	511	587	11	11	76	0.1447368
NODE_4987_length_1102_cov_17.631107	511	587	12	3	76	0.0394737
NODE_4987_length_1102_cov_17.631107	511	587	13	11	76	0.1447368
NODE_4987_length_1102_cov_17.631107	560	640	8	14	80	0.1750000
NODE_4987_length_1102_cov_17.631107	560	640	10	2	80	0.0250000
NODE_4987_length_1102_cov_17.631107	560	640	11	28	80	0.3500000
NODE_4987_length_1102_cov_17.631107	560	640	12	4	80	0.0500000
NODE_4987_length_1102_cov_17.631107	560	640	13	32	80	0.4000000
NODE_4998_length_1101_cov_35.638723	414	491	3	6	77	0.0779221
NODE_4998_length_1101_cov_35.638723	414	491	4	71	77	0.9220779
NODE_4998_length_1101_cov_35.638723	414	491	3	6	77	0.0779221
NODE_4998_length_1101_cov_35.638723	414	491	4	71	77	0.9220779
NODE_4998_length_1101_cov_35.638723	488	544	3	35	56	0.6250000
NODE_4998_length_1101_cov_35.638723	488	544	4	21	56	0.3750000
NODE_4998_length_1101_cov_35.638723	752	832	0	80	80	1.0000000
NODE_4998_length_1101_cov_35.638723	805	885	0	80	80	1.0000000
NODE_4998_length_1101_cov_35.638723	881	961	0	80	80	1.0000000
NODE_4998_length_1101_cov_35.638723	934	1014	0	80	80	1.0000000
NODE_4999_length_1101_cov_28.366267	452	532	2	2	80	0.0250000
NODE_4999_length_1101_cov_28.366267	452	532	3	23	80	0.2875000
NODE_4999_length_1101_cov_28.366267	452	532	5	55	80	0.6875000
NODE_4999_length_1101_cov_28.366267	505	585	1	1	80	0.0125000
NODE_4999_length_1101_cov_28.366267	505	585	3	26	80	0.3250000
NODE_4999_length_1101_cov_28.366267	505	585	4	13	80	0.1625000
NODE_4999_length_1101_cov_28.366267	505	585	5	40	80	0.5000000
NODE_5000_length_1101_cov_24.513972	475	555	5	28	80	0.3500000
NODE_5000_length_1101_cov_24.513972	475	555	6	3	80	0.0375000
NODE_5000_length_1101_cov_24.513972	475	555	7	33	80	0.4125000
NODE_5000_length_1101_cov_24.513972	475	555	8	16	80	0.2000000
NODE_5000_length_1101_cov_24.513972	528	608	4	13	80	0.1625000
NODE_5000_length_1101_cov_24.513972	528	608	5	1	80	0.0125000
NODE_5000_length_1101_cov_24.513972	528	608	6	3	80	0.0375000
NODE_5000_length_1101_cov_24.513972	528	608	7	35	80	0.4375000
NODE_5000_length_1101_cov_24.513972	528	608	8	28	80	0.3500000
NODE_5001_length_1101_cov_22.315369	335	415	0	9	80	0.1125000
NODE_5001_length_1101_cov_22.315369	335	415	1	12	80	0.1500000
NODE_5001_length_1101_cov_22.315369	335	415	3	1	80	0.0125000
NODE_5001_length_1101_cov_22.315369	335	415	5	27	80	0.3375000
NODE_5001_length_1101_cov_22.315369	335	415	6	10	80	0.1250000
NODE_5001_length_1101_cov_22.315369	335	415	7	21	80	0.2625000
NODE_5001_length_1101_cov_22.315369	388	468	6	6	80	0.0750000
NODE_5001_length_1101_cov_22.315369	388	468	7	27	80	0.3375000
NODE_5001_length_1101_cov_22.315369	388	468	8	31	80	0.3875000
NODE_5001_length_1101_cov_22.315369	388	468	9	2	80	0.0250000
NODE_5001_length_1101_cov_22.315369	388	468	10	14	80	0.1750000
NODE_5001_length_1101_cov_22.315369	464	544	7	10	80	0.1250000
NODE_5001_length_1101_cov_22.315369	464	544	8	28	80	0.3500000
NODE_5001_length_1101_cov_22.315369	464	544	9	15	80	0.1875000
NODE_5001_length_1101_cov_22.315369	464	544	10	27	80	0.3375000
NODE_5001_length_1101_cov_22.315369	517	597	6	26	80	0.3250000
NODE_5001_length_1101_cov_22.315369	517	597	7	2	80	0.0250000
NODE_5001_length_1101_cov_22.315369	517	597	8	1	80	0.0125000
NODE_5001_length_1101_cov_22.315369	517	597	9	35	80	0.4375000
NODE_5001_length_1101_cov_22.315369	517	597	10	16	80	0.2000000
NODE_5002_length_1101_cov_22.070858	419	499	5	8	80	0.1000000
NODE_5002_length_1101_cov_22.070858	419	499	6	62	80	0.7750000
NODE_5002_length_1101_cov_22.070858	419	499	8	10	80	0.1250000
NODE_5002_length_1101_cov_22.070858	472	552	1	10	80	0.1250000
NODE_5002_length_1101_cov_22.070858	472	552	2	14	80	0.1750000
NODE_5002_length_1101_cov_22.070858	472	552	4	25	80	0.3125000
NODE_5002_length_1101_cov_22.070858	472	552	5	12	80	0.1500000
NODE_5002_length_1101_cov_22.070858	472	552	6	19	80	0.2375000
NODE_5002_length_1101_cov_22.070858	548	628	0	74	80	0.9250000
NODE_5002_length_1101_cov_22.070858	548	628	1	6	80	0.0750000
NODE_5002_length_1101_cov_22.070858	601	681	0	80	80	1.0000000
NODE_5003_length_1101_cov_18.821357	469	549	3	8	80	0.1000000
NODE_5003_length_1101_cov_18.821357	469	549	5	3	80	0.0375000
NODE_5003_length_1101_cov_18.821357	469	549	8	38	80	0.4750000
NODE_5003_length_1101_cov_18.821357	469	549	10	22	80	0.2750000
NODE_5003_length_1101_cov_18.821357	469	549	12	9	80	0.1125000
NODE_5003_length_1101_cov_18.821357	522	602	10	30	80	0.3750000
NODE_5003_length_1101_cov_18.821357	522	602	12	50	80	0.6250000
NODE_5004_length_1101_cov_17.151697	502	582	7	20	80	0.2500000
NODE_5004_length_1101_cov_17.151697	502	582	8	18	80	0.2250000
NODE_5004_length_1101_cov_17.151697	502	582	9	34	80	0.4250000
NODE_5004_length_1101_cov_17.151697	502	582	10	8	80	0.1000000
NODE_5004_length_1101_cov_17.151697	555	635	3	12	80	0.1500000
NODE_5004_length_1101_cov_17.151697	555	635	5	4	80	0.0500000
NODE_5004_length_1101_cov_17.151697	555	635	7	57	80	0.7125000
NODE_5004_length_1101_cov_17.151697	555	635	9	7	80	0.0875000
NODE_5005_length_1101_cov_8.371257	968	1048	4	1	80	0.0125000
NODE_5005_length_1101_cov_8.371257	968	1048	6	25	80	0.3125000
NODE_5005_length_1101_cov_8.371257	968	1048	8	52	80	0.6500000
NODE_5005_length_1101_cov_8.371257	968	1048	10	1	80	0.0125000
NODE_5005_length_1101_cov_8.371257	968	1048	12	1	80	0.0125000
NODE_5010_length_1100_cov_42.528472	582	662	7	3	80	0.0375000
NODE_5010_length_1100_cov_42.528472	582	662	8	16	80	0.2000000
NODE_5010_length_1100_cov_42.528472	582	662	9	15	80	0.1875000
NODE_5010_length_1100_cov_42.528472	582	662	10	39	80	0.4875000
NODE_5010_length_1100_cov_42.528472	582	662	11	6	80	0.0750000
NODE_5010_length_1100_cov_42.528472	582	662	12	1	80	0.0125000
NODE_5010_length_1100_cov_42.528472	635	715	3	4	80	0.0500000
NODE_5010_length_1100_cov_42.528472	635	715	4	10	80	0.1250000
NODE_5010_length_1100_cov_42.528472	635	715	5	5	80	0.0625000
NODE_5010_length_1100_cov_42.528472	635	715	6	4	80	0.0500000
NODE_5010_length_1100_cov_42.528472	635	715	7	25	80	0.3125000
NODE_5010_length_1100_cov_42.528472	635	715	8	24	80	0.3000000
NODE_5010_length_1100_cov_42.528472	635	715	9	8	80	0.1000000
NODE_5010_length_1100_cov_42.528472	711	791	3	15	80	0.1875000
NODE_5010_length_1100_cov_42.528472	711	791	4	14	80	0.1750000
NODE_5010_length_1100_cov_42.528472	711	791	5	45	80	0.5625000
NODE_5010_length_1100_cov_42.528472	711	791	6	6	80	0.0750000
NODE_5010_length_1100_cov_42.528472	764	844	4	7	80	0.0875000
NODE_5010_length_1100_cov_42.528472	764	844	5	21	80	0.2625000
NODE_5010_length_1100_cov_42.528472	764	844	6	52	80	0.6500000
NODE_5011_length_1100_cov_40.883117	324	404	3	23	80	0.2875000
NODE_5011_length_1100_cov_40.883117	324	404	4	57	80	0.7125000
NODE_5011_length_1100_cov_40.883117	377	457	4	45	80	0.5625000
NODE_5011_length_1100_cov_40.883117	377	457	5	29	80	0.3625000
NODE_5011_length_1100_cov_40.883117	377	457	6	6	80	0.0750000
NODE_5011_length_1100_cov_40.883117	453	533	5	26	80	0.3250000
NODE_5011_length_1100_cov_40.883117	453	533	6	12	80	0.1500000
NODE_5011_length_1100_cov_40.883117	453	533	7	31	80	0.3875000
NODE_5011_length_1100_cov_40.883117	453	533	8	10	80	0.1250000
NODE_5011_length_1100_cov_40.883117	453	533	9	1	80	0.0125000
NODE_5011_length_1100_cov_40.883117	506	586	7	19	80	0.2375000
NODE_5011_length_1100_cov_40.883117	506	586	8	21	80	0.2625000
NODE_5011_length_1100_cov_40.883117	506	586	9	15	80	0.1875000
NODE_5011_length_1100_cov_40.883117	506	586	10	20	80	0.2500000
NODE_5011_length_1100_cov_40.883117	506	586	11	5	80	0.0625000
NODE_5012_length_1100_cov_23.160839	524	604	0	62	80	0.7750000
NODE_5012_length_1100_cov_23.160839	524	604	1	10	80	0.1250000
NODE_5012_length_1100_cov_23.160839	524	604	2	8	80	0.1000000
NODE_5012_length_1100_cov_23.160839	577	657	0	9	80	0.1125000
NODE_5012_length_1100_cov_23.160839	577	657	1	10	80	0.1250000
NODE_5012_length_1100_cov_23.160839	577	657	2	32	80	0.4000000
NODE_5012_length_1100_cov_23.160839	577	657	3	8	80	0.1000000
NODE_5012_length_1100_cov_23.160839	577	657	5	3	80	0.0375000
NODE_5012_length_1100_cov_23.160839	577	657	6	13	80	0.1625000
NODE_5012_length_1100_cov_23.160839	577	657	8	5	80	0.0625000
NODE_5012_length_1100_cov_23.160839	653	733	8	28	80	0.3500000
NODE_5012_length_1100_cov_23.160839	653	733	9	4	80	0.0500000
NODE_5012_length_1100_cov_23.160839	653	733	10	18	80	0.2250000
NODE_5012_length_1100_cov_23.160839	653	733	12	4	80	0.0500000
NODE_5012_length_1100_cov_23.160839	653	733	13	19	80	0.2375000
NODE_5012_length_1100_cov_23.160839	653	733	14	4	80	0.0500000
NODE_5012_length_1100_cov_23.160839	653	733	15	3	80	0.0375000
NODE_5012_length_1100_cov_23.160839	706	786	8	7	80	0.0875000
NODE_5012_length_1100_cov_23.160839	706	786	10	1	80	0.0125000
NODE_5012_length_1100_cov_23.160839	706	786	11	10	80	0.1250000
NODE_5012_length_1100_cov_23.160839	706	786	12	1	80	0.0125000
NODE_5012_length_1100_cov_23.160839	706	786	13	41	80	0.5125000
NODE_5012_length_1100_cov_23.160839	706	786	14	14	80	0.1750000
NODE_5012_length_1100_cov_23.160839	706	786	15	6	80	0.0750000
NODE_5013_length_1100_cov_22.200799	485	565	2	16	80	0.2000000
NODE_5013_length_1100_cov_22.200799	485	565	3	20	80	0.2500000
NODE_5013_length_1100_cov_22.200799	485	565	4	44	80	0.5500000
NODE_5013_length_1100_cov_22.200799	538	618	1	14	80	0.1750000
NODE_5013_length_1100_cov_22.200799	538	618	2	52	80	0.6500000
NODE_5013_length_1100_cov_22.200799	538	618	3	14	80	0.1750000
NODE_5013_length_1100_cov_22.200799	614	694	2	1	80	0.0125000
NODE_5013_length_1100_cov_22.200799	614	694	3	69	80	0.8625000
NODE_5013_length_1100_cov_22.200799	614	694	4	10	80	0.1250000
NODE_5013_length_1100_cov_22.200799	667	745	3	61	78	0.7820513
NODE_5013_length_1100_cov_22.200799	667	745	4	1	78	0.0128205
NODE_5013_length_1100_cov_22.200799	667	745	5	10	78	0.1282051
NODE_5013_length_1100_cov_22.200799	667	745	6	6	78	0.0769231
NODE_5014_length_1100_cov_15.353646	472	552	0	1	80	0.0125000
NODE_5014_length_1100_cov_15.353646	472	552	2	79	80	0.9875000
NODE_5014_length_1100_cov_15.353646	525	605	0	54	80	0.6750000
NODE_5014_length_1100_cov_15.353646	525	605	2	26	80	0.3250000
NODE_5015_length_1100_cov_14.584416	673	753	2	1	80	0.0125000
NODE_5015_length_1100_cov_14.584416	673	753	3	22	80	0.2750000
NODE_5015_length_1100_cov_14.584416	673	753	4	15	80	0.1875000
NODE_5015_length_1100_cov_14.584416	673	753	5	42	80	0.5250000
NODE_5015_length_1100_cov_14.584416	726	806	0	19	80	0.2375000
NODE_5015_length_1100_cov_14.584416	726	806	2	35	80	0.4375000
NODE_5015_length_1100_cov_14.584416	726	806	3	2	80	0.0250000
NODE_5015_length_1100_cov_14.584416	726	806	4	15	80	0.1875000
NODE_5015_length_1100_cov_14.584416	726	806	5	9	80	0.1125000
NODE_5029_length_1099_cov_85.893000	464	544	14	14	80	0.1750000
NODE_5029_length_1099_cov_85.893000	464	544	15	12	80	0.1500000
NODE_5029_length_1099_cov_85.893000	464	544	17	23	80	0.2875000
NODE_5029_length_1099_cov_85.893000	464	544	19	31	80	0.3875000
NODE_5029_length_1099_cov_85.893000	517	597	5	3	80	0.0375000
NODE_5029_length_1099_cov_85.893000	517	597	6	21	80	0.2625000
NODE_5029_length_1099_cov_85.893000	517	597	7	2	80	0.0250000
NODE_5029_length_1099_cov_85.893000	517	597	10	1	80	0.0125000
NODE_5029_length_1099_cov_85.893000	517	597	11	6	80	0.0750000
NODE_5029_length_1099_cov_85.893000	517	597	13	5	80	0.0625000
NODE_5029_length_1099_cov_85.893000	517	597	14	18	80	0.2250000
NODE_5029_length_1099_cov_85.893000	517	597	15	14	80	0.1750000
NODE_5029_length_1099_cov_85.893000	517	597	17	2	80	0.0250000
NODE_5029_length_1099_cov_85.893000	517	597	19	8	80	0.1000000
NODE_5029_length_1099_cov_85.893000	593	673	2	2	80	0.0250000
NODE_5029_length_1099_cov_85.893000	593	673	3	1	80	0.0125000
NODE_5029_length_1099_cov_85.893000	593	673	4	52	80	0.6500000
NODE_5029_length_1099_cov_85.893000	593	673	5	15	80	0.1875000
NODE_5029_length_1099_cov_85.893000	593	673	6	10	80	0.1250000
NODE_5029_length_1099_cov_85.893000	646	726	1	28	80	0.3500000
NODE_5029_length_1099_cov_85.893000	646	726	2	27	80	0.3375000
NODE_5029_length_1099_cov_85.893000	646	726	3	1	80	0.0125000
NODE_5029_length_1099_cov_85.893000	646	726	4	24	80	0.3000000
NODE_5030_length_1099_cov_45.874000	521	601	0	14	80	0.1750000
NODE_5030_length_1099_cov_45.874000	521	601	1	21	80	0.2625000
NODE_5030_length_1099_cov_45.874000	521	601	2	31	80	0.3875000
NODE_5030_length_1099_cov_45.874000	521	601	3	1	80	0.0125000
NODE_5030_length_1099_cov_45.874000	521	601	4	13	80	0.1625000
NODE_5030_length_1099_cov_45.874000	574	654	2	13	80	0.1625000
NODE_5030_length_1099_cov_45.874000	574	654	3	1	80	0.0125000
NODE_5030_length_1099_cov_45.874000	574	654	4	39	80	0.4875000
NODE_5030_length_1099_cov_45.874000	574	654	5	8	80	0.1000000
NODE_5030_length_1099_cov_45.874000	574	654	6	19	80	0.2375000
NODE_5030_length_1099_cov_45.874000	650	730	4	24	80	0.3000000
NODE_5030_length_1099_cov_45.874000	650	730	5	21	80	0.2625000
NODE_5030_length_1099_cov_45.874000	650	730	6	35	80	0.4375000
NODE_5030_length_1099_cov_45.874000	703	783	1	6	80	0.0750000
NODE_5030_length_1099_cov_45.874000	703	783	2	39	80	0.4875000
NODE_5030_length_1099_cov_45.874000	703	783	3	1	80	0.0125000
NODE_5030_length_1099_cov_45.874000	703	783	4	31	80	0.3875000
NODE_5030_length_1099_cov_45.874000	703	783	5	3	80	0.0375000
NODE_5031_length_1099_cov_25.192000	526	606	4	17	80	0.2125000
NODE_5031_length_1099_cov_25.192000	526	606	5	19	80	0.2375000
NODE_5031_length_1099_cov_25.192000	526	606	6	44	80	0.5500000
NODE_5031_length_1099_cov_25.192000	579	659	2	35	80	0.4375000
NODE_5031_length_1099_cov_25.192000	579	659	3	8	80	0.1000000
NODE_5031_length_1099_cov_25.192000	579	659	4	27	80	0.3375000
NODE_5031_length_1099_cov_25.192000	579	659	6	10	80	0.1250000
NODE_5032_length_1099_cov_11.846000	565	645	5	70	80	0.8750000
NODE_5032_length_1099_cov_11.846000	565	645	6	7	80	0.0875000
NODE_5032_length_1099_cov_11.846000	565	645	7	3	80	0.0375000
NODE_5032_length_1099_cov_11.846000	618	698	5	34	80	0.4250000
NODE_5032_length_1099_cov_11.846000	618	698	6	42	80	0.5250000
NODE_5032_length_1099_cov_11.846000	618	698	7	4	80	0.0500000
NODE_5033_length_1099_cov_9.527000	495	575	6	32	80	0.4000000
NODE_5033_length_1099_cov_9.527000	495	575	7	36	80	0.4500000
NODE_5033_length_1099_cov_9.527000	495	575	8	12	80	0.1500000
NODE_5033_length_1099_cov_9.527000	548	628	1	4	80	0.0500000
NODE_5033_length_1099_cov_9.527000	548	628	2	23	80	0.2875000
NODE_5033_length_1099_cov_9.527000	548	628	4	1	80	0.0125000
NODE_5033_length_1099_cov_9.527000	548	628	6	52	80	0.6500000
NODE_5034_length_1099_cov_8.993000	464	544	2	51	80	0.6375000
NODE_5034_length_1099_cov_8.993000	464	544	4	29	80	0.3625000
NODE_5034_length_1099_cov_8.993000	517	597	4	36	80	0.4500000
NODE_5034_length_1099_cov_8.993000	517	597	5	44	80	0.5500000
NODE_5039_length_1099_cov_2.286000	273	353	1	68	80	0.8500000
NODE_5039_length_1099_cov_2.286000	273	353	2	12	80	0.1500000
NODE_5045_length_1098_cov_44.988989	360	440	14	13	80	0.1625000
NODE_5045_length_1098_cov_44.988989	360	440	15	18	80	0.2250000
NODE_5045_length_1098_cov_44.988989	360	440	16	45	80	0.5625000
NODE_5045_length_1098_cov_44.988989	360	440	17	4	80	0.0500000
NODE_5045_length_1098_cov_44.988989	413	493	4	3	80	0.0375000
NODE_5045_length_1098_cov_44.988989	413	493	5	13	80	0.1625000
NODE_5045_length_1098_cov_44.988989	413	493	6	5	80	0.0625000
NODE_5045_length_1098_cov_44.988989	413	493	7	3	80	0.0375000
NODE_5045_length_1098_cov_44.988989	413	493	8	5	80	0.0625000
NODE_5045_length_1098_cov_44.988989	413	493	9	1	80	0.0125000
NODE_5045_length_1098_cov_44.988989	413	493	11	2	80	0.0250000
NODE_5045_length_1098_cov_44.988989	413	493	12	14	80	0.1750000
NODE_5045_length_1098_cov_44.988989	413	493	14	11	80	0.1375000
NODE_5045_length_1098_cov_44.988989	413	493	15	13	80	0.1625000
NODE_5045_length_1098_cov_44.988989	413	493	16	10	80	0.1250000
NODE_5046_length_1098_cov_35.192192	452	532	7	13	80	0.1625000
NODE_5046_length_1098_cov_35.192192	452	532	8	10	80	0.1250000
NODE_5046_length_1098_cov_35.192192	452	532	9	3	80	0.0375000
NODE_5046_length_1098_cov_35.192192	452	532	10	17	80	0.2125000
NODE_5046_length_1098_cov_35.192192	452	532	11	1	80	0.0125000
NODE_5046_length_1098_cov_35.192192	452	532	12	31	80	0.3875000
NODE_5046_length_1098_cov_35.192192	452	532	13	5	80	0.0625000
NODE_5046_length_1098_cov_35.192192	505	585	7	13	80	0.1625000
NODE_5046_length_1098_cov_35.192192	505	585	8	41	80	0.5125000
NODE_5046_length_1098_cov_35.192192	505	585	9	1	80	0.0125000
NODE_5046_length_1098_cov_35.192192	505	585	10	9	80	0.1125000
NODE_5046_length_1098_cov_35.192192	505	585	11	1	80	0.0125000
NODE_5046_length_1098_cov_35.192192	505	585	12	15	80	0.1875000
NODE_5046_length_1098_cov_35.192192	581	661	5	23	80	0.2875000
NODE_5046_length_1098_cov_35.192192	581	661	6	4	80	0.0500000
NODE_5046_length_1098_cov_35.192192	581	661	7	7	80	0.0875000
NODE_5046_length_1098_cov_35.192192	581	661	8	20	80	0.2500000
NODE_5046_length_1098_cov_35.192192	581	661	9	23	80	0.2875000
NODE_5046_length_1098_cov_35.192192	581	661	10	3	80	0.0375000
NODE_5046_length_1098_cov_35.192192	634	714	4	11	80	0.1375000
NODE_5046_length_1098_cov_35.192192	634	714	5	65	80	0.8125000
NODE_5046_length_1098_cov_35.192192	634	714	6	4	80	0.0500000
NODE_5047_length_1098_cov_28.743744	449	529	0	73	80	0.9125000
NODE_5047_length_1098_cov_28.743744	449	529	1	7	80	0.0875000
NODE_5047_length_1098_cov_28.743744	502	582	0	20	80	0.2500000
NODE_5047_length_1098_cov_28.743744	502	582	1	9	80	0.1125000
NODE_5047_length_1098_cov_28.743744	502	582	2	14	80	0.1750000
NODE_5047_length_1098_cov_28.743744	502	582	3	31	80	0.3875000
NODE_5047_length_1098_cov_28.743744	502	582	4	4	80	0.0500000
NODE_5047_length_1098_cov_28.743744	502	582	5	2	80	0.0250000
NODE_5047_length_1098_cov_28.743744	578	658	4	2	80	0.0250000
NODE_5047_length_1098_cov_28.743744	578	658	5	67	80	0.8375000
NODE_5047_length_1098_cov_28.743744	578	658	6	11	80	0.1375000
NODE_5047_length_1098_cov_28.743744	631	711	3	16	80	0.2000000
NODE_5047_length_1098_cov_28.743744	631	711	4	14	80	0.1750000
NODE_5047_length_1098_cov_28.743744	631	711	5	25	80	0.3125000
NODE_5047_length_1098_cov_28.743744	631	711	6	25	80	0.3125000
NODE_5048_length_1098_cov_28.230230	477	557	10	20	80	0.2500000
NODE_5048_length_1098_cov_28.230230	477	557	11	16	80	0.2000000
NODE_5048_length_1098_cov_28.230230	477	557	12	6	80	0.0750000
NODE_5048_length_1098_cov_28.230230	477	557	13	5	80	0.0625000
NODE_5048_length_1098_cov_28.230230	477	557	14	9	80	0.1125000
NODE_5048_length_1098_cov_28.230230	477	557	15	6	80	0.0750000
NODE_5048_length_1098_cov_28.230230	477	557	16	18	80	0.2250000
NODE_5048_length_1098_cov_28.230230	530	610	8	9	80	0.1125000
NODE_5048_length_1098_cov_28.230230	530	610	9	36	80	0.4500000
NODE_5048_length_1098_cov_28.230230	530	610	10	4	80	0.0500000
NODE_5048_length_1098_cov_28.230230	530	610	12	1	80	0.0125000
NODE_5048_length_1098_cov_28.230230	530	610	14	4	80	0.0500000
NODE_5048_length_1098_cov_28.230230	530	610	15	6	80	0.0750000
NODE_5048_length_1098_cov_28.230230	530	610	16	20	80	0.2500000
NODE_5048_length_1098_cov_28.230230	606	686	4	3	80	0.0375000
NODE_5048_length_1098_cov_28.230230	606	686	5	9	80	0.1125000
NODE_5048_length_1098_cov_28.230230	606	686	6	5	80	0.0625000
NODE_5048_length_1098_cov_28.230230	606	686	7	12	80	0.1500000
NODE_5048_length_1098_cov_28.230230	606	686	8	51	80	0.6375000
NODE_5048_length_1098_cov_28.230230	659	739	2	26	80	0.3250000
NODE_5048_length_1098_cov_28.230230	659	739	3	24	80	0.3000000
NODE_5048_length_1098_cov_28.230230	659	739	4	6	80	0.0750000
NODE_5048_length_1098_cov_28.230230	659	739	5	9	80	0.1125000
NODE_5048_length_1098_cov_28.230230	659	739	6	5	80	0.0625000
NODE_5048_length_1098_cov_28.230230	659	739	7	7	80	0.0875000
NODE_5048_length_1098_cov_28.230230	659	739	8	3	80	0.0375000
NODE_5049_length_1098_cov_26.131131	494	574	7	24	80	0.3000000
NODE_5049_length_1098_cov_26.131131	494	574	8	9	80	0.1125000
NODE_5049_length_1098_cov_26.131131	494	574	9	28	80	0.3500000
NODE_5049_length_1098_cov_26.131131	494	574	10	19	80	0.2375000
NODE_5049_length_1098_cov_26.131131	547	627	4	2	80	0.0250000
NODE_5049_length_1098_cov_26.131131	547	627	6	13	80	0.1625000
NODE_5049_length_1098_cov_26.131131	547	627	8	26	80	0.3250000
NODE_5049_length_1098_cov_26.131131	547	627	9	6	80	0.0750000
NODE_5049_length_1098_cov_26.131131	547	627	10	33	80	0.4125000
NODE_5050_length_1098_cov_21.355355	599	679	4	9	80	0.1125000
NODE_5050_length_1098_cov_21.355355	599	679	5	62	80	0.7750000
NODE_5050_length_1098_cov_21.355355	599	679	6	9	80	0.1125000
NODE_5050_length_1098_cov_21.355355	652	732	4	15	80	0.1875000
NODE_5050_length_1098_cov_21.355355	652	732	5	53	80	0.6625000
NODE_5050_length_1098_cov_21.355355	652	732	6	12	80	0.1500000
NODE_5051_length_1098_cov_17.087087	541	621	0	31	80	0.3875000
NODE_5051_length_1098_cov_17.087087	541	621	2	11	80	0.1375000
NODE_5051_length_1098_cov_17.087087	541	621	3	38	80	0.4750000
NODE_5051_length_1098_cov_17.087087	594	674	3	56	80	0.7000000
NODE_5051_length_1098_cov_17.087087	594	674	4	8	80	0.1000000
NODE_5051_length_1098_cov_17.087087	594	674	5	10	80	0.1250000
NODE_5051_length_1098_cov_17.087087	594	674	7	1	80	0.0125000
NODE_5051_length_1098_cov_17.087087	594	674	8	5	80	0.0625000
NODE_5051_length_1098_cov_17.087087	670	750	7	32	80	0.4000000
NODE_5051_length_1098_cov_17.087087	670	750	8	42	80	0.5250000
NODE_5051_length_1098_cov_17.087087	670	750	9	6	80	0.0750000
NODE_5051_length_1098_cov_17.087087	723	803	4	3	80	0.0375000
NODE_5051_length_1098_cov_17.087087	723	803	5	42	80	0.5250000
NODE_5051_length_1098_cov_17.087087	723	803	7	25	80	0.3125000
NODE_5051_length_1098_cov_17.087087	723	803	8	10	80	0.1250000
NODE_5052_length_1098_cov_15.455455	545	625	0	80	80	1.0000000
NODE_5052_length_1098_cov_15.455455	598	678	0	66	80	0.8250000
NODE_5052_length_1098_cov_15.455455	598	678	1	14	80	0.1750000
NODE_5052_length_1098_cov_15.455455	674	754	1	80	80	1.0000000
NODE_5052_length_1098_cov_15.455455	727	807	1	52	80	0.6500000
NODE_5052_length_1098_cov_15.455455	727	807	2	28	80	0.3500000
NODE_5054_length_1097_cov_37.103206	438	518	3	6	80	0.0750000
NODE_5054_length_1097_cov_37.103206	438	518	4	37	80	0.4625000
NODE_5054_length_1097_cov_37.103206	438	518	5	37	80	0.4625000
NODE_5054_length_1097_cov_37.103206	491	571	3	23	80	0.2875000
NODE_5054_length_1097_cov_37.103206	491	571	5	48	80	0.6000000
NODE_5054_length_1097_cov_37.103206	491	571	6	9	80	0.1125000
NODE_5054_length_1097_cov_37.103206	567	647	4	2	80	0.0250000
NODE_5054_length_1097_cov_37.103206	567	647	5	43	80	0.5375000
NODE_5054_length_1097_cov_37.103206	567	647	6	35	80	0.4375000
NODE_5054_length_1097_cov_37.103206	620	700	3	38	80	0.4750000
NODE_5054_length_1097_cov_37.103206	620	700	5	31	80	0.3875000
NODE_5054_length_1097_cov_37.103206	620	700	6	11	80	0.1375000
NODE_5055_length_1097_cov_32.624248	501	581	9	14	80	0.1750000
NODE_5055_length_1097_cov_32.624248	501	581	11	7	80	0.0875000
NODE_5055_length_1097_cov_32.624248	501	581	13	1	80	0.0125000
NODE_5055_length_1097_cov_32.624248	501	581	14	5	80	0.0625000
NODE_5055_length_1097_cov_32.624248	501	581	16	3	80	0.0375000
NODE_5055_length_1097_cov_32.624248	501	581	17	50	80	0.6250000
NODE_5055_length_1097_cov_32.624248	554	634	8	2	80	0.0250000
NODE_5055_length_1097_cov_32.624248	554	634	9	1	80	0.0125000
NODE_5055_length_1097_cov_32.624248	554	634	10	6	80	0.0750000
NODE_5055_length_1097_cov_32.624248	554	634	12	9	80	0.1125000
NODE_5055_length_1097_cov_32.624248	554	634	14	20	80	0.2500000
NODE_5055_length_1097_cov_32.624248	554	634	15	1	80	0.0125000
NODE_5055_length_1097_cov_32.624248	554	634	16	11	80	0.1375000
NODE_5055_length_1097_cov_32.624248	554	634	17	30	80	0.3750000
NODE_5056_length_1097_cov_25.240481	401	480	6	17	79	0.2151899
NODE_5056_length_1097_cov_25.240481	401	480	7	45	79	0.5696203
NODE_5056_length_1097_cov_25.240481	401	480	8	17	79	0.2151899
NODE_5056_length_1097_cov_25.240481	453	533	5	30	80	0.3750000
NODE_5056_length_1097_cov_25.240481	453	533	6	7	80	0.0875000
NODE_5056_length_1097_cov_25.240481	453	533	7	35	80	0.4375000
NODE_5056_length_1097_cov_25.240481	453	533	8	8	80	0.1000000
NODE_5056_length_1097_cov_25.240481	529	609	4	48	80	0.6000000
NODE_5056_length_1097_cov_25.240481	529	609	5	24	80	0.3000000
NODE_5056_length_1097_cov_25.240481	529	609	7	8	80	0.1000000
NODE_5056_length_1097_cov_25.240481	582	662	1	16	80	0.2000000
NODE_5056_length_1097_cov_25.240481	582	662	3	15	80	0.1875000
NODE_5056_length_1097_cov_25.240481	582	662	4	49	80	0.6125000
NODE_5057_length_1097_cov_21.221443	484	564	1	23	80	0.2875000
NODE_5057_length_1097_cov_21.221443	484	564	2	17	80	0.2125000
NODE_5057_length_1097_cov_21.221443	484	564	3	36	80	0.4500000
NODE_5057_length_1097_cov_21.221443	484	564	5	4	80	0.0500000
NODE_5057_length_1097_cov_21.221443	537	617	3	23	80	0.2875000
NODE_5057_length_1097_cov_21.221443	537	617	4	26	80	0.3250000
NODE_5057_length_1097_cov_21.221443	537	617	5	31	80	0.3875000
NODE_5057_length_1097_cov_21.221443	613	693	1	19	80	0.2375000
NODE_5057_length_1097_cov_21.221443	613	693	2	18	80	0.2250000
NODE_5057_length_1097_cov_21.221443	613	693	3	37	80	0.4625000
NODE_5057_length_1097_cov_21.221443	613	693	4	6	80	0.0750000
NODE_5057_length_1097_cov_21.221443	666	746	1	40	80	0.5000000
NODE_5057_length_1097_cov_21.221443	666	746	2	40	80	0.5000000
NODE_5058_length_1097_cov_20.968938	515	595	1	10	80	0.1250000
NODE_5058_length_1097_cov_20.968938	515	595	2	70	80	0.8750000
NODE_5058_length_1097_cov_20.968938	568	648	0	31	80	0.3875000
NODE_5058_length_1097_cov_20.968938	568	648	1	32	80	0.4000000
NODE_5058_length_1097_cov_20.968938	568	648	2	17	80	0.2125000
NODE_5059_length_1097_cov_13.136273	697	779	3	44	82	0.5365854
NODE_5059_length_1097_cov_13.136273	697	779	4	38	82	0.4634146
NODE_5059_length_1097_cov_13.136273	752	832	1	7	80	0.0875000
NODE_5059_length_1097_cov_13.136273	752	832	2	42	80	0.5250000
NODE_5059_length_1097_cov_13.136273	752	832	3	20	80	0.2500000
NODE_5059_length_1097_cov_13.136273	752	832	4	11	80	0.1375000
NODE_5060_length_1097_cov_6.376754	442	522	2	80	80	1.0000000
NODE_5060_length_1097_cov_6.376754	495	575	1	9	80	0.1125000
NODE_5060_length_1097_cov_6.376754	495	575	2	71	80	0.8875000
NODE_5061_length_1097_cov_6.068136	299	379	0	18	80	0.2250000
NODE_5061_length_1097_cov_6.068136	299	379	1	29	80	0.3625000
NODE_5061_length_1097_cov_6.068136	299	379	2	33	80	0.4125000
NODE_5061_length_1097_cov_6.068136	352	432	2	80	80	1.0000000
NODE_5072_length_1096_cov_55.816449	430	510	6	19	80	0.2375000
NODE_5072_length_1096_cov_55.816449	430	510	7	5	80	0.0625000
NODE_5072_length_1096_cov_55.816449	430	510	8	52	80	0.6500000
NODE_5072_length_1096_cov_55.816449	430	510	9	4	80	0.0500000
NODE_5072_length_1096_cov_55.816449	483	563	8	37	80	0.4625000
NODE_5072_length_1096_cov_55.816449	483	563	9	34	80	0.4250000
NODE_5072_length_1096_cov_55.816449	483	563	10	5	80	0.0625000
NODE_5072_length_1096_cov_55.816449	483	563	11	4	80	0.0500000
NODE_5072_length_1096_cov_55.816449	559	639	6	13	80	0.1625000
NODE_5072_length_1096_cov_55.816449	559	639	7	39	80	0.4875000
NODE_5072_length_1096_cov_55.816449	559	639	8	22	80	0.2750000
NODE_5072_length_1096_cov_55.816449	559	639	9	6	80	0.0750000
NODE_5072_length_1096_cov_55.816449	612	692	4	1	80	0.0125000
NODE_5072_length_1096_cov_55.816449	612	692	5	26	80	0.3250000
NODE_5072_length_1096_cov_55.816449	612	692	7	19	80	0.2375000
NODE_5072_length_1096_cov_55.816449	612	692	8	34	80	0.4250000
NODE_5073_length_1096_cov_24.672016	431	511	4	60	80	0.7500000
NODE_5073_length_1096_cov_24.672016	431	511	5	13	80	0.1625000
NODE_5073_length_1096_cov_24.672016	431	511	6	7	80	0.0875000
NODE_5073_length_1096_cov_24.672016	484	564	2	26	80	0.3250000
NODE_5073_length_1096_cov_24.672016	484	564	3	25	80	0.3125000
NODE_5073_length_1096_cov_24.672016	484	564	4	7	80	0.0875000
NODE_5073_length_1096_cov_24.672016	484	564	5	15	80	0.1875000
NODE_5073_length_1096_cov_24.672016	484	564	6	7	80	0.0875000
NODE_5073_length_1096_cov_24.672016	560	640	2	45	80	0.5625000
NODE_5073_length_1096_cov_24.672016	560	640	4	26	80	0.3250000
NODE_5073_length_1096_cov_24.672016	560	640	6	9	80	0.1125000
NODE_5073_length_1096_cov_24.672016	613	693	4	76	80	0.9500000
NODE_5073_length_1096_cov_24.672016	613	693	6	4	80	0.0500000
NODE_5074_length_1096_cov_22.980943	372	452	12	1	80	0.0125000
NODE_5074_length_1096_cov_22.980943	372	452	14	8	80	0.1000000
NODE_5074_length_1096_cov_22.980943	372	452	15	9	80	0.1125000
NODE_5074_length_1096_cov_22.980943	372	452	16	4	80	0.0500000
NODE_5074_length_1096_cov_22.980943	372	452	17	26	80	0.3250000
NODE_5074_length_1096_cov_22.980943	372	452	18	14	80	0.1750000
NODE_5074_length_1096_cov_22.980943	372	452	19	13	80	0.1625000
NODE_5074_length_1096_cov_22.980943	372	452	20	5	80	0.0625000
NODE_5074_length_1096_cov_22.980943	425	505	8	10	80	0.1250000
NODE_5074_length_1096_cov_22.980943	425	505	10	5	80	0.0625000
NODE_5074_length_1096_cov_22.980943	425	505	11	6	80	0.0750000
NODE_5074_length_1096_cov_22.980943	425	505	12	3	80	0.0375000
NODE_5074_length_1096_cov_22.980943	425	505	13	22	80	0.2750000
NODE_5074_length_1096_cov_22.980943	425	505	14	3	80	0.0375000
NODE_5074_length_1096_cov_22.980943	425	505	15	2	80	0.0250000
NODE_5074_length_1096_cov_22.980943	425	505	17	10	80	0.1250000
NODE_5074_length_1096_cov_22.980943	425	505	18	14	80	0.1750000
NODE_5074_length_1096_cov_22.980943	425	505	19	5	80	0.0625000
NODE_5075_length_1096_cov_16.649950	486	566	7	34	80	0.4250000
NODE_5075_length_1096_cov_16.649950	486	566	8	13	80	0.1625000
NODE_5075_length_1096_cov_16.649950	486	566	9	33	80	0.4125000
NODE_5075_length_1096_cov_16.649950	539	619	2	11	80	0.1375000
NODE_5075_length_1096_cov_16.649950	539	619	3	2	80	0.0250000
NODE_5075_length_1096_cov_16.649950	539	619	4	16	80	0.2000000
NODE_5075_length_1096_cov_16.649950	539	619	5	15	80	0.1875000
NODE_5075_length_1096_cov_16.649950	539	619	7	36	80	0.4500000
NODE_5076_length_1096_cov_16.433300	443	523	2	20	80	0.2500000
NODE_5076_length_1096_cov_16.433300	443	523	3	18	80	0.2250000
NODE_5076_length_1096_cov_16.433300	443	523	4	8	80	0.1000000
NODE_5076_length_1096_cov_16.433300	443	523	5	34	80	0.4250000
NODE_5076_length_1096_cov_16.433300	496	576	4	8	80	0.1000000
NODE_5076_length_1096_cov_16.433300	496	576	5	72	80	0.9000000
NODE_5076_length_1096_cov_16.433300	886	966	0	80	80	1.0000000
NODE_5076_length_1096_cov_16.433300	939	1018	0	50	79	0.6329114
NODE_5076_length_1096_cov_16.433300	939	1018	1	29	79	0.3670886
NODE_5077_length_1096_cov_13.398195	670	750	7	24	80	0.3000000
NODE_5077_length_1096_cov_13.398195	670	750	8	56	80	0.7000000
NODE_5077_length_1096_cov_13.398195	723	803	3	22	80	0.2750000
NODE_5077_length_1096_cov_13.398195	723	803	5	28	80	0.3500000
NODE_5077_length_1096_cov_13.398195	723	803	7	27	80	0.3375000
NODE_5077_length_1096_cov_13.398195	723	803	8	3	80	0.0375000
NODE_5080_length_1095_cov_25.390562	520	600	3	5	80	0.0625000
NODE_5080_length_1095_cov_25.390562	520	600	4	9	80	0.1125000
NODE_5080_length_1095_cov_25.390562	520	600	5	43	80	0.5375000
NODE_5080_length_1095_cov_25.390562	520	600	6	23	80	0.2875000
NODE_5080_length_1095_cov_25.390562	573	653	0	19	80	0.2375000
NODE_5080_length_1095_cov_25.390562	573	653	1	24	80	0.3000000
NODE_5080_length_1095_cov_25.390562	573	653	2	3	80	0.0375000
NODE_5080_length_1095_cov_25.390562	573	653	3	12	80	0.1500000
NODE_5080_length_1095_cov_25.390562	573	653	4	9	80	0.1125000
NODE_5080_length_1095_cov_25.390562	573	653	5	13	80	0.1625000
NODE_5080_length_1095_cov_25.390562	649	729	0	72	80	0.9000000
NODE_5080_length_1095_cov_25.390562	649	729	2	8	80	0.1000000
NODE_5080_length_1095_cov_25.390562	702	782	0	19	80	0.2375000
NODE_5080_length_1095_cov_25.390562	702	782	2	61	80	0.7625000
NODE_5081_length_1095_cov_13.832329	549	629	6	64	80	0.8000000
NODE_5081_length_1095_cov_13.832329	549	629	8	16	80	0.2000000
NODE_5081_length_1095_cov_13.832329	602	682	2	11	80	0.1375000
NODE_5081_length_1095_cov_13.832329	602	682	4	18	80	0.2250000
NODE_5081_length_1095_cov_13.832329	602	682	6	51	80	0.6375000
NODE_5082_length_1095_cov_13.017068	497	577	2	25	80	0.3125000
NODE_5082_length_1095_cov_13.017068	497	577	3	21	80	0.2625000
NODE_5082_length_1095_cov_13.017068	497	577	4	34	80	0.4250000
NODE_5082_length_1095_cov_13.017068	550	630	3	55	80	0.6875000
NODE_5082_length_1095_cov_13.017068	550	630	4	25	80	0.3125000
NODE_5083_length_1095_cov_7.640562	627	707	3	1	80	0.0125000
NODE_5083_length_1095_cov_7.640562	627	707	5	4	80	0.0500000
NODE_5083_length_1095_cov_7.640562	627	707	6	1	80	0.0125000
NODE_5083_length_1095_cov_7.640562	627	707	7	18	80	0.2250000
NODE_5083_length_1095_cov_7.640562	627	707	8	56	80	0.7000000
NODE_5083_length_1095_cov_7.640562	680	760	3	6	80	0.0750000
NODE_5083_length_1095_cov_7.640562	680	760	4	39	80	0.4875000
NODE_5083_length_1095_cov_7.640562	680	760	6	10	80	0.1250000
NODE_5083_length_1095_cov_7.640562	680	760	8	25	80	0.3125000
NODE_5085_length_1095_cov_4.664659	307	387	0	46	80	0.5750000
NODE_5085_length_1095_cov_4.664659	307	387	2	34	80	0.4250000
NODE_5089_length_1094_cov_35.850251	409	489	2	64	80	0.8000000
NODE_5089_length_1094_cov_35.850251	409	489	3	2	80	0.0250000
NODE_5089_length_1094_cov_35.850251	409	489	4	14	80	0.1750000
NODE_5089_length_1094_cov_35.850251	462	542	2	25	80	0.3125000
NODE_5089_length_1094_cov_35.850251	462	542	3	16	80	0.2000000
NODE_5089_length_1094_cov_35.850251	462	542	4	14	80	0.1750000
NODE_5089_length_1094_cov_35.850251	462	542	5	20	80	0.2500000
NODE_5089_length_1094_cov_35.850251	462	542	6	3	80	0.0375000
NODE_5089_length_1094_cov_35.850251	462	542	7	2	80	0.0250000
NODE_5089_length_1094_cov_35.850251	538	618	6	2	80	0.0250000
NODE_5089_length_1094_cov_35.850251	538	618	7	20	80	0.2500000
NODE_5089_length_1094_cov_35.850251	538	618	8	39	80	0.4875000
NODE_5089_length_1094_cov_35.850251	538	618	9	19	80	0.2375000
NODE_5089_length_1094_cov_35.850251	591	671	7	20	80	0.2500000
NODE_5089_length_1094_cov_35.850251	591	671	8	37	80	0.4625000
NODE_5089_length_1094_cov_35.850251	591	671	9	23	80	0.2875000
NODE_5090_length_1094_cov_27.197990	462	542	6	6	80	0.0750000
NODE_5090_length_1094_cov_27.197990	462	542	7	34	80	0.4250000
NODE_5090_length_1094_cov_27.197990	462	542	8	7	80	0.0875000
NODE_5090_length_1094_cov_27.197990	462	542	9	33	80	0.4125000
NODE_5090_length_1094_cov_27.197990	515	595	5	26	80	0.3250000
NODE_5090_length_1094_cov_27.197990	515	595	6	27	80	0.3375000
NODE_5090_length_1094_cov_27.197990	515	595	7	26	80	0.3250000
NODE_5090_length_1094_cov_27.197990	515	595	9	1	80	0.0125000
NODE_5091_length_1094_cov_19.282412	451	531	1	8	80	0.1000000
NODE_5091_length_1094_cov_19.282412	451	531	2	16	80	0.2000000
NODE_5091_length_1094_cov_19.282412	451	531	3	22	80	0.2750000
NODE_5091_length_1094_cov_19.282412	451	531	5	30	80	0.3750000
NODE_5091_length_1094_cov_19.282412	451	531	6	4	80	0.0500000
NODE_5091_length_1094_cov_19.282412	504	584	5	23	80	0.2875000
NODE_5091_length_1094_cov_19.282412	504	584	6	57	80	0.7125000
NODE_5092_length_1094_cov_16.084422	558	614	1	32	56	0.5714286
NODE_5092_length_1094_cov_16.084422	558	614	2	24	56	0.4285714
NODE_5092_length_1094_cov_16.084422	587	667	1	51	80	0.6375000
NODE_5092_length_1094_cov_16.084422	587	667	2	9	80	0.1125000
NODE_5092_length_1094_cov_16.084422	587	667	4	20	80	0.2500000
NODE_5093_length_1094_cov_11.335678	384	464	3	7	80	0.0875000
NODE_5093_length_1094_cov_11.335678	384	464	5	3	80	0.0375000
NODE_5093_length_1094_cov_11.335678	384	464	6	15	80	0.1875000
NODE_5093_length_1094_cov_11.335678	384	464	7	45	80	0.5625000
NODE_5093_length_1094_cov_11.335678	384	464	8	10	80	0.1250000
NODE_5093_length_1094_cov_11.335678	437	517	2	4	80	0.0500000
NODE_5093_length_1094_cov_11.335678	437	517	4	29	80	0.3625000
NODE_5093_length_1094_cov_11.335678	437	517	5	7	80	0.0875000
NODE_5093_length_1094_cov_11.335678	437	517	6	10	80	0.1250000
NODE_5093_length_1094_cov_11.335678	437	517	7	30	80	0.3750000
NODE_5094_length_1094_cov_10.767839	396	476	3	24	80	0.3000000
NODE_5094_length_1094_cov_10.767839	396	476	4	16	80	0.2000000
NODE_5094_length_1094_cov_10.767839	396	476	5	40	80	0.5000000
NODE_5094_length_1094_cov_10.767839	449	529	2	28	80	0.3500000
NODE_5094_length_1094_cov_10.767839	449	529	3	49	80	0.6125000
NODE_5094_length_1094_cov_10.767839	449	529	5	3	80	0.0375000
NODE_5095_length_1094_cov_9.527638	579	659	3	9	80	0.1125000
NODE_5095_length_1094_cov_9.527638	579	659	6	30	80	0.3750000
NODE_5095_length_1094_cov_9.527638	579	659	7	14	80	0.1750000
NODE_5095_length_1094_cov_9.527638	579	659	8	3	80	0.0375000
NODE_5095_length_1094_cov_9.527638	579	659	9	24	80	0.3000000
NODE_5095_length_1094_cov_9.527638	632	712	6	55	80	0.6875000
NODE_5095_length_1094_cov_9.527638	632	712	7	14	80	0.1750000
NODE_5095_length_1094_cov_9.527638	632	712	8	3	80	0.0375000
NODE_5095_length_1094_cov_9.527638	632	712	9	8	80	0.1000000
NODE_5096_length_1094_cov_9.166834	527	607	1	36	80	0.4500000
NODE_5096_length_1094_cov_9.166834	527	607	2	15	80	0.1875000
NODE_5096_length_1094_cov_9.166834	527	607	3	29	80	0.3625000
NODE_5096_length_1094_cov_9.166834	580	660	3	42	80	0.5250000
NODE_5096_length_1094_cov_9.166834	580	660	4	9	80	0.1125000
NODE_5096_length_1094_cov_9.166834	580	660	6	29	80	0.3625000
NODE_5097_length_1094_cov_5.632161	708	768	0	52	60	0.8666667
NODE_5097_length_1094_cov_5.632161	708	768	2	8	60	0.1333333
NODE_5097_length_1094_cov_5.632161	761	821	2	60	60	1.0000000
NODE_5108_length_1093_cov_28.531187	374	454	2	8	80	0.1000000
NODE_5108_length_1093_cov_28.531187	374	454	3	3	80	0.0375000
NODE_5108_length_1093_cov_28.531187	374	454	4	13	80	0.1625000
NODE_5108_length_1093_cov_28.531187	374	454	5	56	80	0.7000000
NODE_5108_length_1093_cov_28.531187	427	507	4	35	80	0.4375000
NODE_5108_length_1093_cov_28.531187	427	507	5	45	80	0.5625000
NODE_5109_length_1093_cov_22.744467	516	596	4	77	80	0.9625000
NODE_5109_length_1093_cov_22.744467	516	596	5	3	80	0.0375000
NODE_5109_length_1093_cov_22.744467	569	649	3	3	80	0.0375000
NODE_5109_length_1093_cov_22.744467	569	649	4	75	80	0.9375000
NODE_5109_length_1093_cov_22.744467	569	649	5	2	80	0.0250000
NODE_5109_length_1093_cov_22.744467	645	725	2	26	80	0.3250000
NODE_5109_length_1093_cov_22.744467	645	725	3	47	80	0.5875000
NODE_5109_length_1093_cov_22.744467	645	725	4	7	80	0.0875000
NODE_5109_length_1093_cov_22.744467	698	778	1	29	80	0.3625000
NODE_5109_length_1093_cov_22.744467	698	778	2	50	80	0.6250000
NODE_5109_length_1093_cov_22.744467	698	778	3	1	80	0.0125000
NODE_5110_length_1093_cov_11.637827	282	362	0	10	80	0.1250000
NODE_5110_length_1093_cov_11.637827	282	362	2	70	80	0.8750000
NODE_5110_length_1093_cov_11.637827	335	415	2	80	80	1.0000000
NODE_5111_length_1093_cov_9.047284	660	740	1	50	80	0.6250000
NODE_5111_length_1093_cov_9.047284	660	740	3	30	80	0.3750000
NODE_5111_length_1093_cov_9.047284	713	793	1	17	80	0.2125000
NODE_5111_length_1093_cov_9.047284	713	793	2	12	80	0.1500000
NODE_5111_length_1093_cov_9.047284	713	793	3	51	80	0.6375000
NODE_5112_length_1093_cov_6.857143	658	738	1	80	80	1.0000000
NODE_5112_length_1093_cov_6.857143	711	791	1	73	80	0.9125000
NODE_5112_length_1093_cov_6.857143	711	791	2	7	80	0.0875000
NODE_5113_length_1093_cov_5.311871	587	667	1	42	80	0.5250000
NODE_5113_length_1093_cov_5.311871	587	667	2	34	80	0.4250000
NODE_5113_length_1093_cov_5.311871	587	667	3	4	80	0.0500000
NODE_5113_length_1093_cov_5.311871	640	720	2	23	80	0.2875000
NODE_5113_length_1093_cov_5.311871	640	720	3	13	80	0.1625000
NODE_5113_length_1093_cov_5.311871	640	720	4	44	80	0.5500000
NODE_5118_length_1092_cov_105.542800	682	768	28	7	86	0.0813954
NODE_5118_length_1092_cov_105.542800	682	768	29	11	86	0.1279070
NODE_5118_length_1092_cov_105.542800	682	768	30	17	86	0.1976744
NODE_5118_length_1092_cov_105.542800	682	768	31	8	86	0.0930233
NODE_5118_length_1092_cov_105.542800	682	768	32	3	86	0.0348837
NODE_5118_length_1092_cov_105.542800	682	768	33	10	86	0.1162791
NODE_5118_length_1092_cov_105.542800	682	768	34	10	86	0.1162791
NODE_5118_length_1092_cov_105.542800	682	768	35	14	86	0.1627907
NODE_5118_length_1092_cov_105.542800	682	768	36	6	86	0.0697674
NODE_5118_length_1092_cov_105.542800	745	807	25	1	62	0.0161290
NODE_5118_length_1092_cov_105.542800	745	807	26	22	62	0.3548387
NODE_5118_length_1092_cov_105.542800	745	807	27	8	62	0.1290323
NODE_5118_length_1092_cov_105.542800	745	807	28	4	62	0.0645161
NODE_5118_length_1092_cov_105.542800	745	807	29	2	62	0.0322581
NODE_5118_length_1092_cov_105.542800	745	807	30	4	62	0.0645161
NODE_5118_length_1092_cov_105.542800	745	807	31	1	62	0.0161290
NODE_5118_length_1092_cov_105.542800	745	807	34	10	62	0.1612903
NODE_5118_length_1092_cov_105.542800	745	807	35	7	62	0.1129032
NODE_5118_length_1092_cov_105.542800	745	807	36	3	62	0.0483871
NODE_5119_length_1092_cov_30.957704	610	690	4	79	80	0.9875000
NODE_5119_length_1092_cov_30.957704	610	690	5	1	80	0.0125000
NODE_5119_length_1092_cov_30.957704	663	743	1	15	80	0.1875000
NODE_5119_length_1092_cov_30.957704	663	743	2	5	80	0.0625000
NODE_5119_length_1092_cov_30.957704	663	743	3	24	80	0.3000000
NODE_5119_length_1092_cov_30.957704	663	743	4	34	80	0.4250000
NODE_5119_length_1092_cov_30.957704	663	743	5	2	80	0.0250000
NODE_5121_length_1092_cov_16.737160	725	805	10	5	80	0.0625000
NODE_5121_length_1092_cov_16.737160	725	805	13	3	80	0.0375000
NODE_5121_length_1092_cov_16.737160	725	805	14	26	80	0.3250000
NODE_5121_length_1092_cov_16.737160	725	805	15	46	80	0.5750000
NODE_5121_length_1092_cov_16.737160	778	858	9	16	80	0.2000000
NODE_5121_length_1092_cov_16.737160	778	858	11	8	80	0.1000000
NODE_5121_length_1092_cov_16.737160	778	858	12	6	80	0.0750000
NODE_5121_length_1092_cov_16.737160	778	858	13	21	80	0.2625000
NODE_5121_length_1092_cov_16.737160	778	858	15	29	80	0.3625000
NODE_5123_length_1092_cov_11.193353	335	415	2	2	80	0.0250000
NODE_5123_length_1092_cov_11.193353	335	415	3	39	80	0.4875000
NODE_5123_length_1092_cov_11.193353	335	415	4	39	80	0.4875000
NODE_5123_length_1092_cov_11.193353	388	468	3	3	80	0.0375000
NODE_5123_length_1092_cov_11.193353	388	468	4	77	80	0.9625000
NODE_5124_length_1092_cov_9.348439	489	569	1	5	80	0.0625000
NODE_5124_length_1092_cov_9.348439	489	569	2	54	80	0.6750000
NODE_5124_length_1092_cov_9.348439	489	569	4	21	80	0.2625000
NODE_5124_length_1092_cov_9.348439	542	622	2	6	80	0.0750000
NODE_5124_length_1092_cov_9.348439	542	622	3	26	80	0.3250000
NODE_5124_length_1092_cov_9.348439	542	622	4	48	80	0.6000000
NODE_5125_length_1092_cov_7.533736	243	323	0	35	80	0.4375000
NODE_5125_length_1092_cov_7.533736	243	323	2	45	80	0.5625000
NODE_5125_length_1092_cov_7.533736	296	376	2	80	80	1.0000000
NODE_5126_length_1092_cov_6.968781	470	550	0	80	80	1.0000000
NODE_5126_length_1092_cov_6.968781	523	603	0	80	80	1.0000000
NODE_5134_length_1091_cov_54.234879	417	497	6	17	80	0.2125000
NODE_5134_length_1091_cov_54.234879	417	497	7	12	80	0.1500000
NODE_5134_length_1091_cov_54.234879	417	497	9	1	80	0.0125000
NODE_5134_length_1091_cov_54.234879	417	497	10	1	80	0.0125000
NODE_5134_length_1091_cov_54.234879	417	497	11	32	80	0.4000000
NODE_5134_length_1091_cov_54.234879	417	497	12	17	80	0.2125000
NODE_5134_length_1091_cov_54.234879	470	550	10	3	80	0.0375000
NODE_5134_length_1091_cov_54.234879	470	550	11	46	80	0.5750000
NODE_5134_length_1091_cov_54.234879	470	550	12	18	80	0.2250000
NODE_5134_length_1091_cov_54.234879	470	550	13	8	80	0.1000000
NODE_5134_length_1091_cov_54.234879	470	550	14	5	80	0.0625000
NODE_5134_length_1091_cov_54.234879	546	626	12	2	80	0.0250000
NODE_5134_length_1091_cov_54.234879	546	626	14	5	80	0.0625000
NODE_5134_length_1091_cov_54.234879	546	626	15	7	80	0.0875000
NODE_5134_length_1091_cov_54.234879	546	626	16	32	80	0.4000000
NODE_5134_length_1091_cov_54.234879	546	626	17	24	80	0.3000000
NODE_5134_length_1091_cov_54.234879	546	626	18	3	80	0.0375000
NODE_5134_length_1091_cov_54.234879	546	626	19	7	80	0.0875000
NODE_5134_length_1091_cov_54.234879	599	679	14	9	80	0.1125000
NODE_5134_length_1091_cov_54.234879	599	679	15	1	80	0.0125000
NODE_5134_length_1091_cov_54.234879	599	679	16	33	80	0.4125000
NODE_5134_length_1091_cov_54.234879	599	679	17	32	80	0.4000000
NODE_5134_length_1091_cov_54.234879	599	679	18	5	80	0.0625000
NODE_5135_length_1091_cov_35.045363	384	464	4	24	80	0.3000000
NODE_5135_length_1091_cov_35.045363	384	464	5	18	80	0.2250000
NODE_5135_length_1091_cov_35.045363	384	464	6	38	80	0.4750000
NODE_5135_length_1091_cov_35.045363	437	517	3	39	80	0.4875000
NODE_5135_length_1091_cov_35.045363	437	517	4	20	80	0.2500000
NODE_5135_length_1091_cov_35.045363	437	517	5	16	80	0.2000000
NODE_5135_length_1091_cov_35.045363	437	517	6	5	80	0.0625000
NODE_5135_length_1091_cov_35.045363	513	593	4	27	80	0.3375000
NODE_5135_length_1091_cov_35.045363	513	593	5	53	80	0.6625000
NODE_5135_length_1091_cov_35.045363	566	646	4	6	80	0.0750000
NODE_5135_length_1091_cov_35.045363	566	646	5	74	80	0.9250000
NODE_5136_length_1091_cov_28.490927	329	409	0	24	80	0.3000000
NODE_5136_length_1091_cov_28.490927	329	409	2	35	80	0.4375000
NODE_5136_length_1091_cov_28.490927	329	409	4	21	80	0.2625000
NODE_5136_length_1091_cov_28.490927	382	462	2	6	80	0.0750000
NODE_5136_length_1091_cov_28.490927	382	462	4	74	80	0.9250000
NODE_5136_length_1091_cov_28.490927	618	698	8	2	80	0.0250000
NODE_5136_length_1091_cov_28.490927	618	698	9	6	80	0.0750000
NODE_5136_length_1091_cov_28.490927	618	698	10	13	80	0.1625000
NODE_5136_length_1091_cov_28.490927	618	698	11	31	80	0.3875000
NODE_5136_length_1091_cov_28.490927	618	698	12	4	80	0.0500000
NODE_5136_length_1091_cov_28.490927	618	698	13	6	80	0.0750000
NODE_5136_length_1091_cov_28.490927	618	698	14	18	80	0.2250000
NODE_5136_length_1091_cov_28.490927	671	751	8	3	80	0.0375000
NODE_5136_length_1091_cov_28.490927	671	751	10	29	80	0.3625000
NODE_5136_length_1091_cov_28.490927	671	751	11	19	80	0.2375000
NODE_5136_length_1091_cov_28.490927	671	751	12	10	80	0.1250000
NODE_5136_length_1091_cov_28.490927	671	751	13	1	80	0.0125000
NODE_5136_length_1091_cov_28.490927	671	751	14	18	80	0.2250000
NODE_5137_length_1091_cov_23.733871	514	594	6	22	80	0.2750000
NODE_5137_length_1091_cov_23.733871	514	594	7	5	80	0.0625000
NODE_5137_length_1091_cov_23.733871	514	594	8	12	80	0.1500000
NODE_5137_length_1091_cov_23.733871	514	594	9	38	80	0.4750000
NODE_5137_length_1091_cov_23.733871	514	594	11	3	80	0.0375000
NODE_5137_length_1091_cov_23.733871	567	647	7	8	80	0.1000000
NODE_5137_length_1091_cov_23.733871	567	647	8	19	80	0.2375000
NODE_5137_length_1091_cov_23.733871	567	647	9	24	80	0.3000000
NODE_5137_length_1091_cov_23.733871	567	647	10	11	80	0.1375000
NODE_5137_length_1091_cov_23.733871	567	647	11	18	80	0.2250000
NODE_5138_length_1091_cov_13.065524	444	524	0	80	80	1.0000000
NODE_5138_length_1091_cov_13.065524	497	577	0	28	80	0.3500000
NODE_5138_length_1091_cov_13.065524	497	577	1	52	80	0.6500000
NODE_5139_length_1091_cov_10.961694	582	646	1	9	64	0.1406250
NODE_5139_length_1091_cov_10.961694	582	646	2	55	64	0.8593750
NODE_5140_length_1091_cov_8.166331	299	379	0	34	80	0.4250000
NODE_5140_length_1091_cov_8.166331	299	379	1	46	80	0.5750000
NODE_5140_length_1091_cov_8.166331	352	432	0	80	80	1.0000000
NODE_5141_length_1091_cov_7.006048	617	697	2	11	80	0.1375000
NODE_5141_length_1091_cov_7.006048	617	697	3	28	80	0.3500000
NODE_5141_length_1091_cov_7.006048	617	697	4	24	80	0.3000000
NODE_5141_length_1091_cov_7.006048	617	697	5	3	80	0.0375000
NODE_5141_length_1091_cov_7.006048	617	697	6	14	80	0.1750000
NODE_5141_length_1091_cov_7.006048	670	750	4	10	80	0.1250000
NODE_5141_length_1091_cov_7.006048	670	750	5	3	80	0.0375000
NODE_5141_length_1091_cov_7.006048	670	750	6	67	80	0.8375000
NODE_5151_length_1090_cov_73.781029	352	432	3	27	80	0.3375000
NODE_5151_length_1090_cov_73.781029	352	432	4	18	80	0.2250000
NODE_5151_length_1090_cov_73.781029	352	432	7	8	80	0.1000000
NODE_5151_length_1090_cov_73.781029	352	432	9	6	80	0.0750000
NODE_5151_length_1090_cov_73.781029	352	432	11	21	80	0.2625000
NODE_5151_length_1090_cov_73.781029	405	485	9	6	80	0.0750000
NODE_5151_length_1090_cov_73.781029	405	485	11	24	80	0.3000000
NODE_5151_length_1090_cov_73.781029	405	485	12	1	80	0.0125000
NODE_5151_length_1090_cov_73.781029	405	485	13	24	80	0.3000000
NODE_5151_length_1090_cov_73.781029	405	485	14	17	80	0.2125000
NODE_5151_length_1090_cov_73.781029	405	485	15	3	80	0.0375000
NODE_5151_length_1090_cov_73.781029	405	485	16	5	80	0.0625000
NODE_5151_length_1090_cov_73.781029	481	567	15	3	86	0.0348837
NODE_5151_length_1090_cov_73.781029	481	567	16	4	86	0.0465116
NODE_5151_length_1090_cov_73.781029	481	567	18	3	86	0.0348837
NODE_5151_length_1090_cov_73.781029	481	567	20	6	86	0.0697674
NODE_5151_length_1090_cov_73.781029	481	567	21	15	86	0.1744186
NODE_5151_length_1090_cov_73.781029	481	567	23	2	86	0.0232558
NODE_5151_length_1090_cov_73.781029	481	567	24	4	86	0.0465116
NODE_5151_length_1090_cov_73.781029	481	567	25	15	86	0.1744186
NODE_5151_length_1090_cov_73.781029	481	567	26	7	86	0.0813954
NODE_5151_length_1090_cov_73.781029	481	567	27	9	86	0.1046512
NODE_5151_length_1090_cov_73.781029	481	567	28	18	86	0.2093023
NODE_5151_length_1090_cov_73.781029	540	620	19	1	80	0.0125000
NODE_5151_length_1090_cov_73.781029	540	620	21	8	80	0.1000000
NODE_5151_length_1090_cov_73.781029	540	620	22	3	80	0.0375000
NODE_5151_length_1090_cov_73.781029	540	620	24	6	80	0.0750000
NODE_5151_length_1090_cov_73.781029	540	620	25	12	80	0.1500000
NODE_5151_length_1090_cov_73.781029	540	620	26	3	80	0.0375000
NODE_5151_length_1090_cov_73.781029	540	620	27	32	80	0.4000000
NODE_5151_length_1090_cov_73.781029	540	620	28	15	80	0.1875000
NODE_5152_length_1090_cov_42.394551	530	610	6	30	80	0.3750000
NODE_5152_length_1090_cov_42.394551	530	610	8	5	80	0.0625000
NODE_5152_length_1090_cov_42.394551	530	610	10	2	80	0.0250000
NODE_5152_length_1090_cov_42.394551	530	610	11	43	80	0.5375000
NODE_5152_length_1090_cov_42.394551	583	663	6	14	80	0.1750000
NODE_5152_length_1090_cov_42.394551	583	663	7	6	80	0.0750000
NODE_5152_length_1090_cov_42.394551	583	663	9	12	80	0.1500000
NODE_5152_length_1090_cov_42.394551	583	663	10	13	80	0.1625000
NODE_5152_length_1090_cov_42.394551	583	663	11	35	80	0.4375000
NODE_5153_length_1090_cov_37.643794	436	516	2	6	80	0.0750000
NODE_5153_length_1090_cov_37.643794	436	516	3	17	80	0.2125000
NODE_5153_length_1090_cov_37.643794	436	516	5	2	80	0.0250000
NODE_5153_length_1090_cov_37.643794	436	516	6	11	80	0.1375000
NODE_5153_length_1090_cov_37.643794	436	516	7	8	80	0.1000000
NODE_5153_length_1090_cov_37.643794	436	516	9	3	80	0.0375000
NODE_5153_length_1090_cov_37.643794	436	516	10	9	80	0.1125000
NODE_5153_length_1090_cov_37.643794	436	516	11	24	80	0.3000000
NODE_5153_length_1090_cov_37.643794	489	569	10	23	80	0.2875000
NODE_5153_length_1090_cov_37.643794	489	569	11	25	80	0.3125000
NODE_5153_length_1090_cov_37.643794	489	569	12	7	80	0.0875000
NODE_5153_length_1090_cov_37.643794	489	569	14	25	80	0.3125000
NODE_5153_length_1090_cov_37.643794	565	645	5	6	80	0.0750000
NODE_5153_length_1090_cov_37.643794	565	645	6	9	80	0.1125000
NODE_5153_length_1090_cov_37.643794	565	645	8	8	80	0.1000000
NODE_5153_length_1090_cov_37.643794	565	645	9	22	80	0.2750000
NODE_5153_length_1090_cov_37.643794	565	645	10	24	80	0.3000000
NODE_5153_length_1090_cov_37.643794	565	645	11	11	80	0.1375000
NODE_5153_length_1090_cov_37.643794	618	698	5	39	80	0.4875000
NODE_5153_length_1090_cov_37.643794	618	698	6	29	80	0.3625000
NODE_5153_length_1090_cov_37.643794	618	698	8	8	80	0.1000000
NODE_5153_length_1090_cov_37.643794	618	698	9	4	80	0.0500000
NODE_5154_length_1090_cov_32.876892	487	567	6	5	80	0.0625000
NODE_5154_length_1090_cov_32.876892	487	567	8	13	80	0.1625000
NODE_5154_length_1090_cov_32.876892	487	567	9	9	80	0.1125000
NODE_5154_length_1090_cov_32.876892	487	567	10	1	80	0.0125000
NODE_5154_length_1090_cov_32.876892	487	567	12	12	80	0.1500000
NODE_5154_length_1090_cov_32.876892	487	567	13	11	80	0.1375000
NODE_5154_length_1090_cov_32.876892	487	567	14	28	80	0.3500000
NODE_5154_length_1090_cov_32.876892	487	567	15	1	80	0.0125000
NODE_5154_length_1090_cov_32.876892	540	620	10	11	80	0.1375000
NODE_5154_length_1090_cov_32.876892	540	620	11	24	80	0.3000000
NODE_5154_length_1090_cov_32.876892	540	620	12	9	80	0.1125000
NODE_5154_length_1090_cov_32.876892	540	620	13	18	80	0.2250000
NODE_5154_length_1090_cov_32.876892	540	620	14	12	80	0.1500000
NODE_5154_length_1090_cov_32.876892	540	620	15	6	80	0.0750000
NODE_5155_length_1090_cov_25.373360	486	566	0	2	80	0.0250000
NODE_5155_length_1090_cov_25.373360	486	566	1	7	80	0.0875000
NODE_5155_length_1090_cov_25.373360	486	566	3	3	80	0.0375000
NODE_5155_length_1090_cov_25.373360	486	566	5	24	80	0.3000000
NODE_5155_length_1090_cov_25.373360	486	566	6	5	80	0.0625000
NODE_5155_length_1090_cov_25.373360	486	566	7	37	80	0.4625000
NODE_5155_length_1090_cov_25.373360	486	566	9	2	80	0.0250000
NODE_5155_length_1090_cov_25.373360	539	619	6	3	80	0.0375000
NODE_5155_length_1090_cov_25.373360	539	619	7	22	80	0.2750000
NODE_5155_length_1090_cov_25.373360	539	619	9	43	80	0.5375000
NODE_5155_length_1090_cov_25.373360	539	619	10	12	80	0.1500000
NODE_5156_length_1090_cov_21.290616	422	502	1	1	80	0.0125000
NODE_5156_length_1090_cov_21.290616	422	502	2	6	80	0.0750000
NODE_5156_length_1090_cov_21.290616	422	502	3	8	80	0.1000000
NODE_5156_length_1090_cov_21.290616	422	502	4	22	80	0.2750000
NODE_5156_length_1090_cov_21.290616	422	502	6	43	80	0.5375000
NODE_5156_length_1090_cov_21.290616	475	555	4	7	80	0.0875000
NODE_5156_length_1090_cov_21.290616	475	555	6	73	80	0.9125000
NODE_5156_length_1090_cov_21.290616	551	631	0	44	80	0.5500000
NODE_5156_length_1090_cov_21.290616	551	631	1	8	80	0.1000000
NODE_5156_length_1090_cov_21.290616	551	631	2	6	80	0.0750000
NODE_5156_length_1090_cov_21.290616	551	631	3	1	80	0.0125000
NODE_5156_length_1090_cov_21.290616	551	631	4	21	80	0.2625000
NODE_5156_length_1090_cov_21.290616	604	684	0	80	80	1.0000000
NODE_5157_length_1090_cov_16.040363	666	746	3	17	80	0.2125000
NODE_5157_length_1090_cov_16.040363	666	746	4	21	80	0.2625000
NODE_5157_length_1090_cov_16.040363	666	746	5	42	80	0.5250000
NODE_5157_length_1090_cov_16.040363	719	799	0	7	80	0.0875000
NODE_5157_length_1090_cov_16.040363	719	799	1	21	80	0.2625000
NODE_5157_length_1090_cov_16.040363	719	799	2	10	80	0.1250000
NODE_5157_length_1090_cov_16.040363	719	799	3	32	80	0.4000000
NODE_5157_length_1090_cov_16.040363	719	799	4	10	80	0.1250000
NODE_5158_length_1090_cov_14.826438	393	473	3	19	80	0.2375000
NODE_5158_length_1090_cov_14.826438	393	473	4	61	80	0.7625000
NODE_5158_length_1090_cov_14.826438	446	526	1	27	80	0.3375000
NODE_5158_length_1090_cov_14.826438	446	526	3	5	80	0.0625000
NODE_5158_length_1090_cov_14.826438	446	526	4	48	80	0.6000000
NODE_5159_length_1090_cov_13.721493	498	578	1	63	80	0.7875000
NODE_5159_length_1090_cov_13.721493	498	578	2	17	80	0.2125000
NODE_5159_length_1090_cov_13.721493	551	631	1	15	80	0.1875000
NODE_5159_length_1090_cov_13.721493	551	631	2	20	80	0.2500000
NODE_5159_length_1090_cov_13.721493	551	631	3	45	80	0.5625000
NODE_5160_length_1090_cov_12.365288	386	467	2	49	81	0.6049383
NODE_5160_length_1090_cov_12.365288	386	467	3	32	81	0.3950617
NODE_5160_length_1090_cov_12.365288	440	520	2	18	80	0.2250000
NODE_5160_length_1090_cov_12.365288	440	520	3	16	80	0.2000000
NODE_5160_length_1090_cov_12.365288	440	520	4	13	80	0.1625000
NODE_5160_length_1090_cov_12.365288	440	520	5	23	80	0.2875000
NODE_5160_length_1090_cov_12.365288	440	520	6	10	80	0.1250000
NODE_5160_length_1090_cov_12.365288	516	596	5	1	80	0.0125000
NODE_5160_length_1090_cov_12.365288	516	596	6	79	80	0.9875000
NODE_5160_length_1090_cov_12.365288	569	649	2	24	80	0.3000000
NODE_5160_length_1090_cov_12.365288	569	649	3	12	80	0.1500000
NODE_5160_length_1090_cov_12.365288	569	649	5	18	80	0.2250000
NODE_5160_length_1090_cov_12.365288	569	649	6	26	80	0.3250000
NODE_5161_length_1090_cov_5.348133	0	80	0	8	80	0.1000000
NODE_5161_length_1090_cov_5.348133	0	80	3	1	80	0.0125000
NODE_5161_length_1090_cov_5.348133	0	80	5	7	80	0.0875000
NODE_5161_length_1090_cov_5.348133	0	80	7	4	80	0.0500000
NODE_5161_length_1090_cov_5.348133	0	80	9	10	80	0.1250000
NODE_5161_length_1090_cov_5.348133	0	80	10	9	80	0.1125000
NODE_5161_length_1090_cov_5.348133	0	80	11	11	80	0.1375000
NODE_5161_length_1090_cov_5.348133	0	80	12	5	80	0.0625000
NODE_5161_length_1090_cov_5.348133	0	80	13	3	80	0.0375000
NODE_5161_length_1090_cov_5.348133	0	80	14	7	80	0.0875000
NODE_5161_length_1090_cov_5.348133	0	80	15	1	80	0.0125000
NODE_5161_length_1090_cov_5.348133	0	80	16	1	80	0.0125000
NODE_5161_length_1090_cov_5.348133	0	80	17	2	80	0.0250000
NODE_5161_length_1090_cov_5.348133	0	80	18	3	80	0.0375000
NODE_5161_length_1090_cov_5.348133	0	80	19	6	80	0.0750000
NODE_5161_length_1090_cov_5.348133	0	80	21	2	80	0.0250000
NODE_5161_length_1090_cov_5.348133	53	99	12	2	46	0.0434783
NODE_5161_length_1090_cov_5.348133	53	99	13	3	46	0.0652174
NODE_5161_length_1090_cov_5.348133	53	99	14	7	46	0.1521739
NODE_5161_length_1090_cov_5.348133	53	99	15	1	46	0.0217391
NODE_5161_length_1090_cov_5.348133	53	99	16	1	46	0.0217391
NODE_5161_length_1090_cov_5.348133	53	99	17	2	46	0.0434783
NODE_5161_length_1090_cov_5.348133	53	99	18	3	46	0.0652174
NODE_5161_length_1090_cov_5.348133	53	99	19	6	46	0.1304348
NODE_5161_length_1090_cov_5.348133	53	99	21	9	46	0.1956522
NODE_5161_length_1090_cov_5.348133	53	99	22	4	46	0.0869565
NODE_5161_length_1090_cov_5.348133	53	99	23	8	46	0.1739130
NODE_5163_length_1090_cov_3.598385	300	340	8	2	40	0.0500000
NODE_5163_length_1090_cov_3.598385	300	340	9	6	40	0.1500000
NODE_5163_length_1090_cov_3.598385	300	340	10	22	40	0.5500000
NODE_5163_length_1090_cov_3.598385	300	340	11	1	40	0.0250000
NODE_5163_length_1090_cov_3.598385	300	340	12	4	40	0.1000000
NODE_5163_length_1090_cov_3.598385	300	340	13	4	40	0.1000000
NODE_5163_length_1090_cov_3.598385	300	340	14	1	40	0.0250000
NODE_5170_length_1089_cov_55.374747	515	594	13	2	79	0.0253165
NODE_5170_length_1089_cov_55.374747	515	594	15	1	79	0.0126582
NODE_5170_length_1089_cov_55.374747	515	594	16	4	79	0.0506329
NODE_5170_length_1089_cov_55.374747	515	594	17	5	79	0.0632911
NODE_5170_length_1089_cov_55.374747	515	594	19	24	79	0.3037975
NODE_5170_length_1089_cov_55.374747	515	594	20	43	79	0.5443038
NODE_5170_length_1089_cov_55.374747	567	647	10	9	80	0.1125000
NODE_5170_length_1089_cov_55.374747	567	647	11	10	80	0.1250000
NODE_5170_length_1089_cov_55.374747	567	647	12	1	80	0.0125000
NODE_5170_length_1089_cov_55.374747	567	647	13	7	80	0.0875000
NODE_5170_length_1089_cov_55.374747	567	647	14	10	80	0.1250000
NODE_5170_length_1089_cov_55.374747	567	647	15	4	80	0.0500000
NODE_5170_length_1089_cov_55.374747	567	647	17	15	80	0.1875000
NODE_5170_length_1089_cov_55.374747	567	647	19	21	80	0.2625000
NODE_5170_length_1089_cov_55.374747	567	647	20	3	80	0.0375000
NODE_5170_length_1089_cov_55.374747	643	723	6	4	80	0.0500000
NODE_5170_length_1089_cov_55.374747	643	723	7	25	80	0.3125000
NODE_5170_length_1089_cov_55.374747	643	723	8	26	80	0.3250000
NODE_5170_length_1089_cov_55.374747	643	723	9	6	80	0.0750000
NODE_5170_length_1089_cov_55.374747	643	723	10	19	80	0.2375000
NODE_5170_length_1089_cov_55.374747	696	776	4	9	80	0.1125000
NODE_5170_length_1089_cov_55.374747	696	776	5	43	80	0.5375000
NODE_5170_length_1089_cov_55.374747	696	776	6	5	80	0.0625000
NODE_5170_length_1089_cov_55.374747	696	776	7	6	80	0.0750000
NODE_5170_length_1089_cov_55.374747	696	776	8	17	80	0.2125000
NODE_5171_length_1089_cov_38.506061	458	538	7	8	80	0.1000000
NODE_5171_length_1089_cov_38.506061	458	538	8	4	80	0.0500000
NODE_5171_length_1089_cov_38.506061	458	538	10	2	80	0.0250000
NODE_5171_length_1089_cov_38.506061	458	538	11	7	80	0.0875000
NODE_5171_length_1089_cov_38.506061	458	538	12	9	80	0.1125000
NODE_5171_length_1089_cov_38.506061	458	538	13	15	80	0.1875000
NODE_5171_length_1089_cov_38.506061	458	538	14	22	80	0.2750000
NODE_5171_length_1089_cov_38.506061	458	538	15	7	80	0.0875000
NODE_5171_length_1089_cov_38.506061	458	538	16	5	80	0.0625000
NODE_5171_length_1089_cov_38.506061	458	538	17	1	80	0.0125000
NODE_5171_length_1089_cov_38.506061	511	591	11	19	80	0.2375000
NODE_5171_length_1089_cov_38.506061	511	591	12	9	80	0.1125000
NODE_5171_length_1089_cov_38.506061	511	591	13	16	80	0.2000000
NODE_5171_length_1089_cov_38.506061	511	591	14	23	80	0.2875000
NODE_5171_length_1089_cov_38.506061	511	591	15	7	80	0.0875000
NODE_5171_length_1089_cov_38.506061	511	591	16	5	80	0.0625000
NODE_5171_length_1089_cov_38.506061	511	591	17	1	80	0.0125000
NODE_5171_length_1089_cov_38.506061	587	667	4	6	80	0.0750000
NODE_5171_length_1089_cov_38.506061	587	667	5	12	80	0.1500000
NODE_5171_length_1089_cov_38.506061	587	667	6	20	80	0.2500000
NODE_5171_length_1089_cov_38.506061	587	667	7	7	80	0.0875000
NODE_5171_length_1089_cov_38.506061	587	667	8	6	80	0.0750000
NODE_5171_length_1089_cov_38.506061	587	667	9	17	80	0.2125000
NODE_5171_length_1089_cov_38.506061	587	667	10	5	80	0.0625000
NODE_5171_length_1089_cov_38.506061	587	667	11	7	80	0.0875000
NODE_5171_length_1089_cov_38.506061	640	720	2	5	80	0.0625000
NODE_5171_length_1089_cov_38.506061	640	720	3	29	80	0.3625000
NODE_5171_length_1089_cov_38.506061	640	720	4	23	80	0.2875000
NODE_5171_length_1089_cov_38.506061	640	720	5	12	80	0.1500000
NODE_5171_length_1089_cov_38.506061	640	720	6	11	80	0.1375000
NODE_5172_length_1089_cov_22.657576	379	459	7	1	80	0.0125000
NODE_5172_length_1089_cov_22.657576	379	459	9	10	80	0.1250000
NODE_5172_length_1089_cov_22.657576	379	459	10	4	80	0.0500000
NODE_5172_length_1089_cov_22.657576	379	459	11	22	80	0.2750000
NODE_5172_length_1089_cov_22.657576	379	459	12	43	80	0.5375000
NODE_5172_length_1089_cov_22.657576	432	512	5	4	80	0.0500000
NODE_5172_length_1089_cov_22.657576	432	512	6	9	80	0.1125000
NODE_5172_length_1089_cov_22.657576	432	512	7	3	80	0.0375000
NODE_5172_length_1089_cov_22.657576	432	512	9	21	80	0.2625000
NODE_5172_length_1089_cov_22.657576	432	512	10	10	80	0.1250000
NODE_5172_length_1089_cov_22.657576	432	512	11	7	80	0.0875000
NODE_5172_length_1089_cov_22.657576	432	512	12	26	80	0.3250000
NODE_5173_length_1089_cov_21.180808	547	627	8	9	80	0.1125000
NODE_5173_length_1089_cov_21.180808	547	627	9	25	80	0.3125000
NODE_5173_length_1089_cov_21.180808	547	627	10	28	80	0.3500000
NODE_5173_length_1089_cov_21.180808	547	627	11	18	80	0.2250000
NODE_5173_length_1089_cov_21.180808	600	680	9	34	80	0.4250000
NODE_5173_length_1089_cov_21.180808	600	680	10	6	80	0.0750000
NODE_5173_length_1089_cov_21.180808	600	680	11	40	80	0.5000000
NODE_5174_length_1089_cov_18.713131	431	511	4	20	80	0.2500000
NODE_5174_length_1089_cov_18.713131	431	511	5	35	80	0.4375000
NODE_5174_length_1089_cov_18.713131	431	511	6	25	80	0.3125000
NODE_5174_length_1089_cov_18.713131	484	564	4	1	80	0.0125000
NODE_5174_length_1089_cov_18.713131	484	564	5	26	80	0.3250000
NODE_5174_length_1089_cov_18.713131	484	564	6	53	80	0.6625000
NODE_5174_length_1089_cov_18.713131	560	640	1	11	80	0.1375000
NODE_5174_length_1089_cov_18.713131	560	640	2	25	80	0.3125000
NODE_5174_length_1089_cov_18.713131	560	640	3	5	80	0.0625000
NODE_5174_length_1089_cov_18.713131	560	640	4	36	80	0.4500000
NODE_5174_length_1089_cov_18.713131	560	640	6	3	80	0.0375000
NODE_5174_length_1089_cov_18.713131	613	693	0	33	80	0.4125000
NODE_5174_length_1089_cov_18.713131	613	693	1	31	80	0.3875000
NODE_5174_length_1089_cov_18.713131	613	693	2	16	80	0.2000000
NODE_5175_length_1089_cov_17.382828	376	456	0	4	80	0.0500000
NODE_5175_length_1089_cov_17.382828	376	456	1	24	80	0.3000000
NODE_5175_length_1089_cov_17.382828	376	456	2	1	80	0.0125000
NODE_5175_length_1089_cov_17.382828	376	456	3	51	80	0.6375000
NODE_5175_length_1089_cov_17.382828	429	509	3	80	80	1.0000000
NODE_5175_length_1089_cov_17.382828	505	585	3	43	80	0.5375000
NODE_5175_length_1089_cov_17.382828	505	585	4	2	80	0.0250000
NODE_5175_length_1089_cov_17.382828	505	585	5	35	80	0.4375000
NODE_5175_length_1089_cov_17.382828	558	638	1	1	80	0.0125000
NODE_5175_length_1089_cov_17.382828	558	638	3	79	80	0.9875000
NODE_5176_length_1089_cov_14.540404	610	690	8	1	80	0.0125000
NODE_5176_length_1089_cov_14.540404	610	690	10	23	80	0.2875000
NODE_5176_length_1089_cov_14.540404	610	690	11	12	80	0.1500000
NODE_5176_length_1089_cov_14.540404	610	690	12	18	80	0.2250000
NODE_5176_length_1089_cov_14.540404	610	690	13	13	80	0.1625000
NODE_5176_length_1089_cov_14.540404	610	690	14	13	80	0.1625000
NODE_5176_length_1089_cov_14.540404	663	743	8	5	80	0.0625000
NODE_5176_length_1089_cov_14.540404	663	743	9	8	80	0.1000000
NODE_5176_length_1089_cov_14.540404	663	743	10	8	80	0.1000000
NODE_5176_length_1089_cov_14.540404	663	743	11	17	80	0.2125000
NODE_5176_length_1089_cov_14.540404	663	743	12	20	80	0.2500000
NODE_5176_length_1089_cov_14.540404	663	743	13	6	80	0.0750000
NODE_5176_length_1089_cov_14.540404	663	743	14	16	80	0.2000000
NODE_5182_length_1088_cov_10.603640	504	584	9	8	80	0.1000000
NODE_5182_length_1088_cov_10.603640	504	584	11	6	80	0.0750000
NODE_5182_length_1088_cov_10.603640	504	584	13	2	80	0.0250000
NODE_5182_length_1088_cov_10.603640	504	584	15	6	80	0.0750000
NODE_5182_length_1088_cov_10.603640	504	584	16	5	80	0.0625000
NODE_5182_length_1088_cov_10.603640	504	584	17	6	80	0.0750000
NODE_5182_length_1088_cov_10.603640	504	584	18	7	80	0.0875000
NODE_5182_length_1088_cov_10.603640	504	584	20	4	80	0.0500000
NODE_5182_length_1088_cov_10.603640	504	584	21	29	80	0.3625000
NODE_5182_length_1088_cov_10.603640	504	584	22	7	80	0.0875000
NODE_5182_length_1088_cov_10.603640	557	632	14	10	75	0.1333333
NODE_5182_length_1088_cov_10.603640	557	632	16	8	75	0.1066667
NODE_5182_length_1088_cov_10.603640	557	632	18	8	75	0.1066667
NODE_5182_length_1088_cov_10.603640	557	632	20	3	75	0.0400000
NODE_5182_length_1088_cov_10.603640	557	632	21	39	75	0.5200000
NODE_5182_length_1088_cov_10.603640	557	632	22	7	75	0.0933333
NODE_5194_length_1088_cov_0.759353	0	59	0	59	59	1.0000000
NODE_5194_length_1088_cov_0.759353	32	97	0	65	65	1.0000000
NODE_5195_length_1087_cov_51.676113	457	537	14	9	80	0.1125000
NODE_5195_length_1087_cov_51.676113	457	537	16	3	80	0.0375000
NODE_5195_length_1087_cov_51.676113	457	537	17	19	80	0.2375000
NODE_5195_length_1087_cov_51.676113	457	537	18	25	80	0.3125000
NODE_5195_length_1087_cov_51.676113	457	537	19	1	80	0.0125000
NODE_5195_length_1087_cov_51.676113	457	537	20	14	80	0.1750000
NODE_5195_length_1087_cov_51.676113	457	537	21	7	80	0.0875000
NODE_5195_length_1087_cov_51.676113	457	537	22	1	80	0.0125000
NODE_5195_length_1087_cov_51.676113	457	537	23	1	80	0.0125000
NODE_5195_length_1087_cov_51.676113	510	590	14	9	80	0.1125000
NODE_5195_length_1087_cov_51.676113	510	590	15	12	80	0.1500000
NODE_5195_length_1087_cov_51.676113	510	590	18	7	80	0.0875000
NODE_5195_length_1087_cov_51.676113	510	590	19	13	80	0.1625000
NODE_5195_length_1087_cov_51.676113	510	590	20	30	80	0.3750000
NODE_5195_length_1087_cov_51.676113	510	590	21	7	80	0.0875000
NODE_5195_length_1087_cov_51.676113	510	590	22	1	80	0.0125000
NODE_5195_length_1087_cov_51.676113	510	590	23	1	80	0.0125000
NODE_5195_length_1087_cov_51.676113	586	666	2	38	80	0.4750000
NODE_5195_length_1087_cov_51.676113	586	666	4	9	80	0.1125000
NODE_5195_length_1087_cov_51.676113	586	666	5	3	80	0.0375000
NODE_5195_length_1087_cov_51.676113	586	666	6	1	80	0.0125000
NODE_5195_length_1087_cov_51.676113	586	666	7	10	80	0.1250000
NODE_5195_length_1087_cov_51.676113	586	666	10	1	80	0.0125000
NODE_5195_length_1087_cov_51.676113	586	666	12	10	80	0.1250000
NODE_5195_length_1087_cov_51.676113	586	666	14	8	80	0.1000000
NODE_5195_length_1087_cov_51.676113	639	719	1	44	80	0.5500000
NODE_5195_length_1087_cov_51.676113	639	719	2	36	80	0.4500000
NODE_5196_length_1087_cov_47.144737	214	276	17	3	62	0.0483871
NODE_5196_length_1087_cov_47.144737	214	276	19	2	62	0.0322581
NODE_5196_length_1087_cov_47.144737	214	276	20	4	62	0.0645161
NODE_5196_length_1087_cov_47.144737	214	276	22	1	62	0.0161290
NODE_5196_length_1087_cov_47.144737	214	276	26	5	62	0.0806452
NODE_5196_length_1087_cov_47.144737	214	276	27	8	62	0.1290323
NODE_5196_length_1087_cov_47.144737	214	276	30	3	62	0.0483871
NODE_5196_length_1087_cov_47.144737	214	276	32	2	62	0.0322581
NODE_5196_length_1087_cov_47.144737	214	276	33	1	62	0.0161290
NODE_5196_length_1087_cov_47.144737	214	276	35	1	62	0.0161290
NODE_5196_length_1087_cov_47.144737	214	276	37	5	62	0.0806452
NODE_5196_length_1087_cov_47.144737	214	276	38	4	62	0.0645161
NODE_5196_length_1087_cov_47.144737	214	276	40	4	62	0.0645161
NODE_5196_length_1087_cov_47.144737	214	276	41	3	62	0.0483871
NODE_5196_length_1087_cov_47.144737	214	276	42	1	62	0.0161290
NODE_5196_length_1087_cov_47.144737	214	276	44	1	62	0.0161290
NODE_5196_length_1087_cov_47.144737	214	276	45	4	62	0.0645161
NODE_5196_length_1087_cov_47.144737	214	276	47	1	62	0.0161290
NODE_5196_length_1087_cov_47.144737	214	276	48	2	62	0.0322581
NODE_5196_length_1087_cov_47.144737	214	276	50	1	62	0.0161290
NODE_5196_length_1087_cov_47.144737	214	276	51	3	62	0.0483871
NODE_5196_length_1087_cov_47.144737	214	276	52	1	62	0.0161290
NODE_5196_length_1087_cov_47.144737	214	276	53	2	62	0.0322581
NODE_5196_length_1087_cov_47.144737	630	710	6	30	80	0.3750000
NODE_5196_length_1087_cov_47.144737	630	710	7	28	80	0.3500000
NODE_5196_length_1087_cov_47.144737	630	710	8	22	80	0.2750000
NODE_5196_length_1087_cov_47.144737	683	763	3	6	80	0.0750000
NODE_5196_length_1087_cov_47.144737	683	763	4	8	80	0.1000000
NODE_5196_length_1087_cov_47.144737	683	763	6	36	80	0.4500000
NODE_5196_length_1087_cov_47.144737	683	763	7	22	80	0.2750000
NODE_5196_length_1087_cov_47.144737	683	763	8	8	80	0.1000000
NODE_5197_length_1087_cov_46.633603	871	951	5	4	80	0.0500000
NODE_5197_length_1087_cov_46.633603	871	951	7	20	80	0.2500000
NODE_5197_length_1087_cov_46.633603	871	951	8	7	80	0.0875000
NODE_5197_length_1087_cov_46.633603	871	951	9	10	80	0.1250000
NODE_5197_length_1087_cov_46.633603	871	951	11	39	80	0.4875000
NODE_5197_length_1087_cov_46.633603	924	999	2	14	75	0.1866667
NODE_5197_length_1087_cov_46.633603	924	999	3	33	75	0.4400000
NODE_5197_length_1087_cov_46.633603	924	999	5	5	75	0.0666667
NODE_5197_length_1087_cov_46.633603	924	999	7	20	75	0.2666667
NODE_5197_length_1087_cov_46.633603	924	999	8	3	75	0.0400000
NODE_5198_length_1087_cov_30.577935	528	608	9	28	80	0.3500000
NODE_5198_length_1087_cov_30.577935	528	608	10	21	80	0.2625000
NODE_5198_length_1087_cov_30.577935	528	608	11	6	80	0.0750000
NODE_5198_length_1087_cov_30.577935	528	608	12	7	80	0.0875000
NODE_5198_length_1087_cov_30.577935	528	608	14	5	80	0.0625000
NODE_5198_length_1087_cov_30.577935	528	608	15	13	80	0.1625000
NODE_5198_length_1087_cov_30.577935	581	661	9	17	80	0.2125000
NODE_5198_length_1087_cov_30.577935	581	661	10	39	80	0.4875000
NODE_5198_length_1087_cov_30.577935	581	661	12	6	80	0.0750000
NODE_5198_length_1087_cov_30.577935	581	661	14	5	80	0.0625000
NODE_5198_length_1087_cov_30.577935	581	661	15	13	80	0.1625000
NODE_5199_length_1087_cov_30.205466	515	591	8	1	76	0.0131579
NODE_5199_length_1087_cov_30.205466	515	591	10	3	76	0.0394737
NODE_5199_length_1087_cov_30.205466	515	591	12	3	76	0.0394737
NODE_5199_length_1087_cov_30.205466	515	591	13	26	76	0.3421053
NODE_5199_length_1087_cov_30.205466	515	591	14	43	76	0.5657895
NODE_5199_length_1087_cov_30.205466	564	644	6	16	80	0.2000000
NODE_5199_length_1087_cov_30.205466	564	644	7	2	80	0.0250000
NODE_5199_length_1087_cov_30.205466	564	644	9	1	80	0.0125000
NODE_5199_length_1087_cov_30.205466	564	644	10	26	80	0.3250000
NODE_5199_length_1087_cov_30.205466	564	644	12	5	80	0.0625000
NODE_5199_length_1087_cov_30.205466	564	644	13	23	80	0.2875000
NODE_5199_length_1087_cov_30.205466	564	644	14	7	80	0.0875000
NODE_5200_length_1087_cov_29.595142	568	648	10	26	80	0.3250000
NODE_5200_length_1087_cov_29.595142	568	648	11	50	80	0.6250000
NODE_5200_length_1087_cov_29.595142	568	648	13	4	80	0.0500000
NODE_5200_length_1087_cov_29.595142	621	701	3	23	80	0.2875000
NODE_5200_length_1087_cov_29.595142	621	701	4	4	80	0.0500000
NODE_5200_length_1087_cov_29.595142	621	701	5	2	80	0.0250000
NODE_5200_length_1087_cov_29.595142	621	701	6	9	80	0.1125000
NODE_5200_length_1087_cov_29.595142	621	701	8	9	80	0.1125000
NODE_5200_length_1087_cov_29.595142	621	701	9	4	80	0.0500000
NODE_5200_length_1087_cov_29.595142	621	701	10	13	80	0.1625000
NODE_5200_length_1087_cov_29.595142	621	701	11	16	80	0.2000000
NODE_5201_length_1087_cov_11.600202	374	454	0	10	80	0.1250000
NODE_5201_length_1087_cov_11.600202	374	454	1	24	80	0.3000000
NODE_5201_length_1087_cov_11.600202	374	454	2	6	80	0.0750000
NODE_5201_length_1087_cov_11.600202	374	454	3	25	80	0.3125000
NODE_5201_length_1087_cov_11.600202	374	454	4	3	80	0.0375000
NODE_5201_length_1087_cov_11.600202	374	454	5	12	80	0.1500000
NODE_5201_length_1087_cov_11.600202	427	507	3	12	80	0.1500000
NODE_5201_length_1087_cov_11.600202	427	507	4	3	80	0.0375000
NODE_5201_length_1087_cov_11.600202	427	507	5	58	80	0.7250000
NODE_5201_length_1087_cov_11.600202	427	507	6	7	80	0.0875000
NODE_5202_length_1087_cov_7.746964	436	516	4	18	80	0.2250000
NODE_5202_length_1087_cov_7.746964	436	516	5	62	80	0.7750000
NODE_5202_length_1087_cov_7.746964	489	569	2	37	80	0.4625000
NODE_5202_length_1087_cov_7.746964	489	569	3	4	80	0.0500000
NODE_5202_length_1087_cov_7.746964	489	569	4	27	80	0.3375000
NODE_5202_length_1087_cov_7.746964	489	569	5	12	80	0.1500000
NODE_5211_length_1086_cov_35.748734	406	486	3	6	80	0.0750000
NODE_5211_length_1086_cov_35.748734	406	486	4	7	80	0.0875000
NODE_5211_length_1086_cov_35.748734	406	486	6	6	80	0.0750000
NODE_5211_length_1086_cov_35.748734	406	486	8	18	80	0.2250000
NODE_5211_length_1086_cov_35.748734	406	486	9	29	80	0.3625000
NODE_5211_length_1086_cov_35.748734	406	486	10	14	80	0.1750000
NODE_5211_length_1086_cov_35.748734	459	539	5	10	80	0.1250000
NODE_5211_length_1086_cov_35.748734	459	539	6	16	80	0.2000000
NODE_5211_length_1086_cov_35.748734	459	539	7	17	80	0.2125000
NODE_5211_length_1086_cov_35.748734	459	539	9	16	80	0.2000000
NODE_5211_length_1086_cov_35.748734	459	539	10	21	80	0.2625000
NODE_5212_length_1086_cov_18.445795	325	405	0	80	80	1.0000000
NODE_5212_length_1086_cov_18.445795	378	458	0	80	80	1.0000000
NODE_5213_length_1086_cov_16.878419	528	608	2	44	80	0.5500000
NODE_5213_length_1086_cov_16.878419	528	608	3	8	80	0.1000000
NODE_5213_length_1086_cov_16.878419	528	608	4	28	80	0.3500000
NODE_5213_length_1086_cov_16.878419	581	661	3	31	80	0.3875000
NODE_5213_length_1086_cov_16.878419	581	661	4	38	80	0.4750000
NODE_5213_length_1086_cov_16.878419	581	661	5	11	80	0.1375000
NODE_5214_length_1086_cov_10.700101	498	578	2	80	80	1.0000000
NODE_5214_length_1086_cov_10.700101	551	631	0	4	80	0.0500000
NODE_5214_length_1086_cov_10.700101	551	631	2	76	80	0.9500000
NODE_5215_length_1086_cov_10.656535	277	357	6	32	80	0.4000000
NODE_5215_length_1086_cov_10.656535	277	357	7	9	80	0.1125000
NODE_5215_length_1086_cov_10.656535	277	357	8	37	80	0.4625000
NODE_5215_length_1086_cov_10.656535	277	357	9	2	80	0.0250000
NODE_5215_length_1086_cov_10.656535	330	410	4	35	80	0.4375000
NODE_5215_length_1086_cov_10.656535	330	410	6	33	80	0.4125000
NODE_5215_length_1086_cov_10.656535	330	410	7	4	80	0.0500000
NODE_5215_length_1086_cov_10.656535	330	410	8	8	80	0.1000000
NODE_5216_length_1086_cov_6.873354	374	454	0	80	80	1.0000000
NODE_5216_length_1086_cov_6.873354	427	507	0	37	80	0.4625000
NODE_5216_length_1086_cov_6.873354	427	507	1	35	80	0.4375000
NODE_5216_length_1086_cov_6.873354	427	507	2	8	80	0.1000000
NODE_5217_length_1086_cov_5.225937	869	949	1	1	80	0.0125000
NODE_5217_length_1086_cov_5.225937	869	949	2	41	80	0.5125000
NODE_5217_length_1086_cov_5.225937	869	949	4	38	80	0.4750000
NODE_5217_length_1086_cov_5.225937	922	1002	3	36	80	0.4500000
NODE_5217_length_1086_cov_5.225937	922	1002	4	44	80	0.5500000
NODE_5229_length_1085_cov_30.599391	515	595	1	34	80	0.4250000
NODE_5229_length_1085_cov_30.599391	515	595	2	24	80	0.3000000
NODE_5229_length_1085_cov_30.599391	515	595	3	5	80	0.0625000
NODE_5229_length_1085_cov_30.599391	515	595	4	17	80	0.2125000
NODE_5229_length_1085_cov_30.599391	568	648	1	4	80	0.0500000
NODE_5229_length_1085_cov_30.599391	568	648	2	1	80	0.0125000
NODE_5229_length_1085_cov_30.599391	568	648	3	5	80	0.0625000
NODE_5229_length_1085_cov_30.599391	568	648	4	55	80	0.6875000
NODE_5229_length_1085_cov_30.599391	568	648	5	15	80	0.1875000
NODE_5231_length_1085_cov_13.723124	558	638	1	41	80	0.5125000
NODE_5231_length_1085_cov_13.723124	558	638	2	18	80	0.2250000
NODE_5231_length_1085_cov_13.723124	558	638	3	6	80	0.0750000
NODE_5231_length_1085_cov_13.723124	558	638	4	15	80	0.1875000
NODE_5231_length_1085_cov_13.723124	611	691	2	12	80	0.1500000
NODE_5231_length_1085_cov_13.723124	611	691	4	21	80	0.2625000
NODE_5231_length_1085_cov_13.723124	611	691	5	47	80	0.5875000
NODE_5232_length_1085_cov_12.481744	576	656	3	59	80	0.7375000
NODE_5232_length_1085_cov_12.481744	576	656	4	21	80	0.2625000
NODE_5232_length_1085_cov_12.481744	629	709	3	71	80	0.8875000
NODE_5232_length_1085_cov_12.481744	629	709	4	9	80	0.1125000
NODE_5233_length_1085_cov_11.570994	553	633	2	10	80	0.1250000
NODE_5233_length_1085_cov_11.570994	553	633	3	24	80	0.3000000
NODE_5233_length_1085_cov_11.570994	553	633	5	46	80	0.5750000
NODE_5233_length_1085_cov_11.570994	606	686	2	14	80	0.1750000
NODE_5233_length_1085_cov_11.570994	606	686	4	3	80	0.0375000
NODE_5233_length_1085_cov_11.570994	606	686	5	63	80	0.7875000
NODE_5234_length_1085_cov_10.730223	273	353	0	80	80	1.0000000
NODE_5234_length_1085_cov_10.730223	326	406	0	80	80	1.0000000
NODE_5234_length_1085_cov_10.730223	402	482	0	48	80	0.6000000
NODE_5234_length_1085_cov_10.730223	402	482	1	32	80	0.4000000
NODE_5234_length_1085_cov_10.730223	455	535	1	80	80	1.0000000
NODE_5234_length_1085_cov_10.730223	832	908	2	28	76	0.3684210
NODE_5234_length_1085_cov_10.730223	832	908	4	48	76	0.6315789
NODE_5236_length_1085_cov_8.309331	400	480	6	25	80	0.3125000
NODE_5236_length_1085_cov_8.309331	400	480	7	27	80	0.3375000
NODE_5236_length_1085_cov_8.309331	400	480	8	22	80	0.2750000
NODE_5236_length_1085_cov_8.309331	400	480	9	6	80	0.0750000
NODE_5236_length_1085_cov_8.309331	453	533	7	19	80	0.2375000
NODE_5236_length_1085_cov_8.309331	453	533	8	55	80	0.6875000
NODE_5236_length_1085_cov_8.309331	453	533	9	6	80	0.0750000
NODE_5248_length_1084_cov_60.255838	446	524	5	16	78	0.2051282
NODE_5248_length_1084_cov_60.255838	446	524	7	4	78	0.0512821
NODE_5248_length_1084_cov_60.255838	446	524	8	13	78	0.1666667
NODE_5248_length_1084_cov_60.255838	446	524	9	20	78	0.2564103
NODE_5248_length_1084_cov_60.255838	446	524	10	4	78	0.0512821
NODE_5248_length_1084_cov_60.255838	446	524	11	19	78	0.2435897
NODE_5248_length_1084_cov_60.255838	446	524	13	2	78	0.0256410
NODE_5248_length_1084_cov_60.255838	497	577	9	2	80	0.0250000
NODE_5248_length_1084_cov_60.255838	497	577	10	4	80	0.0500000
NODE_5248_length_1084_cov_60.255838	497	577	11	19	80	0.2375000
NODE_5248_length_1084_cov_60.255838	497	577	13	3	80	0.0375000
NODE_5248_length_1084_cov_60.255838	497	577	14	11	80	0.1375000
NODE_5248_length_1084_cov_60.255838	497	577	15	17	80	0.2125000
NODE_5248_length_1084_cov_60.255838	497	577	16	24	80	0.3000000
NODE_5249_length_1084_cov_33.332995	445	525	0	30	80	0.3750000
NODE_5249_length_1084_cov_33.332995	445	525	2	50	80	0.6250000
NODE_5249_length_1084_cov_33.332995	498	578	2	80	80	1.0000000
NODE_5250_length_1084_cov_11.004061	757	837	1	1	80	0.0125000
NODE_5250_length_1084_cov_11.004061	757	837	5	75	80	0.9375000
NODE_5250_length_1084_cov_11.004061	757	837	6	4	80	0.0500000
NODE_5250_length_1084_cov_11.004061	810	890	0	25	80	0.3125000
NODE_5250_length_1084_cov_11.004061	810	890	1	29	80	0.3625000
NODE_5250_length_1084_cov_11.004061	810	890	5	26	80	0.3250000
NODE_5258_length_1083_cov_42.182927	451	531	0	29	80	0.3625000
NODE_5258_length_1083_cov_42.182927	451	531	1	11	80	0.1375000
NODE_5258_length_1083_cov_42.182927	451	531	2	22	80	0.2750000
NODE_5258_length_1083_cov_42.182927	451	531	3	1	80	0.0125000
NODE_5258_length_1083_cov_42.182927	451	531	4	17	80	0.2125000
NODE_5258_length_1083_cov_42.182927	504	584	2	9	80	0.1125000
NODE_5258_length_1083_cov_42.182927	504	584	3	1	80	0.0125000
NODE_5258_length_1083_cov_42.182927	504	584	4	17	80	0.2125000
NODE_5258_length_1083_cov_42.182927	504	584	6	4	80	0.0500000
NODE_5258_length_1083_cov_42.182927	504	584	7	22	80	0.2750000
NODE_5258_length_1083_cov_42.182927	504	584	8	3	80	0.0375000
NODE_5258_length_1083_cov_42.182927	504	584	9	10	80	0.1250000
NODE_5258_length_1083_cov_42.182927	504	584	10	14	80	0.1750000
NODE_5258_length_1083_cov_42.182927	580	660	10	14	80	0.1750000
NODE_5258_length_1083_cov_42.182927	580	660	13	66	80	0.8250000
NODE_5258_length_1083_cov_42.182927	633	713	3	2	80	0.0250000
NODE_5258_length_1083_cov_42.182927	633	713	4	22	80	0.2750000
NODE_5258_length_1083_cov_42.182927	633	713	6	4	80	0.0500000
NODE_5258_length_1083_cov_42.182927	633	713	7	8	80	0.1000000
NODE_5258_length_1083_cov_42.182927	633	713	9	10	80	0.1250000
NODE_5258_length_1083_cov_42.182927	633	713	11	3	80	0.0375000
NODE_5258_length_1083_cov_42.182927	633	713	12	1	80	0.0125000
NODE_5258_length_1083_cov_42.182927	633	713	13	30	80	0.3750000
NODE_5259_length_1083_cov_41.163618	275	355	1	25	80	0.3125000
NODE_5259_length_1083_cov_41.163618	275	355	2	55	80	0.6875000
NODE_5259_length_1083_cov_41.163618	328	408	1	29	80	0.3625000
NODE_5259_length_1083_cov_41.163618	328	408	2	18	80	0.2250000
NODE_5259_length_1083_cov_41.163618	328	408	3	20	80	0.2500000
NODE_5259_length_1083_cov_41.163618	328	408	4	13	80	0.1625000
NODE_5259_length_1083_cov_41.163618	404	484	4	9	80	0.1125000
NODE_5259_length_1083_cov_41.163618	404	484	5	8	80	0.1000000
NODE_5259_length_1083_cov_41.163618	404	484	6	2	80	0.0250000
NODE_5259_length_1083_cov_41.163618	404	484	7	10	80	0.1250000
NODE_5259_length_1083_cov_41.163618	404	484	9	31	80	0.3875000
NODE_5259_length_1083_cov_41.163618	404	484	10	20	80	0.2500000
NODE_5259_length_1083_cov_41.163618	457	537	8	12	80	0.1500000
NODE_5259_length_1083_cov_41.163618	457	537	9	23	80	0.2875000
NODE_5259_length_1083_cov_41.163618	457	537	10	45	80	0.5625000
NODE_5260_length_1083_cov_39.798780	527	607	8	4	80	0.0500000
NODE_5260_length_1083_cov_39.798780	527	607	10	19	80	0.2375000
NODE_5260_length_1083_cov_39.798780	527	607	11	14	80	0.1750000
NODE_5260_length_1083_cov_39.798780	527	607	13	43	80	0.5375000
NODE_5260_length_1083_cov_39.798780	580	660	4	6	80	0.0750000
NODE_5260_length_1083_cov_39.798780	580	660	5	10	80	0.1250000
NODE_5260_length_1083_cov_39.798780	580	660	6	29	80	0.3625000
NODE_5260_length_1083_cov_39.798780	580	660	7	1	80	0.0125000
NODE_5260_length_1083_cov_39.798780	580	660	8	9	80	0.1125000
NODE_5260_length_1083_cov_39.798780	580	660	13	25	80	0.3125000
NODE_5261_length_1083_cov_34.261179	475	555	6	10	80	0.1250000
NODE_5261_length_1083_cov_34.261179	475	555	7	14	80	0.1750000
NODE_5261_length_1083_cov_34.261179	475	555	8	27	80	0.3375000
NODE_5261_length_1083_cov_34.261179	475	555	9	29	80	0.3625000
NODE_5261_length_1083_cov_34.261179	528	608	8	9	80	0.1125000
NODE_5261_length_1083_cov_34.261179	528	608	9	39	80	0.4875000
NODE_5261_length_1083_cov_34.261179	528	608	10	32	80	0.4000000
NODE_5262_length_1083_cov_33.573171	486	566	3	10	80	0.1250000
NODE_5262_length_1083_cov_33.573171	486	566	4	59	80	0.7375000
NODE_5262_length_1083_cov_33.573171	486	566	5	11	80	0.1375000
NODE_5262_length_1083_cov_33.573171	539	619	3	22	80	0.2750000
NODE_5262_length_1083_cov_33.573171	539	619	4	35	80	0.4375000
NODE_5262_length_1083_cov_33.573171	539	619	5	11	80	0.1375000
NODE_5262_length_1083_cov_33.573171	539	619	6	9	80	0.1125000
NODE_5262_length_1083_cov_33.573171	539	619	7	3	80	0.0375000
NODE_5262_length_1083_cov_33.573171	615	695	5	4	80	0.0500000
NODE_5262_length_1083_cov_33.573171	615	695	6	11	80	0.1375000
NODE_5262_length_1083_cov_33.573171	615	695	7	49	80	0.6125000
NODE_5262_length_1083_cov_33.573171	615	695	8	1	80	0.0125000
NODE_5262_length_1083_cov_33.573171	615	695	9	15	80	0.1875000
NODE_5262_length_1083_cov_33.573171	668	748	4	26	80	0.3250000
NODE_5262_length_1083_cov_33.573171	668	748	6	27	80	0.3375000
NODE_5262_length_1083_cov_33.573171	668	748	7	11	80	0.1375000
NODE_5262_length_1083_cov_33.573171	668	748	8	1	80	0.0125000
NODE_5262_length_1083_cov_33.573171	668	748	9	15	80	0.1875000
NODE_5263_length_1083_cov_33.091463	452	532	3	21	80	0.2625000
NODE_5263_length_1083_cov_33.091463	452	532	4	13	80	0.1625000
NODE_5263_length_1083_cov_33.091463	452	532	5	15	80	0.1875000
NODE_5263_length_1083_cov_33.091463	452	532	6	31	80	0.3875000
NODE_5263_length_1083_cov_33.091463	505	585	1	16	80	0.2000000
NODE_5263_length_1083_cov_33.091463	505	585	2	3	80	0.0375000
NODE_5263_length_1083_cov_33.091463	505	585	3	55	80	0.6875000
NODE_5263_length_1083_cov_33.091463	505	585	4	6	80	0.0750000
NODE_5264_length_1083_cov_30.982724	550	630	3	9	80	0.1125000
NODE_5264_length_1083_cov_30.982724	550	630	4	20	80	0.2500000
NODE_5264_length_1083_cov_30.982724	550	630	5	6	80	0.0750000
NODE_5264_length_1083_cov_30.982724	550	630	6	23	80	0.2875000
NODE_5264_length_1083_cov_30.982724	550	630	7	4	80	0.0500000
NODE_5264_length_1083_cov_30.982724	550	630	8	10	80	0.1250000
NODE_5264_length_1083_cov_30.982724	550	630	9	8	80	0.1000000
NODE_5264_length_1083_cov_30.982724	603	683	6	31	80	0.3875000
NODE_5264_length_1083_cov_30.982724	603	683	7	31	80	0.3875000
NODE_5264_length_1083_cov_30.982724	603	683	8	10	80	0.1250000
NODE_5264_length_1083_cov_30.982724	603	683	9	8	80	0.1000000
NODE_5265_length_1083_cov_18.819106	586	666	1	5	80	0.0625000
NODE_5265_length_1083_cov_18.819106	586	666	2	29	80	0.3625000
NODE_5265_length_1083_cov_18.819106	586	666	3	46	80	0.5750000
NODE_5265_length_1083_cov_18.819106	639	719	1	29	80	0.3625000
NODE_5265_length_1083_cov_18.819106	639	719	2	18	80	0.2250000
NODE_5265_length_1083_cov_18.819106	639	719	3	33	80	0.4125000
NODE_5266_length_1083_cov_17.278455	408	488	3	21	80	0.2625000
NODE_5266_length_1083_cov_17.278455	408	488	4	50	80	0.6250000
NODE_5266_length_1083_cov_17.278455	408	488	5	9	80	0.1125000
NODE_5266_length_1083_cov_17.278455	461	541	3	44	80	0.5500000
NODE_5266_length_1083_cov_17.278455	461	541	4	36	80	0.4500000
NODE_5267_length_1083_cov_13.862805	481	561	1	12	80	0.1500000
NODE_5267_length_1083_cov_13.862805	481	561	2	43	80	0.5375000
NODE_5267_length_1083_cov_13.862805	481	561	3	25	80	0.3125000
NODE_5267_length_1083_cov_13.862805	534	614	1	2	80	0.0250000
NODE_5267_length_1083_cov_13.862805	534	614	2	6	80	0.0750000
NODE_5267_length_1083_cov_13.862805	534	614	3	72	80	0.9000000
NODE_5268_length_1083_cov_13.083333	522	602	0	23	80	0.2875000
NODE_5268_length_1083_cov_13.083333	522	602	2	57	80	0.7125000
NODE_5268_length_1083_cov_13.083333	575	655	0	4	80	0.0500000
NODE_5268_length_1083_cov_13.083333	575	655	2	76	80	0.9500000
NODE_5269_length_1083_cov_11.824187	242	322	3	3	80	0.0375000
NODE_5269_length_1083_cov_11.824187	242	322	4	24	80	0.3000000
NODE_5269_length_1083_cov_11.824187	242	322	5	33	80	0.4125000
NODE_5269_length_1083_cov_11.824187	242	322	7	20	80	0.2500000
NODE_5269_length_1083_cov_11.824187	295	375	4	20	80	0.2500000
NODE_5269_length_1083_cov_11.824187	295	375	5	25	80	0.3125000
NODE_5269_length_1083_cov_11.824187	295	375	6	14	80	0.1750000
NODE_5269_length_1083_cov_11.824187	295	375	7	21	80	0.2625000
NODE_5271_length_1083_cov_3.025407	359	439	0	80	80	1.0000000
NODE_5271_length_1083_cov_3.025407	412	489	0	77	77	1.0000000
NODE_5277_length_1082_cov_34.664293	461	541	6	1	80	0.0125000
NODE_5277_length_1082_cov_34.664293	461	541	8	22	80	0.2750000
NODE_5277_length_1082_cov_34.664293	461	541	12	10	80	0.1250000
NODE_5277_length_1082_cov_34.664293	461	541	14	22	80	0.2750000
NODE_5277_length_1082_cov_34.664293	461	541	15	25	80	0.3125000
NODE_5277_length_1082_cov_34.664293	514	594	8	10	80	0.1250000
NODE_5277_length_1082_cov_34.664293	514	594	9	5	80	0.0625000
NODE_5277_length_1082_cov_34.664293	514	594	10	6	80	0.0750000
NODE_5277_length_1082_cov_34.664293	514	594	12	14	80	0.1750000
NODE_5277_length_1082_cov_34.664293	514	594	13	5	80	0.0625000
NODE_5277_length_1082_cov_34.664293	514	594	14	5	80	0.0625000
NODE_5277_length_1082_cov_34.664293	514	594	15	35	80	0.4375000
NODE_5278_length_1082_cov_17.422177	406	486	3	7	80	0.0875000
NODE_5278_length_1082_cov_17.422177	406	486	4	26	80	0.3250000
NODE_5278_length_1082_cov_17.422177	406	486	5	47	80	0.5875000
NODE_5278_length_1082_cov_17.422177	459	539	3	33	80	0.4125000
NODE_5278_length_1082_cov_17.422177	459	539	4	27	80	0.3375000
NODE_5278_length_1082_cov_17.422177	459	539	5	20	80	0.2500000
NODE_5279_length_1082_cov_15.906409	442	522	0	20	80	0.2500000
NODE_5279_length_1082_cov_15.906409	442	522	1	23	80	0.2875000
NODE_5279_length_1082_cov_15.906409	442	522	3	14	80	0.1750000
NODE_5279_length_1082_cov_15.906409	442	522	5	23	80	0.2875000
NODE_5279_length_1082_cov_15.906409	495	575	3	4	80	0.0500000
NODE_5279_length_1082_cov_15.906409	495	575	5	31	80	0.3875000
NODE_5279_length_1082_cov_15.906409	495	575	7	45	80	0.5625000
NODE_5280_length_1082_cov_13.703967	324	404	4	10	80	0.1250000
NODE_5280_length_1082_cov_13.703967	324	404	5	14	80	0.1750000
NODE_5280_length_1082_cov_13.703967	324	404	6	29	80	0.3625000
NODE_5280_length_1082_cov_13.703967	324	404	7	27	80	0.3375000
NODE_5280_length_1082_cov_13.703967	377	457	3	30	80	0.3750000
NODE_5280_length_1082_cov_13.703967	377	457	4	33	80	0.4125000
NODE_5280_length_1082_cov_13.703967	377	457	5	14	80	0.1750000
NODE_5280_length_1082_cov_13.703967	377	457	7	3	80	0.0375000
NODE_5281_length_1082_cov_6.478128	159	205	0	46	46	1.0000000
NODE_5281_length_1082_cov_6.478128	203	283	0	43	80	0.5375000
NODE_5281_length_1082_cov_6.478128	203	283	2	37	80	0.4625000
NODE_5281_length_1082_cov_6.478128	256	336	0	11	80	0.1375000
NODE_5281_length_1082_cov_6.478128	256	336	2	69	80	0.8625000
NODE_5281_length_1082_cov_6.478128	861	941	1	38	80	0.4750000
NODE_5281_length_1082_cov_6.478128	861	941	2	42	80	0.5250000
NODE_5282_length_1082_cov_4.218718	982	1062	20	2	80	0.0250000
NODE_5282_length_1082_cov_4.218718	982	1062	21	5	80	0.0625000
NODE_5282_length_1082_cov_4.218718	982	1062	22	3	80	0.0375000
NODE_5282_length_1082_cov_4.218718	982	1062	23	3	80	0.0375000
NODE_5282_length_1082_cov_4.218718	982	1062	25	3	80	0.0375000
NODE_5282_length_1082_cov_4.218718	982	1062	27	1	80	0.0125000
NODE_5282_length_1082_cov_4.218718	982	1062	28	4	80	0.0500000
NODE_5282_length_1082_cov_4.218718	982	1062	30	1	80	0.0125000
NODE_5282_length_1082_cov_4.218718	982	1062	31	1	80	0.0125000
NODE_5282_length_1082_cov_4.218718	982	1062	33	1	80	0.0125000
NODE_5282_length_1082_cov_4.218718	982	1062	34	4	80	0.0500000
NODE_5282_length_1082_cov_4.218718	982	1062	35	2	80	0.0250000
NODE_5282_length_1082_cov_4.218718	982	1062	36	1	80	0.0125000
NODE_5282_length_1082_cov_4.218718	982	1062	37	3	80	0.0375000
NODE_5282_length_1082_cov_4.218718	982	1062	39	1	80	0.0125000
NODE_5282_length_1082_cov_4.218718	982	1062	40	1	80	0.0125000
NODE_5282_length_1082_cov_4.218718	982	1062	41	1	80	0.0125000
NODE_5282_length_1082_cov_4.218718	982	1062	42	1	80	0.0125000
NODE_5282_length_1082_cov_4.218718	982	1062	43	3	80	0.0375000
NODE_5282_length_1082_cov_4.218718	982	1062	44	1	80	0.0125000
NODE_5282_length_1082_cov_4.218718	982	1062	46	1	80	0.0125000
NODE_5282_length_1082_cov_4.218718	982	1062	47	4	80	0.0500000
NODE_5282_length_1082_cov_4.218718	982	1062	49	7	80	0.0875000
NODE_5282_length_1082_cov_4.218718	982	1062	50	2	80	0.0250000
NODE_5282_length_1082_cov_4.218718	982	1062	51	1	80	0.0125000
NODE_5282_length_1082_cov_4.218718	982	1062	53	1	80	0.0125000
NODE_5282_length_1082_cov_4.218718	982	1062	55	9	80	0.1125000
NODE_5282_length_1082_cov_4.218718	982	1062	57	2	80	0.0250000
NODE_5282_length_1082_cov_4.218718	982	1062	58	2	80	0.0250000
NODE_5282_length_1082_cov_4.218718	982	1062	59	2	80	0.0250000
NODE_5282_length_1082_cov_4.218718	982	1062	61	6	80	0.0750000
NODE_5282_length_1082_cov_4.218718	982	1062	62	1	80	0.0125000
NODE_5291_length_1081_cov_45.308554	510	590	7	24	80	0.3000000
NODE_5291_length_1081_cov_45.308554	510	590	8	10	80	0.1250000
NODE_5291_length_1081_cov_45.308554	510	590	9	8	80	0.1000000
NODE_5291_length_1081_cov_45.308554	510	590	10	24	80	0.3000000
NODE_5291_length_1081_cov_45.308554	510	590	12	14	80	0.1750000
NODE_5291_length_1081_cov_45.308554	563	643	2	10	80	0.1250000
NODE_5291_length_1081_cov_45.308554	563	643	4	25	80	0.3125000
NODE_5291_length_1081_cov_45.308554	563	643	5	9	80	0.1125000
NODE_5291_length_1081_cov_45.308554	563	643	6	2	80	0.0250000
NODE_5291_length_1081_cov_45.308554	563	643	7	29	80	0.3625000
NODE_5291_length_1081_cov_45.308554	563	643	8	5	80	0.0625000
NODE_5292_length_1081_cov_39.581466	476	556	11	13	80	0.1625000
NODE_5292_length_1081_cov_39.581466	476	556	12	52	80	0.6500000
NODE_5292_length_1081_cov_39.581466	476	556	13	15	80	0.1875000
NODE_5292_length_1081_cov_39.581466	529	609	6	21	80	0.2625000
NODE_5292_length_1081_cov_39.581466	529	609	7	4	80	0.0500000
NODE_5292_length_1081_cov_39.581466	529	609	8	12	80	0.1500000
NODE_5292_length_1081_cov_39.581466	529	609	9	11	80	0.1375000
NODE_5292_length_1081_cov_39.581466	529	609	10	2	80	0.0250000
NODE_5292_length_1081_cov_39.581466	529	609	11	3	80	0.0375000
NODE_5292_length_1081_cov_39.581466	529	609	12	27	80	0.3375000
NODE_5292_length_1081_cov_39.581466	605	685	3	29	80	0.3625000
NODE_5292_length_1081_cov_39.581466	605	685	4	3	80	0.0375000
NODE_5292_length_1081_cov_39.581466	605	685	5	24	80	0.3000000
NODE_5292_length_1081_cov_39.581466	605	685	7	24	80	0.3000000
NODE_5292_length_1081_cov_39.581466	658	738	2	10	80	0.1250000
NODE_5292_length_1081_cov_39.581466	658	738	3	24	80	0.3000000
NODE_5292_length_1081_cov_39.581466	658	738	4	35	80	0.4375000
NODE_5292_length_1081_cov_39.581466	658	738	5	11	80	0.1375000
NODE_5293_length_1081_cov_39.457230	373	453	5	17	80	0.2125000
NODE_5293_length_1081_cov_39.457230	373	453	6	33	80	0.4125000
NODE_5293_length_1081_cov_39.457230	373	453	7	20	80	0.2500000
NODE_5293_length_1081_cov_39.457230	373	453	8	10	80	0.1250000
NODE_5293_length_1081_cov_39.457230	426	506	6	17	80	0.2125000
NODE_5293_length_1081_cov_39.457230	426	506	8	26	80	0.3250000
NODE_5293_length_1081_cov_39.457230	426	506	9	27	80	0.3375000
NODE_5293_length_1081_cov_39.457230	426	506	10	3	80	0.0375000
NODE_5293_length_1081_cov_39.457230	426	506	11	7	80	0.0875000
NODE_5294_length_1081_cov_20.415479	376	451	2	47	75	0.6266667
NODE_5294_length_1081_cov_20.415479	376	451	3	26	75	0.3466667
NODE_5294_length_1081_cov_20.415479	376	451	4	2	75	0.0266667
NODE_5294_length_1081_cov_20.415479	436	511	2	9	75	0.1200000
NODE_5294_length_1081_cov_20.415479	436	511	3	4	75	0.0533333
NODE_5294_length_1081_cov_20.415479	436	511	4	48	75	0.6400000
NODE_5294_length_1081_cov_20.415479	436	511	6	14	75	0.1866667
NODE_5294_length_1081_cov_20.415479	496	571	4	1	75	0.0133333
NODE_5294_length_1081_cov_20.415479	496	571	6	37	75	0.4933333
NODE_5294_length_1081_cov_20.415479	496	571	7	24	75	0.3200000
NODE_5294_length_1081_cov_20.415479	496	571	8	13	75	0.1733333
NODE_5294_length_1081_cov_20.415479	544	624	4	25	80	0.3125000
NODE_5294_length_1081_cov_20.415479	544	624	5	1	80	0.0125000
NODE_5294_length_1081_cov_20.415479	544	624	6	13	80	0.1625000
NODE_5294_length_1081_cov_20.415479	544	624	7	38	80	0.4750000
NODE_5294_length_1081_cov_20.415479	544	624	8	3	80	0.0375000
NODE_5295_length_1081_cov_19.985743	378	458	0	15	80	0.1875000
NODE_5295_length_1081_cov_19.985743	378	458	2	21	80	0.2625000
NODE_5295_length_1081_cov_19.985743	378	458	3	9	80	0.1125000
NODE_5295_length_1081_cov_19.985743	378	458	4	9	80	0.1125000
NODE_5295_length_1081_cov_19.985743	378	458	5	26	80	0.3250000
NODE_5295_length_1081_cov_19.985743	431	511	3	7	80	0.0875000
NODE_5295_length_1081_cov_19.985743	431	511	4	16	80	0.2000000
NODE_5295_length_1081_cov_19.985743	431	511	5	57	80	0.7125000
NODE_5295_length_1081_cov_19.985743	507	587	2	5	80	0.0625000
NODE_5295_length_1081_cov_19.985743	507	587	3	9	80	0.1125000
NODE_5295_length_1081_cov_19.985743	507	587	4	66	80	0.8250000
NODE_5295_length_1081_cov_19.985743	560	640	2	24	80	0.3000000
NODE_5295_length_1081_cov_19.985743	560	640	3	43	80	0.5375000
NODE_5295_length_1081_cov_19.985743	560	640	4	13	80	0.1625000
NODE_5296_length_1081_cov_12.658859	468	548	0	14	80	0.1750000
NODE_5296_length_1081_cov_12.658859	468	548	1	12	80	0.1500000
NODE_5296_length_1081_cov_12.658859	468	548	2	5	80	0.0625000
NODE_5296_length_1081_cov_12.658859	468	548	6	49	80	0.6125000
NODE_5296_length_1081_cov_12.658859	521	601	4	11	80	0.1375000
NODE_5296_length_1081_cov_12.658859	521	601	6	69	80	0.8625000
NODE_5299_length_1081_cov_2.586558	7	44	0	37	37	1.0000000
NODE_5304_length_1080_cov_27.857288	261	341	4	70	80	0.8750000
NODE_5304_length_1080_cov_27.857288	261	341	6	10	80	0.1250000
NODE_5304_length_1080_cov_27.857288	314	394	3	18	80	0.2250000
NODE_5304_length_1080_cov_27.857288	314	394	4	51	80	0.6375000
NODE_5304_length_1080_cov_27.857288	314	394	5	1	80	0.0125000
NODE_5304_length_1080_cov_27.857288	314	394	6	10	80	0.1250000
NODE_5305_length_1080_cov_24.258919	321	401	3	24	80	0.3000000
NODE_5305_length_1080_cov_24.258919	321	401	5	56	80	0.7000000
NODE_5305_length_1080_cov_24.258919	374	454	2	14	80	0.1750000
NODE_5305_length_1080_cov_24.258919	374	454	3	21	80	0.2625000
NODE_5305_length_1080_cov_24.258919	374	454	4	17	80	0.2125000
NODE_5305_length_1080_cov_24.258919	374	454	5	28	80	0.3500000
NODE_5305_length_1080_cov_24.258919	450	530	1	15	80	0.1875000
NODE_5305_length_1080_cov_24.258919	450	530	2	46	80	0.5750000
NODE_5305_length_1080_cov_24.258919	450	530	3	19	80	0.2375000
NODE_5305_length_1080_cov_24.258919	503	583	1	2	80	0.0250000
NODE_5305_length_1080_cov_24.258919	503	583	2	78	80	0.9750000
NODE_5306_length_1080_cov_22.589195	446	526	2	25	80	0.3125000
NODE_5306_length_1080_cov_22.589195	446	526	6	42	80	0.5250000
NODE_5306_length_1080_cov_22.589195	446	526	8	13	80	0.1625000
NODE_5306_length_1080_cov_22.589195	499	579	6	14	80	0.1750000
NODE_5306_length_1080_cov_22.589195	499	579	7	30	80	0.3750000
NODE_5306_length_1080_cov_22.589195	499	579	8	26	80	0.3250000
NODE_5306_length_1080_cov_22.589195	499	579	9	10	80	0.1250000
NODE_5306_length_1080_cov_22.589195	575	655	1	55	80	0.6875000
NODE_5306_length_1080_cov_22.589195	575	655	3	6	80	0.0750000
NODE_5306_length_1080_cov_22.589195	575	655	7	19	80	0.2375000
NODE_5306_length_1080_cov_22.589195	628	708	0	16	80	0.2000000
NODE_5306_length_1080_cov_22.589195	628	708	1	64	80	0.8000000
NODE_5307_length_1080_cov_15.544343	599	679	0	80	80	1.0000000
NODE_5307_length_1080_cov_15.544343	652	732	0	80	80	1.0000000
NODE_5308_length_1080_cov_10.416922	321	401	4	14	80	0.1750000
NODE_5308_length_1080_cov_10.416922	321	401	5	38	80	0.4750000
NODE_5308_length_1080_cov_10.416922	321	401	6	16	80	0.2000000
NODE_5308_length_1080_cov_10.416922	321	401	7	7	80	0.0875000
NODE_5308_length_1080_cov_10.416922	321	401	8	5	80	0.0625000
NODE_5308_length_1080_cov_10.416922	374	454	6	31	80	0.3875000
NODE_5308_length_1080_cov_10.416922	374	454	7	44	80	0.5500000
NODE_5308_length_1080_cov_10.416922	374	454	8	5	80	0.0625000
NODE_5315_length_1079_cov_55.352041	367	447	6	22	80	0.2750000
NODE_5315_length_1079_cov_55.352041	367	447	7	39	80	0.4875000
NODE_5315_length_1079_cov_55.352041	367	447	8	19	80	0.2375000
NODE_5315_length_1079_cov_55.352041	420	500	6	57	80	0.7125000
NODE_5315_length_1079_cov_55.352041	420	500	7	5	80	0.0625000
NODE_5315_length_1079_cov_55.352041	420	500	8	18	80	0.2250000
NODE_5315_length_1079_cov_55.352041	496	576	6	8	80	0.1000000
NODE_5315_length_1079_cov_55.352041	496	576	7	36	80	0.4500000
NODE_5315_length_1079_cov_55.352041	496	576	8	21	80	0.2625000
NODE_5315_length_1079_cov_55.352041	496	576	9	15	80	0.1875000
NODE_5315_length_1079_cov_55.352041	549	629	6	8	80	0.1000000
NODE_5315_length_1079_cov_55.352041	549	629	7	31	80	0.3875000
NODE_5315_length_1079_cov_55.352041	549	629	8	18	80	0.2250000
NODE_5315_length_1079_cov_55.352041	549	629	9	23	80	0.2875000
NODE_5316_length_1079_cov_46.879592	444	524	8	2	80	0.0250000
NODE_5316_length_1079_cov_46.879592	444	524	9	17	80	0.2125000
NODE_5316_length_1079_cov_46.879592	444	524	11	16	80	0.2000000
NODE_5316_length_1079_cov_46.879592	444	524	13	8	80	0.1000000
NODE_5316_length_1079_cov_46.879592	444	524	14	5	80	0.0625000
NODE_5316_length_1079_cov_46.879592	444	524	15	3	80	0.0375000
NODE_5316_length_1079_cov_46.879592	444	524	16	23	80	0.2875000
NODE_5316_length_1079_cov_46.879592	444	524	17	6	80	0.0750000
NODE_5316_length_1079_cov_46.879592	497	577	15	18	80	0.2250000
NODE_5316_length_1079_cov_46.879592	497	577	16	18	80	0.2250000
NODE_5316_length_1079_cov_46.879592	497	577	17	30	80	0.3750000
NODE_5316_length_1079_cov_46.879592	497	577	18	11	80	0.1375000
NODE_5316_length_1079_cov_46.879592	497	577	19	3	80	0.0375000
NODE_5316_length_1079_cov_46.879592	573	652	11	6	79	0.0759494
NODE_5316_length_1079_cov_46.879592	573	652	12	11	79	0.1392405
NODE_5316_length_1079_cov_46.879592	573	652	13	10	79	0.1265823
NODE_5316_length_1079_cov_46.879592	573	652	14	25	79	0.3164557
NODE_5316_length_1079_cov_46.879592	573	652	15	8	79	0.1012658
NODE_5316_length_1079_cov_46.879592	573	652	16	4	79	0.0506329
NODE_5316_length_1079_cov_46.879592	573	652	18	11	79	0.1392405
NODE_5316_length_1079_cov_46.879592	573	652	19	4	79	0.0506329
NODE_5316_length_1079_cov_46.879592	625	703	8	13	78	0.1666667
NODE_5316_length_1079_cov_46.879592	625	703	10	5	78	0.0641026
NODE_5316_length_1079_cov_46.879592	625	703	11	6	78	0.0769231
NODE_5316_length_1079_cov_46.879592	625	703	12	29	78	0.3717949
NODE_5316_length_1079_cov_46.879592	625	703	13	1	78	0.0128205
NODE_5316_length_1079_cov_46.879592	625	703	14	24	78	0.3076923
NODE_5317_length_1079_cov_13.708163	611	691	8	20	80	0.2500000
NODE_5317_length_1079_cov_13.708163	611	691	9	1	80	0.0125000
NODE_5317_length_1079_cov_13.708163	611	691	10	38	80	0.4750000
NODE_5317_length_1079_cov_13.708163	611	691	11	21	80	0.2625000
NODE_5317_length_1079_cov_13.708163	664	744	7	5	80	0.0625000
NODE_5317_length_1079_cov_13.708163	664	744	8	8	80	0.1000000
NODE_5317_length_1079_cov_13.708163	664	744	10	62	80	0.7750000
NODE_5317_length_1079_cov_13.708163	664	744	11	5	80	0.0625000
NODE_5318_length_1079_cov_8.632653	416	496	0	28	80	0.3500000
NODE_5318_length_1079_cov_8.632653	416	496	2	8	80	0.1000000
NODE_5318_length_1079_cov_8.632653	416	496	4	44	80	0.5500000
NODE_5318_length_1079_cov_8.632653	469	549	4	80	80	1.0000000
NODE_5325_length_1078_cov_27.804903	357	437	5	6	80	0.0750000
NODE_5325_length_1078_cov_27.804903	357	437	6	1	80	0.0125000
NODE_5325_length_1078_cov_27.804903	357	437	7	19	80	0.2375000
NODE_5325_length_1078_cov_27.804903	357	437	8	8	80	0.1000000
NODE_5325_length_1078_cov_27.804903	357	437	9	3	80	0.0375000
NODE_5325_length_1078_cov_27.804903	357	437	10	36	80	0.4500000
NODE_5325_length_1078_cov_27.804903	357	437	11	7	80	0.0875000
NODE_5325_length_1078_cov_27.804903	410	490	9	10	80	0.1250000
NODE_5325_length_1078_cov_27.804903	410	490	10	26	80	0.3250000
NODE_5325_length_1078_cov_27.804903	410	490	11	37	80	0.4625000
NODE_5325_length_1078_cov_27.804903	410	490	12	7	80	0.0875000
NODE_5326_length_1078_cov_26.071502	459	539	4	4	80	0.0500000
NODE_5326_length_1078_cov_26.071502	459	539	6	1	80	0.0125000
NODE_5326_length_1078_cov_26.071502	459	539	7	38	80	0.4750000
NODE_5326_length_1078_cov_26.071502	459	539	8	30	80	0.3750000
NODE_5326_length_1078_cov_26.071502	459	539	9	7	80	0.0875000
NODE_5326_length_1078_cov_26.071502	512	592	7	12	80	0.1500000
NODE_5326_length_1078_cov_26.071502	512	592	8	30	80	0.3750000
NODE_5326_length_1078_cov_26.071502	512	592	9	23	80	0.2875000
NODE_5326_length_1078_cov_26.071502	512	592	10	15	80	0.1875000
NODE_5326_length_1078_cov_26.071502	588	668	5	2	80	0.0250000
NODE_5326_length_1078_cov_26.071502	588	668	6	14	80	0.1750000
NODE_5326_length_1078_cov_26.071502	588	668	7	42	80	0.5250000
NODE_5326_length_1078_cov_26.071502	588	668	8	22	80	0.2750000
NODE_5326_length_1078_cov_26.071502	641	718	3	14	77	0.1818182
NODE_5326_length_1078_cov_26.071502	641	718	4	16	77	0.2077922
NODE_5326_length_1078_cov_26.071502	641	718	5	22	77	0.2857143
NODE_5326_length_1078_cov_26.071502	641	718	6	14	77	0.1818182
NODE_5326_length_1078_cov_26.071502	641	718	7	11	77	0.1428571
NODE_5327_length_1078_cov_14.985700	495	575	1	77	80	0.9625000
NODE_5327_length_1078_cov_14.985700	495	575	2	3	80	0.0375000
NODE_5327_length_1078_cov_14.985700	548	628	1	24	80	0.3000000
NODE_5327_length_1078_cov_14.985700	548	628	2	56	80	0.7000000
NODE_5333_length_1077_cov_23.876278	546	626	1	2	80	0.0250000
NODE_5333_length_1077_cov_23.876278	546	626	3	12	80	0.1500000
NODE_5333_length_1077_cov_23.876278	546	626	5	65	80	0.8125000
NODE_5333_length_1077_cov_23.876278	546	626	6	1	80	0.0125000
NODE_5333_length_1077_cov_23.876278	599	679	0	4	80	0.0500000
NODE_5333_length_1077_cov_23.876278	599	679	1	51	80	0.6375000
NODE_5333_length_1077_cov_23.876278	599	679	3	12	80	0.1500000
NODE_5333_length_1077_cov_23.876278	599	679	5	13	80	0.1625000
NODE_5334_length_1077_cov_16.067485	532	612	1	31	80	0.3875000
NODE_5334_length_1077_cov_16.067485	532	612	3	23	80	0.2875000
NODE_5334_length_1077_cov_16.067485	532	612	5	26	80	0.3250000
NODE_5334_length_1077_cov_16.067485	585	665	2	24	80	0.3000000
NODE_5334_length_1077_cov_16.067485	585	665	3	1	80	0.0125000
NODE_5334_length_1077_cov_16.067485	585	665	4	8	80	0.1000000
NODE_5334_length_1077_cov_16.067485	585	665	5	47	80	0.5875000
NODE_5335_length_1077_cov_14.568507	556	636	4	4	80	0.0500000
NODE_5335_length_1077_cov_14.568507	556	636	5	12	80	0.1500000
NODE_5335_length_1077_cov_14.568507	556	636	6	33	80	0.4125000
NODE_5335_length_1077_cov_14.568507	556	636	7	15	80	0.1875000
NODE_5335_length_1077_cov_14.568507	556	636	8	16	80	0.2000000
NODE_5335_length_1077_cov_14.568507	609	689	4	7	80	0.0875000
NODE_5335_length_1077_cov_14.568507	609	689	5	2	80	0.0250000
NODE_5335_length_1077_cov_14.568507	609	689	6	71	80	0.8875000
NODE_5336_length_1077_cov_9.507157	496	576	1	34	80	0.4250000
NODE_5336_length_1077_cov_9.507157	496	576	2	46	80	0.5750000
NODE_5336_length_1077_cov_9.507157	549	629	1	16	80	0.2000000
NODE_5336_length_1077_cov_9.507157	549	629	2	64	80	0.8000000
NODE_5342_length_1077_cov_1.781186	252	274	0	22	22	1.0000000
NODE_5345_length_1076_cov_20.592631	534	614	0	17	80	0.2125000
NODE_5345_length_1076_cov_20.592631	534	614	2	34	80	0.4250000
NODE_5345_length_1076_cov_20.592631	534	614	3	29	80	0.3625000
NODE_5345_length_1076_cov_20.592631	587	667	1	24	80	0.3000000
NODE_5345_length_1076_cov_20.592631	587	667	3	56	80	0.7000000
NODE_5346_length_1076_cov_14.788127	427	507	3	2	80	0.0250000
NODE_5346_length_1076_cov_14.788127	427	507	5	62	80	0.7750000
NODE_5346_length_1076_cov_14.788127	427	507	6	16	80	0.2000000
NODE_5346_length_1076_cov_14.788127	480	560	4	10	80	0.1250000
NODE_5346_length_1076_cov_14.788127	480	560	5	41	80	0.5125000
NODE_5346_length_1076_cov_14.788127	480	560	6	29	80	0.3625000
NODE_5348_length_1076_cov_6.306039	883	961	3	16	78	0.2051282
NODE_5348_length_1076_cov_6.306039	883	961	5	15	78	0.1923077
NODE_5348_length_1076_cov_6.306039	883	961	6	47	78	0.6025641
NODE_5348_length_1076_cov_6.306039	936	1014	1	12	78	0.1538462
NODE_5348_length_1076_cov_6.306039	936	1014	3	27	78	0.3461539
NODE_5348_length_1076_cov_6.306039	936	1014	4	7	78	0.0897436
NODE_5348_length_1076_cov_6.306039	936	1014	6	32	78	0.4102564
NODE_5357_length_1075_cov_37.941598	550	630	5	7	80	0.0875000
NODE_5357_length_1075_cov_37.941598	550	630	7	48	80	0.6000000
NODE_5357_length_1075_cov_37.941598	550	630	8	25	80	0.3125000
NODE_5357_length_1075_cov_37.941598	603	685	5	5	82	0.0609756
NODE_5357_length_1075_cov_37.941598	603	685	6	7	82	0.0853659
NODE_5357_length_1075_cov_37.941598	603	685	7	40	82	0.4878049
NODE_5357_length_1075_cov_37.941598	603	685	8	30	82	0.3658537
NODE_5357_length_1075_cov_37.941598	681	761	5	14	80	0.1750000
NODE_5357_length_1075_cov_37.941598	681	761	6	9	80	0.1125000
NODE_5357_length_1075_cov_37.941598	681	761	7	1	80	0.0125000
NODE_5357_length_1075_cov_37.941598	681	761	8	18	80	0.2250000
NODE_5357_length_1075_cov_37.941598	681	761	9	37	80	0.4625000
NODE_5357_length_1075_cov_37.941598	681	761	10	1	80	0.0125000
NODE_5357_length_1075_cov_37.941598	734	814	5	11	80	0.1375000
NODE_5357_length_1075_cov_37.941598	734	814	8	31	80	0.3875000
NODE_5357_length_1075_cov_37.941598	734	814	9	38	80	0.4750000
NODE_5358_length_1075_cov_32.224385	397	477	2	8	80	0.1000000
NODE_5358_length_1075_cov_32.224385	397	477	4	23	80	0.2875000
NODE_5358_length_1075_cov_32.224385	397	477	6	6	80	0.0750000
NODE_5358_length_1075_cov_32.224385	397	477	7	29	80	0.3625000
NODE_5358_length_1075_cov_32.224385	397	477	8	14	80	0.1750000
NODE_5358_length_1075_cov_32.224385	450	530	7	13	80	0.1625000
NODE_5358_length_1075_cov_32.224385	450	530	8	67	80	0.8375000
NODE_5359_length_1075_cov_9.626025	440	520	3	3	80	0.0375000
NODE_5359_length_1075_cov_9.626025	440	520	4	46	80	0.5750000
NODE_5359_length_1075_cov_9.626025	440	520	5	1	80	0.0125000
NODE_5359_length_1075_cov_9.626025	440	520	7	6	80	0.0750000
NODE_5359_length_1075_cov_9.626025	440	520	9	7	80	0.0875000
NODE_5359_length_1075_cov_9.626025	440	520	10	13	80	0.1625000
NODE_5359_length_1075_cov_9.626025	440	520	11	4	80	0.0500000
NODE_5359_length_1075_cov_9.626025	493	573	7	3	80	0.0375000
NODE_5359_length_1075_cov_9.626025	493	573	9	7	80	0.0875000
NODE_5359_length_1075_cov_9.626025	493	573	10	63	80	0.7875000
NODE_5359_length_1075_cov_9.626025	493	573	11	7	80	0.0875000
NODE_5362_length_1075_cov_2.926230	38	99	0	61	61	1.0000000
NODE_5372_length_1074_cov_19.034872	568	648	2	29	80	0.3625000
NODE_5372_length_1074_cov_19.034872	568	648	3	10	80	0.1250000
NODE_5372_length_1074_cov_19.034872	568	648	4	2	80	0.0250000
NODE_5372_length_1074_cov_19.034872	568	648	5	39	80	0.4875000
NODE_5372_length_1074_cov_19.034872	621	701	5	78	80	0.9750000
NODE_5372_length_1074_cov_19.034872	621	701	6	2	80	0.0250000
NODE_5372_length_1074_cov_19.034872	697	777	2	30	80	0.3750000
NODE_5372_length_1074_cov_19.034872	697	777	3	37	80	0.4625000
NODE_5372_length_1074_cov_19.034872	697	777	5	8	80	0.1000000
NODE_5372_length_1074_cov_19.034872	697	777	6	5	80	0.0625000
NODE_5372_length_1074_cov_19.034872	750	830	2	29	80	0.3625000
NODE_5372_length_1074_cov_19.034872	750	830	3	23	80	0.2875000
NODE_5372_length_1074_cov_19.034872	750	830	4	28	80	0.3500000
NODE_5373_length_1074_cov_9.450256	577	657	5	5	80	0.0625000
NODE_5373_length_1074_cov_9.450256	577	657	6	11	80	0.1375000
NODE_5373_length_1074_cov_9.450256	577	657	7	50	80	0.6250000
NODE_5373_length_1074_cov_9.450256	577	657	8	7	80	0.0875000
NODE_5373_length_1074_cov_9.450256	577	657	9	7	80	0.0875000
NODE_5373_length_1074_cov_9.450256	630	710	6	10	80	0.1250000
NODE_5373_length_1074_cov_9.450256	630	710	7	5	80	0.0625000
NODE_5373_length_1074_cov_9.450256	630	710	8	16	80	0.2000000
NODE_5373_length_1074_cov_9.450256	630	710	9	23	80	0.2875000
NODE_5373_length_1074_cov_9.450256	630	710	10	4	80	0.0500000
NODE_5373_length_1074_cov_9.450256	630	710	11	22	80	0.2750000
NODE_5374_length_1074_cov_9.155897	526	606	0	80	80	1.0000000
NODE_5374_length_1074_cov_9.155897	579	659	0	74	80	0.9250000
NODE_5374_length_1074_cov_9.155897	579	659	2	6	80	0.0750000
NODE_5374_length_1074_cov_9.155897	655	735	2	20	80	0.2500000
NODE_5374_length_1074_cov_9.155897	655	735	4	5	80	0.0625000
NODE_5374_length_1074_cov_9.155897	655	735	6	12	80	0.1500000
NODE_5374_length_1074_cov_9.155897	655	735	8	32	80	0.4000000
NODE_5374_length_1074_cov_9.155897	655	735	9	11	80	0.1375000
NODE_5374_length_1074_cov_9.155897	708	788	4	2	80	0.0250000
NODE_5374_length_1074_cov_9.155897	708	788	5	22	80	0.2750000
NODE_5374_length_1074_cov_9.155897	708	788	7	4	80	0.0500000
NODE_5374_length_1074_cov_9.155897	708	788	8	16	80	0.2000000
NODE_5374_length_1074_cov_9.155897	708	788	9	18	80	0.2250000
NODE_5374_length_1074_cov_9.155897	708	788	10	18	80	0.2250000
NODE_5375_length_1074_cov_4.600000	606	686	1	19	80	0.2375000
NODE_5375_length_1074_cov_4.600000	606	686	3	61	80	0.7625000
NODE_5375_length_1074_cov_4.600000	659	739	2	43	80	0.5375000
NODE_5375_length_1074_cov_4.600000	659	739	3	37	80	0.4625000
NODE_5376_length_1074_cov_4.328205	32	112	0	67	80	0.8375000
NODE_5376_length_1074_cov_4.328205	32	112	1	13	80	0.1625000
NODE_5380_length_1073_cov_60.012320	448	528	8	12	80	0.1500000
NODE_5380_length_1073_cov_60.012320	448	528	9	19	80	0.2375000
NODE_5380_length_1073_cov_60.012320	448	528	10	13	80	0.1625000
NODE_5380_length_1073_cov_60.012320	448	528	11	4	80	0.0500000
NODE_5380_length_1073_cov_60.012320	448	528	12	32	80	0.4000000
NODE_5380_length_1073_cov_60.012320	501	581	8	2	80	0.0250000
NODE_5380_length_1073_cov_60.012320	501	581	10	60	80	0.7500000
NODE_5380_length_1073_cov_60.012320	501	581	11	4	80	0.0500000
NODE_5380_length_1073_cov_60.012320	501	581	12	14	80	0.1750000
NODE_5382_length_1073_cov_26.415811	529	609	7	26	80	0.3250000
NODE_5382_length_1073_cov_26.415811	529	609	8	54	80	0.6750000
NODE_5382_length_1073_cov_26.415811	582	662	1	13	80	0.1625000
NODE_5382_length_1073_cov_26.415811	582	662	2	4	80	0.0500000
NODE_5382_length_1073_cov_26.415811	582	662	4	27	80	0.3375000
NODE_5382_length_1073_cov_26.415811	582	662	5	2	80	0.0250000
NODE_5382_length_1073_cov_26.415811	582	662	7	27	80	0.3375000
NODE_5382_length_1073_cov_26.415811	582	662	8	7	80	0.0875000
NODE_5383_length_1073_cov_19.062628	571	651	3	3	80	0.0375000
NODE_5383_length_1073_cov_19.062628	571	651	5	61	80	0.7625000
NODE_5383_length_1073_cov_19.062628	571	651	6	16	80	0.2000000
NODE_5383_length_1073_cov_19.062628	624	704	5	60	80	0.7500000
NODE_5383_length_1073_cov_19.062628	624	704	6	20	80	0.2500000
NODE_5384_length_1073_cov_18.536961	447	527	3	6	80	0.0750000
NODE_5384_length_1073_cov_18.536961	447	527	4	8	80	0.1000000
NODE_5384_length_1073_cov_18.536961	447	527	5	8	80	0.1000000
NODE_5384_length_1073_cov_18.536961	447	527	7	42	80	0.5250000
NODE_5384_length_1073_cov_18.536961	447	527	8	16	80	0.2000000
NODE_5384_length_1073_cov_18.536961	500	580	5	14	80	0.1750000
NODE_5384_length_1073_cov_18.536961	500	580	6	5	80	0.0625000
NODE_5384_length_1073_cov_18.536961	500	580	7	35	80	0.4375000
NODE_5384_length_1073_cov_18.536961	500	580	8	24	80	0.3000000
NODE_5384_length_1073_cov_18.536961	500	580	9	2	80	0.0250000
NODE_5384_length_1073_cov_18.536961	576	656	8	6	80	0.0750000
NODE_5384_length_1073_cov_18.536961	576	656	9	16	80	0.2000000
NODE_5384_length_1073_cov_18.536961	576	656	10	37	80	0.4625000
NODE_5384_length_1073_cov_18.536961	576	656	11	8	80	0.1000000
NODE_5384_length_1073_cov_18.536961	576	656	12	13	80	0.1625000
NODE_5384_length_1073_cov_18.536961	629	709	5	11	80	0.1375000
NODE_5384_length_1073_cov_18.536961	629	709	6	4	80	0.0500000
NODE_5384_length_1073_cov_18.536961	629	709	7	28	80	0.3500000
NODE_5384_length_1073_cov_18.536961	629	709	8	14	80	0.1750000
NODE_5384_length_1073_cov_18.536961	629	709	10	23	80	0.2875000
NODE_5385_length_1073_cov_15.318275	712	792	5	11	80	0.1375000
NODE_5385_length_1073_cov_15.318275	712	792	6	1	80	0.0125000
NODE_5385_length_1073_cov_15.318275	712	792	8	19	80	0.2375000
NODE_5385_length_1073_cov_15.318275	712	792	10	4	80	0.0500000
NODE_5385_length_1073_cov_15.318275	712	792	11	45	80	0.5625000
NODE_5385_length_1073_cov_15.318275	765	845	4	9	80	0.1125000
NODE_5385_length_1073_cov_15.318275	765	845	6	2	80	0.0250000
NODE_5385_length_1073_cov_15.318275	765	845	7	20	80	0.2500000
NODE_5385_length_1073_cov_15.318275	765	845	9	8	80	0.1000000
NODE_5385_length_1073_cov_15.318275	765	845	11	41	80	0.5125000
NODE_5386_length_1073_cov_8.376797	287	367	0	80	80	1.0000000
NODE_5386_length_1073_cov_8.376797	340	420	0	80	80	1.0000000
NODE_5387_length_1073_cov_5.749487	257	337	2	3	80	0.0375000
NODE_5387_length_1073_cov_5.749487	257	337	3	17	80	0.2125000
NODE_5387_length_1073_cov_5.749487	257	337	4	60	80	0.7500000
NODE_5387_length_1073_cov_5.749487	310	390	2	9	80	0.1125000
NODE_5387_length_1073_cov_5.749487	310	390	3	61	80	0.7625000
NODE_5387_length_1073_cov_5.749487	310	390	4	10	80	0.1250000
NODE_5388_length_1073_cov_5.156057	408	444	0	12	36	0.3333333
NODE_5388_length_1073_cov_5.156057	408	444	1	6	36	0.1666667
NODE_5388_length_1073_cov_5.156057	408	444	2	18	36	0.5000000
NODE_5390_length_1073_cov_3.019507	1	69	0	68	68	1.0000000
NODE_5390_length_1073_cov_3.019507	42	122	0	80	80	1.0000000
NODE_5399_length_1072_cov_62.729702	351	431	10	2	80	0.0250000
NODE_5399_length_1072_cov_62.729702	351	431	11	5	80	0.0625000
NODE_5399_length_1072_cov_62.729702	351	431	12	9	80	0.1125000
NODE_5399_length_1072_cov_62.729702	351	431	13	25	80	0.3125000
NODE_5399_length_1072_cov_62.729702	351	431	14	16	80	0.2000000
NODE_5399_length_1072_cov_62.729702	351	431	15	9	80	0.1125000
NODE_5399_length_1072_cov_62.729702	351	431	17	11	80	0.1375000
NODE_5399_length_1072_cov_62.729702	351	431	18	3	80	0.0375000
NODE_5399_length_1072_cov_62.729702	404	484	14	4	80	0.0500000
NODE_5399_length_1072_cov_62.729702	404	484	15	18	80	0.2250000
NODE_5399_length_1072_cov_62.729702	404	484	16	11	80	0.1375000
NODE_5399_length_1072_cov_62.729702	404	484	17	23	80	0.2875000
NODE_5399_length_1072_cov_62.729702	404	484	18	3	80	0.0375000
NODE_5399_length_1072_cov_62.729702	404	484	19	14	80	0.1750000
NODE_5399_length_1072_cov_62.729702	404	484	20	2	80	0.0250000
NODE_5399_length_1072_cov_62.729702	404	484	21	2	80	0.0250000
NODE_5399_length_1072_cov_62.729702	404	484	22	3	80	0.0375000
NODE_5399_length_1072_cov_62.729702	480	560	10	2	80	0.0250000
NODE_5399_length_1072_cov_62.729702	480	560	11	13	80	0.1625000
NODE_5399_length_1072_cov_62.729702	480	560	12	5	80	0.0625000
NODE_5399_length_1072_cov_62.729702	480	560	13	25	80	0.3125000
NODE_5399_length_1072_cov_62.729702	480	560	14	16	80	0.2000000
NODE_5399_length_1072_cov_62.729702	480	560	15	16	80	0.2000000
NODE_5399_length_1072_cov_62.729702	480	560	16	3	80	0.0375000
NODE_5399_length_1072_cov_62.729702	533	613	6	25	80	0.3125000
NODE_5399_length_1072_cov_62.729702	533	613	9	2	80	0.0250000
NODE_5399_length_1072_cov_62.729702	533	613	10	6	80	0.0750000
NODE_5399_length_1072_cov_62.729702	533	613	11	21	80	0.2625000
NODE_5399_length_1072_cov_62.729702	533	613	12	3	80	0.0375000
NODE_5399_length_1072_cov_62.729702	533	613	13	16	80	0.2000000
NODE_5399_length_1072_cov_62.729702	533	613	14	7	80	0.0875000
NODE_5400_length_1072_cov_34.045221	430	510	7	5	80	0.0625000
NODE_5400_length_1072_cov_34.045221	430	510	9	10	80	0.1250000
NODE_5400_length_1072_cov_34.045221	430	510	10	1	80	0.0125000
NODE_5400_length_1072_cov_34.045221	430	510	11	15	80	0.1875000
NODE_5400_length_1072_cov_34.045221	430	510	12	31	80	0.3875000
NODE_5400_length_1072_cov_34.045221	430	510	13	18	80	0.2250000
NODE_5400_length_1072_cov_34.045221	483	563	6	10	80	0.1250000
NODE_5400_length_1072_cov_34.045221	483	563	8	4	80	0.0500000
NODE_5400_length_1072_cov_34.045221	483	563	9	15	80	0.1875000
NODE_5400_length_1072_cov_34.045221	483	563	10	2	80	0.0250000
NODE_5400_length_1072_cov_34.045221	483	563	11	19	80	0.2375000
NODE_5400_length_1072_cov_34.045221	483	563	12	25	80	0.3125000
NODE_5400_length_1072_cov_34.045221	483	563	13	5	80	0.0625000
NODE_5401_length_1072_cov_34.006166	342	423	5	9	81	0.1111111
NODE_5401_length_1072_cov_34.006166	342	423	8	29	81	0.3580247
NODE_5401_length_1072_cov_34.006166	342	423	10	43	81	0.5308642
NODE_5401_length_1072_cov_34.006166	396	476	6	32	80	0.4000000
NODE_5401_length_1072_cov_34.006166	396	476	7	17	80	0.2125000
NODE_5401_length_1072_cov_34.006166	396	476	8	24	80	0.3000000
NODE_5401_length_1072_cov_34.006166	396	476	9	1	80	0.0125000
NODE_5401_length_1072_cov_34.006166	396	476	10	6	80	0.0750000
NODE_5401_length_1072_cov_34.006166	472	552	3	6	80	0.0750000
NODE_5401_length_1072_cov_34.006166	472	552	4	59	80	0.7375000
NODE_5401_length_1072_cov_34.006166	472	552	5	11	80	0.1375000
NODE_5401_length_1072_cov_34.006166	472	552	6	4	80	0.0500000
NODE_5401_length_1072_cov_34.006166	525	605	0	22	80	0.2750000
NODE_5401_length_1072_cov_34.006166	525	605	1	2	80	0.0250000
NODE_5401_length_1072_cov_34.006166	525	605	2	15	80	0.1875000
NODE_5401_length_1072_cov_34.006166	525	605	4	41	80	0.5125000
NODE_5403_length_1072_cov_21.852004	300	380	2	4	80	0.0500000
NODE_5403_length_1072_cov_21.852004	300	380	4	76	80	0.9500000
NODE_5403_length_1072_cov_21.852004	353	433	2	4	80	0.0500000
NODE_5403_length_1072_cov_21.852004	353	433	4	76	80	0.9500000
NODE_5404_length_1072_cov_21.532374	476	556	2	11	80	0.1375000
NODE_5404_length_1072_cov_21.532374	476	556	3	1	80	0.0125000
NODE_5404_length_1072_cov_21.532374	476	556	5	30	80	0.3750000
NODE_5404_length_1072_cov_21.532374	476	556	6	27	80	0.3375000
NODE_5404_length_1072_cov_21.532374	476	556	7	11	80	0.1375000
NODE_5404_length_1072_cov_21.532374	529	609	3	5	80	0.0625000
NODE_5404_length_1072_cov_21.532374	529	609	5	31	80	0.3875000
NODE_5404_length_1072_cov_21.532374	529	609	6	44	80	0.5500000
NODE_5405_length_1072_cov_17.018499	415	495	6	15	80	0.1875000
NODE_5405_length_1072_cov_17.018499	415	495	7	22	80	0.2750000
NODE_5405_length_1072_cov_17.018499	415	495	8	43	80	0.5375000
NODE_5405_length_1072_cov_17.018499	468	548	5	23	80	0.2875000
NODE_5405_length_1072_cov_17.018499	468	548	6	10	80	0.1250000
NODE_5405_length_1072_cov_17.018499	468	548	7	20	80	0.2500000
NODE_5405_length_1072_cov_17.018499	468	548	8	27	80	0.3375000
NODE_5410_length_1072_cov_3.302158	388	449	0	1	61	0.0163934
NODE_5410_length_1072_cov_3.302158	388	449	2	60	61	0.9836066
NODE_5410_length_1072_cov_3.302158	422	502	2	50	80	0.6250000
NODE_5410_length_1072_cov_3.302158	422	502	3	16	80	0.2000000
NODE_5410_length_1072_cov_3.302158	422	502	4	14	80	0.1750000
NODE_5414_length_1072_cov_1.773895	114	176	0	62	62	1.0000000
NODE_5417_length_1071_cov_27.565844	312	392	4	5	80	0.0625000
NODE_5417_length_1071_cov_27.565844	312	392	5	52	80	0.6500000
NODE_5417_length_1071_cov_27.565844	312	392	6	11	80	0.1375000
NODE_5417_length_1071_cov_27.565844	312	392	7	12	80	0.1500000
NODE_5417_length_1071_cov_27.565844	365	445	5	66	80	0.8250000
NODE_5417_length_1071_cov_27.565844	365	445	6	2	80	0.0250000
NODE_5417_length_1071_cov_27.565844	365	445	7	12	80	0.1500000
NODE_5419_length_1071_cov_12.666667	480	560	0	66	80	0.8250000
NODE_5419_length_1071_cov_12.666667	480	560	1	14	80	0.1750000
NODE_5419_length_1071_cov_12.666667	533	613	0	80	80	1.0000000
NODE_5421_length_1071_cov_8.942387	418	498	1	6	80	0.0750000
NODE_5421_length_1071_cov_8.942387	418	498	3	18	80	0.2250000
NODE_5421_length_1071_cov_8.942387	418	498	4	52	80	0.6500000
NODE_5421_length_1071_cov_8.942387	418	498	5	4	80	0.0500000
NODE_5421_length_1071_cov_8.942387	471	551	4	24	80	0.3000000
NODE_5421_length_1071_cov_8.942387	471	551	5	4	80	0.0500000
NODE_5421_length_1071_cov_8.942387	471	551	6	52	80	0.6500000
NODE_5427_length_1070_cov_39.255407	591	671	5	4	80	0.0500000
NODE_5427_length_1070_cov_39.255407	591	671	7	1	80	0.0125000
NODE_5427_length_1070_cov_39.255407	591	671	9	30	80	0.3750000
NODE_5427_length_1070_cov_39.255407	591	671	10	13	80	0.1625000
NODE_5427_length_1070_cov_39.255407	591	671	11	31	80	0.3875000
NODE_5427_length_1070_cov_39.255407	591	671	12	1	80	0.0125000
NODE_5427_length_1070_cov_39.255407	644	724	5	1	80	0.0125000
NODE_5427_length_1070_cov_39.255407	644	724	6	12	80	0.1500000
NODE_5427_length_1070_cov_39.255407	644	724	7	21	80	0.2625000
NODE_5427_length_1070_cov_39.255407	644	724	8	4	80	0.0500000
NODE_5427_length_1070_cov_39.255407	644	724	10	4	80	0.0500000
NODE_5427_length_1070_cov_39.255407	644	724	11	38	80	0.4750000
NODE_5428_length_1070_cov_21.903193	430	510	4	73	80	0.9125000
NODE_5428_length_1070_cov_21.903193	430	510	5	7	80	0.0875000
NODE_5428_length_1070_cov_21.903193	483	563	3	27	80	0.3375000
NODE_5428_length_1070_cov_21.903193	483	563	4	27	80	0.3375000
NODE_5428_length_1070_cov_21.903193	483	563	5	10	80	0.1250000
NODE_5428_length_1070_cov_21.903193	483	563	6	16	80	0.2000000
NODE_5428_length_1070_cov_21.903193	559	639	3	56	80	0.7000000
NODE_5428_length_1070_cov_21.903193	559	639	4	24	80	0.3000000
NODE_5428_length_1070_cov_21.903193	612	692	2	21	80	0.2625000
NODE_5428_length_1070_cov_21.903193	612	692	3	25	80	0.3125000
NODE_5428_length_1070_cov_21.903193	612	692	4	34	80	0.4250000
NODE_5429_length_1070_cov_8.963955	871	900	2	2	29	0.0689655
NODE_5429_length_1070_cov_8.963955	871	900	3	3	29	0.1034483
NODE_5429_length_1070_cov_8.963955	871	900	4	1	29	0.0344828
NODE_5429_length_1070_cov_8.963955	871	900	9	7	29	0.2413793
NODE_5429_length_1070_cov_8.963955	871	900	10	2	29	0.0689655
NODE_5429_length_1070_cov_8.963955	871	900	11	4	29	0.1379310
NODE_5429_length_1070_cov_8.963955	871	900	12	7	29	0.2413793
NODE_5429_length_1070_cov_8.963955	871	900	13	2	29	0.0689655
NODE_5429_length_1070_cov_8.963955	871	900	15	1	29	0.0344828
NODE_5429_length_1070_cov_8.963955	873	953	3	3	80	0.0375000
NODE_5429_length_1070_cov_8.963955	873	953	4	1	80	0.0125000
NODE_5429_length_1070_cov_8.963955	873	953	9	7	80	0.0875000
NODE_5429_length_1070_cov_8.963955	873	953	10	2	80	0.0250000
NODE_5429_length_1070_cov_8.963955	873	953	11	4	80	0.0500000
NODE_5429_length_1070_cov_8.963955	873	953	12	7	80	0.0875000
NODE_5429_length_1070_cov_8.963955	873	953	13	2	80	0.0250000
NODE_5429_length_1070_cov_8.963955	873	953	15	3	80	0.0375000
NODE_5429_length_1070_cov_8.963955	873	953	16	9	80	0.1125000
NODE_5429_length_1070_cov_8.963955	873	953	18	42	80	0.5250000
NODE_5433_length_1070_cov_1.659114	1027	1046	0	19	19	1.0000000
NODE_5439_length_1069_cov_40.277320	451	531	7	4	80	0.0500000
NODE_5439_length_1069_cov_40.277320	451	531	8	9	80	0.1125000
NODE_5439_length_1069_cov_40.277320	451	531	9	5	80	0.0625000
NODE_5439_length_1069_cov_40.277320	451	531	11	14	80	0.1750000
NODE_5439_length_1069_cov_40.277320	451	531	12	8	80	0.1000000
NODE_5439_length_1069_cov_40.277320	451	531	13	14	80	0.1750000
NODE_5439_length_1069_cov_40.277320	451	531	15	9	80	0.1125000
NODE_5439_length_1069_cov_40.277320	451	531	16	7	80	0.0875000
NODE_5439_length_1069_cov_40.277320	451	531	17	10	80	0.1250000
NODE_5439_length_1069_cov_40.277320	504	584	11	7	80	0.0875000
NODE_5439_length_1069_cov_40.277320	504	584	12	6	80	0.0750000
NODE_5439_length_1069_cov_40.277320	504	584	13	15	80	0.1875000
NODE_5439_length_1069_cov_40.277320	504	584	14	1	80	0.0125000
NODE_5439_length_1069_cov_40.277320	504	584	15	9	80	0.1125000
NODE_5439_length_1069_cov_40.277320	504	584	16	29	80	0.3625000
NODE_5439_length_1069_cov_40.277320	504	584	17	13	80	0.1625000
NODE_5440_length_1069_cov_23.571134	274	354	6	2	80	0.0250000
NODE_5440_length_1069_cov_23.571134	274	354	7	24	80	0.3000000
NODE_5440_length_1069_cov_23.571134	274	354	8	1	80	0.0125000
NODE_5440_length_1069_cov_23.571134	274	354	9	15	80	0.1875000
NODE_5440_length_1069_cov_23.571134	274	354	10	38	80	0.4750000
NODE_5440_length_1069_cov_23.571134	327	407	2	34	80	0.4250000
NODE_5440_length_1069_cov_23.571134	327	407	4	7	80	0.0875000
NODE_5440_length_1069_cov_23.571134	327	407	6	14	80	0.1750000
NODE_5440_length_1069_cov_23.571134	327	407	7	24	80	0.3000000
NODE_5440_length_1069_cov_23.571134	327	407	9	1	80	0.0125000
NODE_5441_length_1069_cov_22.436082	185	265	1	72	80	0.9000000
NODE_5441_length_1069_cov_22.436082	185	265	3	8	80	0.1000000
NODE_5441_length_1069_cov_22.436082	238	318	1	19	80	0.2375000
NODE_5441_length_1069_cov_22.436082	238	318	3	14	80	0.1750000
NODE_5441_length_1069_cov_22.436082	238	318	4	47	80	0.5875000
NODE_5442_length_1069_cov_18.207216	436	516	4	27	80	0.3375000
NODE_5442_length_1069_cov_18.207216	436	516	5	8	80	0.1000000
NODE_5442_length_1069_cov_18.207216	436	516	8	4	80	0.0500000
NODE_5442_length_1069_cov_18.207216	436	516	9	41	80	0.5125000
NODE_5442_length_1069_cov_18.207216	489	569	8	3	80	0.0375000
NODE_5442_length_1069_cov_18.207216	489	569	9	50	80	0.6250000
NODE_5442_length_1069_cov_18.207216	489	569	10	27	80	0.3375000
NODE_5443_length_1069_cov_17.601031	596	676	2	2	80	0.0250000
NODE_5443_length_1069_cov_17.601031	596	676	4	3	80	0.0375000
NODE_5443_length_1069_cov_17.601031	596	676	5	39	80	0.4875000
NODE_5443_length_1069_cov_17.601031	596	676	6	21	80	0.2625000
NODE_5443_length_1069_cov_17.601031	596	676	7	15	80	0.1875000
NODE_5443_length_1069_cov_17.601031	649	729	2	43	80	0.5375000
NODE_5443_length_1069_cov_17.601031	649	729	3	12	80	0.1500000
NODE_5443_length_1069_cov_17.601031	649	729	4	3	80	0.0375000
NODE_5443_length_1069_cov_17.601031	649	729	5	22	80	0.2750000
NODE_5444_length_1069_cov_16.318557	353	433	5	67	80	0.8375000
NODE_5444_length_1069_cov_16.318557	353	433	6	3	80	0.0375000
NODE_5444_length_1069_cov_16.318557	353	433	7	1	80	0.0125000
NODE_5444_length_1069_cov_16.318557	353	433	8	9	80	0.1125000
NODE_5444_length_1069_cov_16.318557	406	486	5	33	80	0.4125000
NODE_5444_length_1069_cov_16.318557	406	486	6	18	80	0.2250000
NODE_5444_length_1069_cov_16.318557	406	486	7	20	80	0.2500000
NODE_5444_length_1069_cov_16.318557	406	486	8	9	80	0.1125000
NODE_5444_length_1069_cov_16.318557	482	562	3	4	80	0.0500000
NODE_5444_length_1069_cov_16.318557	482	562	5	73	80	0.9125000
NODE_5444_length_1069_cov_16.318557	482	562	7	3	80	0.0375000
NODE_5444_length_1069_cov_16.318557	535	615	0	8	80	0.1000000
NODE_5444_length_1069_cov_16.318557	535	615	2	38	80	0.4750000
NODE_5444_length_1069_cov_16.318557	535	615	3	11	80	0.1375000
NODE_5444_length_1069_cov_16.318557	535	615	5	23	80	0.2875000
NODE_5445_length_1069_cov_13.349485	471	551	6	9	80	0.1125000
NODE_5445_length_1069_cov_13.349485	471	551	7	15	80	0.1875000
NODE_5445_length_1069_cov_13.349485	471	551	8	50	80	0.6250000
NODE_5445_length_1069_cov_13.349485	471	551	9	6	80	0.0750000
NODE_5445_length_1069_cov_13.349485	524	604	2	19	80	0.2375000
NODE_5445_length_1069_cov_13.349485	524	604	3	11	80	0.1375000
NODE_5445_length_1069_cov_13.349485	524	604	4	22	80	0.2750000
NODE_5445_length_1069_cov_13.349485	524	604	6	10	80	0.1250000
NODE_5445_length_1069_cov_13.349485	524	604	7	15	80	0.1875000
NODE_5445_length_1069_cov_13.349485	524	604	8	3	80	0.0375000
NODE_5446_length_1069_cov_13.050515	314	394	2	26	80	0.3250000
NODE_5446_length_1069_cov_13.050515	314	394	3	17	80	0.2125000
NODE_5446_length_1069_cov_13.050515	314	394	4	37	80	0.4625000
NODE_5446_length_1069_cov_13.050515	367	447	1	52	80	0.6500000
NODE_5446_length_1069_cov_13.050515	367	447	2	27	80	0.3375000
NODE_5446_length_1069_cov_13.050515	367	447	3	1	80	0.0125000
NODE_5447_length_1069_cov_12.818557	240	320	0	80	80	1.0000000
NODE_5447_length_1069_cov_12.818557	293	373	0	80	80	1.0000000
NODE_5448_length_1069_cov_11.985567	554	634	4	7	80	0.0875000
NODE_5448_length_1069_cov_11.985567	554	634	5	73	80	0.9125000
NODE_5448_length_1069_cov_11.985567	607	687	2	3	80	0.0375000
NODE_5448_length_1069_cov_11.985567	607	687	3	20	80	0.2500000
NODE_5448_length_1069_cov_11.985567	607	687	4	19	80	0.2375000
NODE_5448_length_1069_cov_11.985567	607	687	5	38	80	0.4750000
NODE_5449_length_1069_cov_10.812371	366	446	3	21	80	0.2625000
NODE_5449_length_1069_cov_10.812371	366	446	4	58	80	0.7250000
NODE_5449_length_1069_cov_10.812371	366	446	5	1	80	0.0125000
NODE_5449_length_1069_cov_10.812371	419	499	4	43	80	0.5375000
NODE_5449_length_1069_cov_10.812371	419	499	5	37	80	0.4625000
NODE_5450_length_1069_cov_7.729897	482	562	2	21	80	0.2625000
NODE_5450_length_1069_cov_7.729897	482	562	3	1	80	0.0125000
NODE_5450_length_1069_cov_7.729897	482	562	4	58	80	0.7250000
NODE_5450_length_1069_cov_7.729897	535	615	0	12	80	0.1500000
NODE_5450_length_1069_cov_7.729897	535	615	1	8	80	0.1000000
NODE_5450_length_1069_cov_7.729897	535	615	3	1	80	0.0125000
NODE_5450_length_1069_cov_7.729897	535	615	4	59	80	0.7375000
NODE_5456_length_1068_cov_31.692466	314	394	5	5	80	0.0625000
NODE_5456_length_1068_cov_31.692466	314	394	6	2	80	0.0250000
NODE_5456_length_1068_cov_31.692466	314	394	7	72	80	0.9000000
NODE_5456_length_1068_cov_31.692466	314	394	8	1	80	0.0125000
NODE_5456_length_1068_cov_31.692466	367	447	3	37	80	0.4625000
NODE_5456_length_1068_cov_31.692466	367	447	5	21	80	0.2625000
NODE_5456_length_1068_cov_31.692466	367	447	7	21	80	0.2625000
NODE_5456_length_1068_cov_31.692466	367	447	8	1	80	0.0125000
NODE_5456_length_1068_cov_31.692466	443	523	1	14	80	0.1750000
NODE_5456_length_1068_cov_31.692466	443	523	2	47	80	0.5875000
NODE_5456_length_1068_cov_31.692466	443	523	3	19	80	0.2375000
NODE_5456_length_1068_cov_31.692466	496	576	1	41	80	0.5125000
NODE_5456_length_1068_cov_31.692466	496	576	2	39	80	0.4875000
NODE_5457_length_1068_cov_29.579979	347	427	9	12	80	0.1500000
NODE_5457_length_1068_cov_29.579979	347	427	11	7	80	0.0875000
NODE_5457_length_1068_cov_29.579979	347	427	12	2	80	0.0250000
NODE_5457_length_1068_cov_29.579979	347	427	13	40	80	0.5000000
NODE_5457_length_1068_cov_29.579979	347	427	14	19	80	0.2375000
NODE_5457_length_1068_cov_29.579979	400	480	5	5	80	0.0625000
NODE_5457_length_1068_cov_29.579979	400	480	6	7	80	0.0875000
NODE_5457_length_1068_cov_29.579979	400	480	8	6	80	0.0750000
NODE_5457_length_1068_cov_29.579979	400	480	9	3	80	0.0375000
NODE_5457_length_1068_cov_29.579979	400	480	10	13	80	0.1625000
NODE_5457_length_1068_cov_29.579979	400	480	11	15	80	0.1875000
NODE_5457_length_1068_cov_29.579979	400	480	13	31	80	0.3875000
NODE_5459_length_1068_cov_23.020640	476	556	4	5	80	0.0625000
NODE_5459_length_1068_cov_23.020640	476	556	5	4	80	0.0500000
NODE_5459_length_1068_cov_23.020640	476	556	6	28	80	0.3500000
NODE_5459_length_1068_cov_23.020640	476	556	7	5	80	0.0625000
NODE_5459_length_1068_cov_23.020640	476	556	8	5	80	0.0625000
NODE_5459_length_1068_cov_23.020640	476	556	9	2	80	0.0250000
NODE_5459_length_1068_cov_23.020640	476	556	10	31	80	0.3875000
NODE_5459_length_1068_cov_23.020640	529	609	8	1	80	0.0125000
NODE_5459_length_1068_cov_23.020640	529	609	9	7	80	0.0875000
NODE_5459_length_1068_cov_23.020640	529	609	10	56	80	0.7000000
NODE_5459_length_1068_cov_23.020640	529	609	11	2	80	0.0250000
NODE_5459_length_1068_cov_23.020640	529	609	12	14	80	0.1750000
NODE_5460_length_1068_cov_15.272446	546	626	2	2	80	0.0250000
NODE_5460_length_1068_cov_15.272446	546	626	4	5	80	0.0625000
NODE_5460_length_1068_cov_15.272446	546	626	5	45	80	0.5625000
NODE_5460_length_1068_cov_15.272446	546	626	6	28	80	0.3500000
NODE_5460_length_1068_cov_15.272446	599	679	4	22	80	0.2750000
NODE_5460_length_1068_cov_15.272446	599	679	5	10	80	0.1250000
NODE_5460_length_1068_cov_15.272446	599	679	6	48	80	0.6000000
NODE_5461_length_1068_cov_13.557276	674	754	1	8	80	0.1000000
NODE_5461_length_1068_cov_13.557276	674	754	2	2	80	0.0250000
NODE_5461_length_1068_cov_13.557276	674	754	3	44	80	0.5500000
NODE_5461_length_1068_cov_13.557276	674	754	4	26	80	0.3250000
NODE_5461_length_1068_cov_13.557276	727	807	0	25	80	0.3125000
NODE_5461_length_1068_cov_13.557276	727	807	1	36	80	0.4500000
NODE_5461_length_1068_cov_13.557276	727	807	2	2	80	0.0250000
NODE_5461_length_1068_cov_13.557276	727	807	3	17	80	0.2125000
NODE_5479_length_1067_cov_48.282025	429	509	0	80	80	1.0000000
NODE_5479_length_1067_cov_48.282025	482	562	0	80	80	1.0000000
NODE_5480_length_1067_cov_41.111570	460	540	3	20	80	0.2500000
NODE_5480_length_1067_cov_41.111570	460	540	5	42	80	0.5250000
NODE_5480_length_1067_cov_41.111570	460	540	6	18	80	0.2250000
NODE_5480_length_1067_cov_41.111570	513	593	4	42	80	0.5250000
NODE_5480_length_1067_cov_41.111570	513	593	5	13	80	0.1625000
NODE_5480_length_1067_cov_41.111570	513	593	6	25	80	0.3125000
NODE_5481_length_1067_cov_39.109504	295	375	5	8	80	0.1000000
NODE_5481_length_1067_cov_39.109504	295	375	6	5	80	0.0625000
NODE_5481_length_1067_cov_39.109504	295	375	7	34	80	0.4250000
NODE_5481_length_1067_cov_39.109504	295	375	8	14	80	0.1750000
NODE_5481_length_1067_cov_39.109504	295	375	9	19	80	0.2375000
NODE_5481_length_1067_cov_39.109504	348	428	2	8	80	0.1000000
NODE_5481_length_1067_cov_39.109504	348	428	3	4	80	0.0500000
NODE_5481_length_1067_cov_39.109504	348	428	4	39	80	0.4875000
NODE_5481_length_1067_cov_39.109504	348	428	5	10	80	0.1250000
NODE_5481_length_1067_cov_39.109504	348	428	6	5	80	0.0625000
NODE_5481_length_1067_cov_39.109504	348	428	7	14	80	0.1750000
NODE_5481_length_1067_cov_39.109504	424	504	2	60	80	0.7500000
NODE_5481_length_1067_cov_39.109504	424	504	3	5	80	0.0625000
NODE_5481_length_1067_cov_39.109504	424	504	4	10	80	0.1250000
NODE_5481_length_1067_cov_39.109504	424	504	5	5	80	0.0625000
NODE_5481_length_1067_cov_39.109504	477	557	2	7	80	0.0875000
NODE_5481_length_1067_cov_39.109504	477	557	3	58	80	0.7250000
NODE_5481_length_1067_cov_39.109504	477	557	4	10	80	0.1250000
NODE_5481_length_1067_cov_39.109504	477	557	5	5	80	0.0625000
NODE_5482_length_1067_cov_35.426653	252	332	6	18	80	0.2250000
NODE_5482_length_1067_cov_35.426653	252	332	7	3	80	0.0375000
NODE_5482_length_1067_cov_35.426653	252	332	8	1	80	0.0125000
NODE_5482_length_1067_cov_35.426653	252	332	10	4	80	0.0500000
NODE_5482_length_1067_cov_35.426653	252	332	11	6	80	0.0750000
NODE_5482_length_1067_cov_35.426653	252	332	12	19	80	0.2375000
NODE_5482_length_1067_cov_35.426653	252	332	13	8	80	0.1000000
NODE_5482_length_1067_cov_35.426653	252	332	15	21	80	0.2625000
NODE_5482_length_1067_cov_35.426653	305	385	12	19	80	0.2375000
NODE_5482_length_1067_cov_35.426653	305	385	13	16	80	0.2000000
NODE_5482_length_1067_cov_35.426653	305	385	15	45	80	0.5625000
NODE_5483_length_1067_cov_29.467975	412	492	4	11	80	0.1375000
NODE_5483_length_1067_cov_29.467975	412	492	5	27	80	0.3375000
NODE_5483_length_1067_cov_29.467975	412	492	6	42	80	0.5250000
NODE_5483_length_1067_cov_29.467975	465	545	3	30	80	0.3750000
NODE_5483_length_1067_cov_29.467975	465	545	4	8	80	0.1000000
NODE_5483_length_1067_cov_29.467975	465	545	5	5	80	0.0625000
NODE_5483_length_1067_cov_29.467975	465	545	6	37	80	0.4625000
NODE_5484_length_1067_cov_20.738636	579	645	2	66	66	1.0000000
NODE_5484_length_1067_cov_20.738636	618	698	0	41	80	0.5125000
NODE_5484_length_1067_cov_20.738636	618	698	2	39	80	0.4875000
NODE_5485_length_1067_cov_15.280992	538	617	1	2	79	0.0253165
NODE_5485_length_1067_cov_15.280992	538	617	2	77	79	0.9746835
NODE_5485_length_1067_cov_15.280992	590	670	2	41	80	0.5125000
NODE_5485_length_1067_cov_15.280992	590	670	3	39	80	0.4875000
NODE_5486_length_1067_cov_13.708678	478	558	3	80	80	1.0000000
NODE_5486_length_1067_cov_13.708678	531	611	0	19	80	0.2375000
NODE_5486_length_1067_cov_13.708678	531	611	1	31	80	0.3875000
NODE_5486_length_1067_cov_13.708678	531	611	3	30	80	0.3750000
NODE_5488_length_1067_cov_9.070248	625	705	4	1	80	0.0125000
NODE_5488_length_1067_cov_9.070248	625	705	6	37	80	0.4625000
NODE_5488_length_1067_cov_9.070248	625	705	7	42	80	0.5250000
NODE_5488_length_1067_cov_9.070248	678	758	1	6	80	0.0750000
NODE_5488_length_1067_cov_9.070248	678	758	2	34	80	0.4250000
NODE_5488_length_1067_cov_9.070248	678	758	3	2	80	0.0250000
NODE_5488_length_1067_cov_9.070248	678	758	5	11	80	0.1375000
NODE_5488_length_1067_cov_9.070248	678	758	7	27	80	0.3375000
NODE_5494_length_1067_cov_1.946281	765	812	0	47	47	1.0000000
NODE_5501_length_1066_cov_54.227508	395	475	9	1	80	0.0125000
NODE_5501_length_1066_cov_54.227508	395	475	10	3	80	0.0375000
NODE_5501_length_1066_cov_54.227508	395	475	11	39	80	0.4875000
NODE_5501_length_1066_cov_54.227508	395	475	12	20	80	0.2500000
NODE_5501_length_1066_cov_54.227508	395	475	13	17	80	0.2125000
NODE_5501_length_1066_cov_54.227508	448	528	2	8	80	0.1000000
NODE_5501_length_1066_cov_54.227508	448	528	3	8	80	0.1000000
NODE_5501_length_1066_cov_54.227508	448	528	5	12	80	0.1500000
NODE_5501_length_1066_cov_54.227508	448	528	6	5	80	0.0625000
NODE_5501_length_1066_cov_54.227508	448	528	7	1	80	0.0125000
NODE_5501_length_1066_cov_54.227508	448	528	9	9	80	0.1125000
NODE_5501_length_1066_cov_54.227508	448	528	10	13	80	0.1625000
NODE_5501_length_1066_cov_54.227508	448	528	11	24	80	0.3000000
NODE_5502_length_1066_cov_33.501551	357	437	8	69	80	0.8625000
NODE_5502_length_1066_cov_33.501551	357	437	9	7	80	0.0875000
NODE_5502_length_1066_cov_33.501551	357	437	10	4	80	0.0500000
NODE_5502_length_1066_cov_33.501551	410	490	6	8	80	0.1000000
NODE_5502_length_1066_cov_33.501551	410	490	7	21	80	0.2625000
NODE_5502_length_1066_cov_33.501551	410	490	8	40	80	0.5000000
NODE_5502_length_1066_cov_33.501551	410	490	9	7	80	0.0875000
NODE_5502_length_1066_cov_33.501551	410	490	10	4	80	0.0500000
NODE_5503_length_1066_cov_33.115822	397	477	14	3	80	0.0375000
NODE_5503_length_1066_cov_33.115822	397	477	15	6	80	0.0750000
NODE_5503_length_1066_cov_33.115822	397	477	16	41	80	0.5125000
NODE_5503_length_1066_cov_33.115822	397	477	17	6	80	0.0750000
NODE_5503_length_1066_cov_33.115822	397	477	18	24	80	0.3000000
NODE_5503_length_1066_cov_33.115822	450	530	1	5	80	0.0625000
NODE_5503_length_1066_cov_33.115822	450	530	2	3	80	0.0375000
NODE_5503_length_1066_cov_33.115822	450	530	5	19	80	0.2375000
NODE_5503_length_1066_cov_33.115822	450	530	6	4	80	0.0500000
NODE_5503_length_1066_cov_33.115822	450	530	8	6	80	0.0750000
NODE_5503_length_1066_cov_33.115822	450	530	9	1	80	0.0125000
NODE_5503_length_1066_cov_33.115822	450	530	11	10	80	0.1250000
NODE_5503_length_1066_cov_33.115822	450	530	12	5	80	0.0625000
NODE_5503_length_1066_cov_33.115822	450	530	14	3	80	0.0375000
NODE_5503_length_1066_cov_33.115822	450	530	16	23	80	0.2875000
NODE_5503_length_1066_cov_33.115822	450	530	17	1	80	0.0125000
NODE_5504_length_1066_cov_26.517063	215	285	52	4	70	0.0571429
NODE_5504_length_1066_cov_26.517063	215	285	53	1	70	0.0142857
NODE_5504_length_1066_cov_26.517063	215	285	54	7	70	0.1000000
NODE_5504_length_1066_cov_26.517063	215	285	55	4	70	0.0571429
NODE_5504_length_1066_cov_26.517063	215	285	58	1	70	0.0142857
NODE_5504_length_1066_cov_26.517063	215	285	59	1	70	0.0142857
NODE_5504_length_1066_cov_26.517063	215	285	60	6	70	0.0857143
NODE_5504_length_1066_cov_26.517063	215	285	61	11	70	0.1571429
NODE_5504_length_1066_cov_26.517063	215	285	62	5	70	0.0714286
NODE_5504_length_1066_cov_26.517063	215	285	64	1	70	0.0142857
NODE_5504_length_1066_cov_26.517063	215	285	65	1	70	0.0142857
NODE_5504_length_1066_cov_26.517063	215	285	66	3	70	0.0428571
NODE_5504_length_1066_cov_26.517063	215	285	67	1	70	0.0142857
NODE_5504_length_1066_cov_26.517063	215	285	69	1	70	0.0142857
NODE_5504_length_1066_cov_26.517063	215	285	70	8	70	0.1142857
NODE_5504_length_1066_cov_26.517063	215	285	71	3	70	0.0428571
NODE_5504_length_1066_cov_26.517063	215	285	72	10	70	0.1428571
NODE_5504_length_1066_cov_26.517063	215	285	73	1	70	0.0142857
NODE_5504_length_1066_cov_26.517063	215	285	75	1	70	0.0142857
NODE_5505_length_1066_cov_16.906929	526	606	3	25	80	0.3125000
NODE_5505_length_1066_cov_16.906929	526	606	4	45	80	0.5625000
NODE_5505_length_1066_cov_16.906929	526	606	5	10	80	0.1250000
NODE_5505_length_1066_cov_16.906929	579	659	2	3	80	0.0375000
NODE_5505_length_1066_cov_16.906929	579	659	3	11	80	0.1375000
NODE_5505_length_1066_cov_16.906929	579	659	4	32	80	0.4000000
NODE_5505_length_1066_cov_16.906929	579	659	5	34	80	0.4250000
NODE_5506_length_1066_cov_16.190279	298	378	6	7	80	0.0875000
NODE_5506_length_1066_cov_16.190279	298	378	7	22	80	0.2750000
NODE_5506_length_1066_cov_16.190279	298	378	8	19	80	0.2375000
NODE_5506_length_1066_cov_16.190279	298	378	9	25	80	0.3125000
NODE_5506_length_1066_cov_16.190279	298	378	11	7	80	0.0875000
NODE_5506_length_1066_cov_16.190279	351	432	6	3	81	0.0370370
NODE_5506_length_1066_cov_16.190279	351	432	7	1	81	0.0123457
NODE_5506_length_1066_cov_16.190279	351	432	8	45	81	0.5555556
NODE_5506_length_1066_cov_16.190279	351	432	9	29	81	0.3580247
NODE_5506_length_1066_cov_16.190279	351	432	11	3	81	0.0370370
NODE_5507_length_1066_cov_15.444674	582	662	10	6	80	0.0750000
NODE_5507_length_1066_cov_15.444674	582	662	11	7	80	0.0875000
NODE_5507_length_1066_cov_15.444674	582	662	13	24	80	0.3000000
NODE_5507_length_1066_cov_15.444674	582	662	15	2	80	0.0250000
NODE_5507_length_1066_cov_15.444674	582	662	16	1	80	0.0125000
NODE_5507_length_1066_cov_15.444674	582	662	20	40	80	0.5000000
NODE_5507_length_1066_cov_15.444674	635	715	10	14	80	0.1750000
NODE_5507_length_1066_cov_15.444674	635	715	12	23	80	0.2875000
NODE_5507_length_1066_cov_15.444674	635	715	13	1	80	0.0125000
NODE_5507_length_1066_cov_15.444674	635	715	15	17	80	0.2125000
NODE_5507_length_1066_cov_15.444674	635	715	16	1	80	0.0125000
NODE_5507_length_1066_cov_15.444674	635	715	20	24	80	0.3000000
NODE_5516_length_1065_cov_51.693582	480	560	2	15	80	0.1875000
NODE_5516_length_1065_cov_51.693582	480	560	3	17	80	0.2125000
NODE_5516_length_1065_cov_51.693582	480	560	4	48	80	0.6000000
NODE_5516_length_1065_cov_51.693582	533	613	3	25	80	0.3125000
NODE_5516_length_1065_cov_51.693582	533	613	4	55	80	0.6875000
NODE_5517_length_1065_cov_33.428571	422	502	3	42	80	0.5250000
NODE_5517_length_1065_cov_33.428571	422	502	5	14	80	0.1750000
NODE_5517_length_1065_cov_33.428571	422	502	6	5	80	0.0625000
NODE_5517_length_1065_cov_33.428571	422	502	9	13	80	0.1625000
NODE_5517_length_1065_cov_33.428571	422	502	10	6	80	0.0750000
NODE_5517_length_1065_cov_33.428571	422	502	3	42	80	0.5250000
NODE_5517_length_1065_cov_33.428571	422	502	5	14	80	0.1750000
NODE_5517_length_1065_cov_33.428571	422	502	6	5	80	0.0625000
NODE_5517_length_1065_cov_33.428571	422	502	9	13	80	0.1625000
NODE_5517_length_1065_cov_33.428571	422	502	10	6	80	0.0750000
NODE_5517_length_1065_cov_33.428571	422	502	3	42	80	0.5250000
NODE_5517_length_1065_cov_33.428571	422	502	5	14	80	0.1750000
NODE_5517_length_1065_cov_33.428571	422	502	6	5	80	0.0625000
NODE_5517_length_1065_cov_33.428571	422	502	9	13	80	0.1625000
NODE_5517_length_1065_cov_33.428571	422	502	10	6	80	0.0750000
NODE_5517_length_1065_cov_33.428571	475	555	5	3	80	0.0375000
NODE_5517_length_1065_cov_33.428571	475	555	6	5	80	0.0625000
NODE_5517_length_1065_cov_33.428571	475	555	9	13	80	0.1625000
NODE_5517_length_1065_cov_33.428571	475	555	10	17	80	0.2125000
NODE_5517_length_1065_cov_33.428571	475	555	11	41	80	0.5125000
NODE_5517_length_1065_cov_33.428571	475	555	12	1	80	0.0125000
NODE_5517_length_1065_cov_33.428571	475	555	5	3	80	0.0375000
NODE_5517_length_1065_cov_33.428571	475	555	6	5	80	0.0625000
NODE_5517_length_1065_cov_33.428571	475	555	9	13	80	0.1625000
NODE_5517_length_1065_cov_33.428571	475	555	10	17	80	0.2125000
NODE_5517_length_1065_cov_33.428571	475	555	11	41	80	0.5125000
NODE_5517_length_1065_cov_33.428571	475	555	12	1	80	0.0125000
NODE_5517_length_1065_cov_33.428571	551	631	7	3	80	0.0375000
NODE_5517_length_1065_cov_33.428571	551	631	8	17	80	0.2125000
NODE_5517_length_1065_cov_33.428571	551	631	9	8	80	0.1000000
NODE_5517_length_1065_cov_33.428571	551	631	10	39	80	0.4875000
NODE_5517_length_1065_cov_33.428571	551	631	11	3	80	0.0375000
NODE_5517_length_1065_cov_33.428571	551	631	12	10	80	0.1250000
NODE_5517_length_1065_cov_33.428571	551	631	7	3	80	0.0375000
NODE_5517_length_1065_cov_33.428571	551	631	8	17	80	0.2125000
NODE_5517_length_1065_cov_33.428571	551	631	9	8	80	0.1000000
NODE_5517_length_1065_cov_33.428571	551	631	10	39	80	0.4875000
NODE_5517_length_1065_cov_33.428571	551	631	11	3	80	0.0375000
NODE_5517_length_1065_cov_33.428571	551	631	12	10	80	0.1250000
NODE_5517_length_1065_cov_33.428571	551	572	9	3	21	0.1428571
NODE_5517_length_1065_cov_33.428571	551	572	10	5	21	0.2380952
NODE_5517_length_1065_cov_33.428571	551	572	11	3	21	0.1428571
NODE_5517_length_1065_cov_33.428571	551	572	12	10	21	0.4761905
NODE_5517_length_1065_cov_33.428571	604	666	5	15	62	0.2419355
NODE_5517_length_1065_cov_33.428571	604	666	6	14	62	0.2258064
NODE_5517_length_1065_cov_33.428571	604	666	7	5	62	0.0806452
NODE_5517_length_1065_cov_33.428571	604	666	8	17	62	0.2741936
NODE_5517_length_1065_cov_33.428571	604	666	9	4	62	0.0645161
NODE_5517_length_1065_cov_33.428571	604	666	10	7	62	0.1129032
NODE_5517_length_1065_cov_33.428571	604	684	5	15	80	0.1875000
NODE_5517_length_1065_cov_33.428571	604	684	6	14	80	0.1750000
NODE_5517_length_1065_cov_33.428571	604	684	7	5	80	0.0625000
NODE_5517_length_1065_cov_33.428571	604	684	8	17	80	0.2125000
NODE_5517_length_1065_cov_33.428571	604	684	9	5	80	0.0625000
NODE_5517_length_1065_cov_33.428571	604	684	10	20	80	0.2500000
NODE_5517_length_1065_cov_33.428571	604	684	11	4	80	0.0500000
NODE_5518_length_1065_cov_31.874741	255	335	1	14	80	0.1750000
NODE_5518_length_1065_cov_31.874741	255	335	2	66	80	0.8250000
NODE_5518_length_1065_cov_31.874741	308	388	1	19	80	0.2375000
NODE_5518_length_1065_cov_31.874741	308	388	2	61	80	0.7625000
NODE_5519_length_1065_cov_21.762940	234	314	4	2	80	0.0250000
NODE_5519_length_1065_cov_21.762940	234	314	5	78	80	0.9750000
NODE_5519_length_1065_cov_21.762940	287	367	4	7	80	0.0875000
NODE_5519_length_1065_cov_21.762940	287	367	5	73	80	0.9125000
NODE_5520_length_1065_cov_19.947205	447	527	7	7	80	0.0875000
NODE_5520_length_1065_cov_19.947205	447	527	8	20	80	0.2500000
NODE_5520_length_1065_cov_19.947205	447	527	9	48	80	0.6000000
NODE_5520_length_1065_cov_19.947205	447	527	10	5	80	0.0625000
NODE_5520_length_1065_cov_19.947205	500	580	6	8	80	0.1000000
NODE_5520_length_1065_cov_19.947205	500	580	7	12	80	0.1500000
NODE_5520_length_1065_cov_19.947205	500	580	8	45	80	0.5625000
NODE_5520_length_1065_cov_19.947205	500	580	9	15	80	0.1875000
NODE_5521_length_1065_cov_14.590062	343	423	2	10	80	0.1250000
NODE_5521_length_1065_cov_14.590062	343	423	3	18	80	0.2250000
NODE_5521_length_1065_cov_14.590062	343	423	4	11	80	0.1375000
NODE_5521_length_1065_cov_14.590062	343	423	6	41	80	0.5125000
NODE_5521_length_1065_cov_14.590062	396	476	6	34	80	0.4250000
NODE_5521_length_1065_cov_14.590062	396	476	7	37	80	0.4625000
NODE_5521_length_1065_cov_14.590062	396	476	8	9	80	0.1125000
NODE_5522_length_1065_cov_13.232919	243	323	2	18	80	0.2250000
NODE_5522_length_1065_cov_13.232919	243	323	4	62	80	0.7750000
NODE_5522_length_1065_cov_13.232919	296	376	2	26	80	0.3250000
NODE_5522_length_1065_cov_13.232919	296	376	4	54	80	0.6750000
NODE_5523_length_1065_cov_10.670807	481	561	7	34	80	0.4250000
NODE_5523_length_1065_cov_10.670807	481	561	8	19	80	0.2375000
NODE_5523_length_1065_cov_10.670807	481	561	9	27	80	0.3375000
NODE_5523_length_1065_cov_10.670807	534	614	1	6	80	0.0750000
NODE_5523_length_1065_cov_10.670807	534	614	3	8	80	0.1000000
NODE_5523_length_1065_cov_10.670807	534	614	5	2	80	0.0250000
NODE_5523_length_1065_cov_10.670807	534	614	6	24	80	0.3000000
NODE_5523_length_1065_cov_10.670807	534	614	7	8	80	0.1000000
NODE_5523_length_1065_cov_10.670807	534	614	8	32	80	0.4000000
NODE_5524_length_1065_cov_10.473085	496	576	6	80	80	1.0000000
NODE_5524_length_1065_cov_10.473085	549	629	1	14	80	0.1750000
NODE_5524_length_1065_cov_10.473085	549	629	3	17	80	0.2125000
NODE_5524_length_1065_cov_10.473085	549	629	4	19	80	0.2375000
NODE_5524_length_1065_cov_10.473085	549	629	6	30	80	0.3750000
NODE_5525_length_1065_cov_9.711180	286	360	1	30	74	0.4054054
NODE_5525_length_1065_cov_9.711180	286	360	2	44	74	0.5945946
NODE_5525_length_1065_cov_9.711180	339	419	2	24	80	0.3000000
NODE_5525_length_1065_cov_9.711180	339	419	3	46	80	0.5750000
NODE_5525_length_1065_cov_9.711180	339	419	4	10	80	0.1250000
NODE_5534_length_1064_cov_59.929534	457	537	5	51	80	0.6375000
NODE_5534_length_1064_cov_59.929534	457	537	6	12	80	0.1500000
NODE_5534_length_1064_cov_59.929534	457	537	8	17	80	0.2125000
NODE_5534_length_1064_cov_59.929534	510	590	5	37	80	0.4625000
NODE_5534_length_1064_cov_59.929534	510	590	6	20	80	0.2500000
NODE_5534_length_1064_cov_59.929534	510	590	7	5	80	0.0625000
NODE_5534_length_1064_cov_59.929534	510	590	8	18	80	0.2250000
NODE_5534_length_1064_cov_59.929534	586	666	5	4	80	0.0500000
NODE_5534_length_1064_cov_59.929534	586	666	7	3	80	0.0375000
NODE_5534_length_1064_cov_59.929534	586	666	8	11	80	0.1375000
NODE_5534_length_1064_cov_59.929534	586	666	9	22	80	0.2750000
NODE_5534_length_1064_cov_59.929534	586	666	10	15	80	0.1875000
NODE_5534_length_1064_cov_59.929534	586	666	11	8	80	0.1000000
NODE_5534_length_1064_cov_59.929534	586	666	12	17	80	0.2125000
NODE_5534_length_1064_cov_59.929534	639	719	9	49	80	0.6125000
NODE_5534_length_1064_cov_59.929534	639	719	10	2	80	0.0250000
NODE_5534_length_1064_cov_59.929534	639	719	11	12	80	0.1500000
NODE_5534_length_1064_cov_59.929534	639	719	12	17	80	0.2125000
NODE_5535_length_1064_cov_36.480829	367	447	7	9	80	0.1125000
NODE_5535_length_1064_cov_36.480829	367	447	8	49	80	0.6125000
NODE_5535_length_1064_cov_36.480829	367	447	9	19	80	0.2375000
NODE_5535_length_1064_cov_36.480829	367	447	10	3	80	0.0375000
NODE_5535_length_1064_cov_36.480829	420	500	3	4	80	0.0500000
NODE_5535_length_1064_cov_36.480829	420	500	4	10	80	0.1250000
NODE_5535_length_1064_cov_36.480829	420	500	5	16	80	0.2000000
NODE_5535_length_1064_cov_36.480829	420	500	6	10	80	0.1250000
NODE_5535_length_1064_cov_36.480829	420	500	7	9	80	0.1125000
NODE_5535_length_1064_cov_36.480829	420	500	8	29	80	0.3625000
NODE_5535_length_1064_cov_36.480829	420	500	9	2	80	0.0250000
NODE_5535_length_1064_cov_36.480829	496	576	3	2	80	0.0250000
NODE_5535_length_1064_cov_36.480829	496	576	5	23	80	0.2875000
NODE_5535_length_1064_cov_36.480829	496	576	6	9	80	0.1125000
NODE_5535_length_1064_cov_36.480829	496	576	8	22	80	0.2750000
NODE_5535_length_1064_cov_36.480829	496	576	9	24	80	0.3000000
NODE_5535_length_1064_cov_36.480829	549	629	6	7	80	0.0875000
NODE_5535_length_1064_cov_36.480829	549	629	7	13	80	0.1625000
NODE_5535_length_1064_cov_36.480829	549	629	8	31	80	0.3875000
NODE_5535_length_1064_cov_36.480829	549	629	9	29	80	0.3625000
NODE_5536_length_1064_cov_32.307772	547	627	11	2	80	0.0250000
NODE_5536_length_1064_cov_32.307772	547	627	12	12	80	0.1500000
NODE_5536_length_1064_cov_32.307772	547	627	13	1	80	0.0125000
NODE_5536_length_1064_cov_32.307772	547	627	14	2	80	0.0250000
NODE_5536_length_1064_cov_32.307772	547	627	15	4	80	0.0500000
NODE_5536_length_1064_cov_32.307772	547	627	16	5	80	0.0625000
NODE_5536_length_1064_cov_32.307772	547	627	18	5	80	0.0625000
NODE_5536_length_1064_cov_32.307772	547	627	20	2	80	0.0250000
NODE_5536_length_1064_cov_32.307772	547	627	21	8	80	0.1000000
NODE_5536_length_1064_cov_32.307772	547	627	23	3	80	0.0375000
NODE_5536_length_1064_cov_32.307772	547	627	24	3	80	0.0375000
NODE_5536_length_1064_cov_32.307772	547	627	25	18	80	0.2250000
NODE_5536_length_1064_cov_32.307772	547	627	26	11	80	0.1375000
NODE_5536_length_1064_cov_32.307772	547	627	27	4	80	0.0500000
NODE_5536_length_1064_cov_32.307772	600	680	24	21	80	0.2625000
NODE_5536_length_1064_cov_32.307772	600	680	25	21	80	0.2625000
NODE_5536_length_1064_cov_32.307772	600	680	26	17	80	0.2125000
NODE_5536_length_1064_cov_32.307772	600	680	27	21	80	0.2625000
NODE_5537_length_1064_cov_25.255959	462	542	2	1	80	0.0125000
NODE_5537_length_1064_cov_25.255959	462	542	3	40	80	0.5000000
NODE_5537_length_1064_cov_25.255959	462	542	4	39	80	0.4875000
NODE_5537_length_1064_cov_25.255959	515	595	1	22	80	0.2750000
NODE_5537_length_1064_cov_25.255959	515	595	2	1	80	0.0125000
NODE_5537_length_1064_cov_25.255959	515	595	3	57	80	0.7125000
NODE_5537_length_1064_cov_25.255959	591	671	2	19	80	0.2375000
NODE_5537_length_1064_cov_25.255959	591	671	3	61	80	0.7625000
NODE_5537_length_1064_cov_25.255959	644	724	0	24	80	0.3000000
NODE_5537_length_1064_cov_25.255959	644	724	1	21	80	0.2625000
NODE_5537_length_1064_cov_25.255959	644	724	2	27	80	0.3375000
NODE_5537_length_1064_cov_25.255959	644	724	3	8	80	0.1000000
NODE_5538_length_1064_cov_23.053886	343	423	3	15	80	0.1875000
NODE_5538_length_1064_cov_23.053886	343	423	4	64	80	0.8000000
NODE_5538_length_1064_cov_23.053886	343	423	5	1	80	0.0125000
NODE_5538_length_1064_cov_23.053886	396	476	4	27	80	0.3375000
NODE_5538_length_1064_cov_23.053886	396	476	5	5	80	0.0625000
NODE_5538_length_1064_cov_23.053886	396	476	6	20	80	0.2500000
NODE_5538_length_1064_cov_23.053886	396	476	7	28	80	0.3500000
NODE_5538_length_1064_cov_23.053886	472	552	3	27	80	0.3375000
NODE_5538_length_1064_cov_23.053886	472	552	4	17	80	0.2125000
NODE_5538_length_1064_cov_23.053886	472	552	5	36	80	0.4500000
NODE_5538_length_1064_cov_23.053886	525	605	0	3	80	0.0375000
NODE_5538_length_1064_cov_23.053886	525	605	1	28	80	0.3500000
NODE_5538_length_1064_cov_23.053886	525	605	2	1	80	0.0125000
NODE_5538_length_1064_cov_23.053886	525	605	3	48	80	0.6000000
NODE_5539_length_1064_cov_22.018653	479	559	0	80	80	1.0000000
NODE_5539_length_1064_cov_22.018653	532	612	0	80	80	1.0000000
NODE_5540_length_1064_cov_12.868394	424	504	1	18	80	0.2250000
NODE_5540_length_1064_cov_12.868394	424	504	2	6	80	0.0750000
NODE_5540_length_1064_cov_12.868394	424	504	3	56	80	0.7000000
NODE_5540_length_1064_cov_12.868394	477	557	2	4	80	0.0500000
NODE_5540_length_1064_cov_12.868394	477	557	3	76	80	0.9500000
NODE_5541_length_1064_cov_10.098446	467	547	2	2	80	0.0250000
NODE_5541_length_1064_cov_10.098446	467	547	3	78	80	0.9750000
NODE_5541_length_1064_cov_10.098446	520	600	2	54	80	0.6750000
NODE_5541_length_1064_cov_10.098446	520	600	3	26	80	0.3250000
NODE_5543_length_1064_cov_2.925389	173	245	2	55	72	0.7638889
NODE_5543_length_1064_cov_2.925389	173	245	4	17	72	0.2361111
NODE_5551_length_1063_cov_104.615145	504	584	26	7	80	0.0875000
NODE_5551_length_1063_cov_104.615145	504	584	28	10	80	0.1250000
NODE_5551_length_1063_cov_104.615145	504	584	29	4	80	0.0500000
NODE_5551_length_1063_cov_104.615145	504	584	30	4	80	0.0500000
NODE_5551_length_1063_cov_104.615145	504	584	31	3	80	0.0375000
NODE_5551_length_1063_cov_104.615145	504	584	32	16	80	0.2000000
NODE_5551_length_1063_cov_104.615145	504	584	33	10	80	0.1250000
NODE_5551_length_1063_cov_104.615145	504	584	34	12	80	0.1500000
NODE_5551_length_1063_cov_104.615145	504	584	35	12	80	0.1500000
NODE_5551_length_1063_cov_104.615145	504	584	36	2	80	0.0250000
NODE_5551_length_1063_cov_104.615145	557	637	15	4	80	0.0500000
NODE_5551_length_1063_cov_104.615145	557	637	17	2	80	0.0250000
NODE_5551_length_1063_cov_104.615145	557	637	18	7	80	0.0875000
NODE_5551_length_1063_cov_104.615145	557	637	20	1	80	0.0125000
NODE_5551_length_1063_cov_104.615145	557	637	23	1	80	0.0125000
NODE_5551_length_1063_cov_104.615145	557	637	24	3	80	0.0375000
NODE_5551_length_1063_cov_104.615145	557	637	25	1	80	0.0125000
NODE_5551_length_1063_cov_104.615145	557	637	27	5	80	0.0625000
NODE_5551_length_1063_cov_104.615145	557	637	28	12	80	0.1500000
NODE_5551_length_1063_cov_104.615145	557	637	29	3	80	0.0375000
NODE_5551_length_1063_cov_104.615145	557	637	30	4	80	0.0500000
NODE_5551_length_1063_cov_104.615145	557	637	31	1	80	0.0125000
NODE_5551_length_1063_cov_104.615145	557	637	32	21	80	0.2625000
NODE_5551_length_1063_cov_104.615145	557	637	33	3	80	0.0375000
NODE_5551_length_1063_cov_104.615145	557	637	34	11	80	0.1375000
NODE_5551_length_1063_cov_104.615145	557	637	35	1	80	0.0125000
NODE_5552_length_1063_cov_36.515560	482	562	2	80	80	1.0000000
NODE_5552_length_1063_cov_36.515560	535	615	2	47	80	0.5875000
NODE_5552_length_1063_cov_36.515560	535	615	3	11	80	0.1375000
NODE_5552_length_1063_cov_36.515560	535	615	4	22	80	0.2750000
NODE_5552_length_1063_cov_36.515560	611	691	2	14	80	0.1750000
NODE_5552_length_1063_cov_36.515560	611	691	3	8	80	0.1000000
NODE_5552_length_1063_cov_36.515560	611	691	5	15	80	0.1875000
NODE_5552_length_1063_cov_36.515560	611	691	6	1	80	0.0125000
NODE_5552_length_1063_cov_36.515560	611	691	7	42	80	0.5250000
NODE_5552_length_1063_cov_36.515560	664	744	3	6	80	0.0750000
NODE_5552_length_1063_cov_36.515560	664	744	4	6	80	0.0750000
NODE_5552_length_1063_cov_36.515560	664	744	5	3	80	0.0375000
NODE_5552_length_1063_cov_36.515560	664	744	7	65	80	0.8125000
NODE_5553_length_1063_cov_30.700207	470	550	7	26	80	0.3250000
NODE_5553_length_1063_cov_30.700207	470	550	8	19	80	0.2375000
NODE_5553_length_1063_cov_30.700207	470	550	9	3	80	0.0375000
NODE_5553_length_1063_cov_30.700207	470	550	10	16	80	0.2000000
NODE_5553_length_1063_cov_30.700207	470	550	11	10	80	0.1250000
NODE_5553_length_1063_cov_30.700207	470	550	12	6	80	0.0750000
NODE_5553_length_1063_cov_30.700207	523	603	9	1	80	0.0125000
NODE_5553_length_1063_cov_30.700207	523	603	10	53	80	0.6625000
NODE_5553_length_1063_cov_30.700207	523	603	11	20	80	0.2500000
NODE_5553_length_1063_cov_30.700207	523	603	12	6	80	0.0750000
NODE_5553_length_1063_cov_30.700207	599	679	7	13	80	0.1625000
NODE_5553_length_1063_cov_30.700207	599	679	8	26	80	0.3250000
NODE_5553_length_1063_cov_30.700207	599	679	9	20	80	0.2500000
NODE_5553_length_1063_cov_30.700207	599	679	10	21	80	0.2625000
NODE_5553_length_1063_cov_30.700207	652	732	5	8	80	0.1000000
NODE_5553_length_1063_cov_30.700207	652	732	6	44	80	0.5500000
NODE_5553_length_1063_cov_30.700207	652	732	7	10	80	0.1250000
NODE_5553_length_1063_cov_30.700207	652	732	8	15	80	0.1875000
NODE_5553_length_1063_cov_30.700207	652	732	9	3	80	0.0375000
NODE_5554_length_1063_cov_24.552905	362	442	5	1	80	0.0125000
NODE_5554_length_1063_cov_24.552905	362	442	6	3	80	0.0375000
NODE_5554_length_1063_cov_24.552905	362	442	7	35	80	0.4375000
NODE_5554_length_1063_cov_24.552905	362	442	8	41	80	0.5125000
NODE_5554_length_1063_cov_24.552905	415	495	5	20	80	0.2500000
NODE_5554_length_1063_cov_24.552905	415	495	7	42	80	0.5250000
NODE_5554_length_1063_cov_24.552905	415	495	8	13	80	0.1625000
NODE_5554_length_1063_cov_24.552905	415	495	9	5	80	0.0625000
NODE_5555_length_1063_cov_21.985477	407	487	5	11	80	0.1375000
NODE_5555_length_1063_cov_21.985477	407	487	6	18	80	0.2250000
NODE_5555_length_1063_cov_21.985477	407	487	7	5	80	0.0625000
NODE_5555_length_1063_cov_21.985477	407	487	8	46	80	0.5750000
NODE_5555_length_1063_cov_21.985477	460	540	6	9	80	0.1125000
NODE_5555_length_1063_cov_21.985477	460	540	7	33	80	0.4125000
NODE_5555_length_1063_cov_21.985477	460	540	8	34	80	0.4250000
NODE_5555_length_1063_cov_21.985477	460	540	9	4	80	0.0500000
NODE_5555_length_1063_cov_21.985477	536	616	5	30	80	0.3750000
NODE_5555_length_1063_cov_21.985477	536	616	6	7	80	0.0875000
NODE_5555_length_1063_cov_21.985477	536	616	7	20	80	0.2500000
NODE_5555_length_1063_cov_21.985477	536	616	8	23	80	0.2875000
NODE_5555_length_1063_cov_21.985477	589	670	5	64	81	0.7901235
NODE_5555_length_1063_cov_21.985477	589	670	6	14	81	0.1728395
NODE_5555_length_1063_cov_21.985477	589	670	7	3	81	0.0370370
NODE_5557_length_1063_cov_15.400415	685	765	4	3	80	0.0375000
NODE_5557_length_1063_cov_15.400415	685	765	5	23	80	0.2875000
NODE_5557_length_1063_cov_15.400415	685	765	6	44	80	0.5500000
NODE_5557_length_1063_cov_15.400415	685	765	7	10	80	0.1250000
NODE_5557_length_1063_cov_15.400415	738	818	5	54	80	0.6750000
NODE_5557_length_1063_cov_15.400415	738	818	7	26	80	0.3250000
NODE_5558_length_1063_cov_13.282158	510	590	0	10	80	0.1250000
NODE_5558_length_1063_cov_13.282158	510	590	2	22	80	0.2750000
NODE_5558_length_1063_cov_13.282158	510	590	3	48	80	0.6000000
NODE_5558_length_1063_cov_13.282158	563	643	3	56	80	0.7000000
NODE_5558_length_1063_cov_13.282158	563	643	5	24	80	0.3000000
NODE_5559_length_1063_cov_12.970954	417	495	0	78	78	1.0000000
NODE_5559_length_1063_cov_12.970954	468	548	0	36	80	0.4500000
NODE_5559_length_1063_cov_12.970954	468	548	1	22	80	0.2750000
NODE_5559_length_1063_cov_12.970954	468	548	2	22	80	0.2750000
NODE_5560_length_1063_cov_7.917012	639	719	5	42	80	0.5250000
NODE_5560_length_1063_cov_7.917012	639	719	6	12	80	0.1500000
NODE_5560_length_1063_cov_7.917012	639	719	7	26	80	0.3250000
NODE_5560_length_1063_cov_7.917012	692	772	5	15	80	0.1875000
NODE_5560_length_1063_cov_7.917012	692	772	6	65	80	0.8125000
NODE_5569_length_1063_cov_1.695021	893	947	0	54	54	1.0000000
NODE_5574_length_1062_cov_43.399792	272	352	3	23	80	0.2875000
NODE_5574_length_1062_cov_43.399792	272	352	6	57	80	0.7125000
NODE_5574_length_1062_cov_43.399792	325	405	0	17	80	0.2125000
NODE_5574_length_1062_cov_43.399792	325	405	3	59	80	0.7375000
NODE_5574_length_1062_cov_43.399792	325	405	6	4	80	0.0500000
NODE_5576_length_1062_cov_19.778816	401	481	5	34	80	0.4250000
NODE_5576_length_1062_cov_19.778816	401	481	6	23	80	0.2875000
NODE_5576_length_1062_cov_19.778816	401	481	7	3	80	0.0375000
NODE_5576_length_1062_cov_19.778816	401	481	8	20	80	0.2500000
NODE_5576_length_1062_cov_19.778816	454	534	4	33	80	0.4125000
NODE_5576_length_1062_cov_19.778816	454	534	5	16	80	0.2000000
NODE_5576_length_1062_cov_19.778816	454	534	6	27	80	0.3375000
NODE_5576_length_1062_cov_19.778816	454	534	8	4	80	0.0500000
NODE_5577_length_1062_cov_16.034268	628	708	1	40	80	0.5000000
NODE_5577_length_1062_cov_16.034268	628	708	2	40	80	0.5000000
NODE_5577_length_1062_cov_16.034268	681	761	0	19	80	0.2375000
NODE_5577_length_1062_cov_16.034268	681	761	1	61	80	0.7625000
NODE_5578_length_1062_cov_13.346833	623	703	0	80	80	1.0000000
NODE_5578_length_1062_cov_13.346833	676	756	0	80	80	1.0000000
NODE_5579_length_1062_cov_9.886812	670	750	0	27	80	0.3375000
NODE_5579_length_1062_cov_9.886812	670	750	1	43	80	0.5375000
NODE_5579_length_1062_cov_9.886812	670	750	2	10	80	0.1250000
NODE_5579_length_1062_cov_9.886812	723	803	1	17	80	0.2125000
NODE_5579_length_1062_cov_9.886812	723	803	2	63	80	0.7875000
NODE_5580_length_1062_cov_9.078920	525	604	1	3	79	0.0379747
NODE_5580_length_1062_cov_9.078920	525	604	2	62	79	0.7848101
NODE_5580_length_1062_cov_9.078920	525	604	3	14	79	0.1772152
NODE_5580_length_1062_cov_9.078920	577	657	2	44	80	0.5500000
NODE_5580_length_1062_cov_9.078920	577	657	3	36	80	0.4500000
NODE_5581_length_1062_cov_8.934579	203	283	1	43	80	0.5375000
NODE_5581_length_1062_cov_8.934579	203	283	2	13	80	0.1625000
NODE_5581_length_1062_cov_8.934579	203	283	3	24	80	0.3000000
NODE_5581_length_1062_cov_8.934579	256	336	1	3	80	0.0375000
NODE_5581_length_1062_cov_8.934579	256	336	3	77	80	0.9625000
NODE_5588_length_1061_cov_22.637214	418	498	7	17	80	0.2125000
NODE_5588_length_1061_cov_22.637214	418	498	8	23	80	0.2875000
NODE_5588_length_1061_cov_22.637214	418	498	9	39	80	0.4875000
NODE_5588_length_1061_cov_22.637214	418	498	10	1	80	0.0125000
NODE_5588_length_1061_cov_22.637214	471	551	4	12	80	0.1500000
NODE_5588_length_1061_cov_22.637214	471	551	5	14	80	0.1750000
NODE_5588_length_1061_cov_22.637214	471	551	6	7	80	0.0875000
NODE_5588_length_1061_cov_22.637214	471	551	7	27	80	0.3375000
NODE_5588_length_1061_cov_22.637214	471	551	8	20	80	0.2500000
NODE_5589_length_1061_cov_22.338877	479	559	3	9	80	0.1125000
NODE_5589_length_1061_cov_22.338877	479	559	5	9	80	0.1125000
NODE_5589_length_1061_cov_22.338877	479	559	6	32	80	0.4000000
NODE_5589_length_1061_cov_22.338877	479	559	9	30	80	0.3750000
NODE_5589_length_1061_cov_22.338877	532	612	7	20	80	0.2500000
NODE_5589_length_1061_cov_22.338877	532	612	9	60	80	0.7500000
NODE_5597_length_1060_cov_31.595213	394	473	4	4	79	0.0506329
NODE_5597_length_1060_cov_31.595213	394	473	5	12	79	0.1518987
NODE_5597_length_1060_cov_31.595213	394	473	6	44	79	0.5569620
NODE_5597_length_1060_cov_31.595213	394	473	7	19	79	0.2405063
NODE_5597_length_1060_cov_31.595213	446	526	6	68	80	0.8500000
NODE_5597_length_1060_cov_31.595213	446	526	7	12	80	0.1500000
NODE_5597_length_1060_cov_31.595213	522	602	6	5	80	0.0625000
NODE_5597_length_1060_cov_31.595213	522	602	7	15	80	0.1875000
NODE_5597_length_1060_cov_31.595213	522	602	8	29	80	0.3625000
NODE_5597_length_1060_cov_31.595213	522	602	9	31	80	0.3875000
NODE_5597_length_1060_cov_31.595213	575	655	4	4	80	0.0500000
NODE_5597_length_1060_cov_31.595213	575	655	5	7	80	0.0875000
NODE_5597_length_1060_cov_31.595213	575	655	6	6	80	0.0750000
NODE_5597_length_1060_cov_31.595213	575	655	7	45	80	0.5625000
NODE_5597_length_1060_cov_31.595213	575	655	9	18	80	0.2250000
NODE_5598_length_1060_cov_26.136316	486	566	7	15	80	0.1875000
NODE_5598_length_1060_cov_26.136316	486	566	8	53	80	0.6625000
NODE_5598_length_1060_cov_26.136316	486	566	9	11	80	0.1375000
NODE_5598_length_1060_cov_26.136316	486	566	10	1	80	0.0125000
NODE_5598_length_1060_cov_26.136316	539	619	7	5	80	0.0625000
NODE_5598_length_1060_cov_26.136316	539	619	8	66	80	0.8250000
NODE_5598_length_1060_cov_26.136316	539	619	9	7	80	0.0875000
NODE_5598_length_1060_cov_26.136316	539	619	10	2	80	0.0250000
NODE_5598_length_1060_cov_26.136316	615	695	4	8	80	0.1000000
NODE_5598_length_1060_cov_26.136316	615	695	5	26	80	0.3250000
NODE_5598_length_1060_cov_26.136316	615	695	6	36	80	0.4500000
NODE_5598_length_1060_cov_26.136316	615	695	7	10	80	0.1250000
NODE_5598_length_1060_cov_26.136316	668	748	1	4	80	0.0500000
NODE_5598_length_1060_cov_26.136316	668	748	2	37	80	0.4625000
NODE_5598_length_1060_cov_26.136316	668	748	4	17	80	0.2125000
NODE_5598_length_1060_cov_26.136316	668	748	5	22	80	0.2750000
NODE_5599_length_1060_cov_25.329865	370	450	3	17	80	0.2125000
NODE_5599_length_1060_cov_25.329865	370	450	5	4	80	0.0500000
NODE_5599_length_1060_cov_25.329865	370	450	6	10	80	0.1250000
NODE_5599_length_1060_cov_25.329865	370	450	7	20	80	0.2500000
NODE_5599_length_1060_cov_25.329865	370	450	8	29	80	0.3625000
NODE_5599_length_1060_cov_25.329865	423	503	0	24	80	0.3000000
NODE_5599_length_1060_cov_25.329865	423	503	1	29	80	0.3625000
NODE_5599_length_1060_cov_25.329865	423	503	3	17	80	0.2125000
NODE_5599_length_1060_cov_25.329865	423	503	5	4	80	0.0500000
NODE_5599_length_1060_cov_25.329865	423	503	6	6	80	0.0750000
NODE_5600_length_1060_cov_16.881374	539	611	2	14	72	0.1944444
NODE_5600_length_1060_cov_16.881374	539	611	3	58	72	0.8055556
NODE_5601_length_1060_cov_14.789802	406	486	2	7	80	0.0875000
NODE_5601_length_1060_cov_14.789802	406	486	3	16	80	0.2000000
NODE_5601_length_1060_cov_14.789802	406	486	4	25	80	0.3125000
NODE_5601_length_1060_cov_14.789802	406	486	6	15	80	0.1875000
NODE_5601_length_1060_cov_14.789802	406	486	8	17	80	0.2125000
NODE_5601_length_1060_cov_14.789802	459	539	6	59	80	0.7375000
NODE_5601_length_1060_cov_14.789802	459	539	8	21	80	0.2625000
NODE_5603_length_1060_cov_5.900104	517	597	3	27	80	0.3375000
NODE_5603_length_1060_cov_5.900104	517	597	4	53	80	0.6625000
NODE_5603_length_1060_cov_5.900104	570	650	0	20	80	0.2500000
NODE_5603_length_1060_cov_5.900104	570	650	1	33	80	0.4125000
NODE_5603_length_1060_cov_5.900104	570	650	3	27	80	0.3375000
NODE_5611_length_1059_cov_16.630208	412	492	2	27	80	0.3375000
NODE_5611_length_1059_cov_16.630208	412	492	3	53	80	0.6625000
NODE_5611_length_1059_cov_16.630208	465	552	2	41	87	0.4712644
NODE_5611_length_1059_cov_16.630208	465	552	3	8	87	0.0919540
NODE_5611_length_1059_cov_16.630208	465	552	4	27	87	0.3103448
NODE_5611_length_1059_cov_16.630208	465	552	5	11	87	0.1264368
NODE_5611_length_1059_cov_16.630208	548	628	4	13	80	0.1625000
NODE_5611_length_1059_cov_16.630208	548	628	5	4	80	0.0500000
NODE_5611_length_1059_cov_16.630208	548	628	6	1	80	0.0125000
NODE_5611_length_1059_cov_16.630208	548	628	7	12	80	0.1500000
NODE_5611_length_1059_cov_16.630208	548	628	8	27	80	0.3375000
NODE_5611_length_1059_cov_16.630208	548	628	9	3	80	0.0375000
NODE_5611_length_1059_cov_16.630208	548	628	10	20	80	0.2500000
NODE_5611_length_1059_cov_16.630208	601	681	6	8	80	0.1000000
NODE_5611_length_1059_cov_16.630208	601	681	7	10	80	0.1250000
NODE_5611_length_1059_cov_16.630208	601	681	8	7	80	0.0875000
NODE_5611_length_1059_cov_16.630208	601	681	9	24	80	0.3000000
NODE_5611_length_1059_cov_16.630208	601	681	10	31	80	0.3875000
NODE_5621_length_1058_cov_60.155370	395	475	3	14	80	0.1750000
NODE_5621_length_1058_cov_60.155370	395	475	4	24	80	0.3000000
NODE_5621_length_1058_cov_60.155370	395	475	5	25	80	0.3125000
NODE_5621_length_1058_cov_60.155370	395	475	6	15	80	0.1875000
NODE_5621_length_1058_cov_60.155370	395	475	7	2	80	0.0250000
NODE_5621_length_1058_cov_60.155370	448	528	5	10	80	0.1250000
NODE_5621_length_1058_cov_60.155370	448	528	6	15	80	0.1875000
NODE_5621_length_1058_cov_60.155370	448	528	7	12	80	0.1500000
NODE_5621_length_1058_cov_60.155370	448	528	8	10	80	0.1250000
NODE_5621_length_1058_cov_60.155370	448	528	9	23	80	0.2875000
NODE_5621_length_1058_cov_60.155370	448	528	10	10	80	0.1250000
NODE_5621_length_1058_cov_60.155370	524	604	10	10	80	0.1250000
NODE_5621_length_1058_cov_60.155370	524	604	12	14	80	0.1750000
NODE_5621_length_1058_cov_60.155370	524	604	14	9	80	0.1125000
NODE_5621_length_1058_cov_60.155370	524	604	15	11	80	0.1375000
NODE_5621_length_1058_cov_60.155370	524	604	16	2	80	0.0250000
NODE_5621_length_1058_cov_60.155370	524	604	17	15	80	0.1875000
NODE_5621_length_1058_cov_60.155370	524	604	18	4	80	0.0500000
NODE_5621_length_1058_cov_60.155370	524	604	19	9	80	0.1125000
NODE_5621_length_1058_cov_60.155370	524	604	20	6	80	0.0750000
NODE_5621_length_1058_cov_60.155370	577	657	17	8	80	0.1000000
NODE_5621_length_1058_cov_60.155370	577	657	18	11	80	0.1375000
NODE_5621_length_1058_cov_60.155370	577	657	19	45	80	0.5625000
NODE_5621_length_1058_cov_60.155370	577	657	20	14	80	0.1750000
NODE_5621_length_1058_cov_60.155370	577	657	21	2	80	0.0250000
NODE_5622_length_1058_cov_31.253389	475	555	0	62	80	0.7750000
NODE_5622_length_1058_cov_31.253389	475	555	1	9	80	0.1125000
NODE_5622_length_1058_cov_31.253389	475	555	2	9	80	0.1125000
NODE_5622_length_1058_cov_31.253389	475	555	0	62	80	0.7750000
NODE_5622_length_1058_cov_31.253389	475	555	1	9	80	0.1125000
NODE_5622_length_1058_cov_31.253389	475	555	2	9	80	0.1125000
NODE_5622_length_1058_cov_31.253389	528	608	0	80	80	1.0000000
NODE_5622_length_1058_cov_31.253389	533	608	0	75	75	1.0000000
NODE_5623_length_1058_cov_24.520334	264	344	0	35	80	0.4375000
NODE_5623_length_1058_cov_24.520334	264	344	2	6	80	0.0750000
NODE_5623_length_1058_cov_24.520334	264	344	4	39	80	0.4875000
NODE_5623_length_1058_cov_24.520334	317	397	4	80	80	1.0000000
NODE_5624_length_1058_cov_24.211679	297	377	1	2	80	0.0250000
NODE_5624_length_1058_cov_24.211679	297	377	2	78	80	0.9750000
NODE_5624_length_1058_cov_24.211679	350	430	1	1	80	0.0125000
NODE_5624_length_1058_cov_24.211679	350	430	2	79	80	0.9875000
NODE_5625_length_1058_cov_18.100104	454	534	3	30	80	0.3750000
NODE_5625_length_1058_cov_18.100104	454	534	4	45	80	0.5625000
NODE_5625_length_1058_cov_18.100104	454	534	5	5	80	0.0625000
NODE_5625_length_1058_cov_18.100104	507	587	2	17	80	0.2125000
NODE_5625_length_1058_cov_18.100104	507	587	3	30	80	0.3750000
NODE_5625_length_1058_cov_18.100104	507	587	4	22	80	0.2750000
NODE_5625_length_1058_cov_18.100104	507	587	5	11	80	0.1375000
NODE_5626_length_1058_cov_11.645464	476	556	2	31	80	0.3875000
NODE_5626_length_1058_cov_11.645464	476	556	4	49	80	0.6125000
NODE_5626_length_1058_cov_11.645464	529	609	2	21	80	0.2625000
NODE_5626_length_1058_cov_11.645464	529	609	4	59	80	0.7375000
NODE_5627_length_1058_cov_9.953076	621	712	3	20	91	0.2197802
NODE_5627_length_1058_cov_9.953076	621	712	4	65	91	0.7142857
NODE_5627_length_1058_cov_9.953076	621	712	6	6	91	0.0659341
NODE_5627_length_1058_cov_9.953076	685	765	4	35	80	0.4375000
NODE_5627_length_1058_cov_9.953076	685	765	5	7	80	0.0875000
NODE_5627_length_1058_cov_9.953076	685	765	6	17	80	0.2125000
NODE_5627_length_1058_cov_9.953076	685	765	7	21	80	0.2625000
NODE_5628_length_1058_cov_6.294056	819	899	2	2	80	0.0250000
NODE_5628_length_1058_cov_6.294056	819	899	4	4	80	0.0500000
NODE_5628_length_1058_cov_6.294056	819	899	6	58	80	0.7250000
NODE_5628_length_1058_cov_6.294056	819	899	8	16	80	0.2000000
NODE_5628_length_1058_cov_6.294056	875	952	2	12	77	0.1558442
NODE_5628_length_1058_cov_6.294056	875	952	4	5	77	0.0649351
NODE_5628_length_1058_cov_6.294056	875	952	6	12	77	0.1558442
NODE_5628_length_1058_cov_6.294056	875	952	8	48	77	0.6233766
NODE_5637_length_1057_cov_43.191023	413	493	5	18	80	0.2250000
NODE_5637_length_1057_cov_43.191023	413	493	6	12	80	0.1500000
NODE_5637_length_1057_cov_43.191023	413	493	7	16	80	0.2000000
NODE_5637_length_1057_cov_43.191023	413	493	8	34	80	0.4250000
NODE_5637_length_1057_cov_43.191023	466	546	5	20	80	0.2500000
NODE_5637_length_1057_cov_43.191023	466	546	6	14	80	0.1750000
NODE_5637_length_1057_cov_43.191023	466	546	7	15	80	0.1875000
NODE_5637_length_1057_cov_43.191023	466	546	8	26	80	0.3250000
NODE_5637_length_1057_cov_43.191023	466	546	9	5	80	0.0625000
NODE_5637_length_1057_cov_43.191023	542	622	6	10	80	0.1250000
NODE_5637_length_1057_cov_43.191023	542	622	7	31	80	0.3875000
NODE_5637_length_1057_cov_43.191023	542	622	8	39	80	0.4875000
NODE_5637_length_1057_cov_43.191023	595	675	2	8	80	0.1000000
NODE_5637_length_1057_cov_43.191023	595	675	3	2	80	0.0250000
NODE_5637_length_1057_cov_43.191023	595	675	5	2	80	0.0250000
NODE_5637_length_1057_cov_43.191023	595	675	6	34	80	0.4250000
NODE_5637_length_1057_cov_43.191023	595	675	7	34	80	0.4250000
NODE_5638_length_1057_cov_27.387265	486	566	6	5	80	0.0625000
NODE_5638_length_1057_cov_27.387265	486	566	7	28	80	0.3500000
NODE_5638_length_1057_cov_27.387265	486	566	8	21	80	0.2625000
NODE_5638_length_1057_cov_27.387265	486	566	9	26	80	0.3250000
NODE_5638_length_1057_cov_27.387265	539	619	4	7	80	0.0875000
NODE_5638_length_1057_cov_27.387265	539	619	5	24	80	0.3000000
NODE_5638_length_1057_cov_27.387265	539	619	6	21	80	0.2625000
NODE_5638_length_1057_cov_27.387265	539	619	7	13	80	0.1625000
NODE_5638_length_1057_cov_27.387265	539	619	8	15	80	0.1875000
NODE_5639_length_1057_cov_16.489562	416	496	1	7	80	0.0875000
NODE_5639_length_1057_cov_16.489562	416	496	3	2	80	0.0250000
NODE_5639_length_1057_cov_16.489562	416	496	5	19	80	0.2375000
NODE_5639_length_1057_cov_16.489562	416	496	6	27	80	0.3375000
NODE_5639_length_1057_cov_16.489562	416	496	7	25	80	0.3125000
NODE_5639_length_1057_cov_16.489562	469	549	3	8	80	0.1000000
NODE_5639_length_1057_cov_16.489562	469	549	5	5	80	0.0625000
NODE_5639_length_1057_cov_16.489562	469	549	6	2	80	0.0250000
NODE_5639_length_1057_cov_16.489562	469	549	7	65	80	0.8125000
NODE_5640_length_1057_cov_13.605428	631	711	1	7	80	0.0875000
NODE_5640_length_1057_cov_13.605428	631	711	3	52	80	0.6500000
NODE_5640_length_1057_cov_13.605428	631	711	4	21	80	0.2625000
NODE_5640_length_1057_cov_13.605428	684	764	1	4	80	0.0500000
NODE_5640_length_1057_cov_13.605428	684	764	2	12	80	0.1500000
NODE_5640_length_1057_cov_13.605428	684	764	3	37	80	0.4625000
NODE_5640_length_1057_cov_13.605428	684	764	4	27	80	0.3375000
NODE_5641_length_1057_cov_12.768267	518	598	1	1	80	0.0125000
NODE_5641_length_1057_cov_12.768267	518	598	4	16	80	0.2000000
NODE_5641_length_1057_cov_12.768267	518	598	5	5	80	0.0625000
NODE_5641_length_1057_cov_12.768267	518	598	6	58	80	0.7250000
NODE_5641_length_1057_cov_12.768267	571	651	3	3	80	0.0375000
NODE_5641_length_1057_cov_12.768267	571	651	4	4	80	0.0500000
NODE_5641_length_1057_cov_12.768267	571	651	5	21	80	0.2625000
NODE_5641_length_1057_cov_12.768267	571	651	6	52	80	0.6500000
NODE_5644_length_1057_cov_7.692067	706	786	4	60	80	0.7500000
NODE_5644_length_1057_cov_7.692067	706	786	5	20	80	0.2500000
NODE_5644_length_1057_cov_7.692067	759	839	3	32	80	0.4000000
NODE_5644_length_1057_cov_7.692067	759	839	4	31	80	0.3875000
NODE_5644_length_1057_cov_7.692067	759	839	5	17	80	0.2125000
NODE_5645_length_1057_cov_6.697286	561	641	0	80	80	1.0000000
NODE_5645_length_1057_cov_6.697286	614	694	0	80	80	1.0000000
NODE_5654_length_1056_cov_57.539185	462	542	20	15	80	0.1875000
NODE_5654_length_1056_cov_57.539185	462	542	22	8	80	0.1000000
NODE_5654_length_1056_cov_57.539185	462	542	23	1	80	0.0125000
NODE_5654_length_1056_cov_57.539185	462	542	24	4	80	0.0500000
NODE_5654_length_1056_cov_57.539185	462	542	25	6	80	0.0750000
NODE_5654_length_1056_cov_57.539185	462	542	26	8	80	0.1000000
NODE_5654_length_1056_cov_57.539185	462	542	28	4	80	0.0500000
NODE_5654_length_1056_cov_57.539185	462	542	29	5	80	0.0625000
NODE_5654_length_1056_cov_57.539185	462	542	30	6	80	0.0750000
NODE_5654_length_1056_cov_57.539185	462	542	31	6	80	0.0750000
NODE_5654_length_1056_cov_57.539185	462	542	32	5	80	0.0625000
NODE_5654_length_1056_cov_57.539185	462	542	33	12	80	0.1500000
NODE_5654_length_1056_cov_57.539185	515	595	17	6	80	0.0750000
NODE_5654_length_1056_cov_57.539185	515	595	20	2	80	0.0250000
NODE_5654_length_1056_cov_57.539185	515	595	21	8	80	0.1000000
NODE_5654_length_1056_cov_57.539185	515	595	22	2	80	0.0250000
NODE_5654_length_1056_cov_57.539185	515	595	23	3	80	0.0375000
NODE_5654_length_1056_cov_57.539185	515	595	25	1	80	0.0125000
NODE_5654_length_1056_cov_57.539185	515	595	26	7	80	0.0875000
NODE_5654_length_1056_cov_57.539185	515	595	27	8	80	0.1000000
NODE_5654_length_1056_cov_57.539185	515	595	28	1	80	0.0125000
NODE_5654_length_1056_cov_57.539185	515	595	30	6	80	0.0750000
NODE_5654_length_1056_cov_57.539185	515	595	31	6	80	0.0750000
NODE_5654_length_1056_cov_57.539185	515	595	32	13	80	0.1625000
NODE_5654_length_1056_cov_57.539185	515	595	33	17	80	0.2125000
NODE_5655_length_1056_cov_35.751306	421	501	5	4	80	0.0500000
NODE_5655_length_1056_cov_35.751306	421	501	7	27	80	0.3375000
NODE_5655_length_1056_cov_35.751306	421	501	8	30	80	0.3750000
NODE_5655_length_1056_cov_35.751306	421	501	10	7	80	0.0875000
NODE_5655_length_1056_cov_35.751306	421	501	11	7	80	0.0875000
NODE_5655_length_1056_cov_35.751306	421	501	12	3	80	0.0375000
NODE_5655_length_1056_cov_35.751306	421	501	13	2	80	0.0250000
NODE_5655_length_1056_cov_35.751306	474	554	8	8	80	0.1000000
NODE_5655_length_1056_cov_35.751306	474	554	10	21	80	0.2625000
NODE_5655_length_1056_cov_35.751306	474	554	11	9	80	0.1125000
NODE_5655_length_1056_cov_35.751306	474	554	12	40	80	0.5000000
NODE_5655_length_1056_cov_35.751306	474	554	13	2	80	0.0250000
NODE_5656_length_1056_cov_29.749216	415	490	0	75	75	1.0000000
NODE_5656_length_1056_cov_29.749216	416	495	0	79	79	1.0000000
NODE_5656_length_1056_cov_29.749216	448	495	0	47	47	1.0000000
NODE_5656_length_1056_cov_29.749216	468	548	0	80	80	1.0000000
NODE_5656_length_1056_cov_29.749216	468	548	0	80	80	1.0000000
NODE_5656_length_1056_cov_29.749216	468	548	0	80	80	1.0000000
NODE_5657_length_1056_cov_25.342738	297	377	2	34	80	0.4250000
NODE_5657_length_1056_cov_25.342738	297	377	3	46	80	0.5750000
NODE_5657_length_1056_cov_25.342738	350	430	1	15	80	0.1875000
NODE_5657_length_1056_cov_25.342738	350	430	2	29	80	0.3625000
NODE_5657_length_1056_cov_25.342738	350	430	3	36	80	0.4500000
NODE_5657_length_1056_cov_25.342738	426	506	1	8	80	0.1000000
NODE_5657_length_1056_cov_25.342738	426	506	2	55	80	0.6875000
NODE_5657_length_1056_cov_25.342738	426	506	3	17	80	0.2125000
NODE_5657_length_1056_cov_25.342738	479	559	1	8	80	0.1000000
NODE_5657_length_1056_cov_25.342738	479	559	2	6	80	0.0750000
NODE_5657_length_1056_cov_25.342738	479	559	3	66	80	0.8250000
NODE_5658_length_1056_cov_24.094044	535	615	6	1	80	0.0125000
NODE_5658_length_1056_cov_24.094044	535	615	7	5	80	0.0625000
NODE_5658_length_1056_cov_24.094044	535	615	8	18	80	0.2250000
NODE_5658_length_1056_cov_24.094044	535	615	9	33	80	0.4125000
NODE_5658_length_1056_cov_24.094044	535	615	10	23	80	0.2875000
NODE_5658_length_1056_cov_24.094044	588	668	5	31	80	0.3875000
NODE_5658_length_1056_cov_24.094044	588	668	6	8	80	0.1000000
NODE_5658_length_1056_cov_24.094044	588	668	7	4	80	0.0500000
NODE_5658_length_1056_cov_24.094044	588	668	8	1	80	0.0125000
NODE_5658_length_1056_cov_24.094044	588	668	9	13	80	0.1625000
NODE_5658_length_1056_cov_24.094044	588	668	10	23	80	0.2875000
NODE_5659_length_1056_cov_20.700104	570	650	5	41	80	0.5125000
NODE_5659_length_1056_cov_20.700104	570	650	7	11	80	0.1375000
NODE_5659_length_1056_cov_20.700104	570	650	8	28	80	0.3500000
NODE_5659_length_1056_cov_20.700104	623	703	5	14	80	0.1750000
NODE_5659_length_1056_cov_20.700104	623	703	7	6	80	0.0750000
NODE_5659_length_1056_cov_20.700104	623	703	8	47	80	0.5875000
NODE_5659_length_1056_cov_20.700104	623	703	9	13	80	0.1625000
NODE_5660_length_1056_cov_14.215256	349	429	0	51	80	0.6375000
NODE_5660_length_1056_cov_14.215256	349	429	1	29	80	0.3625000
NODE_5660_length_1056_cov_14.215256	402	482	1	28	80	0.3500000
NODE_5660_length_1056_cov_14.215256	402	482	3	52	80	0.6500000
NODE_5660_length_1056_cov_14.215256	478	558	3	5	80	0.0625000
NODE_5660_length_1056_cov_14.215256	478	558	4	10	80	0.1250000
NODE_5660_length_1056_cov_14.215256	478	558	5	8	80	0.1000000
NODE_5660_length_1056_cov_14.215256	478	558	6	57	80	0.7125000
NODE_5660_length_1056_cov_14.215256	531	611	3	6	80	0.0750000
NODE_5660_length_1056_cov_14.215256	531	611	5	49	80	0.6125000
NODE_5660_length_1056_cov_14.215256	531	611	6	19	80	0.2375000
NODE_5660_length_1056_cov_14.215256	531	611	7	6	80	0.0750000
NODE_5661_length_1056_cov_13.782654	563	643	1	80	80	1.0000000
NODE_5661_length_1056_cov_13.782654	616	696	1	80	80	1.0000000
NODE_5663_length_1056_cov_9.298851	373	453	6	18	80	0.2250000
NODE_5663_length_1056_cov_9.298851	373	453	7	49	80	0.6125000
NODE_5663_length_1056_cov_9.298851	373	453	8	13	80	0.1625000
NODE_5663_length_1056_cov_9.298851	426	503	3	7	77	0.0909091
NODE_5663_length_1056_cov_9.298851	426	503	4	14	77	0.1818182
NODE_5663_length_1056_cov_9.298851	426	503	5	14	77	0.1818182
NODE_5663_length_1056_cov_9.298851	426	503	6	9	77	0.1168831
NODE_5663_length_1056_cov_9.298851	426	503	7	33	77	0.4285714
NODE_5665_length_1056_cov_6.157785	396	476	0	80	80	1.0000000
NODE_5665_length_1056_cov_6.157785	449	529	0	64	80	0.8000000
NODE_5665_length_1056_cov_6.157785	449	529	2	16	80	0.2000000
NODE_5666_length_1056_cov_6.034483	287	367	0	46	80	0.5750000
NODE_5666_length_1056_cov_6.034483	287	367	1	30	80	0.3750000
NODE_5666_length_1056_cov_6.034483	287	367	2	4	80	0.0500000
NODE_5666_length_1056_cov_6.034483	340	420	1	23	80	0.2875000
NODE_5666_length_1056_cov_6.034483	340	420	2	57	80	0.7125000
NODE_5667_length_1056_cov_3.259143	371	410	2	7	39	0.1794872
NODE_5667_length_1056_cov_3.259143	371	410	3	30	39	0.7692308
NODE_5667_length_1056_cov_3.259143	371	410	4	2	39	0.0512821
NODE_5667_length_1056_cov_3.259143	424	463	4	32	39	0.8205128
NODE_5667_length_1056_cov_3.259143	424	463	5	5	39	0.1282051
NODE_5667_length_1056_cov_3.259143	424	463	6	2	39	0.0512821
NODE_5668_length_1056_cov_2.362591	234	314	0	80	80	1.0000000
NODE_5672_length_1055_cov_36.460251	468	548	3	51	80	0.6375000
NODE_5672_length_1055_cov_36.460251	468	548	4	14	80	0.1750000
NODE_5672_length_1055_cov_36.460251	468	548	5	15	80	0.1875000
NODE_5672_length_1055_cov_36.460251	521	601	3	12	80	0.1500000
NODE_5672_length_1055_cov_36.460251	521	601	5	25	80	0.3125000
NODE_5672_length_1055_cov_36.460251	521	601	7	43	80	0.5375000
NODE_5673_length_1055_cov_31.235356	502	582	10	15	80	0.1875000
NODE_5673_length_1055_cov_31.235356	502	582	11	36	80	0.4500000
NODE_5673_length_1055_cov_31.235356	502	582	12	5	80	0.0625000
NODE_5673_length_1055_cov_31.235356	502	582	13	1	80	0.0125000
NODE_5673_length_1055_cov_31.235356	502	582	14	18	80	0.2250000
NODE_5673_length_1055_cov_31.235356	502	582	15	5	80	0.0625000
NODE_5673_length_1055_cov_31.235356	555	635	7	9	80	0.1125000
NODE_5673_length_1055_cov_31.235356	555	635	8	19	80	0.2375000
NODE_5673_length_1055_cov_31.235356	555	635	9	8	80	0.1000000
NODE_5673_length_1055_cov_31.235356	555	635	10	2	80	0.0250000
NODE_5673_length_1055_cov_31.235356	555	635	11	11	80	0.1375000
NODE_5673_length_1055_cov_31.235356	555	635	12	3	80	0.0375000
NODE_5673_length_1055_cov_31.235356	555	635	13	1	80	0.0125000
NODE_5673_length_1055_cov_31.235356	555	635	14	22	80	0.2750000
NODE_5673_length_1055_cov_31.235356	555	635	15	5	80	0.0625000
NODE_5674_length_1055_cov_23.330544	403	483	1	56	80	0.7000000
NODE_5674_length_1055_cov_23.330544	403	483	2	24	80	0.3000000
NODE_5674_length_1055_cov_23.330544	456	536	1	3	80	0.0375000
NODE_5674_length_1055_cov_23.330544	456	536	2	47	80	0.5875000
NODE_5674_length_1055_cov_23.330544	456	536	3	28	80	0.3500000
NODE_5674_length_1055_cov_23.330544	456	536	4	2	80	0.0250000
NODE_5674_length_1055_cov_23.330544	532	612	3	17	80	0.2125000
NODE_5674_length_1055_cov_23.330544	532	612	4	18	80	0.2250000
NODE_5674_length_1055_cov_23.330544	532	612	5	45	80	0.5625000
NODE_5674_length_1055_cov_23.330544	585	665	4	3	80	0.0375000
NODE_5674_length_1055_cov_23.330544	585	665	5	24	80	0.3000000
NODE_5674_length_1055_cov_23.330544	585	665	6	14	80	0.1750000
NODE_5674_length_1055_cov_23.330544	585	665	7	39	80	0.4875000
NODE_5675_length_1055_cov_19.541841	321	401	5	8	80	0.1000000
NODE_5675_length_1055_cov_19.541841	321	401	7	1	80	0.0125000
NODE_5675_length_1055_cov_19.541841	321	401	9	7	80	0.0875000
NODE_5675_length_1055_cov_19.541841	321	401	11	24	80	0.3000000
NODE_5675_length_1055_cov_19.541841	321	401	12	40	80	0.5000000
NODE_5675_length_1055_cov_19.541841	374	454	4	15	80	0.1875000
NODE_5675_length_1055_cov_19.541841	374	454	5	24	80	0.3000000
NODE_5675_length_1055_cov_19.541841	374	454	7	3	80	0.0375000
NODE_5675_length_1055_cov_19.541841	374	454	9	1	80	0.0125000
NODE_5675_length_1055_cov_19.541841	374	454	10	9	80	0.1125000
NODE_5675_length_1055_cov_19.541841	374	454	12	28	80	0.3500000
NODE_5676_length_1055_cov_15.744770	525	605	1	2	80	0.0250000
NODE_5676_length_1055_cov_15.744770	525	605	2	78	80	0.9750000
NODE_5676_length_1055_cov_15.744770	578	658	1	54	80	0.6750000
NODE_5676_length_1055_cov_15.744770	578	658	2	26	80	0.3250000
NODE_5677_length_1055_cov_10.729079	335	415	7	23	80	0.2875000
NODE_5677_length_1055_cov_10.729079	335	415	8	28	80	0.3500000
NODE_5677_length_1055_cov_10.729079	335	415	9	2	80	0.0250000
NODE_5677_length_1055_cov_10.729079	335	415	10	27	80	0.3375000
NODE_5677_length_1055_cov_10.729079	388	468	4	8	80	0.1000000
NODE_5677_length_1055_cov_10.729079	388	468	5	15	80	0.1875000
NODE_5677_length_1055_cov_10.729079	388	468	6	16	80	0.2000000
NODE_5677_length_1055_cov_10.729079	388	468	7	25	80	0.3125000
NODE_5677_length_1055_cov_10.729079	388	468	8	16	80	0.2000000
NODE_5678_length_1055_cov_7.525105	575	655	3	15	80	0.1875000
NODE_5678_length_1055_cov_7.525105	575	655	4	15	80	0.1875000
NODE_5678_length_1055_cov_7.525105	575	655	5	15	80	0.1875000
NODE_5678_length_1055_cov_7.525105	575	655	6	13	80	0.1625000
NODE_5678_length_1055_cov_7.525105	575	655	7	22	80	0.2750000
NODE_5678_length_1055_cov_7.525105	628	708	4	13	80	0.1625000
NODE_5678_length_1055_cov_7.525105	628	708	5	20	80	0.2500000
NODE_5678_length_1055_cov_7.525105	628	708	6	32	80	0.4000000
NODE_5678_length_1055_cov_7.525105	628	708	7	15	80	0.1875000
NODE_5688_length_1054_cov_45.920419	371	451	5	6	80	0.0750000
NODE_5688_length_1054_cov_45.920419	371	451	6	3	80	0.0375000
NODE_5688_length_1054_cov_45.920419	371	451	8	13	80	0.1625000
NODE_5688_length_1054_cov_45.920419	371	451	9	7	80	0.0875000
NODE_5688_length_1054_cov_45.920419	371	451	11	23	80	0.2875000
NODE_5688_length_1054_cov_45.920419	371	451	12	6	80	0.0750000
NODE_5688_length_1054_cov_45.920419	371	451	13	15	80	0.1875000
NODE_5688_length_1054_cov_45.920419	371	451	14	7	80	0.0875000
NODE_5688_length_1054_cov_45.920419	424	505	8	14	81	0.1728395
NODE_5688_length_1054_cov_45.920419	424	505	10	22	81	0.2716049
NODE_5688_length_1054_cov_45.920419	424	505	11	29	81	0.3580247
NODE_5688_length_1054_cov_45.920419	424	505	12	12	81	0.1481481
NODE_5688_length_1054_cov_45.920419	424	505	13	4	81	0.0493827
NODE_5689_length_1054_cov_30.545550	499	578	5	37	79	0.4683544
NODE_5689_length_1054_cov_30.545550	499	578	6	42	79	0.5316456
NODE_5689_length_1054_cov_30.545550	552	631	1	7	79	0.0886076
NODE_5689_length_1054_cov_30.545550	552	631	2	7	79	0.0886076
NODE_5689_length_1054_cov_30.545550	552	631	3	26	79	0.3291139
NODE_5689_length_1054_cov_30.545550	552	631	4	10	79	0.1265823
NODE_5689_length_1054_cov_30.545550	552	631	5	29	79	0.3670886
NODE_5689_length_1054_cov_30.545550	627	707	1	20	80	0.2500000
NODE_5689_length_1054_cov_30.545550	627	707	2	7	80	0.0875000
NODE_5689_length_1054_cov_30.545550	627	707	3	17	80	0.2125000
NODE_5689_length_1054_cov_30.545550	627	707	5	36	80	0.4500000
NODE_5689_length_1054_cov_30.545550	680	760	5	80	80	1.0000000
NODE_5690_length_1054_cov_16.606283	347	427	4	9	80	0.1125000
NODE_5690_length_1054_cov_16.606283	347	427	5	63	80	0.7875000
NODE_5690_length_1054_cov_16.606283	347	427	6	8	80	0.1000000
NODE_5690_length_1054_cov_16.606283	400	480	3	11	80	0.1375000
NODE_5690_length_1054_cov_16.606283	400	480	4	21	80	0.2625000
NODE_5690_length_1054_cov_16.606283	400	480	5	35	80	0.4375000
NODE_5690_length_1054_cov_16.606283	400	480	6	13	80	0.1625000
NODE_5691_length_1054_cov_11.637696	244	316	0	21	72	0.2916667
NODE_5691_length_1054_cov_11.637696	244	316	1	36	72	0.5000000
NODE_5691_length_1054_cov_11.637696	244	316	2	15	72	0.2083333
NODE_5691_length_1054_cov_11.637696	312	392	2	7	80	0.0875000
NODE_5691_length_1054_cov_11.637696	312	392	3	55	80	0.6875000
NODE_5691_length_1054_cov_11.637696	312	392	4	18	80	0.2250000
NODE_5691_length_1054_cov_11.637696	365	445	3	9	80	0.1125000
NODE_5691_length_1054_cov_11.637696	365	445	4	68	80	0.8500000
NODE_5691_length_1054_cov_11.637696	365	445	5	3	80	0.0375000
NODE_5692_length_1054_cov_10.381152	493	573	0	80	80	1.0000000
NODE_5692_length_1054_cov_10.381152	546	626	0	80	80	1.0000000
NODE_5703_length_1053_cov_57.660377	445	527	6	22	82	0.2682927
NODE_5703_length_1053_cov_57.660377	445	527	7	46	82	0.5609756
NODE_5703_length_1053_cov_57.660377	445	527	8	14	82	0.1707317
NODE_5703_length_1053_cov_57.660377	500	580	5	24	80	0.3000000
NODE_5703_length_1053_cov_57.660377	500	580	6	50	80	0.6250000
NODE_5703_length_1053_cov_57.660377	500	580	8	6	80	0.0750000
NODE_5704_length_1053_cov_33.518868	329	409	3	3	80	0.0375000
NODE_5704_length_1053_cov_33.518868	329	409	4	67	80	0.8375000
NODE_5704_length_1053_cov_33.518868	329	409	6	10	80	0.1250000
NODE_5704_length_1053_cov_33.518868	382	462	3	56	80	0.7000000
NODE_5704_length_1053_cov_33.518868	382	462	4	24	80	0.3000000
NODE_5704_length_1053_cov_33.518868	458	538	0	47	80	0.5875000
NODE_5704_length_1053_cov_33.518868	458	538	1	2	80	0.0250000
NODE_5704_length_1053_cov_33.518868	458	538	2	18	80	0.2250000
NODE_5704_length_1053_cov_33.518868	458	538	3	13	80	0.1625000
NODE_5704_length_1053_cov_33.518868	511	591	0	13	80	0.1625000
NODE_5704_length_1053_cov_33.518868	511	591	1	2	80	0.0250000
NODE_5704_length_1053_cov_33.518868	511	591	2	65	80	0.8125000
NODE_5705_length_1053_cov_32.412998	375	455	2	3	80	0.0375000
NODE_5705_length_1053_cov_32.412998	375	455	4	54	80	0.6750000
NODE_5705_length_1053_cov_32.412998	375	455	5	23	80	0.2875000
NODE_5705_length_1053_cov_32.412998	428	508	2	3	80	0.0375000
NODE_5705_length_1053_cov_32.412998	428	508	4	66	80	0.8250000
NODE_5705_length_1053_cov_32.412998	428	508	5	11	80	0.1375000
NODE_5705_length_1053_cov_32.412998	504	584	4	8	80	0.1000000
NODE_5705_length_1053_cov_32.412998	504	584	5	45	80	0.5625000
NODE_5705_length_1053_cov_32.412998	504	584	7	27	80	0.3375000
NODE_5705_length_1053_cov_32.412998	557	637	2	34	80	0.4250000
NODE_5705_length_1053_cov_32.412998	557	637	4	25	80	0.3125000
NODE_5705_length_1053_cov_32.412998	557	637	5	21	80	0.2625000
NODE_5706_length_1053_cov_26.545073	456	536	4	2	80	0.0250000
NODE_5706_length_1053_cov_26.545073	456	536	5	37	80	0.4625000
NODE_5706_length_1053_cov_26.545073	456	536	6	5	80	0.0625000
NODE_5706_length_1053_cov_26.545073	456	536	7	8	80	0.1000000
NODE_5706_length_1053_cov_26.545073	456	536	8	28	80	0.3500000
NODE_5706_length_1053_cov_26.545073	509	589	6	2	80	0.0250000
NODE_5706_length_1053_cov_26.545073	509	589	7	29	80	0.3625000
NODE_5706_length_1053_cov_26.545073	509	589	8	47	80	0.5875000
NODE_5706_length_1053_cov_26.545073	509	589	9	2	80	0.0250000
NODE_5706_length_1053_cov_26.545073	585	665	3	6	80	0.0750000
NODE_5706_length_1053_cov_26.545073	585	665	4	16	80	0.2000000
NODE_5706_length_1053_cov_26.545073	585	665	5	13	80	0.1625000
NODE_5706_length_1053_cov_26.545073	585	665	6	24	80	0.3000000
NODE_5706_length_1053_cov_26.545073	585	665	7	21	80	0.2625000
NODE_5706_length_1053_cov_26.545073	638	718	1	1	80	0.0125000
NODE_5706_length_1053_cov_26.545073	638	718	2	15	80	0.1875000
NODE_5706_length_1053_cov_26.545073	638	718	3	14	80	0.1750000
NODE_5706_length_1053_cov_26.545073	638	718	4	45	80	0.5625000
NODE_5706_length_1053_cov_26.545073	638	718	5	5	80	0.0625000
NODE_5707_length_1053_cov_20.346960	543	623	5	15	80	0.1875000
NODE_5707_length_1053_cov_20.346960	543	623	6	37	80	0.4625000
NODE_5707_length_1053_cov_20.346960	543	623	8	28	80	0.3500000
NODE_5707_length_1053_cov_20.346960	596	677	4	4	81	0.0493827
NODE_5707_length_1053_cov_20.346960	596	677	5	11	81	0.1358025
NODE_5707_length_1053_cov_20.346960	596	677	6	66	81	0.8148148
NODE_5708_length_1053_cov_11.655136	393	473	0	32	80	0.4000000
NODE_5708_length_1053_cov_11.655136	393	473	1	48	80	0.6000000
NODE_5708_length_1053_cov_11.655136	446	526	0	80	80	1.0000000
NODE_5710_length_1053_cov_4.771488	84	149	0	65	65	1.0000000
NODE_5718_length_1052_cov_18.469045	448	528	4	41	80	0.5125000
NODE_5718_length_1052_cov_18.469045	448	528	5	1	80	0.0125000
NODE_5718_length_1052_cov_18.469045	448	528	7	26	80	0.3250000
NODE_5718_length_1052_cov_18.469045	448	528	8	9	80	0.1125000
NODE_5718_length_1052_cov_18.469045	448	528	9	3	80	0.0375000
NODE_5718_length_1052_cov_18.469045	501	581	7	17	80	0.2125000
NODE_5718_length_1052_cov_18.469045	501	581	8	9	80	0.1125000
NODE_5718_length_1052_cov_18.469045	501	581	9	14	80	0.1750000
NODE_5718_length_1052_cov_18.469045	501	581	10	40	80	0.5000000
NODE_5719_length_1052_cov_13.136411	425	505	2	80	80	1.0000000
NODE_5719_length_1052_cov_13.136411	478	558	1	36	80	0.4500000
NODE_5719_length_1052_cov_13.136411	478	558	2	44	80	0.5500000
NODE_5722_length_1052_cov_3.082896	607	687	0	80	80	1.0000000
NODE_5722_length_1052_cov_3.082896	660	740	0	80	80	1.0000000
NODE_5729_length_1051_cov_34.868697	472	552	3	46	80	0.5750000
NODE_5729_length_1051_cov_34.868697	472	552	4	15	80	0.1875000
NODE_5729_length_1051_cov_34.868697	472	552	5	19	80	0.2375000
NODE_5729_length_1051_cov_34.868697	525	605	3	19	80	0.2375000
NODE_5729_length_1051_cov_34.868697	525	605	4	57	80	0.7125000
NODE_5729_length_1051_cov_34.868697	525	605	5	4	80	0.0500000
NODE_5730_length_1051_cov_19.446429	549	629	2	15	80	0.1875000
NODE_5730_length_1051_cov_19.446429	549	629	4	40	80	0.5000000
NODE_5730_length_1051_cov_19.446429	549	629	6	25	80	0.3125000
NODE_5730_length_1051_cov_19.446429	602	682	4	54	80	0.6750000
NODE_5730_length_1051_cov_19.446429	602	682	6	26	80	0.3250000
NODE_5731_length_1051_cov_4.022059	600	680	1	80	80	1.0000000
NODE_5736_length_1050_cov_31.556257	429	509	2	80	80	1.0000000
NODE_5736_length_1050_cov_31.556257	482	562	1	25	80	0.3125000
NODE_5736_length_1050_cov_31.556257	482	562	2	35	80	0.4375000
NODE_5736_length_1050_cov_31.556257	482	562	3	20	80	0.2500000
NODE_5736_length_1050_cov_31.556257	558	638	1	5	80	0.0625000
NODE_5736_length_1050_cov_31.556257	558	638	2	75	80	0.9375000
NODE_5736_length_1050_cov_31.556257	611	691	1	48	80	0.6000000
NODE_5736_length_1050_cov_31.556257	611	691	2	32	80	0.4000000
NODE_5737_length_1050_cov_16.337539	398	478	3	63	80	0.7875000
NODE_5737_length_1050_cov_16.337539	398	478	4	17	80	0.2125000
NODE_5737_length_1050_cov_16.337539	451	531	2	19	80	0.2375000
NODE_5737_length_1050_cov_16.337539	451	531	3	61	80	0.7625000
NODE_5738_length_1050_cov_13.290221	507	587	6	12	80	0.1500000
NODE_5738_length_1050_cov_13.290221	507	587	8	29	80	0.3625000
NODE_5738_length_1050_cov_13.290221	507	587	9	39	80	0.4875000
NODE_5738_length_1050_cov_13.290221	560	640	4	3	80	0.0375000
NODE_5738_length_1050_cov_13.290221	560	640	5	15	80	0.1875000
NODE_5738_length_1050_cov_13.290221	560	640	6	1	80	0.0125000
NODE_5738_length_1050_cov_13.290221	560	640	7	6	80	0.0750000
NODE_5738_length_1050_cov_13.290221	560	640	8	7	80	0.0875000
NODE_5738_length_1050_cov_13.290221	560	640	9	48	80	0.6000000
NODE_5739_length_1050_cov_11.389064	532	612	1	80	80	1.0000000
NODE_5739_length_1050_cov_11.389064	585	665	1	80	80	1.0000000
NODE_5740_length_1050_cov_11.091483	259	321	4	49	62	0.7903226
NODE_5740_length_1050_cov_11.091483	259	321	6	13	62	0.2096774
NODE_5740_length_1050_cov_11.091483	294	374	2	21	80	0.2625000
NODE_5740_length_1050_cov_11.091483	294	374	4	46	80	0.5750000
NODE_5740_length_1050_cov_11.091483	294	374	6	13	80	0.1625000
NODE_5740_length_1050_cov_11.091483	370	450	0	52	80	0.6500000
NODE_5740_length_1050_cov_11.091483	370	450	2	28	80	0.3500000
NODE_5740_length_1050_cov_11.091483	423	503	0	80	80	1.0000000
NODE_5742_length_1050_cov_2.201893	928	990	0	62	62	1.0000000
NODE_5742_length_1050_cov_2.201893	981	1043	0	62	62	1.0000000
NODE_5748_length_1050_cov_1.241851	935	990	2	55	55	1.0000000
NODE_5748_length_1050_cov_1.241851	956	1036	2	80	80	1.0000000
NODE_5752_length_1049_cov_28.174737	446	526	9	1	80	0.0125000
NODE_5752_length_1049_cov_28.174737	446	526	11	32	80	0.4000000
NODE_5752_length_1049_cov_28.174737	446	526	13	6	80	0.0750000
NODE_5752_length_1049_cov_28.174737	446	526	14	4	80	0.0500000
NODE_5752_length_1049_cov_28.174737	446	526	15	1	80	0.0125000
NODE_5752_length_1049_cov_28.174737	446	526	16	15	80	0.1875000
NODE_5752_length_1049_cov_28.174737	446	526	17	21	80	0.2625000
NODE_5752_length_1049_cov_28.174737	499	579	8	4	80	0.0500000
NODE_5752_length_1049_cov_28.174737	499	579	11	6	80	0.0750000
NODE_5752_length_1049_cov_28.174737	499	579	12	7	80	0.0875000
NODE_5752_length_1049_cov_28.174737	499	579	13	11	80	0.1375000
NODE_5752_length_1049_cov_28.174737	499	579	15	8	80	0.1000000
NODE_5752_length_1049_cov_28.174737	499	579	16	15	80	0.1875000
NODE_5752_length_1049_cov_28.174737	499	579	17	29	80	0.3625000
NODE_5753_length_1049_cov_23.186316	389	469	0	19	80	0.2375000
NODE_5753_length_1049_cov_23.186316	389	469	1	30	80	0.3750000
NODE_5753_length_1049_cov_23.186316	389	469	3	9	80	0.1125000
NODE_5753_length_1049_cov_23.186316	389	469	4	22	80	0.2750000
NODE_5753_length_1049_cov_23.186316	442	522	3	5	80	0.0625000
NODE_5753_length_1049_cov_23.186316	442	522	4	75	80	0.9375000
NODE_5753_length_1049_cov_23.186316	518	595	3	22	77	0.2857143
NODE_5753_length_1049_cov_23.186316	518	595	4	38	77	0.4935065
NODE_5753_length_1049_cov_23.186316	518	595	5	1	77	0.0129870
NODE_5753_length_1049_cov_23.186316	518	595	6	9	77	0.1168831
NODE_5753_length_1049_cov_23.186316	518	595	8	7	77	0.0909091
NODE_5753_length_1049_cov_23.186316	568	648	3	7	80	0.0875000
NODE_5753_length_1049_cov_23.186316	568	648	4	3	80	0.0375000
NODE_5753_length_1049_cov_23.186316	568	648	5	10	80	0.1250000
NODE_5753_length_1049_cov_23.186316	568	648	6	53	80	0.6625000
NODE_5753_length_1049_cov_23.186316	568	648	8	7	80	0.0875000
NODE_5754_length_1049_cov_21.097895	532	612	3	25	80	0.3125000
NODE_5754_length_1049_cov_21.097895	532	612	4	28	80	0.3500000
NODE_5754_length_1049_cov_21.097895	532	612	5	2	80	0.0250000
NODE_5754_length_1049_cov_21.097895	532	612	6	13	80	0.1625000
NODE_5754_length_1049_cov_21.097895	532	612	7	12	80	0.1500000
NODE_5754_length_1049_cov_21.097895	585	665	5	12	80	0.1500000
NODE_5754_length_1049_cov_21.097895	585	665	6	16	80	0.2000000
NODE_5754_length_1049_cov_21.097895	585	665	7	52	80	0.6500000
NODE_5755_length_1049_cov_18.964211	375	466	3	48	91	0.5274726
NODE_5755_length_1049_cov_18.964211	375	466	6	43	91	0.4725275
NODE_5755_length_1049_cov_18.964211	439	519	3	50	80	0.6250000
NODE_5755_length_1049_cov_18.964211	439	519	6	30	80	0.3750000
NODE_5755_length_1049_cov_18.964211	515	595	0	31	80	0.3875000
NODE_5755_length_1049_cov_18.964211	515	595	3	49	80	0.6125000
NODE_5755_length_1049_cov_18.964211	568	648	0	80	80	1.0000000
NODE_5756_length_1049_cov_18.075789	437	517	0	80	80	1.0000000
NODE_5756_length_1049_cov_18.075789	490	570	0	80	80	1.0000000
NODE_5756_length_1049_cov_18.075789	566	644	0	78	78	1.0000000
NODE_5756_length_1049_cov_18.075789	620	695	0	75	75	1.0000000
NODE_5757_length_1049_cov_16.194737	569	650	7	42	81	0.5185185
NODE_5757_length_1049_cov_16.194737	569	650	8	23	81	0.2839506
NODE_5757_length_1049_cov_16.194737	569	650	9	16	81	0.1975309
NODE_5757_length_1049_cov_16.194737	623	703	2	3	80	0.0375000
NODE_5757_length_1049_cov_16.194737	623	703	3	25	80	0.3125000
NODE_5757_length_1049_cov_16.194737	623	703	4	2	80	0.0250000
NODE_5757_length_1049_cov_16.194737	623	703	5	15	80	0.1875000
NODE_5757_length_1049_cov_16.194737	623	703	8	11	80	0.1375000
NODE_5757_length_1049_cov_16.194737	623	703	9	24	80	0.3000000
NODE_5757_length_1049_cov_16.194737	699	779	2	57	80	0.7125000
NODE_5757_length_1049_cov_16.194737	699	779	3	19	80	0.2375000
NODE_5757_length_1049_cov_16.194737	699	779	4	4	80	0.0500000
NODE_5757_length_1049_cov_16.194737	752	832	2	53	80	0.6625000
NODE_5757_length_1049_cov_16.194737	752	832	3	23	80	0.2875000
NODE_5757_length_1049_cov_16.194737	752	832	4	4	80	0.0500000
NODE_5759_length_1049_cov_6.323158	588	668	0	32	80	0.4000000
NODE_5759_length_1049_cov_6.323158	588	668	1	48	80	0.6000000
NODE_5759_length_1049_cov_6.323158	641	721	0	80	80	1.0000000
NODE_5770_length_1048_cov_73.887250	535	615	9	4	80	0.0500000
NODE_5770_length_1048_cov_73.887250	535	615	10	1	80	0.0125000
NODE_5770_length_1048_cov_73.887250	535	615	11	14	80	0.1750000
NODE_5770_length_1048_cov_73.887250	535	615	12	61	80	0.7625000
NODE_5770_length_1048_cov_73.887250	588	668	9	4	80	0.0500000
NODE_5770_length_1048_cov_73.887250	588	668	11	37	80	0.4625000
NODE_5770_length_1048_cov_73.887250	588	668	12	34	80	0.4250000
NODE_5770_length_1048_cov_73.887250	588	668	13	5	80	0.0625000
NODE_5770_length_1048_cov_73.887250	664	744	5	15	80	0.1875000
NODE_5770_length_1048_cov_73.887250	664	744	6	26	80	0.3250000
NODE_5770_length_1048_cov_73.887250	664	744	7	3	80	0.0375000
NODE_5770_length_1048_cov_73.887250	664	744	8	23	80	0.2875000
NODE_5770_length_1048_cov_73.887250	664	744	10	2	80	0.0250000
NODE_5770_length_1048_cov_73.887250	664	744	11	10	80	0.1250000
NODE_5770_length_1048_cov_73.887250	664	744	13	1	80	0.0125000
NODE_5770_length_1048_cov_73.887250	717	797	3	15	80	0.1875000
NODE_5770_length_1048_cov_73.887250	717	797	4	8	80	0.1000000
NODE_5770_length_1048_cov_73.887250	717	797	5	12	80	0.1500000
NODE_5770_length_1048_cov_73.887250	717	797	6	45	80	0.5625000
NODE_5770_length_1048_cov_73.887250	899	979	0	80	80	1.0000000
NODE_5771_length_1048_cov_48.242360	407	487	2	1	80	0.0125000
NODE_5771_length_1048_cov_48.242360	407	487	3	32	80	0.4000000
NODE_5771_length_1048_cov_48.242360	407	487	4	13	80	0.1625000
NODE_5771_length_1048_cov_48.242360	407	487	6	32	80	0.4000000
NODE_5771_length_1048_cov_48.242360	407	487	7	2	80	0.0250000
NODE_5771_length_1048_cov_48.242360	460	540	5	8	80	0.1000000
NODE_5771_length_1048_cov_48.242360	460	540	6	66	80	0.8250000
NODE_5771_length_1048_cov_48.242360	460	540	7	6	80	0.0750000
NODE_5771_length_1048_cov_48.242360	536	616	4	27	80	0.3375000
NODE_5771_length_1048_cov_48.242360	536	616	5	28	80	0.3500000
NODE_5771_length_1048_cov_48.242360	536	616	6	16	80	0.2000000
NODE_5771_length_1048_cov_48.242360	536	616	7	9	80	0.1125000
NODE_5771_length_1048_cov_48.242360	589	669	4	1	80	0.0125000
NODE_5771_length_1048_cov_48.242360	589	669	5	9	80	0.1125000
NODE_5771_length_1048_cov_48.242360	589	669	6	8	80	0.1000000
NODE_5771_length_1048_cov_48.242360	589	669	7	12	80	0.1500000
NODE_5771_length_1048_cov_48.242360	589	669	8	36	80	0.4500000
NODE_5771_length_1048_cov_48.242360	589	669	9	14	80	0.1750000
NODE_5772_length_1048_cov_38.430980	352	432	1	9	80	0.1125000
NODE_5772_length_1048_cov_38.430980	352	432	3	35	80	0.4375000
NODE_5772_length_1048_cov_38.430980	352	432	4	3	80	0.0375000
NODE_5772_length_1048_cov_38.430980	352	432	5	25	80	0.3125000
NODE_5772_length_1048_cov_38.430980	352	432	6	8	80	0.1000000
NODE_5772_length_1048_cov_38.430980	405	485	4	7	80	0.0875000
NODE_5772_length_1048_cov_38.430980	405	485	5	56	80	0.7000000
NODE_5772_length_1048_cov_38.430980	405	485	6	17	80	0.2125000
NODE_5773_length_1048_cov_28.179136	548	628	0	16	80	0.2000000
NODE_5773_length_1048_cov_28.179136	548	628	2	40	80	0.5000000
NODE_5773_length_1048_cov_28.179136	548	628	4	24	80	0.3000000
NODE_5773_length_1048_cov_28.179136	601	681	2	3	80	0.0375000
NODE_5773_length_1048_cov_28.179136	601	681	4	72	80	0.9000000
NODE_5773_length_1048_cov_28.179136	601	681	6	5	80	0.0625000
NODE_5773_length_1048_cov_28.179136	677	757	2	43	80	0.5375000
NODE_5773_length_1048_cov_28.179136	677	757	4	37	80	0.4625000
NODE_5773_length_1048_cov_28.179136	730	810	0	34	80	0.4250000
NODE_5773_length_1048_cov_28.179136	730	810	2	46	80	0.5750000
NODE_5774_length_1048_cov_22.985248	409	489	1	2	80	0.0250000
NODE_5774_length_1048_cov_22.985248	409	489	3	3	80	0.0375000
NODE_5774_length_1048_cov_22.985248	409	489	4	50	80	0.6250000
NODE_5774_length_1048_cov_22.985248	409	489	5	25	80	0.3125000
NODE_5774_length_1048_cov_22.985248	462	542	2	8	80	0.1000000
NODE_5774_length_1048_cov_22.985248	462	542	3	16	80	0.2000000
NODE_5774_length_1048_cov_22.985248	462	542	4	56	80	0.7000000
NODE_5774_length_1048_cov_22.985248	538	618	2	1	80	0.0125000
NODE_5774_length_1048_cov_22.985248	538	618	3	18	80	0.2250000
NODE_5774_length_1048_cov_22.985248	538	618	4	55	80	0.6875000
NODE_5774_length_1048_cov_22.985248	538	618	5	6	80	0.0750000
NODE_5774_length_1048_cov_22.985248	591	671	4	26	80	0.3250000
NODE_5774_length_1048_cov_22.985248	591	671	5	54	80	0.6750000
NODE_5775_length_1048_cov_17.883035	500	580	1	10	80	0.1250000
NODE_5775_length_1048_cov_17.883035	500	580	3	2	80	0.0250000
NODE_5775_length_1048_cov_17.883035	500	580	5	2	80	0.0250000
NODE_5775_length_1048_cov_17.883035	500	580	6	23	80	0.2875000
NODE_5775_length_1048_cov_17.883035	500	580	7	11	80	0.1375000
NODE_5775_length_1048_cov_17.883035	500	580	8	32	80	0.4000000
NODE_5775_length_1048_cov_17.883035	553	633	3	2	80	0.0250000
NODE_5775_length_1048_cov_17.883035	553	633	4	16	80	0.2000000
NODE_5775_length_1048_cov_17.883035	553	633	6	27	80	0.3375000
NODE_5775_length_1048_cov_17.883035	553	633	8	35	80	0.4375000
NODE_5776_length_1048_cov_17.444679	377	457	0	68	80	0.8500000
NODE_5776_length_1048_cov_17.444679	377	457	1	12	80	0.1500000
NODE_5776_length_1048_cov_17.444679	430	510	0	80	80	1.0000000
NODE_5777_length_1048_cov_13.387777	518	598	1	15	80	0.1875000
NODE_5777_length_1048_cov_13.387777	518	598	2	48	80	0.6000000
NODE_5777_length_1048_cov_13.387777	518	598	3	17	80	0.2125000
NODE_5777_length_1048_cov_13.387777	571	651	1	10	80	0.1250000
NODE_5777_length_1048_cov_13.387777	571	651	2	70	80	0.8750000
NODE_5778_length_1048_cov_12.934668	716	796	3	27	80	0.3375000
NODE_5778_length_1048_cov_12.934668	716	796	4	12	80	0.1500000
NODE_5778_length_1048_cov_12.934668	716	796	6	41	80	0.5125000
NODE_5778_length_1048_cov_12.934668	769	849	4	38	80	0.4750000
NODE_5778_length_1048_cov_12.934668	769	849	6	42	80	0.5250000
NODE_5778_length_1048_cov_12.934668	845	925	4	47	80	0.5875000
NODE_5778_length_1048_cov_12.934668	845	925	6	32	80	0.4000000
NODE_5778_length_1048_cov_12.934668	845	925	8	1	80	0.0125000
NODE_5778_length_1048_cov_12.934668	898	975	4	70	77	0.9090909
NODE_5778_length_1048_cov_12.934668	898	975	6	7	77	0.0909091
NODE_5779_length_1048_cov_12.712329	330	410	1	20	80	0.2500000
NODE_5779_length_1048_cov_12.712329	330	410	2	53	80	0.6625000
NODE_5779_length_1048_cov_12.712329	330	410	3	7	80	0.0875000
NODE_5779_length_1048_cov_12.712329	384	463	1	20	79	0.2531646
NODE_5779_length_1048_cov_12.712329	384	463	2	59	79	0.7468355
NODE_5779_length_1048_cov_12.712329	459	539	2	75	80	0.9375000
NODE_5779_length_1048_cov_12.712329	459	539	3	5	80	0.0625000
NODE_5779_length_1048_cov_12.712329	512	592	1	36	80	0.4500000
NODE_5779_length_1048_cov_12.712329	512	592	2	44	80	0.5500000
NODE_5780_length_1048_cov_9.232877	305	355	2	17	50	0.3400000
NODE_5780_length_1048_cov_9.232877	305	355	3	32	50	0.6400000
NODE_5780_length_1048_cov_9.232877	305	355	4	1	50	0.0200000
NODE_5786_length_1047_cov_79.917722	540	620	17	4	80	0.0500000
NODE_5786_length_1047_cov_79.917722	540	620	18	3	80	0.0375000
NODE_5786_length_1047_cov_79.917722	540	620	19	1	80	0.0125000
NODE_5786_length_1047_cov_79.917722	540	620	20	5	80	0.0625000
NODE_5786_length_1047_cov_79.917722	540	620	21	6	80	0.0750000
NODE_5786_length_1047_cov_79.917722	540	620	22	10	80	0.1250000
NODE_5786_length_1047_cov_79.917722	540	620	23	2	80	0.0250000
NODE_5786_length_1047_cov_79.917722	540	620	24	22	80	0.2750000
NODE_5786_length_1047_cov_79.917722	540	620	25	12	80	0.1500000
NODE_5786_length_1047_cov_79.917722	540	620	26	12	80	0.1500000
NODE_5786_length_1047_cov_79.917722	540	620	27	3	80	0.0375000
NODE_5786_length_1047_cov_79.917722	593	673	7	1	80	0.0125000
NODE_5786_length_1047_cov_79.917722	593	673	9	3	80	0.0375000
NODE_5786_length_1047_cov_79.917722	593	673	11	5	80	0.0625000
NODE_5786_length_1047_cov_79.917722	593	673	13	5	80	0.0625000
NODE_5786_length_1047_cov_79.917722	593	673	19	20	80	0.2500000
NODE_5786_length_1047_cov_79.917722	593	673	20	16	80	0.2000000
NODE_5786_length_1047_cov_79.917722	593	673	21	1	80	0.0125000
NODE_5786_length_1047_cov_79.917722	593	673	22	11	80	0.1375000
NODE_5786_length_1047_cov_79.917722	593	673	23	2	80	0.0250000
NODE_5786_length_1047_cov_79.917722	593	673	24	16	80	0.2000000
NODE_5787_length_1047_cov_28.527426	582	662	6	1	80	0.0125000
NODE_5787_length_1047_cov_28.527426	582	662	7	8	80	0.1000000
NODE_5787_length_1047_cov_28.527426	582	662	8	2	80	0.0250000
NODE_5787_length_1047_cov_28.527426	582	662	9	16	80	0.2000000
NODE_5787_length_1047_cov_28.527426	582	662	10	18	80	0.2250000
NODE_5787_length_1047_cov_28.527426	582	662	11	32	80	0.4000000
NODE_5787_length_1047_cov_28.527426	582	662	12	3	80	0.0375000
NODE_5787_length_1047_cov_28.527426	635	715	7	2	80	0.0250000
NODE_5787_length_1047_cov_28.527426	635	715	8	8	80	0.1000000
NODE_5787_length_1047_cov_28.527426	635	715	9	9	80	0.1125000
NODE_5787_length_1047_cov_28.527426	635	715	11	32	80	0.4000000
NODE_5787_length_1047_cov_28.527426	635	715	12	29	80	0.3625000
NODE_5788_length_1047_cov_26.068565	372	452	7	19	80	0.2375000
NODE_5788_length_1047_cov_26.068565	372	452	8	14	80	0.1750000
NODE_5788_length_1047_cov_26.068565	372	452	9	29	80	0.3625000
NODE_5788_length_1047_cov_26.068565	372	452	10	18	80	0.2250000
NODE_5788_length_1047_cov_26.068565	425	505	3	8	80	0.1000000
NODE_5788_length_1047_cov_26.068565	425	505	5	12	80	0.1500000
NODE_5788_length_1047_cov_26.068565	425	505	6	12	80	0.1500000
NODE_5788_length_1047_cov_26.068565	425	505	8	35	80	0.4375000
NODE_5788_length_1047_cov_26.068565	425	505	10	13	80	0.1625000
NODE_5789_length_1047_cov_25.946203	424	504	0	80	80	1.0000000
NODE_5789_length_1047_cov_25.946203	477	557	0	80	80	1.0000000
NODE_5790_length_1047_cov_19.255274	458	538	4	27	80	0.3375000
NODE_5790_length_1047_cov_19.255274	458	538	6	3	80	0.0375000
NODE_5790_length_1047_cov_19.255274	458	538	7	45	80	0.5625000
NODE_5790_length_1047_cov_19.255274	458	538	8	1	80	0.0125000
NODE_5790_length_1047_cov_19.255274	458	538	9	4	80	0.0500000
NODE_5790_length_1047_cov_19.255274	511	591	4	7	80	0.0875000
NODE_5790_length_1047_cov_19.255274	511	591	5	5	80	0.0625000
NODE_5790_length_1047_cov_19.255274	511	591	7	24	80	0.3000000
NODE_5790_length_1047_cov_19.255274	511	591	8	19	80	0.2375000
NODE_5790_length_1047_cov_19.255274	511	591	9	25	80	0.3125000
NODE_5791_length_1047_cov_16.618143	467	547	2	67	80	0.8375000
NODE_5791_length_1047_cov_16.618143	467	547	3	13	80	0.1625000
NODE_5791_length_1047_cov_16.618143	520	600	1	3	80	0.0375000
NODE_5791_length_1047_cov_16.618143	520	600	2	33	80	0.4125000
NODE_5791_length_1047_cov_16.618143	520	600	3	41	80	0.5125000
NODE_5791_length_1047_cov_16.618143	520	600	4	3	80	0.0375000
NODE_5792_length_1047_cov_14.246835	643	723	0	80	80	1.0000000
NODE_5792_length_1047_cov_14.246835	696	776	0	68	80	0.8500000
NODE_5792_length_1047_cov_14.246835	696	776	1	12	80	0.1500000
NODE_5793_length_1047_cov_9.869198	414	494	4	30	80	0.3750000
NODE_5793_length_1047_cov_9.869198	414	494	5	17	80	0.2125000
NODE_5793_length_1047_cov_9.869198	414	494	6	5	80	0.0625000
NODE_5793_length_1047_cov_9.869198	414	494	8	11	80	0.1375000
NODE_5793_length_1047_cov_9.869198	414	494	10	17	80	0.2125000
NODE_5793_length_1047_cov_9.869198	467	547	6	8	80	0.1000000
NODE_5793_length_1047_cov_9.869198	467	547	8	26	80	0.3250000
NODE_5793_length_1047_cov_9.869198	467	547	10	46	80	0.5750000
NODE_5794_length_1047_cov_8.513713	300	380	1	20	80	0.2500000
NODE_5794_length_1047_cov_8.513713	300	380	2	10	80	0.1250000
NODE_5794_length_1047_cov_8.513713	300	380	4	50	80	0.6250000
NODE_5794_length_1047_cov_8.513713	353	433	4	80	80	1.0000000
NODE_5795_length_1047_cov_7.412447	442	522	0	8	80	0.1000000
NODE_5795_length_1047_cov_7.412447	442	522	1	15	80	0.1875000
NODE_5795_length_1047_cov_7.412447	442	522	2	16	80	0.2000000
NODE_5795_length_1047_cov_7.412447	442	522	3	2	80	0.0250000
NODE_5795_length_1047_cov_7.412447	442	522	5	28	80	0.3500000
NODE_5795_length_1047_cov_7.412447	442	522	6	11	80	0.1375000
NODE_5795_length_1047_cov_7.412447	495	575	4	4	80	0.0500000
NODE_5795_length_1047_cov_7.412447	495	575	5	17	80	0.2125000
NODE_5795_length_1047_cov_7.412447	495	575	6	59	80	0.7375000
NODE_5803_length_1046_cov_41.392819	587	667	4	1	80	0.0125000
NODE_5803_length_1046_cov_41.392819	587	667	5	36	80	0.4500000
NODE_5803_length_1046_cov_41.392819	587	667	6	8	80	0.1000000
NODE_5803_length_1046_cov_41.392819	587	667	7	3	80	0.0375000
NODE_5803_length_1046_cov_41.392819	587	667	8	6	80	0.0750000
NODE_5803_length_1046_cov_41.392819	587	667	10	26	80	0.3250000
NODE_5803_length_1046_cov_41.392819	640	720	8	1	80	0.0125000
NODE_5803_length_1046_cov_41.392819	640	720	10	32	80	0.4000000
NODE_5803_length_1046_cov_41.392819	640	720	11	20	80	0.2500000
NODE_5803_length_1046_cov_41.392819	640	720	12	27	80	0.3375000
NODE_5804_length_1046_cov_30.317846	382	462	8	13	80	0.1625000
NODE_5804_length_1046_cov_30.317846	382	462	10	17	80	0.2125000
NODE_5804_length_1046_cov_30.317846	382	462	11	8	80	0.1000000
NODE_5804_length_1046_cov_30.317846	382	462	12	3	80	0.0375000
NODE_5804_length_1046_cov_30.317846	382	462	13	14	80	0.1750000
NODE_5804_length_1046_cov_30.317846	382	462	14	4	80	0.0500000
NODE_5804_length_1046_cov_30.317846	382	462	15	4	80	0.0500000
NODE_5804_length_1046_cov_30.317846	382	462	17	3	80	0.0375000
NODE_5804_length_1046_cov_30.317846	382	462	18	3	80	0.0375000
NODE_5804_length_1046_cov_30.317846	382	462	19	7	80	0.0875000
NODE_5804_length_1046_cov_30.317846	382	462	20	4	80	0.0500000
NODE_5804_length_1046_cov_30.317846	435	515	13	6	80	0.0750000
NODE_5804_length_1046_cov_30.317846	435	515	15	4	80	0.0500000
NODE_5804_length_1046_cov_30.317846	435	515	16	10	80	0.1250000
NODE_5804_length_1046_cov_30.317846	435	515	17	5	80	0.0625000
NODE_5804_length_1046_cov_30.317846	435	515	18	6	80	0.0750000
NODE_5804_length_1046_cov_30.317846	435	515	19	7	80	0.0875000
NODE_5804_length_1046_cov_30.317846	435	515	20	18	80	0.2250000
NODE_5804_length_1046_cov_30.317846	435	515	21	24	80	0.3000000
NODE_5805_length_1046_cov_28.184794	346	426	2	24	80	0.3000000
NODE_5805_length_1046_cov_28.184794	346	426	4	56	80	0.7000000
NODE_5805_length_1046_cov_28.184794	399	479	0	36	80	0.4500000
NODE_5805_length_1046_cov_28.184794	399	479	2	41	80	0.5125000
NODE_5805_length_1046_cov_28.184794	399	479	4	3	80	0.0375000
NODE_5806_length_1046_cov_24.595565	501	581	4	61	80	0.7625000
NODE_5806_length_1046_cov_24.595565	501	581	5	19	80	0.2375000
NODE_5806_length_1046_cov_24.595565	554	634	3	10	80	0.1250000
NODE_5806_length_1046_cov_24.595565	554	634	4	33	80	0.4125000
NODE_5806_length_1046_cov_24.595565	554	634	5	37	80	0.4625000
NODE_5807_length_1046_cov_17.958817	447	527	1	31	80	0.3875000
NODE_5807_length_1046_cov_17.958817	447	527	2	49	80	0.6125000
NODE_5807_length_1046_cov_17.958817	500	580	2	30	80	0.3750000
NODE_5807_length_1046_cov_17.958817	500	580	3	23	80	0.2875000
NODE_5807_length_1046_cov_17.958817	500	580	4	27	80	0.3375000
NODE_5808_length_1046_cov_15.494192	385	465	4	21	80	0.2625000
NODE_5808_length_1046_cov_15.494192	385	465	5	12	80	0.1500000
NODE_5808_length_1046_cov_15.494192	385	465	6	2	80	0.0250000
NODE_5808_length_1046_cov_15.494192	385	465	7	9	80	0.1125000
NODE_5808_length_1046_cov_15.494192	385	465	8	30	80	0.3750000
NODE_5808_length_1046_cov_15.494192	385	465	9	6	80	0.0750000
NODE_5808_length_1046_cov_15.494192	438	518	8	28	80	0.3500000
NODE_5808_length_1046_cov_15.494192	438	518	9	3	80	0.0375000
NODE_5808_length_1046_cov_15.494192	438	518	10	12	80	0.1500000
NODE_5808_length_1046_cov_15.494192	438	518	11	1	80	0.0125000
NODE_5808_length_1046_cov_15.494192	438	518	12	14	80	0.1750000
NODE_5808_length_1046_cov_15.494192	438	518	13	22	80	0.2750000
NODE_5809_length_1046_cov_12.639916	554	634	3	23	80	0.2875000
NODE_5809_length_1046_cov_12.639916	554	634	5	29	80	0.3625000
NODE_5809_length_1046_cov_12.639916	554	634	6	28	80	0.3500000
NODE_5809_length_1046_cov_12.639916	607	687	2	30	80	0.3750000
NODE_5809_length_1046_cov_12.639916	607	687	3	46	80	0.5750000
NODE_5809_length_1046_cov_12.639916	607	687	5	4	80	0.0500000
NODE_5810_length_1046_cov_11.238648	471	551	0	11	80	0.1375000
NODE_5810_length_1046_cov_11.238648	471	551	2	69	80	0.8625000
NODE_5810_length_1046_cov_11.238648	524	604	0	25	80	0.3125000
NODE_5810_length_1046_cov_11.238648	524	604	2	55	80	0.6875000
NODE_5811_length_1046_cov_10.744456	459	539	1	9	80	0.1125000
NODE_5811_length_1046_cov_10.744456	459	539	2	59	80	0.7375000
NODE_5811_length_1046_cov_10.744456	459	539	3	12	80	0.1500000
NODE_5811_length_1046_cov_10.744456	512	592	1	9	80	0.1125000
NODE_5811_length_1046_cov_10.744456	512	592	2	71	80	0.8875000
NODE_5812_length_1046_cov_8.689546	302	382	1	13	80	0.1625000
NODE_5812_length_1046_cov_8.689546	302	382	2	28	80	0.3500000
NODE_5812_length_1046_cov_8.689546	302	382	3	8	80	0.1000000
NODE_5812_length_1046_cov_8.689546	302	382	4	31	80	0.3875000
NODE_5812_length_1046_cov_8.689546	355	435	3	39	80	0.4875000
NODE_5812_length_1046_cov_8.689546	355	435	4	41	80	0.5125000
NODE_5823_length_1045_cov_75.975687	359	440	11	1	81	0.0123457
NODE_5823_length_1045_cov_75.975687	359	440	13	16	81	0.1975309
NODE_5823_length_1045_cov_75.975687	359	440	14	1	81	0.0123457
NODE_5823_length_1045_cov_75.975687	359	440	15	3	81	0.0370370
NODE_5823_length_1045_cov_75.975687	359	440	16	14	81	0.1728395
NODE_5823_length_1045_cov_75.975687	359	440	17	28	81	0.3456790
NODE_5823_length_1045_cov_75.975687	359	440	18	3	81	0.0370370
NODE_5823_length_1045_cov_75.975687	359	440	19	2	81	0.0246914
NODE_5823_length_1045_cov_75.975687	359	440	20	2	81	0.0246914
NODE_5823_length_1045_cov_75.975687	359	440	21	6	81	0.0740741
NODE_5823_length_1045_cov_75.975687	359	440	22	5	81	0.0617284
NODE_5823_length_1045_cov_75.975687	412	493	13	5	81	0.0617284
NODE_5823_length_1045_cov_75.975687	412	493	14	26	81	0.3209876
NODE_5823_length_1045_cov_75.975687	412	493	15	5	81	0.0617284
NODE_5823_length_1045_cov_75.975687	412	493	17	10	81	0.1234568
NODE_5823_length_1045_cov_75.975687	412	493	18	5	81	0.0617284
NODE_5823_length_1045_cov_75.975687	412	493	19	4	81	0.0493827
NODE_5823_length_1045_cov_75.975687	412	493	20	2	81	0.0246914
NODE_5823_length_1045_cov_75.975687	412	493	21	9	81	0.1111111
NODE_5823_length_1045_cov_75.975687	412	493	22	15	81	0.1851852
NODE_5823_length_1045_cov_75.975687	489	569	13	1	80	0.0125000
NODE_5823_length_1045_cov_75.975687	489	569	14	7	80	0.0875000
NODE_5823_length_1045_cov_75.975687	489	569	15	10	80	0.1250000
NODE_5823_length_1045_cov_75.975687	489	569	16	13	80	0.1625000
NODE_5823_length_1045_cov_75.975687	489	569	17	17	80	0.2125000
NODE_5823_length_1045_cov_75.975687	489	569	18	10	80	0.1250000
NODE_5823_length_1045_cov_75.975687	489	569	19	22	80	0.2750000
NODE_5823_length_1045_cov_75.975687	542	622	12	13	80	0.1625000
NODE_5823_length_1045_cov_75.975687	542	622	13	18	80	0.2250000
NODE_5823_length_1045_cov_75.975687	542	622	14	8	80	0.1000000
NODE_5823_length_1045_cov_75.975687	542	622	15	4	80	0.0500000
NODE_5823_length_1045_cov_75.975687	542	622	16	5	80	0.0625000
NODE_5823_length_1045_cov_75.975687	542	622	17	4	80	0.0500000
NODE_5823_length_1045_cov_75.975687	542	622	18	9	80	0.1125000
NODE_5823_length_1045_cov_75.975687	542	622	19	19	80	0.2375000
NODE_5824_length_1045_cov_54.419662	434	514	3	11	80	0.1375000
NODE_5824_length_1045_cov_54.419662	434	514	4	49	80	0.6125000
NODE_5824_length_1045_cov_54.419662	434	514	5	1	80	0.0125000
NODE_5824_length_1045_cov_54.419662	434	514	6	2	80	0.0250000
NODE_5824_length_1045_cov_54.419662	434	514	7	3	80	0.0375000
NODE_5824_length_1045_cov_54.419662	434	514	8	14	80	0.1750000
NODE_5824_length_1045_cov_54.419662	487	567	4	7	80	0.0875000
NODE_5824_length_1045_cov_54.419662	487	567	5	1	80	0.0125000
NODE_5824_length_1045_cov_54.419662	487	567	6	2	80	0.0250000
NODE_5824_length_1045_cov_54.419662	487	567	7	10	80	0.1250000
NODE_5824_length_1045_cov_54.419662	487	567	8	44	80	0.5500000
NODE_5824_length_1045_cov_54.419662	487	567	9	4	80	0.0500000
NODE_5824_length_1045_cov_54.419662	487	567	10	9	80	0.1125000
NODE_5824_length_1045_cov_54.419662	487	567	11	1	80	0.0125000
NODE_5824_length_1045_cov_54.419662	487	567	12	2	80	0.0250000
NODE_5824_length_1045_cov_54.419662	563	639	10	1	76	0.0131579
NODE_5824_length_1045_cov_54.419662	563	639	11	1	76	0.0131579
NODE_5824_length_1045_cov_54.419662	563	639	12	26	76	0.3421053
NODE_5824_length_1045_cov_54.419662	563	639	13	30	76	0.3947369
NODE_5824_length_1045_cov_54.419662	563	639	14	18	76	0.2368421
NODE_5824_length_1045_cov_54.419662	616	696	7	1	80	0.0125000
NODE_5824_length_1045_cov_54.419662	616	696	8	15	80	0.1875000
NODE_5824_length_1045_cov_54.419662	616	696	9	3	80	0.0375000
NODE_5824_length_1045_cov_54.419662	616	696	10	15	80	0.1875000
NODE_5824_length_1045_cov_54.419662	616	696	11	17	80	0.2125000
NODE_5824_length_1045_cov_54.419662	616	696	12	13	80	0.1625000
NODE_5824_length_1045_cov_54.419662	616	696	13	14	80	0.1750000
NODE_5824_length_1045_cov_54.419662	616	696	14	2	80	0.0250000
NODE_5825_length_1045_cov_23.188161	395	475	5	31	80	0.3875000
NODE_5825_length_1045_cov_23.188161	395	475	7	16	80	0.2000000
NODE_5825_length_1045_cov_23.188161	395	475	8	33	80	0.4125000
NODE_5825_length_1045_cov_23.188161	448	528	5	11	80	0.1375000
NODE_5825_length_1045_cov_23.188161	448	528	6	2	80	0.0250000
NODE_5825_length_1045_cov_23.188161	448	528	7	24	80	0.3000000
NODE_5825_length_1045_cov_23.188161	448	528	8	20	80	0.2500000
NODE_5825_length_1045_cov_23.188161	448	528	9	23	80	0.2875000
NODE_5826_length_1045_cov_19.686047	571	651	2	4	80	0.0500000
NODE_5826_length_1045_cov_19.686047	571	651	3	15	80	0.1875000
NODE_5826_length_1045_cov_19.686047	571	651	4	8	80	0.1000000
NODE_5826_length_1045_cov_19.686047	571	651	5	14	80	0.1750000
NODE_5826_length_1045_cov_19.686047	571	651	6	22	80	0.2750000
NODE_5826_length_1045_cov_19.686047	571	651	7	17	80	0.2125000
NODE_5826_length_1045_cov_19.686047	624	704	5	8	80	0.1000000
NODE_5826_length_1045_cov_19.686047	624	704	6	2	80	0.0250000
NODE_5826_length_1045_cov_19.686047	624	704	7	25	80	0.3125000
NODE_5826_length_1045_cov_19.686047	624	704	9	45	80	0.5625000
NODE_5827_length_1045_cov_19.378436	478	558	3	7	80	0.0875000
NODE_5827_length_1045_cov_19.378436	478	558	4	11	80	0.1375000
NODE_5827_length_1045_cov_19.378436	478	558	5	19	80	0.2375000
NODE_5827_length_1045_cov_19.378436	478	558	6	30	80	0.3750000
NODE_5827_length_1045_cov_19.378436	478	558	7	13	80	0.1625000
NODE_5827_length_1045_cov_19.378436	531	611	6	24	80	0.3000000
NODE_5827_length_1045_cov_19.378436	531	611	7	3	80	0.0375000
NODE_5827_length_1045_cov_19.378436	531	611	8	6	80	0.0750000
NODE_5827_length_1045_cov_19.378436	531	611	9	19	80	0.2375000
NODE_5827_length_1045_cov_19.378436	531	611	10	28	80	0.3500000
NODE_5828_length_1045_cov_17.601480	359	439	0	80	80	1.0000000
NODE_5828_length_1045_cov_17.601480	412	492	0	80	80	1.0000000
NODE_5829_length_1045_cov_17.372093	633	713	2	12	80	0.1500000
NODE_5829_length_1045_cov_17.372093	633	713	4	22	80	0.2750000
NODE_5829_length_1045_cov_17.372093	633	713	6	46	80	0.5750000
NODE_5829_length_1045_cov_17.372093	686	766	1	3	80	0.0375000
NODE_5829_length_1045_cov_17.372093	686	766	3	6	80	0.0750000
NODE_5829_length_1045_cov_17.372093	686	766	4	7	80	0.0875000
NODE_5829_length_1045_cov_17.372093	686	766	5	29	80	0.3625000
NODE_5829_length_1045_cov_17.372093	686	766	6	35	80	0.4375000
NODE_5830_length_1045_cov_14.828753	433	513	2	66	80	0.8250000
NODE_5830_length_1045_cov_14.828753	433	513	4	14	80	0.1750000
NODE_5830_length_1045_cov_14.828753	486	566	0	13	80	0.1625000
NODE_5830_length_1045_cov_14.828753	486	566	1	1	80	0.0125000
NODE_5830_length_1045_cov_14.828753	486	566	2	66	80	0.8250000
NODE_5831_length_1045_cov_11.673362	664	744	4	30	80	0.3750000
NODE_5831_length_1045_cov_11.673362	664	744	6	17	80	0.2125000
NODE_5831_length_1045_cov_11.673362	664	744	7	33	80	0.4125000
NODE_5831_length_1045_cov_11.673362	717	797	3	21	80	0.2625000
NODE_5831_length_1045_cov_11.673362	717	797	5	1	80	0.0125000
NODE_5831_length_1045_cov_11.673362	717	797	6	5	80	0.0625000
NODE_5831_length_1045_cov_11.673362	717	797	7	53	80	0.6625000
NODE_5843_length_1044_cov_42.600000	344	424	6	14	80	0.1750000
NODE_5843_length_1044_cov_42.600000	344	424	7	33	80	0.4125000
NODE_5843_length_1044_cov_42.600000	344	424	8	2	80	0.0250000
NODE_5843_length_1044_cov_42.600000	344	424	9	5	80	0.0625000
NODE_5843_length_1044_cov_42.600000	344	424	10	6	80	0.0750000
NODE_5843_length_1044_cov_42.600000	344	424	12	6	80	0.0750000
NODE_5843_length_1044_cov_42.600000	344	424	13	2	80	0.0250000
NODE_5843_length_1044_cov_42.600000	344	424	14	12	80	0.1500000
NODE_5843_length_1044_cov_42.600000	397	477	7	2	80	0.0250000
NODE_5843_length_1044_cov_42.600000	397	477	8	1	80	0.0125000
NODE_5843_length_1044_cov_42.600000	397	477	9	8	80	0.1000000
NODE_5843_length_1044_cov_42.600000	397	477	10	49	80	0.6125000
NODE_5843_length_1044_cov_42.600000	397	477	12	6	80	0.0750000
NODE_5843_length_1044_cov_42.600000	397	477	13	2	80	0.0250000
NODE_5843_length_1044_cov_42.600000	397	477	14	12	80	0.1500000
NODE_5844_length_1044_cov_27.653968	454	534	7	11	80	0.1375000
NODE_5844_length_1044_cov_27.653968	454	534	8	17	80	0.2125000
NODE_5844_length_1044_cov_27.653968	454	534	9	23	80	0.2875000
NODE_5844_length_1044_cov_27.653968	454	534	10	5	80	0.0625000
NODE_5844_length_1044_cov_27.653968	454	534	11	21	80	0.2625000
NODE_5844_length_1044_cov_27.653968	454	534	12	3	80	0.0375000
NODE_5844_length_1044_cov_27.653968	507	587	7	2	80	0.0250000
NODE_5844_length_1044_cov_27.653968	507	587	8	7	80	0.0875000
NODE_5844_length_1044_cov_27.653968	507	587	9	16	80	0.2000000
NODE_5844_length_1044_cov_27.653968	507	587	10	3	80	0.0375000
NODE_5844_length_1044_cov_27.653968	507	587	11	49	80	0.6125000
NODE_5844_length_1044_cov_27.653968	507	587	12	3	80	0.0375000
NODE_5845_length_1044_cov_24.561905	297	375	3	2	78	0.0256410
NODE_5845_length_1044_cov_24.561905	297	375	4	39	78	0.5000000
NODE_5845_length_1044_cov_24.561905	297	375	5	37	78	0.4743590
NODE_5845_length_1044_cov_24.561905	348	428	2	2	80	0.0250000
NODE_5845_length_1044_cov_24.561905	348	428	3	15	80	0.1875000
NODE_5845_length_1044_cov_24.561905	348	428	5	63	80	0.7875000
NODE_5845_length_1044_cov_24.561905	424	504	3	11	80	0.1375000
NODE_5845_length_1044_cov_24.561905	424	504	4	7	80	0.0875000
NODE_5845_length_1044_cov_24.561905	424	504	5	37	80	0.4625000
NODE_5845_length_1044_cov_24.561905	424	504	6	20	80	0.2500000
NODE_5845_length_1044_cov_24.561905	424	504	7	5	80	0.0625000
NODE_5845_length_1044_cov_24.561905	477	557	5	5	80	0.0625000
NODE_5845_length_1044_cov_24.561905	477	557	6	70	80	0.8750000
NODE_5845_length_1044_cov_24.561905	477	557	7	5	80	0.0625000
NODE_5846_length_1044_cov_23.720635	294	374	0	8	80	0.1000000
NODE_5846_length_1044_cov_23.720635	294	374	1	71	80	0.8875000
NODE_5846_length_1044_cov_23.720635	294	374	2	1	80	0.0125000
NODE_5846_length_1044_cov_23.720635	347	427	1	26	80	0.3250000
NODE_5846_length_1044_cov_23.720635	347	427	2	6	80	0.0750000
NODE_5846_length_1044_cov_23.720635	347	427	3	11	80	0.1375000
NODE_5846_length_1044_cov_23.720635	347	427	4	37	80	0.4625000
NODE_5846_length_1044_cov_23.720635	423	503	4	13	80	0.1625000
NODE_5846_length_1044_cov_23.720635	423	503	6	7	80	0.0875000
NODE_5846_length_1044_cov_23.720635	423	503	7	14	80	0.1750000
NODE_5846_length_1044_cov_23.720635	423	503	8	15	80	0.1875000
NODE_5846_length_1044_cov_23.720635	423	503	9	31	80	0.3875000
NODE_5846_length_1044_cov_23.720635	476	556	6	16	80	0.2000000
NODE_5846_length_1044_cov_23.720635	476	556	7	11	80	0.1375000
NODE_5846_length_1044_cov_23.720635	476	556	8	6	80	0.0750000
NODE_5846_length_1044_cov_23.720635	476	556	9	47	80	0.5875000
NODE_5847_length_1044_cov_20.871958	462	542	6	5	80	0.0625000
NODE_5847_length_1044_cov_20.871958	462	542	7	5	80	0.0625000
NODE_5847_length_1044_cov_20.871958	462	542	8	17	80	0.2125000
NODE_5847_length_1044_cov_20.871958	462	542	9	32	80	0.4000000
NODE_5847_length_1044_cov_20.871958	462	542	10	21	80	0.2625000
NODE_5847_length_1044_cov_20.871958	515	595	3	20	80	0.2500000
NODE_5847_length_1044_cov_20.871958	515	595	4	14	80	0.1750000
NODE_5847_length_1044_cov_20.871958	515	595	6	24	80	0.3000000
NODE_5847_length_1044_cov_20.871958	515	595	8	5	80	0.0625000
NODE_5847_length_1044_cov_20.871958	515	595	9	12	80	0.1500000
NODE_5847_length_1044_cov_20.871958	515	595	10	5	80	0.0625000
NODE_5847_length_1044_cov_20.871958	591	671	0	22	80	0.2750000
NODE_5847_length_1044_cov_20.871958	591	671	1	20	80	0.2500000
NODE_5847_length_1044_cov_20.871958	591	671	2	5	80	0.0625000
NODE_5847_length_1044_cov_20.871958	591	671	3	33	80	0.4125000
NODE_5847_length_1044_cov_20.871958	644	724	0	75	80	0.9375000
NODE_5847_length_1044_cov_20.871958	644	724	1	5	80	0.0625000
NODE_5848_length_1044_cov_18.596825	433	513	0	28	80	0.3500000
NODE_5848_length_1044_cov_18.596825	433	513	1	42	80	0.5250000
NODE_5848_length_1044_cov_18.596825	433	513	2	10	80	0.1250000
NODE_5848_length_1044_cov_18.596825	486	566	1	17	80	0.2125000
NODE_5848_length_1044_cov_18.596825	486	566	2	63	80	0.7875000
NODE_5849_length_1044_cov_16.102646	414	494	1	64	80	0.8000000
NODE_5849_length_1044_cov_16.102646	414	494	2	16	80	0.2000000
NODE_5849_length_1044_cov_16.102646	467	547	1	42	80	0.5250000
NODE_5849_length_1044_cov_16.102646	467	547	2	38	80	0.4750000
NODE_5850_length_1044_cov_12.156614	578	658	4	21	80	0.2625000
NODE_5850_length_1044_cov_12.156614	578	658	5	59	80	0.7375000
NODE_5850_length_1044_cov_12.156614	631	711	4	48	80	0.6000000
NODE_5850_length_1044_cov_12.156614	631	711	5	32	80	0.4000000
NODE_5851_length_1044_cov_10.661376	506	586	1	80	80	1.0000000
NODE_5851_length_1044_cov_10.661376	559	639	0	39	80	0.4875000
NODE_5851_length_1044_cov_10.661376	559	639	1	41	80	0.5125000
NODE_5852_length_1044_cov_9.534392	461	541	1	42	80	0.5250000
NODE_5852_length_1044_cov_9.534392	461	541	3	14	80	0.1750000
NODE_5852_length_1044_cov_9.534392	461	541	4	3	80	0.0375000
NODE_5852_length_1044_cov_9.534392	461	541	5	21	80	0.2625000
NODE_5852_length_1044_cov_9.534392	514	594	3	3	80	0.0375000
NODE_5852_length_1044_cov_9.534392	514	594	4	16	80	0.2000000
NODE_5852_length_1044_cov_9.534392	514	594	5	61	80	0.7625000
NODE_5853_length_1044_cov_5.517460	434	514	2	18	80	0.2250000
NODE_5853_length_1044_cov_5.517460	434	514	3	21	80	0.2625000
NODE_5853_length_1044_cov_5.517460	434	514	4	2	80	0.0250000
NODE_5853_length_1044_cov_5.517460	434	514	5	39	80	0.4875000
NODE_5853_length_1044_cov_5.517460	487	567	4	11	80	0.1375000
NODE_5853_length_1044_cov_5.517460	487	567	5	69	80	0.8625000
NODE_5856_length_1044_cov_1.502646	769	845	0	76	76	1.0000000
NODE_5860_length_1043_cov_42.288136	452	532	2	5	80	0.0625000
NODE_5860_length_1043_cov_42.288136	452	532	3	1	80	0.0125000
NODE_5860_length_1043_cov_42.288136	452	532	5	3	80	0.0375000
NODE_5860_length_1043_cov_42.288136	452	532	7	19	80	0.2375000
NODE_5860_length_1043_cov_42.288136	452	532	9	52	80	0.6500000
NODE_5860_length_1043_cov_42.288136	505	585	6	2	80	0.0250000
NODE_5860_length_1043_cov_42.288136	505	585	7	25	80	0.3125000
NODE_5860_length_1043_cov_42.288136	505	585	8	4	80	0.0500000
NODE_5860_length_1043_cov_42.288136	505	585	9	49	80	0.6125000
NODE_5861_length_1043_cov_25.987288	350	430	3	11	80	0.1375000
NODE_5861_length_1043_cov_25.987288	350	430	4	2	80	0.0250000
NODE_5861_length_1043_cov_25.987288	350	430	6	22	80	0.2750000
NODE_5861_length_1043_cov_25.987288	350	430	8	8	80	0.1000000
NODE_5861_length_1043_cov_25.987288	350	430	11	20	80	0.2500000
NODE_5861_length_1043_cov_25.987288	350	430	12	9	80	0.1125000
NODE_5861_length_1043_cov_25.987288	350	430	13	8	80	0.1000000
NODE_5861_length_1043_cov_25.987288	403	483	10	4	80	0.0500000
NODE_5861_length_1043_cov_25.987288	403	483	11	19	80	0.2375000
NODE_5861_length_1043_cov_25.987288	403	483	12	11	80	0.1375000
NODE_5861_length_1043_cov_25.987288	403	483	13	44	80	0.5500000
NODE_5861_length_1043_cov_25.987288	403	483	14	2	80	0.0250000
NODE_5861_length_1043_cov_25.987288	479	559	13	12	80	0.1500000
NODE_5861_length_1043_cov_25.987288	479	559	14	18	80	0.2250000
NODE_5861_length_1043_cov_25.987288	479	559	15	37	80	0.4625000
NODE_5861_length_1043_cov_25.987288	479	559	16	11	80	0.1375000
NODE_5861_length_1043_cov_25.987288	479	559	18	2	80	0.0250000
NODE_5861_length_1043_cov_25.987288	532	612	14	10	80	0.1250000
NODE_5861_length_1043_cov_25.987288	532	612	15	35	80	0.4375000
NODE_5861_length_1043_cov_25.987288	532	612	16	34	80	0.4250000
NODE_5861_length_1043_cov_25.987288	532	612	17	1	80	0.0125000
NODE_5862_length_1043_cov_20.838983	561	641	4	14	80	0.1750000
NODE_5862_length_1043_cov_20.838983	561	641	5	47	80	0.5875000
NODE_5862_length_1043_cov_20.838983	561	641	6	19	80	0.2375000
NODE_5862_length_1043_cov_20.838983	614	694	1	16	80	0.2000000
NODE_5862_length_1043_cov_20.838983	614	694	3	33	80	0.4125000
NODE_5862_length_1043_cov_20.838983	614	694	4	18	80	0.2250000
NODE_5862_length_1043_cov_20.838983	614	694	5	13	80	0.1625000
NODE_5863_length_1043_cov_20.312500	489	569	3	8	80	0.1000000
NODE_5863_length_1043_cov_20.312500	489	569	4	9	80	0.1125000
NODE_5863_length_1043_cov_20.312500	489	569	5	19	80	0.2375000
NODE_5863_length_1043_cov_20.312500	489	569	6	36	80	0.4500000
NODE_5863_length_1043_cov_20.312500	489	569	7	3	80	0.0375000
NODE_5863_length_1043_cov_20.312500	489	569	8	1	80	0.0125000
NODE_5863_length_1043_cov_20.312500	489	569	9	4	80	0.0500000
NODE_5863_length_1043_cov_20.312500	542	622	6	19	80	0.2375000
NODE_5863_length_1043_cov_20.312500	542	622	7	7	80	0.0875000
NODE_5863_length_1043_cov_20.312500	542	622	8	41	80	0.5125000
NODE_5863_length_1043_cov_20.312500	542	622	9	13	80	0.1625000
NODE_5864_length_1043_cov_16.320975	569	649	0	11	80	0.1375000
NODE_5864_length_1043_cov_16.320975	569	649	2	8	80	0.1000000
NODE_5864_length_1043_cov_16.320975	569	649	4	2	80	0.0250000
NODE_5864_length_1043_cov_16.320975	569	649	6	59	80	0.7375000
NODE_5864_length_1043_cov_16.320975	622	702	6	80	80	1.0000000
NODE_5865_length_1043_cov_11.176907	521	601	0	80	80	1.0000000
NODE_5865_length_1043_cov_11.176907	574	654	0	80	80	1.0000000
NODE_5866_length_1043_cov_8.146186	530	596	0	66	66	1.0000000
NODE_5866_length_1043_cov_8.146186	569	649	0	80	80	1.0000000
NODE_5868_length_1043_cov_5.347458	646	726	0	51	80	0.6375000
NODE_5868_length_1043_cov_5.347458	646	726	2	29	80	0.3625000
NODE_5868_length_1043_cov_5.347458	699	779	0	80	80	1.0000000
NODE_5879_length_1042_cov_242.728526	820	900	39	6	80	0.0750000
NODE_5879_length_1042_cov_242.728526	820	900	40	2	80	0.0250000
NODE_5879_length_1042_cov_242.728526	820	900	42	2	80	0.0250000
NODE_5879_length_1042_cov_242.728526	820	900	43	5	80	0.0625000
NODE_5879_length_1042_cov_242.728526	820	900	44	13	80	0.1625000
NODE_5879_length_1042_cov_242.728526	820	900	45	11	80	0.1375000
NODE_5879_length_1042_cov_242.728526	820	900	46	2	80	0.0250000
NODE_5879_length_1042_cov_242.728526	820	900	47	2	80	0.0250000
NODE_5879_length_1042_cov_242.728526	820	900	51	1	80	0.0125000
NODE_5879_length_1042_cov_242.728526	820	900	52	4	80	0.0500000
NODE_5879_length_1042_cov_242.728526	820	900	53	2	80	0.0250000
NODE_5879_length_1042_cov_242.728526	820	900	55	6	80	0.0750000
NODE_5879_length_1042_cov_242.728526	820	900	57	5	80	0.0625000
NODE_5879_length_1042_cov_242.728526	820	900	58	10	80	0.1250000
NODE_5879_length_1042_cov_242.728526	820	900	59	9	80	0.1125000
NODE_5879_length_1042_cov_242.728526	873	903	55	3	30	0.1000000
NODE_5879_length_1042_cov_242.728526	873	903	57	5	30	0.1666667
NODE_5879_length_1042_cov_242.728526	873	903	58	11	30	0.3666667
NODE_5879_length_1042_cov_242.728526	873	903	59	10	30	0.3333333
NODE_5879_length_1042_cov_242.728526	873	903	60	1	30	0.0333333
NODE_5880_length_1042_cov_63.214210	355	435	5	24	80	0.3000000
NODE_5880_length_1042_cov_63.214210	355	435	6	11	80	0.1375000
NODE_5880_length_1042_cov_63.214210	355	435	7	40	80	0.5000000
NODE_5880_length_1042_cov_63.214210	355	435	8	5	80	0.0625000
NODE_5880_length_1042_cov_63.214210	408	488	6	3	80	0.0375000
NODE_5880_length_1042_cov_63.214210	408	488	7	29	80	0.3625000
NODE_5880_length_1042_cov_63.214210	408	488	8	23	80	0.2875000
NODE_5880_length_1042_cov_63.214210	408	488	9	25	80	0.3125000
NODE_5881_length_1042_cov_29.581124	497	577	0	80	80	1.0000000
NODE_5881_length_1042_cov_29.581124	550	630	0	80	80	1.0000000
NODE_5882_length_1042_cov_23.861082	519	599	1	36	80	0.4500000
NODE_5882_length_1042_cov_23.861082	519	599	2	44	80	0.5500000
NODE_5882_length_1042_cov_23.861082	572	652	2	42	80	0.5250000
NODE_5882_length_1042_cov_23.861082	572	652	4	32	80	0.4000000
NODE_5882_length_1042_cov_23.861082	572	652	5	6	80	0.0750000
NODE_5882_length_1042_cov_23.861082	648	728	4	12	80	0.1500000
NODE_5882_length_1042_cov_23.861082	648	728	5	48	80	0.6000000
NODE_5882_length_1042_cov_23.861082	648	728	6	20	80	0.2500000
NODE_5882_length_1042_cov_23.861082	701	781	4	30	80	0.3750000
NODE_5882_length_1042_cov_23.861082	701	781	5	8	80	0.1000000
NODE_5882_length_1042_cov_23.861082	701	781	6	42	80	0.5250000
NODE_5883_length_1042_cov_22.247084	555	635	0	38	80	0.4750000
NODE_5883_length_1042_cov_22.247084	555	635	2	24	80	0.3000000
NODE_5883_length_1042_cov_22.247084	555	635	4	18	80	0.2250000
NODE_5883_length_1042_cov_22.247084	608	688	2	9	80	0.1125000
NODE_5883_length_1042_cov_22.247084	608	688	4	36	80	0.4500000
NODE_5883_length_1042_cov_22.247084	608	688	5	35	80	0.4375000
NODE_5884_length_1042_cov_22.117709	335	415	10	10	80	0.1250000
NODE_5884_length_1042_cov_22.117709	335	415	11	10	80	0.1250000
NODE_5884_length_1042_cov_22.117709	335	415	12	27	80	0.3375000
NODE_5884_length_1042_cov_22.117709	335	415	13	33	80	0.4125000
NODE_5884_length_1042_cov_22.117709	388	468	3	7	80	0.0875000
NODE_5884_length_1042_cov_22.117709	388	468	4	18	80	0.2250000
NODE_5884_length_1042_cov_22.117709	388	468	5	1	80	0.0125000
NODE_5884_length_1042_cov_22.117709	388	468	6	2	80	0.0250000
NODE_5884_length_1042_cov_22.117709	388	468	7	3	80	0.0375000
NODE_5884_length_1042_cov_22.117709	388	468	9	21	80	0.2625000
NODE_5884_length_1042_cov_22.117709	388	468	10	5	80	0.0625000
NODE_5884_length_1042_cov_22.117709	388	468	12	7	80	0.0875000
NODE_5884_length_1042_cov_22.117709	388	468	13	16	80	0.2000000
NODE_5884_length_1042_cov_22.117709	464	544	2	23	80	0.2875000
NODE_5884_length_1042_cov_22.117709	464	544	3	56	80	0.7000000
NODE_5884_length_1042_cov_22.117709	464	544	4	1	80	0.0125000
NODE_5884_length_1042_cov_22.117709	517	597	2	71	80	0.8875000
NODE_5884_length_1042_cov_22.117709	517	597	3	9	80	0.1125000
NODE_5885_length_1042_cov_16.831389	27	97	0	70	70	1.0000000
NODE_5885_length_1042_cov_16.831389	372	452	2	3	80	0.0375000
NODE_5885_length_1042_cov_16.831389	372	452	3	10	80	0.1250000
NODE_5885_length_1042_cov_16.831389	372	452	4	5	80	0.0625000
NODE_5885_length_1042_cov_16.831389	372	452	6	22	80	0.2750000
NODE_5885_length_1042_cov_16.831389	372	452	7	28	80	0.3500000
NODE_5885_length_1042_cov_16.831389	372	452	8	12	80	0.1500000
NODE_5885_length_1042_cov_16.831389	425	505	7	37	80	0.4625000
NODE_5885_length_1042_cov_16.831389	425	505	8	17	80	0.2125000
NODE_5885_length_1042_cov_16.831389	425	505	9	23	80	0.2875000
NODE_5885_length_1042_cov_16.831389	425	505	10	3	80	0.0375000
NODE_5886_length_1042_cov_16.662778	416	496	11	10	80	0.1250000
NODE_5886_length_1042_cov_16.662778	416	496	12	2	80	0.0250000
NODE_5886_length_1042_cov_16.662778	416	496	13	25	80	0.3125000
NODE_5886_length_1042_cov_16.662778	416	496	15	4	80	0.0500000
NODE_5886_length_1042_cov_16.662778	416	496	17	8	80	0.1000000
NODE_5886_length_1042_cov_16.662778	416	496	19	6	80	0.0750000
NODE_5886_length_1042_cov_16.662778	416	496	20	4	80	0.0500000
NODE_5886_length_1042_cov_16.662778	416	496	21	6	80	0.0750000
NODE_5886_length_1042_cov_16.662778	416	496	23	15	80	0.1875000
NODE_5886_length_1042_cov_16.662778	469	549	14	1	80	0.0125000
NODE_5886_length_1042_cov_16.662778	469	549	15	3	80	0.0375000
NODE_5886_length_1042_cov_16.662778	469	549	17	5	80	0.0625000
NODE_5886_length_1042_cov_16.662778	469	549	19	24	80	0.3000000
NODE_5886_length_1042_cov_16.662778	469	549	20	5	80	0.0625000
NODE_5886_length_1042_cov_16.662778	469	549	21	9	80	0.1125000
NODE_5886_length_1042_cov_16.662778	469	549	22	11	80	0.1375000
NODE_5886_length_1042_cov_16.662778	469	549	23	22	80	0.2750000
NODE_5887_length_1042_cov_9.474019	361	441	5	46	80	0.5750000
NODE_5887_length_1042_cov_9.474019	361	441	6	9	80	0.1125000
NODE_5887_length_1042_cov_9.474019	361	441	7	25	80	0.3125000
NODE_5887_length_1042_cov_9.474019	414	494	2	19	80	0.2375000
NODE_5887_length_1042_cov_9.474019	414	494	3	10	80	0.1250000
NODE_5887_length_1042_cov_9.474019	414	494	4	17	80	0.2125000
NODE_5887_length_1042_cov_9.474019	414	494	5	1	80	0.0125000
NODE_5887_length_1042_cov_9.474019	414	494	6	2	80	0.0250000
NODE_5887_length_1042_cov_9.474019	414	494	7	31	80	0.3875000
NODE_5888_length_1042_cov_6.725345	356	419	0	1	63	0.0158730
NODE_5888_length_1042_cov_6.725345	356	419	2	43	63	0.6825397
NODE_5888_length_1042_cov_6.725345	356	419	3	19	63	0.3015873
NODE_5888_length_1042_cov_6.725345	392	472	2	8	80	0.1000000
NODE_5888_length_1042_cov_6.725345	392	472	3	72	80	0.9000000
NODE_5896_length_1041_cov_42.960722	335	415	11	6	80	0.0750000
NODE_5896_length_1041_cov_42.960722	335	415	13	12	80	0.1500000
NODE_5896_length_1041_cov_42.960722	335	415	14	41	80	0.5125000
NODE_5896_length_1041_cov_42.960722	335	415	15	19	80	0.2375000
NODE_5896_length_1041_cov_42.960722	335	415	16	2	80	0.0250000
NODE_5896_length_1041_cov_42.960722	388	468	14	12	80	0.1500000
NODE_5896_length_1041_cov_42.960722	388	468	15	39	80	0.4875000
NODE_5896_length_1041_cov_42.960722	388	468	16	16	80	0.2000000
NODE_5896_length_1041_cov_42.960722	388	468	17	6	80	0.0750000
NODE_5896_length_1041_cov_42.960722	388	468	18	7	80	0.0875000
NODE_5896_length_1041_cov_42.960722	464	544	12	13	80	0.1625000
NODE_5896_length_1041_cov_42.960722	464	544	13	22	80	0.2750000
NODE_5896_length_1041_cov_42.960722	464	544	14	3	80	0.0375000
NODE_5896_length_1041_cov_42.960722	464	544	15	21	80	0.2625000
NODE_5896_length_1041_cov_42.960722	464	544	16	10	80	0.1250000
NODE_5896_length_1041_cov_42.960722	464	544	17	11	80	0.1375000
NODE_5896_length_1041_cov_42.960722	517	597	10	12	80	0.1500000
NODE_5896_length_1041_cov_42.960722	517	597	11	23	80	0.2875000
NODE_5896_length_1041_cov_42.960722	517	597	12	27	80	0.3375000
NODE_5896_length_1041_cov_42.960722	517	597	13	1	80	0.0125000
NODE_5896_length_1041_cov_42.960722	517	597	15	6	80	0.0750000
NODE_5896_length_1041_cov_42.960722	517	597	17	11	80	0.1375000
NODE_5897_length_1041_cov_37.331210	513	593	2	17	80	0.2125000
NODE_5897_length_1041_cov_37.331210	513	593	4	6	80	0.0750000
NODE_5897_length_1041_cov_37.331210	513	593	5	16	80	0.2000000
NODE_5897_length_1041_cov_37.331210	513	593	6	10	80	0.1250000
NODE_5897_length_1041_cov_37.331210	513	593	7	5	80	0.0625000
NODE_5897_length_1041_cov_37.331210	513	593	8	26	80	0.3250000
NODE_5897_length_1041_cov_37.331210	566	646	7	1	80	0.0125000
NODE_5897_length_1041_cov_37.331210	566	646	8	39	80	0.4875000
NODE_5897_length_1041_cov_37.331210	566	646	9	19	80	0.2375000
NODE_5897_length_1041_cov_37.331210	566	646	10	20	80	0.2500000
NODE_5897_length_1041_cov_37.331210	566	646	12	1	80	0.0125000
NODE_5897_length_1041_cov_37.331210	642	722	6	10	80	0.1250000
NODE_5897_length_1041_cov_37.331210	642	722	7	9	80	0.1125000
NODE_5897_length_1041_cov_37.331210	642	722	8	15	80	0.1875000
NODE_5897_length_1041_cov_37.331210	642	722	9	2	80	0.0250000
NODE_5897_length_1041_cov_37.331210	642	722	10	42	80	0.5250000
NODE_5897_length_1041_cov_37.331210	642	722	12	2	80	0.0250000
NODE_5897_length_1041_cov_37.331210	695	775	1	9	80	0.1125000
NODE_5897_length_1041_cov_37.331210	695	775	2	26	80	0.3250000
NODE_5897_length_1041_cov_37.331210	695	775	4	14	80	0.1750000
NODE_5897_length_1041_cov_37.331210	695	775	6	14	80	0.1750000
NODE_5897_length_1041_cov_37.331210	695	775	7	9	80	0.1125000
NODE_5897_length_1041_cov_37.331210	695	775	8	8	80	0.1000000
NODE_5898_length_1041_cov_36.477707	455	535	7	2	80	0.0250000
NODE_5898_length_1041_cov_36.477707	455	535	8	1	80	0.0125000
NODE_5898_length_1041_cov_36.477707	455	535	9	27	80	0.3375000
NODE_5898_length_1041_cov_36.477707	455	535	10	47	80	0.5875000
NODE_5898_length_1041_cov_36.477707	455	535	12	3	80	0.0375000
NODE_5898_length_1041_cov_36.477707	508	588	4	7	80	0.0875000
NODE_5898_length_1041_cov_36.477707	508	588	5	3	80	0.0375000
NODE_5898_length_1041_cov_36.477707	508	588	6	9	80	0.1125000
NODE_5898_length_1041_cov_36.477707	508	588	9	37	80	0.4625000
NODE_5898_length_1041_cov_36.477707	508	588	10	21	80	0.2625000
NODE_5898_length_1041_cov_36.477707	508	588	12	3	80	0.0375000
NODE_5898_length_1041_cov_36.477707	584	664	0	70	80	0.8750000
NODE_5898_length_1041_cov_36.477707	584	664	3	1	80	0.0125000
NODE_5898_length_1041_cov_36.477707	584	664	4	9	80	0.1125000
NODE_5898_length_1041_cov_36.477707	637	717	0	80	80	1.0000000
NODE_5898_length_1041_cov_36.477707	753	799	0	46	46	1.0000000
NODE_5899_length_1041_cov_19.286624	468	548	4	17	80	0.2125000
NODE_5899_length_1041_cov_19.286624	468	548	5	13	80	0.1625000
NODE_5899_length_1041_cov_19.286624	468	548	6	14	80	0.1750000
NODE_5899_length_1041_cov_19.286624	468	548	7	17	80	0.2125000
NODE_5899_length_1041_cov_19.286624	468	548	9	19	80	0.2375000
NODE_5899_length_1041_cov_19.286624	521	601	7	8	80	0.1000000
NODE_5899_length_1041_cov_19.286624	521	601	8	9	80	0.1125000
NODE_5899_length_1041_cov_19.286624	521	601	9	37	80	0.4625000
NODE_5899_length_1041_cov_19.286624	521	601	10	26	80	0.3250000
NODE_5900_length_1041_cov_17.072187	578	658	9	7	80	0.0875000
NODE_5900_length_1041_cov_17.072187	578	658	10	17	80	0.2125000
NODE_5900_length_1041_cov_17.072187	578	658	11	14	80	0.1750000
NODE_5900_length_1041_cov_17.072187	578	658	13	10	80	0.1250000
NODE_5900_length_1041_cov_17.072187	578	658	14	14	80	0.1750000
NODE_5900_length_1041_cov_17.072187	578	658	15	18	80	0.2250000
NODE_5900_length_1041_cov_17.072187	631	711	5	15	80	0.1875000
NODE_5900_length_1041_cov_17.072187	631	711	6	1	80	0.0125000
NODE_5900_length_1041_cov_17.072187	631	711	7	2	80	0.0250000
NODE_5900_length_1041_cov_17.072187	631	711	8	10	80	0.1250000
NODE_5900_length_1041_cov_17.072187	631	711	9	32	80	0.4000000
NODE_5900_length_1041_cov_17.072187	631	711	14	11	80	0.1375000
NODE_5900_length_1041_cov_17.072187	631	711	15	9	80	0.1125000
NODE_5901_length_1041_cov_11.887473	437	517	4	80	80	1.0000000
NODE_5901_length_1041_cov_11.887473	490	570	4	80	80	1.0000000
NODE_5902_length_1041_cov_6.957537	354	434	5	6	80	0.0750000
NODE_5902_length_1041_cov_6.957537	354	434	6	31	80	0.3875000
NODE_5902_length_1041_cov_6.957537	354	434	7	9	80	0.1125000
NODE_5902_length_1041_cov_6.957537	354	434	8	34	80	0.4250000
NODE_5902_length_1041_cov_6.957537	407	487	4	3	80	0.0375000
NODE_5902_length_1041_cov_6.957537	407	487	5	7	80	0.0875000
NODE_5902_length_1041_cov_6.957537	407	487	6	41	80	0.5125000
NODE_5902_length_1041_cov_6.957537	407	487	7	14	80	0.1750000
NODE_5902_length_1041_cov_6.957537	407	487	8	15	80	0.1875000
NODE_5913_length_1040_cov_34.618491	478	558	9	9	80	0.1125000
NODE_5913_length_1040_cov_34.618491	478	558	10	6	80	0.0750000
NODE_5913_length_1040_cov_34.618491	478	558	11	18	80	0.2250000
NODE_5913_length_1040_cov_34.618491	478	558	12	10	80	0.1250000
NODE_5913_length_1040_cov_34.618491	478	558	13	1	80	0.0125000
NODE_5913_length_1040_cov_34.618491	478	558	14	10	80	0.1250000
NODE_5913_length_1040_cov_34.618491	478	558	15	26	80	0.3250000
NODE_5913_length_1040_cov_34.618491	531	611	7	19	80	0.2375000
NODE_5913_length_1040_cov_34.618491	531	611	8	4	80	0.0500000
NODE_5913_length_1040_cov_34.618491	531	611	10	8	80	0.1000000
NODE_5913_length_1040_cov_34.618491	531	611	11	11	80	0.1375000
NODE_5913_length_1040_cov_34.618491	531	611	12	19	80	0.2375000
NODE_5913_length_1040_cov_34.618491	531	611	14	10	80	0.1250000
NODE_5913_length_1040_cov_34.618491	531	611	15	9	80	0.1125000
NODE_5914_length_1040_cov_33.061637	485	565	4	17	80	0.2125000
NODE_5914_length_1040_cov_33.061637	485	565	5	63	80	0.7875000
NODE_5914_length_1040_cov_33.061637	538	618	3	4	80	0.0500000
NODE_5914_length_1040_cov_33.061637	538	618	4	60	80	0.7500000
NODE_5914_length_1040_cov_33.061637	538	618	5	10	80	0.1250000
NODE_5914_length_1040_cov_33.061637	538	618	6	6	80	0.0750000
NODE_5915_length_1040_cov_27.818278	402	482	6	11	80	0.1375000
NODE_5915_length_1040_cov_27.818278	402	482	7	2	80	0.0250000
NODE_5915_length_1040_cov_27.818278	402	482	8	9	80	0.1125000
NODE_5915_length_1040_cov_27.818278	402	482	9	26	80	0.3250000
NODE_5915_length_1040_cov_27.818278	402	482	10	32	80	0.4000000
NODE_5915_length_1040_cov_27.818278	455	535	4	37	80	0.4625000
NODE_5915_length_1040_cov_27.818278	455	535	6	27	80	0.3375000
NODE_5915_length_1040_cov_27.818278	455	535	7	2	80	0.0250000
NODE_5915_length_1040_cov_27.818278	455	535	9	9	80	0.1125000
NODE_5915_length_1040_cov_27.818278	455	535	10	5	80	0.0625000
NODE_5916_length_1040_cov_17.933050	487	567	3	10	80	0.1250000
NODE_5916_length_1040_cov_17.933050	487	567	4	70	80	0.8750000
NODE_5916_length_1040_cov_17.933050	540	620	0	4	80	0.0500000
NODE_5916_length_1040_cov_17.933050	540	620	1	43	80	0.5375000
NODE_5916_length_1040_cov_17.933050	540	620	2	6	80	0.0750000
NODE_5916_length_1040_cov_17.933050	540	620	3	10	80	0.1250000
NODE_5916_length_1040_cov_17.933050	540	620	4	17	80	0.2125000
NODE_5917_length_1040_cov_14.327311	237	317	5	1	80	0.0125000
NODE_5917_length_1040_cov_14.327311	237	317	6	79	80	0.9875000
NODE_5917_length_1040_cov_14.327311	290	370	4	19	80	0.2375000
NODE_5917_length_1040_cov_14.327311	290	370	5	20	80	0.2500000
NODE_5917_length_1040_cov_14.327311	290	370	6	41	80	0.5125000
NODE_5917_length_1040_cov_14.327311	366	446	1	8	80	0.1000000
NODE_5917_length_1040_cov_14.327311	366	446	2	59	80	0.7375000
NODE_5917_length_1040_cov_14.327311	366	446	3	3	80	0.0375000
NODE_5917_length_1040_cov_14.327311	366	446	4	10	80	0.1250000
NODE_5917_length_1040_cov_14.327311	419	499	1	36	80	0.4500000
NODE_5917_length_1040_cov_14.327311	419	499	2	44	80	0.5500000
NODE_5918_length_1040_cov_11.910733	369	449	6	14	80	0.1750000
NODE_5918_length_1040_cov_11.910733	369	449	7	1	80	0.0125000
NODE_5918_length_1040_cov_11.910733	369	449	8	19	80	0.2375000
NODE_5918_length_1040_cov_11.910733	369	449	9	32	80	0.4000000
NODE_5918_length_1040_cov_11.910733	369	449	10	10	80	0.1250000
NODE_5918_length_1040_cov_11.910733	369	449	11	4	80	0.0500000
NODE_5918_length_1040_cov_11.910733	422	502	9	69	80	0.8625000
NODE_5918_length_1040_cov_11.910733	422	502	10	10	80	0.1250000
NODE_5918_length_1040_cov_11.910733	422	502	11	1	80	0.0125000
NODE_5919_length_1040_cov_11.521785	355	435	0	80	80	1.0000000
NODE_5919_length_1040_cov_11.521785	408	488	0	80	80	1.0000000
NODE_5920_length_1040_cov_9.573858	632	712	4	2	80	0.0250000
NODE_5920_length_1040_cov_9.573858	632	712	5	5	80	0.0625000
NODE_5920_length_1040_cov_9.573858	632	712	7	22	80	0.2750000
NODE_5920_length_1040_cov_9.573858	632	712	8	4	80	0.0500000
NODE_5920_length_1040_cov_9.573858	632	712	9	7	80	0.0875000
NODE_5920_length_1040_cov_9.573858	632	712	11	40	80	0.5000000
NODE_5920_length_1040_cov_9.573858	685	765	6	2	80	0.0250000
NODE_5920_length_1040_cov_9.573858	685	765	8	6	80	0.0750000
NODE_5920_length_1040_cov_9.573858	685	765	9	2	80	0.0250000
NODE_5920_length_1040_cov_9.573858	685	765	10	19	80	0.2375000
NODE_5920_length_1040_cov_9.573858	685	765	11	51	80	0.6375000
NODE_5921_length_1040_cov_8.148778	349	429	0	14	80	0.1750000
NODE_5921_length_1040_cov_8.148778	349	429	2	7	80	0.0875000
NODE_5921_length_1040_cov_8.148778	349	429	3	51	80	0.6375000
NODE_5921_length_1040_cov_8.148778	349	429	4	8	80	0.1000000
NODE_5921_length_1040_cov_8.148778	402	482	0	14	80	0.1750000
NODE_5921_length_1040_cov_8.148778	402	482	2	5	80	0.0625000
NODE_5921_length_1040_cov_8.148778	402	482	4	32	80	0.4000000
NODE_5921_length_1040_cov_8.148778	402	482	5	7	80	0.0875000
NODE_5921_length_1040_cov_8.148778	402	482	6	10	80	0.1250000
NODE_5921_length_1040_cov_8.148778	402	482	7	9	80	0.1125000
NODE_5921_length_1040_cov_8.148778	402	482	8	3	80	0.0375000
NODE_5922_length_1040_cov_7.927736	282	362	2	12	80	0.1500000
NODE_5922_length_1040_cov_7.927736	282	362	3	68	80	0.8500000
NODE_5922_length_1040_cov_7.927736	335	415	1	53	80	0.6625000
NODE_5922_length_1040_cov_7.927736	335	415	2	8	80	0.1000000
NODE_5922_length_1040_cov_7.927736	335	415	3	19	80	0.2375000
NODE_5927_length_1040_cov_2.317747	2	78	0	76	76	1.0000000
NODE_5934_length_1039_cov_40.150000	487	567	1	3	80	0.0375000
NODE_5934_length_1039_cov_40.150000	487	567	2	16	80	0.2000000
NODE_5934_length_1039_cov_40.150000	487	567	3	3	80	0.0375000
NODE_5934_length_1039_cov_40.150000	487	567	4	8	80	0.1000000
NODE_5934_length_1039_cov_40.150000	487	567	8	18	80	0.2250000
NODE_5934_length_1039_cov_40.150000	487	567	9	19	80	0.2375000
NODE_5934_length_1039_cov_40.150000	487	567	10	13	80	0.1625000
NODE_5934_length_1039_cov_40.150000	540	620	7	2	80	0.0250000
NODE_5934_length_1039_cov_40.150000	540	620	9	14	80	0.1750000
NODE_5934_length_1039_cov_40.150000	540	620	10	17	80	0.2125000
NODE_5934_length_1039_cov_40.150000	540	620	11	29	80	0.3625000
NODE_5934_length_1039_cov_40.150000	540	620	12	18	80	0.2250000
NODE_5934_length_1039_cov_40.150000	616	696	7	8	80	0.1000000
NODE_5934_length_1039_cov_40.150000	616	696	8	2	80	0.0250000
NODE_5934_length_1039_cov_40.150000	616	696	9	5	80	0.0625000
NODE_5934_length_1039_cov_40.150000	616	696	10	1	80	0.0125000
NODE_5934_length_1039_cov_40.150000	616	696	11	2	80	0.0250000
NODE_5934_length_1039_cov_40.150000	616	696	12	2	80	0.0250000
NODE_5934_length_1039_cov_40.150000	616	696	14	5	80	0.0625000
NODE_5934_length_1039_cov_40.150000	616	696	15	13	80	0.1625000
NODE_5934_length_1039_cov_40.150000	616	696	17	1	80	0.0125000
NODE_5934_length_1039_cov_40.150000	616	696	18	11	80	0.1375000
NODE_5934_length_1039_cov_40.150000	616	696	19	17	80	0.2125000
NODE_5934_length_1039_cov_40.150000	616	696	20	13	80	0.1625000
NODE_5934_length_1039_cov_40.150000	669	739	17	2	70	0.0285714
NODE_5934_length_1039_cov_40.150000	669	739	18	16	70	0.2285714
NODE_5934_length_1039_cov_40.150000	669	739	19	25	70	0.3571429
NODE_5934_length_1039_cov_40.150000	669	739	20	27	70	0.3857143
NODE_5935_length_1039_cov_37.940426	175	255	0	43	80	0.5375000
NODE_5935_length_1039_cov_37.940426	175	255	2	37	80	0.4625000
NODE_5935_length_1039_cov_37.940426	228	308	2	80	80	1.0000000
NODE_5935_length_1039_cov_37.940426	304	384	1	26	80	0.3250000
NODE_5935_length_1039_cov_37.940426	304	384	2	25	80	0.3125000
NODE_5935_length_1039_cov_37.940426	304	384	3	10	80	0.1250000
NODE_5935_length_1039_cov_37.940426	304	384	5	19	80	0.2375000
NODE_5935_length_1039_cov_37.940426	357	437	2	1	80	0.0125000
NODE_5935_length_1039_cov_37.940426	357	437	3	7	80	0.0875000
NODE_5935_length_1039_cov_37.940426	357	437	5	43	80	0.5375000
NODE_5935_length_1039_cov_37.940426	357	437	6	29	80	0.3625000
NODE_5936_length_1039_cov_24.567021	371	451	9	9	80	0.1125000
NODE_5936_length_1039_cov_24.567021	371	451	10	66	80	0.8250000
NODE_5936_length_1039_cov_24.567021	371	451	11	5	80	0.0625000
NODE_5936_length_1039_cov_24.567021	424	504	4	16	80	0.2000000
NODE_5936_length_1039_cov_24.567021	424	504	6	13	80	0.1625000
NODE_5936_length_1039_cov_24.567021	424	504	7	3	80	0.0375000
NODE_5936_length_1039_cov_24.567021	424	504	8	18	80	0.2250000
NODE_5936_length_1039_cov_24.567021	424	504	9	8	80	0.1000000
NODE_5936_length_1039_cov_24.567021	424	504	10	22	80	0.2750000
NODE_5937_length_1039_cov_15.790426	293	373	3	3	80	0.0375000
NODE_5937_length_1039_cov_15.790426	293	373	4	38	80	0.4750000
NODE_5937_length_1039_cov_15.790426	293	373	5	31	80	0.3875000
NODE_5937_length_1039_cov_15.790426	293	373	7	8	80	0.1000000
NODE_5937_length_1039_cov_15.790426	346	426	2	53	80	0.6625000
NODE_5937_length_1039_cov_15.790426	346	426	3	3	80	0.0375000
NODE_5937_length_1039_cov_15.790426	346	426	5	23	80	0.2875000
NODE_5937_length_1039_cov_15.790426	346	426	7	1	80	0.0125000
NODE_5938_length_1039_cov_14.670213	591	671	2	24	80	0.3000000
NODE_5938_length_1039_cov_14.670213	591	671	3	10	80	0.1250000
NODE_5938_length_1039_cov_14.670213	591	671	4	46	80	0.5750000
NODE_5938_length_1039_cov_14.670213	644	724	2	30	80	0.3750000
NODE_5938_length_1039_cov_14.670213	644	724	3	41	80	0.5125000
NODE_5938_length_1039_cov_14.670213	644	724	4	9	80	0.1125000
NODE_5939_length_1039_cov_11.568085	439	519	3	41	80	0.5125000
NODE_5939_length_1039_cov_11.568085	439	519	5	39	80	0.4875000
NODE_5939_length_1039_cov_11.568085	492	571	3	68	79	0.8607595
NODE_5939_length_1039_cov_11.568085	492	571	4	5	79	0.0632911
NODE_5939_length_1039_cov_11.568085	492	571	5	6	79	0.0759494
NODE_5947_length_1038_cov_17.191693	549	629	1	46	80	0.5750000
NODE_5947_length_1038_cov_17.191693	549	629	2	34	80	0.4250000
NODE_5947_length_1038_cov_17.191693	602	682	1	11	80	0.1375000
NODE_5947_length_1038_cov_17.191693	602	682	2	69	80	0.8625000
NODE_5948_length_1038_cov_13.520767	516	596	0	80	80	1.0000000
NODE_5948_length_1038_cov_13.520767	569	649	0	80	80	1.0000000
NODE_5949_length_1038_cov_10.541001	487	567	2	14	80	0.1750000
NODE_5949_length_1038_cov_10.541001	487	567	3	36	80	0.4500000
NODE_5949_length_1038_cov_10.541001	487	567	4	19	80	0.2375000
NODE_5949_length_1038_cov_10.541001	487	567	5	11	80	0.1375000
NODE_5949_length_1038_cov_10.541001	540	620	4	36	80	0.4500000
NODE_5949_length_1038_cov_10.541001	540	620	5	44	80	0.5500000
NODE_5950_length_1038_cov_8.826411	432	512	0	12	80	0.1500000
NODE_5950_length_1038_cov_8.826411	432	512	1	45	80	0.5625000
NODE_5950_length_1038_cov_8.826411	432	512	3	23	80	0.2875000
NODE_5950_length_1038_cov_8.826411	485	565	1	4	80	0.0500000
NODE_5950_length_1038_cov_8.826411	485	565	3	50	80	0.6250000
NODE_5950_length_1038_cov_8.826411	485	565	4	26	80	0.3250000
NODE_5952_length_1038_cov_2.587859	673	753	0	80	80	1.0000000
NODE_5952_length_1038_cov_2.587859	726	806	0	80	80	1.0000000
NODE_5963_length_1037_cov_66.968017	402	482	2	32	80	0.4000000
NODE_5963_length_1037_cov_66.968017	402	482	3	28	80	0.3500000
NODE_5963_length_1037_cov_66.968017	402	482	4	5	80	0.0625000
NODE_5963_length_1037_cov_66.968017	402	482	5	7	80	0.0875000
NODE_5963_length_1037_cov_66.968017	402	482	6	8	80	0.1000000
NODE_5963_length_1037_cov_66.968017	455	535	2	6	80	0.0750000
NODE_5963_length_1037_cov_66.968017	455	535	3	1	80	0.0125000
NODE_5963_length_1037_cov_66.968017	455	535	4	5	80	0.0625000
NODE_5963_length_1037_cov_66.968017	455	535	5	7	80	0.0875000
NODE_5963_length_1037_cov_66.968017	455	535	6	60	80	0.7500000
NODE_5963_length_1037_cov_66.968017	455	535	7	1	80	0.0125000
NODE_5964_length_1037_cov_53.639659	527	607	13	3	80	0.0375000
NODE_5964_length_1037_cov_53.639659	527	607	15	3	80	0.0375000
NODE_5964_length_1037_cov_53.639659	527	607	16	4	80	0.0500000
NODE_5964_length_1037_cov_53.639659	527	607	17	2	80	0.0250000
NODE_5964_length_1037_cov_53.639659	527	607	18	5	80	0.0625000
NODE_5964_length_1037_cov_53.639659	527	607	19	6	80	0.0750000
NODE_5964_length_1037_cov_53.639659	527	607	20	3	80	0.0375000
NODE_5964_length_1037_cov_53.639659	527	607	21	5	80	0.0625000
NODE_5964_length_1037_cov_53.639659	527	607	22	10	80	0.1250000
NODE_5964_length_1037_cov_53.639659	527	607	23	24	80	0.3000000
NODE_5964_length_1037_cov_53.639659	527	607	25	5	80	0.0625000
NODE_5964_length_1037_cov_53.639659	527	607	26	10	80	0.1250000
NODE_5964_length_1037_cov_53.639659	580	660	16	6	80	0.0750000
NODE_5964_length_1037_cov_53.639659	580	660	18	1	80	0.0125000
NODE_5964_length_1037_cov_53.639659	580	660	20	12	80	0.1500000
NODE_5964_length_1037_cov_53.639659	580	660	21	6	80	0.0750000
NODE_5964_length_1037_cov_53.639659	580	660	22	1	80	0.0125000
NODE_5964_length_1037_cov_53.639659	580	660	23	18	80	0.2250000
NODE_5964_length_1037_cov_53.639659	580	660	24	2	80	0.0250000
NODE_5964_length_1037_cov_53.639659	580	660	25	20	80	0.2500000
NODE_5964_length_1037_cov_53.639659	580	660	26	14	80	0.1750000
NODE_5965_length_1037_cov_45.353945	542	622	8	13	80	0.1625000
NODE_5965_length_1037_cov_45.353945	542	622	9	45	80	0.5625000
NODE_5965_length_1037_cov_45.353945	542	622	10	22	80	0.2750000
NODE_5965_length_1037_cov_45.353945	595	675	3	4	80	0.0500000
NODE_5965_length_1037_cov_45.353945	595	675	4	7	80	0.0875000
NODE_5965_length_1037_cov_45.353945	595	675	5	10	80	0.1250000
NODE_5965_length_1037_cov_45.353945	595	675	7	4	80	0.0500000
NODE_5965_length_1037_cov_45.353945	595	675	9	24	80	0.3000000
NODE_5965_length_1037_cov_45.353945	595	675	10	31	80	0.3875000
NODE_5966_length_1037_cov_31.078891	356	436	7	23	80	0.2875000
NODE_5966_length_1037_cov_31.078891	356	436	8	18	80	0.2250000
NODE_5966_length_1037_cov_31.078891	356	436	9	39	80	0.4875000
NODE_5966_length_1037_cov_31.078891	409	489	4	10	80	0.1250000
NODE_5966_length_1037_cov_31.078891	409	489	5	30	80	0.3750000
NODE_5966_length_1037_cov_31.078891	409	489	7	6	80	0.0750000
NODE_5966_length_1037_cov_31.078891	409	489	9	34	80	0.4250000
NODE_5967_length_1037_cov_25.453092	421	501	7	10	80	0.1250000
NODE_5967_length_1037_cov_25.453092	421	501	8	4	80	0.0500000
NODE_5967_length_1037_cov_25.453092	421	501	9	3	80	0.0375000
NODE_5967_length_1037_cov_25.453092	421	501	11	28	80	0.3500000
NODE_5967_length_1037_cov_25.453092	421	501	12	12	80	0.1500000
NODE_5967_length_1037_cov_25.453092	421	501	13	23	80	0.2875000
NODE_5967_length_1037_cov_25.453092	474	554	7	5	80	0.0625000
NODE_5967_length_1037_cov_25.453092	474	554	8	4	80	0.0500000
NODE_5967_length_1037_cov_25.453092	474	554	9	17	80	0.2125000
NODE_5967_length_1037_cov_25.453092	474	554	11	19	80	0.2375000
NODE_5967_length_1037_cov_25.453092	474	554	12	12	80	0.1500000
NODE_5967_length_1037_cov_25.453092	474	554	13	23	80	0.2875000
NODE_5967_length_1037_cov_25.453092	550	573	5	4	23	0.1739130
NODE_5967_length_1037_cov_25.453092	550	573	6	6	23	0.2608696
NODE_5967_length_1037_cov_25.453092	550	573	7	13	23	0.5652174
NODE_5968_length_1037_cov_13.740938	348	428	4	38	80	0.4750000
NODE_5968_length_1037_cov_13.740938	348	428	5	6	80	0.0750000
NODE_5968_length_1037_cov_13.740938	348	428	7	36	80	0.4500000
NODE_5968_length_1037_cov_13.740938	401	481	1	17	80	0.2125000
NODE_5968_length_1037_cov_13.740938	401	481	2	2	80	0.0250000
NODE_5968_length_1037_cov_13.740938	401	481	4	39	80	0.4875000
NODE_5968_length_1037_cov_13.740938	401	481	5	3	80	0.0375000
NODE_5968_length_1037_cov_13.740938	401	481	7	19	80	0.2375000
NODE_5969_length_1037_cov_12.632196	564	644	4	15	80	0.1875000
NODE_5969_length_1037_cov_12.632196	564	644	5	63	80	0.7875000
NODE_5969_length_1037_cov_12.632196	564	644	6	2	80	0.0250000
NODE_5969_length_1037_cov_12.632196	617	697	4	68	80	0.8500000
NODE_5969_length_1037_cov_12.632196	617	697	5	12	80	0.1500000
NODE_5970_length_1037_cov_8.904051	640	720	4	26	80	0.3250000
NODE_5970_length_1037_cov_8.904051	640	720	5	54	80	0.6750000
NODE_5970_length_1037_cov_8.904051	693	773	1	35	80	0.4375000
NODE_5970_length_1037_cov_8.904051	693	773	3	2	80	0.0250000
NODE_5970_length_1037_cov_8.904051	693	773	4	19	80	0.2375000
NODE_5970_length_1037_cov_8.904051	693	773	5	24	80	0.3000000
NODE_5978_length_1037_cov_1.859275	31	91	0	60	60	1.0000000
NODE_5986_length_1036_cov_52.270011	493	573	15	4	80	0.0500000
NODE_5986_length_1036_cov_52.270011	493	573	17	17	80	0.2125000
NODE_5986_length_1036_cov_52.270011	493	573	18	25	80	0.3125000
NODE_5986_length_1036_cov_52.270011	493	573	19	26	80	0.3250000
NODE_5986_length_1036_cov_52.270011	493	573	20	8	80	0.1000000
NODE_5986_length_1036_cov_52.270011	546	626	9	8	80	0.1000000
NODE_5986_length_1036_cov_52.270011	546	626	10	10	80	0.1250000
NODE_5986_length_1036_cov_52.270011	546	626	12	7	80	0.0875000
NODE_5986_length_1036_cov_52.270011	546	626	13	3	80	0.0375000
NODE_5986_length_1036_cov_52.270011	546	626	14	17	80	0.2125000
NODE_5986_length_1036_cov_52.270011	546	626	15	6	80	0.0750000
NODE_5986_length_1036_cov_52.270011	546	626	16	2	80	0.0250000
NODE_5986_length_1036_cov_52.270011	546	626	18	25	80	0.3125000
NODE_5986_length_1036_cov_52.270011	546	626	19	2	80	0.0250000
NODE_5987_length_1036_cov_24.080043	369	449	4	1	80	0.0125000
NODE_5987_length_1036_cov_24.080043	369	449	6	10	80	0.1250000
NODE_5987_length_1036_cov_24.080043	369	449	8	37	80	0.4625000
NODE_5987_length_1036_cov_24.080043	369	449	10	3	80	0.0375000
NODE_5987_length_1036_cov_24.080043	369	449	11	19	80	0.2375000
NODE_5987_length_1036_cov_24.080043	369	449	13	10	80	0.1250000
NODE_5987_length_1036_cov_24.080043	422	502	10	15	80	0.1875000
NODE_5987_length_1036_cov_24.080043	422	502	11	27	80	0.3375000
NODE_5987_length_1036_cov_24.080043	422	502	12	27	80	0.3375000
NODE_5987_length_1036_cov_24.080043	422	502	13	11	80	0.1375000
NODE_5988_length_1036_cov_20.533618	513	593	4	8	80	0.1000000
NODE_5988_length_1036_cov_20.533618	513	593	5	36	80	0.4500000
NODE_5988_length_1036_cov_20.533618	513	593	6	4	80	0.0500000
NODE_5988_length_1036_cov_20.533618	513	593	7	24	80	0.3000000
NODE_5988_length_1036_cov_20.533618	513	593	8	8	80	0.1000000
NODE_5988_length_1036_cov_20.533618	566	645	6	11	79	0.1392405
NODE_5988_length_1036_cov_20.533618	566	645	7	35	79	0.4430380
NODE_5988_length_1036_cov_20.533618	566	645	8	22	79	0.2784810
NODE_5988_length_1036_cov_20.533618	566	645	9	11	79	0.1392405
NODE_5988_length_1036_cov_20.533618	648	728	2	20	80	0.2500000
NODE_5988_length_1036_cov_20.533618	648	728	4	2	80	0.0250000
NODE_5988_length_1036_cov_20.533618	648	728	5	13	80	0.1625000
NODE_5988_length_1036_cov_20.533618	648	728	6	45	80	0.5625000
NODE_5988_length_1036_cov_20.533618	701	781	1	39	80	0.4875000
NODE_5988_length_1036_cov_20.533618	701	781	2	34	80	0.4250000
NODE_5988_length_1036_cov_20.533618	701	781	4	2	80	0.0250000
NODE_5988_length_1036_cov_20.533618	701	781	5	2	80	0.0250000
NODE_5988_length_1036_cov_20.533618	701	781	6	3	80	0.0375000
NODE_5989_length_1036_cov_19.715048	467	547	6	32	80	0.4000000
NODE_5989_length_1036_cov_19.715048	467	547	7	43	80	0.5375000
NODE_5989_length_1036_cov_19.715048	467	547	8	5	80	0.0625000
NODE_5989_length_1036_cov_19.715048	520	600	4	2	80	0.0250000
NODE_5989_length_1036_cov_19.715048	520	600	5	4	80	0.0500000
NODE_5989_length_1036_cov_19.715048	520	600	6	22	80	0.2750000
NODE_5989_length_1036_cov_19.715048	520	600	7	48	80	0.6000000
NODE_5989_length_1036_cov_19.715048	520	600	8	4	80	0.0500000
NODE_5990_length_1036_cov_19.452508	399	479	0	21	80	0.2625000
NODE_5990_length_1036_cov_19.452508	399	479	1	56	80	0.7000000
NODE_5990_length_1036_cov_19.452508	399	479	2	3	80	0.0375000
NODE_5990_length_1036_cov_19.452508	452	532	1	24	80	0.3000000
NODE_5990_length_1036_cov_19.452508	452	532	2	4	80	0.0500000
NODE_5990_length_1036_cov_19.452508	452	532	3	4	80	0.0500000
NODE_5990_length_1036_cov_19.452508	452	532	4	48	80	0.6000000
NODE_5990_length_1036_cov_19.452508	528	608	4	45	80	0.5625000
NODE_5990_length_1036_cov_19.452508	528	608	5	35	80	0.4375000
NODE_5990_length_1036_cov_19.452508	581	661	2	27	80	0.3375000
NODE_5990_length_1036_cov_19.452508	581	661	3	4	80	0.0500000
NODE_5990_length_1036_cov_19.452508	581	661	4	4	80	0.0500000
NODE_5990_length_1036_cov_19.452508	581	661	5	45	80	0.5625000
NODE_5991_length_1036_cov_13.840982	635	715	5	5	80	0.0625000
NODE_5991_length_1036_cov_13.840982	635	715	8	75	80	0.9375000
NODE_5991_length_1036_cov_13.840982	688	768	0	24	80	0.3000000
NODE_5991_length_1036_cov_13.840982	688	768	1	2	80	0.0250000
NODE_5991_length_1036_cov_13.840982	688	768	3	12	80	0.1500000
NODE_5991_length_1036_cov_13.840982	688	768	5	20	80	0.2500000
NODE_5991_length_1036_cov_13.840982	688	768	8	22	80	0.2750000
NODE_5992_length_1036_cov_6.913554	424	504	2	9	80	0.1125000
NODE_5992_length_1036_cov_6.913554	424	504	4	19	80	0.2375000
NODE_5992_length_1036_cov_6.913554	424	504	6	12	80	0.1500000
NODE_5992_length_1036_cov_6.913554	424	504	7	3	80	0.0375000
NODE_5992_length_1036_cov_6.913554	424	504	8	9	80	0.1125000
NODE_5992_length_1036_cov_6.913554	424	504	9	16	80	0.2000000
NODE_5992_length_1036_cov_6.913554	424	504	10	12	80	0.1500000
NODE_5992_length_1036_cov_6.913554	477	557	8	9	80	0.1125000
NODE_5992_length_1036_cov_6.913554	477	557	9	37	80	0.4625000
NODE_5992_length_1036_cov_6.913554	477	557	10	24	80	0.3000000
NODE_5992_length_1036_cov_6.913554	477	557	11	10	80	0.1250000
NODE_5993_length_1036_cov_5.880470	436	516	2	16	80	0.2000000
NODE_5993_length_1036_cov_5.880470	436	516	3	16	80	0.2000000
NODE_5993_length_1036_cov_5.880470	436	516	4	42	80	0.5250000
NODE_5993_length_1036_cov_5.880470	436	516	5	6	80	0.0750000
NODE_5993_length_1036_cov_5.880470	489	569	2	56	80	0.7000000
NODE_5993_length_1036_cov_5.880470	489	569	4	24	80	0.3000000
NODE_5994_length_1036_cov_4.638207	531	611	1	12	80	0.1500000
NODE_5994_length_1036_cov_4.638207	531	611	2	68	80	0.8500000
NODE_5994_length_1036_cov_4.638207	584	664	1	5	80	0.0625000
NODE_5994_length_1036_cov_4.638207	584	664	2	75	80	0.9375000
NODE_5998_length_1036_cov_1.293490	19	69	0	50	50	1.0000000
NODE_6001_length_1035_cov_31.941239	590	670	4	35	80	0.4375000
NODE_6001_length_1035_cov_31.941239	590	670	6	34	80	0.4250000
NODE_6001_length_1035_cov_31.941239	590	670	7	11	80	0.1375000
NODE_6001_length_1035_cov_31.941239	643	723	4	30	80	0.3750000
NODE_6001_length_1035_cov_31.941239	643	723	5	49	80	0.6125000
NODE_6001_length_1035_cov_31.941239	643	723	6	1	80	0.0125000
NODE_6002_length_1035_cov_14.917735	396	476	0	4	80	0.0500000
NODE_6002_length_1035_cov_14.917735	396	476	2	76	80	0.9500000
NODE_6002_length_1035_cov_14.917735	449	529	0	57	80	0.7125000
NODE_6002_length_1035_cov_14.917735	449	529	2	23	80	0.2875000
NODE_6003_length_1035_cov_12.552350	467	547	5	26	80	0.3250000
NODE_6003_length_1035_cov_12.552350	467	547	6	54	80	0.6750000
NODE_6003_length_1035_cov_12.552350	520	600	3	26	80	0.3250000
NODE_6003_length_1035_cov_12.552350	520	600	4	22	80	0.2750000
NODE_6003_length_1035_cov_12.552350	520	600	6	32	80	0.4000000
NODE_6004_length_1035_cov_12.050214	40	103	1	49	63	0.7777778
NODE_6004_length_1035_cov_12.050214	40	103	6	6	63	0.0952381
NODE_6004_length_1035_cov_12.050214	40	103	7	8	63	0.1269841
NODE_6004_length_1035_cov_12.050214	138	219	2	4	81	0.0493827
NODE_6004_length_1035_cov_12.050214	138	219	3	6	81	0.0740741
NODE_6004_length_1035_cov_12.050214	138	219	5	7	81	0.0864198
NODE_6004_length_1035_cov_12.050214	138	219	7	4	81	0.0493827
NODE_6004_length_1035_cov_12.050214	138	219	8	6	81	0.0740741
NODE_6004_length_1035_cov_12.050214	138	219	10	8	81	0.0987654
NODE_6004_length_1035_cov_12.050214	138	219	11	46	81	0.5679013
NODE_6005_length_1035_cov_7.020299	350	430	4	4	80	0.0500000
NODE_6005_length_1035_cov_7.020299	350	430	6	19	80	0.2375000
NODE_6005_length_1035_cov_7.020299	350	430	7	37	80	0.4625000
NODE_6005_length_1035_cov_7.020299	350	430	8	20	80	0.2500000
NODE_6005_length_1035_cov_7.020299	403	483	3	13	80	0.1625000
NODE_6005_length_1035_cov_7.020299	403	483	4	25	80	0.3125000
NODE_6005_length_1035_cov_7.020299	403	483	6	29	80	0.3625000
NODE_6005_length_1035_cov_7.020299	403	483	7	7	80	0.0875000
NODE_6005_length_1035_cov_7.020299	403	483	8	6	80	0.0750000
NODE_6006_length_1035_cov_4.726496	531	611	0	7	80	0.0875000
NODE_6006_length_1035_cov_4.726496	531	611	1	73	80	0.9125000
NODE_6006_length_1035_cov_4.726496	584	664	0	7	80	0.0875000
NODE_6006_length_1035_cov_4.726496	584	664	1	37	80	0.4625000
NODE_6006_length_1035_cov_4.726496	584	664	2	36	80	0.4500000
NODE_6018_length_1034_cov_26.810695	322	402	6	21	80	0.2625000
NODE_6018_length_1034_cov_26.810695	322	402	7	28	80	0.3500000
NODE_6018_length_1034_cov_26.810695	322	402	10	4	80	0.0500000
NODE_6018_length_1034_cov_26.810695	322	402	11	6	80	0.0750000
NODE_6018_length_1034_cov_26.810695	322	402	12	17	80	0.2125000
NODE_6018_length_1034_cov_26.810695	322	402	13	4	80	0.0500000
NODE_6018_length_1034_cov_26.810695	375	455	8	24	80	0.3000000
NODE_6018_length_1034_cov_26.810695	375	455	9	13	80	0.1625000
NODE_6018_length_1034_cov_26.810695	375	455	11	21	80	0.2625000
NODE_6018_length_1034_cov_26.810695	375	455	12	18	80	0.2250000
NODE_6018_length_1034_cov_26.810695	375	455	13	4	80	0.0500000
NODE_6018_length_1034_cov_26.810695	451	531	5	6	80	0.0750000
NODE_6018_length_1034_cov_26.810695	451	531	6	17	80	0.2125000
NODE_6018_length_1034_cov_26.810695	451	531	7	6	80	0.0750000
NODE_6018_length_1034_cov_26.810695	451	531	8	46	80	0.5750000
NODE_6018_length_1034_cov_26.810695	451	531	9	5	80	0.0625000
NODE_6018_length_1034_cov_26.810695	504	584	3	33	80	0.4125000
NODE_6018_length_1034_cov_26.810695	504	584	4	9	80	0.1125000
NODE_6018_length_1034_cov_26.810695	504	584	5	17	80	0.2125000
NODE_6018_length_1034_cov_26.810695	504	584	7	4	80	0.0500000
NODE_6018_length_1034_cov_26.810695	504	584	8	17	80	0.2125000
NODE_6032_length_1033_cov_42.574946	462	542	3	44	80	0.5500000
NODE_6032_length_1033_cov_42.574946	462	542	5	4	80	0.0500000
NODE_6032_length_1033_cov_42.574946	462	542	6	32	80	0.4000000
NODE_6032_length_1033_cov_42.574946	515	595	4	32	80	0.4000000
NODE_6032_length_1033_cov_42.574946	515	595	5	14	80	0.1750000
NODE_6032_length_1033_cov_42.574946	515	595	6	34	80	0.4250000
NODE_6033_length_1033_cov_17.073876	464	544	0	4	80	0.0500000
NODE_6033_length_1033_cov_17.073876	464	544	3	10	80	0.1250000
NODE_6033_length_1033_cov_17.073876	464	544	6	33	80	0.4125000
NODE_6033_length_1033_cov_17.073876	464	544	7	27	80	0.3375000
NODE_6033_length_1033_cov_17.073876	464	544	8	6	80	0.0750000
NODE_6033_length_1033_cov_17.073876	517	597	4	4	80	0.0500000
NODE_6033_length_1033_cov_17.073876	517	597	6	10	80	0.1250000
NODE_6033_length_1033_cov_17.073876	517	597	7	21	80	0.2625000
NODE_6033_length_1033_cov_17.073876	517	597	8	45	80	0.5625000
NODE_6034_length_1033_cov_15.791221	309	386	3	10	77	0.1298701
NODE_6034_length_1033_cov_15.791221	309	386	4	15	77	0.1948052
NODE_6034_length_1033_cov_15.791221	309	386	5	28	77	0.3636364
NODE_6034_length_1033_cov_15.791221	309	386	6	1	77	0.0129870
NODE_6034_length_1033_cov_15.791221	309	386	9	7	77	0.0909091
NODE_6034_length_1033_cov_15.791221	309	386	10	16	77	0.2077922
NODE_6034_length_1033_cov_15.791221	359	439	5	3	80	0.0375000
NODE_6034_length_1033_cov_15.791221	359	439	6	1	80	0.0125000
NODE_6034_length_1033_cov_15.791221	359	439	9	7	80	0.0875000
NODE_6034_length_1033_cov_15.791221	359	439	10	20	80	0.2500000
NODE_6034_length_1033_cov_15.791221	359	439	11	30	80	0.3750000
NODE_6034_length_1033_cov_15.791221	359	439	12	19	80	0.2375000
NODE_6035_length_1033_cov_11.340471	437	517	4	67	80	0.8375000
NODE_6035_length_1033_cov_11.340471	437	517	5	13	80	0.1625000
NODE_6035_length_1033_cov_11.340471	490	570	2	3	80	0.0375000
NODE_6035_length_1033_cov_11.340471	490	570	3	18	80	0.2250000
NODE_6035_length_1033_cov_11.340471	490	570	4	46	80	0.5750000
NODE_6035_length_1033_cov_11.340471	490	570	5	13	80	0.1625000
NODE_6045_length_1032_cov_56.511254	466	546	15	11	80	0.1375000
NODE_6045_length_1032_cov_56.511254	466	546	16	2	80	0.0250000
NODE_6045_length_1032_cov_56.511254	466	546	17	29	80	0.3625000
NODE_6045_length_1032_cov_56.511254	466	546	18	4	80	0.0500000
NODE_6045_length_1032_cov_56.511254	466	546	19	20	80	0.2500000
NODE_6045_length_1032_cov_56.511254	466	546	20	14	80	0.1750000
NODE_6045_length_1032_cov_56.511254	519	599	13	8	80	0.1000000
NODE_6045_length_1032_cov_56.511254	519	599	15	18	80	0.2250000
NODE_6045_length_1032_cov_56.511254	519	599	16	3	80	0.0375000
NODE_6045_length_1032_cov_56.511254	519	599	17	13	80	0.1625000
NODE_6045_length_1032_cov_56.511254	519	599	18	15	80	0.1875000
NODE_6045_length_1032_cov_56.511254	519	599	19	20	80	0.2500000
NODE_6045_length_1032_cov_56.511254	519	599	20	3	80	0.0375000
NODE_6046_length_1032_cov_20.752412	479	559	3	17	80	0.2125000
NODE_6046_length_1032_cov_20.752412	479	559	7	5	80	0.0625000
NODE_6046_length_1032_cov_20.752412	479	559	8	6	80	0.0750000
NODE_6046_length_1032_cov_20.752412	479	559	9	50	80	0.6250000
NODE_6046_length_1032_cov_20.752412	479	559	10	2	80	0.0250000
NODE_6046_length_1032_cov_20.752412	532	612	5	8	80	0.1000000
NODE_6046_length_1032_cov_20.752412	532	612	9	70	80	0.8750000
NODE_6046_length_1032_cov_20.752412	532	612	10	2	80	0.0250000
NODE_6047_length_1032_cov_8.166131	257	337	0	80	80	1.0000000
NODE_6047_length_1032_cov_8.166131	310	390	0	80	80	1.0000000
NODE_6048_length_1032_cov_7.991426	277	357	2	5	80	0.0625000
NODE_6048_length_1032_cov_7.991426	277	357	3	23	80	0.2875000
NODE_6048_length_1032_cov_7.991426	277	357	4	43	80	0.5375000
NODE_6048_length_1032_cov_7.991426	277	357	5	9	80	0.1125000
NODE_6048_length_1032_cov_7.991426	330	410	4	18	80	0.2250000
NODE_6048_length_1032_cov_7.991426	330	410	5	26	80	0.3250000
NODE_6048_length_1032_cov_7.991426	330	410	6	19	80	0.2375000
NODE_6048_length_1032_cov_7.991426	330	410	7	17	80	0.2125000
NODE_6049_length_1032_cov_5.276527	371	451	0	80	80	1.0000000
NODE_6049_length_1032_cov_5.276527	424	504	0	80	80	1.0000000
NODE_6055_length_1031_cov_71.154506	586	654	17	16	68	0.2352941
NODE_6055_length_1031_cov_71.154506	586	654	18	3	68	0.0441176
NODE_6055_length_1031_cov_71.154506	586	654	20	1	68	0.0147059
NODE_6055_length_1031_cov_71.154506	586	654	22	1	68	0.0147059
NODE_6055_length_1031_cov_71.154506	586	654	23	2	68	0.0294118
NODE_6055_length_1031_cov_71.154506	586	654	24	1	68	0.0147059
NODE_6055_length_1031_cov_71.154506	586	654	25	1	68	0.0147059
NODE_6055_length_1031_cov_71.154506	586	654	26	12	68	0.1764706
NODE_6055_length_1031_cov_71.154506	586	654	27	21	68	0.3088235
NODE_6055_length_1031_cov_71.154506	586	654	28	3	68	0.0441176
NODE_6055_length_1031_cov_71.154506	586	654	29	7	68	0.1029412
NODE_6055_length_1031_cov_71.154506	616	696	23	11	80	0.1375000
NODE_6055_length_1031_cov_71.154506	616	696	26	7	80	0.0875000
NODE_6055_length_1031_cov_71.154506	616	696	27	21	80	0.2625000
NODE_6055_length_1031_cov_71.154506	616	696	28	3	80	0.0375000
NODE_6055_length_1031_cov_71.154506	616	696	29	34	80	0.4250000
NODE_6055_length_1031_cov_71.154506	616	696	30	3	80	0.0375000
NODE_6055_length_1031_cov_71.154506	616	696	31	1	80	0.0125000
NODE_6055_length_1031_cov_71.154506	669	749	8	10	80	0.1250000
NODE_6055_length_1031_cov_71.154506	669	749	9	4	80	0.0500000
NODE_6055_length_1031_cov_71.154506	669	749	10	2	80	0.0250000
NODE_6055_length_1031_cov_71.154506	669	749	11	1	80	0.0125000
NODE_6055_length_1031_cov_71.154506	669	749	13	5	80	0.0625000
NODE_6055_length_1031_cov_71.154506	669	749	14	3	80	0.0375000
NODE_6055_length_1031_cov_71.154506	669	749	15	3	80	0.0375000
NODE_6055_length_1031_cov_71.154506	669	749	16	1	80	0.0125000
NODE_6055_length_1031_cov_71.154506	669	749	17	3	80	0.0375000
NODE_6055_length_1031_cov_71.154506	669	749	18	1	80	0.0125000
NODE_6055_length_1031_cov_71.154506	669	749	19	1	80	0.0125000
NODE_6055_length_1031_cov_71.154506	669	749	20	9	80	0.1125000
NODE_6055_length_1031_cov_71.154506	669	749	21	6	80	0.0750000
NODE_6055_length_1031_cov_71.154506	669	749	23	15	80	0.1875000
NODE_6055_length_1031_cov_71.154506	669	749	29	12	80	0.1500000
NODE_6055_length_1031_cov_71.154506	669	749	30	3	80	0.0375000
NODE_6055_length_1031_cov_71.154506	669	749	31	1	80	0.0125000
NODE_6056_length_1031_cov_70.221030	409	489	10	25	80	0.3125000
NODE_6056_length_1031_cov_70.221030	409	489	11	14	80	0.1750000
NODE_6056_length_1031_cov_70.221030	409	489	12	22	80	0.2750000
NODE_6056_length_1031_cov_70.221030	409	489	13	5	80	0.0625000
NODE_6056_length_1031_cov_70.221030	409	489	14	1	80	0.0125000
NODE_6056_length_1031_cov_70.221030	409	489	16	13	80	0.1625000
NODE_6056_length_1031_cov_70.221030	462	542	12	8	80	0.1000000
NODE_6056_length_1031_cov_70.221030	462	542	13	5	80	0.0625000
NODE_6056_length_1031_cov_70.221030	462	542	14	1	80	0.0125000
NODE_6056_length_1031_cov_70.221030	462	542	16	21	80	0.2625000
NODE_6056_length_1031_cov_70.221030	462	542	18	1	80	0.0125000
NODE_6056_length_1031_cov_70.221030	462	542	19	15	80	0.1875000
NODE_6056_length_1031_cov_70.221030	462	542	20	18	80	0.2250000
NODE_6056_length_1031_cov_70.221030	462	542	21	11	80	0.1375000
NODE_6056_length_1031_cov_70.221030	538	618	10	5	80	0.0625000
NODE_6056_length_1031_cov_70.221030	538	618	12	1	80	0.0125000
NODE_6056_length_1031_cov_70.221030	538	618	13	4	80	0.0500000
NODE_6056_length_1031_cov_70.221030	538	618	14	2	80	0.0250000
NODE_6056_length_1031_cov_70.221030	538	618	15	29	80	0.3625000
NODE_6056_length_1031_cov_70.221030	538	618	16	1	80	0.0125000
NODE_6056_length_1031_cov_70.221030	538	618	17	17	80	0.2125000
NODE_6056_length_1031_cov_70.221030	538	618	18	13	80	0.1625000
NODE_6056_length_1031_cov_70.221030	538	618	19	4	80	0.0500000
NODE_6056_length_1031_cov_70.221030	538	618	20	4	80	0.0500000
NODE_6056_length_1031_cov_70.221030	591	671	4	4	80	0.0500000
NODE_6056_length_1031_cov_70.221030	591	671	5	7	80	0.0875000
NODE_6056_length_1031_cov_70.221030	591	671	7	6	80	0.0750000
NODE_6056_length_1031_cov_70.221030	591	671	8	7	80	0.0875000
NODE_6056_length_1031_cov_70.221030	591	671	9	22	80	0.2750000
NODE_6056_length_1031_cov_70.221030	591	671	10	12	80	0.1500000
NODE_6056_length_1031_cov_70.221030	591	671	12	1	80	0.0125000
NODE_6056_length_1031_cov_70.221030	591	671	13	4	80	0.0500000
NODE_6056_length_1031_cov_70.221030	591	671	14	2	80	0.0250000
NODE_6056_length_1031_cov_70.221030	591	671	15	14	80	0.1750000
NODE_6056_length_1031_cov_70.221030	591	671	16	1	80	0.0125000
NODE_6057_length_1031_cov_43.618026	462	542	0	4	80	0.0500000
NODE_6057_length_1031_cov_43.618026	462	542	2	76	80	0.9500000
NODE_6057_length_1031_cov_43.618026	515	595	0	57	80	0.7125000
NODE_6057_length_1031_cov_43.618026	515	595	2	23	80	0.2875000
NODE_6058_length_1031_cov_43.581545	303	383	1	80	80	1.0000000
NODE_6058_length_1031_cov_43.581545	356	436	1	80	80	1.0000000
NODE_6058_length_1031_cov_43.581545	432	512	0	17	80	0.2125000
NODE_6058_length_1031_cov_43.581545	432	512	1	15	80	0.1875000
NODE_6058_length_1031_cov_43.581545	432	512	2	6	80	0.0750000
NODE_6058_length_1031_cov_43.581545	432	512	3	42	80	0.5250000
NODE_6058_length_1031_cov_43.581545	485	565	1	14	80	0.1750000
NODE_6058_length_1031_cov_43.581545	485	565	3	66	80	0.8250000
NODE_6059_length_1031_cov_22.310086	382	462	4	23	80	0.2875000
NODE_6059_length_1031_cov_22.310086	382	462	5	6	80	0.0750000
NODE_6059_length_1031_cov_22.310086	382	462	6	1	80	0.0125000
NODE_6059_length_1031_cov_22.310086	382	462	7	23	80	0.2875000
NODE_6059_length_1031_cov_22.310086	382	462	8	27	80	0.3375000
NODE_6059_length_1031_cov_22.310086	435	515	4	9	80	0.1125000
NODE_6059_length_1031_cov_22.310086	435	515	5	14	80	0.1750000
NODE_6059_length_1031_cov_22.310086	435	515	6	18	80	0.2250000
NODE_6059_length_1031_cov_22.310086	435	515	7	35	80	0.4375000
NODE_6059_length_1031_cov_22.310086	435	515	8	4	80	0.0500000
NODE_6060_length_1031_cov_11.547210	481	561	4	2	80	0.0250000
NODE_6060_length_1031_cov_11.547210	481	561	5	60	80	0.7500000
NODE_6060_length_1031_cov_11.547210	481	561	6	13	80	0.1625000
NODE_6060_length_1031_cov_11.547210	481	561	7	5	80	0.0625000
NODE_6060_length_1031_cov_11.547210	534	614	3	42	80	0.5250000
NODE_6060_length_1031_cov_11.547210	534	614	5	31	80	0.3875000
NODE_6060_length_1031_cov_11.547210	534	614	6	2	80	0.0250000
NODE_6060_length_1031_cov_11.547210	534	614	7	5	80	0.0625000
NODE_6066_length_1030_cov_54.380236	363	443	5	38	80	0.4750000
NODE_6066_length_1030_cov_54.380236	363	443	7	14	80	0.1750000
NODE_6066_length_1030_cov_54.380236	363	443	8	1	80	0.0125000
NODE_6066_length_1030_cov_54.380236	363	443	9	17	80	0.2125000
NODE_6066_length_1030_cov_54.380236	363	443	10	10	80	0.1250000
NODE_6066_length_1030_cov_54.380236	416	496	8	15	80	0.1875000
NODE_6066_length_1030_cov_54.380236	416	496	9	21	80	0.2625000
NODE_6066_length_1030_cov_54.380236	416	496	10	28	80	0.3500000
NODE_6066_length_1030_cov_54.380236	416	496	11	16	80	0.2000000
NODE_6066_length_1030_cov_54.380236	492	572	8	8	80	0.1000000
NODE_6066_length_1030_cov_54.380236	492	572	9	5	80	0.0625000
NODE_6066_length_1030_cov_54.380236	492	572	11	20	80	0.2500000
NODE_6066_length_1030_cov_54.380236	492	572	12	8	80	0.1000000
NODE_6066_length_1030_cov_54.380236	492	572	13	39	80	0.4875000
NODE_6066_length_1030_cov_54.380236	545	625	9	20	80	0.2500000
NODE_6066_length_1030_cov_54.380236	545	625	10	20	80	0.2500000
NODE_6066_length_1030_cov_54.380236	545	625	11	19	80	0.2375000
NODE_6066_length_1030_cov_54.380236	545	625	12	6	80	0.0750000
NODE_6066_length_1030_cov_54.380236	545	625	13	15	80	0.1875000
NODE_6067_length_1030_cov_45.040816	334	414	4	18	80	0.2250000
NODE_6067_length_1030_cov_45.040816	334	414	5	6	80	0.0750000
NODE_6067_length_1030_cov_45.040816	334	414	6	6	80	0.0750000
NODE_6067_length_1030_cov_45.040816	334	414	8	12	80	0.1500000
NODE_6067_length_1030_cov_45.040816	334	414	9	14	80	0.1750000
NODE_6067_length_1030_cov_45.040816	334	414	10	24	80	0.3000000
NODE_6067_length_1030_cov_45.040816	387	467	4	25	80	0.3125000
NODE_6067_length_1030_cov_45.040816	387	467	5	46	80	0.5750000
NODE_6067_length_1030_cov_45.040816	387	467	6	9	80	0.1125000
NODE_6067_length_1030_cov_45.040816	463	543	5	33	80	0.4125000
NODE_6067_length_1030_cov_45.040816	463	543	6	19	80	0.2375000
NODE_6067_length_1030_cov_45.040816	463	543	7	28	80	0.3500000
NODE_6067_length_1030_cov_45.040816	516	596	7	28	80	0.3500000
NODE_6067_length_1030_cov_45.040816	516	596	8	40	80	0.5000000
NODE_6067_length_1030_cov_45.040816	516	596	9	12	80	0.1500000
NODE_6068_length_1030_cov_20.491944	511	591	7	2	80	0.0250000
NODE_6068_length_1030_cov_20.491944	511	591	8	7	80	0.0875000
NODE_6068_length_1030_cov_20.491944	511	591	9	38	80	0.4750000
NODE_6068_length_1030_cov_20.491944	511	591	10	33	80	0.4125000
NODE_6068_length_1030_cov_20.491944	564	644	3	13	80	0.1625000
NODE_6068_length_1030_cov_20.491944	564	644	4	3	80	0.0375000
NODE_6068_length_1030_cov_20.491944	564	644	5	3	80	0.0375000
NODE_6068_length_1030_cov_20.491944	564	644	6	30	80	0.3750000
NODE_6068_length_1030_cov_20.491944	564	644	7	6	80	0.0750000
NODE_6068_length_1030_cov_20.491944	564	644	9	18	80	0.2250000
NODE_6068_length_1030_cov_20.491944	564	644	10	7	80	0.0875000
NODE_6069_length_1030_cov_17.253491	524	604	0	80	80	1.0000000
NODE_6069_length_1030_cov_17.253491	577	657	0	80	80	1.0000000
NODE_6070_length_1030_cov_14.337272	564	644	5	28	80	0.3500000
NODE_6070_length_1030_cov_14.337272	564	644	6	27	80	0.3375000
NODE_6070_length_1030_cov_14.337272	564	644	7	25	80	0.3125000
NODE_6070_length_1030_cov_14.337272	617	697	4	2	80	0.0250000
NODE_6070_length_1030_cov_14.337272	617	697	5	15	80	0.1875000
NODE_6070_length_1030_cov_14.337272	617	697	6	38	80	0.4750000
NODE_6070_length_1030_cov_14.337272	617	697	7	25	80	0.3125000
NODE_6071_length_1030_cov_5.742213	474	554	2	80	80	1.0000000
NODE_6071_length_1030_cov_5.742213	527	607	0	3	80	0.0375000
NODE_6071_length_1030_cov_5.742213	527	607	1	41	80	0.5125000
NODE_6071_length_1030_cov_5.742213	527	607	2	36	80	0.4500000
NODE_6073_length_1030_cov_5.208378	978	1030	0	52	52	1.0000000
NODE_6077_length_1030_cov_2.146079	979	1010	0	31	31	1.0000000
NODE_6083_length_1029_cov_236.527957	584	666	8	10	82	0.1219512
NODE_6083_length_1029_cov_236.527957	584	666	12	1	82	0.0121951
NODE_6083_length_1029_cov_236.527957	584	666	13	12	82	0.1463415
NODE_6083_length_1029_cov_236.527957	584	666	14	8	82	0.0975610
NODE_6083_length_1029_cov_236.527957	584	666	15	3	82	0.0365854
NODE_6083_length_1029_cov_236.527957	584	666	17	5	82	0.0609756
NODE_6083_length_1029_cov_236.527957	584	666	18	2	82	0.0243902
NODE_6083_length_1029_cov_236.527957	584	666	19	11	82	0.1341463
NODE_6083_length_1029_cov_236.527957	584	666	21	30	82	0.3658537
NODE_6083_length_1029_cov_236.527957	639	702	4	6	63	0.0952381
NODE_6083_length_1029_cov_236.527957	639	702	6	1	63	0.0158730
NODE_6083_length_1029_cov_236.527957	639	702	7	3	63	0.0476190
NODE_6083_length_1029_cov_236.527957	639	702	8	36	63	0.5714286
NODE_6083_length_1029_cov_236.527957	639	702	12	1	63	0.0158730
NODE_6083_length_1029_cov_236.527957	639	702	13	12	63	0.1904762
NODE_6083_length_1029_cov_236.527957	639	702	14	4	63	0.0634921
NODE_6084_length_1029_cov_41.650538	364	444	4	7	80	0.0875000
NODE_6084_length_1029_cov_41.650538	364	444	5	27	80	0.3375000
NODE_6084_length_1029_cov_41.650538	364	444	6	32	80	0.4000000
NODE_6084_length_1029_cov_41.650538	364	444	7	14	80	0.1750000
NODE_6084_length_1029_cov_41.650538	417	497	4	3	80	0.0375000
NODE_6084_length_1029_cov_41.650538	417	497	5	8	80	0.1000000
NODE_6084_length_1029_cov_41.650538	417	497	6	24	80	0.3000000
NODE_6084_length_1029_cov_41.650538	417	497	8	7	80	0.0875000
NODE_6084_length_1029_cov_41.650538	417	497	9	1	80	0.0125000
NODE_6084_length_1029_cov_41.650538	417	497	10	14	80	0.1750000
NODE_6084_length_1029_cov_41.650538	417	497	11	5	80	0.0625000
NODE_6084_length_1029_cov_41.650538	417	497	12	2	80	0.0250000
NODE_6084_length_1029_cov_41.650538	417	497	13	16	80	0.2000000
NODE_6084_length_1029_cov_41.650538	493	573	12	3	80	0.0375000
NODE_6084_length_1029_cov_41.650538	493	573	13	32	80	0.4000000
NODE_6084_length_1029_cov_41.650538	493	573	14	17	80	0.2125000
NODE_6084_length_1029_cov_41.650538	493	573	15	28	80	0.3500000
NODE_6084_length_1029_cov_41.650538	546	626	4	5	80	0.0625000
NODE_6084_length_1029_cov_41.650538	546	626	5	9	80	0.1125000
NODE_6084_length_1029_cov_41.650538	546	626	7	2	80	0.0250000
NODE_6084_length_1029_cov_41.650538	546	626	8	1	80	0.0125000
NODE_6084_length_1029_cov_41.650538	546	626	11	27	80	0.3375000
NODE_6084_length_1029_cov_41.650538	546	626	12	12	80	0.1500000
NODE_6084_length_1029_cov_41.650538	546	626	13	20	80	0.2500000
NODE_6084_length_1029_cov_41.650538	546	626	15	4	80	0.0500000
NODE_6085_length_1029_cov_34.940860	314	360	1	22	46	0.4782609
NODE_6085_length_1029_cov_34.940860	314	360	2	20	46	0.4347826
NODE_6085_length_1029_cov_34.940860	314	360	3	4	46	0.0869565
NODE_6085_length_1029_cov_34.940860	371	451	3	17	80	0.2125000
NODE_6085_length_1029_cov_34.940860	371	451	4	2	80	0.0250000
NODE_6085_length_1029_cov_34.940860	371	451	5	11	80	0.1375000
NODE_6085_length_1029_cov_34.940860	371	451	6	15	80	0.1875000
NODE_6085_length_1029_cov_34.940860	371	451	7	11	80	0.1375000
NODE_6085_length_1029_cov_34.940860	371	451	8	3	80	0.0375000
NODE_6085_length_1029_cov_34.940860	371	451	9	21	80	0.2625000
NODE_6085_length_1029_cov_34.940860	424	502	7	4	78	0.0512821
NODE_6085_length_1029_cov_34.940860	424	502	8	53	78	0.6794872
NODE_6085_length_1029_cov_34.940860	424	502	9	21	78	0.2692308
NODE_6086_length_1029_cov_28.752688	255	335	0	9	80	0.1125000
NODE_6086_length_1029_cov_28.752688	255	335	1	21	80	0.2625000
NODE_6086_length_1029_cov_28.752688	255	335	3	3	80	0.0375000
NODE_6086_length_1029_cov_28.752688	255	335	4	47	80	0.5875000
NODE_6086_length_1029_cov_28.752688	308	388	4	49	80	0.6125000
NODE_6086_length_1029_cov_28.752688	308	388	5	18	80	0.2250000
NODE_6086_length_1029_cov_28.752688	308	388	6	13	80	0.1625000
NODE_6086_length_1029_cov_28.752688	384	464	5	25	80	0.3125000
NODE_6086_length_1029_cov_28.752688	384	464	6	19	80	0.2375000
NODE_6086_length_1029_cov_28.752688	384	464	7	36	80	0.4500000
NODE_6086_length_1029_cov_28.752688	437	517	5	16	80	0.2000000
NODE_6086_length_1029_cov_28.752688	437	517	6	2	80	0.0250000
NODE_6086_length_1029_cov_28.752688	437	517	7	62	80	0.7750000
NODE_6087_length_1029_cov_28.523656	409	489	0	2	80	0.0250000
NODE_6087_length_1029_cov_28.523656	409	489	2	13	80	0.1625000
NODE_6087_length_1029_cov_28.523656	409	489	4	65	80	0.8125000
NODE_6087_length_1029_cov_28.523656	462	542	2	11	80	0.1375000
NODE_6087_length_1029_cov_28.523656	462	542	4	69	80	0.8625000
NODE_6088_length_1029_cov_28.283871	281	361	3	15	80	0.1875000
NODE_6088_length_1029_cov_28.283871	281	361	5	26	80	0.3250000
NODE_6088_length_1029_cov_28.283871	281	361	7	29	80	0.3625000
NODE_6088_length_1029_cov_28.283871	281	361	9	10	80	0.1250000
NODE_6088_length_1029_cov_28.283871	334	414	7	25	80	0.3125000
NODE_6088_length_1029_cov_28.283871	334	414	8	5	80	0.0625000
NODE_6088_length_1029_cov_28.283871	334	414	9	36	80	0.4500000
NODE_6088_length_1029_cov_28.283871	334	414	10	14	80	0.1750000
NODE_6088_length_1029_cov_28.283871	410	490	6	44	80	0.5500000
NODE_6088_length_1029_cov_28.283871	410	490	8	7	80	0.0875000
NODE_6088_length_1029_cov_28.283871	410	490	9	14	80	0.1750000
NODE_6088_length_1029_cov_28.283871	410	490	10	15	80	0.1875000
NODE_6088_length_1029_cov_28.283871	463	546	2	6	83	0.0722892
NODE_6088_length_1029_cov_28.283871	463	546	3	41	83	0.4939759
NODE_6088_length_1029_cov_28.283871	463	546	4	3	83	0.0361446
NODE_6088_length_1029_cov_28.283871	463	546	6	33	83	0.3975904
NODE_6089_length_1029_cov_26.883871	434	514	8	32	80	0.4000000
NODE_6089_length_1029_cov_26.883871	434	514	9	31	80	0.3875000
NODE_6089_length_1029_cov_26.883871	434	514	10	1	80	0.0125000
NODE_6089_length_1029_cov_26.883871	434	514	11	2	80	0.0250000
NODE_6089_length_1029_cov_26.883871	434	514	12	14	80	0.1750000
NODE_6089_length_1029_cov_26.883871	487	567	5	1	80	0.0125000
NODE_6089_length_1029_cov_26.883871	487	567	6	39	80	0.4875000
NODE_6089_length_1029_cov_26.883871	487	567	7	12	80	0.1500000
NODE_6089_length_1029_cov_26.883871	487	567	8	28	80	0.3500000
NODE_6090_length_1029_cov_23.552688	305	385	8	14	80	0.1750000
NODE_6090_length_1029_cov_23.552688	305	385	9	29	80	0.3625000
NODE_6090_length_1029_cov_23.552688	305	385	10	26	80	0.3250000
NODE_6090_length_1029_cov_23.552688	305	385	11	11	80	0.1375000
NODE_6090_length_1029_cov_23.552688	358	438	8	50	80	0.6250000
NODE_6090_length_1029_cov_23.552688	358	438	9	19	80	0.2375000
NODE_6090_length_1029_cov_23.552688	358	438	10	8	80	0.1000000
NODE_6090_length_1029_cov_23.552688	358	438	11	3	80	0.0375000
NODE_6090_length_1029_cov_23.552688	434	514	3	12	80	0.1500000
NODE_6090_length_1029_cov_23.552688	434	514	5	7	80	0.0875000
NODE_6090_length_1029_cov_23.552688	434	514	6	13	80	0.1625000
NODE_6090_length_1029_cov_23.552688	434	514	8	16	80	0.2000000
NODE_6090_length_1029_cov_23.552688	434	514	9	9	80	0.1125000
NODE_6090_length_1029_cov_23.552688	434	514	10	23	80	0.2875000
NODE_6090_length_1029_cov_23.552688	487	567	3	20	80	0.2500000
NODE_6090_length_1029_cov_23.552688	487	567	4	45	80	0.5625000
NODE_6090_length_1029_cov_23.552688	487	567	5	7	80	0.0875000
NODE_6090_length_1029_cov_23.552688	487	567	6	8	80	0.1000000
NODE_6091_length_1029_cov_22.520430	434	514	1	17	80	0.2125000
NODE_6091_length_1029_cov_22.520430	434	514	2	7	80	0.0875000
NODE_6091_length_1029_cov_22.520430	434	514	3	56	80	0.7000000
NODE_6091_length_1029_cov_22.520430	487	567	1	4	80	0.0500000
NODE_6091_length_1029_cov_22.520430	487	567	2	3	80	0.0375000
NODE_6091_length_1029_cov_22.520430	487	567	3	73	80	0.9125000
NODE_6092_length_1029_cov_21.924731	335	415	10	3	80	0.0375000
NODE_6092_length_1029_cov_21.924731	335	415	11	20	80	0.2500000
NODE_6092_length_1029_cov_21.924731	335	415	12	12	80	0.1500000
NODE_6092_length_1029_cov_21.924731	335	415	13	12	80	0.1500000
NODE_6092_length_1029_cov_21.924731	335	415	14	30	80	0.3750000
NODE_6092_length_1029_cov_21.924731	335	415	15	3	80	0.0375000
NODE_6092_length_1029_cov_21.924731	388	468	2	7	80	0.0875000
NODE_6092_length_1029_cov_21.924731	388	468	3	2	80	0.0250000
NODE_6092_length_1029_cov_21.924731	388	468	4	2	80	0.0250000
NODE_6092_length_1029_cov_21.924731	388	468	5	29	80	0.3625000
NODE_6092_length_1029_cov_21.924731	388	468	6	2	80	0.0250000
NODE_6092_length_1029_cov_21.924731	388	468	7	1	80	0.0125000
NODE_6092_length_1029_cov_21.924731	388	468	8	6	80	0.0750000
NODE_6092_length_1029_cov_21.924731	388	468	9	1	80	0.0125000
NODE_6092_length_1029_cov_21.924731	388	468	10	6	80	0.0750000
NODE_6092_length_1029_cov_21.924731	388	468	11	13	80	0.1625000
NODE_6092_length_1029_cov_21.924731	388	468	12	11	80	0.1375000
NODE_6093_length_1029_cov_17.101075	501	581	0	4	80	0.0500000
NODE_6093_length_1029_cov_17.101075	501	581	1	25	80	0.3125000
NODE_6093_length_1029_cov_17.101075	501	581	2	1	80	0.0125000
NODE_6093_length_1029_cov_17.101075	501	581	3	35	80	0.4375000
NODE_6093_length_1029_cov_17.101075	501	581	4	15	80	0.1875000
NODE_6093_length_1029_cov_17.101075	554	634	3	12	80	0.1500000
NODE_6093_length_1029_cov_17.101075	554	634	4	35	80	0.4375000
NODE_6093_length_1029_cov_17.101075	554	634	5	24	80	0.3000000
NODE_6093_length_1029_cov_17.101075	554	634	6	8	80	0.1000000
NODE_6093_length_1029_cov_17.101075	554	634	8	1	80	0.0125000
NODE_6093_length_1029_cov_17.101075	630	710	5	29	80	0.3625000
NODE_6093_length_1029_cov_17.101075	630	710	6	4	80	0.0500000
NODE_6093_length_1029_cov_17.101075	630	710	7	22	80	0.2750000
NODE_6093_length_1029_cov_17.101075	630	710	8	25	80	0.3125000
NODE_6093_length_1029_cov_17.101075	683	755	1	4	72	0.0555556
NODE_6093_length_1029_cov_17.101075	683	755	2	1	72	0.0138889
NODE_6093_length_1029_cov_17.101075	683	755	4	34	72	0.4722222
NODE_6093_length_1029_cov_17.101075	683	755	5	33	72	0.4583333
NODE_6094_length_1029_cov_14.052688	405	485	2	13	80	0.1625000
NODE_6094_length_1029_cov_14.052688	405	485	3	55	80	0.6875000
NODE_6094_length_1029_cov_14.052688	405	485	4	12	80	0.1500000
NODE_6094_length_1029_cov_14.052688	458	538	3	15	80	0.1875000
NODE_6094_length_1029_cov_14.052688	458	538	4	65	80	0.8125000
NODE_6095_length_1029_cov_11.119355	291	369	3	76	78	0.9743590
NODE_6095_length_1029_cov_11.119355	291	369	4	2	78	0.0256410
NODE_6095_length_1029_cov_11.119355	342	422	1	40	80	0.5000000
NODE_6095_length_1029_cov_11.119355	342	422	2	10	80	0.1250000
NODE_6095_length_1029_cov_11.119355	342	422	3	25	80	0.3125000
NODE_6095_length_1029_cov_11.119355	342	422	4	5	80	0.0625000
NODE_6097_length_1029_cov_3.850538	231	311	0	80	80	1.0000000
NODE_6097_length_1029_cov_3.850538	284	364	0	31	80	0.3875000
NODE_6097_length_1029_cov_3.850538	284	364	2	49	80	0.6125000
NODE_6104_length_1028_cov_19.625404	495	575	3	45	80	0.5625000
NODE_6104_length_1028_cov_19.625404	495	575	4	35	80	0.4375000
NODE_6104_length_1028_cov_19.625404	548	628	1	8	80	0.1000000
NODE_6104_length_1028_cov_19.625404	548	628	2	19	80	0.2375000
NODE_6104_length_1028_cov_19.625404	548	628	4	53	80	0.6625000
NODE_6105_length_1028_cov_17.497309	533	613	6	29	80	0.3625000
NODE_6105_length_1028_cov_17.497309	533	613	7	51	80	0.6375000
NODE_6105_length_1028_cov_17.497309	586	666	2	17	80	0.2125000
NODE_6105_length_1028_cov_17.497309	586	666	4	10	80	0.1250000
NODE_6105_length_1028_cov_17.497309	586	666	5	4	80	0.0500000
NODE_6105_length_1028_cov_17.497309	586	666	6	6	80	0.0750000
NODE_6105_length_1028_cov_17.497309	586	666	7	43	80	0.5375000
NODE_6106_length_1028_cov_16.528525	497	577	4	51	80	0.6375000
NODE_6106_length_1028_cov_16.528525	497	577	6	29	80	0.3625000
NODE_6106_length_1028_cov_16.528525	550	630	2	43	80	0.5375000
NODE_6106_length_1028_cov_16.528525	550	630	3	3	80	0.0375000
NODE_6106_length_1028_cov_16.528525	550	630	4	34	80	0.4250000
NODE_6107_length_1028_cov_10.212056	463	543	2	45	80	0.5625000
NODE_6107_length_1028_cov_10.212056	463	543	3	35	80	0.4375000
NODE_6107_length_1028_cov_10.212056	516	596	1	24	80	0.3000000
NODE_6107_length_1028_cov_10.212056	516	596	2	7	80	0.0875000
NODE_6107_length_1028_cov_10.212056	516	596	3	49	80	0.6125000
NODE_6108_length_1028_cov_10.131324	399	479	1	2	80	0.0250000
NODE_6108_length_1028_cov_10.131324	399	479	2	25	80	0.3125000
NODE_6108_length_1028_cov_10.131324	399	479	3	53	80	0.6625000
NODE_6108_length_1028_cov_10.131324	452	532	1	7	80	0.0875000
NODE_6108_length_1028_cov_10.131324	452	532	2	58	80	0.7250000
NODE_6108_length_1028_cov_10.131324	452	532	3	15	80	0.1875000
NODE_6109_length_1028_cov_9.773950	482	562	5	18	80	0.2250000
NODE_6109_length_1028_cov_9.773950	482	562	7	33	80	0.4125000
NODE_6109_length_1028_cov_9.773950	482	562	8	1	80	0.0125000
NODE_6109_length_1028_cov_9.773950	482	562	9	28	80	0.3500000
NODE_6109_length_1028_cov_9.773950	535	615	6	8	80	0.1000000
NODE_6109_length_1028_cov_9.773950	535	615	7	33	80	0.4125000
NODE_6109_length_1028_cov_9.773950	535	615	9	39	80	0.4875000
NODE_6110_length_1028_cov_8.079656	399	479	1	80	80	1.0000000
NODE_6110_length_1028_cov_8.079656	452	532	0	10	80	0.1250000
NODE_6110_length_1028_cov_8.079656	452	532	1	70	80	0.8750000
NODE_6111_length_1028_cov_7.092573	439	519	0	67	80	0.8375000
NODE_6111_length_1028_cov_7.092573	439	519	2	13	80	0.1625000
NODE_6111_length_1028_cov_7.092573	492	572	0	14	80	0.1750000
NODE_6111_length_1028_cov_7.092573	492	572	2	66	80	0.8250000
NODE_6112_length_1028_cov_4.727664	416	488	5	6	72	0.0833333
NODE_6112_length_1028_cov_4.727664	416	488	7	10	72	0.1388889
NODE_6112_length_1028_cov_4.727664	416	488	8	21	72	0.2916667
NODE_6112_length_1028_cov_4.727664	416	488	9	35	72	0.4861111
NODE_6112_length_1028_cov_4.727664	461	541	1	48	80	0.6000000
NODE_6112_length_1028_cov_4.727664	461	541	3	2	80	0.0250000
NODE_6112_length_1028_cov_4.727664	461	541	5	9	80	0.1125000
NODE_6112_length_1028_cov_4.727664	461	541	7	8	80	0.1000000
NODE_6112_length_1028_cov_4.727664	461	541	8	13	80	0.1625000
NODE_6125_length_1027_cov_51.341595	399	479	0	80	80	1.0000000
NODE_6125_length_1027_cov_51.341595	452	532	0	31	80	0.3875000
NODE_6125_length_1027_cov_51.341595	452	532	1	28	80	0.3500000
NODE_6125_length_1027_cov_51.341595	452	532	2	21	80	0.2625000
NODE_6125_length_1027_cov_51.341595	528	608	2	17	80	0.2125000
NODE_6125_length_1027_cov_51.341595	528	608	3	6	80	0.0750000
NODE_6125_length_1027_cov_51.341595	528	608	4	9	80	0.1125000
NODE_6125_length_1027_cov_51.341595	528	608	5	18	80	0.2250000
NODE_6125_length_1027_cov_51.341595	528	608	8	13	80	0.1625000
NODE_6125_length_1027_cov_51.341595	528	608	9	17	80	0.2125000
NODE_6125_length_1027_cov_51.341595	581	661	8	10	80	0.1250000
NODE_6125_length_1027_cov_51.341595	581	661	9	59	80	0.7375000
NODE_6125_length_1027_cov_51.341595	581	661	10	11	80	0.1375000
NODE_6126_length_1027_cov_45.613147	347	427	0	66	80	0.8250000
NODE_6126_length_1027_cov_45.613147	347	427	1	14	80	0.1750000
NODE_6126_length_1027_cov_45.613147	400	480	0	13	80	0.1625000
NODE_6126_length_1027_cov_45.613147	400	480	1	17	80	0.2125000
NODE_6126_length_1027_cov_45.613147	400	480	2	36	80	0.4500000
NODE_6126_length_1027_cov_45.613147	400	480	4	14	80	0.1750000
NODE_6126_length_1027_cov_45.613147	476	556	4	64	80	0.8000000
NODE_6126_length_1027_cov_45.613147	476	556	5	6	80	0.0750000
NODE_6126_length_1027_cov_45.613147	476	556	6	10	80	0.1250000
NODE_6126_length_1027_cov_45.613147	529	609	4	11	80	0.1375000
NODE_6126_length_1027_cov_45.613147	529	609	5	21	80	0.2625000
NODE_6126_length_1027_cov_45.613147	529	609	6	46	80	0.5750000
NODE_6126_length_1027_cov_45.613147	529	609	7	2	80	0.0250000
NODE_6127_length_1027_cov_35.435345	431	511	2	50	80	0.6250000
NODE_6127_length_1027_cov_35.435345	431	511	3	10	80	0.1250000
NODE_6127_length_1027_cov_35.435345	431	511	4	20	80	0.2500000
NODE_6127_length_1027_cov_35.435345	484	564	3	61	80	0.7625000
NODE_6127_length_1027_cov_35.435345	484	564	4	17	80	0.2125000
NODE_6127_length_1027_cov_35.435345	484	564	5	2	80	0.0250000
NODE_6135_length_1026_cov_39.737864	374	454	3	8	80	0.1000000
NODE_6135_length_1026_cov_39.737864	374	454	5	20	80	0.2500000
NODE_6135_length_1026_cov_39.737864	374	454	7	13	80	0.1625000
NODE_6135_length_1026_cov_39.737864	374	454	9	1	80	0.0125000
NODE_6135_length_1026_cov_39.737864	374	454	10	4	80	0.0500000
NODE_6135_length_1026_cov_39.737864	374	454	12	15	80	0.1875000
NODE_6135_length_1026_cov_39.737864	374	454	13	19	80	0.2375000
NODE_6135_length_1026_cov_39.737864	427	509	9	16	82	0.1951219
NODE_6135_length_1026_cov_39.737864	427	509	11	12	82	0.1463415
NODE_6135_length_1026_cov_39.737864	427	509	12	30	82	0.3658537
NODE_6135_length_1026_cov_39.737864	427	509	13	24	82	0.2926829
NODE_6135_length_1026_cov_39.737864	505	585	7	22	80	0.2750000
NODE_6135_length_1026_cov_39.737864	505	585	8	41	80	0.5125000
NODE_6135_length_1026_cov_39.737864	505	585	9	13	80	0.1625000
NODE_6135_length_1026_cov_39.737864	505	585	10	4	80	0.0500000
NODE_6135_length_1026_cov_39.737864	558	638	5	13	80	0.1625000
NODE_6135_length_1026_cov_39.737864	558	638	6	40	80	0.5000000
NODE_6135_length_1026_cov_39.737864	558	638	7	19	80	0.2375000
NODE_6135_length_1026_cov_39.737864	558	638	8	8	80	0.1000000
NODE_6136_length_1026_cov_26.400216	423	503	1	13	80	0.1625000
NODE_6136_length_1026_cov_26.400216	423	503	2	67	80	0.8375000
NODE_6136_length_1026_cov_26.400216	476	556	1	30	80	0.3750000
NODE_6136_length_1026_cov_26.400216	476	556	2	50	80	0.6250000
NODE_6137_length_1026_cov_25.325782	477	557	0	25	80	0.3125000
NODE_6137_length_1026_cov_25.325782	477	557	2	25	80	0.3125000
NODE_6137_length_1026_cov_25.325782	477	557	3	1	80	0.0125000
NODE_6137_length_1026_cov_25.325782	477	557	4	29	80	0.3625000
NODE_6137_length_1026_cov_25.325782	530	610	2	14	80	0.1750000
NODE_6137_length_1026_cov_25.325782	530	610	4	66	80	0.8250000
NODE_6137_length_1026_cov_25.325782	606	686	0	5	80	0.0625000
NODE_6137_length_1026_cov_25.325782	606	686	1	1	80	0.0125000
NODE_6137_length_1026_cov_25.325782	606	686	2	74	80	0.9250000
NODE_6137_length_1026_cov_25.325782	659	739	0	58	80	0.7250000
NODE_6137_length_1026_cov_25.325782	659	739	1	1	80	0.0125000
NODE_6137_length_1026_cov_25.325782	659	739	2	21	80	0.2625000
NODE_6138_length_1026_cov_22.218986	408	488	12	2	80	0.0250000
NODE_6138_length_1026_cov_22.218986	408	488	14	14	80	0.1750000
NODE_6138_length_1026_cov_22.218986	408	488	15	54	80	0.6750000
NODE_6138_length_1026_cov_22.218986	408	488	16	10	80	0.1250000
NODE_6138_length_1026_cov_22.218986	461	541	4	12	80	0.1500000
NODE_6138_length_1026_cov_22.218986	461	541	5	3	80	0.0375000
NODE_6138_length_1026_cov_22.218986	461	541	6	10	80	0.1250000
NODE_6138_length_1026_cov_22.218986	461	541	7	2	80	0.0250000
NODE_6138_length_1026_cov_22.218986	461	541	10	14	80	0.1750000
NODE_6138_length_1026_cov_22.218986	461	541	12	14	80	0.1750000
NODE_6138_length_1026_cov_22.218986	461	541	14	3	80	0.0375000
NODE_6138_length_1026_cov_22.218986	461	541	15	22	80	0.2750000
NODE_6138_length_1026_cov_22.218986	537	617	0	12	80	0.1500000
NODE_6138_length_1026_cov_22.218986	537	617	1	21	80	0.2625000
NODE_6138_length_1026_cov_22.218986	537	617	2	25	80	0.3125000
NODE_6138_length_1026_cov_22.218986	537	617	3	4	80	0.0500000
NODE_6138_length_1026_cov_22.218986	537	617	4	18	80	0.2250000
NODE_6138_length_1026_cov_22.218986	590	670	0	65	80	0.8125000
NODE_6138_length_1026_cov_22.218986	590	670	1	15	80	0.1875000
NODE_6139_length_1026_cov_15.640777	450	530	2	1	80	0.0125000
NODE_6139_length_1026_cov_15.640777	450	530	3	58	80	0.7250000
NODE_6139_length_1026_cov_15.640777	450	530	4	21	80	0.2625000
NODE_6139_length_1026_cov_15.640777	503	583	2	2	80	0.0250000
NODE_6139_length_1026_cov_15.640777	503	583	3	26	80	0.3250000
NODE_6139_length_1026_cov_15.640777	503	583	4	52	80	0.6500000
NODE_6140_length_1026_cov_12.062567	165	245	4	7	80	0.0875000
NODE_6140_length_1026_cov_12.062567	165	245	5	35	80	0.4375000
NODE_6140_length_1026_cov_12.062567	165	245	6	4	80	0.0500000
NODE_6140_length_1026_cov_12.062567	165	245	7	17	80	0.2125000
NODE_6140_length_1026_cov_12.062567	165	245	8	1	80	0.0125000
NODE_6140_length_1026_cov_12.062567	165	245	10	8	80	0.1000000
NODE_6140_length_1026_cov_12.062567	165	245	11	5	80	0.0625000
NODE_6140_length_1026_cov_12.062567	165	245	12	3	80	0.0375000
NODE_6140_length_1026_cov_12.062567	218	298	6	4	80	0.0500000
NODE_6140_length_1026_cov_12.062567	218	298	7	10	80	0.1250000
NODE_6140_length_1026_cov_12.062567	218	298	8	8	80	0.1000000
NODE_6140_length_1026_cov_12.062567	218	298	10	8	80	0.1000000
NODE_6140_length_1026_cov_12.062567	218	298	11	5	80	0.0625000
NODE_6140_length_1026_cov_12.062567	218	298	12	45	80	0.5625000
NODE_6142_length_1026_cov_5.002157	335	415	0	80	80	1.0000000
NODE_6142_length_1026_cov_5.002157	388	468	0	80	80	1.0000000
NODE_6155_length_1025_cov_52.053996	366	446	3	13	80	0.1625000
NODE_6155_length_1025_cov_52.053996	366	446	4	67	80	0.8375000
NODE_6155_length_1025_cov_52.053996	419	499	4	58	80	0.7250000
NODE_6155_length_1025_cov_52.053996	419	499	6	12	80	0.1500000
NODE_6155_length_1025_cov_52.053996	419	499	7	8	80	0.1000000
NODE_6155_length_1025_cov_52.053996	419	499	8	2	80	0.0250000
NODE_6155_length_1025_cov_52.053996	495	575	7	16	80	0.2000000
NODE_6155_length_1025_cov_52.053996	495	575	8	53	80	0.6625000
NODE_6155_length_1025_cov_52.053996	495	575	9	11	80	0.1375000
NODE_6155_length_1025_cov_52.053996	548	628	7	12	80	0.1500000
NODE_6155_length_1025_cov_52.053996	548	628	8	50	80	0.6250000
NODE_6155_length_1025_cov_52.053996	548	628	9	14	80	0.1750000
NODE_6155_length_1025_cov_52.053996	548	628	10	4	80	0.0500000
NODE_6156_length_1025_cov_35.980562	318	375	7	17	57	0.2982456
NODE_6156_length_1025_cov_35.980562	318	375	8	30	57	0.5263158
NODE_6156_length_1025_cov_35.980562	318	375	10	9	57	0.1578947
NODE_6156_length_1025_cov_35.980562	318	375	11	1	57	0.0175439
NODE_6156_length_1025_cov_35.980562	348	428	8	17	80	0.2125000
NODE_6156_length_1025_cov_35.980562	348	428	10	34	80	0.4250000
NODE_6156_length_1025_cov_35.980562	348	428	11	3	80	0.0375000
NODE_6156_length_1025_cov_35.980562	348	428	12	3	80	0.0375000
NODE_6156_length_1025_cov_35.980562	348	428	14	23	80	0.2875000
NODE_6156_length_1025_cov_35.980562	425	482	8	21	57	0.3684210
NODE_6156_length_1025_cov_35.980562	425	482	9	6	57	0.1052632
NODE_6156_length_1025_cov_35.980562	425	482	10	11	57	0.1929825
NODE_6156_length_1025_cov_35.980562	425	482	12	1	57	0.0175439
NODE_6156_length_1025_cov_35.980562	425	482	13	5	57	0.0877193
NODE_6156_length_1025_cov_35.980562	425	482	14	13	57	0.2280702
NODE_6156_length_1025_cov_35.980562	455	521	1	8	66	0.1212121
NODE_6156_length_1025_cov_35.980562	455	521	3	1	66	0.0151515
NODE_6156_length_1025_cov_35.980562	455	521	5	13	66	0.1969697
NODE_6156_length_1025_cov_35.980562	455	521	7	14	66	0.2121212
NODE_6156_length_1025_cov_35.980562	455	521	8	24	66	0.3636364
NODE_6156_length_1025_cov_35.980562	455	521	9	6	66	0.0909091
NODE_6157_length_1025_cov_26.954644	607	687	7	4	80	0.0500000
NODE_6157_length_1025_cov_26.954644	607	687	10	30	80	0.3750000
NODE_6157_length_1025_cov_26.954644	607	687	11	20	80	0.2500000
NODE_6157_length_1025_cov_26.954644	607	687	13	5	80	0.0625000
NODE_6157_length_1025_cov_26.954644	607	687	14	4	80	0.0500000
NODE_6157_length_1025_cov_26.954644	607	687	16	17	80	0.2125000
NODE_6157_length_1025_cov_26.954644	660	740	8	18	80	0.2250000
NODE_6157_length_1025_cov_26.954644	660	740	9	3	80	0.0375000
NODE_6157_length_1025_cov_26.954644	660	740	11	4	80	0.0500000
NODE_6157_length_1025_cov_26.954644	660	740	13	10	80	0.1250000
NODE_6157_length_1025_cov_26.954644	660	740	14	20	80	0.2500000
NODE_6157_length_1025_cov_26.954644	660	740	16	25	80	0.3125000
NODE_6158_length_1025_cov_20.576674	428	508	8	19	80	0.2375000
NODE_6158_length_1025_cov_20.576674	428	508	9	15	80	0.1875000
NODE_6158_length_1025_cov_20.576674	428	508	10	46	80	0.5750000
NODE_6158_length_1025_cov_20.576674	481	561	5	15	80	0.1875000
NODE_6158_length_1025_cov_20.576674	481	561	6	3	80	0.0375000
NODE_6158_length_1025_cov_20.576674	481	561	7	8	80	0.1000000
NODE_6158_length_1025_cov_20.576674	481	561	8	15	80	0.1875000
NODE_6158_length_1025_cov_20.576674	481	561	10	39	80	0.4875000
NODE_6159_length_1025_cov_15.525918	415	495	6	33	80	0.4125000
NODE_6159_length_1025_cov_15.525918	415	495	7	29	80	0.3625000
NODE_6159_length_1025_cov_15.525918	415	495	8	12	80	0.1500000
NODE_6159_length_1025_cov_15.525918	415	495	9	6	80	0.0750000
NODE_6159_length_1025_cov_15.525918	468	548	4	29	80	0.3625000
NODE_6159_length_1025_cov_15.525918	468	548	6	16	80	0.2000000
NODE_6159_length_1025_cov_15.525918	468	548	8	29	80	0.3625000
NODE_6159_length_1025_cov_15.525918	468	548	9	6	80	0.0750000
NODE_6160_length_1025_cov_7.044276	240	320	2	41	80	0.5125000
NODE_6160_length_1025_cov_7.044276	240	320	4	39	80	0.4875000
NODE_6161_length_1025_cov_6.688985	334	414	0	57	80	0.7125000
NODE_6161_length_1025_cov_6.688985	334	414	1	23	80	0.2875000
NODE_6161_length_1025_cov_6.688985	387	467	0	4	80	0.0500000
NODE_6161_length_1025_cov_6.688985	387	467	1	66	80	0.8250000
NODE_6161_length_1025_cov_6.688985	387	467	2	8	80	0.1000000
NODE_6161_length_1025_cov_6.688985	387	467	3	2	80	0.0250000
NODE_6170_length_1024_cov_28.681081	264	344	0	80	80	1.0000000
NODE_6170_length_1024_cov_28.681081	317	397	0	80	80	1.0000000
NODE_6170_length_1024_cov_28.681081	393	477	0	81	84	0.9642857
NODE_6170_length_1024_cov_28.681081	393	477	2	3	84	0.0357143
NODE_6171_length_1024_cov_17.922162	324	404	2	24	80	0.3000000
NODE_6171_length_1024_cov_17.922162	324	404	3	56	80	0.7000000
NODE_6171_length_1024_cov_17.922162	377	457	1	42	80	0.5250000
NODE_6171_length_1024_cov_17.922162	377	457	2	7	80	0.0875000
NODE_6171_length_1024_cov_17.922162	377	457	3	31	80	0.3875000
NODE_6173_length_1024_cov_12.018378	368	448	4	19	80	0.2375000
NODE_6173_length_1024_cov_12.018378	368	448	5	1	80	0.0125000
NODE_6173_length_1024_cov_12.018378	368	448	7	6	80	0.0750000
NODE_6173_length_1024_cov_12.018378	368	448	8	5	80	0.0625000
NODE_6173_length_1024_cov_12.018378	368	448	9	49	80	0.6125000
NODE_6173_length_1024_cov_12.018378	421	501	4	12	80	0.1500000
NODE_6173_length_1024_cov_12.018378	421	501	6	7	80	0.0875000
NODE_6173_length_1024_cov_12.018378	421	501	7	35	80	0.4375000
NODE_6173_length_1024_cov_12.018378	421	501	8	5	80	0.0625000
NODE_6173_length_1024_cov_12.018378	421	501	9	21	80	0.2625000
NODE_6174_length_1024_cov_8.800000	517	597	0	26	80	0.3250000
NODE_6174_length_1024_cov_8.800000	517	597	1	47	80	0.5875000
NODE_6174_length_1024_cov_8.800000	517	597	2	7	80	0.0875000
NODE_6174_length_1024_cov_8.800000	570	650	1	20	80	0.2500000
NODE_6174_length_1024_cov_8.800000	570	650	2	60	80	0.7500000
NODE_6175_length_1024_cov_6.207568	318	398	0	80	80	1.0000000
NODE_6175_length_1024_cov_6.207568	371	451	0	80	80	1.0000000
NODE_6178_length_1024_cov_2.468108	274	324	0	50	50	1.0000000
NODE_6178_length_1024_cov_2.468108	274	322	0	48	48	1.0000000
NODE_6178_length_1024_cov_2.468108	274	324	0	50	50	1.0000000
NODE_6178_length_1024_cov_2.468108	274	323	0	49	49	1.0000000
NODE_6178_length_1024_cov_2.468108	274	322	0	48	48	1.0000000
NODE_6185_length_1023_cov_100.366883	441	521	15	3	80	0.0375000
NODE_6185_length_1023_cov_100.366883	441	521	16	6	80	0.0750000
NODE_6185_length_1023_cov_100.366883	441	521	17	4	80	0.0500000
NODE_6185_length_1023_cov_100.366883	441	521	18	1	80	0.0125000
NODE_6185_length_1023_cov_100.366883	441	521	19	20	80	0.2500000
NODE_6185_length_1023_cov_100.366883	441	521	21	9	80	0.1125000
NODE_6185_length_1023_cov_100.366883	441	521	22	34	80	0.4250000
NODE_6185_length_1023_cov_100.366883	441	521	23	3	80	0.0375000
NODE_6185_length_1023_cov_100.366883	494	574	11	11	80	0.1375000
NODE_6185_length_1023_cov_100.366883	494	574	12	3	80	0.0375000
NODE_6185_length_1023_cov_100.366883	494	574	13	31	80	0.3875000
NODE_6185_length_1023_cov_100.366883	494	574	14	3	80	0.0375000
NODE_6185_length_1023_cov_100.366883	494	574	16	4	80	0.0500000
NODE_6185_length_1023_cov_100.366883	494	574	19	12	80	0.1500000
NODE_6185_length_1023_cov_100.366883	494	574	21	1	80	0.0125000
NODE_6185_length_1023_cov_100.366883	494	574	22	15	80	0.1875000
NODE_6186_length_1023_cov_64.271645	349	429	13	7	80	0.0875000
NODE_6186_length_1023_cov_64.271645	349	429	14	6	80	0.0750000
NODE_6186_length_1023_cov_64.271645	349	429	15	2	80	0.0250000
NODE_6186_length_1023_cov_64.271645	349	429	17	5	80	0.0625000
NODE_6186_length_1023_cov_64.271645	349	429	18	10	80	0.1250000
NODE_6186_length_1023_cov_64.271645	349	429	19	14	80	0.1750000
NODE_6186_length_1023_cov_64.271645	349	429	20	36	80	0.4500000
NODE_6186_length_1023_cov_64.271645	402	482	12	1	80	0.0125000
NODE_6186_length_1023_cov_64.271645	402	482	13	2	80	0.0250000
NODE_6186_length_1023_cov_64.271645	402	482	14	9	80	0.1125000
NODE_6186_length_1023_cov_64.271645	402	482	15	1	80	0.0125000
NODE_6186_length_1023_cov_64.271645	402	482	16	14	80	0.1750000
NODE_6186_length_1023_cov_64.271645	402	482	17	6	80	0.0750000
NODE_6186_length_1023_cov_64.271645	402	482	19	1	80	0.0125000
NODE_6186_length_1023_cov_64.271645	402	482	20	44	80	0.5500000
NODE_6186_length_1023_cov_64.271645	402	482	21	2	80	0.0250000
NODE_6186_length_1023_cov_64.271645	478	558	8	15	80	0.1875000
NODE_6186_length_1023_cov_64.271645	478	558	9	9	80	0.1125000
NODE_6186_length_1023_cov_64.271645	478	558	10	18	80	0.2250000
NODE_6186_length_1023_cov_64.271645	478	558	11	22	80	0.2750000
NODE_6186_length_1023_cov_64.271645	478	558	12	5	80	0.0625000
NODE_6186_length_1023_cov_64.271645	478	558	13	8	80	0.1000000
NODE_6186_length_1023_cov_64.271645	478	558	14	3	80	0.0375000
NODE_6186_length_1023_cov_64.271645	531	611	6	1	80	0.0125000
NODE_6186_length_1023_cov_64.271645	531	611	7	9	80	0.1125000
NODE_6186_length_1023_cov_64.271645	531	611	8	21	80	0.2625000
NODE_6186_length_1023_cov_64.271645	531	611	9	7	80	0.0875000
NODE_6186_length_1023_cov_64.271645	531	611	10	22	80	0.2750000
NODE_6186_length_1023_cov_64.271645	531	611	11	20	80	0.2500000
NODE_6187_length_1023_cov_32.695887	318	398	2	7	80	0.0875000
NODE_6187_length_1023_cov_32.695887	318	398	3	13	80	0.1625000
NODE_6187_length_1023_cov_32.695887	318	398	4	60	80	0.7500000
NODE_6187_length_1023_cov_32.695887	371	451	0	16	80	0.2000000
NODE_6187_length_1023_cov_32.695887	371	451	1	25	80	0.3125000
NODE_6187_length_1023_cov_32.695887	371	451	2	19	80	0.2375000
NODE_6187_length_1023_cov_32.695887	371	451	3	13	80	0.1625000
NODE_6187_length_1023_cov_32.695887	371	451	4	7	80	0.0875000
NODE_6187_length_1023_cov_32.695887	447	527	0	80	80	1.0000000
NODE_6187_length_1023_cov_32.695887	500	580	0	80	80	1.0000000
NODE_6188_length_1023_cov_16.244589	601	681	2	57	80	0.7125000
NODE_6188_length_1023_cov_16.244589	601	681	4	23	80	0.2875000
NODE_6188_length_1023_cov_16.244589	654	734	2	4	80	0.0500000
NODE_6188_length_1023_cov_16.244589	654	734	3	19	80	0.2375000
NODE_6188_length_1023_cov_16.244589	654	734	4	52	80	0.6500000
NODE_6188_length_1023_cov_16.244589	654	734	5	5	80	0.0625000
NODE_6189_length_1023_cov_15.876623	371	451	5	2	80	0.0250000
NODE_6189_length_1023_cov_15.876623	371	451	6	50	80	0.6250000
NODE_6189_length_1023_cov_15.876623	371	451	7	1	80	0.0125000
NODE_6189_length_1023_cov_15.876623	371	451	8	27	80	0.3375000
NODE_6189_length_1023_cov_15.876623	424	504	2	10	80	0.1250000
NODE_6189_length_1023_cov_15.876623	424	504	3	9	80	0.1125000
NODE_6189_length_1023_cov_15.876623	424	504	4	34	80	0.4250000
NODE_6189_length_1023_cov_15.876623	424	504	5	2	80	0.0250000
NODE_6189_length_1023_cov_15.876623	424	504	6	17	80	0.2125000
NODE_6189_length_1023_cov_15.876623	424	504	8	8	80	0.1000000
NODE_6189_length_1023_cov_15.876623	500	580	1	18	80	0.2250000
NODE_6189_length_1023_cov_15.876623	500	580	2	54	80	0.6750000
NODE_6189_length_1023_cov_15.876623	500	580	3	8	80	0.1000000
NODE_6189_length_1023_cov_15.876623	553	633	1	18	80	0.2250000
NODE_6189_length_1023_cov_15.876623	553	633	2	26	80	0.3250000
NODE_6189_length_1023_cov_15.876623	553	633	3	36	80	0.4500000
NODE_6190_length_1023_cov_14.678571	555	635	6	21	80	0.2625000
NODE_6190_length_1023_cov_14.678571	555	635	7	59	80	0.7375000
NODE_6190_length_1023_cov_14.678571	608	688	6	11	80	0.1375000
NODE_6190_length_1023_cov_14.678571	608	688	7	60	80	0.7500000
NODE_6190_length_1023_cov_14.678571	608	688	8	9	80	0.1125000
NODE_6191_length_1023_cov_14.443723	406	486	3	35	80	0.4375000
NODE_6191_length_1023_cov_14.443723	406	486	4	7	80	0.0875000
NODE_6191_length_1023_cov_14.443723	406	486	5	38	80	0.4750000
NODE_6191_length_1023_cov_14.443723	459	539	3	25	80	0.3125000
NODE_6191_length_1023_cov_14.443723	459	539	4	33	80	0.4125000
NODE_6191_length_1023_cov_14.443723	459	539	5	22	80	0.2750000
NODE_6192_length_1023_cov_10.984848	590	670	3	65	80	0.8125000
NODE_6192_length_1023_cov_10.984848	590	670	4	15	80	0.1875000
NODE_6192_length_1023_cov_10.984848	643	723	2	41	80	0.5125000
NODE_6192_length_1023_cov_10.984848	643	723	3	39	80	0.4875000
NODE_6202_length_1022_cov_42.952329	555	636	14	3	81	0.0370370
NODE_6202_length_1022_cov_42.952329	555	636	15	77	81	0.9506173
NODE_6202_length_1022_cov_42.952329	555	636	16	1	81	0.0123457
NODE_6202_length_1022_cov_42.952329	609	689	10	2	80	0.0250000
NODE_6202_length_1022_cov_42.952329	609	689	11	28	80	0.3500000
NODE_6202_length_1022_cov_42.952329	609	689	12	7	80	0.0875000
NODE_6202_length_1022_cov_42.952329	609	689	13	2	80	0.0250000
NODE_6202_length_1022_cov_42.952329	609	689	14	9	80	0.1125000
NODE_6202_length_1022_cov_42.952329	609	689	15	27	80	0.3375000
NODE_6202_length_1022_cov_42.952329	609	689	16	5	80	0.0625000
NODE_6202_length_1022_cov_42.952329	685	765	8	56	80	0.7000000
NODE_6202_length_1022_cov_42.952329	685	765	9	4	80	0.0500000
NODE_6202_length_1022_cov_42.952329	685	765	11	11	80	0.1375000
NODE_6202_length_1022_cov_42.952329	685	765	12	6	80	0.0750000
NODE_6202_length_1022_cov_42.952329	685	765	13	3	80	0.0375000
NODE_6202_length_1022_cov_42.952329	738	818	3	8	80	0.1000000
NODE_6202_length_1022_cov_42.952329	738	818	5	5	80	0.0625000
NODE_6202_length_1022_cov_42.952329	738	818	6	18	80	0.2250000
NODE_6202_length_1022_cov_42.952329	738	818	7	11	80	0.1375000
NODE_6202_length_1022_cov_42.952329	738	818	8	38	80	0.4750000
NODE_6203_length_1022_cov_29.949079	510	590	3	12	80	0.1500000
NODE_6203_length_1022_cov_29.949079	510	590	4	20	80	0.2500000
NODE_6203_length_1022_cov_29.949079	510	590	5	6	80	0.0750000
NODE_6203_length_1022_cov_29.949079	510	590	6	12	80	0.1500000
NODE_6203_length_1022_cov_29.949079	510	590	7	9	80	0.1125000
NODE_6203_length_1022_cov_29.949079	510	590	8	18	80	0.2250000
NODE_6203_length_1022_cov_29.949079	510	590	9	3	80	0.0375000
NODE_6203_length_1022_cov_29.949079	563	643	7	6	80	0.0750000
NODE_6203_length_1022_cov_29.949079	563	643	8	18	80	0.2250000
NODE_6203_length_1022_cov_29.949079	563	643	9	8	80	0.1000000
NODE_6203_length_1022_cov_29.949079	563	643	10	6	80	0.0750000
NODE_6203_length_1022_cov_29.949079	563	643	11	42	80	0.5250000
NODE_6204_length_1022_cov_7.672806	461	541	0	41	80	0.5125000
NODE_6204_length_1022_cov_7.672806	461	541	1	39	80	0.4875000
NODE_6204_length_1022_cov_7.672806	514	594	0	80	80	1.0000000
NODE_6213_length_1021_cov_47.379610	341	421	0	8	80	0.1000000
NODE_6213_length_1021_cov_47.379610	341	421	1	7	80	0.0875000
NODE_6213_length_1021_cov_47.379610	341	421	2	45	80	0.5625000
NODE_6213_length_1021_cov_47.379610	341	421	3	20	80	0.2500000
NODE_6213_length_1021_cov_47.379610	394	474	1	5	80	0.0625000
NODE_6213_length_1021_cov_47.379610	394	474	2	2	80	0.0250000
NODE_6213_length_1021_cov_47.379610	394	474	3	59	80	0.7375000
NODE_6213_length_1021_cov_47.379610	394	474	4	14	80	0.1750000
NODE_6213_length_1021_cov_47.379610	470	550	4	27	80	0.3375000
NODE_6213_length_1021_cov_47.379610	470	550	5	1	80	0.0125000
NODE_6213_length_1021_cov_47.379610	470	550	6	45	80	0.5625000
NODE_6213_length_1021_cov_47.379610	470	550	7	7	80	0.0875000
NODE_6213_length_1021_cov_47.379610	523	603	4	52	80	0.6500000
NODE_6213_length_1021_cov_47.379610	523	603	5	2	80	0.0250000
NODE_6213_length_1021_cov_47.379610	523	603	6	19	80	0.2375000
NODE_6213_length_1021_cov_47.379610	523	603	7	7	80	0.0875000
NODE_6214_length_1021_cov_33.255965	588	668	8	7	80	0.0875000
NODE_6214_length_1021_cov_33.255965	588	668	9	5	80	0.0625000
NODE_6214_length_1021_cov_33.255965	588	668	10	35	80	0.4375000
NODE_6214_length_1021_cov_33.255965	588	668	11	2	80	0.0250000
NODE_6214_length_1021_cov_33.255965	588	668	12	3	80	0.0375000
NODE_6214_length_1021_cov_33.255965	588	668	13	5	80	0.0625000
NODE_6214_length_1021_cov_33.255965	588	668	14	23	80	0.2875000
NODE_6214_length_1021_cov_33.255965	641	721	7	14	80	0.1750000
NODE_6214_length_1021_cov_33.255965	641	721	8	29	80	0.3625000
NODE_6214_length_1021_cov_33.255965	641	721	9	11	80	0.1375000
NODE_6214_length_1021_cov_33.255965	641	721	10	11	80	0.1375000
NODE_6214_length_1021_cov_33.255965	641	721	11	2	80	0.0250000
NODE_6214_length_1021_cov_33.255965	641	721	14	13	80	0.1625000
NODE_6227_length_1020_cov_24.565689	485	565	0	80	80	1.0000000
NODE_6227_length_1020_cov_24.565689	538	618	0	80	80	1.0000000
NODE_6228_length_1020_cov_20.825190	395	475	8	15	80	0.1875000
NODE_6228_length_1020_cov_20.825190	395	475	9	31	80	0.3875000
NODE_6228_length_1020_cov_20.825190	395	475	10	32	80	0.4000000
NODE_6228_length_1020_cov_20.825190	395	475	11	2	80	0.0250000
NODE_6228_length_1020_cov_20.825190	448	528	5	32	80	0.4000000
NODE_6228_length_1020_cov_20.825190	448	528	6	8	80	0.1000000
NODE_6228_length_1020_cov_20.825190	448	528	7	6	80	0.0750000
NODE_6228_length_1020_cov_20.825190	448	528	8	7	80	0.0875000
NODE_6228_length_1020_cov_20.825190	448	528	9	3	80	0.0375000
NODE_6228_length_1020_cov_20.825190	448	528	10	22	80	0.2750000
NODE_6228_length_1020_cov_20.825190	448	528	11	2	80	0.0250000
NODE_6229_length_1020_cov_20.305103	285	365	5	24	80	0.3000000
NODE_6229_length_1020_cov_20.305103	285	365	7	1	80	0.0125000
NODE_6229_length_1020_cov_20.305103	285	365	9	27	80	0.3375000
NODE_6229_length_1020_cov_20.305103	285	365	10	28	80	0.3500000
NODE_6229_length_1020_cov_20.305103	338	418	3	9	80	0.1125000
NODE_6229_length_1020_cov_20.305103	338	418	4	15	80	0.1875000
NODE_6229_length_1020_cov_20.305103	338	418	5	53	80	0.6625000
NODE_6229_length_1020_cov_20.305103	338	418	7	1	80	0.0125000
NODE_6229_length_1020_cov_20.305103	338	418	9	2	80	0.0250000
NODE_6229_length_1020_cov_20.305103	414	494	0	65	80	0.8125000
NODE_6229_length_1020_cov_20.305103	414	494	1	9	80	0.1125000
NODE_6229_length_1020_cov_20.305103	414	494	3	6	80	0.0750000
NODE_6229_length_1020_cov_20.305103	467	548	0	81	81	1.0000000
NODE_6230_length_1020_cov_17.919653	408	488	1	4	80	0.0500000
NODE_6230_length_1020_cov_17.919653	408	488	2	37	80	0.4625000
NODE_6230_length_1020_cov_17.919653	408	488	3	39	80	0.4875000
NODE_6230_length_1020_cov_17.919653	461	541	2	43	80	0.5375000
NODE_6230_length_1020_cov_17.919653	461	541	3	37	80	0.4625000
NODE_6231_length_1020_cov_13.972856	436	516	2	2	80	0.0250000
NODE_6231_length_1020_cov_13.972856	436	516	9	2	80	0.0250000
NODE_6231_length_1020_cov_13.972856	436	516	10	51	80	0.6375000
NODE_6231_length_1020_cov_13.972856	436	516	11	4	80	0.0500000
NODE_6231_length_1020_cov_13.972856	436	516	12	21	80	0.2625000
NODE_6231_length_1020_cov_13.972856	489	569	5	16	80	0.2000000
NODE_6231_length_1020_cov_13.972856	489	569	6	1	80	0.0125000
NODE_6231_length_1020_cov_13.972856	489	569	7	1	80	0.0125000
NODE_6231_length_1020_cov_13.972856	489	569	8	1	80	0.0125000
NODE_6231_length_1020_cov_13.972856	489	569	9	5	80	0.0625000
NODE_6231_length_1020_cov_13.972856	489	569	10	18	80	0.2250000
NODE_6231_length_1020_cov_13.972856	489	569	11	7	80	0.0875000
NODE_6231_length_1020_cov_13.972856	489	569	12	31	80	0.3875000
NODE_6232_length_1020_cov_10.472313	407	487	1	37	80	0.4625000
NODE_6232_length_1020_cov_10.472313	407	487	2	8	80	0.1000000
NODE_6232_length_1020_cov_10.472313	407	487	4	35	80	0.4375000
NODE_6232_length_1020_cov_10.472313	460	540	4	80	80	1.0000000
NODE_6235_length_1020_cov_3.707926	821	901	2	35	80	0.4375000
NODE_6235_length_1020_cov_3.707926	821	901	4	45	80	0.5625000
NODE_6235_length_1020_cov_3.707926	874	954	2	58	80	0.7250000
NODE_6235_length_1020_cov_3.707926	874	954	4	22	80	0.2750000
NODE_6238_length_1020_cov_2.648208	0	70	0	70	70	1.0000000
NODE_6238_length_1020_cov_2.648208	43	88	0	45	45	1.0000000
NODE_6248_length_1019_cov_30.164130	476	556	2	5	80	0.0625000
NODE_6248_length_1019_cov_30.164130	476	556	3	10	80	0.1250000
NODE_6248_length_1019_cov_30.164130	476	556	4	5	80	0.0625000
NODE_6248_length_1019_cov_30.164130	476	556	6	10	80	0.1250000
NODE_6248_length_1019_cov_30.164130	476	556	8	50	80	0.6250000
NODE_6248_length_1019_cov_30.164130	529	609	6	1	80	0.0125000
NODE_6248_length_1019_cov_30.164130	529	609	7	31	80	0.3875000
NODE_6248_length_1019_cov_30.164130	529	609	8	48	80	0.6000000
NODE_6248_length_1019_cov_30.164130	605	685	0	1	80	0.0125000
NODE_6248_length_1019_cov_30.164130	605	685	1	6	80	0.0750000
NODE_6248_length_1019_cov_30.164130	605	685	3	6	80	0.0750000
NODE_6248_length_1019_cov_30.164130	605	685	4	13	80	0.1625000
NODE_6248_length_1019_cov_30.164130	605	685	5	4	80	0.0500000
NODE_6248_length_1019_cov_30.164130	605	685	6	38	80	0.4750000
NODE_6248_length_1019_cov_30.164130	605	685	7	12	80	0.1500000
NODE_6248_length_1019_cov_30.164130	658	738	5	2	80	0.0250000
NODE_6248_length_1019_cov_30.164130	658	738	6	18	80	0.2250000
NODE_6248_length_1019_cov_30.164130	658	738	7	56	80	0.7000000
NODE_6248_length_1019_cov_30.164130	658	738	8	4	80	0.0500000
NODE_6249_length_1019_cov_22.845652	343	423	2	17	80	0.2125000
NODE_6249_length_1019_cov_22.845652	343	423	3	63	80	0.7875000
NODE_6249_length_1019_cov_22.845652	396	476	3	80	80	1.0000000
NODE_6249_length_1019_cov_22.845652	472	552	0	37	80	0.4625000
NODE_6249_length_1019_cov_22.845652	472	552	1	32	80	0.4000000
NODE_6249_length_1019_cov_22.845652	472	552	3	11	80	0.1375000
NODE_6249_length_1019_cov_22.845652	525	605	0	80	80	1.0000000
NODE_6250_length_1019_cov_8.098913	523	601	1	9	78	0.1153846
NODE_6250_length_1019_cov_8.098913	523	601	3	8	78	0.1025641
NODE_6250_length_1019_cov_8.098913	523	601	4	27	78	0.3461539
NODE_6250_length_1019_cov_8.098913	523	601	5	34	78	0.4358974
NODE_6250_length_1019_cov_8.098913	574	654	2	8	80	0.1000000
NODE_6250_length_1019_cov_8.098913	574	654	3	11	80	0.1375000
NODE_6250_length_1019_cov_8.098913	574	654	5	61	80	0.7625000
NODE_6251_length_1019_cov_7.896739	423	503	2	80	80	1.0000000
NODE_6251_length_1019_cov_7.896739	476	556	2	80	80	1.0000000
NODE_6252_length_1019_cov_4.597826	625	696	2	32	71	0.4507042
NODE_6252_length_1019_cov_4.597826	625	696	3	39	71	0.5492958
NODE_6263_length_1019_cov_1.139130	89	165	0	15	76	0.1973684
NODE_6263_length_1019_cov_1.139130	89	165	2	61	76	0.8026316
NODE_6265_length_1018_cov_33.494015	212	292	7	19	80	0.2375000
NODE_6265_length_1018_cov_33.494015	212	292	8	22	80	0.2750000
NODE_6265_length_1018_cov_33.494015	212	292	9	39	80	0.4875000
NODE_6265_length_1018_cov_33.494015	265	345	3	19	80	0.2375000
NODE_6265_length_1018_cov_33.494015	265	345	4	15	80	0.1875000
NODE_6265_length_1018_cov_33.494015	265	345	6	5	80	0.0625000
NODE_6265_length_1018_cov_33.494015	265	345	8	23	80	0.2875000
NODE_6265_length_1018_cov_33.494015	265	345	9	18	80	0.2250000
NODE_6266_length_1018_cov_22.776931	372	452	2	10	80	0.1250000
NODE_6266_length_1018_cov_22.776931	372	452	4	65	80	0.8125000
NODE_6266_length_1018_cov_22.776931	372	452	6	5	80	0.0625000
NODE_6266_length_1018_cov_22.776931	425	505	4	75	80	0.9375000
NODE_6266_length_1018_cov_22.776931	425	505	6	5	80	0.0625000
NODE_6268_length_1018_cov_8.486398	404	484	0	80	80	1.0000000
NODE_6268_length_1018_cov_8.486398	457	537	0	80	80	1.0000000
NODE_6270_length_1018_cov_7.737758	357	437	3	12	80	0.1500000
NODE_6270_length_1018_cov_7.737758	357	437	4	5	80	0.0625000
NODE_6270_length_1018_cov_7.737758	357	437	6	36	80	0.4500000
NODE_6270_length_1018_cov_7.737758	357	437	8	27	80	0.3375000
NODE_6270_length_1018_cov_7.737758	410	490	4	38	80	0.4750000
NODE_6270_length_1018_cov_7.737758	410	490	6	42	80	0.5250000
NODE_6286_length_1017_cov_207.523965	0	41	21	7	41	0.1707317
NODE_6286_length_1017_cov_207.523965	0	41	23	5	41	0.1219512
NODE_6286_length_1017_cov_207.523965	0	41	24	4	41	0.0975610
NODE_6286_length_1017_cov_207.523965	0	41	25	5	41	0.1219512
NODE_6286_length_1017_cov_207.523965	0	41	27	3	41	0.0731707
NODE_6286_length_1017_cov_207.523965	0	41	28	1	41	0.0243902
NODE_6286_length_1017_cov_207.523965	0	41	29	1	41	0.0243902
NODE_6286_length_1017_cov_207.523965	0	41	31	13	41	0.3170732
NODE_6286_length_1017_cov_207.523965	0	41	32	1	41	0.0243902
NODE_6286_length_1017_cov_207.523965	0	41	33	1	41	0.0243902
NODE_6286_length_1017_cov_207.523965	14	94	24	2	80	0.0250000
NODE_6286_length_1017_cov_207.523965	14	94	25	5	80	0.0625000
NODE_6286_length_1017_cov_207.523965	14	94	27	3	80	0.0375000
NODE_6286_length_1017_cov_207.523965	14	94	28	1	80	0.0125000
NODE_6286_length_1017_cov_207.523965	14	94	29	1	80	0.0125000
NODE_6286_length_1017_cov_207.523965	14	94	31	13	80	0.1625000
NODE_6286_length_1017_cov_207.523965	14	94	32	1	80	0.0125000
NODE_6286_length_1017_cov_207.523965	14	94	33	4	80	0.0500000
NODE_6286_length_1017_cov_207.523965	14	94	34	6	80	0.0750000
NODE_6286_length_1017_cov_207.523965	14	94	35	1	80	0.0125000
NODE_6286_length_1017_cov_207.523965	14	94	36	16	80	0.2000000
NODE_6286_length_1017_cov_207.523965	14	94	37	1	80	0.0125000
NODE_6286_length_1017_cov_207.523965	14	94	38	3	80	0.0375000
NODE_6286_length_1017_cov_207.523965	14	94	42	1	80	0.0125000
NODE_6286_length_1017_cov_207.523965	14	94	43	3	80	0.0375000
NODE_6286_length_1017_cov_207.523965	14	94	44	3	80	0.0375000
NODE_6286_length_1017_cov_207.523965	14	94	45	7	80	0.0875000
NODE_6286_length_1017_cov_207.523965	14	94	46	9	80	0.1125000
NODE_6287_length_1017_cov_18.824619	490	570	6	51	80	0.6375000
NODE_6287_length_1017_cov_18.824619	490	570	7	21	80	0.2625000
NODE_6287_length_1017_cov_18.824619	490	570	8	8	80	0.1000000
NODE_6287_length_1017_cov_18.824619	543	623	5	32	80	0.4000000
NODE_6287_length_1017_cov_18.824619	543	623	7	42	80	0.5250000
NODE_6287_length_1017_cov_18.824619	543	623	8	6	80	0.0750000
NODE_6288_length_1017_cov_14.794118	428	508	2	9	80	0.1125000
NODE_6288_length_1017_cov_14.794118	428	508	5	4	80	0.0500000
NODE_6288_length_1017_cov_14.794118	428	508	6	34	80	0.4250000
NODE_6288_length_1017_cov_14.794118	428	508	7	33	80	0.4125000
NODE_6288_length_1017_cov_14.794118	481	561	7	36	80	0.4500000
NODE_6288_length_1017_cov_14.794118	481	561	8	20	80	0.2500000
NODE_6288_length_1017_cov_14.794118	481	561	9	24	80	0.3000000
NODE_6288_length_1017_cov_14.794118	557	637	3	29	80	0.3625000
NODE_6288_length_1017_cov_14.794118	557	637	4	4	80	0.0500000
NODE_6288_length_1017_cov_14.794118	557	637	5	5	80	0.0625000
NODE_6288_length_1017_cov_14.794118	557	637	6	12	80	0.1500000
NODE_6288_length_1017_cov_14.794118	557	637	7	12	80	0.1500000
NODE_6288_length_1017_cov_14.794118	557	637	8	12	80	0.1500000
NODE_6288_length_1017_cov_14.794118	557	637	9	6	80	0.0750000
NODE_6288_length_1017_cov_14.794118	610	690	3	10	80	0.1250000
NODE_6288_length_1017_cov_14.794118	610	690	4	3	80	0.0375000
NODE_6288_length_1017_cov_14.794118	610	690	5	25	80	0.3125000
NODE_6288_length_1017_cov_14.794118	610	690	6	42	80	0.5250000
NODE_6297_length_1016_cov_22.267176	577	657	8	10	80	0.1250000
NODE_6297_length_1016_cov_22.267176	577	657	9	6	80	0.0750000
NODE_6297_length_1016_cov_22.267176	577	657	10	64	80	0.8000000
NODE_6297_length_1016_cov_22.267176	630	710	5	20	80	0.2500000
NODE_6297_length_1016_cov_22.267176	630	710	6	27	80	0.3375000
NODE_6297_length_1016_cov_22.267176	630	710	10	33	80	0.4125000
NODE_6298_length_1016_cov_21.134133	625	705	7	40	80	0.5000000
NODE_6298_length_1016_cov_21.134133	625	705	8	15	80	0.1875000
NODE_6298_length_1016_cov_21.134133	625	705	9	25	80	0.3125000
NODE_6298_length_1016_cov_21.134133	678	758	5	4	80	0.0500000
NODE_6298_length_1016_cov_21.134133	678	758	6	10	80	0.1250000
NODE_6298_length_1016_cov_21.134133	678	758	7	50	80	0.6250000
NODE_6298_length_1016_cov_21.134133	678	758	9	16	80	0.2000000
NODE_6299_length_1016_cov_20.392585	504	584	5	25	80	0.3125000
NODE_6299_length_1016_cov_20.392585	504	584	6	39	80	0.4875000
NODE_6299_length_1016_cov_20.392585	504	584	7	16	80	0.2000000
NODE_6299_length_1016_cov_20.392585	557	637	4	12	80	0.1500000
NODE_6299_length_1016_cov_20.392585	557	637	5	30	80	0.3750000
NODE_6299_length_1016_cov_20.392585	557	637	6	34	80	0.4250000
NODE_6299_length_1016_cov_20.392585	557	637	7	4	80	0.0500000
NODE_6299_length_1016_cov_20.392585	633	713	6	24	80	0.3000000
NODE_6299_length_1016_cov_20.392585	633	713	7	48	80	0.6000000
NODE_6299_length_1016_cov_20.392585	633	713	8	8	80	0.1000000
NODE_6299_length_1016_cov_20.392585	686	766	3	23	80	0.2875000
NODE_6299_length_1016_cov_20.392585	686	766	5	2	80	0.0250000
NODE_6299_length_1016_cov_20.392585	686	766	6	41	80	0.5125000
NODE_6299_length_1016_cov_20.392585	686	766	7	6	80	0.0750000
NODE_6299_length_1016_cov_20.392585	686	766	8	8	80	0.1000000
NODE_6300_length_1016_cov_16.917121	524	604	0	16	80	0.2000000
NODE_6300_length_1016_cov_16.917121	524	604	2	45	80	0.5625000
NODE_6300_length_1016_cov_16.917121	524	604	3	19	80	0.2375000
NODE_6300_length_1016_cov_16.917121	577	657	2	9	80	0.1125000
NODE_6300_length_1016_cov_16.917121	577	657	3	47	80	0.5875000
NODE_6300_length_1016_cov_16.917121	577	657	4	24	80	0.3000000
NODE_6301_length_1016_cov_8.243184	438	518	0	80	80	1.0000000
NODE_6301_length_1016_cov_8.243184	491	571	0	80	80	1.0000000
NODE_6301_length_1016_cov_8.243184	567	647	0	80	80	1.0000000
NODE_6301_length_1016_cov_8.243184	620	700	0	80	80	1.0000000
NODE_6302_length_1016_cov_8.141767	166	256	4	1	90	0.0111111
NODE_6302_length_1016_cov_8.141767	166	256	15	13	90	0.1444445
NODE_6302_length_1016_cov_8.141767	166	256	17	18	90	0.2000000
NODE_6302_length_1016_cov_8.141767	166	256	18	2	90	0.0222222
NODE_6302_length_1016_cov_8.141767	166	256	19	3	90	0.0333333
NODE_6302_length_1016_cov_8.141767	166	256	20	15	90	0.1666667
NODE_6302_length_1016_cov_8.141767	166	256	21	8	90	0.0888889
NODE_6302_length_1016_cov_8.141767	166	256	22	11	90	0.1222222
NODE_6302_length_1016_cov_8.141767	166	256	24	19	90	0.2111111
NODE_6303_length_1016_cov_7.466739	576	656	3	22	80	0.2750000
NODE_6303_length_1016_cov_7.466739	576	656	4	8	80	0.1000000
NODE_6303_length_1016_cov_7.466739	576	656	5	2	80	0.0250000
NODE_6303_length_1016_cov_7.466739	576	656	6	48	80	0.6000000
NODE_6303_length_1016_cov_7.466739	629	709	2	30	80	0.3750000
NODE_6303_length_1016_cov_7.466739	629	709	3	45	80	0.5625000
NODE_6303_length_1016_cov_7.466739	629	709	4	5	80	0.0625000
NODE_6318_length_1015_cov_24.680131	459	539	2	2	80	0.0250000
NODE_6318_length_1015_cov_24.680131	459	539	3	78	80	0.9750000
NODE_6318_length_1015_cov_24.680131	512	592	1	50	80	0.6250000
NODE_6318_length_1015_cov_24.680131	512	592	3	30	80	0.3750000
NODE_6318_length_1015_cov_24.680131	588	668	1	26	80	0.3250000
NODE_6318_length_1015_cov_24.680131	588	668	2	24	80	0.3000000
NODE_6318_length_1015_cov_24.680131	588	668	3	30	80	0.3750000
NODE_6318_length_1015_cov_24.680131	641	721	3	80	80	1.0000000
NODE_6319_length_1015_cov_23.198690	407	487	1	61	80	0.7625000
NODE_6319_length_1015_cov_23.198690	407	487	2	18	80	0.2250000
NODE_6319_length_1015_cov_23.198690	407	487	4	1	80	0.0125000
NODE_6319_length_1015_cov_23.198690	460	540	1	26	80	0.3250000
NODE_6319_length_1015_cov_23.198690	460	540	3	22	80	0.2750000
NODE_6319_length_1015_cov_23.198690	460	540	4	29	80	0.3625000
NODE_6319_length_1015_cov_23.198690	460	540	6	3	80	0.0375000
NODE_6319_length_1015_cov_23.198690	536	616	4	1	80	0.0125000
NODE_6319_length_1015_cov_23.198690	536	616	6	43	80	0.5375000
NODE_6319_length_1015_cov_23.198690	536	616	7	23	80	0.2875000
NODE_6319_length_1015_cov_23.198690	536	616	8	13	80	0.1625000
NODE_6319_length_1015_cov_23.198690	589	669	3	5	80	0.0625000
NODE_6319_length_1015_cov_23.198690	589	669	4	8	80	0.1000000
NODE_6319_length_1015_cov_23.198690	589	669	6	55	80	0.6875000
NODE_6319_length_1015_cov_23.198690	589	669	7	6	80	0.0750000
NODE_6319_length_1015_cov_23.198690	589	669	8	6	80	0.0750000
NODE_6320_length_1015_cov_22.544760	490	570	6	20	80	0.2500000
NODE_6320_length_1015_cov_22.544760	490	570	7	15	80	0.1875000
NODE_6320_length_1015_cov_22.544760	490	570	8	34	80	0.4250000
NODE_6320_length_1015_cov_22.544760	490	570	11	11	80	0.1375000
NODE_6320_length_1015_cov_22.544760	543	623	1	19	80	0.2375000
NODE_6320_length_1015_cov_22.544760	543	623	3	19	80	0.2375000
NODE_6320_length_1015_cov_22.544760	543	623	5	9	80	0.1125000
NODE_6320_length_1015_cov_22.544760	543	623	6	16	80	0.2000000
NODE_6320_length_1015_cov_22.544760	543	623	7	15	80	0.1875000
NODE_6320_length_1015_cov_22.544760	543	623	8	2	80	0.0250000
NODE_6321_length_1015_cov_17.994541	510	590	4	7	80	0.0875000
NODE_6321_length_1015_cov_17.994541	510	590	5	1	80	0.0125000
NODE_6321_length_1015_cov_17.994541	510	590	6	1	80	0.0125000
NODE_6321_length_1015_cov_17.994541	510	590	7	33	80	0.4125000
NODE_6321_length_1015_cov_17.994541	510	590	8	1	80	0.0125000
NODE_6321_length_1015_cov_17.994541	510	590	9	3	80	0.0375000
NODE_6321_length_1015_cov_17.994541	510	590	10	1	80	0.0125000
NODE_6321_length_1015_cov_17.994541	510	590	11	6	80	0.0750000
NODE_6321_length_1015_cov_17.994541	510	590	13	13	80	0.1625000
NODE_6321_length_1015_cov_17.994541	510	590	14	14	80	0.1750000
NODE_6321_length_1015_cov_17.994541	563	643	11	2	80	0.0250000
NODE_6321_length_1015_cov_17.994541	563	643	12	40	80	0.5000000
NODE_6321_length_1015_cov_17.994541	563	643	13	20	80	0.2500000
NODE_6321_length_1015_cov_17.994541	563	643	14	18	80	0.2250000
NODE_6322_length_1015_cov_16.594978	437	517	1	25	80	0.3125000
NODE_6322_length_1015_cov_16.594978	437	517	2	55	80	0.6875000
NODE_6322_length_1015_cov_16.594978	490	570	1	24	80	0.3000000
NODE_6322_length_1015_cov_16.594978	490	570	2	56	80	0.7000000
NODE_6323_length_1015_cov_14.000000	505	585	0	56	80	0.7000000
NODE_6323_length_1015_cov_14.000000	505	585	2	24	80	0.3000000
NODE_6323_length_1015_cov_14.000000	558	638	0	3	80	0.0375000
NODE_6323_length_1015_cov_14.000000	558	638	2	77	80	0.9625000
NODE_6324_length_1015_cov_9.978166	345	425	0	80	80	1.0000000
NODE_6324_length_1015_cov_9.978166	398	478	0	75	80	0.9375000
NODE_6324_length_1015_cov_9.978166	398	478	2	5	80	0.0625000
NODE_6325_length_1015_cov_6.844978	393	473	0	80	80	1.0000000
NODE_6325_length_1015_cov_6.844978	446	526	0	80	80	1.0000000
NODE_6337_length_1014_cov_95.709290	259	335	4	8	76	0.1052632
NODE_6337_length_1014_cov_95.709290	259	335	5	25	76	0.3289474
NODE_6337_length_1014_cov_95.709290	259	335	6	28	76	0.3684210
NODE_6337_length_1014_cov_95.709290	259	335	7	2	76	0.0263158
NODE_6337_length_1014_cov_95.709290	259	335	8	11	76	0.1447368
NODE_6337_length_1014_cov_95.709290	259	335	9	2	76	0.0263158
NODE_6337_length_1014_cov_95.709290	310	390	4	4	80	0.0500000
NODE_6337_length_1014_cov_95.709290	310	390	5	5	80	0.0625000
NODE_6337_length_1014_cov_95.709290	310	390	6	1	80	0.0125000
NODE_6337_length_1014_cov_95.709290	310	390	7	2	80	0.0250000
NODE_6337_length_1014_cov_95.709290	310	390	8	11	80	0.1375000
NODE_6337_length_1014_cov_95.709290	310	390	9	28	80	0.3500000
NODE_6337_length_1014_cov_95.709290	310	390	10	11	80	0.1375000
NODE_6337_length_1014_cov_95.709290	310	390	12	18	80	0.2250000
NODE_6337_length_1014_cov_95.709290	386	466	9	9	80	0.1125000
NODE_6337_length_1014_cov_95.709290	386	466	10	1	80	0.0125000
NODE_6337_length_1014_cov_95.709290	386	466	11	32	80	0.4000000
NODE_6337_length_1014_cov_95.709290	386	466	12	4	80	0.0500000
NODE_6337_length_1014_cov_95.709290	386	466	13	3	80	0.0375000
NODE_6337_length_1014_cov_95.709290	386	466	14	18	80	0.2250000
NODE_6337_length_1014_cov_95.709290	386	466	15	13	80	0.1625000
NODE_6337_length_1014_cov_95.709290	439	519	7	8	80	0.1000000
NODE_6337_length_1014_cov_95.709290	439	519	8	28	80	0.3500000
NODE_6337_length_1014_cov_95.709290	439	519	11	13	80	0.1625000
NODE_6337_length_1014_cov_95.709290	439	519	12	1	80	0.0125000
NODE_6337_length_1014_cov_95.709290	439	519	13	1	80	0.0125000
NODE_6337_length_1014_cov_95.709290	439	519	14	16	80	0.2000000
NODE_6337_length_1014_cov_95.709290	439	519	15	13	80	0.1625000
NODE_6338_length_1014_cov_67.918033	182	262	1	13	80	0.1625000
NODE_6338_length_1014_cov_67.918033	182	262	3	12	80	0.1500000
NODE_6338_length_1014_cov_67.918033	182	262	5	3	80	0.0375000
NODE_6338_length_1014_cov_67.918033	182	262	6	16	80	0.2000000
NODE_6338_length_1014_cov_67.918033	182	262	8	1	80	0.0125000
NODE_6338_length_1014_cov_67.918033	182	262	9	9	80	0.1125000
NODE_6338_length_1014_cov_67.918033	182	262	11	1	80	0.0125000
NODE_6338_length_1014_cov_67.918033	182	262	12	1	80	0.0125000
NODE_6338_length_1014_cov_67.918033	182	262	13	8	80	0.1000000
NODE_6338_length_1014_cov_67.918033	182	262	14	2	80	0.0250000
NODE_6338_length_1014_cov_67.918033	182	262	16	3	80	0.0375000
NODE_6338_length_1014_cov_67.918033	182	262	17	11	80	0.1375000
NODE_6338_length_1014_cov_67.918033	235	315	9	1	80	0.0125000
NODE_6338_length_1014_cov_67.918033	235	315	11	1	80	0.0125000
NODE_6338_length_1014_cov_67.918033	235	315	12	1	80	0.0125000
NODE_6338_length_1014_cov_67.918033	235	315	13	8	80	0.1000000
NODE_6338_length_1014_cov_67.918033	235	315	14	2	80	0.0250000
NODE_6338_length_1014_cov_67.918033	235	315	16	3	80	0.0375000
NODE_6338_length_1014_cov_67.918033	235	315	17	15	80	0.1875000
NODE_6338_length_1014_cov_67.918033	235	315	18	2	80	0.0250000
NODE_6338_length_1014_cov_67.918033	235	315	19	4	80	0.0500000
NODE_6338_length_1014_cov_67.918033	235	315	20	13	80	0.1625000
NODE_6338_length_1014_cov_67.918033	235	315	21	9	80	0.1125000
NODE_6338_length_1014_cov_67.918033	235	315	24	1	80	0.0125000
NODE_6338_length_1014_cov_67.918033	235	315	25	17	80	0.2125000
NODE_6338_length_1014_cov_67.918033	235	315	27	3	80	0.0375000
NODE_6338_length_1014_cov_67.918033	311	391	25	4	80	0.0500000
NODE_6338_length_1014_cov_67.918033	311	391	26	1	80	0.0125000
NODE_6338_length_1014_cov_67.918033	311	391	27	27	80	0.3375000
NODE_6338_length_1014_cov_67.918033	311	391	28	21	80	0.2625000
NODE_6338_length_1014_cov_67.918033	311	391	29	8	80	0.1000000
NODE_6338_length_1014_cov_67.918033	311	391	30	11	80	0.1375000
NODE_6338_length_1014_cov_67.918033	311	391	31	8	80	0.1000000
NODE_6338_length_1014_cov_67.918033	364	444	20	2	80	0.0250000
NODE_6338_length_1014_cov_67.918033	364	444	22	7	80	0.0875000
NODE_6338_length_1014_cov_67.918033	364	444	23	13	80	0.1625000
NODE_6338_length_1014_cov_67.918033	364	444	24	4	80	0.0500000
NODE_6338_length_1014_cov_67.918033	364	444	25	6	80	0.0750000
NODE_6338_length_1014_cov_67.918033	364	444	26	16	80	0.2000000
NODE_6338_length_1014_cov_67.918033	364	444	27	15	80	0.1875000
NODE_6338_length_1014_cov_67.918033	364	444	28	13	80	0.1625000
NODE_6338_length_1014_cov_67.918033	364	444	29	2	80	0.0250000
NODE_6338_length_1014_cov_67.918033	364	444	30	2	80	0.0250000
NODE_6339_length_1014_cov_44.802186	418	498	3	30	80	0.3750000
NODE_6339_length_1014_cov_44.802186	418	498	4	50	80	0.6250000
NODE_6339_length_1014_cov_44.802186	471	551	3	10	80	0.1250000
NODE_6339_length_1014_cov_44.802186	471	551	4	70	80	0.8750000
NODE_6340_length_1014_cov_36.349727	369	449	6	65	80	0.8125000
NODE_6340_length_1014_cov_36.349727	369	449	7	15	80	0.1875000
NODE_6340_length_1014_cov_36.349727	422	502	3	12	80	0.1500000
NODE_6340_length_1014_cov_36.349727	422	502	4	28	80	0.3500000
NODE_6340_length_1014_cov_36.349727	422	502	5	3	80	0.0375000
NODE_6340_length_1014_cov_36.349727	422	502	6	32	80	0.4000000
NODE_6340_length_1014_cov_36.349727	422	502	7	5	80	0.0625000
NODE_6340_length_1014_cov_36.349727	498	578	2	35	80	0.4375000
NODE_6340_length_1014_cov_36.349727	498	578	3	45	80	0.5625000
NODE_6340_length_1014_cov_36.349727	551	631	1	13	80	0.1625000
NODE_6340_length_1014_cov_36.349727	551	631	2	14	80	0.1750000
NODE_6340_length_1014_cov_36.349727	551	631	3	53	80	0.6625000
NODE_6341_length_1014_cov_35.547541	363	441	9	18	78	0.2307692
NODE_6341_length_1014_cov_35.547541	363	441	10	5	78	0.0641026
NODE_6341_length_1014_cov_35.547541	363	441	11	6	78	0.0769231
NODE_6341_length_1014_cov_35.547541	363	441	12	5	78	0.0641026
NODE_6341_length_1014_cov_35.547541	363	441	13	4	78	0.0512821
NODE_6341_length_1014_cov_35.547541	363	441	14	3	78	0.0384615
NODE_6341_length_1014_cov_35.547541	363	441	15	10	78	0.1282051
NODE_6341_length_1014_cov_35.547541	363	441	16	24	78	0.3076923
NODE_6341_length_1014_cov_35.547541	363	441	17	2	78	0.0256410
NODE_6341_length_1014_cov_35.547541	363	441	18	1	78	0.0128205
NODE_6341_length_1014_cov_35.547541	416	494	11	5	78	0.0641026
NODE_6341_length_1014_cov_35.547541	416	494	12	2	78	0.0256410
NODE_6341_length_1014_cov_35.547541	416	494	13	9	78	0.1153846
NODE_6341_length_1014_cov_35.547541	416	494	14	7	78	0.0897436
NODE_6341_length_1014_cov_35.547541	416	494	15	3	78	0.0384615
NODE_6341_length_1014_cov_35.547541	416	494	16	26	78	0.3333333
NODE_6341_length_1014_cov_35.547541	416	494	17	5	78	0.0641026
NODE_6341_length_1014_cov_35.547541	416	494	18	21	78	0.2692308
NODE_6342_length_1014_cov_32.266667	428	508	5	73	80	0.9125000
NODE_6342_length_1014_cov_32.266667	428	508	7	7	80	0.0875000
NODE_6342_length_1014_cov_32.266667	481	561	2	26	80	0.3250000
NODE_6342_length_1014_cov_32.266667	481	561	3	20	80	0.2500000
NODE_6342_length_1014_cov_32.266667	481	561	5	34	80	0.4250000
NODE_6343_length_1014_cov_28.493989	480	560	5	5	80	0.0625000
NODE_6343_length_1014_cov_28.493989	480	560	6	16	80	0.2000000
NODE_6343_length_1014_cov_28.493989	480	560	7	28	80	0.3500000
NODE_6343_length_1014_cov_28.493989	480	560	8	7	80	0.0875000
NODE_6343_length_1014_cov_28.493989	480	560	9	24	80	0.3000000
NODE_6343_length_1014_cov_28.493989	533	613	6	8	80	0.1000000
NODE_6343_length_1014_cov_28.493989	533	613	7	17	80	0.2125000
NODE_6343_length_1014_cov_28.493989	533	613	8	18	80	0.2250000
NODE_6343_length_1014_cov_28.493989	533	613	9	37	80	0.4625000
NODE_6343_length_1014_cov_28.493989	609	689	7	4	80	0.0500000
NODE_6343_length_1014_cov_28.493989	609	689	9	6	80	0.0750000
NODE_6343_length_1014_cov_28.493989	609	689	10	33	80	0.4125000
NODE_6343_length_1014_cov_28.493989	609	689	11	27	80	0.3375000
NODE_6343_length_1014_cov_28.493989	609	689	12	10	80	0.1250000
NODE_6343_length_1014_cov_28.493989	662	742	5	43	80	0.5375000
NODE_6343_length_1014_cov_28.493989	662	742	6	2	80	0.0250000
NODE_6343_length_1014_cov_28.493989	662	742	9	6	80	0.0750000
NODE_6343_length_1014_cov_28.493989	662	742	10	27	80	0.3375000
NODE_6343_length_1014_cov_28.493989	662	742	12	2	80	0.0250000
NODE_6344_length_1014_cov_25.171585	500	580	8	10	80	0.1250000
NODE_6344_length_1014_cov_25.171585	500	580	9	9	80	0.1125000
NODE_6344_length_1014_cov_25.171585	500	580	10	45	80	0.5625000
NODE_6344_length_1014_cov_25.171585	500	580	12	14	80	0.1750000
NODE_6344_length_1014_cov_25.171585	500	580	13	2	80	0.0250000
NODE_6344_length_1014_cov_25.171585	553	633	9	8	80	0.1000000
NODE_6344_length_1014_cov_25.171585	553	633	10	8	80	0.1000000
NODE_6344_length_1014_cov_25.171585	553	633	11	20	80	0.2500000
NODE_6344_length_1014_cov_25.171585	553	633	12	28	80	0.3500000
NODE_6344_length_1014_cov_25.171585	553	633	13	16	80	0.2000000
NODE_6345_length_1014_cov_22.437158	534	614	6	24	80	0.3000000
NODE_6345_length_1014_cov_22.437158	534	614	8	47	80	0.5875000
NODE_6345_length_1014_cov_22.437158	534	614	9	9	80	0.1125000
NODE_6345_length_1014_cov_22.437158	587	667	1	1	80	0.0125000
NODE_6345_length_1014_cov_22.437158	587	667	3	25	80	0.3125000
NODE_6345_length_1014_cov_22.437158	587	667	5	9	80	0.1125000
NODE_6345_length_1014_cov_22.437158	587	667	6	12	80	0.1500000
NODE_6345_length_1014_cov_22.437158	587	667	8	24	80	0.3000000
NODE_6345_length_1014_cov_22.437158	587	667	9	9	80	0.1125000
NODE_6346_length_1014_cov_19.238251	379	459	4	23	80	0.2875000
NODE_6346_length_1014_cov_19.238251	379	459	6	32	80	0.4000000
NODE_6346_length_1014_cov_19.238251	379	459	7	12	80	0.1500000
NODE_6346_length_1014_cov_19.238251	379	459	8	13	80	0.1625000
NODE_6346_length_1014_cov_19.238251	432	512	4	49	80	0.6125000
NODE_6346_length_1014_cov_19.238251	432	512	6	6	80	0.0750000
NODE_6346_length_1014_cov_19.238251	432	512	7	12	80	0.1500000
NODE_6346_length_1014_cov_19.238251	432	512	8	13	80	0.1625000
NODE_6346_length_1014_cov_19.238251	508	585	0	18	77	0.2337662
NODE_6346_length_1014_cov_19.238251	508	585	1	5	77	0.0649351
NODE_6346_length_1014_cov_19.238251	508	585	2	16	77	0.2077922
NODE_6346_length_1014_cov_19.238251	508	585	4	38	77	0.4935065
NODE_6346_length_1014_cov_19.238251	558	638	0	6	80	0.0750000
NODE_6346_length_1014_cov_19.238251	558	638	1	5	80	0.0625000
NODE_6346_length_1014_cov_19.238251	558	638	2	69	80	0.8625000
NODE_6347_length_1014_cov_15.926776	594	674	5	47	80	0.5875000
NODE_6347_length_1014_cov_15.926776	594	674	6	8	80	0.1000000
NODE_6347_length_1014_cov_15.926776	594	674	7	6	80	0.0750000
NODE_6347_length_1014_cov_15.926776	594	674	8	13	80	0.1625000
NODE_6347_length_1014_cov_15.926776	594	674	9	6	80	0.0750000
NODE_6347_length_1014_cov_15.926776	647	727	6	2	80	0.0250000
NODE_6347_length_1014_cov_15.926776	647	727	7	7	80	0.0875000
NODE_6347_length_1014_cov_15.926776	647	727	8	34	80	0.4250000
NODE_6347_length_1014_cov_15.926776	647	727	9	7	80	0.0875000
NODE_6347_length_1014_cov_15.926776	647	727	10	30	80	0.3750000
NODE_6348_length_1014_cov_8.691803	285	365	3	14	80	0.1750000
NODE_6348_length_1014_cov_8.691803	285	365	4	29	80	0.3625000
NODE_6348_length_1014_cov_8.691803	285	365	5	37	80	0.4625000
NODE_6348_length_1014_cov_8.691803	338	418	2	3	80	0.0375000
NODE_6348_length_1014_cov_8.691803	338	418	3	63	80	0.7875000
NODE_6348_length_1014_cov_8.691803	338	418	4	14	80	0.1750000
NODE_6349_length_1014_cov_7.959563	531	611	2	27	80	0.3375000
NODE_6349_length_1014_cov_7.959563	531	611	3	14	80	0.1750000
NODE_6349_length_1014_cov_7.959563	531	611	4	39	80	0.4875000
NODE_6349_length_1014_cov_7.959563	584	664	3	34	80	0.4250000
NODE_6349_length_1014_cov_7.959563	584	664	4	46	80	0.5750000
NODE_6351_length_1014_cov_7.608743	298	378	1	12	80	0.1500000
NODE_6351_length_1014_cov_7.608743	298	378	2	17	80	0.2125000
NODE_6351_length_1014_cov_7.608743	298	378	4	51	80	0.6375000
NODE_6351_length_1014_cov_7.608743	351	431	1	26	80	0.3250000
NODE_6351_length_1014_cov_7.608743	351	431	3	18	80	0.2250000
NODE_6351_length_1014_cov_7.608743	351	431	4	36	80	0.4500000
NODE_6352_length_1014_cov_6.209836	321	401	4	36	80	0.4500000
NODE_6352_length_1014_cov_6.209836	321	401	5	4	80	0.0500000
NODE_6352_length_1014_cov_6.209836	321	401	6	30	80	0.3750000
NODE_6352_length_1014_cov_6.209836	321	401	7	10	80	0.1250000
NODE_6352_length_1014_cov_6.209836	374	454	3	1	80	0.0125000
NODE_6352_length_1014_cov_6.209836	374	454	5	48	80	0.6000000
NODE_6352_length_1014_cov_6.209836	374	454	6	31	80	0.3875000
NODE_6364_length_1013_cov_32.695842	423	503	2	17	80	0.2125000
NODE_6364_length_1013_cov_32.695842	423	503	3	14	80	0.1750000
NODE_6364_length_1013_cov_32.695842	423	503	4	34	80	0.4250000
NODE_6364_length_1013_cov_32.695842	423	503	5	15	80	0.1875000
NODE_6364_length_1013_cov_32.695842	476	556	3	2	80	0.0250000
NODE_6364_length_1013_cov_32.695842	476	556	4	17	80	0.2125000
NODE_6364_length_1013_cov_32.695842	476	556	5	17	80	0.2125000
NODE_6364_length_1013_cov_32.695842	476	556	6	41	80	0.5125000
NODE_6364_length_1013_cov_32.695842	476	556	7	3	80	0.0375000
NODE_6364_length_1013_cov_32.695842	552	632	6	20	80	0.2500000
NODE_6364_length_1013_cov_32.695842	552	632	7	11	80	0.1375000
NODE_6364_length_1013_cov_32.695842	552	632	8	35	80	0.4375000
NODE_6364_length_1013_cov_32.695842	552	632	9	14	80	0.1750000
NODE_6364_length_1013_cov_32.695842	605	685	4	20	80	0.2500000
NODE_6364_length_1013_cov_32.695842	605	685	5	3	80	0.0375000
NODE_6364_length_1013_cov_32.695842	605	685	6	17	80	0.2125000
NODE_6364_length_1013_cov_32.695842	605	685	7	17	80	0.2125000
NODE_6364_length_1013_cov_32.695842	605	685	8	10	80	0.1250000
NODE_6364_length_1013_cov_32.695842	605	685	9	13	80	0.1625000
NODE_6365_length_1013_cov_21.935449	424	503	1	29	79	0.3670886
NODE_6365_length_1013_cov_21.935449	424	503	5	50	79	0.6329114
NODE_6365_length_1013_cov_21.935449	476	556	5	80	80	1.0000000
NODE_6366_length_1013_cov_17.532823	440	520	0	9	80	0.1125000
NODE_6366_length_1013_cov_17.532823	440	520	2	13	80	0.1625000
NODE_6366_length_1013_cov_17.532823	440	520	3	58	80	0.7250000
NODE_6366_length_1013_cov_17.532823	493	573	3	43	80	0.5375000
NODE_6366_length_1013_cov_17.532823	493	573	4	37	80	0.4625000
NODE_6367_length_1013_cov_14.555799	478	558	5	53	80	0.6625000
NODE_6367_length_1013_cov_14.555799	478	558	6	20	80	0.2500000
NODE_6367_length_1013_cov_14.555799	478	558	7	7	80	0.0875000
NODE_6367_length_1013_cov_14.555799	531	611	4	20	80	0.2500000
NODE_6367_length_1013_cov_14.555799	531	611	5	9	80	0.1125000
NODE_6367_length_1013_cov_14.555799	531	611	6	48	80	0.6000000
NODE_6367_length_1013_cov_14.555799	531	611	7	3	80	0.0375000
NODE_6368_length_1013_cov_13.142232	476	556	8	5	80	0.0625000
NODE_6368_length_1013_cov_13.142232	476	556	9	5	80	0.0625000
NODE_6368_length_1013_cov_13.142232	476	556	10	7	80	0.0875000
NODE_6368_length_1013_cov_13.142232	476	556	11	21	80	0.2625000
NODE_6368_length_1013_cov_13.142232	476	556	12	6	80	0.0750000
NODE_6368_length_1013_cov_13.142232	476	556	13	19	80	0.2375000
NODE_6368_length_1013_cov_13.142232	476	556	14	17	80	0.2125000
NODE_6368_length_1013_cov_13.142232	529	609	3	19	80	0.2375000
NODE_6368_length_1013_cov_13.142232	529	609	4	18	80	0.2250000
NODE_6368_length_1013_cov_13.142232	529	609	6	6	80	0.0750000
NODE_6368_length_1013_cov_13.142232	529	609	7	4	80	0.0500000
NODE_6368_length_1013_cov_13.142232	529	609	8	11	80	0.1375000
NODE_6368_length_1013_cov_13.142232	529	609	9	5	80	0.0625000
NODE_6368_length_1013_cov_13.142232	529	609	10	7	80	0.0875000
NODE_6368_length_1013_cov_13.142232	529	609	11	10	80	0.1250000
NODE_6369_length_1013_cov_7.756018	538	618	0	18	80	0.2250000
NODE_6369_length_1013_cov_7.756018	538	618	2	62	80	0.7750000
NODE_6369_length_1013_cov_7.756018	591	671	0	32	80	0.4000000
NODE_6369_length_1013_cov_7.756018	591	671	2	48	80	0.6000000
NODE_6371_length_1013_cov_4.368709	550	630	4	38	80	0.4750000
NODE_6371_length_1013_cov_4.368709	550	630	6	42	80	0.5250000
NODE_6371_length_1013_cov_4.368709	603	683	0	6	80	0.0750000
NODE_6371_length_1013_cov_4.368709	603	683	1	1	80	0.0125000
NODE_6371_length_1013_cov_4.368709	603	683	2	22	80	0.2750000
NODE_6371_length_1013_cov_4.368709	603	683	4	37	80	0.4625000
NODE_6371_length_1013_cov_4.368709	603	683	6	14	80	0.1750000
NODE_6380_length_1012_cov_91.547645	378	458	5	18	80	0.2250000
NODE_6380_length_1012_cov_91.547645	378	458	6	18	80	0.2250000
NODE_6380_length_1012_cov_91.547645	378	458	10	6	80	0.0750000
NODE_6380_length_1012_cov_91.547645	378	458	14	1	80	0.0125000
NODE_6380_length_1012_cov_91.547645	378	458	15	1	80	0.0125000
NODE_6380_length_1012_cov_91.547645	378	458	19	4	80	0.0500000
NODE_6380_length_1012_cov_91.547645	378	458	20	7	80	0.0875000
NODE_6380_length_1012_cov_91.547645	378	458	21	5	80	0.0625000
NODE_6380_length_1012_cov_91.547645	378	458	22	1	80	0.0125000
NODE_6380_length_1012_cov_91.547645	378	458	23	19	80	0.2375000
NODE_6380_length_1012_cov_91.547645	431	511	20	9	80	0.1125000
NODE_6380_length_1012_cov_91.547645	431	511	21	18	80	0.2250000
NODE_6380_length_1012_cov_91.547645	431	511	22	24	80	0.3000000
NODE_6380_length_1012_cov_91.547645	431	511	23	29	80	0.3625000
NODE_6380_length_1012_cov_91.547645	507	587	9	4	80	0.0500000
NODE_6380_length_1012_cov_91.547645	507	587	10	7	80	0.0875000
NODE_6380_length_1012_cov_91.547645	507	587	11	6	80	0.0750000
NODE_6380_length_1012_cov_91.547645	507	587	15	1	80	0.0125000
NODE_6380_length_1012_cov_91.547645	507	587	16	4	80	0.0500000
NODE_6380_length_1012_cov_91.547645	507	587	20	1	80	0.0125000
NODE_6380_length_1012_cov_91.547645	507	587	21	6	80	0.0750000
NODE_6380_length_1012_cov_91.547645	507	587	22	18	80	0.2250000
NODE_6380_length_1012_cov_91.547645	507	587	23	18	80	0.2250000
NODE_6380_length_1012_cov_91.547645	507	587	24	15	80	0.1875000
NODE_6380_length_1012_cov_91.547645	560	640	7	36	80	0.4500000
NODE_6380_length_1012_cov_91.547645	560	640	8	16	80	0.2000000
NODE_6380_length_1012_cov_91.547645	560	640	9	4	80	0.0500000
NODE_6380_length_1012_cov_91.547645	560	640	10	8	80	0.1000000
NODE_6380_length_1012_cov_91.547645	560	640	11	6	80	0.0750000
NODE_6380_length_1012_cov_91.547645	560	640	15	1	80	0.0125000
NODE_6380_length_1012_cov_91.547645	560	640	16	4	80	0.0500000
NODE_6380_length_1012_cov_91.547645	560	640	20	1	80	0.0125000
NODE_6380_length_1012_cov_91.547645	560	640	24	4	80	0.0500000
NODE_6381_length_1012_cov_64.409639	345	425	8	8	80	0.1000000
NODE_6381_length_1012_cov_64.409639	345	425	9	6	80	0.0750000
NODE_6381_length_1012_cov_64.409639	345	425	10	13	80	0.1625000
NODE_6381_length_1012_cov_64.409639	345	425	11	35	80	0.4375000
NODE_6381_length_1012_cov_64.409639	345	425	15	18	80	0.2250000
NODE_6381_length_1012_cov_64.409639	398	478	11	19	80	0.2375000
NODE_6381_length_1012_cov_64.409639	398	478	13	31	80	0.3875000
NODE_6381_length_1012_cov_64.409639	398	478	14	1	80	0.0125000
NODE_6381_length_1012_cov_64.409639	398	478	15	29	80	0.3625000
NODE_6382_length_1012_cov_63.035049	438	518	6	10	80	0.1250000
NODE_6382_length_1012_cov_63.035049	438	518	7	2	80	0.0250000
NODE_6382_length_1012_cov_63.035049	438	518	9	38	80	0.4750000
NODE_6382_length_1012_cov_63.035049	438	518	11	30	80	0.3750000
NODE_6382_length_1012_cov_63.035049	491	571	5	1	80	0.0125000
NODE_6382_length_1012_cov_63.035049	491	571	6	22	80	0.2750000
NODE_6382_length_1012_cov_63.035049	491	571	7	18	80	0.2250000
NODE_6382_length_1012_cov_63.035049	491	571	9	39	80	0.4875000
NODE_6383_length_1012_cov_53.686747	276	356	10	25	80	0.3125000
NODE_6383_length_1012_cov_53.686747	276	356	11	54	80	0.6750000
NODE_6383_length_1012_cov_53.686747	276	356	12	1	80	0.0125000
NODE_6383_length_1012_cov_53.686747	329	409	5	1	80	0.0125000
NODE_6383_length_1012_cov_53.686747	329	409	6	9	80	0.1125000
NODE_6383_length_1012_cov_53.686747	329	409	7	21	80	0.2625000
NODE_6383_length_1012_cov_53.686747	329	409	9	4	80	0.0500000
NODE_6383_length_1012_cov_53.686747	329	409	10	32	80	0.4000000
NODE_6383_length_1012_cov_53.686747	329	409	11	13	80	0.1625000
NODE_6383_length_1012_cov_53.686747	405	485	6	1	80	0.0125000
NODE_6383_length_1012_cov_53.686747	405	485	7	43	80	0.5375000
NODE_6383_length_1012_cov_53.686747	405	485	9	6	80	0.0750000
NODE_6383_length_1012_cov_53.686747	405	485	10	4	80	0.0500000
NODE_6383_length_1012_cov_53.686747	405	485	11	5	80	0.0625000
NODE_6383_length_1012_cov_53.686747	405	485	12	7	80	0.0875000
NODE_6383_length_1012_cov_53.686747	405	485	13	2	80	0.0250000
NODE_6383_length_1012_cov_53.686747	405	485	14	1	80	0.0125000
NODE_6383_length_1012_cov_53.686747	405	485	15	2	80	0.0250000
NODE_6383_length_1012_cov_53.686747	405	485	16	9	80	0.1125000
NODE_6383_length_1012_cov_53.686747	458	538	10	1	80	0.0125000
NODE_6383_length_1012_cov_53.686747	458	538	11	5	80	0.0625000
NODE_6383_length_1012_cov_53.686747	458	538	12	17	80	0.2125000
NODE_6383_length_1012_cov_53.686747	458	538	13	2	80	0.0250000
NODE_6383_length_1012_cov_53.686747	458	538	14	6	80	0.0750000
NODE_6383_length_1012_cov_53.686747	458	538	15	2	80	0.0250000
NODE_6383_length_1012_cov_53.686747	458	538	16	20	80	0.2500000
NODE_6383_length_1012_cov_53.686747	458	538	17	12	80	0.1500000
NODE_6383_length_1012_cov_53.686747	458	538	18	15	80	0.1875000
NODE_6384_length_1012_cov_35.861993	453	533	0	18	80	0.2250000
NODE_6384_length_1012_cov_35.861993	453	533	2	62	80	0.7750000
NODE_6384_length_1012_cov_35.861993	506	581	1	17	75	0.2266667
NODE_6384_length_1012_cov_35.861993	506	581	2	55	75	0.7333333
NODE_6384_length_1012_cov_35.861993	506	581	3	3	75	0.0400000
NODE_6385_length_1012_cov_16.125958	510	590	4	80	80	1.0000000
NODE_6385_length_1012_cov_16.125958	563	643	0	6	80	0.0750000
NODE_6385_length_1012_cov_16.125958	563	643	1	2	80	0.0250000
NODE_6385_length_1012_cov_16.125958	563	643	2	5	80	0.0625000
NODE_6385_length_1012_cov_16.125958	563	643	4	67	80	0.8375000
NODE_6386_length_1012_cov_15.395400	501	581	2	17	80	0.2125000
NODE_6386_length_1012_cov_15.395400	501	581	3	63	80	0.7875000
NODE_6386_length_1012_cov_15.395400	554	634	2	20	80	0.2500000
NODE_6386_length_1012_cov_15.395400	554	634	3	60	80	0.7500000
NODE_6388_length_1012_cov_6.409639	528	608	2	80	80	1.0000000
NODE_6388_length_1012_cov_6.409639	581	661	0	8	80	0.1000000
NODE_6388_length_1012_cov_6.409639	581	661	1	11	80	0.1375000
NODE_6388_length_1012_cov_6.409639	581	661	2	61	80	0.7625000
NODE_6398_length_1011_cov_53.032895	515	595	5	4	80	0.0500000
NODE_6398_length_1011_cov_53.032895	515	595	7	64	80	0.8000000
NODE_6398_length_1011_cov_53.032895	515	595	8	12	80	0.1500000
NODE_6398_length_1011_cov_53.032895	568	648	3	9	80	0.1125000
NODE_6398_length_1011_cov_53.032895	568	648	5	17	80	0.2125000
NODE_6398_length_1011_cov_53.032895	568	648	6	18	80	0.2250000
NODE_6398_length_1011_cov_53.032895	568	648	7	33	80	0.4125000
NODE_6398_length_1011_cov_53.032895	568	648	8	3	80	0.0375000
NODE_6399_length_1011_cov_25.838816	366	446	4	14	80	0.1750000
NODE_6399_length_1011_cov_25.838816	366	446	6	11	80	0.1375000
NODE_6399_length_1011_cov_25.838816	366	446	7	55	80	0.6875000
NODE_6399_length_1011_cov_25.838816	419	499	2	9	80	0.1125000
NODE_6399_length_1011_cov_25.838816	419	499	3	22	80	0.2750000
NODE_6399_length_1011_cov_25.838816	419	499	4	36	80	0.4500000
NODE_6399_length_1011_cov_25.838816	419	499	7	13	80	0.1625000
NODE_6400_length_1011_cov_22.734649	426	506	0	12	80	0.1500000
NODE_6400_length_1011_cov_22.734649	426	506	1	68	80	0.8500000
NODE_6400_length_1011_cov_22.734649	479	559	1	35	80	0.4375000
NODE_6400_length_1011_cov_22.734649	479	559	2	45	80	0.5625000
NODE_6400_length_1011_cov_22.734649	555	636	2	24	81	0.2962963
NODE_6400_length_1011_cov_22.734649	555	636	3	7	81	0.0864198
NODE_6400_length_1011_cov_22.734649	555	636	4	50	81	0.6172839
NODE_6400_length_1011_cov_22.734649	609	689	3	1	80	0.0125000
NODE_6400_length_1011_cov_22.734649	609	689	4	79	80	0.9875000
NODE_6401_length_1011_cov_18.127193	389	469	2	32	80	0.4000000
NODE_6401_length_1011_cov_18.127193	389	469	4	13	80	0.1625000
NODE_6401_length_1011_cov_18.127193	389	469	5	6	80	0.0750000
NODE_6401_length_1011_cov_18.127193	389	469	6	29	80	0.3625000
NODE_6401_length_1011_cov_18.127193	442	520	4	29	78	0.3717949
NODE_6401_length_1011_cov_18.127193	442	520	6	49	78	0.6282051
NODE_6401_length_1011_cov_18.127193	516	596	4	8	80	0.1000000
NODE_6401_length_1011_cov_18.127193	516	596	5	8	80	0.1000000
NODE_6401_length_1011_cov_18.127193	516	596	6	33	80	0.4125000
NODE_6401_length_1011_cov_18.127193	516	596	7	31	80	0.3875000
NODE_6401_length_1011_cov_18.127193	569	649	3	40	80	0.5000000
NODE_6401_length_1011_cov_18.127193	569	649	5	19	80	0.2375000
NODE_6401_length_1011_cov_18.127193	569	649	6	6	80	0.0750000
NODE_6401_length_1011_cov_18.127193	569	649	7	15	80	0.1875000
NODE_6402_length_1011_cov_12.709430	309	389	1	36	80	0.4500000
NODE_6402_length_1011_cov_12.709430	309	389	3	19	80	0.2375000
NODE_6402_length_1011_cov_12.709430	309	389	4	25	80	0.3125000
NODE_6402_length_1011_cov_12.709430	362	442	3	2	80	0.0250000
NODE_6402_length_1011_cov_12.709430	362	442	4	78	80	0.9750000
NODE_6403_length_1011_cov_8.731360	441	521	7	69	80	0.8625000
NODE_6403_length_1011_cov_8.731360	441	521	8	11	80	0.1375000
NODE_6403_length_1011_cov_8.731360	494	574	3	5	80	0.0625000
NODE_6403_length_1011_cov_8.731360	494	574	5	37	80	0.4625000
NODE_6403_length_1011_cov_8.731360	494	574	6	8	80	0.1000000
NODE_6403_length_1011_cov_8.731360	494	574	7	16	80	0.2000000
NODE_6403_length_1011_cov_8.731360	494	574	8	14	80	0.1750000
NODE_6405_length_1011_cov_7.212719	219	299	3	75	80	0.9375000
NODE_6405_length_1011_cov_7.212719	219	299	4	5	80	0.0625000
NODE_6408_length_1011_cov_3.569079	173	253	2	38	80	0.4750000
NODE_6408_length_1011_cov_3.569079	173	253	3	42	80	0.5250000
NODE_6408_length_1011_cov_3.569079	226	306	3	80	80	1.0000000
NODE_6409_length_1011_cov_1.703947	779	851	5	7	72	0.0972222
NODE_6409_length_1011_cov_1.703947	779	851	6	1	72	0.0138889
NODE_6409_length_1011_cov_1.703947	779	851	8	20	72	0.2777778
NODE_6409_length_1011_cov_1.703947	779	851	10	19	72	0.2638889
NODE_6409_length_1011_cov_1.703947	779	851	11	9	72	0.1250000
NODE_6409_length_1011_cov_1.703947	779	851	12	16	72	0.2222222
NODE_6416_length_1010_cov_51.841932	335	415	4	6	80	0.0750000
NODE_6416_length_1010_cov_51.841932	335	415	5	10	80	0.1250000
NODE_6416_length_1010_cov_51.841932	335	415	6	64	80	0.8000000
NODE_6416_length_1010_cov_51.841932	388	468	2	18	80	0.2250000
NODE_6416_length_1010_cov_51.841932	388	468	4	19	80	0.2375000
NODE_6416_length_1010_cov_51.841932	388	468	5	10	80	0.1250000
NODE_6416_length_1010_cov_51.841932	388	468	6	33	80	0.4125000
NODE_6417_length_1010_cov_35.860593	576	656	4	58	80	0.7250000
NODE_6417_length_1010_cov_35.860593	576	656	5	22	80	0.2750000
NODE_6417_length_1010_cov_35.860593	629	709	1	43	80	0.5375000
NODE_6417_length_1010_cov_35.860593	629	709	2	9	80	0.1125000
NODE_6417_length_1010_cov_35.860593	629	709	4	6	80	0.0750000
NODE_6417_length_1010_cov_35.860593	629	709	5	22	80	0.2750000
NODE_6418_length_1010_cov_30.043908	509	589	2	17	80	0.2125000
NODE_6418_length_1010_cov_30.043908	509	589	3	1	80	0.0125000
NODE_6418_length_1010_cov_30.043908	509	589	4	22	80	0.2750000
NODE_6418_length_1010_cov_30.043908	509	589	5	40	80	0.5000000
NODE_6418_length_1010_cov_30.043908	562	642	4	26	80	0.3250000
NODE_6418_length_1010_cov_30.043908	562	642	5	54	80	0.6750000
NODE_6418_length_1010_cov_30.043908	638	718	2	18	80	0.2250000
NODE_6418_length_1010_cov_30.043908	638	718	3	42	80	0.5250000
NODE_6418_length_1010_cov_30.043908	638	718	4	20	80	0.2500000
NODE_6418_length_1010_cov_30.043908	691	771	3	44	80	0.5500000
NODE_6418_length_1010_cov_30.043908	691	771	4	29	80	0.3625000
NODE_6418_length_1010_cov_30.043908	691	771	6	7	80	0.0875000
NODE_6420_length_1010_cov_15.156970	364	444	2	43	80	0.5375000
NODE_6420_length_1010_cov_15.156970	364	444	3	13	80	0.1625000
NODE_6420_length_1010_cov_15.156970	364	444	4	24	80	0.3000000
NODE_6420_length_1010_cov_15.156970	417	497	2	30	80	0.3750000
NODE_6420_length_1010_cov_15.156970	417	497	3	14	80	0.1750000
NODE_6420_length_1010_cov_15.156970	417	497	4	36	80	0.4500000
NODE_6421_length_1010_cov_13.546652	385	465	0	80	80	1.0000000
NODE_6421_length_1010_cov_13.546652	438	518	0	80	80	1.0000000
NODE_6422_length_1010_cov_13.317234	480	560	1	19	80	0.2375000
NODE_6422_length_1010_cov_13.317234	480	560	2	3	80	0.0375000
NODE_6422_length_1010_cov_13.317234	480	560	3	8	80	0.1000000
NODE_6422_length_1010_cov_13.317234	480	560	4	29	80	0.3625000
NODE_6422_length_1010_cov_13.317234	480	560	5	21	80	0.2625000
NODE_6422_length_1010_cov_13.317234	533	613	4	6	80	0.0750000
NODE_6422_length_1010_cov_13.317234	533	613	5	74	80	0.9250000
NODE_6423_length_1010_cov_12.900110	427	507	0	43	80	0.5375000
NODE_6423_length_1010_cov_12.900110	427	507	1	37	80	0.4625000
NODE_6423_length_1010_cov_12.900110	480	560	1	80	80	1.0000000
NODE_6424_length_1010_cov_11.423710	631	711	5	45	80	0.5625000
NODE_6424_length_1010_cov_11.423710	631	711	6	35	80	0.4375000
NODE_6424_length_1010_cov_11.423710	684	764	2	16	80	0.2000000
NODE_6424_length_1010_cov_11.423710	684	764	3	16	80	0.2000000
NODE_6424_length_1010_cov_11.423710	684	764	4	3	80	0.0375000
NODE_6424_length_1010_cov_11.423710	684	764	5	40	80	0.5000000
NODE_6424_length_1010_cov_11.423710	684	764	6	5	80	0.0625000
NODE_6425_length_1010_cov_11.256861	492	572	4	43	80	0.5375000
NODE_6425_length_1010_cov_11.256861	492	572	5	22	80	0.2750000
NODE_6425_length_1010_cov_11.256861	492	572	6	3	80	0.0375000
NODE_6425_length_1010_cov_11.256861	492	572	7	12	80	0.1500000
NODE_6425_length_1010_cov_11.256861	545	625	4	12	80	0.1500000
NODE_6425_length_1010_cov_11.256861	545	625	5	53	80	0.6625000
NODE_6425_length_1010_cov_11.256861	545	625	6	3	80	0.0375000
NODE_6425_length_1010_cov_11.256861	545	625	7	12	80	0.1500000
NODE_6426_length_1010_cov_11.000000	455	535	0	48	80	0.6000000
NODE_6426_length_1010_cov_11.000000	455	535	1	32	80	0.4000000
NODE_6426_length_1010_cov_11.000000	508	588	1	80	80	1.0000000
NODE_6428_length_1010_cov_4.990121	476	556	0	80	80	1.0000000
NODE_6428_length_1010_cov_4.990121	529	609	0	80	80	1.0000000
NODE_6430_length_1010_cov_4.892426	476	556	0	18	80	0.2250000
NODE_6430_length_1010_cov_4.892426	476	556	2	62	80	0.7750000
NODE_6430_length_1010_cov_4.892426	529	609	2	80	80	1.0000000
NODE_6431_length_1010_cov_3.624588	157	196	4	39	39	1.0000000
NODE_6435_length_1010_cov_1.440176	1	58	0	57	57	1.0000000
NODE_6436_length_1009_cov_44.626374	288	362	2	11	74	0.1486486
NODE_6436_length_1009_cov_44.626374	288	362	3	63	74	0.8513514
NODE_6436_length_1009_cov_44.626374	335	415	2	5	80	0.0625000
NODE_6436_length_1009_cov_44.626374	335	415	3	75	80	0.9375000
NODE_6436_length_1009_cov_44.626374	411	491	1	42	80	0.5250000
NODE_6436_length_1009_cov_44.626374	411	491	2	38	80	0.4750000
NODE_6436_length_1009_cov_44.626374	464	544	1	32	80	0.4000000
NODE_6436_length_1009_cov_44.626374	464	544	2	48	80	0.6000000
NODE_6437_length_1009_cov_31.828571	412	492	17	1	80	0.0125000
NODE_6437_length_1009_cov_31.828571	412	492	18	3	80	0.0375000
NODE_6437_length_1009_cov_31.828571	412	492	19	10	80	0.1250000
NODE_6437_length_1009_cov_31.828571	412	492	20	3	80	0.0375000
NODE_6437_length_1009_cov_31.828571	412	492	21	6	80	0.0750000
NODE_6437_length_1009_cov_31.828571	412	492	22	8	80	0.1000000
NODE_6437_length_1009_cov_31.828571	412	492	23	27	80	0.3375000
NODE_6437_length_1009_cov_31.828571	412	492	24	21	80	0.2625000
NODE_6437_length_1009_cov_31.828571	412	492	25	1	80	0.0125000
NODE_6437_length_1009_cov_31.828571	465	545	10	9	80	0.1125000
NODE_6437_length_1009_cov_31.828571	465	545	11	2	80	0.0250000
NODE_6437_length_1009_cov_31.828571	465	545	12	5	80	0.0625000
NODE_6437_length_1009_cov_31.828571	465	545	13	17	80	0.2125000
NODE_6437_length_1009_cov_31.828571	465	545	14	11	80	0.1375000
NODE_6437_length_1009_cov_31.828571	465	545	16	2	80	0.0250000
NODE_6437_length_1009_cov_31.828571	465	545	17	6	80	0.0750000
NODE_6437_length_1009_cov_31.828571	465	545	18	2	80	0.0250000
NODE_6437_length_1009_cov_31.828571	465	545	19	6	80	0.0750000
NODE_6437_length_1009_cov_31.828571	465	545	20	2	80	0.0250000
NODE_6437_length_1009_cov_31.828571	465	545	23	10	80	0.1250000
NODE_6437_length_1009_cov_31.828571	465	545	24	7	80	0.0875000
NODE_6437_length_1009_cov_31.828571	465	545	25	1	80	0.0125000
NODE_6438_length_1009_cov_28.539560	571	651	5	17	80	0.2125000
NODE_6438_length_1009_cov_28.539560	571	651	7	63	80	0.7875000
NODE_6438_length_1009_cov_28.539560	624	704	3	4	80	0.0500000
NODE_6438_length_1009_cov_28.539560	624	704	4	32	80	0.4000000
NODE_6438_length_1009_cov_28.539560	624	704	5	34	80	0.4250000
NODE_6438_length_1009_cov_28.539560	624	704	7	10	80	0.1250000
NODE_6439_length_1009_cov_20.281319	577	657	14	2	80	0.0250000
NODE_6439_length_1009_cov_20.281319	577	657	15	6	80	0.0750000
NODE_6439_length_1009_cov_20.281319	577	657	16	12	80	0.1500000
NODE_6439_length_1009_cov_20.281319	577	657	17	9	80	0.1125000
NODE_6439_length_1009_cov_20.281319	577	657	18	7	80	0.0875000
NODE_6439_length_1009_cov_20.281319	577	657	19	4	80	0.0500000
NODE_6439_length_1009_cov_20.281319	577	657	20	40	80	0.5000000
NODE_6439_length_1009_cov_20.281319	630	710	9	9	80	0.1125000
NODE_6439_length_1009_cov_20.281319	630	710	11	4	80	0.0500000
NODE_6439_length_1009_cov_20.281319	630	710	12	8	80	0.1000000
NODE_6439_length_1009_cov_20.281319	630	710	14	10	80	0.1250000
NODE_6439_length_1009_cov_20.281319	630	710	15	9	80	0.1125000
NODE_6439_length_1009_cov_20.281319	630	710	16	10	80	0.1250000
NODE_6439_length_1009_cov_20.281319	630	710	17	10	80	0.1250000
NODE_6439_length_1009_cov_20.281319	630	710	19	2	80	0.0250000
NODE_6439_length_1009_cov_20.281319	630	710	20	18	80	0.2250000
NODE_6440_length_1009_cov_18.649451	430	510	6	5	80	0.0625000
NODE_6440_length_1009_cov_18.649451	430	510	8	9	80	0.1125000
NODE_6440_length_1009_cov_18.649451	430	510	9	4	80	0.0500000
NODE_6440_length_1009_cov_18.649451	430	510	10	43	80	0.5375000
NODE_6440_length_1009_cov_18.649451	430	510	11	19	80	0.2375000
NODE_6440_length_1009_cov_18.649451	483	563	6	3	80	0.0375000
NODE_6440_length_1009_cov_18.649451	483	563	8	42	80	0.5250000
NODE_6440_length_1009_cov_18.649451	483	563	10	26	80	0.3250000
NODE_6440_length_1009_cov_18.649451	483	563	11	9	80	0.1125000
NODE_6442_length_1009_cov_3.767033	647	727	0	73	80	0.9125000
NODE_6442_length_1009_cov_3.767033	647	727	1	1	80	0.0125000
NODE_6442_length_1009_cov_3.767033	647	727	2	6	80	0.0750000
NODE_6442_length_1009_cov_3.767033	700	780	0	20	80	0.2500000
NODE_6442_length_1009_cov_3.767033	700	780	1	1	80	0.0125000
NODE_6442_length_1009_cov_3.767033	700	780	2	15	80	0.1875000
NODE_6442_length_1009_cov_3.767033	700	780	3	44	80	0.5500000
NODE_6443_length_1009_cov_2.903297	36	63	0	27	27	1.0000000
NODE_6451_length_1008_cov_44.825083	399	479	9	6	80	0.0750000
NODE_6451_length_1008_cov_44.825083	399	479	11	13	80	0.1625000
NODE_6451_length_1008_cov_44.825083	399	479	13	10	80	0.1250000
NODE_6451_length_1008_cov_44.825083	399	479	14	12	80	0.1500000
NODE_6451_length_1008_cov_44.825083	399	479	16	16	80	0.2000000
NODE_6451_length_1008_cov_44.825083	399	479	18	23	80	0.2875000
NODE_6451_length_1008_cov_44.825083	452	532	9	8	80	0.1000000
NODE_6451_length_1008_cov_44.825083	452	532	11	9	80	0.1125000
NODE_6451_length_1008_cov_44.825083	452	532	12	4	80	0.0500000
NODE_6451_length_1008_cov_44.825083	452	532	14	4	80	0.0500000
NODE_6451_length_1008_cov_44.825083	452	532	16	15	80	0.1875000
NODE_6451_length_1008_cov_44.825083	452	532	18	40	80	0.5000000
NODE_6452_length_1008_cov_41.030803	280	360	3	6	80	0.0750000
NODE_6452_length_1008_cov_41.030803	280	360	4	6	80	0.0750000
NODE_6452_length_1008_cov_41.030803	280	360	5	17	80	0.2125000
NODE_6452_length_1008_cov_41.030803	280	360	6	30	80	0.3750000
NODE_6452_length_1008_cov_41.030803	280	360	7	21	80	0.2625000
NODE_6452_length_1008_cov_41.030803	333	413	5	40	80	0.5000000
NODE_6452_length_1008_cov_41.030803	333	413	6	32	80	0.4000000
NODE_6452_length_1008_cov_41.030803	333	413	7	8	80	0.1000000
NODE_6452_length_1008_cov_41.030803	409	489	2	22	80	0.2750000
NODE_6452_length_1008_cov_41.030803	409	489	3	8	80	0.1000000
NODE_6452_length_1008_cov_41.030803	409	489	4	17	80	0.2125000
NODE_6452_length_1008_cov_41.030803	409	489	5	6	80	0.0750000
NODE_6452_length_1008_cov_41.030803	409	489	6	27	80	0.3375000
NODE_6452_length_1008_cov_41.030803	462	542	2	50	80	0.6250000
NODE_6452_length_1008_cov_41.030803	462	542	3	30	80	0.3750000
NODE_6453_length_1008_cov_39.377338	311	391	4	2	80	0.0250000
NODE_6453_length_1008_cov_39.377338	311	391	5	15	80	0.1875000
NODE_6453_length_1008_cov_39.377338	311	391	7	31	80	0.3875000
NODE_6453_length_1008_cov_39.377338	311	391	8	32	80	0.4000000
NODE_6453_length_1008_cov_39.377338	364	444	5	8	80	0.1000000
NODE_6453_length_1008_cov_39.377338	364	444	6	3	80	0.0375000
NODE_6453_length_1008_cov_39.377338	364	444	7	32	80	0.4000000
NODE_6453_length_1008_cov_39.377338	364	444	8	30	80	0.3750000
NODE_6453_length_1008_cov_39.377338	364	444	9	7	80	0.0875000
NODE_6453_length_1008_cov_39.377338	440	520	6	9	80	0.1125000
NODE_6453_length_1008_cov_39.377338	440	520	7	16	80	0.2000000
NODE_6453_length_1008_cov_39.377338	440	520	8	14	80	0.1750000
NODE_6453_length_1008_cov_39.377338	440	520	9	30	80	0.3750000
NODE_6453_length_1008_cov_39.377338	440	520	10	11	80	0.1375000
NODE_6453_length_1008_cov_39.377338	493	573	6	1	80	0.0125000
NODE_6453_length_1008_cov_39.377338	493	573	7	3	80	0.0375000
NODE_6453_length_1008_cov_39.377338	493	573	8	31	80	0.3875000
NODE_6453_length_1008_cov_39.377338	493	573	9	45	80	0.5625000
NODE_6454_length_1008_cov_27.836084	405	485	5	52	80	0.6500000
NODE_6454_length_1008_cov_27.836084	405	485	6	15	80	0.1875000
NODE_6454_length_1008_cov_27.836084	405	485	8	3	80	0.0375000
NODE_6454_length_1008_cov_27.836084	405	485	9	10	80	0.1250000
NODE_6454_length_1008_cov_27.836084	458	538	5	6	80	0.0750000
NODE_6454_length_1008_cov_27.836084	458	538	6	19	80	0.2375000
NODE_6454_length_1008_cov_27.836084	458	538	7	25	80	0.3125000
NODE_6454_length_1008_cov_27.836084	458	538	8	3	80	0.0375000
NODE_6454_length_1008_cov_27.836084	458	538	9	27	80	0.3375000
NODE_6454_length_1008_cov_27.836084	534	614	5	4	80	0.0500000
NODE_6454_length_1008_cov_27.836084	534	614	6	7	80	0.0875000
NODE_6454_length_1008_cov_27.836084	534	614	7	32	80	0.4000000
NODE_6454_length_1008_cov_27.836084	534	614	8	9	80	0.1125000
NODE_6454_length_1008_cov_27.836084	534	614	9	28	80	0.3500000
NODE_6454_length_1008_cov_27.836084	587	667	5	16	80	0.2000000
NODE_6454_length_1008_cov_27.836084	587	667	6	34	80	0.4250000
NODE_6454_length_1008_cov_27.836084	587	667	7	30	80	0.3750000
NODE_6455_length_1008_cov_24.741474	485	565	7	1	80	0.0125000
NODE_6455_length_1008_cov_24.741474	485	565	8	1	80	0.0125000
NODE_6455_length_1008_cov_24.741474	485	565	9	3	80	0.0375000
NODE_6455_length_1008_cov_24.741474	485	565	10	75	80	0.9375000
NODE_6455_length_1008_cov_24.741474	538	618	3	1	80	0.0125000
NODE_6455_length_1008_cov_24.741474	538	618	5	6	80	0.0750000
NODE_6455_length_1008_cov_24.741474	538	618	7	8	80	0.1000000
NODE_6455_length_1008_cov_24.741474	538	618	9	13	80	0.1625000
NODE_6455_length_1008_cov_24.741474	538	618	10	52	80	0.6500000
NODE_6456_length_1008_cov_20.278328	401	481	2	15	80	0.1875000
NODE_6456_length_1008_cov_20.278328	401	481	3	14	80	0.1750000
NODE_6456_length_1008_cov_20.278328	401	481	5	1	80	0.0125000
NODE_6456_length_1008_cov_20.278328	401	481	6	16	80	0.2000000
NODE_6456_length_1008_cov_20.278328	401	481	7	34	80	0.4250000
NODE_6456_length_1008_cov_20.278328	454	534	6	22	80	0.2750000
NODE_6456_length_1008_cov_20.278328	454	534	7	32	80	0.4000000
NODE_6456_length_1008_cov_20.278328	454	534	8	26	80	0.3250000
NODE_6457_length_1008_cov_6.071507	460	540	1	67	80	0.8375000
NODE_6457_length_1008_cov_6.071507	460	540	2	13	80	0.1625000
NODE_6457_length_1008_cov_6.071507	513	593	1	33	80	0.4125000
NODE_6457_length_1008_cov_6.071507	513	593	2	47	80	0.5875000
NODE_6466_length_1008_cov_1.798680	0	64	0	64	64	1.0000000
NODE_6466_length_1008_cov_1.798680	37	104	0	67	67	1.0000000
NODE_6473_length_1007_cov_27.011013	294	371	0	10	77	0.1298701
NODE_6473_length_1007_cov_27.011013	294	371	2	67	77	0.8701299
NODE_6473_length_1007_cov_27.011013	347	424	0	6	77	0.0779221
NODE_6473_length_1007_cov_27.011013	347	424	2	71	77	0.9220779
NODE_6474_length_1007_cov_24.668502	369	449	3	16	80	0.2000000
NODE_6474_length_1007_cov_24.668502	369	449	4	55	80	0.6875000
NODE_6474_length_1007_cov_24.668502	369	449	5	9	80	0.1125000
NODE_6474_length_1007_cov_24.668502	422	502	3	21	80	0.2625000
NODE_6474_length_1007_cov_24.668502	422	502	4	31	80	0.3875000
NODE_6474_length_1007_cov_24.668502	422	502	5	12	80	0.1500000
NODE_6474_length_1007_cov_24.668502	422	502	6	16	80	0.2000000
NODE_6474_length_1007_cov_24.668502	498	578	6	37	80	0.4625000
NODE_6474_length_1007_cov_24.668502	498	578	7	3	80	0.0375000
NODE_6474_length_1007_cov_24.668502	498	578	8	5	80	0.0625000
NODE_6474_length_1007_cov_24.668502	498	578	9	20	80	0.2500000
NODE_6474_length_1007_cov_24.668502	498	578	10	15	80	0.1875000
NODE_6474_length_1007_cov_24.668502	551	631	4	15	80	0.1875000
NODE_6474_length_1007_cov_24.668502	551	631	5	3	80	0.0375000
NODE_6474_length_1007_cov_24.668502	551	631	7	11	80	0.1375000
NODE_6474_length_1007_cov_24.668502	551	631	8	12	80	0.1500000
NODE_6474_length_1007_cov_24.668502	551	631	9	17	80	0.2125000
NODE_6474_length_1007_cov_24.668502	551	631	10	22	80	0.2750000
NODE_6475_length_1007_cov_21.729075	454	534	1	12	80	0.1500000
NODE_6475_length_1007_cov_21.729075	454	534	2	53	80	0.6625000
NODE_6475_length_1007_cov_21.729075	454	534	4	15	80	0.1875000
NODE_6475_length_1007_cov_21.729075	507	587	2	12	80	0.1500000
NODE_6475_length_1007_cov_21.729075	507	587	3	1	80	0.0125000
NODE_6475_length_1007_cov_21.729075	507	587	4	37	80	0.4625000
NODE_6475_length_1007_cov_21.729075	507	587	5	24	80	0.3000000
NODE_6475_length_1007_cov_21.729075	507	587	6	6	80	0.0750000
NODE_6475_length_1007_cov_21.729075	583	663	3	47	80	0.5875000
NODE_6475_length_1007_cov_21.729075	583	663	4	16	80	0.2000000
NODE_6475_length_1007_cov_21.729075	583	663	6	17	80	0.2125000
NODE_6475_length_1007_cov_21.729075	636	716	2	24	80	0.3000000
NODE_6475_length_1007_cov_21.729075	636	716	3	46	80	0.5750000
NODE_6475_length_1007_cov_21.729075	636	716	4	10	80	0.1250000
NODE_6476_length_1007_cov_14.515419	400	480	1	33	80	0.4125000
NODE_6476_length_1007_cov_14.515419	400	480	2	47	80	0.5875000
NODE_6476_length_1007_cov_14.515419	453	533	2	29	80	0.3625000
NODE_6476_length_1007_cov_14.515419	453	533	3	31	80	0.3875000
NODE_6476_length_1007_cov_14.515419	453	533	4	20	80	0.2500000
NODE_6477_length_1007_cov_13.685022	376	456	1	1	80	0.0125000
NODE_6477_length_1007_cov_13.685022	376	456	2	25	80	0.3125000
NODE_6477_length_1007_cov_13.685022	376	456	3	3	80	0.0375000
NODE_6477_length_1007_cov_13.685022	376	456	4	44	80	0.5500000
NODE_6477_length_1007_cov_13.685022	376	456	5	7	80	0.0875000
NODE_6477_length_1007_cov_13.685022	429	509	4	38	80	0.4750000
NODE_6477_length_1007_cov_13.685022	429	509	5	42	80	0.5250000
NODE_6478_length_1007_cov_9.189427	438	518	2	3	80	0.0375000
NODE_6478_length_1007_cov_9.189427	438	518	3	23	80	0.2875000
NODE_6478_length_1007_cov_9.189427	438	518	4	54	80	0.6750000
NODE_6478_length_1007_cov_9.189427	491	571	2	31	80	0.3875000
NODE_6478_length_1007_cov_9.189427	491	571	4	49	80	0.6125000
NODE_6491_length_1006_cov_59.773980	379	459	8	13	80	0.1625000
NODE_6491_length_1006_cov_59.773980	379	459	9	21	80	0.2625000
NODE_6491_length_1006_cov_59.773980	379	459	10	4	80	0.0500000
NODE_6491_length_1006_cov_59.773980	379	459	11	42	80	0.5250000
NODE_6491_length_1006_cov_59.773980	432	512	4	1	80	0.0125000
NODE_6491_length_1006_cov_59.773980	432	512	5	17	80	0.2125000
NODE_6491_length_1006_cov_59.773980	432	512	6	4	80	0.0500000
NODE_6491_length_1006_cov_59.773980	432	512	8	7	80	0.0875000
NODE_6491_length_1006_cov_59.773980	432	512	9	14	80	0.1750000
NODE_6491_length_1006_cov_59.773980	432	512	10	11	80	0.1375000
NODE_6491_length_1006_cov_59.773980	432	512	11	26	80	0.3250000
NODE_6491_length_1006_cov_59.773980	508	588	3	26	80	0.3250000
NODE_6491_length_1006_cov_59.773980	508	588	4	19	80	0.2375000
NODE_6491_length_1006_cov_59.773980	508	588	5	17	80	0.2125000
NODE_6491_length_1006_cov_59.773980	508	588	6	18	80	0.2250000
NODE_6491_length_1006_cov_59.773980	561	641	3	79	80	0.9875000
NODE_6491_length_1006_cov_59.773980	561	641	4	1	80	0.0125000
NODE_6492_length_1006_cov_34.762955	482	562	5	6	80	0.0750000
NODE_6492_length_1006_cov_34.762955	482	562	6	12	80	0.1500000
NODE_6492_length_1006_cov_34.762955	482	562	8	8	80	0.1000000
NODE_6492_length_1006_cov_34.762955	482	562	9	4	80	0.0500000
NODE_6492_length_1006_cov_34.762955	482	562	10	17	80	0.2125000
NODE_6492_length_1006_cov_34.762955	482	562	12	22	80	0.2750000
NODE_6492_length_1006_cov_34.762955	482	562	13	10	80	0.1250000
NODE_6492_length_1006_cov_34.762955	482	562	14	1	80	0.0125000
NODE_6492_length_1006_cov_34.762955	535	615	7	5	80	0.0625000
NODE_6492_length_1006_cov_34.762955	535	615	8	9	80	0.1125000
NODE_6492_length_1006_cov_34.762955	535	615	9	16	80	0.2000000
NODE_6492_length_1006_cov_34.762955	535	615	11	6	80	0.0750000
NODE_6492_length_1006_cov_34.762955	535	615	12	17	80	0.2125000
NODE_6492_length_1006_cov_34.762955	535	615	13	10	80	0.1250000
NODE_6492_length_1006_cov_34.762955	535	615	14	17	80	0.2125000
NODE_6493_length_1006_cov_21.776185	516	596	5	8	80	0.1000000
NODE_6493_length_1006_cov_21.776185	516	596	6	33	80	0.4125000
NODE_6493_length_1006_cov_21.776185	516	596	7	12	80	0.1500000
NODE_6493_length_1006_cov_21.776185	516	596	8	15	80	0.1875000
NODE_6493_length_1006_cov_21.776185	516	596	9	12	80	0.1500000
NODE_6493_length_1006_cov_21.776185	569	649	4	8	80	0.1000000
NODE_6493_length_1006_cov_21.776185	569	649	5	5	80	0.0625000
NODE_6493_length_1006_cov_21.776185	569	649	6	6	80	0.0750000
NODE_6493_length_1006_cov_21.776185	569	649	8	49	80	0.6125000
NODE_6493_length_1006_cov_21.776185	569	649	9	12	80	0.1500000
NODE_6494_length_1006_cov_19.690187	371	451	1	19	80	0.2375000
NODE_6494_length_1006_cov_19.690187	371	451	2	25	80	0.3125000
NODE_6494_length_1006_cov_19.690187	371	451	3	36	80	0.4500000
NODE_6494_length_1006_cov_19.690187	424	504	1	10	80	0.1250000
NODE_6494_length_1006_cov_19.690187	424	504	2	65	80	0.8125000
NODE_6494_length_1006_cov_19.690187	424	504	3	5	80	0.0625000
NODE_6495_length_1006_cov_19.299890	495	575	9	17	80	0.2125000
NODE_6495_length_1006_cov_19.299890	495	575	10	63	80	0.7875000
NODE_6495_length_1006_cov_19.299890	548	628	1	2	80	0.0250000
NODE_6495_length_1006_cov_19.299890	548	628	2	2	80	0.0250000
NODE_6495_length_1006_cov_19.299890	548	628	3	18	80	0.2250000
NODE_6495_length_1006_cov_19.299890	548	628	5	11	80	0.1375000
NODE_6495_length_1006_cov_19.299890	548	628	7	19	80	0.2375000
NODE_6495_length_1006_cov_19.299890	548	628	9	12	80	0.1500000
NODE_6495_length_1006_cov_19.299890	548	628	10	16	80	0.2000000
NODE_6496_length_1006_cov_13.187431	245	325	6	14	80	0.1750000
NODE_6496_length_1006_cov_13.187431	245	325	8	4	80	0.0500000
NODE_6496_length_1006_cov_13.187431	245	325	9	22	80	0.2750000
NODE_6496_length_1006_cov_13.187431	245	325	10	23	80	0.2875000
NODE_6496_length_1006_cov_13.187431	245	325	11	1	80	0.0125000
NODE_6496_length_1006_cov_13.187431	245	325	12	16	80	0.2000000
NODE_6496_length_1006_cov_13.187431	298	378	6	4	80	0.0500000
NODE_6496_length_1006_cov_13.187431	298	378	8	21	80	0.2625000
NODE_6496_length_1006_cov_13.187431	298	378	9	8	80	0.1000000
NODE_6496_length_1006_cov_13.187431	298	378	10	30	80	0.3750000
NODE_6496_length_1006_cov_13.187431	298	378	12	17	80	0.2125000
NODE_6497_length_1006_cov_12.862183	383	463	3	15	80	0.1875000
NODE_6497_length_1006_cov_12.862183	383	463	4	65	80	0.8125000
NODE_6497_length_1006_cov_12.862183	436	516	0	9	80	0.1125000
NODE_6497_length_1006_cov_12.862183	436	516	1	24	80	0.3000000
NODE_6497_length_1006_cov_12.862183	436	516	2	17	80	0.2125000
NODE_6497_length_1006_cov_12.862183	436	516	3	18	80	0.2250000
NODE_6497_length_1006_cov_12.862183	436	516	4	12	80	0.1500000
NODE_6498_length_1006_cov_10.986770	762	842	4	5	80	0.0625000
NODE_6498_length_1006_cov_10.986770	762	842	5	11	80	0.1375000
NODE_6498_length_1006_cov_10.986770	762	842	6	48	80	0.6000000
NODE_6498_length_1006_cov_10.986770	762	842	7	16	80	0.2000000
NODE_6498_length_1006_cov_10.986770	815	895	1	14	80	0.1750000
NODE_6498_length_1006_cov_10.986770	815	895	2	23	80	0.2875000
NODE_6498_length_1006_cov_10.986770	815	895	3	4	80	0.0500000
NODE_6498_length_1006_cov_10.986770	815	895	4	17	80	0.2125000
NODE_6498_length_1006_cov_10.986770	815	895	5	11	80	0.1375000
NODE_6498_length_1006_cov_10.986770	815	895	6	11	80	0.1375000
NODE_6499_length_1006_cov_8.633958	314	394	9	33	80	0.4125000
NODE_6499_length_1006_cov_8.633958	314	394	10	26	80	0.3250000
NODE_6499_length_1006_cov_8.633958	314	394	11	21	80	0.2625000
NODE_6499_length_1006_cov_8.633958	367	447	4	7	80	0.0875000
NODE_6499_length_1006_cov_8.633958	367	447	5	4	80	0.0500000
NODE_6499_length_1006_cov_8.633958	367	447	6	14	80	0.1750000
NODE_6499_length_1006_cov_8.633958	367	447	7	11	80	0.1375000
NODE_6499_length_1006_cov_8.633958	367	447	8	9	80	0.1125000
NODE_6499_length_1006_cov_8.633958	367	447	9	29	80	0.3625000
NODE_6499_length_1006_cov_8.633958	367	447	11	6	80	0.0750000
NODE_6515_length_1005_cov_80.271523	509	589	2	6	80	0.0750000
NODE_6515_length_1005_cov_80.271523	509	589	3	3	80	0.0375000
NODE_6515_length_1005_cov_80.271523	509	589	4	41	80	0.5125000
NODE_6515_length_1005_cov_80.271523	509	589	5	30	80	0.3750000
NODE_6515_length_1005_cov_80.271523	562	642	2	6	80	0.0750000
NODE_6515_length_1005_cov_80.271523	562	642	3	8	80	0.1000000
NODE_6515_length_1005_cov_80.271523	562	642	4	66	80	0.8250000
NODE_6516_length_1005_cov_45.008830	357	437	3	22	80	0.2750000
NODE_6516_length_1005_cov_45.008830	357	437	4	14	80	0.1750000
NODE_6516_length_1005_cov_45.008830	357	437	5	2	80	0.0250000
NODE_6516_length_1005_cov_45.008830	357	437	6	17	80	0.2125000
NODE_6516_length_1005_cov_45.008830	357	437	8	19	80	0.2375000
NODE_6516_length_1005_cov_45.008830	357	437	9	1	80	0.0125000
NODE_6516_length_1005_cov_45.008830	357	437	11	5	80	0.0625000
NODE_6516_length_1005_cov_45.008830	410	490	6	5	80	0.0625000
NODE_6516_length_1005_cov_45.008830	410	490	8	16	80	0.2000000
NODE_6516_length_1005_cov_45.008830	410	490	9	1	80	0.0125000
NODE_6516_length_1005_cov_45.008830	410	490	11	7	80	0.0875000
NODE_6516_length_1005_cov_45.008830	410	490	12	8	80	0.1000000
NODE_6516_length_1005_cov_45.008830	410	490	13	38	80	0.4750000
NODE_6516_length_1005_cov_45.008830	410	490	14	5	80	0.0625000
NODE_6517_length_1005_cov_36.636865	567	647	3	10	80	0.1250000
NODE_6517_length_1005_cov_36.636865	567	647	5	70	80	0.8750000
NODE_6517_length_1005_cov_36.636865	620	700	0	25	80	0.3125000
NODE_6517_length_1005_cov_36.636865	620	700	1	6	80	0.0750000
NODE_6517_length_1005_cov_36.636865	620	700	3	32	80	0.4000000
NODE_6517_length_1005_cov_36.636865	620	700	5	17	80	0.2125000
NODE_6518_length_1005_cov_21.222958	389	409	0	20	20	1.0000000
NODE_6518_length_1005_cov_21.222958	451	519	0	32	68	0.4705882
NODE_6518_length_1005_cov_21.222958	451	519	1	24	68	0.3529412
NODE_6518_length_1005_cov_21.222958	451	519	2	10	68	0.1470588
NODE_6518_length_1005_cov_21.222958	451	519	3	2	68	0.0294118
NODE_6518_length_1005_cov_21.222958	515	595	2	2	80	0.0250000
NODE_6518_length_1005_cov_21.222958	515	595	3	46	80	0.5750000
NODE_6518_length_1005_cov_21.222958	515	595	5	32	80	0.4000000
NODE_6518_length_1005_cov_21.222958	568	648	5	53	80	0.6625000
NODE_6518_length_1005_cov_21.222958	568	648	6	27	80	0.3375000
NODE_6520_length_1005_cov_14.278146	480	560	7	12	80	0.1500000
NODE_6520_length_1005_cov_14.278146	480	560	8	14	80	0.1750000
NODE_6520_length_1005_cov_14.278146	480	560	10	49	80	0.6125000
NODE_6520_length_1005_cov_14.278146	480	560	11	5	80	0.0625000
NODE_6520_length_1005_cov_14.278146	533	613	1	3	80	0.0375000
NODE_6520_length_1005_cov_14.278146	533	613	2	19	80	0.2375000
NODE_6520_length_1005_cov_14.278146	533	613	3	4	80	0.0500000
NODE_6520_length_1005_cov_14.278146	533	613	6	6	80	0.0750000
NODE_6520_length_1005_cov_14.278146	533	613	7	33	80	0.4125000
NODE_6520_length_1005_cov_14.278146	533	613	8	2	80	0.0250000
NODE_6520_length_1005_cov_14.278146	533	613	10	13	80	0.1625000
NODE_6521_length_1005_cov_13.215232	511	591	2	19	80	0.2375000
NODE_6521_length_1005_cov_13.215232	511	591	3	52	80	0.6500000
NODE_6521_length_1005_cov_13.215232	511	591	4	9	80	0.1125000
NODE_6521_length_1005_cov_13.215232	564	644	3	59	80	0.7375000
NODE_6521_length_1005_cov_13.215232	564	644	4	18	80	0.2250000
NODE_6521_length_1005_cov_13.215232	564	644	5	3	80	0.0375000
NODE_6523_length_1005_cov_5.579470	534	614	1	28	80	0.3500000
NODE_6523_length_1005_cov_5.579470	534	614	3	28	80	0.3500000
NODE_6523_length_1005_cov_5.579470	534	614	4	17	80	0.2125000
NODE_6523_length_1005_cov_5.579470	534	614	6	7	80	0.0875000
NODE_6523_length_1005_cov_5.579470	587	667	1	80	80	1.0000000
NODE_6536_length_1004_cov_45.470718	343	423	1	14	80	0.1750000
NODE_6536_length_1004_cov_45.470718	343	423	2	19	80	0.2375000
NODE_6536_length_1004_cov_45.470718	343	423	3	1	80	0.0125000
NODE_6536_length_1004_cov_45.470718	343	423	4	10	80	0.1250000
NODE_6536_length_1004_cov_45.470718	343	423	6	1	80	0.0125000
NODE_6536_length_1004_cov_45.470718	343	423	7	35	80	0.4375000
NODE_6536_length_1004_cov_45.470718	396	476	7	40	80	0.5000000
NODE_6536_length_1004_cov_45.470718	396	476	8	35	80	0.4375000
NODE_6536_length_1004_cov_45.470718	396	476	9	5	80	0.0625000
NODE_6536_length_1004_cov_45.470718	472	552	3	15	80	0.1875000
NODE_6536_length_1004_cov_45.470718	472	552	6	10	80	0.1250000
NODE_6536_length_1004_cov_45.470718	472	552	7	1	80	0.0125000
NODE_6536_length_1004_cov_45.470718	472	552	8	16	80	0.2000000
NODE_6536_length_1004_cov_45.470718	472	552	9	38	80	0.4750000
NODE_6536_length_1004_cov_45.470718	525	605	1	33	80	0.4125000
NODE_6536_length_1004_cov_45.470718	525	605	3	35	80	0.4375000
NODE_6536_length_1004_cov_45.470718	525	605	6	10	80	0.1250000
NODE_6536_length_1004_cov_45.470718	525	605	7	1	80	0.0125000
NODE_6536_length_1004_cov_45.470718	525	605	8	1	80	0.0125000
NODE_6537_length_1004_cov_34.565746	419	499	8	23	80	0.2875000
NODE_6537_length_1004_cov_34.565746	419	499	9	27	80	0.3375000
NODE_6537_length_1004_cov_34.565746	419	499	10	14	80	0.1750000
NODE_6537_length_1004_cov_34.565746	419	499	11	10	80	0.1250000
NODE_6537_length_1004_cov_34.565746	419	499	12	6	80	0.0750000
NODE_6537_length_1004_cov_34.565746	472	552	6	9	80	0.1125000
NODE_6537_length_1004_cov_34.565746	472	552	7	13	80	0.1625000
NODE_6537_length_1004_cov_34.565746	472	552	8	21	80	0.2625000
NODE_6537_length_1004_cov_34.565746	472	552	9	18	80	0.2250000
NODE_6537_length_1004_cov_34.565746	472	552	10	3	80	0.0375000
NODE_6537_length_1004_cov_34.565746	472	552	11	10	80	0.1250000
NODE_6537_length_1004_cov_34.565746	472	552	12	6	80	0.0750000
NODE_6538_length_1004_cov_28.710497	385	465	2	19	80	0.2375000
NODE_6538_length_1004_cov_28.710497	385	465	3	12	80	0.1500000
NODE_6538_length_1004_cov_28.710497	385	465	6	18	80	0.2250000
NODE_6538_length_1004_cov_28.710497	385	465	7	24	80	0.3000000
NODE_6538_length_1004_cov_28.710497	385	465	8	5	80	0.0625000
NODE_6538_length_1004_cov_28.710497	385	465	9	2	80	0.0250000
NODE_6538_length_1004_cov_28.710497	438	518	7	20	80	0.2500000
NODE_6538_length_1004_cov_28.710497	438	518	8	8	80	0.1000000
NODE_6538_length_1004_cov_28.710497	438	518	9	52	80	0.6500000
NODE_6538_length_1004_cov_28.710497	514	594	2	10	80	0.1250000
NODE_6538_length_1004_cov_28.710497	514	594	3	11	80	0.1375000
NODE_6538_length_1004_cov_28.710497	514	594	4	7	80	0.0875000
NODE_6538_length_1004_cov_28.710497	514	594	7	12	80	0.1500000
NODE_6538_length_1004_cov_28.710497	514	594	8	35	80	0.4375000
NODE_6538_length_1004_cov_28.710497	514	594	9	5	80	0.0625000
NODE_6538_length_1004_cov_28.710497	567	647	0	13	80	0.1625000
NODE_6538_length_1004_cov_28.710497	567	647	1	21	80	0.2625000
NODE_6538_length_1004_cov_28.710497	567	647	2	29	80	0.3625000
NODE_6538_length_1004_cov_28.710497	567	647	3	11	80	0.1375000
NODE_6538_length_1004_cov_28.710497	567	647	4	6	80	0.0750000
NODE_6539_length_1004_cov_12.745856	432	512	1	43	80	0.5375000
NODE_6539_length_1004_cov_12.745856	432	512	2	37	80	0.4625000
NODE_6539_length_1004_cov_12.745856	485	565	2	31	80	0.3875000
NODE_6539_length_1004_cov_12.745856	485	565	3	10	80	0.1250000
NODE_6539_length_1004_cov_12.745856	485	565	4	39	80	0.4875000
NODE_6550_length_1003_cov_47.014381	383	463	1	27	80	0.3375000
NODE_6550_length_1003_cov_47.014381	383	463	4	5	80	0.0625000
NODE_6550_length_1003_cov_47.014381	383	463	5	11	80	0.1375000
NODE_6550_length_1003_cov_47.014381	383	463	6	19	80	0.2375000
NODE_6550_length_1003_cov_47.014381	383	463	7	18	80	0.2250000
NODE_6550_length_1003_cov_47.014381	436	516	6	9	80	0.1125000
NODE_6550_length_1003_cov_47.014381	436	516	7	71	80	0.8875000
NODE_6550_length_1003_cov_47.014381	512	592	2	16	80	0.2000000
NODE_6550_length_1003_cov_47.014381	512	592	3	11	80	0.1375000
NODE_6550_length_1003_cov_47.014381	512	592	4	5	80	0.0625000
NODE_6550_length_1003_cov_47.014381	512	592	5	24	80	0.3000000
NODE_6550_length_1003_cov_47.014381	512	592	7	24	80	0.3000000
NODE_6550_length_1003_cov_47.014381	565	645	0	48	80	0.6000000
NODE_6550_length_1003_cov_47.014381	565	645	1	4	80	0.0500000
NODE_6550_length_1003_cov_47.014381	565	645	2	17	80	0.2125000
NODE_6550_length_1003_cov_47.014381	565	645	3	11	80	0.1375000
NODE_6551_length_1003_cov_35.329646	372	452	2	42	80	0.5250000
NODE_6551_length_1003_cov_35.329646	372	452	3	38	80	0.4750000
NODE_6551_length_1003_cov_35.329646	425	505	0	36	80	0.4500000
NODE_6551_length_1003_cov_35.329646	425	505	1	12	80	0.1500000
NODE_6551_length_1003_cov_35.329646	425	505	2	32	80	0.4000000
NODE_6552_length_1003_cov_32.721239	357	437	3	5	80	0.0625000
NODE_6552_length_1003_cov_32.721239	357	437	5	4	80	0.0500000
NODE_6552_length_1003_cov_32.721239	357	437	6	11	80	0.1375000
NODE_6552_length_1003_cov_32.721239	357	437	8	8	80	0.1000000
NODE_6552_length_1003_cov_32.721239	357	437	9	24	80	0.3000000
NODE_6552_length_1003_cov_32.721239	357	437	10	4	80	0.0500000
NODE_6552_length_1003_cov_32.721239	357	437	11	24	80	0.3000000
NODE_6552_length_1003_cov_32.721239	410	490	7	46	80	0.5750000
NODE_6552_length_1003_cov_32.721239	410	490	9	27	80	0.3375000
NODE_6552_length_1003_cov_32.721239	410	490	10	4	80	0.0500000
NODE_6552_length_1003_cov_32.721239	410	490	11	3	80	0.0375000
NODE_6553_length_1003_cov_23.758850	467	547	2	19	80	0.2375000
NODE_6553_length_1003_cov_23.758850	467	547	4	45	80	0.5625000
NODE_6553_length_1003_cov_23.758850	467	547	8	16	80	0.2000000
NODE_6553_length_1003_cov_23.758850	520	600	4	11	80	0.1375000
NODE_6553_length_1003_cov_23.758850	520	600	8	18	80	0.2250000
NODE_6553_length_1003_cov_23.758850	520	600	10	37	80	0.4625000
NODE_6553_length_1003_cov_23.758850	520	600	12	14	80	0.1750000
NODE_6554_length_1003_cov_19.939159	240	320	6	7	80	0.0875000
NODE_6554_length_1003_cov_19.939159	240	320	7	5	80	0.0625000
NODE_6554_length_1003_cov_19.939159	240	320	8	6	80	0.0750000
NODE_6554_length_1003_cov_19.939159	240	320	10	47	80	0.5875000
NODE_6554_length_1003_cov_19.939159	240	320	11	15	80	0.1875000
NODE_6554_length_1003_cov_19.939159	293	373	6	6	80	0.0750000
NODE_6554_length_1003_cov_19.939159	293	373	7	15	80	0.1875000
NODE_6554_length_1003_cov_19.939159	293	373	9	9	80	0.1125000
NODE_6554_length_1003_cov_19.939159	293	373	10	45	80	0.5625000
NODE_6554_length_1003_cov_19.939159	293	373	11	5	80	0.0625000
NODE_6555_length_1003_cov_16.618363	524	604	1	80	80	1.0000000
NODE_6555_length_1003_cov_16.618363	577	657	1	35	80	0.4375000
NODE_6555_length_1003_cov_16.618363	577	657	2	43	80	0.5375000
NODE_6555_length_1003_cov_16.618363	577	657	3	2	80	0.0250000
NODE_6555_length_1003_cov_16.618363	653	733	0	8	80	0.1000000
NODE_6555_length_1003_cov_16.618363	653	733	2	72	80	0.9000000
NODE_6555_length_1003_cov_16.618363	706	786	0	61	80	0.7625000
NODE_6555_length_1003_cov_16.618363	706	786	2	19	80	0.2375000
NODE_6556_length_1003_cov_13.863938	537	617	9	10	80	0.1250000
NODE_6556_length_1003_cov_13.863938	537	617	10	2	80	0.0250000
NODE_6556_length_1003_cov_13.863938	537	617	11	8	80	0.1000000
NODE_6556_length_1003_cov_13.863938	537	617	12	26	80	0.3250000
NODE_6556_length_1003_cov_13.863938	537	617	13	34	80	0.4250000
NODE_6556_length_1003_cov_13.863938	590	670	9	4	80	0.0500000
NODE_6556_length_1003_cov_13.863938	590	670	10	27	80	0.3375000
NODE_6556_length_1003_cov_13.863938	590	670	11	5	80	0.0625000
NODE_6556_length_1003_cov_13.863938	590	670	12	17	80	0.2125000
NODE_6556_length_1003_cov_13.863938	590	670	13	27	80	0.3375000
NODE_6557_length_1003_cov_12.363938	529	609	5	13	80	0.1625000
NODE_6557_length_1003_cov_12.363938	529	609	6	11	80	0.1375000
NODE_6557_length_1003_cov_12.363938	529	609	7	22	80	0.2750000
NODE_6557_length_1003_cov_12.363938	529	609	8	34	80	0.4250000
NODE_6557_length_1003_cov_12.363938	582	662	5	3	80	0.0375000
NODE_6557_length_1003_cov_12.363938	582	662	6	44	80	0.5500000
NODE_6557_length_1003_cov_12.363938	582	662	8	33	80	0.4125000
NODE_6567_length_1002_cov_65.513843	387	467	2	23	80	0.2875000
NODE_6567_length_1002_cov_65.513843	387	467	4	57	80	0.7125000
NODE_6567_length_1002_cov_65.513843	440	520	0	8	80	0.1000000
NODE_6567_length_1002_cov_65.513843	440	520	1	37	80	0.4625000
NODE_6567_length_1002_cov_65.513843	440	520	2	31	80	0.3875000
NODE_6567_length_1002_cov_65.513843	440	520	4	4	80	0.0500000
NODE_6567_length_1002_cov_65.513843	516	596	2	27	80	0.3375000
NODE_6567_length_1002_cov_65.513843	516	596	4	3	80	0.0375000
NODE_6567_length_1002_cov_65.513843	516	596	6	24	80	0.3000000
NODE_6567_length_1002_cov_65.513843	516	596	8	26	80	0.3250000
NODE_6567_length_1002_cov_65.513843	569	649	6	1	80	0.0125000
NODE_6567_length_1002_cov_65.513843	569	649	7	13	80	0.1625000
NODE_6567_length_1002_cov_65.513843	569	649	8	59	80	0.7375000
NODE_6567_length_1002_cov_65.513843	569	649	9	7	80	0.0875000
NODE_6568_length_1002_cov_41.995570	408	488	4	52	80	0.6500000
NODE_6568_length_1002_cov_41.995570	408	488	5	28	80	0.3500000
NODE_6568_length_1002_cov_41.995570	461	541	4	26	80	0.3250000
NODE_6568_length_1002_cov_41.995570	461	541	5	6	80	0.0750000
NODE_6568_length_1002_cov_41.995570	461	541	6	12	80	0.1500000
NODE_6568_length_1002_cov_41.995570	461	541	7	8	80	0.1000000
NODE_6568_length_1002_cov_41.995570	461	541	8	28	80	0.3500000
NODE_6569_length_1002_cov_19.966777	401	481	1	5	80	0.0625000
NODE_6569_length_1002_cov_19.966777	401	481	3	2	80	0.0250000
NODE_6569_length_1002_cov_19.966777	401	481	5	73	80	0.9125000
NODE_6569_length_1002_cov_19.966777	454	534	1	13	80	0.1625000
NODE_6569_length_1002_cov_19.966777	454	534	2	45	80	0.5625000
NODE_6569_length_1002_cov_19.966777	454	534	3	2	80	0.0250000
NODE_6569_length_1002_cov_19.966777	454	534	5	20	80	0.2500000
NODE_6570_length_1002_cov_19.539313	334	414	0	80	80	1.0000000
NODE_6570_length_1002_cov_19.539313	335	414	0	79	79	1.0000000
NODE_6570_length_1002_cov_19.539313	387	467	0	75	80	0.9375000
NODE_6570_length_1002_cov_19.539313	387	467	2	5	80	0.0625000
NODE_6570_length_1002_cov_19.539313	387	467	0	75	80	0.9375000
NODE_6570_length_1002_cov_19.539313	387	467	2	5	80	0.0625000
NODE_6570_length_1002_cov_19.539313	396	467	0	66	71	0.9295775
NODE_6570_length_1002_cov_19.539313	396	467	2	5	71	0.0704225
NODE_6570_length_1002_cov_19.539313	463	543	2	10	80	0.1250000
NODE_6570_length_1002_cov_19.539313	463	543	3	39	80	0.4875000
NODE_6570_length_1002_cov_19.539313	463	543	5	22	80	0.2750000
NODE_6570_length_1002_cov_19.539313	463	543	6	1	80	0.0125000
NODE_6570_length_1002_cov_19.539313	463	543	7	8	80	0.1000000
NODE_6570_length_1002_cov_19.539313	516	596	5	69	80	0.8625000
NODE_6570_length_1002_cov_19.539313	516	596	6	1	80	0.0125000
NODE_6570_length_1002_cov_19.539313	516	596	7	10	80	0.1250000
NODE_6571_length_1002_cov_17.780731	631	711	1	10	80	0.1250000
NODE_6571_length_1002_cov_17.780731	631	711	2	9	80	0.1125000
NODE_6571_length_1002_cov_17.780731	631	711	4	7	80	0.0875000
NODE_6571_length_1002_cov_17.780731	631	711	6	3	80	0.0375000
NODE_6571_length_1002_cov_17.780731	631	711	8	3	80	0.0375000
NODE_6571_length_1002_cov_17.780731	631	711	9	9	80	0.1125000
NODE_6571_length_1002_cov_17.780731	631	711	10	1	80	0.0125000
NODE_6571_length_1002_cov_17.780731	631	711	11	14	80	0.1750000
NODE_6571_length_1002_cov_17.780731	631	711	12	24	80	0.3000000
NODE_6571_length_1002_cov_17.780731	684	764	8	10	80	0.1250000
NODE_6571_length_1002_cov_17.780731	684	764	10	9	80	0.1125000
NODE_6571_length_1002_cov_17.780731	684	764	11	17	80	0.2125000
NODE_6571_length_1002_cov_17.780731	684	764	12	44	80	0.5500000
NODE_6572_length_1002_cov_17.590255	0	58	0	58	58	1.0000000
NODE_6572_length_1002_cov_17.590255	31	77	0	46	46	1.0000000
NODE_6573_length_1002_cov_17.105205	522	602	3	8	80	0.1000000
NODE_6573_length_1002_cov_17.105205	522	602	5	21	80	0.2625000
NODE_6573_length_1002_cov_17.105205	522	602	6	51	80	0.6375000
NODE_6573_length_1002_cov_17.105205	575	655	2	9	80	0.1125000
NODE_6573_length_1002_cov_17.105205	575	655	3	28	80	0.3500000
NODE_6573_length_1002_cov_17.105205	575	655	4	5	80	0.0625000
NODE_6573_length_1002_cov_17.105205	575	655	6	38	80	0.4750000
NODE_6574_length_1002_cov_11.954596	480	560	0	80	80	1.0000000
NODE_6574_length_1002_cov_11.954596	533	613	0	80	80	1.0000000
NODE_6575_length_1002_cov_11.823920	471	551	4	19	80	0.2375000
NODE_6575_length_1002_cov_11.823920	471	551	6	11	80	0.1375000
NODE_6575_length_1002_cov_11.823920	471	551	8	50	80	0.6250000
NODE_6575_length_1002_cov_11.823920	524	614	1	6	90	0.0666667
NODE_6575_length_1002_cov_11.823920	524	614	2	2	90	0.0222222
NODE_6575_length_1002_cov_11.823920	524	614	4	1	90	0.0111111
NODE_6575_length_1002_cov_11.823920	524	614	6	19	90	0.2111111
NODE_6575_length_1002_cov_11.823920	524	614	8	62	90	0.6888889
NODE_6577_length_1002_cov_6.596899	422	502	2	8	80	0.1000000
NODE_6577_length_1002_cov_6.596899	422	502	3	72	80	0.9000000
NODE_6577_length_1002_cov_6.596899	475	555	1	14	80	0.1750000
NODE_6577_length_1002_cov_6.596899	475	555	3	66	80	0.8250000
NODE_6588_length_1002_cov_2.102990	29	110	0	81	81	1.0000000
NODE_6596_length_1001_cov_41.914634	549	629	5	3	80	0.0375000
NODE_6596_length_1001_cov_41.914634	549	629	6	2	80	0.0250000
NODE_6596_length_1001_cov_41.914634	549	629	7	17	80	0.2125000
NODE_6596_length_1001_cov_41.914634	549	629	9	5	80	0.0625000
NODE_6596_length_1001_cov_41.914634	549	629	10	3	80	0.0375000
NODE_6596_length_1001_cov_41.914634	549	629	11	27	80	0.3375000
NODE_6596_length_1001_cov_41.914634	549	629	13	23	80	0.2875000
NODE_6596_length_1001_cov_41.914634	602	682	9	7	80	0.0875000
NODE_6596_length_1001_cov_41.914634	602	682	10	7	80	0.0875000
NODE_6596_length_1001_cov_41.914634	602	682	11	21	80	0.2625000
NODE_6596_length_1001_cov_41.914634	602	682	12	17	80	0.2125000
NODE_6596_length_1001_cov_41.914634	602	682	13	28	80	0.3500000
NODE_6597_length_1001_cov_30.378049	306	386	2	5	80	0.0625000
NODE_6597_length_1001_cov_30.378049	306	386	4	13	80	0.1625000
NODE_6597_length_1001_cov_30.378049	306	386	5	32	80	0.4000000
NODE_6597_length_1001_cov_30.378049	306	386	6	11	80	0.1375000
NODE_6597_length_1001_cov_30.378049	306	386	8	19	80	0.2375000
NODE_6597_length_1001_cov_30.378049	359	439	5	7	80	0.0875000
NODE_6597_length_1001_cov_30.378049	359	439	6	18	80	0.2250000
NODE_6597_length_1001_cov_30.378049	359	439	7	7	80	0.0875000
NODE_6597_length_1001_cov_30.378049	359	439	8	48	80	0.6000000
NODE_6597_length_1001_cov_30.378049	369	439	5	7	70	0.1000000
NODE_6597_length_1001_cov_30.378049	369	439	6	18	70	0.2571429
NODE_6597_length_1001_cov_30.378049	369	439	7	7	70	0.1000000
NODE_6597_length_1001_cov_30.378049	369	439	8	38	70	0.5428572
NODE_6597_length_1001_cov_30.378049	435	515	4	9	80	0.1125000
NODE_6597_length_1001_cov_30.378049	435	515	5	31	80	0.3875000
NODE_6597_length_1001_cov_30.378049	435	515	6	13	80	0.1625000
NODE_6597_length_1001_cov_30.378049	435	515	7	1	80	0.0125000
NODE_6597_length_1001_cov_30.378049	435	515	8	26	80	0.3250000
NODE_6597_length_1001_cov_30.378049	488	568	3	48	80	0.6000000
NODE_6597_length_1001_cov_30.378049	488	568	4	14	80	0.1750000
NODE_6597_length_1001_cov_30.378049	488	568	5	18	80	0.2250000
NODE_6598_length_1001_cov_22.517738	536	616	4	7	80	0.0875000
NODE_6598_length_1001_cov_22.517738	536	616	5	73	80	0.9125000
NODE_6598_length_1001_cov_22.517738	589	670	0	12	81	0.1481481
NODE_6598_length_1001_cov_22.517738	589	670	1	10	81	0.1234568
NODE_6598_length_1001_cov_22.517738	589	670	2	14	81	0.1728395
NODE_6598_length_1001_cov_22.517738	589	670	3	15	81	0.1851852
NODE_6598_length_1001_cov_22.517738	589	670	4	10	81	0.1234568
NODE_6598_length_1001_cov_22.517738	589	670	5	20	81	0.2469136
NODE_6599_length_1001_cov_17.996674	414	456	1	17	42	0.4047619
NODE_6599_length_1001_cov_17.996674	414	456	2	25	42	0.5952381
NODE_6599_length_1001_cov_17.996674	429	509	1	2	80	0.0250000
NODE_6599_length_1001_cov_17.996674	429	509	2	49	80	0.6125000
NODE_6599_length_1001_cov_17.996674	429	509	3	16	80	0.2000000
NODE_6599_length_1001_cov_17.996674	429	509	4	6	80	0.0750000
NODE_6599_length_1001_cov_17.996674	429	509	5	7	80	0.0875000
NODE_6599_length_1001_cov_17.996674	505	585	4	4	80	0.0500000
NODE_6599_length_1001_cov_17.996674	505	585	5	53	80	0.6625000
NODE_6599_length_1001_cov_17.996674	505	585	6	23	80	0.2875000
NODE_6599_length_1001_cov_17.996674	558	638	4	26	80	0.3250000
NODE_6599_length_1001_cov_17.996674	558	638	5	54	80	0.6750000
NODE_6600_length_1001_cov_16.798226	422	502	2	30	80	0.3750000
NODE_6600_length_1001_cov_16.798226	422	502	3	50	80	0.6250000
NODE_6600_length_1001_cov_16.798226	475	555	2	53	80	0.6625000
NODE_6600_length_1001_cov_16.798226	475	555	3	16	80	0.2000000
NODE_6600_length_1001_cov_16.798226	475	555	4	11	80	0.1375000
NODE_6600_length_1001_cov_16.798226	551	631	2	5	80	0.0625000
NODE_6600_length_1001_cov_16.798226	551	631	3	22	80	0.2750000
NODE_6600_length_1001_cov_16.798226	551	631	4	9	80	0.1125000
NODE_6600_length_1001_cov_16.798226	551	631	5	25	80	0.3125000
NODE_6600_length_1001_cov_16.798226	551	631	7	19	80	0.2375000
NODE_6600_length_1001_cov_16.798226	604	684	5	35	80	0.4375000
NODE_6600_length_1001_cov_16.798226	604	684	7	45	80	0.5625000
NODE_6601_length_1001_cov_12.778271	348	428	2	80	80	1.0000000
NODE_6601_length_1001_cov_12.778271	401	481	1	25	80	0.3125000
NODE_6601_length_1001_cov_12.778271	401	481	2	55	80	0.6875000
NODE_6602_length_1001_cov_12.305987	255	335	0	80	80	1.0000000
NODE_6602_length_1001_cov_12.305987	308	388	0	80	80	1.0000000
NODE_6603_length_1001_cov_11.955654	485	569	1	45	84	0.5357143
NODE_6603_length_1001_cov_11.955654	485	569	3	39	84	0.4642857
NODE_6603_length_1001_cov_11.955654	542	622	3	72	80	0.9000000
NODE_6603_length_1001_cov_11.955654	542	622	4	8	80	0.1000000
NODE_6604_length_1001_cov_10.156319	587	667	6	71	80	0.8875000
NODE_6604_length_1001_cov_10.156319	587	667	7	9	80	0.1125000
NODE_6604_length_1001_cov_10.156319	640	720	2	16	80	0.2000000
NODE_6604_length_1001_cov_10.156319	640	720	4	3	80	0.0375000
NODE_6604_length_1001_cov_10.156319	640	720	5	23	80	0.2875000
NODE_6604_length_1001_cov_10.156319	640	720	6	29	80	0.3625000
NODE_6604_length_1001_cov_10.156319	640	720	7	9	80	0.1125000
NODE_6605_length_1001_cov_9.754989	377	457	0	26	80	0.3250000
NODE_6605_length_1001_cov_9.754989	377	457	1	6	80	0.0750000
NODE_6605_length_1001_cov_9.754989	377	457	2	48	80	0.6000000
NODE_6605_length_1001_cov_9.754989	430	510	0	79	80	0.9875000
NODE_6605_length_1001_cov_9.754989	430	510	1	1	80	0.0125000
NODE_6607_length_1001_cov_4.616408	408	488	0	38	80	0.4750000
NODE_6607_length_1001_cov_4.616408	408	488	2	35	80	0.4375000
NODE_6607_length_1001_cov_4.616408	408	488	3	7	80	0.0875000
NODE_6607_length_1001_cov_4.616408	461	541	2	20	80	0.2500000
NODE_6607_length_1001_cov_4.616408	461	541	3	27	80	0.3375000
NODE_6607_length_1001_cov_4.616408	461	541	4	27	80	0.3375000
NODE_6607_length_1001_cov_4.616408	461	541	5	6	80	0.0750000
NODE_6616_length_1000_cov_55.578246	393	473	12	1	80	0.0125000
NODE_6616_length_1000_cov_55.578246	393	473	13	18	80	0.2250000
NODE_6616_length_1000_cov_55.578246	393	473	15	14	80	0.1750000
NODE_6616_length_1000_cov_55.578246	393	473	16	36	80	0.4500000
NODE_6616_length_1000_cov_55.578246	393	473	17	11	80	0.1375000
NODE_6616_length_1000_cov_55.578246	446	526	9	15	80	0.1875000
NODE_6616_length_1000_cov_55.578246	446	526	10	2	80	0.0250000
NODE_6616_length_1000_cov_55.578246	446	526	11	6	80	0.0750000
NODE_6616_length_1000_cov_55.578246	446	526	12	5	80	0.0625000
NODE_6616_length_1000_cov_55.578246	446	526	13	18	80	0.2250000
NODE_6616_length_1000_cov_55.578246	446	526	14	1	80	0.0125000
NODE_6616_length_1000_cov_55.578246	446	526	15	10	80	0.1250000
NODE_6616_length_1000_cov_55.578246	446	526	16	21	80	0.2625000
NODE_6616_length_1000_cov_55.578246	446	526	17	2	80	0.0250000
NODE_6616_length_1000_cov_55.578246	522	598	7	1	76	0.0131579
NODE_6616_length_1000_cov_55.578246	522	598	8	6	76	0.0789474
NODE_6616_length_1000_cov_55.578246	522	598	9	6	76	0.0789474
NODE_6616_length_1000_cov_55.578246	522	598	10	2	76	0.0263158
NODE_6616_length_1000_cov_55.578246	522	598	11	34	76	0.4473684
NODE_6616_length_1000_cov_55.578246	522	598	12	9	76	0.1184211
NODE_6616_length_1000_cov_55.578246	522	598	13	18	76	0.2368421
NODE_6616_length_1000_cov_55.578246	575	649	11	2	74	0.0270270
NODE_6616_length_1000_cov_55.578246	575	649	12	8	74	0.1081081
NODE_6616_length_1000_cov_55.578246	575	649	13	26	74	0.3513514
NODE_6616_length_1000_cov_55.578246	575	649	14	2	74	0.0270270
NODE_6616_length_1000_cov_55.578246	575	649	15	6	74	0.0810811
NODE_6616_length_1000_cov_55.578246	575	649	16	30	74	0.4054054
NODE_6617_length_1000_cov_51.534961	432	512	1	26	80	0.3250000
NODE_6617_length_1000_cov_51.534961	432	512	2	24	80	0.3000000
NODE_6617_length_1000_cov_51.534961	432	512	3	17	80	0.2125000
NODE_6617_length_1000_cov_51.534961	432	512	4	13	80	0.1625000
NODE_6617_length_1000_cov_51.534961	485	565	3	14	80	0.1750000
NODE_6617_length_1000_cov_51.534961	485	565	4	16	80	0.2000000
NODE_6617_length_1000_cov_51.534961	485	565	5	16	80	0.2000000
NODE_6617_length_1000_cov_51.534961	485	565	6	20	80	0.2500000
NODE_6617_length_1000_cov_51.534961	485	565	7	4	80	0.0500000
NODE_6617_length_1000_cov_51.534961	485	565	8	4	80	0.0500000
NODE_6617_length_1000_cov_51.534961	485	565	9	6	80	0.0750000
NODE_6617_length_1000_cov_51.534961	561	641	7	11	80	0.1375000
NODE_6617_length_1000_cov_51.534961	561	641	8	35	80	0.4375000
NODE_6617_length_1000_cov_51.534961	561	641	9	34	80	0.4250000
NODE_6617_length_1000_cov_51.534961	614	694	2	15	80	0.1875000
NODE_6617_length_1000_cov_51.534961	614	694	3	5	80	0.0625000
NODE_6617_length_1000_cov_51.534961	614	694	5	11	80	0.1375000
NODE_6617_length_1000_cov_51.534961	614	694	6	16	80	0.2000000
NODE_6617_length_1000_cov_51.534961	614	694	7	17	80	0.2125000
NODE_6617_length_1000_cov_51.534961	614	694	8	16	80	0.2000000
NODE_6618_length_1000_cov_39.011099	186	266	9	9	80	0.1125000
NODE_6618_length_1000_cov_39.011099	186	266	11	12	80	0.1500000
NODE_6618_length_1000_cov_39.011099	186	266	12	54	80	0.6750000
NODE_6618_length_1000_cov_39.011099	186	266	13	5	80	0.0625000
NODE_6618_length_1000_cov_39.011099	239	319	6	6	80	0.0750000
NODE_6618_length_1000_cov_39.011099	239	319	8	9	80	0.1125000
NODE_6618_length_1000_cov_39.011099	239	319	9	33	80	0.4125000
NODE_6618_length_1000_cov_39.011099	239	319	10	2	80	0.0250000
NODE_6618_length_1000_cov_39.011099	239	319	11	1	80	0.0125000
NODE_6618_length_1000_cov_39.011099	239	319	12	29	80	0.3625000
NODE_6619_length_1000_cov_19.897891	451	531	6	6	80	0.0750000
NODE_6619_length_1000_cov_19.897891	451	531	7	5	80	0.0625000
NODE_6619_length_1000_cov_19.897891	451	531	8	13	80	0.1625000
NODE_6619_length_1000_cov_19.897891	451	531	9	2	80	0.0250000
NODE_6619_length_1000_cov_19.897891	451	531	10	32	80	0.4000000
NODE_6619_length_1000_cov_19.897891	451	531	11	22	80	0.2750000
NODE_6619_length_1000_cov_19.897891	504	584	5	5	80	0.0625000
NODE_6619_length_1000_cov_19.897891	504	584	6	26	80	0.3250000
NODE_6619_length_1000_cov_19.897891	504	584	7	16	80	0.2000000
NODE_6619_length_1000_cov_19.897891	504	584	8	9	80	0.1125000
NODE_6619_length_1000_cov_19.897891	504	584	9	2	80	0.0250000
NODE_6619_length_1000_cov_19.897891	504	584	11	22	80	0.2750000
NODE_6619_length_1000_cov_19.897891	580	660	7	4	80	0.0500000
NODE_6619_length_1000_cov_19.897891	580	660	8	58	80	0.7250000
NODE_6619_length_1000_cov_19.897891	580	660	9	11	80	0.1375000
NODE_6619_length_1000_cov_19.897891	580	660	10	7	80	0.0875000
NODE_6619_length_1000_cov_19.897891	633	713	4	4	80	0.0500000
NODE_6619_length_1000_cov_19.897891	633	713	5	8	80	0.1000000
NODE_6619_length_1000_cov_19.897891	633	713	6	12	80	0.1500000
NODE_6619_length_1000_cov_19.897891	633	713	8	50	80	0.6250000
NODE_6619_length_1000_cov_19.897891	633	713	9	6	80	0.0750000
NODE_6620_length_1000_cov_13.349612	324	404	3	13	80	0.1625000
NODE_6620_length_1000_cov_13.349612	324	404	4	67	80	0.8375000
NODE_6620_length_1000_cov_13.349612	377	457	4	49	80	0.6125000
NODE_6620_length_1000_cov_13.349612	377	457	5	11	80	0.1375000
NODE_6620_length_1000_cov_13.349612	377	457	6	20	80	0.2500000
NODE_6621_length_1000_cov_11.463929	382	462	1	47	80	0.5875000
NODE_6621_length_1000_cov_11.463929	382	462	2	33	80	0.4125000
NODE_6621_length_1000_cov_11.463929	435	515	1	80	80	1.0000000
NODE_6622_length_1000_cov_9.675916	625	705	5	2	80	0.0250000
NODE_6622_length_1000_cov_9.675916	625	705	6	17	80	0.2125000
NODE_6622_length_1000_cov_9.675916	625	705	7	47	80	0.5875000
NODE_6622_length_1000_cov_9.675916	625	705	8	14	80	0.1750000
NODE_6622_length_1000_cov_9.675916	678	758	3	12	80	0.1500000
NODE_6622_length_1000_cov_9.675916	678	758	5	43	80	0.5375000
NODE_6622_length_1000_cov_9.675916	678	758	6	6	80	0.0750000
NODE_6622_length_1000_cov_9.675916	678	758	7	5	80	0.0625000
NODE_6622_length_1000_cov_9.675916	678	758	8	14	80	0.1750000
NODE_6623_length_1000_cov_7.051054	358	438	8	1	80	0.0125000
NODE_6623_length_1000_cov_7.051054	358	438	9	13	80	0.1625000
NODE_6623_length_1000_cov_7.051054	358	438	10	29	80	0.3625000
NODE_6623_length_1000_cov_7.051054	358	438	11	11	80	0.1375000
NODE_6623_length_1000_cov_7.051054	358	438	12	26	80	0.3250000
NODE_6623_length_1000_cov_7.051054	411	491	4	4	80	0.0500000
NODE_6623_length_1000_cov_7.051054	411	491	5	6	80	0.0750000
NODE_6623_length_1000_cov_7.051054	411	491	7	6	80	0.0750000
NODE_6623_length_1000_cov_7.051054	411	491	10	16	80	0.2000000
NODE_6623_length_1000_cov_7.051054	411	491	11	27	80	0.3375000
NODE_6623_length_1000_cov_7.051054	411	491	12	21	80	0.2625000
NODE_6626_length_1000_cov_3.652608	203	265	1	62	62	1.0000000
NODE_6639_length_999_cov_47.442222	604	684	11	5	80	0.0625000
NODE_6639_length_999_cov_47.442222	604	684	13	6	80	0.0750000
NODE_6639_length_999_cov_47.442222	604	684	14	64	80	0.8000000
NODE_6639_length_999_cov_47.442222	604	684	15	5	80	0.0625000
NODE_6639_length_999_cov_47.442222	657	723	6	10	66	0.1515152
NODE_6639_length_999_cov_47.442222	657	723	8	16	66	0.2424242
NODE_6639_length_999_cov_47.442222	657	723	9	4	66	0.0606061
NODE_6639_length_999_cov_47.442222	657	723	11	2	66	0.0303030
NODE_6639_length_999_cov_47.442222	657	723	12	2	66	0.0303030
NODE_6639_length_999_cov_47.442222	657	723	13	6	66	0.0909091
NODE_6639_length_999_cov_47.442222	657	723	14	21	66	0.3181818
NODE_6639_length_999_cov_47.442222	657	723	15	5	66	0.0757576
NODE_6640_length_999_cov_33.055556	458	540	3	2	82	0.0243902
NODE_6640_length_999_cov_33.055556	458	540	4	26	82	0.3170732
NODE_6640_length_999_cov_33.055556	458	540	5	53	82	0.6463414
NODE_6640_length_999_cov_33.055556	458	540	6	1	82	0.0121951
NODE_6640_length_999_cov_33.055556	513	593	3	39	80	0.4875000
NODE_6640_length_999_cov_33.055556	513	593	4	41	80	0.5125000
NODE_6641_length_999_cov_22.755556	493	573	12	4	80	0.0500000
NODE_6641_length_999_cov_22.755556	493	573	13	9	80	0.1125000
NODE_6641_length_999_cov_22.755556	493	573	14	4	80	0.0500000
NODE_6641_length_999_cov_22.755556	493	573	16	25	80	0.3125000
NODE_6641_length_999_cov_22.755556	493	573	17	38	80	0.4750000
NODE_6641_length_999_cov_22.755556	546	626	10	10	80	0.1250000
NODE_6641_length_999_cov_22.755556	546	626	11	1	80	0.0125000
NODE_6641_length_999_cov_22.755556	546	626	12	5	80	0.0625000
NODE_6641_length_999_cov_22.755556	546	626	13	8	80	0.1000000
NODE_6641_length_999_cov_22.755556	546	626	14	4	80	0.0500000
NODE_6641_length_999_cov_22.755556	546	626	15	1	80	0.0125000
NODE_6641_length_999_cov_22.755556	546	626	16	1	80	0.0125000
NODE_6641_length_999_cov_22.755556	546	626	17	48	80	0.6000000
NODE_6641_length_999_cov_22.755556	546	626	18	1	80	0.0125000
NODE_6641_length_999_cov_22.755556	546	626	19	1	80	0.0125000
NODE_6642_length_999_cov_21.842222	359	439	0	8	80	0.1000000
NODE_6642_length_999_cov_21.842222	359	439	2	29	80	0.3625000
NODE_6642_length_999_cov_21.842222	359	439	4	15	80	0.1875000
NODE_6642_length_999_cov_21.842222	359	439	6	28	80	0.3500000
NODE_6642_length_999_cov_21.842222	412	492	2	11	80	0.1375000
NODE_6642_length_999_cov_21.842222	412	492	4	5	80	0.0625000
NODE_6642_length_999_cov_21.842222	412	492	6	64	80	0.8000000
NODE_6643_length_999_cov_20.006667	361	441	3	51	80	0.6375000
NODE_6643_length_999_cov_20.006667	361	441	4	29	80	0.3625000
NODE_6643_length_999_cov_20.006667	414	494	3	5	80	0.0625000
NODE_6643_length_999_cov_20.006667	414	494	4	75	80	0.9375000
NODE_6643_length_999_cov_20.006667	490	570	0	8	80	0.1000000
NODE_6643_length_999_cov_20.006667	490	570	1	54	80	0.6750000
NODE_6643_length_999_cov_20.006667	490	570	2	14	80	0.1750000
NODE_6643_length_999_cov_20.006667	490	570	3	4	80	0.0500000
NODE_6643_length_999_cov_20.006667	543	623	0	61	80	0.7625000
NODE_6643_length_999_cov_20.006667	543	623	1	19	80	0.2375000
NODE_6645_length_999_cov_16.794444	438	518	6	15	80	0.1875000
NODE_6645_length_999_cov_16.794444	438	518	7	1	80	0.0125000
NODE_6645_length_999_cov_16.794444	438	518	8	24	80	0.3000000
NODE_6645_length_999_cov_16.794444	438	518	12	33	80	0.4125000
NODE_6645_length_999_cov_16.794444	438	518	13	7	80	0.0875000
NODE_6645_length_999_cov_16.794444	491	571	7	7	80	0.0875000
NODE_6645_length_999_cov_16.794444	491	571	9	20	80	0.2500000
NODE_6645_length_999_cov_16.794444	491	571	11	1	80	0.0125000
NODE_6645_length_999_cov_16.794444	491	571	12	20	80	0.2500000
NODE_6645_length_999_cov_16.794444	491	571	13	32	80	0.4000000
NODE_6646_length_999_cov_15.146667	464	544	2	27	80	0.3375000
NODE_6646_length_999_cov_15.146667	464	544	3	29	80	0.3625000
NODE_6646_length_999_cov_15.146667	464	544	4	24	80	0.3000000
NODE_6646_length_999_cov_15.146667	517	597	0	5	80	0.0625000
NODE_6646_length_999_cov_15.146667	517	597	2	22	80	0.2750000
NODE_6646_length_999_cov_15.146667	517	597	3	53	80	0.6625000
NODE_6648_length_999_cov_8.771111	361	441	0	80	80	1.0000000
NODE_6648_length_999_cov_8.771111	414	492	0	78	78	1.0000000
NODE_6649_length_999_cov_5.171111	417	497	0	48	80	0.6000000
NODE_6649_length_999_cov_5.171111	417	497	2	32	80	0.4000000
NODE_6649_length_999_cov_5.171111	470	550	0	27	80	0.3375000
NODE_6649_length_999_cov_5.171111	470	550	2	53	80	0.6625000
NODE_6650_length_999_cov_2.854444	35	101	0	62	66	0.9393939
NODE_6650_length_999_cov_2.854444	35	101	2	4	66	0.0606061
NODE_6657_length_998_cov_30.697442	404	484	5	3	80	0.0375000
NODE_6657_length_998_cov_30.697442	404	484	8	10	80	0.1250000
NODE_6657_length_998_cov_30.697442	404	484	9	13	80	0.1625000
NODE_6657_length_998_cov_30.697442	404	484	10	2	80	0.0250000
NODE_6657_length_998_cov_30.697442	404	484	11	6	80	0.0750000
NODE_6657_length_998_cov_30.697442	404	484	13	28	80	0.3500000
NODE_6657_length_998_cov_30.697442	404	484	14	18	80	0.2250000
NODE_6657_length_998_cov_30.697442	457	537	5	25	80	0.3125000
NODE_6657_length_998_cov_30.697442	457	537	6	10	80	0.1250000
NODE_6657_length_998_cov_30.697442	457	537	7	21	80	0.2625000
NODE_6657_length_998_cov_30.697442	457	537	8	10	80	0.1250000
NODE_6657_length_998_cov_30.697442	457	537	9	5	80	0.0625000
NODE_6657_length_998_cov_30.697442	457	537	11	6	80	0.0750000
NODE_6657_length_998_cov_30.697442	457	537	13	3	80	0.0375000
NODE_6657_length_998_cov_30.697442	533	613	5	31	80	0.3875000
NODE_6657_length_998_cov_30.697442	533	613	6	18	80	0.2250000
NODE_6657_length_998_cov_30.697442	533	613	7	10	80	0.1250000
NODE_6657_length_998_cov_30.697442	533	613	8	19	80	0.2375000
NODE_6657_length_998_cov_30.697442	533	613	9	2	80	0.0250000
NODE_6657_length_998_cov_30.697442	586	666	2	5	80	0.0625000
NODE_6657_length_998_cov_30.697442	586	666	5	35	80	0.4375000
NODE_6657_length_998_cov_30.697442	586	666	6	40	80	0.5000000
NODE_6658_length_998_cov_23.703003	235	315	5	14	80	0.1750000
NODE_6658_length_998_cov_23.703003	235	315	6	46	80	0.5750000
NODE_6658_length_998_cov_23.703003	235	315	7	20	80	0.2500000
NODE_6658_length_998_cov_23.703003	288	368	3	19	80	0.2375000
NODE_6658_length_998_cov_23.703003	288	368	4	34	80	0.4250000
NODE_6658_length_998_cov_23.703003	288	368	5	8	80	0.1000000
NODE_6658_length_998_cov_23.703003	288	368	6	5	80	0.0625000
NODE_6658_length_998_cov_23.703003	288	368	7	14	80	0.1750000
NODE_6659_length_998_cov_22.692992	531	611	0	15	80	0.1875000
NODE_6659_length_998_cov_22.692992	531	611	1	18	80	0.2250000
NODE_6659_length_998_cov_22.692992	531	611	2	47	80	0.5875000
NODE_6659_length_998_cov_22.692992	584	664	0	36	80	0.4500000
NODE_6659_length_998_cov_22.692992	584	664	1	44	80	0.5500000
NODE_6660_length_998_cov_11.152392	514	594	2	80	80	1.0000000
NODE_6660_length_998_cov_11.152392	567	640	1	19	73	0.2602740
NODE_6660_length_998_cov_11.152392	567	640	2	54	73	0.7397260
NODE_6660_length_998_cov_11.152392	636	716	1	16	80	0.2000000
NODE_6660_length_998_cov_11.152392	636	716	2	27	80	0.3375000
NODE_6660_length_998_cov_11.152392	636	716	3	37	80	0.4625000
NODE_6660_length_998_cov_11.152392	689	769	3	73	80	0.9125000
NODE_6660_length_998_cov_11.152392	689	769	4	7	80	0.0875000
NODE_6661_length_998_cov_10.061179	422	502	0	6	80	0.0750000
NODE_6661_length_998_cov_10.061179	422	502	2	16	80	0.2000000
NODE_6661_length_998_cov_10.061179	422	502	3	58	80	0.7250000
NODE_6661_length_998_cov_10.061179	475	555	1	30	80	0.3750000
NODE_6661_length_998_cov_10.061179	475	555	3	50	80	0.6250000
NODE_6662_length_998_cov_7.126808	353	430	3	33	77	0.4285714
NODE_6662_length_998_cov_7.126808	353	430	4	20	77	0.2597403
NODE_6662_length_998_cov_7.126808	353	430	5	24	77	0.3116883
NODE_6662_length_998_cov_7.126808	403	483	3	14	80	0.1750000
NODE_6662_length_998_cov_7.126808	403	483	4	15	80	0.1875000
NODE_6662_length_998_cov_7.126808	403	483	5	51	80	0.6375000
NODE_6669_length_997_cov_48.518931	445	525	16	1	80	0.0125000
NODE_6669_length_997_cov_48.518931	445	525	18	2	80	0.0250000
NODE_6669_length_997_cov_48.518931	445	525	21	5	80	0.0625000
NODE_6669_length_997_cov_48.518931	445	525	22	4	80	0.0500000
NODE_6669_length_997_cov_48.518931	445	525	23	9	80	0.1125000
NODE_6669_length_997_cov_48.518931	445	525	24	10	80	0.1250000
NODE_6669_length_997_cov_48.518931	445	525	26	2	80	0.0250000
NODE_6669_length_997_cov_48.518931	445	525	27	5	80	0.0625000
NODE_6669_length_997_cov_48.518931	445	525	28	20	80	0.2500000
NODE_6669_length_997_cov_48.518931	445	525	29	22	80	0.2750000
NODE_6669_length_997_cov_48.518931	498	578	17	13	80	0.1625000
NODE_6669_length_997_cov_48.518931	498	578	18	15	80	0.1875000
NODE_6669_length_997_cov_48.518931	498	578	20	4	80	0.0500000
NODE_6669_length_997_cov_48.518931	498	578	21	6	80	0.0750000
NODE_6669_length_997_cov_48.518931	498	578	23	3	80	0.0375000
NODE_6669_length_997_cov_48.518931	498	578	24	1	80	0.0125000
NODE_6669_length_997_cov_48.518931	498	578	25	1	80	0.0125000
NODE_6669_length_997_cov_48.518931	498	578	26	6	80	0.0750000
NODE_6669_length_997_cov_48.518931	498	578	27	5	80	0.0625000
NODE_6669_length_997_cov_48.518931	498	578	28	19	80	0.2375000
NODE_6669_length_997_cov_48.518931	498	578	29	7	80	0.0875000
NODE_6670_length_997_cov_36.721604	400	480	2	66	80	0.8250000
NODE_6670_length_997_cov_36.721604	400	480	4	14	80	0.1750000
NODE_6670_length_997_cov_36.721604	453	533	2	13	80	0.1625000
NODE_6670_length_997_cov_36.721604	453	533	3	34	80	0.4250000
NODE_6670_length_997_cov_36.721604	453	533	4	30	80	0.3750000
NODE_6670_length_997_cov_36.721604	453	533	5	3	80	0.0375000
NODE_6671_length_997_cov_22.646993	328	408	4	31	80	0.3875000
NODE_6671_length_997_cov_22.646993	328	408	6	49	80	0.6125000
NODE_6671_length_997_cov_22.646993	381	461	3	4	80	0.0500000
NODE_6671_length_997_cov_22.646993	381	461	4	26	80	0.3250000
NODE_6671_length_997_cov_22.646993	381	461	5	22	80	0.2750000
NODE_6671_length_997_cov_22.646993	381	461	6	28	80	0.3500000
NODE_6672_length_997_cov_19.709354	420	500	2	13	80	0.1625000
NODE_6672_length_997_cov_19.709354	420	500	4	67	80	0.8375000
NODE_6672_length_997_cov_19.709354	473	553	1	19	80	0.2375000
NODE_6672_length_997_cov_19.709354	473	553	2	40	80	0.5000000
NODE_6672_length_997_cov_19.709354	473	553	3	7	80	0.0875000
NODE_6672_length_997_cov_19.709354	473	553	4	14	80	0.1750000
NODE_6672_length_997_cov_19.709354	549	629	1	10	80	0.1250000
NODE_6672_length_997_cov_19.709354	549	629	2	4	80	0.0500000
NODE_6672_length_997_cov_19.709354	549	629	3	2	80	0.0250000
NODE_6672_length_997_cov_19.709354	549	629	4	8	80	0.1000000
NODE_6672_length_997_cov_19.709354	549	629	5	56	80	0.7000000
NODE_6672_length_997_cov_19.709354	602	682	5	61	80	0.7625000
NODE_6672_length_997_cov_19.709354	602	682	6	6	80	0.0750000
NODE_6672_length_997_cov_19.709354	602	682	7	5	80	0.0625000
NODE_6672_length_997_cov_19.709354	602	682	8	8	80	0.1000000
NODE_6673_length_997_cov_17.947661	465	545	1	25	80	0.3125000
NODE_6673_length_997_cov_17.947661	465	545	2	4	80	0.0500000
NODE_6673_length_997_cov_17.947661	465	545	3	25	80	0.3125000
NODE_6673_length_997_cov_17.947661	465	545	4	21	80	0.2625000
NODE_6673_length_997_cov_17.947661	465	545	5	5	80	0.0625000
NODE_6673_length_997_cov_17.947661	518	598	3	20	80	0.2500000
NODE_6673_length_997_cov_17.947661	518	598	4	2	80	0.0250000
NODE_6673_length_997_cov_17.947661	518	598	5	22	80	0.2750000
NODE_6673_length_997_cov_17.947661	518	598	6	36	80	0.4500000
NODE_6673_length_997_cov_17.947661	594	674	5	28	80	0.3500000
NODE_6673_length_997_cov_17.947661	594	674	6	28	80	0.3500000
NODE_6673_length_997_cov_17.947661	594	674	7	20	80	0.2500000
NODE_6673_length_997_cov_17.947661	594	674	8	4	80	0.0500000
NODE_6673_length_997_cov_17.947661	647	727	3	9	80	0.1125000
NODE_6673_length_997_cov_17.947661	647	727	5	6	80	0.0750000
NODE_6673_length_997_cov_17.947661	647	727	6	32	80	0.4000000
NODE_6673_length_997_cov_17.947661	647	727	7	15	80	0.1875000
NODE_6673_length_997_cov_17.947661	647	727	8	18	80	0.2250000
NODE_6674_length_997_cov_14.718263	388	468	6	2	80	0.0250000
NODE_6674_length_997_cov_14.718263	388	468	7	7	80	0.0875000
NODE_6674_length_997_cov_14.718263	388	468	8	1	80	0.0125000
NODE_6674_length_997_cov_14.718263	388	468	9	1	80	0.0125000
NODE_6674_length_997_cov_14.718263	388	468	11	68	80	0.8500000
NODE_6674_length_997_cov_14.718263	388	468	13	1	80	0.0125000
NODE_6674_length_997_cov_14.718263	441	521	2	21	80	0.2625000
NODE_6674_length_997_cov_14.718263	441	521	3	1	80	0.0125000
NODE_6674_length_997_cov_14.718263	441	521	5	21	80	0.2625000
NODE_6674_length_997_cov_14.718263	441	521	6	12	80	0.1500000
NODE_6674_length_997_cov_14.718263	441	521	7	7	80	0.0875000
NODE_6674_length_997_cov_14.718263	441	521	8	1	80	0.0125000
NODE_6674_length_997_cov_14.718263	441	521	9	1	80	0.0125000
NODE_6674_length_997_cov_14.718263	441	521	11	16	80	0.2000000
NODE_6675_length_997_cov_7.114699	307	387	0	13	80	0.1625000
NODE_6675_length_997_cov_7.114699	307	387	2	67	80	0.8375000
NODE_6675_length_997_cov_7.114699	360	440	2	80	80	1.0000000
NODE_6694_length_996_cov_59.568562	387	467	1	24	80	0.3000000
NODE_6694_length_996_cov_59.568562	387	467	2	6	80	0.0750000
NODE_6694_length_996_cov_59.568562	387	467	4	4	80	0.0500000
NODE_6694_length_996_cov_59.568562	387	467	6	18	80	0.2250000
NODE_6694_length_996_cov_59.568562	387	467	7	13	80	0.1625000
NODE_6694_length_996_cov_59.568562	387	467	8	15	80	0.1875000
NODE_6694_length_996_cov_59.568562	440	520	7	27	80	0.3375000
NODE_6694_length_996_cov_59.568562	440	520	8	38	80	0.4750000
NODE_6694_length_996_cov_59.568562	440	520	9	15	80	0.1875000
NODE_6695_length_996_cov_32.462653	503	583	1	46	80	0.5750000
NODE_6695_length_996_cov_32.462653	503	583	2	34	80	0.4250000
NODE_6695_length_996_cov_32.462653	556	636	0	29	80	0.3625000
NODE_6695_length_996_cov_32.462653	556	636	1	51	80	0.6375000
NODE_6696_length_996_cov_23.312152	571	651	6	12	80	0.1500000
NODE_6696_length_996_cov_23.312152	571	651	7	10	80	0.1250000
NODE_6696_length_996_cov_23.312152	571	651	8	58	80	0.7250000
NODE_6696_length_996_cov_23.312152	624	704	3	8	80	0.1000000
NODE_6696_length_996_cov_23.312152	624	704	5	8	80	0.1000000
NODE_6696_length_996_cov_23.312152	624	704	6	7	80	0.0875000
NODE_6696_length_996_cov_23.312152	624	704	7	23	80	0.2875000
NODE_6696_length_996_cov_23.312152	624	704	8	34	80	0.4250000
NODE_6697_length_996_cov_20.979933	533	613	8	6	80	0.0750000
NODE_6697_length_996_cov_20.979933	533	613	9	8	80	0.1000000
NODE_6697_length_996_cov_20.979933	533	613	10	12	80	0.1500000
NODE_6697_length_996_cov_20.979933	533	613	11	3	80	0.0375000
NODE_6697_length_996_cov_20.979933	533	613	12	42	80	0.5250000
NODE_6697_length_996_cov_20.979933	533	613	13	9	80	0.1125000
NODE_6697_length_996_cov_20.979933	586	666	8	23	80	0.2875000
NODE_6697_length_996_cov_20.979933	586	666	9	12	80	0.1500000
NODE_6697_length_996_cov_20.979933	586	666	11	5	80	0.0625000
NODE_6697_length_996_cov_20.979933	586	666	12	18	80	0.2250000
NODE_6697_length_996_cov_20.979933	586	666	13	22	80	0.2750000
NODE_6698_length_996_cov_17.865106	535	615	5	8	80	0.1000000
NODE_6698_length_996_cov_17.865106	535	615	6	23	80	0.2875000
NODE_6698_length_996_cov_17.865106	535	615	8	5	80	0.0625000
NODE_6698_length_996_cov_17.865106	535	615	9	14	80	0.1750000
NODE_6698_length_996_cov_17.865106	535	615	10	30	80	0.3750000
NODE_6698_length_996_cov_17.865106	588	668	3	20	80	0.2500000
NODE_6698_length_996_cov_17.865106	588	668	5	6	80	0.0750000
NODE_6698_length_996_cov_17.865106	588	668	6	2	80	0.0250000
NODE_6698_length_996_cov_17.865106	588	668	8	22	80	0.2750000
NODE_6698_length_996_cov_17.865106	588	668	9	14	80	0.1750000
NODE_6698_length_996_cov_17.865106	588	668	10	16	80	0.2000000
NODE_6699_length_996_cov_10.297659	499	579	2	39	80	0.4875000
NODE_6699_length_996_cov_10.297659	499	579	3	41	80	0.5125000
NODE_6699_length_996_cov_10.297659	552	630	1	26	78	0.3333333
NODE_6699_length_996_cov_10.297659	552	630	2	15	78	0.1923077
NODE_6699_length_996_cov_10.297659	552	630	3	37	78	0.4743590
NODE_6702_length_996_cov_3.205128	499	555	0	56	56	1.0000000
NODE_6707_length_995_cov_26.131696	543	623	12	1	80	0.0125000
NODE_6707_length_995_cov_26.131696	543	623	13	16	80	0.2000000
NODE_6707_length_995_cov_26.131696	543	623	14	5	80	0.0625000
NODE_6707_length_995_cov_26.131696	543	623	15	15	80	0.1875000
NODE_6707_length_995_cov_26.131696	543	623	16	26	80	0.3250000
NODE_6707_length_995_cov_26.131696	543	623	17	17	80	0.2125000
NODE_6707_length_995_cov_26.131696	596	676	7	2	80	0.0250000
NODE_6707_length_995_cov_26.131696	596	676	8	4	80	0.0500000
NODE_6707_length_995_cov_26.131696	596	676	9	11	80	0.1375000
NODE_6707_length_995_cov_26.131696	596	676	10	34	80	0.4250000
NODE_6707_length_995_cov_26.131696	596	676	12	1	80	0.0125000
NODE_6707_length_995_cov_26.131696	596	676	13	18	80	0.2250000
NODE_6707_length_995_cov_26.131696	596	676	14	5	80	0.0625000
NODE_6707_length_995_cov_26.131696	596	676	15	5	80	0.0625000
NODE_6708_length_995_cov_20.262277	457	537	3	20	80	0.2500000
NODE_6708_length_995_cov_20.262277	457	537	4	1	80	0.0125000
NODE_6708_length_995_cov_20.262277	457	537	5	59	80	0.7375000
NODE_6708_length_995_cov_20.262277	510	590	2	6	80	0.0750000
NODE_6708_length_995_cov_20.262277	510	590	3	38	80	0.4750000
NODE_6708_length_995_cov_20.262277	510	590	4	2	80	0.0250000
NODE_6708_length_995_cov_20.262277	510	590	5	34	80	0.4250000
NODE_6709_length_995_cov_19.382812	457	537	2	13	80	0.1625000
NODE_6709_length_995_cov_19.382812	457	537	4	36	80	0.4500000
NODE_6709_length_995_cov_19.382812	457	537	5	11	80	0.1375000
NODE_6709_length_995_cov_19.382812	457	537	6	20	80	0.2500000
NODE_6709_length_995_cov_19.382812	510	590	0	17	80	0.2125000
NODE_6709_length_995_cov_19.382812	510	590	2	49	80	0.6125000
NODE_6709_length_995_cov_19.382812	510	590	4	14	80	0.1750000
NODE_6710_length_995_cov_19.034598	453	533	4	15	80	0.1875000
NODE_6710_length_995_cov_19.034598	453	533	6	11	80	0.1375000
NODE_6710_length_995_cov_19.034598	453	533	8	54	80	0.6750000
NODE_6710_length_995_cov_19.034598	506	586	0	17	80	0.2125000
NODE_6710_length_995_cov_19.034598	506	586	1	14	80	0.1750000
NODE_6710_length_995_cov_19.034598	506	586	3	2	80	0.0250000
NODE_6710_length_995_cov_19.034598	506	586	4	24	80	0.3000000
NODE_6710_length_995_cov_19.034598	506	586	6	6	80	0.0750000
NODE_6710_length_995_cov_19.034598	506	586	8	17	80	0.2125000
NODE_6711_length_995_cov_9.734375	222	323	2	101	101	1.0000000
NODE_6711_length_995_cov_9.734375	296	376	0	20	80	0.2500000
NODE_6711_length_995_cov_9.734375	296	376	2	60	80	0.7500000
NODE_6723_length_994_cov_74.678212	362	442	8	26	80	0.3250000
NODE_6723_length_994_cov_74.678212	362	442	10	14	80	0.1750000
NODE_6723_length_994_cov_74.678212	362	442	11	24	80	0.3000000
NODE_6723_length_994_cov_74.678212	362	442	12	14	80	0.1750000
NODE_6723_length_994_cov_74.678212	362	442	13	2	80	0.0250000
NODE_6723_length_994_cov_74.678212	415	495	10	10	80	0.1250000
NODE_6723_length_994_cov_74.678212	415	495	11	31	80	0.3875000
NODE_6723_length_994_cov_74.678212	415	495	12	33	80	0.4125000
NODE_6723_length_994_cov_74.678212	415	495	13	6	80	0.0750000
NODE_6723_length_994_cov_74.678212	491	571	4	19	80	0.2375000
NODE_6723_length_994_cov_74.678212	491	571	5	14	80	0.1750000
NODE_6723_length_994_cov_74.678212	491	571	7	30	80	0.3750000
NODE_6723_length_994_cov_74.678212	491	571	9	2	80	0.0250000
NODE_6723_length_994_cov_74.678212	491	571	11	15	80	0.1875000
NODE_6723_length_994_cov_74.678212	544	624	1	7	80	0.0875000
NODE_6723_length_994_cov_74.678212	544	624	2	24	80	0.3000000
NODE_6723_length_994_cov_74.678212	544	624	3	10	80	0.1250000
NODE_6723_length_994_cov_74.678212	544	624	4	31	80	0.3875000
NODE_6723_length_994_cov_74.678212	544	624	5	8	80	0.1000000
NODE_6724_length_994_cov_26.045810	442	522	1	7	80	0.0875000
NODE_6724_length_994_cov_26.045810	442	522	3	73	80	0.9125000
NODE_6724_length_994_cov_26.045810	495	575	0	7	80	0.0875000
NODE_6724_length_994_cov_26.045810	495	575	1	53	80	0.6625000
NODE_6724_length_994_cov_26.045810	495	575	3	20	80	0.2500000
NODE_6725_length_994_cov_25.240223	504	584	7	15	80	0.1875000
NODE_6725_length_994_cov_25.240223	504	584	9	38	80	0.4750000
NODE_6725_length_994_cov_25.240223	504	584	10	12	80	0.1500000
NODE_6725_length_994_cov_25.240223	504	584	11	8	80	0.1000000
NODE_6725_length_994_cov_25.240223	504	584	12	7	80	0.0875000
NODE_6725_length_994_cov_25.240223	557	637	5	2	80	0.0250000
NODE_6725_length_994_cov_25.240223	557	637	7	2	80	0.0250000
NODE_6725_length_994_cov_25.240223	557	637	8	20	80	0.2500000
NODE_6725_length_994_cov_25.240223	557	637	9	50	80	0.6250000
NODE_6725_length_994_cov_25.240223	557	637	11	6	80	0.0750000
NODE_6726_length_994_cov_24.615642	422	502	2	59	80	0.7375000
NODE_6726_length_994_cov_24.615642	422	502	4	10	80	0.1250000
NODE_6726_length_994_cov_24.615642	422	502	6	11	80	0.1375000
NODE_6726_length_994_cov_24.615642	475	555	2	6	80	0.0750000
NODE_6726_length_994_cov_24.615642	475	555	4	10	80	0.1250000
NODE_6726_length_994_cov_24.615642	475	555	6	43	80	0.5375000
NODE_6726_length_994_cov_24.615642	475	555	7	5	80	0.0625000
NODE_6726_length_994_cov_24.615642	475	555	8	7	80	0.0875000
NODE_6726_length_994_cov_24.615642	475	555	9	9	80	0.1125000
NODE_6726_length_994_cov_24.615642	551	631	7	3	80	0.0375000
NODE_6726_length_994_cov_24.615642	551	631	8	44	80	0.5500000
NODE_6726_length_994_cov_24.615642	551	631	9	16	80	0.2000000
NODE_6726_length_994_cov_24.615642	551	631	10	17	80	0.2125000
NODE_6726_length_994_cov_24.615642	604	684	8	18	80	0.2250000
NODE_6726_length_994_cov_24.615642	604	684	10	62	80	0.7750000
NODE_6727_length_994_cov_22.593296	323	403	1	35	80	0.4375000
NODE_6727_length_994_cov_22.593296	323	403	3	1	80	0.0125000
NODE_6727_length_994_cov_22.593296	323	403	4	2	80	0.0250000
NODE_6727_length_994_cov_22.593296	323	403	5	12	80	0.1500000
NODE_6727_length_994_cov_22.593296	323	403	6	30	80	0.3750000
NODE_6727_length_994_cov_22.593296	376	456	5	39	80	0.4875000
NODE_6727_length_994_cov_22.593296	376	456	6	39	80	0.4875000
NODE_6727_length_994_cov_22.593296	376	456	7	2	80	0.0250000
NODE_6727_length_994_cov_22.593296	452	532	2	6	80	0.0750000
NODE_6727_length_994_cov_22.593296	452	532	4	15	80	0.1875000
NODE_6727_length_994_cov_22.593296	452	532	5	24	80	0.3000000
NODE_6727_length_994_cov_22.593296	452	532	6	9	80	0.1125000
NODE_6727_length_994_cov_22.593296	452	532	7	26	80	0.3250000
NODE_6727_length_994_cov_22.593296	505	585	2	6	80	0.0750000
NODE_6727_length_994_cov_22.593296	505	585	3	2	80	0.0250000
NODE_6727_length_994_cov_22.593296	505	585	4	66	80	0.8250000
NODE_6727_length_994_cov_22.593296	505	585	5	6	80	0.0750000
NODE_6728_length_994_cov_6.985475	0	58	0	58	58	1.0000000
NODE_6728_length_994_cov_6.985475	15	95	0	80	80	1.0000000
NODE_6728_length_994_cov_6.985475	68	148	0	80	80	1.0000000
NODE_6740_length_993_cov_56.321029	266	346	1	9	80	0.1125000
NODE_6740_length_993_cov_56.321029	266	346	2	71	80	0.8875000
NODE_6740_length_993_cov_56.321029	319	399	1	26	80	0.3250000
NODE_6740_length_993_cov_56.321029	319	399	2	54	80	0.6750000
NODE_6740_length_993_cov_56.321029	400	470	0	45	70	0.6428571
NODE_6740_length_993_cov_56.321029	400	470	1	25	70	0.3571429
NODE_6740_length_993_cov_56.321029	443	523	0	50	80	0.6250000
NODE_6740_length_993_cov_56.321029	443	523	1	30	80	0.3750000
NODE_6741_length_993_cov_44.695749	385	465	5	11	80	0.1375000
NODE_6741_length_993_cov_44.695749	385	465	7	11	80	0.1375000
NODE_6741_length_993_cov_44.695749	385	465	10	1	80	0.0125000
NODE_6741_length_993_cov_44.695749	385	465	12	12	80	0.1500000
NODE_6741_length_993_cov_44.695749	385	465	13	1	80	0.0125000
NODE_6741_length_993_cov_44.695749	385	465	15	11	80	0.1375000
NODE_6741_length_993_cov_44.695749	385	465	17	8	80	0.1000000
NODE_6741_length_993_cov_44.695749	385	465	18	8	80	0.1000000
NODE_6741_length_993_cov_44.695749	385	465	19	17	80	0.2125000
NODE_6741_length_993_cov_44.695749	438	518	17	6	80	0.0750000
NODE_6741_length_993_cov_44.695749	438	518	18	11	80	0.1375000
NODE_6741_length_993_cov_44.695749	438	518	19	46	80	0.5750000
NODE_6741_length_993_cov_44.695749	438	518	20	17	80	0.2125000
NODE_6742_length_993_cov_40.574944	417	497	3	11	80	0.1375000
NODE_6742_length_993_cov_40.574944	417	497	4	21	80	0.2625000
NODE_6742_length_993_cov_40.574944	417	497	5	43	80	0.5375000
NODE_6742_length_993_cov_40.574944	417	497	6	5	80	0.0625000
NODE_6742_length_993_cov_40.574944	470	550	3	6	80	0.0750000
NODE_6742_length_993_cov_40.574944	470	550	4	9	80	0.1125000
NODE_6742_length_993_cov_40.574944	470	550	5	17	80	0.2125000
NODE_6742_length_993_cov_40.574944	470	550	6	13	80	0.1625000
NODE_6742_length_993_cov_40.574944	470	550	8	2	80	0.0250000
NODE_6742_length_993_cov_40.574944	470	550	9	14	80	0.1750000
NODE_6742_length_993_cov_40.574944	470	550	10	15	80	0.1875000
NODE_6742_length_993_cov_40.574944	470	550	11	4	80	0.0500000
NODE_6742_length_993_cov_40.574944	546	628	10	1	82	0.0121951
NODE_6742_length_993_cov_40.574944	546	628	11	23	82	0.2804878
NODE_6742_length_993_cov_40.574944	546	628	12	44	82	0.5365854
NODE_6742_length_993_cov_40.574944	546	628	13	14	82	0.1707317
NODE_6742_length_993_cov_40.574944	601	681	9	14	80	0.1750000
NODE_6742_length_993_cov_40.574944	601	681	10	3	80	0.0375000
NODE_6742_length_993_cov_40.574944	601	681	11	12	80	0.1500000
NODE_6742_length_993_cov_40.574944	601	681	12	39	80	0.4875000
NODE_6742_length_993_cov_40.574944	601	681	13	12	80	0.1500000
NODE_6743_length_993_cov_39.817673	3	83	0	80	80	1.0000000
NODE_6744_length_993_cov_30.128635	477	557	5	23	80	0.2875000
NODE_6744_length_993_cov_30.128635	477	557	7	54	80	0.6750000
NODE_6744_length_993_cov_30.128635	477	557	9	3	80	0.0375000
NODE_6744_length_993_cov_30.128635	530	610	3	9	80	0.1125000
NODE_6744_length_993_cov_30.128635	530	610	4	14	80	0.1750000
NODE_6744_length_993_cov_30.128635	530	610	5	20	80	0.2500000
NODE_6744_length_993_cov_30.128635	530	610	6	9	80	0.1125000
NODE_6744_length_993_cov_30.128635	530	610	7	28	80	0.3500000
NODE_6745_length_993_cov_17.435123	573	653	5	22	80	0.2750000
NODE_6745_length_993_cov_17.435123	573	653	6	58	80	0.7250000
NODE_6745_length_993_cov_17.435123	626	706	0	24	80	0.3000000
NODE_6745_length_993_cov_17.435123	626	706	1	2	80	0.0250000
NODE_6745_length_993_cov_17.435123	626	706	2	19	80	0.2375000
NODE_6745_length_993_cov_17.435123	626	706	5	30	80	0.3750000
NODE_6745_length_993_cov_17.435123	626	706	6	5	80	0.0625000
NODE_6746_length_993_cov_13.074944	483	563	1	34	80	0.4250000
NODE_6746_length_993_cov_13.074944	483	563	2	4	80	0.0500000
NODE_6746_length_993_cov_13.074944	483	563	3	42	80	0.5250000
NODE_6746_length_993_cov_13.074944	536	616	2	34	80	0.4250000
NODE_6746_length_993_cov_13.074944	536	616	3	46	80	0.5750000
NODE_6747_length_993_cov_10.190157	500	580	5	33	80	0.4125000
NODE_6747_length_993_cov_10.190157	500	580	6	47	80	0.5875000
NODE_6747_length_993_cov_10.190157	553	633	4	12	80	0.1500000
NODE_6747_length_993_cov_10.190157	553	633	5	68	80	0.8500000
NODE_6756_length_993_cov_0.909396	16	73	0	57	57	1.0000000
NODE_6757_length_992_cov_36.119821	354	434	6	11	80	0.1375000
NODE_6757_length_992_cov_36.119821	354	434	7	1	80	0.0125000
NODE_6757_length_992_cov_36.119821	354	434	9	2	80	0.0250000
NODE_6757_length_992_cov_36.119821	354	434	10	14	80	0.1750000
NODE_6757_length_992_cov_36.119821	354	434	11	20	80	0.2500000
NODE_6757_length_992_cov_36.119821	354	434	12	22	80	0.2750000
NODE_6757_length_992_cov_36.119821	354	434	14	5	80	0.0625000
NODE_6757_length_992_cov_36.119821	354	434	15	5	80	0.0625000
NODE_6757_length_992_cov_36.119821	407	487	11	2	80	0.0250000
NODE_6757_length_992_cov_36.119821	407	487	12	15	80	0.1875000
NODE_6757_length_992_cov_36.119821	407	487	14	30	80	0.3750000
NODE_6757_length_992_cov_36.119821	407	487	15	29	80	0.3625000
NODE_6757_length_992_cov_36.119821	407	487	16	4	80	0.0500000
NODE_6757_length_992_cov_36.119821	483	563	10	24	80	0.3000000
NODE_6757_length_992_cov_36.119821	483	563	11	14	80	0.1750000
NODE_6757_length_992_cov_36.119821	483	563	12	11	80	0.1375000
NODE_6757_length_992_cov_36.119821	483	563	13	13	80	0.1625000
NODE_6757_length_992_cov_36.119821	483	563	14	11	80	0.1375000
NODE_6757_length_992_cov_36.119821	483	563	15	7	80	0.0875000
NODE_6757_length_992_cov_36.119821	536	616	4	18	80	0.2250000
NODE_6757_length_992_cov_36.119821	536	616	5	1	80	0.0125000
NODE_6757_length_992_cov_36.119821	536	616	6	13	80	0.1625000
NODE_6757_length_992_cov_36.119821	536	616	7	5	80	0.0625000
NODE_6757_length_992_cov_36.119821	536	616	8	5	80	0.0625000
NODE_6757_length_992_cov_36.119821	536	616	10	17	80	0.2125000
NODE_6757_length_992_cov_36.119821	536	616	11	11	80	0.1375000
NODE_6757_length_992_cov_36.119821	536	616	12	10	80	0.1250000
NODE_6758_length_992_cov_34.802912	443	523	1	80	80	1.0000000
NODE_6758_length_992_cov_34.802912	496	576	0	24	80	0.3000000
NODE_6758_length_992_cov_34.802912	496	576	1	56	80	0.7000000
NODE_6759_length_992_cov_33.047032	381	461	9	9	80	0.1125000
NODE_6759_length_992_cov_33.047032	381	461	10	28	80	0.3500000
NODE_6759_length_992_cov_33.047032	381	461	11	38	80	0.4750000
NODE_6759_length_992_cov_33.047032	381	461	12	5	80	0.0625000
NODE_6759_length_992_cov_33.047032	434	514	5	3	80	0.0375000
NODE_6759_length_992_cov_33.047032	434	514	6	27	80	0.3375000
NODE_6759_length_992_cov_33.047032	434	514	7	11	80	0.1375000
NODE_6759_length_992_cov_33.047032	434	514	8	11	80	0.1375000
NODE_6759_length_992_cov_33.047032	434	514	9	9	80	0.1125000
NODE_6759_length_992_cov_33.047032	434	514	10	14	80	0.1750000
NODE_6759_length_992_cov_33.047032	434	514	12	5	80	0.0625000
NODE_6759_length_992_cov_33.047032	510	590	5	49	80	0.6125000
NODE_6759_length_992_cov_33.047032	510	590	6	13	80	0.1625000
NODE_6759_length_992_cov_33.047032	510	590	7	17	80	0.2125000
NODE_6759_length_992_cov_33.047032	510	590	8	1	80	0.0125000
NODE_6759_length_992_cov_33.047032	563	643	4	40	80	0.5000000
NODE_6759_length_992_cov_33.047032	563	643	5	40	80	0.5000000
NODE_6760_length_992_cov_23.543113	435	515	0	34	80	0.4250000
NODE_6760_length_992_cov_23.543113	435	515	1	43	80	0.5375000
NODE_6760_length_992_cov_23.543113	435	515	2	3	80	0.0375000
NODE_6760_length_992_cov_23.543113	488	568	1	24	80	0.3000000
NODE_6760_length_992_cov_23.543113	488	568	2	11	80	0.1375000
NODE_6760_length_992_cov_23.543113	488	568	3	45	80	0.5625000
NODE_6761_length_992_cov_22.608063	440	520	6	2	80	0.0250000
NODE_6761_length_992_cov_22.608063	440	520	7	38	80	0.4750000
NODE_6761_length_992_cov_22.608063	440	520	8	25	80	0.3125000
NODE_6761_length_992_cov_22.608063	440	520	9	15	80	0.1875000
NODE_6761_length_992_cov_22.608063	493	573	3	30	80	0.3750000
NODE_6761_length_992_cov_22.608063	493	573	4	7	80	0.0875000
NODE_6761_length_992_cov_22.608063	493	573	5	5	80	0.0625000
NODE_6761_length_992_cov_22.608063	493	573	6	13	80	0.1625000
NODE_6761_length_992_cov_22.608063	493	573	7	9	80	0.1125000
NODE_6761_length_992_cov_22.608063	493	573	8	16	80	0.2000000
NODE_6762_length_992_cov_21.427772	216	296	3	80	80	1.0000000
NODE_6762_length_992_cov_21.427772	269	349	0	12	80	0.1500000
NODE_6762_length_992_cov_21.427772	269	349	1	5	80	0.0625000
NODE_6762_length_992_cov_21.427772	269	349	2	4	80	0.0500000
NODE_6762_length_992_cov_21.427772	269	349	3	59	80	0.7375000
NODE_6763_length_992_cov_20.010078	312	392	7	24	80	0.3000000
NODE_6763_length_992_cov_20.010078	312	392	9	2	80	0.0250000
NODE_6763_length_992_cov_20.010078	312	392	11	50	80	0.6250000
NODE_6763_length_992_cov_20.010078	312	392	12	4	80	0.0500000
NODE_6763_length_992_cov_20.010078	365	445	2	17	80	0.2125000
NODE_6763_length_992_cov_20.010078	365	445	4	11	80	0.1375000
NODE_6763_length_992_cov_20.010078	365	445	6	3	80	0.0375000
NODE_6763_length_992_cov_20.010078	365	445	8	5	80	0.0625000
NODE_6763_length_992_cov_20.010078	365	445	9	3	80	0.0375000
NODE_6763_length_992_cov_20.010078	365	445	11	37	80	0.4625000
NODE_6763_length_992_cov_20.010078	365	445	12	4	80	0.0500000
NODE_6764_length_992_cov_16.524076	465	545	3	14	80	0.1750000
NODE_6764_length_992_cov_16.524076	465	545	4	11	80	0.1375000
NODE_6764_length_992_cov_16.524076	465	545	5	2	80	0.0250000
NODE_6764_length_992_cov_16.524076	465	545	7	29	80	0.3625000
NODE_6764_length_992_cov_16.524076	465	545	9	24	80	0.3000000
NODE_6764_length_992_cov_16.524076	518	598	4	13	80	0.1625000
NODE_6764_length_992_cov_16.524076	518	598	5	6	80	0.0750000
NODE_6764_length_992_cov_16.524076	518	598	7	38	80	0.4750000
NODE_6764_length_992_cov_16.524076	518	598	9	23	80	0.2875000
NODE_6765_length_992_cov_16.266517	396	476	3	64	80	0.8000000
NODE_6765_length_992_cov_16.266517	396	476	4	16	80	0.2000000
NODE_6765_length_992_cov_16.266517	449	529	2	38	80	0.4750000
NODE_6765_length_992_cov_16.266517	449	529	3	26	80	0.3250000
NODE_6765_length_992_cov_16.266517	449	529	4	16	80	0.2000000
NODE_6766_length_992_cov_16.146697	272	352	0	80	80	1.0000000
NODE_6766_length_992_cov_16.146697	325	405	0	42	80	0.5250000
NODE_6766_length_992_cov_16.146697	325	405	2	38	80	0.4750000
NODE_6767_length_992_cov_15.212766	354	434	2	34	80	0.4250000
NODE_6767_length_992_cov_15.212766	354	434	3	17	80	0.2125000
NODE_6767_length_992_cov_15.212766	354	434	4	18	80	0.2250000
NODE_6767_length_992_cov_15.212766	354	434	5	11	80	0.1375000
NODE_6767_length_992_cov_15.212766	407	487	4	19	80	0.2375000
NODE_6767_length_992_cov_15.212766	407	487	5	14	80	0.1750000
NODE_6767_length_992_cov_15.212766	407	487	6	14	80	0.1750000
NODE_6767_length_992_cov_15.212766	407	487	7	33	80	0.4125000
NODE_6767_length_992_cov_15.212766	483	563	4	8	80	0.1000000
NODE_6767_length_992_cov_15.212766	483	563	5	17	80	0.2125000
NODE_6767_length_992_cov_15.212766	483	563	6	55	80	0.6875000
NODE_6767_length_992_cov_15.212766	536	616	0	31	80	0.3875000
NODE_6767_length_992_cov_15.212766	536	616	1	4	80	0.0500000
NODE_6767_length_992_cov_15.212766	536	616	3	18	80	0.2250000
NODE_6767_length_992_cov_15.212766	536	616	4	8	80	0.1000000
NODE_6767_length_992_cov_15.212766	536	616	5	17	80	0.2125000
NODE_6767_length_992_cov_15.212766	536	616	6	2	80	0.0250000
NODE_6781_length_991_cov_48.582960	451	531	8	7	80	0.0875000
NODE_6781_length_991_cov_48.582960	451	531	9	4	80	0.0500000
NODE_6781_length_991_cov_48.582960	451	531	10	31	80	0.3875000
NODE_6781_length_991_cov_48.582960	451	531	11	9	80	0.1125000
NODE_6781_length_991_cov_48.582960	451	531	12	7	80	0.0875000
NODE_6781_length_991_cov_48.582960	451	531	15	2	80	0.0250000
NODE_6781_length_991_cov_48.582960	451	531	16	1	80	0.0125000
NODE_6781_length_991_cov_48.582960	451	531	17	2	80	0.0250000
NODE_6781_length_991_cov_48.582960	451	531	18	3	80	0.0375000
NODE_6781_length_991_cov_48.582960	451	531	19	1	80	0.0125000
NODE_6781_length_991_cov_48.582960	451	531	22	13	80	0.1625000
NODE_6781_length_991_cov_48.582960	504	584	11	1	80	0.0125000
NODE_6781_length_991_cov_48.582960	504	584	12	4	80	0.0500000
NODE_6781_length_991_cov_48.582960	504	584	15	2	80	0.0250000
NODE_6781_length_991_cov_48.582960	504	584	16	1	80	0.0125000
NODE_6781_length_991_cov_48.582960	504	584	17	2	80	0.0250000
NODE_6781_length_991_cov_48.582960	504	584	18	3	80	0.0375000
NODE_6781_length_991_cov_48.582960	504	584	19	1	80	0.0125000
NODE_6781_length_991_cov_48.582960	504	584	22	17	80	0.2125000
NODE_6781_length_991_cov_48.582960	504	584	23	4	80	0.0500000
NODE_6781_length_991_cov_48.582960	504	584	24	15	80	0.1875000
NODE_6781_length_991_cov_48.582960	504	584	25	28	80	0.3500000
NODE_6781_length_991_cov_48.582960	504	584	26	2	80	0.0250000
NODE_6782_length_991_cov_25.891256	340	420	0	80	80	1.0000000
NODE_6782_length_991_cov_25.891256	393	473	0	80	80	1.0000000
NODE_6782_length_991_cov_25.891256	469	549	0	80	80	1.0000000
NODE_6782_length_991_cov_25.891256	522	602	0	80	80	1.0000000
NODE_6783_length_991_cov_25.392377	377	457	2	6	80	0.0750000
NODE_6783_length_991_cov_25.392377	377	457	3	74	80	0.9250000
NODE_6783_length_991_cov_25.392377	430	510	1	8	80	0.1000000
NODE_6783_length_991_cov_25.392377	430	510	2	3	80	0.0375000
NODE_6783_length_991_cov_25.392377	430	510	3	69	80	0.8625000
NODE_6783_length_991_cov_25.392377	506	586	1	10	80	0.1250000
NODE_6783_length_991_cov_25.392377	506	586	2	13	80	0.1625000
NODE_6783_length_991_cov_25.392377	506	586	3	33	80	0.4125000
NODE_6783_length_991_cov_25.392377	506	586	4	24	80	0.3000000
NODE_6783_length_991_cov_25.392377	559	639	2	3	80	0.0375000
NODE_6783_length_991_cov_25.392377	559	639	4	77	80	0.9625000
NODE_6784_length_991_cov_22.210762	421	501	4	57	80	0.7125000
NODE_6784_length_991_cov_22.210762	421	501	5	6	80	0.0750000
NODE_6784_length_991_cov_22.210762	421	501	6	17	80	0.2125000
NODE_6784_length_991_cov_22.210762	474	554	3	22	80	0.2750000
NODE_6784_length_991_cov_22.210762	474	554	4	16	80	0.2000000
NODE_6784_length_991_cov_22.210762	474	554	5	25	80	0.3125000
NODE_6784_length_991_cov_22.210762	474	554	6	17	80	0.2125000
NODE_6785_length_991_cov_18.008969	366	446	2	67	80	0.8375000
NODE_6785_length_991_cov_18.008969	366	446	4	13	80	0.1625000
NODE_6785_length_991_cov_18.008969	419	499	2	45	80	0.5625000
NODE_6785_length_991_cov_18.008969	419	499	3	2	80	0.0250000
NODE_6785_length_991_cov_18.008969	419	499	4	33	80	0.4125000
NODE_6785_length_991_cov_18.008969	495	575	2	24	80	0.3000000
NODE_6785_length_991_cov_18.008969	495	575	4	56	80	0.7000000
NODE_6785_length_991_cov_18.008969	548	629	2	74	81	0.9135802
NODE_6785_length_991_cov_18.008969	548	629	4	7	81	0.0864198
NODE_6786_length_991_cov_14.727578	426	506	6	35	80	0.4375000
NODE_6786_length_991_cov_14.727578	426	506	7	41	80	0.5125000
NODE_6786_length_991_cov_14.727578	426	506	8	4	80	0.0500000
NODE_6786_length_991_cov_14.727578	479	559	5	1	80	0.0125000
NODE_6786_length_991_cov_14.727578	479	559	6	50	80	0.6250000
NODE_6786_length_991_cov_14.727578	479	559	7	25	80	0.3125000
NODE_6786_length_991_cov_14.727578	479	559	8	4	80	0.0500000
NODE_6787_length_991_cov_13.081839	240	320	1	15	80	0.1875000
NODE_6787_length_991_cov_13.081839	240	320	3	18	80	0.2250000
NODE_6787_length_991_cov_13.081839	240	320	4	47	80	0.5875000
NODE_6787_length_991_cov_13.081839	293	373	1	3	80	0.0375000
NODE_6787_length_991_cov_13.081839	293	373	3	7	80	0.0875000
NODE_6787_length_991_cov_13.081839	293	373	4	70	80	0.8750000
NODE_6788_length_991_cov_12.693946	425	505	1	7	80	0.0875000
NODE_6788_length_991_cov_12.693946	425	505	2	9	80	0.1125000
NODE_6788_length_991_cov_12.693946	425	505	3	3	80	0.0375000
NODE_6788_length_991_cov_12.693946	425	505	4	15	80	0.1875000
NODE_6788_length_991_cov_12.693946	425	505	5	46	80	0.5750000
NODE_6788_length_991_cov_12.693946	478	558	5	28	80	0.3500000
NODE_6788_length_991_cov_12.693946	478	558	6	14	80	0.1750000
NODE_6788_length_991_cov_12.693946	478	558	7	38	80	0.4750000
NODE_6789_length_991_cov_9.647982	436	516	2	7	80	0.0875000
NODE_6789_length_991_cov_9.647982	436	516	3	73	80	0.9125000
NODE_6789_length_991_cov_9.647982	489	569	1	2	80	0.0250000
NODE_6789_length_991_cov_9.647982	489	569	2	42	80	0.5250000
NODE_6789_length_991_cov_9.647982	489	569	3	36	80	0.4500000
NODE_6790_length_991_cov_5.176009	538	618	0	80	80	1.0000000
NODE_6790_length_991_cov_5.176009	591	671	0	80	80	1.0000000
NODE_6801_length_990_cov_39.386083	402	482	6	12	80	0.1500000
NODE_6801_length_990_cov_39.386083	402	482	7	2	80	0.0250000
NODE_6801_length_990_cov_39.386083	402	482	9	4	80	0.0500000
NODE_6801_length_990_cov_39.386083	402	482	10	5	80	0.0625000
NODE_6801_length_990_cov_39.386083	402	482	11	17	80	0.2125000
NODE_6801_length_990_cov_39.386083	402	482	12	32	80	0.4000000
NODE_6801_length_990_cov_39.386083	402	482	13	8	80	0.1000000
NODE_6801_length_990_cov_39.386083	455	535	5	6	80	0.0750000
NODE_6801_length_990_cov_39.386083	455	535	7	12	80	0.1500000
NODE_6801_length_990_cov_39.386083	455	535	8	1	80	0.0125000
NODE_6801_length_990_cov_39.386083	455	535	10	27	80	0.3375000
NODE_6801_length_990_cov_39.386083	455	535	11	1	80	0.0125000
NODE_6801_length_990_cov_39.386083	455	535	12	19	80	0.2375000
NODE_6801_length_990_cov_39.386083	455	535	13	14	80	0.1750000
NODE_6802_length_990_cov_35.993266	321	401	0	34	80	0.4250000
NODE_6802_length_990_cov_35.993266	321	401	1	3	80	0.0375000
NODE_6802_length_990_cov_35.993266	321	401	3	3	80	0.0375000
NODE_6802_length_990_cov_35.993266	321	401	4	1	80	0.0125000
NODE_6802_length_990_cov_35.993266	321	401	5	19	80	0.2375000
NODE_6802_length_990_cov_35.993266	321	401	7	20	80	0.2500000
NODE_6802_length_990_cov_35.993266	374	454	5	7	80	0.0875000
NODE_6802_length_990_cov_35.993266	374	454	7	35	80	0.4375000
NODE_6802_length_990_cov_35.993266	374	454	10	32	80	0.4000000
NODE_6802_length_990_cov_35.993266	374	454	12	6	80	0.0750000
NODE_6802_length_990_cov_35.993266	450	530	9	18	80	0.2250000
NODE_6802_length_990_cov_35.993266	450	530	10	33	80	0.4125000
NODE_6802_length_990_cov_35.993266	450	530	11	6	80	0.0750000
NODE_6802_length_990_cov_35.993266	450	530	12	11	80	0.1375000
NODE_6802_length_990_cov_35.993266	450	530	13	7	80	0.0875000
NODE_6802_length_990_cov_35.993266	450	530	14	5	80	0.0625000
NODE_6802_length_990_cov_35.993266	503	583	4	17	80	0.2125000
NODE_6802_length_990_cov_35.993266	503	583	5	14	80	0.1750000
NODE_6802_length_990_cov_35.993266	503	583	7	13	80	0.1625000
NODE_6802_length_990_cov_35.993266	503	583	9	27	80	0.3375000
NODE_6802_length_990_cov_35.993266	503	583	10	1	80	0.0125000
NODE_6802_length_990_cov_35.993266	503	583	13	7	80	0.0875000
NODE_6802_length_990_cov_35.993266	503	583	14	1	80	0.0125000
NODE_6803_length_990_cov_24.445567	588	668	1	24	80	0.3000000
NODE_6803_length_990_cov_24.445567	588	668	2	56	80	0.7000000
NODE_6803_length_990_cov_24.445567	641	721	1	63	80	0.7875000
NODE_6803_length_990_cov_24.445567	641	721	2	17	80	0.2125000
NODE_6805_length_990_cov_22.378227	430	510	0	6	80	0.0750000
NODE_6805_length_990_cov_22.378227	430	510	1	74	80	0.9250000
NODE_6805_length_990_cov_22.378227	483	563	1	80	80	1.0000000
NODE_6806_length_990_cov_20.150393	408	488	5	24	80	0.3000000
NODE_6806_length_990_cov_20.150393	408	488	6	4	80	0.0500000
NODE_6806_length_990_cov_20.150393	408	488	7	3	80	0.0375000
NODE_6806_length_990_cov_20.150393	408	488	8	49	80	0.6125000
NODE_6806_length_990_cov_20.150393	461	541	4	1	80	0.0125000
NODE_6806_length_990_cov_20.150393	461	541	6	48	80	0.6000000
NODE_6806_length_990_cov_20.150393	461	541	8	31	80	0.3875000
NODE_6807_length_990_cov_18.154882	434	514	6	15	80	0.1875000
NODE_6807_length_990_cov_18.154882	434	514	7	14	80	0.1750000
NODE_6807_length_990_cov_18.154882	434	514	8	17	80	0.2125000
NODE_6807_length_990_cov_18.154882	434	514	9	19	80	0.2375000
NODE_6807_length_990_cov_18.154882	434	514	10	7	80	0.0875000
NODE_6807_length_990_cov_18.154882	434	514	12	8	80	0.1000000
NODE_6807_length_990_cov_18.154882	487	567	5	9	80	0.1125000
NODE_6807_length_990_cov_18.154882	487	567	7	18	80	0.2250000
NODE_6807_length_990_cov_18.154882	487	567	8	45	80	0.5625000
NODE_6807_length_990_cov_18.154882	487	567	12	8	80	0.1000000
NODE_6808_length_990_cov_17.250281	329	409	2	5	80	0.0625000
NODE_6808_length_990_cov_17.250281	329	409	3	41	80	0.5125000
NODE_6808_length_990_cov_17.250281	329	409	4	34	80	0.4250000
NODE_6808_length_990_cov_17.250281	382	462	1	23	80	0.2875000
NODE_6808_length_990_cov_17.250281	382	462	2	35	80	0.4375000
NODE_6808_length_990_cov_17.250281	382	462	3	5	80	0.0625000
NODE_6808_length_990_cov_17.250281	382	462	4	17	80	0.2125000
NODE_6808_length_990_cov_17.250281	458	538	0	23	80	0.2875000
NODE_6808_length_990_cov_17.250281	458	538	1	57	80	0.7125000
NODE_6808_length_990_cov_17.250281	511	591	0	76	80	0.9500000
NODE_6808_length_990_cov_17.250281	511	591	1	4	80	0.0500000
NODE_6809_length_990_cov_14.977553	448	528	5	40	80	0.5000000
NODE_6809_length_990_cov_14.977553	448	528	6	10	80	0.1250000
NODE_6809_length_990_cov_14.977553	448	528	7	30	80	0.3750000
NODE_6809_length_990_cov_14.977553	501	581	3	2	80	0.0250000
NODE_6809_length_990_cov_14.977553	501	581	5	67	80	0.8375000
NODE_6809_length_990_cov_14.977553	501	581	6	11	80	0.1375000
NODE_6810_length_990_cov_13.846240	482	562	0	1	80	0.0125000
NODE_6810_length_990_cov_13.846240	482	562	2	79	80	0.9875000
NODE_6810_length_990_cov_13.846240	535	615	1	8	80	0.1000000
NODE_6810_length_990_cov_13.846240	535	615	2	28	80	0.3500000
NODE_6810_length_990_cov_13.846240	535	615	3	44	80	0.5500000
NODE_6821_length_990_cov_0.978676	79	151	0	72	72	1.0000000
NODE_6821_length_990_cov_0.978676	82	152	0	70	70	1.0000000
NODE_6823_length_989_cov_45.902247	47	127	2	1	80	0.0125000
NODE_6823_length_989_cov_45.902247	47	127	4	2	80	0.0250000
NODE_6823_length_989_cov_45.902247	47	127	6	12	80	0.1500000
NODE_6823_length_989_cov_45.902247	47	127	8	65	80	0.8125000
NODE_6823_length_989_cov_45.902247	330	410	6	7	80	0.0875000
NODE_6823_length_989_cov_45.902247	330	410	8	8	80	0.1000000
NODE_6823_length_989_cov_45.902247	330	410	9	10	80	0.1250000
NODE_6823_length_989_cov_45.902247	330	410	10	48	80	0.6000000
NODE_6823_length_989_cov_45.902247	330	410	12	7	80	0.0875000
NODE_6823_length_989_cov_45.902247	383	463	5	28	80	0.3500000
NODE_6823_length_989_cov_45.902247	383	463	6	12	80	0.1500000
NODE_6823_length_989_cov_45.902247	383	463	7	14	80	0.1750000
NODE_6823_length_989_cov_45.902247	383	463	8	5	80	0.0625000
NODE_6823_length_989_cov_45.902247	383	463	10	21	80	0.2625000
NODE_6824_length_989_cov_35.430337	412	492	0	4	80	0.0500000
NODE_6824_length_989_cov_35.430337	412	492	2	7	80	0.0875000
NODE_6824_length_989_cov_35.430337	412	492	4	16	80	0.2000000
NODE_6824_length_989_cov_35.430337	412	492	5	5	80	0.0625000
NODE_6824_length_989_cov_35.430337	412	492	6	1	80	0.0125000
NODE_6824_length_989_cov_35.430337	412	492	7	47	80	0.5875000
NODE_6824_length_989_cov_35.430337	465	545	6	43	80	0.5375000
NODE_6824_length_989_cov_35.430337	465	545	7	33	80	0.4125000
NODE_6824_length_989_cov_35.430337	465	545	8	4	80	0.0500000
NODE_6825_length_989_cov_30.124719	477	557	2	14	80	0.1750000
NODE_6825_length_989_cov_30.124719	477	557	3	35	80	0.4375000
NODE_6825_length_989_cov_30.124719	477	557	5	31	80	0.3875000
NODE_6825_length_989_cov_30.124719	530	610	3	32	80	0.4000000
NODE_6825_length_989_cov_30.124719	530	610	4	20	80	0.2500000
NODE_6825_length_989_cov_30.124719	530	610	5	28	80	0.3500000
NODE_6826_length_989_cov_29.347191	447	527	4	8	80	0.1000000
NODE_6826_length_989_cov_29.347191	447	527	6	5	80	0.0625000
NODE_6826_length_989_cov_29.347191	447	527	7	4	80	0.0500000
NODE_6826_length_989_cov_29.347191	447	527	8	31	80	0.3875000
NODE_6826_length_989_cov_29.347191	447	527	9	1	80	0.0125000
NODE_6826_length_989_cov_29.347191	447	527	10	31	80	0.3875000
NODE_6826_length_989_cov_29.347191	500	580	8	26	80	0.3250000
NODE_6826_length_989_cov_29.347191	500	580	9	13	80	0.1625000
NODE_6826_length_989_cov_29.347191	500	580	10	7	80	0.0875000
NODE_6826_length_989_cov_29.347191	500	580	11	19	80	0.2375000
NODE_6826_length_989_cov_29.347191	500	580	12	15	80	0.1875000
NODE_6826_length_989_cov_29.347191	576	656	12	37	80	0.4625000
NODE_6826_length_989_cov_29.347191	576	656	13	19	80	0.2375000
NODE_6826_length_989_cov_29.347191	576	656	14	17	80	0.2125000
NODE_6826_length_989_cov_29.347191	576	656	15	7	80	0.0875000
NODE_6826_length_989_cov_29.347191	629	709	4	7	80	0.0875000
NODE_6826_length_989_cov_29.347191	629	709	5	2	80	0.0250000
NODE_6826_length_989_cov_29.347191	629	709	6	2	80	0.0250000
NODE_6826_length_989_cov_29.347191	629	709	8	2	80	0.0250000
NODE_6826_length_989_cov_29.347191	629	709	9	13	80	0.1625000
NODE_6826_length_989_cov_29.347191	629	709	10	3	80	0.0375000
NODE_6826_length_989_cov_29.347191	629	709	12	38	80	0.4750000
NODE_6826_length_989_cov_29.347191	629	709	14	13	80	0.1625000
NODE_6827_length_989_cov_27.886517	245	325	0	26	80	0.3250000
NODE_6827_length_989_cov_27.886517	245	325	2	24	80	0.3000000
NODE_6827_length_989_cov_27.886517	245	325	4	30	80	0.3750000
NODE_6827_length_989_cov_27.886517	298	378	4	80	80	1.0000000
NODE_6827_length_989_cov_27.886517	374	454	2	1	80	0.0125000
NODE_6827_length_989_cov_27.886517	374	454	4	71	80	0.8875000
NODE_6827_length_989_cov_27.886517	374	454	6	8	80	0.1000000
NODE_6827_length_989_cov_27.886517	427	507	4	32	80	0.4000000
NODE_6827_length_989_cov_27.886517	427	507	6	19	80	0.2375000
NODE_6827_length_989_cov_27.886517	427	507	8	29	80	0.3625000
NODE_6828_length_989_cov_27.515730	393	473	4	1	80	0.0125000
NODE_6828_length_989_cov_27.515730	393	473	5	36	80	0.4500000
NODE_6828_length_989_cov_27.515730	393	473	6	22	80	0.2750000
NODE_6828_length_989_cov_27.515730	393	473	7	21	80	0.2625000
NODE_6828_length_989_cov_27.515730	446	526	5	58	80	0.7250000
NODE_6828_length_989_cov_27.515730	446	526	6	12	80	0.1500000
NODE_6828_length_989_cov_27.515730	446	526	7	10	80	0.1250000
NODE_6828_length_989_cov_27.515730	522	602	3	33	80	0.4125000
NODE_6828_length_989_cov_27.515730	522	602	4	21	80	0.2625000
NODE_6828_length_989_cov_27.515730	522	602	5	14	80	0.1750000
NODE_6828_length_989_cov_27.515730	522	602	6	12	80	0.1500000
NODE_6828_length_989_cov_27.515730	575	655	1	45	80	0.5625000
NODE_6828_length_989_cov_27.515730	575	655	3	35	80	0.4375000
NODE_6829_length_989_cov_23.844944	312	392	0	18	80	0.2250000
NODE_6829_length_989_cov_23.844944	312	392	1	1	80	0.0125000
NODE_6829_length_989_cov_23.844944	312	392	2	61	80	0.7625000
NODE_6829_length_989_cov_23.844944	365	445	0	71	80	0.8875000
NODE_6829_length_989_cov_23.844944	365	445	1	1	80	0.0125000
NODE_6829_length_989_cov_23.844944	365	445	2	8	80	0.1000000
NODE_6830_length_989_cov_23.131461	475	555	0	80	80	1.0000000
NODE_6830_length_989_cov_23.131461	528	608	0	80	80	1.0000000
NODE_6831_length_989_cov_20.189888	500	580	3	71	80	0.8875000
NODE_6831_length_989_cov_20.189888	500	580	4	9	80	0.1125000
NODE_6831_length_989_cov_20.189888	553	633	2	8	80	0.1000000
NODE_6831_length_989_cov_20.189888	553	633	3	63	80	0.7875000
NODE_6831_length_989_cov_20.189888	553	633	4	9	80	0.1125000
NODE_6832_length_989_cov_18.429213	190	270	4	9	80	0.1125000
NODE_6832_length_989_cov_18.429213	190	270	5	12	80	0.1500000
NODE_6832_length_989_cov_18.429213	190	270	6	6	80	0.0750000
NODE_6832_length_989_cov_18.429213	190	270	7	26	80	0.3250000
NODE_6832_length_989_cov_18.429213	190	270	8	27	80	0.3375000
NODE_6832_length_989_cov_18.429213	258	323	4	42	65	0.6461539
NODE_6832_length_989_cov_18.429213	258	323	5	1	65	0.0153846
NODE_6832_length_989_cov_18.429213	258	323	7	22	65	0.3384615
NODE_6832_length_989_cov_18.429213	319	399	2	30	80	0.3750000
NODE_6832_length_989_cov_18.429213	319	399	3	2	80	0.0250000
NODE_6832_length_989_cov_18.429213	319	399	4	30	80	0.3750000
NODE_6832_length_989_cov_18.429213	319	399	5	12	80	0.1500000
NODE_6832_length_989_cov_18.429213	319	399	6	6	80	0.0750000
NODE_6832_length_989_cov_18.429213	372	412	2	25	40	0.6250000
NODE_6832_length_989_cov_18.429213	372	412	3	15	40	0.3750000
NODE_6833_length_989_cov_10.307865	433	513	0	29	80	0.3625000
NODE_6833_length_989_cov_10.307865	433	513	2	51	80	0.6375000
NODE_6833_length_989_cov_10.307865	486	570	2	60	84	0.7142857
NODE_6833_length_989_cov_10.307865	486	570	3	24	84	0.2857143
NODE_6833_length_989_cov_10.307865	566	642	1	65	76	0.8552632
NODE_6833_length_989_cov_10.307865	566	642	3	11	76	0.1447368
NODE_6833_length_989_cov_10.307865	615	695	0	3	80	0.0375000
NODE_6833_length_989_cov_10.307865	615	695	1	77	80	0.9625000
NODE_6834_length_989_cov_8.941573	528	608	0	9	80	0.1125000
NODE_6834_length_989_cov_8.941573	528	608	1	60	80	0.7500000
NODE_6834_length_989_cov_8.941573	528	608	2	11	80	0.1375000
NODE_6834_length_989_cov_8.941573	581	661	1	16	80	0.2000000
NODE_6834_length_989_cov_8.941573	581	661	2	64	80	0.8000000
NODE_6835_length_989_cov_5.132584	459	524	2	62	65	0.9538462
NODE_6835_length_989_cov_5.132584	459	524	4	3	65	0.0461538
NODE_6838_length_989_cov_2.540449	703	783	1	25	80	0.3125000
NODE_6838_length_989_cov_2.540449	703	783	2	55	80	0.6875000
NODE_6845_length_988_cov_52.168729	361	441	0	32	80	0.4000000
NODE_6845_length_988_cov_52.168729	361	441	1	48	80	0.6000000
NODE_6845_length_988_cov_52.168729	414	494	0	27	80	0.3375000
NODE_6845_length_988_cov_52.168729	414	494	1	4	80	0.0500000
NODE_6845_length_988_cov_52.168729	414	494	2	49	80	0.6125000
NODE_6845_length_988_cov_52.168729	490	570	2	5	80	0.0625000
NODE_6845_length_988_cov_52.168729	490	570	3	43	80	0.5375000
NODE_6845_length_988_cov_52.168729	490	570	4	11	80	0.1375000
NODE_6845_length_988_cov_52.168729	490	570	7	20	80	0.2500000
NODE_6845_length_988_cov_52.168729	490	570	8	1	80	0.0125000
NODE_6845_length_988_cov_52.168729	543	623	4	6	80	0.0750000
NODE_6845_length_988_cov_52.168729	543	623	7	48	80	0.6000000
NODE_6845_length_988_cov_52.168729	543	623	8	16	80	0.2000000
NODE_6845_length_988_cov_52.168729	543	623	9	10	80	0.1250000
NODE_6846_length_988_cov_36.733408	390	470	6	11	80	0.1375000
NODE_6846_length_988_cov_36.733408	390	470	7	11	80	0.1375000
NODE_6846_length_988_cov_36.733408	390	470	8	12	80	0.1500000
NODE_6846_length_988_cov_36.733408	390	470	9	21	80	0.2625000
NODE_6846_length_988_cov_36.733408	390	470	11	25	80	0.3125000
NODE_6846_length_988_cov_36.733408	443	523	7	31	80	0.3875000
NODE_6846_length_988_cov_36.733408	443	523	8	3	80	0.0375000
NODE_6846_length_988_cov_36.733408	443	523	9	2	80	0.0250000
NODE_6846_length_988_cov_36.733408	443	523	10	6	80	0.0750000
NODE_6846_length_988_cov_36.733408	443	523	11	25	80	0.3125000
NODE_6846_length_988_cov_36.733408	443	523	12	13	80	0.1625000
NODE_6847_length_988_cov_36.221597	478	558	7	3	80	0.0375000
NODE_6847_length_988_cov_36.221597	478	558	8	8	80	0.1000000
NODE_6847_length_988_cov_36.221597	478	558	9	11	80	0.1375000
NODE_6847_length_988_cov_36.221597	478	558	10	29	80	0.3625000
NODE_6847_length_988_cov_36.221597	478	558	11	28	80	0.3500000
NODE_6847_length_988_cov_36.221597	478	558	12	1	80	0.0125000
NODE_6847_length_988_cov_36.221597	531	611	6	23	80	0.2875000
NODE_6847_length_988_cov_36.221597	531	611	7	3	80	0.0375000
NODE_6847_length_988_cov_36.221597	531	611	8	28	80	0.3500000
NODE_6847_length_988_cov_36.221597	531	611	9	12	80	0.1500000
NODE_6847_length_988_cov_36.221597	531	611	10	10	80	0.1250000
NODE_6847_length_988_cov_36.221597	531	611	11	3	80	0.0375000
NODE_6847_length_988_cov_36.221597	531	611	12	1	80	0.0125000
NODE_6848_length_988_cov_25.895388	389	469	1	39	80	0.4875000
NODE_6848_length_988_cov_25.895388	389	469	2	4	80	0.0500000
NODE_6848_length_988_cov_25.895388	389	469	3	21	80	0.2625000
NODE_6848_length_988_cov_25.895388	389	469	5	8	80	0.1000000
NODE_6848_length_988_cov_25.895388	389	469	6	8	80	0.1000000
NODE_6848_length_988_cov_25.895388	442	522	3	11	80	0.1375000
NODE_6848_length_988_cov_25.895388	442	522	5	61	80	0.7625000
NODE_6848_length_988_cov_25.895388	442	522	6	8	80	0.1000000
NODE_6848_length_988_cov_25.895388	518	598	1	16	80	0.2000000
NODE_6848_length_988_cov_25.895388	518	598	2	4	80	0.0500000
NODE_6848_length_988_cov_25.895388	518	598	3	6	80	0.0750000
NODE_6848_length_988_cov_25.895388	518	598	5	54	80	0.6750000
NODE_6848_length_988_cov_25.895388	571	651	0	48	80	0.6000000
NODE_6848_length_988_cov_25.895388	571	651	1	21	80	0.2625000
NODE_6848_length_988_cov_25.895388	571	651	2	4	80	0.0500000
NODE_6848_length_988_cov_25.895388	571	651	3	6	80	0.0750000
NODE_6848_length_988_cov_25.895388	571	651	5	1	80	0.0125000
NODE_6849_length_988_cov_20.250844	423	503	2	19	80	0.2375000
NODE_6849_length_988_cov_20.250844	423	503	3	11	80	0.1375000
NODE_6849_length_988_cov_20.250844	423	503	4	50	80	0.6250000
NODE_6849_length_988_cov_20.250844	476	556	3	13	80	0.1625000
NODE_6849_length_988_cov_20.250844	476	556	4	56	80	0.7000000
NODE_6849_length_988_cov_20.250844	476	556	5	11	80	0.1375000
NODE_6850_length_988_cov_15.812148	474	554	2	13	80	0.1625000
NODE_6850_length_988_cov_15.812148	474	554	3	40	80	0.5000000
NODE_6850_length_988_cov_15.812148	474	554	4	21	80	0.2625000
NODE_6850_length_988_cov_15.812148	474	554	5	6	80	0.0750000
NODE_6850_length_988_cov_15.812148	527	607	4	21	80	0.2625000
NODE_6850_length_988_cov_15.812148	527	607	5	19	80	0.2375000
NODE_6850_length_988_cov_15.812148	527	607	6	6	80	0.0750000
NODE_6850_length_988_cov_15.812148	527	607	7	14	80	0.1750000
NODE_6850_length_988_cov_15.812148	527	607	8	20	80	0.2500000
NODE_6851_length_988_cov_15.082115	435	517	1	7	82	0.0853659
NODE_6851_length_988_cov_15.082115	435	517	2	12	82	0.1463415
NODE_6851_length_988_cov_15.082115	435	517	5	36	82	0.4390244
NODE_6851_length_988_cov_15.082115	435	517	6	27	82	0.3292683
NODE_6851_length_988_cov_15.082115	490	570	1	60	80	0.7500000
NODE_6851_length_988_cov_15.082115	490	570	2	12	80	0.1500000
NODE_6851_length_988_cov_15.082115	490	570	5	8	80	0.1000000
NODE_6852_length_988_cov_14.697413	467	547	1	7	80	0.0875000
NODE_6852_length_988_cov_14.697413	467	547	3	41	80	0.5125000
NODE_6852_length_988_cov_14.697413	467	547	4	32	80	0.4000000
NODE_6852_length_988_cov_14.697413	520	600	1	8	80	0.1000000
NODE_6852_length_988_cov_14.697413	520	600	2	36	80	0.4500000
NODE_6852_length_988_cov_14.697413	520	600	4	36	80	0.4500000
NODE_6853_length_988_cov_7.730034	562	642	3	11	80	0.1375000
NODE_6853_length_988_cov_7.730034	562	642	4	19	80	0.2375000
NODE_6853_length_988_cov_7.730034	562	642	6	4	80	0.0500000
NODE_6853_length_988_cov_7.730034	562	642	7	46	80	0.5750000
NODE_6853_length_988_cov_7.730034	615	695	3	40	80	0.5000000
NODE_6853_length_988_cov_7.730034	615	695	4	40	80	0.5000000
NODE_6862_length_987_cov_42.784910	383	476	2	16	93	0.1720430
NODE_6862_length_987_cov_42.784910	383	476	4	29	93	0.3118280
NODE_6862_length_987_cov_42.784910	383	476	6	14	93	0.1505376
NODE_6862_length_987_cov_42.784910	383	476	7	26	93	0.2795699
NODE_6862_length_987_cov_42.784910	383	476	8	8	93	0.0860215
NODE_6862_length_987_cov_42.784910	449	529	6	10	80	0.1250000
NODE_6862_length_987_cov_42.784910	449	529	7	27	80	0.3375000
NODE_6862_length_987_cov_42.784910	449	529	8	43	80	0.5375000
NODE_6863_length_987_cov_39.716216	290	370	0	4	80	0.0500000
NODE_6863_length_987_cov_39.716216	290	370	1	24	80	0.3000000
NODE_6863_length_987_cov_39.716216	290	370	2	52	80	0.6500000
NODE_6863_length_987_cov_39.716216	343	423	2	80	80	1.0000000
NODE_6863_length_987_cov_39.716216	419	499	2	10	80	0.1250000
NODE_6863_length_987_cov_39.716216	419	499	3	30	80	0.3750000
NODE_6863_length_987_cov_39.716216	419	499	4	24	80	0.3000000
NODE_6863_length_987_cov_39.716216	419	499	5	16	80	0.2000000
NODE_6863_length_987_cov_39.716216	472	552	3	17	80	0.2125000
NODE_6863_length_987_cov_39.716216	472	552	5	63	80	0.7875000
NODE_6864_length_987_cov_28.171171	406	486	3	4	80	0.0500000
NODE_6864_length_987_cov_28.171171	406	486	4	28	80	0.3500000
NODE_6864_length_987_cov_28.171171	406	486	5	13	80	0.1625000
NODE_6864_length_987_cov_28.171171	406	486	6	11	80	0.1375000
NODE_6864_length_987_cov_28.171171	406	486	7	24	80	0.3000000
NODE_6864_length_987_cov_28.171171	459	539	6	3	80	0.0375000
NODE_6864_length_987_cov_28.171171	459	539	7	39	80	0.4875000
NODE_6864_length_987_cov_28.171171	459	539	9	5	80	0.0625000
NODE_6864_length_987_cov_28.171171	459	539	10	3	80	0.0375000
NODE_6864_length_987_cov_28.171171	459	539	11	28	80	0.3500000
NODE_6864_length_987_cov_28.171171	459	539	12	2	80	0.0250000
NODE_6864_length_987_cov_28.171171	535	615	8	1	80	0.0125000
NODE_6864_length_987_cov_28.171171	535	615	9	16	80	0.2000000
NODE_6864_length_987_cov_28.171171	535	615	10	17	80	0.2125000
NODE_6864_length_987_cov_28.171171	535	615	11	25	80	0.3125000
NODE_6864_length_987_cov_28.171171	535	615	12	18	80	0.2250000
NODE_6864_length_987_cov_28.171171	535	615	13	3	80	0.0375000
NODE_6864_length_987_cov_28.171171	588	668	5	17	80	0.2125000
NODE_6864_length_987_cov_28.171171	588	668	6	13	80	0.1625000
NODE_6864_length_987_cov_28.171171	588	668	7	3	80	0.0375000
NODE_6864_length_987_cov_28.171171	588	668	8	1	80	0.0125000
NODE_6864_length_987_cov_28.171171	588	668	9	36	80	0.4500000
NODE_6864_length_987_cov_28.171171	588	668	10	10	80	0.1250000
NODE_6865_length_987_cov_23.627252	331	411	6	11	80	0.1375000
NODE_6865_length_987_cov_23.627252	331	411	8	37	80	0.4625000
NODE_6865_length_987_cov_23.627252	331	411	9	32	80	0.4000000
NODE_6865_length_987_cov_23.627252	384	464	2	15	80	0.1875000
NODE_6865_length_987_cov_23.627252	384	464	3	23	80	0.2875000
NODE_6865_length_987_cov_23.627252	384	464	4	1	80	0.0125000
NODE_6865_length_987_cov_23.627252	384	464	6	25	80	0.3125000
NODE_6865_length_987_cov_23.627252	384	464	8	16	80	0.2000000
NODE_6866_length_987_cov_18.797297	437	517	4	78	80	0.9750000
NODE_6866_length_987_cov_18.797297	437	517	5	2	80	0.0250000
NODE_6866_length_987_cov_18.797297	490	570	0	41	80	0.5125000
NODE_6866_length_987_cov_18.797297	490	570	2	8	80	0.1000000
NODE_6866_length_987_cov_18.797297	490	570	3	1	80	0.0125000
NODE_6866_length_987_cov_18.797297	490	570	4	30	80	0.3750000
NODE_6867_length_987_cov_15.628378	369	449	3	33	80	0.4125000
NODE_6867_length_987_cov_15.628378	369	449	4	19	80	0.2375000
NODE_6867_length_987_cov_15.628378	369	449	5	28	80	0.3500000
NODE_6867_length_987_cov_15.628378	422	502	5	44	80	0.5500000
NODE_6867_length_987_cov_15.628378	422	502	6	23	80	0.2875000
NODE_6867_length_987_cov_15.628378	422	502	7	13	80	0.1625000
NODE_6868_length_987_cov_15.439189	438	518	2	12	80	0.1500000
NODE_6868_length_987_cov_15.439189	438	518	3	3	80	0.0375000
NODE_6868_length_987_cov_15.439189	438	518	4	4	80	0.0500000
NODE_6868_length_987_cov_15.439189	438	518	5	7	80	0.0875000
NODE_6868_length_987_cov_15.439189	438	518	6	5	80	0.0625000
NODE_6868_length_987_cov_15.439189	438	518	8	18	80	0.2250000
NODE_6868_length_987_cov_15.439189	438	518	9	9	80	0.1125000
NODE_6868_length_987_cov_15.439189	438	518	10	9	80	0.1125000
NODE_6868_length_987_cov_15.439189	438	518	11	2	80	0.0250000
NODE_6868_length_987_cov_15.439189	438	518	12	1	80	0.0125000
NODE_6868_length_987_cov_15.439189	438	518	13	10	80	0.1250000
NODE_6868_length_987_cov_15.439189	491	571	9	5	80	0.0625000
NODE_6868_length_987_cov_15.439189	491	571	10	9	80	0.1125000
NODE_6868_length_987_cov_15.439189	491	571	11	7	80	0.0875000
NODE_6868_length_987_cov_15.439189	491	571	12	12	80	0.1500000
NODE_6868_length_987_cov_15.439189	491	571	13	46	80	0.5750000
NODE_6868_length_987_cov_15.439189	491	571	14	1	80	0.0125000
NODE_6869_length_987_cov_14.343468	506	586	1	31	80	0.3875000
NODE_6869_length_987_cov_14.343468	506	586	2	33	80	0.4125000
NODE_6869_length_987_cov_14.343468	506	586	4	16	80	0.2000000
NODE_6869_length_987_cov_14.343468	559	639	2	11	80	0.1375000
NODE_6869_length_987_cov_14.343468	559	639	4	20	80	0.2500000
NODE_6869_length_987_cov_14.343468	559	639	5	49	80	0.6125000
NODE_6870_length_987_cov_13.515766	475	555	3	16	80	0.2000000
NODE_6870_length_987_cov_13.515766	475	555	4	17	80	0.2125000
NODE_6870_length_987_cov_13.515766	475	555	5	21	80	0.2625000
NODE_6870_length_987_cov_13.515766	475	555	6	16	80	0.2000000
NODE_6870_length_987_cov_13.515766	475	555	7	10	80	0.1250000
NODE_6870_length_987_cov_13.515766	528	608	5	1	80	0.0125000
NODE_6870_length_987_cov_13.515766	528	608	6	16	80	0.2000000
NODE_6870_length_987_cov_13.515766	528	608	7	17	80	0.2125000
NODE_6870_length_987_cov_13.515766	528	608	8	29	80	0.3625000
NODE_6870_length_987_cov_13.515766	528	608	9	17	80	0.2125000
NODE_6871_length_987_cov_9.521396	408	482	2	17	74	0.2297297
NODE_6871_length_987_cov_9.521396	408	482	3	17	74	0.2297297
NODE_6871_length_987_cov_9.521396	408	482	4	2	74	0.0270270
NODE_6871_length_987_cov_9.521396	408	482	5	38	74	0.5135135
NODE_6871_length_987_cov_9.521396	455	535	3	54	80	0.6750000
NODE_6871_length_987_cov_9.521396	455	535	4	17	80	0.2125000
NODE_6871_length_987_cov_9.521396	455	535	5	9	80	0.1125000
NODE_6872_length_987_cov_9.054054	440	520	1	17	80	0.2125000
NODE_6872_length_987_cov_9.054054	440	520	2	5	80	0.0625000
NODE_6872_length_987_cov_9.054054	440	520	3	46	80	0.5750000
NODE_6872_length_987_cov_9.054054	440	520	4	12	80	0.1500000
NODE_6872_length_987_cov_9.054054	493	573	1	16	80	0.2000000
NODE_6872_length_987_cov_9.054054	493	573	3	64	80	0.8000000
NODE_6875_length_987_cov_5.378378	509	589	0	9	80	0.1125000
NODE_6875_length_987_cov_5.378378	509	589	2	16	80	0.2000000
NODE_6875_length_987_cov_5.378378	509	589	4	55	80	0.6875000
NODE_6875_length_987_cov_5.378378	562	642	2	27	80	0.3375000
NODE_6875_length_987_cov_5.378378	562	642	4	53	80	0.6625000
NODE_6889_length_986_cov_36.937993	327	407	2	54	80	0.6750000
NODE_6889_length_986_cov_36.937993	327	407	3	18	80	0.2250000
NODE_6889_length_986_cov_36.937993	327	407	4	8	80	0.1000000
NODE_6889_length_986_cov_36.937993	380	460	2	1	80	0.0125000
NODE_6889_length_986_cov_36.937993	380	460	3	19	80	0.2375000
NODE_6889_length_986_cov_36.937993	380	460	4	8	80	0.1000000
NODE_6889_length_986_cov_36.937993	380	460	5	14	80	0.1750000
NODE_6889_length_986_cov_36.937993	380	460	6	3	80	0.0375000
NODE_6889_length_986_cov_36.937993	380	460	7	35	80	0.4375000
NODE_6889_length_986_cov_36.937993	456	536	7	17	80	0.2125000
NODE_6889_length_986_cov_36.937993	456	536	8	17	80	0.2125000
NODE_6889_length_986_cov_36.937993	456	536	9	46	80	0.5750000
NODE_6889_length_986_cov_36.937993	509	589	3	5	80	0.0625000
NODE_6889_length_986_cov_36.937993	509	589	4	12	80	0.1500000
NODE_6889_length_986_cov_36.937993	509	589	5	14	80	0.1750000
NODE_6889_length_986_cov_36.937993	509	589	7	9	80	0.1125000
NODE_6889_length_986_cov_36.937993	509	589	8	18	80	0.2250000
NODE_6889_length_986_cov_36.937993	509	589	9	22	80	0.2750000
NODE_6890_length_986_cov_35.130778	325	405	2	8	80	0.1000000
NODE_6890_length_986_cov_35.130778	325	405	3	37	80	0.4625000
NODE_6890_length_986_cov_35.130778	325	405	4	19	80	0.2375000
NODE_6890_length_986_cov_35.130778	325	405	5	16	80	0.2000000
NODE_6890_length_986_cov_35.130778	378	458	4	11	80	0.1375000
NODE_6890_length_986_cov_35.130778	378	458	5	34	80	0.4250000
NODE_6890_length_986_cov_35.130778	378	458	6	35	80	0.4375000
NODE_6890_length_986_cov_35.130778	454	534	5	42	80	0.5250000
NODE_6890_length_986_cov_35.130778	454	534	6	14	80	0.1750000
NODE_6890_length_986_cov_35.130778	454	534	7	24	80	0.3000000
NODE_6890_length_986_cov_35.130778	507	587	4	30	80	0.3750000
NODE_6890_length_986_cov_35.130778	507	587	5	32	80	0.4000000
NODE_6890_length_986_cov_35.130778	507	587	6	12	80	0.1500000
NODE_6890_length_986_cov_35.130778	507	587	7	6	80	0.0750000
NODE_6891_length_986_cov_24.037204	602	682	0	67	80	0.8375000
NODE_6891_length_986_cov_24.037204	602	682	1	4	80	0.0500000
NODE_6891_length_986_cov_24.037204	602	682	3	9	80	0.1125000
NODE_6891_length_986_cov_24.037204	655	735	0	14	80	0.1750000
NODE_6891_length_986_cov_24.037204	655	735	1	4	80	0.0500000
NODE_6891_length_986_cov_24.037204	655	735	3	62	80	0.7750000
NODE_6891_length_986_cov_24.037204	731	811	2	11	80	0.1375000
NODE_6891_length_986_cov_24.037204	731	811	3	12	80	0.1500000
NODE_6891_length_986_cov_24.037204	731	811	4	57	80	0.7125000
NODE_6891_length_986_cov_24.037204	784	864	1	45	80	0.5625000
NODE_6891_length_986_cov_24.037204	784	864	2	19	80	0.2375000
NODE_6891_length_986_cov_24.037204	784	864	4	16	80	0.2000000
NODE_6892_length_986_cov_20.591883	395	475	1	12	80	0.1500000
NODE_6892_length_986_cov_20.591883	395	475	4	13	80	0.1625000
NODE_6892_length_986_cov_20.591883	395	475	6	14	80	0.1750000
NODE_6892_length_986_cov_20.591883	395	475	8	25	80	0.3125000
NODE_6892_length_986_cov_20.591883	395	475	9	16	80	0.2000000
NODE_6892_length_986_cov_20.591883	448	528	6	38	80	0.4750000
NODE_6892_length_986_cov_20.591883	448	528	8	19	80	0.2375000
NODE_6892_length_986_cov_20.591883	448	528	9	23	80	0.2875000
NODE_6893_length_986_cov_16.815107	389	469	8	1	80	0.0125000
NODE_6893_length_986_cov_16.815107	389	469	10	14	80	0.1750000
NODE_6893_length_986_cov_16.815107	389	469	11	20	80	0.2500000
NODE_6893_length_986_cov_16.815107	389	469	12	1	80	0.0125000
NODE_6893_length_986_cov_16.815107	389	469	13	15	80	0.1875000
NODE_6893_length_986_cov_16.815107	389	469	15	18	80	0.2250000
NODE_6893_length_986_cov_16.815107	389	469	16	11	80	0.1375000
NODE_6893_length_986_cov_16.815107	442	522	9	5	80	0.0625000
NODE_6893_length_986_cov_16.815107	442	522	10	7	80	0.0875000
NODE_6893_length_986_cov_16.815107	442	522	11	60	80	0.7500000
NODE_6893_length_986_cov_16.815107	442	522	13	1	80	0.0125000
NODE_6893_length_986_cov_16.815107	442	522	15	7	80	0.0875000
NODE_6894_length_986_cov_11.021421	474	554	1	30	80	0.3750000
NODE_6894_length_986_cov_11.021421	474	554	2	50	80	0.6250000
NODE_6894_length_986_cov_11.021421	527	607	1	28	80	0.3500000
NODE_6894_length_986_cov_11.021421	527	607	2	52	80	0.6500000
NODE_6905_length_985_cov_41.707675	443	523	9	2	80	0.0250000
NODE_6905_length_985_cov_41.707675	443	523	10	11	80	0.1375000
NODE_6905_length_985_cov_41.707675	443	523	11	11	80	0.1375000
NODE_6905_length_985_cov_41.707675	443	523	12	8	80	0.1000000
NODE_6905_length_985_cov_41.707675	443	523	13	2	80	0.0250000
NODE_6905_length_985_cov_41.707675	443	523	14	8	80	0.1000000
NODE_6905_length_985_cov_41.707675	443	523	16	5	80	0.0625000
NODE_6905_length_985_cov_41.707675	443	523	17	2	80	0.0250000
NODE_6905_length_985_cov_41.707675	443	523	18	4	80	0.0500000
NODE_6905_length_985_cov_41.707675	443	523	19	5	80	0.0625000
NODE_6905_length_985_cov_41.707675	443	523	20	8	80	0.1000000
NODE_6905_length_985_cov_41.707675	443	523	21	1	80	0.0125000
NODE_6905_length_985_cov_41.707675	443	523	22	6	80	0.0750000
NODE_6905_length_985_cov_41.707675	443	523	23	6	80	0.0750000
NODE_6905_length_985_cov_41.707675	443	523	26	1	80	0.0125000
NODE_6905_length_985_cov_41.707675	496	576	19	5	80	0.0625000
NODE_6905_length_985_cov_41.707675	496	576	20	11	80	0.1375000
NODE_6905_length_985_cov_41.707675	496	576	21	1	80	0.0125000
NODE_6905_length_985_cov_41.707675	496	576	22	8	80	0.1000000
NODE_6905_length_985_cov_41.707675	496	576	23	7	80	0.0875000
NODE_6905_length_985_cov_41.707675	496	576	24	5	80	0.0625000
NODE_6905_length_985_cov_41.707675	496	576	25	34	80	0.4250000
NODE_6905_length_985_cov_41.707675	496	576	26	9	80	0.1125000
NODE_6911_length_984_cov_64.531073	412	481	8	32	69	0.4637681
NODE_6911_length_984_cov_64.531073	412	481	9	27	69	0.3913043
NODE_6911_length_984_cov_64.531073	412	481	10	10	69	0.1449275
NODE_6911_length_984_cov_64.531073	454	534	3	10	80	0.1250000
NODE_6911_length_984_cov_64.531073	454	534	4	4	80	0.0500000
NODE_6911_length_984_cov_64.531073	454	534	6	10	80	0.1250000
NODE_6911_length_984_cov_64.531073	454	534	8	3	80	0.0375000
NODE_6911_length_984_cov_64.531073	454	534	9	17	80	0.2125000
NODE_6911_length_984_cov_64.531073	454	534	10	21	80	0.2625000
NODE_6911_length_984_cov_64.531073	454	534	11	15	80	0.1875000
NODE_6911_length_984_cov_64.531073	475	555	3	31	80	0.3875000
NODE_6911_length_984_cov_64.531073	475	555	4	4	80	0.0500000
NODE_6911_length_984_cov_64.531073	475	555	6	10	80	0.1250000
NODE_6911_length_984_cov_64.531073	475	555	8	3	80	0.0375000
NODE_6911_length_984_cov_64.531073	475	555	10	17	80	0.2125000
NODE_6911_length_984_cov_64.531073	475	555	11	15	80	0.1875000
NODE_6911_length_984_cov_64.531073	528	608	3	38	80	0.4750000
NODE_6911_length_984_cov_64.531073	528	608	5	16	80	0.2000000
NODE_6911_length_984_cov_64.531073	528	608	6	13	80	0.1625000
NODE_6911_length_984_cov_64.531073	528	608	7	13	80	0.1625000
NODE_6911_length_984_cov_64.531073	549	629	3	17	80	0.2125000
NODE_6911_length_984_cov_64.531073	549	629	5	22	80	0.2750000
NODE_6911_length_984_cov_64.531073	549	629	6	28	80	0.3500000
NODE_6911_length_984_cov_64.531073	549	629	7	13	80	0.1625000
NODE_6912_length_984_cov_28.832768	430	510	1	6	80	0.0750000
NODE_6912_length_984_cov_28.832768	430	510	3	10	80	0.1250000
NODE_6912_length_984_cov_28.832768	430	510	5	41	80	0.5125000
NODE_6912_length_984_cov_28.832768	430	510	6	19	80	0.2375000
NODE_6912_length_984_cov_28.832768	430	510	7	4	80	0.0500000
NODE_6912_length_984_cov_28.832768	483	563	5	4	80	0.0500000
NODE_6912_length_984_cov_28.832768	483	563	6	22	80	0.2750000
NODE_6912_length_984_cov_28.832768	483	563	7	8	80	0.1000000
NODE_6912_length_984_cov_28.832768	483	563	8	13	80	0.1625000
NODE_6912_length_984_cov_28.832768	483	563	10	33	80	0.4125000
NODE_6913_length_984_cov_27.247458	203	283	2	40	80	0.5000000
NODE_6913_length_984_cov_27.247458	203	283	3	4	80	0.0500000
NODE_6913_length_984_cov_27.247458	203	283	4	8	80	0.1000000
NODE_6913_length_984_cov_27.247458	203	283	5	23	80	0.2875000
NODE_6913_length_984_cov_27.247458	203	283	6	5	80	0.0625000
NODE_6913_length_984_cov_27.247458	256	336	3	1	80	0.0125000
NODE_6913_length_984_cov_27.247458	256	336	5	48	80	0.6000000
NODE_6913_length_984_cov_27.247458	256	336	6	31	80	0.3875000
NODE_6913_length_984_cov_27.247458	332	412	5	3	80	0.0375000
NODE_6913_length_984_cov_27.247458	332	412	6	8	80	0.1000000
NODE_6913_length_984_cov_27.247458	332	412	7	32	80	0.4000000
NODE_6913_length_984_cov_27.247458	332	412	8	37	80	0.4625000
NODE_6913_length_984_cov_27.247458	385	465	3	2	80	0.0250000
NODE_6913_length_984_cov_27.247458	385	465	5	35	80	0.4375000
NODE_6913_length_984_cov_27.247458	385	465	6	23	80	0.2875000
NODE_6913_length_984_cov_27.247458	385	465	7	12	80	0.1500000
NODE_6913_length_984_cov_27.247458	385	465	8	8	80	0.1000000
NODE_6914_length_984_cov_25.944633	483	563	8	46	80	0.5750000
NODE_6914_length_984_cov_25.944633	483	563	9	27	80	0.3375000
NODE_6914_length_984_cov_25.944633	483	563	10	7	80	0.0875000
NODE_6914_length_984_cov_25.944633	536	616	7	28	80	0.3500000
NODE_6914_length_984_cov_25.944633	536	616	8	32	80	0.4000000
NODE_6914_length_984_cov_25.944633	536	616	9	20	80	0.2500000
NODE_6915_length_984_cov_16.611299	351	431	3	15	80	0.1875000
NODE_6915_length_984_cov_16.611299	351	431	5	34	80	0.4250000
NODE_6915_length_984_cov_16.611299	351	431	7	2	80	0.0250000
NODE_6915_length_984_cov_16.611299	351	431	8	29	80	0.3625000
NODE_6915_length_984_cov_16.611299	404	484	2	3	80	0.0375000
NODE_6915_length_984_cov_16.611299	404	484	3	1	80	0.0125000
NODE_6915_length_984_cov_16.611299	404	484	4	2	80	0.0250000
NODE_6915_length_984_cov_16.611299	404	484	6	4	80	0.0500000
NODE_6915_length_984_cov_16.611299	404	484	7	5	80	0.0625000
NODE_6915_length_984_cov_16.611299	404	484	8	65	80	0.8125000
NODE_6917_length_984_cov_6.414689	415	495	1	5	80	0.0625000
NODE_6917_length_984_cov_6.414689	415	495	2	52	80	0.6500000
NODE_6917_length_984_cov_6.414689	415	495	3	23	80	0.2875000
NODE_6917_length_984_cov_6.414689	468	548	2	76	80	0.9500000
NODE_6917_length_984_cov_6.414689	468	548	3	4	80	0.0500000
NODE_6918_length_984_cov_4.720904	494	574	1	80	80	1.0000000
NODE_6918_length_984_cov_4.720904	547	627	0	3	80	0.0375000
NODE_6918_length_984_cov_4.720904	547	627	1	77	80	0.9625000
NODE_6927_length_984_cov_1.333333	922	971	0	49	49	1.0000000
NODE_6931_length_983_cov_34.566742	466	546	5	17	80	0.2125000
NODE_6931_length_983_cov_34.566742	466	546	6	4	80	0.0500000
NODE_6931_length_983_cov_34.566742	466	546	7	59	80	0.7375000
NODE_6931_length_983_cov_34.566742	519	599	0	16	80	0.2000000
NODE_6931_length_983_cov_34.566742	519	599	2	19	80	0.2375000
NODE_6931_length_983_cov_34.566742	519	599	3	6	80	0.0750000
NODE_6931_length_983_cov_34.566742	519	599	5	29	80	0.3625000
NODE_6931_length_983_cov_34.566742	519	599	6	4	80	0.0500000
NODE_6931_length_983_cov_34.566742	519	599	7	6	80	0.0750000
NODE_6932_length_983_cov_26.011312	449	529	5	12	80	0.1500000
NODE_6932_length_983_cov_26.011312	449	529	6	23	80	0.2875000
NODE_6932_length_983_cov_26.011312	449	529	7	3	80	0.0375000
NODE_6932_length_983_cov_26.011312	449	529	8	7	80	0.0875000
NODE_6932_length_983_cov_26.011312	449	529	9	7	80	0.0875000
NODE_6932_length_983_cov_26.011312	449	529	10	25	80	0.3125000
NODE_6932_length_983_cov_26.011312	449	529	11	3	80	0.0375000
NODE_6932_length_983_cov_26.011312	502	582	9	15	80	0.1875000
NODE_6932_length_983_cov_26.011312	502	582	10	51	80	0.6375000
NODE_6932_length_983_cov_26.011312	502	582	11	10	80	0.1250000
NODE_6932_length_983_cov_26.011312	502	582	12	4	80	0.0500000
NODE_6932_length_983_cov_26.011312	578	658	7	24	80	0.3000000
NODE_6932_length_983_cov_26.011312	578	658	8	14	80	0.1750000
NODE_6932_length_983_cov_26.011312	578	658	9	10	80	0.1250000
NODE_6932_length_983_cov_26.011312	578	658	10	24	80	0.3000000
NODE_6932_length_983_cov_26.011312	578	658	11	8	80	0.1000000
NODE_6932_length_983_cov_26.011312	631	711	5	2	80	0.0250000
NODE_6932_length_983_cov_26.011312	631	711	6	5	80	0.0625000
NODE_6932_length_983_cov_26.011312	631	711	7	46	80	0.5750000
NODE_6932_length_983_cov_26.011312	631	711	8	14	80	0.1750000
NODE_6932_length_983_cov_26.011312	631	711	10	7	80	0.0875000
NODE_6932_length_983_cov_26.011312	631	711	11	6	80	0.0750000
NODE_6933_length_983_cov_24.694570	539	619	2	4	80	0.0500000
NODE_6933_length_983_cov_24.694570	539	619	3	8	80	0.1000000
NODE_6933_length_983_cov_24.694570	539	619	4	11	80	0.1375000
NODE_6933_length_983_cov_24.694570	539	619	5	50	80	0.6250000
NODE_6933_length_983_cov_24.694570	539	619	6	7	80	0.0875000
NODE_6933_length_983_cov_24.694570	592	672	3	38	80	0.4750000
NODE_6933_length_983_cov_24.694570	592	672	4	29	80	0.3625000
NODE_6933_length_983_cov_24.694570	592	672	5	6	80	0.0750000
NODE_6933_length_983_cov_24.694570	592	672	6	7	80	0.0875000
NODE_6934_length_983_cov_22.214932	395	475	3	9	80	0.1125000
NODE_6934_length_983_cov_22.214932	395	475	4	71	80	0.8875000
NODE_6934_length_983_cov_22.214932	448	528	0	20	80	0.2500000
NODE_6934_length_983_cov_22.214932	448	528	2	2	80	0.0250000
NODE_6934_length_983_cov_22.214932	448	528	3	40	80	0.5000000
NODE_6934_length_983_cov_22.214932	448	528	4	18	80	0.2250000
NODE_6935_length_983_cov_19.132353	377	457	6	17	80	0.2125000
NODE_6935_length_983_cov_19.132353	377	457	7	50	80	0.6250000
NODE_6935_length_983_cov_19.132353	377	457	8	13	80	0.1625000
NODE_6935_length_983_cov_19.132353	430	510	5	41	80	0.5125000
NODE_6935_length_983_cov_19.132353	430	510	6	14	80	0.1750000
NODE_6935_length_983_cov_19.132353	430	510	7	15	80	0.1875000
NODE_6935_length_983_cov_19.132353	430	510	8	10	80	0.1250000
NODE_6936_length_983_cov_16.875566	419	499	2	36	80	0.4500000
NODE_6936_length_983_cov_16.875566	419	499	3	17	80	0.2125000
NODE_6936_length_983_cov_16.875566	419	499	5	21	80	0.2625000
NODE_6936_length_983_cov_16.875566	419	499	6	6	80	0.0750000
NODE_6936_length_983_cov_16.875566	472	552	5	21	80	0.2625000
NODE_6936_length_983_cov_16.875566	472	552	6	7	80	0.0875000
NODE_6936_length_983_cov_16.875566	472	552	7	18	80	0.2250000
NODE_6936_length_983_cov_16.875566	472	552	8	16	80	0.2000000
NODE_6936_length_983_cov_16.875566	472	552	9	1	80	0.0125000
NODE_6936_length_983_cov_16.875566	472	552	10	5	80	0.0625000
NODE_6936_length_983_cov_16.875566	472	552	11	12	80	0.1500000
NODE_6936_length_983_cov_16.875566	548	628	6	17	80	0.2125000
NODE_6936_length_983_cov_16.875566	548	628	7	44	80	0.5500000
NODE_6936_length_983_cov_16.875566	548	628	8	4	80	0.0500000
NODE_6936_length_983_cov_16.875566	548	628	10	2	80	0.0250000
NODE_6936_length_983_cov_16.875566	548	628	11	13	80	0.1625000
NODE_6936_length_983_cov_16.875566	601	681	4	13	80	0.1625000
NODE_6936_length_983_cov_16.875566	601	681	5	18	80	0.2250000
NODE_6936_length_983_cov_16.875566	601	681	6	24	80	0.3000000
NODE_6936_length_983_cov_16.875566	601	681	7	25	80	0.3125000
NODE_6937_length_983_cov_7.240950	487	567	0	80	80	1.0000000
NODE_6937_length_983_cov_7.240950	540	620	0	80	80	1.0000000
NODE_6949_length_982_cov_30.750849	357	437	4	20	80	0.2500000
NODE_6949_length_982_cov_30.750849	357	437	5	27	80	0.3375000
NODE_6949_length_982_cov_30.750849	357	437	6	31	80	0.3875000
NODE_6949_length_982_cov_30.750849	357	437	7	2	80	0.0250000
NODE_6949_length_982_cov_30.750849	410	490	6	28	80	0.3500000
NODE_6949_length_982_cov_30.750849	410	490	7	29	80	0.3625000
NODE_6949_length_982_cov_30.750849	410	490	8	18	80	0.2250000
NODE_6949_length_982_cov_30.750849	410	490	9	5	80	0.0625000
NODE_6950_length_982_cov_29.901472	516	596	2	72	80	0.9000000
NODE_6950_length_982_cov_29.901472	516	596	3	8	80	0.1000000
NODE_6950_length_982_cov_29.901472	569	649	2	19	80	0.2375000
NODE_6950_length_982_cov_29.901472	569	649	3	14	80	0.1750000
NODE_6950_length_982_cov_29.901472	569	649	4	47	80	0.5875000
NODE_6951_length_982_cov_18.251416	356	436	1	11	80	0.1375000
NODE_6951_length_982_cov_18.251416	356	436	2	2	80	0.0250000
NODE_6951_length_982_cov_18.251416	356	436	3	62	80	0.7750000
NODE_6951_length_982_cov_18.251416	356	436	4	5	80	0.0625000
NODE_6951_length_982_cov_18.251416	409	489	0	6	80	0.0750000
NODE_6951_length_982_cov_18.251416	409	489	1	34	80	0.4250000
NODE_6951_length_982_cov_18.251416	409	489	2	2	80	0.0250000
NODE_6951_length_982_cov_18.251416	409	489	3	14	80	0.1750000
NODE_6951_length_982_cov_18.251416	409	489	4	24	80	0.3000000
NODE_6951_length_982_cov_18.251416	485	565	0	16	80	0.2000000
NODE_6951_length_982_cov_18.251416	485	565	4	64	80	0.8000000
NODE_6951_length_982_cov_18.251416	538	618	0	69	80	0.8625000
NODE_6951_length_982_cov_18.251416	538	618	4	11	80	0.1375000
NODE_6952_length_982_cov_13.840317	608	688	1	80	80	1.0000000
NODE_6952_length_982_cov_13.840317	661	741	1	75	80	0.9375000
NODE_6952_length_982_cov_13.840317	661	741	2	5	80	0.0625000
NODE_6953_length_982_cov_13.227633	317	397	2	26	80	0.3250000
NODE_6953_length_982_cov_13.227633	317	397	3	54	80	0.6750000
NODE_6953_length_982_cov_13.227633	370	450	1	14	80	0.1750000
NODE_6953_length_982_cov_13.227633	370	450	2	61	80	0.7625000
NODE_6953_length_982_cov_13.227633	370	450	3	5	80	0.0625000
NODE_6954_length_982_cov_10.918460	209	289	5	1	80	0.0125000
NODE_6954_length_982_cov_10.918460	209	289	7	3	80	0.0375000
NODE_6954_length_982_cov_10.918460	209	289	9	23	80	0.2875000
NODE_6954_length_982_cov_10.918460	209	289	13	7	80	0.0875000
NODE_6954_length_982_cov_10.918460	209	289	14	18	80	0.2250000
NODE_6954_length_982_cov_10.918460	209	289	15	25	80	0.3125000
NODE_6954_length_982_cov_10.918460	209	289	16	3	80	0.0375000
NODE_6954_length_982_cov_10.918460	262	342	9	2	80	0.0250000
NODE_6954_length_982_cov_10.918460	262	342	11	48	80	0.6000000
NODE_6954_length_982_cov_10.918460	262	342	13	3	80	0.0375000
NODE_6954_length_982_cov_10.918460	262	342	15	24	80	0.3000000
NODE_6954_length_982_cov_10.918460	262	342	16	3	80	0.0375000
NODE_6956_length_982_cov_7.210646	216	296	3	47	80	0.5875000
NODE_6956_length_982_cov_7.210646	216	296	5	7	80	0.0875000
NODE_6956_length_982_cov_7.210646	216	296	6	2	80	0.0250000
NODE_6956_length_982_cov_7.210646	216	296	7	24	80	0.3000000
NODE_6956_length_982_cov_7.210646	269	349	5	27	80	0.3375000
NODE_6956_length_982_cov_7.210646	269	349	6	28	80	0.3500000
NODE_6956_length_982_cov_7.210646	269	349	7	24	80	0.3000000
NODE_6956_length_982_cov_7.210646	269	349	8	1	80	0.0125000
NODE_6973_length_981_cov_55.260771	410	490	8	6	80	0.0750000
NODE_6973_length_981_cov_55.260771	410	490	9	1	80	0.0125000
NODE_6973_length_981_cov_55.260771	410	490	10	11	80	0.1375000
NODE_6973_length_981_cov_55.260771	410	490	11	16	80	0.2000000
NODE_6973_length_981_cov_55.260771	410	490	12	28	80	0.3500000
NODE_6973_length_981_cov_55.260771	410	490	13	8	80	0.1000000
NODE_6973_length_981_cov_55.260771	410	490	14	10	80	0.1250000
NODE_6973_length_981_cov_55.260771	463	543	8	2	80	0.0250000
NODE_6973_length_981_cov_55.260771	463	543	9	23	80	0.2875000
NODE_6973_length_981_cov_55.260771	463	543	10	5	80	0.0625000
NODE_6973_length_981_cov_55.260771	463	543	11	24	80	0.3000000
NODE_6973_length_981_cov_55.260771	463	543	12	26	80	0.3250000
NODE_6973_length_981_cov_55.260771	539	619	10	5	80	0.0625000
NODE_6973_length_981_cov_55.260771	539	619	11	11	80	0.1375000
NODE_6973_length_981_cov_55.260771	539	619	12	1	80	0.0125000
NODE_6973_length_981_cov_55.260771	539	619	13	13	80	0.1625000
NODE_6973_length_981_cov_55.260771	539	619	14	26	80	0.3250000
NODE_6973_length_981_cov_55.260771	539	619	15	13	80	0.1625000
NODE_6973_length_981_cov_55.260771	539	619	16	11	80	0.1375000
NODE_6973_length_981_cov_55.260771	592	672	10	10	80	0.1250000
NODE_6973_length_981_cov_55.260771	592	672	12	17	80	0.2125000
NODE_6973_length_981_cov_55.260771	592	672	13	4	80	0.0500000
NODE_6973_length_981_cov_55.260771	592	672	14	14	80	0.1750000
NODE_6973_length_981_cov_55.260771	592	672	15	19	80	0.2375000
NODE_6973_length_981_cov_55.260771	592	672	16	16	80	0.2000000
NODE_6974_length_981_cov_33.287982	362	441	11	7	79	0.0886076
NODE_6974_length_981_cov_33.287982	362	441	13	10	79	0.1265823
NODE_6974_length_981_cov_33.287982	362	441	14	1	79	0.0126582
NODE_6974_length_981_cov_33.287982	362	441	16	20	79	0.2531646
NODE_6974_length_981_cov_33.287982	362	441	17	12	79	0.1518987
NODE_6974_length_981_cov_33.287982	362	441	18	29	79	0.3670886
NODE_6974_length_981_cov_33.287982	414	495	15	7	81	0.0864198
NODE_6974_length_981_cov_33.287982	414	495	16	64	81	0.7901235
NODE_6974_length_981_cov_33.287982	414	495	17	3	81	0.0370370
NODE_6974_length_981_cov_33.287982	414	495	18	7	81	0.0864198
NODE_6974_length_981_cov_33.287982	491	571	8	5	80	0.0625000
NODE_6974_length_981_cov_33.287982	491	571	9	25	80	0.3125000
NODE_6974_length_981_cov_33.287982	491	571	10	13	80	0.1625000
NODE_6974_length_981_cov_33.287982	491	571	12	4	80	0.0500000
NODE_6974_length_981_cov_33.287982	491	571	13	4	80	0.0500000
NODE_6974_length_981_cov_33.287982	491	571	14	9	80	0.1125000
NODE_6974_length_981_cov_33.287982	491	571	15	20	80	0.2500000
NODE_6974_length_981_cov_33.287982	544	624	8	10	80	0.1250000
NODE_6974_length_981_cov_33.287982	544	624	9	15	80	0.1875000
NODE_6974_length_981_cov_33.287982	544	624	10	18	80	0.2250000
NODE_6974_length_981_cov_33.287982	544	624	11	9	80	0.1125000
NODE_6974_length_981_cov_33.287982	544	624	12	28	80	0.3500000
NODE_6975_length_981_cov_33.121315	269	349	11	7	80	0.0875000
NODE_6975_length_981_cov_33.121315	269	349	13	19	80	0.2375000
NODE_6975_length_981_cov_33.121315	269	349	14	14	80	0.1750000
NODE_6975_length_981_cov_33.121315	269	349	15	39	80	0.4875000
NODE_6975_length_981_cov_33.121315	269	349	16	1	80	0.0125000
NODE_6975_length_981_cov_33.121315	322	402	3	10	80	0.1250000
NODE_6975_length_981_cov_33.121315	322	402	5	6	80	0.0750000
NODE_6975_length_981_cov_33.121315	322	402	6	7	80	0.0875000
NODE_6975_length_981_cov_33.121315	322	402	7	5	80	0.0625000
NODE_6975_length_981_cov_33.121315	322	402	8	1	80	0.0125000
NODE_6975_length_981_cov_33.121315	322	402	9	9	80	0.1125000
NODE_6975_length_981_cov_33.121315	322	402	11	7	80	0.0875000
NODE_6975_length_981_cov_33.121315	322	402	13	16	80	0.2000000
NODE_6975_length_981_cov_33.121315	322	402	15	19	80	0.2375000
NODE_6975_length_981_cov_33.121315	398	478	3	22	80	0.2750000
NODE_6975_length_981_cov_33.121315	398	478	4	3	80	0.0375000
NODE_6975_length_981_cov_33.121315	398	478	5	55	80	0.6875000
NODE_6975_length_981_cov_33.121315	451	531	3	68	80	0.8500000
NODE_6975_length_981_cov_33.121315	451	531	5	12	80	0.1500000
NODE_6976_length_981_cov_26.732426	397	477	4	9	80	0.1125000
NODE_6976_length_981_cov_26.732426	397	477	5	7	80	0.0875000
NODE_6976_length_981_cov_26.732426	397	477	6	19	80	0.2375000
NODE_6976_length_981_cov_26.732426	397	477	7	20	80	0.2500000
NODE_6976_length_981_cov_26.732426	397	477	8	25	80	0.3125000
NODE_6976_length_981_cov_26.732426	450	530	6	13	80	0.1625000
NODE_6976_length_981_cov_26.732426	450	530	7	29	80	0.3625000
NODE_6976_length_981_cov_26.732426	450	530	8	28	80	0.3500000
NODE_6976_length_981_cov_26.732426	450	530	9	10	80	0.1250000
NODE_6977_length_981_cov_24.304989	390	470	9	4	80	0.0500000
NODE_6977_length_981_cov_24.304989	390	470	10	22	80	0.2750000
NODE_6977_length_981_cov_24.304989	390	470	11	6	80	0.0750000
NODE_6977_length_981_cov_24.304989	390	470	12	27	80	0.3375000
NODE_6977_length_981_cov_24.304989	390	470	13	2	80	0.0250000
NODE_6977_length_981_cov_24.304989	390	470	14	19	80	0.2375000
NODE_6977_length_981_cov_24.304989	443	523	7	26	80	0.3250000
NODE_6977_length_981_cov_24.304989	443	523	9	11	80	0.1375000
NODE_6977_length_981_cov_24.304989	443	523	11	15	80	0.1875000
NODE_6977_length_981_cov_24.304989	443	523	12	7	80	0.0875000
NODE_6977_length_981_cov_24.304989	443	523	13	2	80	0.0250000
NODE_6977_length_981_cov_24.304989	443	523	14	19	80	0.2375000
NODE_6978_length_981_cov_10.485261	363	443	4	2	80	0.0250000
NODE_6978_length_981_cov_10.485261	363	443	5	49	80	0.6125000
NODE_6978_length_981_cov_10.485261	363	443	6	29	80	0.3625000
NODE_6978_length_981_cov_10.485261	416	496	4	22	80	0.2750000
NODE_6978_length_981_cov_10.485261	416	496	5	58	80	0.7250000
NODE_6980_length_981_cov_5.328798	821	885	0	64	64	1.0000000
NODE_6980_length_981_cov_5.328798	847	884	0	37	37	1.0000000
NODE_6998_length_980_cov_40.710556	329	409	3	1	80	0.0125000
NODE_6998_length_980_cov_40.710556	329	409	4	21	80	0.2625000
NODE_6998_length_980_cov_40.710556	329	409	5	3	80	0.0375000
NODE_6998_length_980_cov_40.710556	329	409	6	11	80	0.1375000
NODE_6998_length_980_cov_40.710556	329	409	7	8	80	0.1000000
NODE_6998_length_980_cov_40.710556	329	409	8	3	80	0.0375000
NODE_6998_length_980_cov_40.710556	329	409	9	8	80	0.1000000
NODE_6998_length_980_cov_40.710556	329	409	10	10	80	0.1250000
NODE_6998_length_980_cov_40.710556	329	409	11	1	80	0.0125000
NODE_6998_length_980_cov_40.710556	329	409	13	14	80	0.1750000
NODE_6998_length_980_cov_40.710556	382	462	9	2	80	0.0250000
NODE_6998_length_980_cov_40.710556	382	462	10	10	80	0.1250000
NODE_6998_length_980_cov_40.710556	382	462	11	16	80	0.2000000
NODE_6998_length_980_cov_40.710556	382	462	12	4	80	0.0500000
NODE_6998_length_980_cov_40.710556	382	462	13	46	80	0.5750000
NODE_6998_length_980_cov_40.710556	382	462	14	2	80	0.0250000
NODE_6998_length_980_cov_40.710556	458	538	6	4	80	0.0500000
NODE_6998_length_980_cov_40.710556	458	538	7	9	80	0.1125000
NODE_6998_length_980_cov_40.710556	458	538	8	3	80	0.0375000
NODE_6998_length_980_cov_40.710556	458	538	9	7	80	0.0875000
NODE_6998_length_980_cov_40.710556	458	538	10	11	80	0.1375000
NODE_6998_length_980_cov_40.710556	458	538	11	14	80	0.1750000
NODE_6998_length_980_cov_40.710556	458	538	12	21	80	0.2625000
NODE_6998_length_980_cov_40.710556	458	538	13	11	80	0.1375000
NODE_6998_length_980_cov_40.710556	511	591	0	12	80	0.1500000
NODE_6998_length_980_cov_40.710556	511	591	1	11	80	0.1375000
NODE_6998_length_980_cov_40.710556	511	591	3	24	80	0.3000000
NODE_6998_length_980_cov_40.710556	511	591	4	4	80	0.0500000
NODE_6998_length_980_cov_40.710556	511	591	6	6	80	0.0750000
NODE_6998_length_980_cov_40.710556	511	591	7	9	80	0.1125000
NODE_6998_length_980_cov_40.710556	511	591	8	3	80	0.0375000
NODE_6998_length_980_cov_40.710556	511	591	9	7	80	0.0875000
NODE_6998_length_980_cov_40.710556	511	591	10	4	80	0.0500000
NODE_6999_length_980_cov_37.634506	666	746	7	13	80	0.1625000
NODE_6999_length_980_cov_37.634506	666	746	8	9	80	0.1125000
NODE_6999_length_980_cov_37.634506	666	746	10	5	80	0.0625000
NODE_6999_length_980_cov_37.634506	666	746	11	32	80	0.4000000
NODE_6999_length_980_cov_37.634506	666	746	13	19	80	0.2375000
NODE_6999_length_980_cov_37.634506	666	746	14	2	80	0.0250000
NODE_6999_length_980_cov_37.634506	719	799	10	8	80	0.1000000
NODE_6999_length_980_cov_37.634506	719	799	11	25	80	0.3125000
NODE_6999_length_980_cov_37.634506	719	799	12	13	80	0.1625000
NODE_6999_length_980_cov_37.634506	719	799	13	31	80	0.3875000
NODE_6999_length_980_cov_37.634506	719	799	14	3	80	0.0375000
NODE_7000_length_980_cov_36.261067	331	411	5	6	80	0.0750000
NODE_7000_length_980_cov_36.261067	331	411	6	1	80	0.0125000
NODE_7000_length_980_cov_36.261067	331	411	7	6	80	0.0750000
NODE_7000_length_980_cov_36.261067	331	411	8	7	80	0.0875000
NODE_7000_length_980_cov_36.261067	331	411	10	8	80	0.1000000
NODE_7000_length_980_cov_36.261067	331	411	11	5	80	0.0625000
NODE_7000_length_980_cov_36.261067	331	411	12	13	80	0.1625000
NODE_7000_length_980_cov_36.261067	331	411	13	6	80	0.0750000
NODE_7000_length_980_cov_36.261067	331	411	14	7	80	0.0875000
NODE_7000_length_980_cov_36.261067	331	411	15	13	80	0.1625000
NODE_7000_length_980_cov_36.261067	331	411	16	1	80	0.0125000
NODE_7000_length_980_cov_36.261067	331	411	17	7	80	0.0875000
NODE_7000_length_980_cov_36.261067	384	453	13	4	69	0.0579710
NODE_7000_length_980_cov_36.261067	384	453	14	6	69	0.0869565
NODE_7000_length_980_cov_36.261067	384	453	15	37	69	0.5362319
NODE_7000_length_980_cov_36.261067	384	453	16	15	69	0.2173913
NODE_7000_length_980_cov_36.261067	384	453	17	7	69	0.1014493
NODE_7000_length_980_cov_36.261067	465	545	10	8	80	0.1000000
NODE_7000_length_980_cov_36.261067	465	545	11	26	80	0.3250000
NODE_7000_length_980_cov_36.261067	465	545	12	16	80	0.2000000
NODE_7000_length_980_cov_36.261067	465	545	13	3	80	0.0375000
NODE_7000_length_980_cov_36.261067	465	545	14	27	80	0.3375000
NODE_7000_length_980_cov_36.261067	518	598	3	1	80	0.0125000
NODE_7000_length_980_cov_36.261067	518	598	4	1	80	0.0125000
NODE_7000_length_980_cov_36.261067	518	598	5	13	80	0.1625000
NODE_7000_length_980_cov_36.261067	518	598	6	3	80	0.0375000
NODE_7000_length_980_cov_36.261067	518	598	7	29	80	0.3625000
NODE_7000_length_980_cov_36.261067	518	598	8	1	80	0.0125000
NODE_7000_length_980_cov_36.261067	518	598	9	5	80	0.0625000
NODE_7000_length_980_cov_36.261067	518	598	10	7	80	0.0875000
NODE_7000_length_980_cov_36.261067	518	598	11	11	80	0.1375000
NODE_7000_length_980_cov_36.261067	518	598	12	8	80	0.1000000
NODE_7000_length_980_cov_36.261067	518	598	13	1	80	0.0125000
NODE_7001_length_980_cov_28.514188	430	510	5	54	80	0.6750000
NODE_7001_length_980_cov_28.514188	430	510	7	26	80	0.3250000
NODE_7001_length_980_cov_28.514188	483	563	2	7	80	0.0875000
NODE_7001_length_980_cov_28.514188	483	563	3	7	80	0.0875000
NODE_7001_length_980_cov_28.514188	483	563	4	5	80	0.0625000
NODE_7001_length_980_cov_28.514188	483	563	5	1	80	0.0125000
NODE_7001_length_980_cov_28.514188	483	563	6	11	80	0.1375000
NODE_7001_length_980_cov_28.514188	483	563	7	49	80	0.6125000
NODE_7002_length_980_cov_25.205448	497	577	6	3	80	0.0375000
NODE_7002_length_980_cov_25.205448	497	577	8	14	80	0.1750000
NODE_7002_length_980_cov_25.205448	497	577	9	1	80	0.0125000
NODE_7002_length_980_cov_25.205448	497	577	10	13	80	0.1625000
NODE_7002_length_980_cov_25.205448	497	577	12	7	80	0.0875000
NODE_7002_length_980_cov_25.205448	497	577	13	34	80	0.4250000
NODE_7002_length_980_cov_25.205448	497	577	14	8	80	0.1000000
NODE_7002_length_980_cov_25.205448	550	630	2	1	80	0.0125000
NODE_7002_length_980_cov_25.205448	550	630	4	22	80	0.2750000
NODE_7002_length_980_cov_25.205448	550	630	5	28	80	0.3500000
NODE_7002_length_980_cov_25.205448	550	630	6	5	80	0.0625000
NODE_7002_length_980_cov_25.205448	550	630	8	14	80	0.1750000
NODE_7002_length_980_cov_25.205448	550	630	9	1	80	0.0125000
NODE_7002_length_980_cov_25.205448	550	630	12	3	80	0.0375000
NODE_7002_length_980_cov_25.205448	550	630	14	6	80	0.0750000
NODE_7003_length_980_cov_24.321226	417	497	1	16	80	0.2000000
NODE_7003_length_980_cov_24.321226	417	497	2	64	80	0.8000000
NODE_7003_length_980_cov_24.321226	470	550	0	13	80	0.1625000
NODE_7003_length_980_cov_24.321226	470	550	1	56	80	0.7000000
NODE_7003_length_980_cov_24.321226	470	550	2	11	80	0.1375000
NODE_7004_length_980_cov_20.460840	388	468	3	42	80	0.5250000
NODE_7004_length_980_cov_20.460840	388	468	4	7	80	0.0875000
NODE_7004_length_980_cov_20.460840	388	468	5	31	80	0.3875000
NODE_7004_length_980_cov_20.460840	441	521	4	36	80	0.4500000
NODE_7004_length_980_cov_20.460840	441	521	5	44	80	0.5500000
NODE_7005_length_980_cov_19.969353	486	566	1	17	80	0.2125000
NODE_7005_length_980_cov_19.969353	486	566	2	10	80	0.1250000
NODE_7005_length_980_cov_19.969353	486	566	4	53	80	0.6625000
NODE_7005_length_980_cov_19.969353	539	619	1	17	80	0.2125000
NODE_7005_length_980_cov_19.969353	539	619	3	9	80	0.1125000
NODE_7005_length_980_cov_19.969353	539	619	4	54	80	0.6750000
NODE_7006_length_980_cov_13.736663	350	430	0	80	80	1.0000000
NODE_7006_length_980_cov_13.736663	403	483	0	80	80	1.0000000
NODE_7006_length_980_cov_13.736663	479	559	0	80	80	1.0000000
NODE_7006_length_980_cov_13.736663	532	612	0	80	80	1.0000000
NODE_7008_length_980_cov_10.842225	517	597	2	4	80	0.0500000
NODE_7008_length_980_cov_10.842225	517	597	3	8	80	0.1000000
NODE_7008_length_980_cov_10.842225	517	597	4	68	80	0.8500000
NODE_7008_length_980_cov_10.842225	570	650	2	44	80	0.5500000
NODE_7008_length_980_cov_10.842225	570	650	4	36	80	0.4500000
NODE_7009_length_980_cov_10.087401	341	424	5	15	83	0.1807229
NODE_7009_length_980_cov_10.087401	341	424	6	39	83	0.4698795
NODE_7009_length_980_cov_10.087401	341	424	7	29	83	0.3493976
NODE_7009_length_980_cov_10.087401	397	477	6	25	80	0.3125000
NODE_7009_length_980_cov_10.087401	397	477	7	32	80	0.4000000
NODE_7009_length_980_cov_10.087401	397	477	8	23	80	0.2875000
NODE_7010_length_980_cov_9.643587	267	347	0	11	80	0.1375000
NODE_7010_length_980_cov_9.643587	267	347	2	69	80	0.8625000
NODE_7010_length_980_cov_9.643587	320	400	0	8	80	0.1000000
NODE_7010_length_980_cov_9.643587	320	400	2	72	80	0.9000000
NODE_7010_length_980_cov_9.643587	396	476	0	80	80	1.0000000
NODE_7010_length_980_cov_9.643587	449	529	0	80	80	1.0000000
NODE_7026_length_979_cov_22.576136	442	522	6	5	80	0.0625000
NODE_7026_length_979_cov_22.576136	442	522	7	23	80	0.2875000
NODE_7026_length_979_cov_22.576136	442	522	8	5	80	0.0625000
NODE_7026_length_979_cov_22.576136	442	522	9	38	80	0.4750000
NODE_7026_length_979_cov_22.576136	442	522	10	9	80	0.1125000
NODE_7026_length_979_cov_22.576136	495	575	8	14	80	0.1750000
NODE_7026_length_979_cov_22.576136	495	575	9	38	80	0.4750000
NODE_7026_length_979_cov_22.576136	495	575	10	28	80	0.3500000
NODE_7027_length_979_cov_19.739773	445	524	1	16	79	0.2025317
NODE_7027_length_979_cov_19.739773	445	524	2	8	79	0.1012658
NODE_7027_length_979_cov_19.739773	445	524	3	55	79	0.6962025
NODE_7027_length_979_cov_19.739773	497	577	1	16	80	0.2000000
NODE_7027_length_979_cov_19.739773	497	577	2	61	80	0.7625000
NODE_7027_length_979_cov_19.739773	497	577	3	3	80	0.0375000
NODE_7028_length_979_cov_19.480682	436	516	2	80	80	1.0000000
NODE_7028_length_979_cov_19.480682	489	569	2	50	80	0.6250000
NODE_7028_length_979_cov_19.480682	489	569	4	30	80	0.3750000
NODE_7028_length_979_cov_19.480682	565	645	2	75	80	0.9375000
NODE_7028_length_979_cov_19.480682	565	645	4	5	80	0.0625000
NODE_7028_length_979_cov_19.480682	618	698	0	41	80	0.5125000
NODE_7028_length_979_cov_19.480682	618	698	2	39	80	0.4875000
NODE_7029_length_979_cov_18.901136	470	550	1	80	80	1.0000000
NODE_7029_length_979_cov_18.901136	523	603	0	7	80	0.0875000
NODE_7029_length_979_cov_18.901136	523	603	1	73	80	0.9125000
NODE_7031_length_979_cov_3.519318	101	168	2	67	67	1.0000000
NODE_7040_length_978_cov_23.195677	424	504	5	37	80	0.4625000
NODE_7040_length_978_cov_23.195677	424	504	6	6	80	0.0750000
NODE_7040_length_978_cov_23.195677	424	504	7	3	80	0.0375000
NODE_7040_length_978_cov_23.195677	424	504	8	34	80	0.4250000
NODE_7040_length_978_cov_23.195677	477	557	3	4	80	0.0500000
NODE_7040_length_978_cov_23.195677	477	557	4	13	80	0.1625000
NODE_7040_length_978_cov_23.195677	477	557	5	6	80	0.0750000
NODE_7040_length_978_cov_23.195677	477	557	7	33	80	0.4125000
NODE_7040_length_978_cov_23.195677	477	557	8	24	80	0.3000000
NODE_7041_length_978_cov_18.866894	440	520	3	24	80	0.3000000
NODE_7041_length_978_cov_18.866894	440	520	4	16	80	0.2000000
NODE_7041_length_978_cov_18.866894	440	520	5	32	80	0.4000000
NODE_7041_length_978_cov_18.866894	440	520	6	2	80	0.0250000
NODE_7041_length_978_cov_18.866894	440	520	7	6	80	0.0750000
NODE_7041_length_978_cov_18.866894	493	573	5	19	80	0.2375000
NODE_7041_length_978_cov_18.866894	493	573	6	2	80	0.0250000
NODE_7041_length_978_cov_18.866894	493	573	7	11	80	0.1375000
NODE_7041_length_978_cov_18.866894	493	573	9	48	80	0.6000000
NODE_7042_length_978_cov_15.614334	341	421	1	54	80	0.6750000
NODE_7042_length_978_cov_15.614334	341	421	2	15	80	0.1875000
NODE_7042_length_978_cov_15.614334	341	421	3	11	80	0.1375000
NODE_7042_length_978_cov_15.614334	394	474	1	1	80	0.0125000
NODE_7042_length_978_cov_15.614334	394	474	2	15	80	0.1875000
NODE_7042_length_978_cov_15.614334	394	474	3	23	80	0.2875000
NODE_7042_length_978_cov_15.614334	394	474	4	41	80	0.5125000
NODE_7042_length_978_cov_15.614334	470	550	3	11	80	0.1375000
NODE_7042_length_978_cov_15.614334	470	550	4	69	80	0.8625000
NODE_7042_length_978_cov_15.614334	523	603	0	25	80	0.3125000
NODE_7042_length_978_cov_15.614334	523	603	1	12	80	0.1500000
NODE_7042_length_978_cov_15.614334	523	603	2	12	80	0.1500000
NODE_7042_length_978_cov_15.614334	523	603	3	15	80	0.1875000
NODE_7042_length_978_cov_15.614334	523	603	4	16	80	0.2000000
NODE_7043_length_978_cov_15.253697	327	407	0	1	80	0.0125000
NODE_7043_length_978_cov_15.253697	327	407	2	46	80	0.5750000
NODE_7043_length_978_cov_15.253697	327	407	3	33	80	0.4125000
NODE_7043_length_978_cov_15.253697	380	460	2	1	80	0.0125000
NODE_7043_length_978_cov_15.253697	380	460	3	36	80	0.4500000
NODE_7043_length_978_cov_15.253697	380	460	4	43	80	0.5375000
NODE_7043_length_978_cov_15.253697	456	536	1	12	80	0.1500000
NODE_7043_length_978_cov_15.253697	456	536	2	65	80	0.8125000
NODE_7043_length_978_cov_15.253697	456	536	4	3	80	0.0375000
NODE_7043_length_978_cov_15.253697	509	589	0	23	80	0.2875000
NODE_7043_length_978_cov_15.253697	509	589	1	42	80	0.5250000
NODE_7043_length_978_cov_15.253697	509	589	2	15	80	0.1875000
NODE_7044_length_978_cov_14.730375	407	487	2	17	80	0.2125000
NODE_7044_length_978_cov_14.730375	407	487	4	49	80	0.6125000
NODE_7044_length_978_cov_14.730375	407	487	5	14	80	0.1750000
NODE_7044_length_978_cov_14.730375	460	540	2	63	80	0.7875000
NODE_7044_length_978_cov_14.730375	460	540	3	7	80	0.0875000
NODE_7044_length_978_cov_14.730375	460	540	4	5	80	0.0625000
NODE_7044_length_978_cov_14.730375	460	540	5	5	80	0.0625000
NODE_7045_length_978_cov_7.257110	571	651	2	4	80	0.0500000
NODE_7045_length_978_cov_7.257110	571	651	4	15	80	0.1875000
NODE_7045_length_978_cov_7.257110	571	651	6	61	80	0.7625000
NODE_7045_length_978_cov_7.257110	624	704	2	57	80	0.7125000
NODE_7045_length_978_cov_7.257110	624	704	4	4	80	0.0500000
NODE_7045_length_978_cov_7.257110	624	704	6	19	80	0.2375000
NODE_7062_length_977_cov_47.484055	427	507	7	4	80	0.0500000
NODE_7062_length_977_cov_47.484055	427	507	8	32	80	0.4000000
NODE_7062_length_977_cov_47.484055	427	507	9	23	80	0.2875000
NODE_7062_length_977_cov_47.484055	427	507	10	21	80	0.2625000
NODE_7062_length_977_cov_47.484055	480	560	3	8	80	0.1000000
NODE_7062_length_977_cov_47.484055	480	560	4	1	80	0.0125000
NODE_7062_length_977_cov_47.484055	480	560	5	3	80	0.0375000
NODE_7062_length_977_cov_47.484055	480	560	6	20	80	0.2500000
NODE_7062_length_977_cov_47.484055	480	560	7	25	80	0.3125000
NODE_7062_length_977_cov_47.484055	480	560	8	14	80	0.1750000
NODE_7062_length_977_cov_47.484055	480	560	9	9	80	0.1125000
NODE_7063_length_977_cov_47.116173	428	508	8	26	80	0.3250000
NODE_7063_length_977_cov_47.116173	428	508	9	7	80	0.0875000
NODE_7063_length_977_cov_47.116173	428	508	10	6	80	0.0750000
NODE_7063_length_977_cov_47.116173	428	508	11	17	80	0.2125000
NODE_7063_length_977_cov_47.116173	428	508	12	7	80	0.0875000
NODE_7063_length_977_cov_47.116173	428	508	13	13	80	0.1625000
NODE_7063_length_977_cov_47.116173	428	508	14	4	80	0.0500000
NODE_7063_length_977_cov_47.116173	481	561	9	16	80	0.2000000
NODE_7063_length_977_cov_47.116173	481	561	10	2	80	0.0250000
NODE_7063_length_977_cov_47.116173	481	561	11	18	80	0.2250000
NODE_7063_length_977_cov_47.116173	481	561	12	27	80	0.3375000
NODE_7063_length_977_cov_47.116173	481	561	13	13	80	0.1625000
NODE_7063_length_977_cov_47.116173	481	561	14	4	80	0.0500000
NODE_7063_length_977_cov_47.116173	557	637	2	12	80	0.1500000
NODE_7063_length_977_cov_47.116173	557	637	3	9	80	0.1125000
NODE_7063_length_977_cov_47.116173	557	637	4	5	80	0.0625000
NODE_7063_length_977_cov_47.116173	557	637	5	15	80	0.1875000
NODE_7063_length_977_cov_47.116173	557	637	6	15	80	0.1875000
NODE_7063_length_977_cov_47.116173	557	637	8	14	80	0.1750000
NODE_7063_length_977_cov_47.116173	557	637	9	10	80	0.1250000
NODE_7063_length_977_cov_47.116173	610	690	1	26	80	0.3250000
NODE_7063_length_977_cov_47.116173	610	690	2	22	80	0.2750000
NODE_7063_length_977_cov_47.116173	610	690	3	26	80	0.3250000
NODE_7063_length_977_cov_47.116173	610	690	4	5	80	0.0625000
NODE_7063_length_977_cov_47.116173	610	690	5	1	80	0.0125000
NODE_7064_length_977_cov_32.542141	486	566	0	3	80	0.0375000
NODE_7064_length_977_cov_32.542141	486	566	2	10	80	0.1250000
NODE_7064_length_977_cov_32.542141	486	566	4	18	80	0.2250000
NODE_7064_length_977_cov_32.542141	486	566	6	27	80	0.3375000
NODE_7064_length_977_cov_32.542141	486	566	7	22	80	0.2750000
NODE_7064_length_977_cov_32.542141	539	619	6	5	80	0.0625000
NODE_7064_length_977_cov_32.542141	539	619	7	75	80	0.9375000
NODE_7065_length_977_cov_30.676538	361	441	12	14	80	0.1750000
NODE_7065_length_977_cov_30.676538	361	441	14	7	80	0.0875000
NODE_7065_length_977_cov_30.676538	361	441	15	3	80	0.0375000
NODE_7065_length_977_cov_30.676538	361	441	16	5	80	0.0625000
NODE_7065_length_977_cov_30.676538	361	441	18	4	80	0.0500000
NODE_7065_length_977_cov_30.676538	361	441	19	28	80	0.3500000
NODE_7065_length_977_cov_30.676538	361	441	20	10	80	0.1250000
NODE_7065_length_977_cov_30.676538	361	441	22	5	80	0.0625000
NODE_7065_length_977_cov_30.676538	361	441	24	4	80	0.0500000
NODE_7065_length_977_cov_30.676538	414	494	16	4	80	0.0500000
NODE_7065_length_977_cov_30.676538	414	494	18	19	80	0.2375000
NODE_7065_length_977_cov_30.676538	414	494	19	11	80	0.1375000
NODE_7065_length_977_cov_30.676538	414	494	20	18	80	0.2250000
NODE_7065_length_977_cov_30.676538	414	494	21	11	80	0.1375000
NODE_7065_length_977_cov_30.676538	414	494	22	13	80	0.1625000
NODE_7065_length_977_cov_30.676538	414	494	24	4	80	0.0500000
NODE_7066_length_977_cov_28.348519	455	535	3	29	80	0.3625000
NODE_7066_length_977_cov_28.348519	455	535	4	5	80	0.0625000
NODE_7066_length_977_cov_28.348519	455	535	6	26	80	0.3250000
NODE_7066_length_977_cov_28.348519	455	535	7	12	80	0.1500000
NODE_7066_length_977_cov_28.348519	455	535	8	8	80	0.1000000
NODE_7066_length_977_cov_28.348519	508	588	2	27	80	0.3375000
NODE_7066_length_977_cov_28.348519	508	588	3	53	80	0.6625000
NODE_7067_length_977_cov_26.571754	343	423	4	5	80	0.0625000
NODE_7067_length_977_cov_26.571754	343	423	5	1	80	0.0125000
NODE_7067_length_977_cov_26.571754	343	423	6	9	80	0.1125000
NODE_7067_length_977_cov_26.571754	343	423	8	34	80	0.4250000
NODE_7067_length_977_cov_26.571754	343	423	9	31	80	0.3875000
NODE_7067_length_977_cov_26.571754	396	476	3	8	80	0.1000000
NODE_7067_length_977_cov_26.571754	396	476	5	14	80	0.1750000
NODE_7067_length_977_cov_26.571754	396	476	6	1	80	0.0125000
NODE_7067_length_977_cov_26.571754	396	476	7	10	80	0.1250000
NODE_7067_length_977_cov_26.571754	396	476	8	19	80	0.2375000
NODE_7067_length_977_cov_26.571754	396	476	9	28	80	0.3500000
NODE_7067_length_977_cov_26.571754	472	552	0	10	80	0.1250000
NODE_7067_length_977_cov_26.571754	472	552	1	43	80	0.5375000
NODE_7067_length_977_cov_26.571754	472	552	2	1	80	0.0125000
NODE_7067_length_977_cov_26.571754	472	552	3	26	80	0.3250000
NODE_7067_length_977_cov_26.571754	525	600	0	58	75	0.7733333
NODE_7067_length_977_cov_26.571754	525	600	1	17	75	0.2266667
NODE_7068_length_977_cov_24.898633	470	550	3	19	80	0.2375000
NODE_7068_length_977_cov_24.898633	470	550	5	31	80	0.3875000
NODE_7068_length_977_cov_24.898633	470	550	7	30	80	0.3750000
NODE_7068_length_977_cov_24.898633	523	603	6	25	80	0.3125000
NODE_7068_length_977_cov_24.898633	523	603	7	33	80	0.4125000
NODE_7068_length_977_cov_24.898633	523	603	8	22	80	0.2750000
NODE_7069_length_977_cov_22.986333	313	393	0	27	80	0.3375000
NODE_7069_length_977_cov_22.986333	313	393	1	20	80	0.2500000
NODE_7069_length_977_cov_22.986333	313	393	2	20	80	0.2500000
NODE_7069_length_977_cov_22.986333	313	393	3	13	80	0.1625000
NODE_7069_length_977_cov_22.986333	366	446	2	14	80	0.1750000
NODE_7069_length_977_cov_22.986333	366	446	3	35	80	0.4375000
NODE_7069_length_977_cov_22.986333	366	446	4	12	80	0.1500000
NODE_7069_length_977_cov_22.986333	366	446	5	19	80	0.2375000
NODE_7069_length_977_cov_22.986333	442	522	5	49	80	0.6125000
NODE_7069_length_977_cov_22.986333	442	522	6	31	80	0.3875000
NODE_7069_length_977_cov_22.986333	495	575	4	29	80	0.3625000
NODE_7069_length_977_cov_22.986333	495	575	5	41	80	0.5125000
NODE_7069_length_977_cov_22.986333	495	575	6	10	80	0.1250000
NODE_7070_length_977_cov_10.753986	290	370	7	9	80	0.1125000
NODE_7070_length_977_cov_10.753986	290	370	8	10	80	0.1250000
NODE_7070_length_977_cov_10.753986	290	370	9	11	80	0.1375000
NODE_7070_length_977_cov_10.753986	290	370	10	50	80	0.6250000
NODE_7070_length_977_cov_10.753986	343	423	4	21	80	0.2625000
NODE_7070_length_977_cov_10.753986	343	423	5	9	80	0.1125000
NODE_7070_length_977_cov_10.753986	343	423	6	7	80	0.0875000
NODE_7070_length_977_cov_10.753986	343	423	7	13	80	0.1625000
NODE_7070_length_977_cov_10.753986	343	423	8	12	80	0.1500000
NODE_7070_length_977_cov_10.753986	343	423	9	10	80	0.1250000
NODE_7070_length_977_cov_10.753986	343	423	10	8	80	0.1000000
NODE_7071_length_977_cov_9.924829	401	456	1	55	55	1.0000000
NODE_7073_length_977_cov_6.391800	483	563	4	3	80	0.0375000
NODE_7073_length_977_cov_6.391800	483	563	5	16	80	0.2000000
NODE_7073_length_977_cov_6.391800	483	563	6	26	80	0.3250000
NODE_7073_length_977_cov_6.391800	483	563	7	35	80	0.4375000
NODE_7073_length_977_cov_6.391800	536	616	1	22	80	0.2750000
NODE_7073_length_977_cov_6.391800	536	616	3	6	80	0.0750000
NODE_7073_length_977_cov_6.391800	536	616	5	41	80	0.5125000
NODE_7073_length_977_cov_6.391800	536	616	6	4	80	0.0500000
NODE_7073_length_977_cov_6.391800	536	616	7	7	80	0.0875000
NODE_7075_length_977_cov_2.907745	191	241	0	7	50	0.1400000
NODE_7075_length_977_cov_2.907745	191	241	1	2	50	0.0400000
NODE_7075_length_977_cov_2.907745	191	241	2	41	50	0.8200000
NODE_7085_length_976_cov_38.192702	326	406	1	25	80	0.3125000
NODE_7085_length_976_cov_38.192702	326	406	2	55	80	0.6875000
NODE_7085_length_976_cov_38.192702	379	459	1	43	80	0.5375000
NODE_7085_length_976_cov_38.192702	379	459	2	13	80	0.1625000
NODE_7085_length_976_cov_38.192702	379	459	3	24	80	0.3000000
NODE_7085_length_976_cov_38.192702	455	535	3	11	80	0.1375000
NODE_7085_length_976_cov_38.192702	455	535	4	58	80	0.7250000
NODE_7085_length_976_cov_38.192702	455	535	5	5	80	0.0625000
NODE_7085_length_976_cov_38.192702	455	535	6	6	80	0.0750000
NODE_7085_length_976_cov_38.192702	455	536	3	11	81	0.1358025
NODE_7085_length_976_cov_38.192702	455	536	4	58	81	0.7160494
NODE_7085_length_976_cov_38.192702	455	536	5	5	81	0.0617284
NODE_7085_length_976_cov_38.192702	455	536	6	7	81	0.0864198
NODE_7085_length_976_cov_38.192702	455	519	3	11	64	0.1718750
NODE_7085_length_976_cov_38.192702	455	519	4	53	64	0.8281250
NODE_7085_length_976_cov_38.192702	508	588	4	19	80	0.2375000
NODE_7085_length_976_cov_38.192702	508	588	5	13	80	0.1625000
NODE_7085_length_976_cov_38.192702	508	588	6	48	80	0.6000000
NODE_7086_length_976_cov_26.275941	499	579	1	33	80	0.4125000
NODE_7086_length_976_cov_26.275941	499	579	2	16	80	0.2000000
NODE_7086_length_976_cov_26.275941	499	579	3	31	80	0.3875000
NODE_7086_length_976_cov_26.275941	552	632	3	80	80	1.0000000
NODE_7087_length_976_cov_25.559863	376	456	1	13	80	0.1625000
NODE_7087_length_976_cov_25.559863	376	456	3	17	80	0.2125000
NODE_7087_length_976_cov_25.559863	376	456	4	50	80	0.6250000
NODE_7087_length_976_cov_25.559863	429	509	4	49	80	0.6125000
NODE_7087_length_976_cov_25.559863	429	509	5	31	80	0.3875000
NODE_7088_length_976_cov_17.961231	572	652	0	3	80	0.0375000
NODE_7088_length_976_cov_17.961231	572	652	1	22	80	0.2750000
NODE_7088_length_976_cov_17.961231	572	652	2	55	80	0.6875000
NODE_7088_length_976_cov_17.961231	625	705	2	80	80	1.0000000
NODE_7089_length_976_cov_5.567845	789	851	0	10	62	0.1612903
NODE_7089_length_976_cov_5.567845	789	851	2	52	62	0.8387097
NODE_7089_length_976_cov_5.567845	842	904	0	29	62	0.4677419
NODE_7089_length_976_cov_5.567845	842	904	2	33	62	0.5322581
NODE_7101_length_975_cov_192.211187	722	802	33	4	80	0.0500000
NODE_7101_length_975_cov_192.211187	722	802	34	6	80	0.0750000
NODE_7101_length_975_cov_192.211187	722	802	35	9	80	0.1125000
NODE_7101_length_975_cov_192.211187	722	802	36	1	80	0.0125000
NODE_7101_length_975_cov_192.211187	722	802	38	11	80	0.1375000
NODE_7101_length_975_cov_192.211187	722	802	39	9	80	0.1125000
NODE_7101_length_975_cov_192.211187	722	802	40	7	80	0.0875000
NODE_7101_length_975_cov_192.211187	722	802	41	8	80	0.1000000
NODE_7101_length_975_cov_192.211187	722	802	42	13	80	0.1625000
NODE_7101_length_975_cov_192.211187	722	802	43	7	80	0.0875000
NODE_7101_length_975_cov_192.211187	722	802	44	1	80	0.0125000
NODE_7101_length_975_cov_192.211187	722	802	45	1	80	0.0125000
NODE_7101_length_975_cov_192.211187	722	802	46	3	80	0.0375000
NODE_7102_length_975_cov_41.446347	414	494	4	9	80	0.1125000
NODE_7102_length_975_cov_41.446347	414	494	5	9	80	0.1125000
NODE_7102_length_975_cov_41.446347	414	494	6	12	80	0.1500000
NODE_7102_length_975_cov_41.446347	414	494	8	8	80	0.1000000
NODE_7102_length_975_cov_41.446347	414	494	9	26	80	0.3250000
NODE_7102_length_975_cov_41.446347	414	494	10	1	80	0.0125000
NODE_7102_length_975_cov_41.446347	414	494	11	11	80	0.1375000
NODE_7102_length_975_cov_41.446347	414	494	12	4	80	0.0500000
NODE_7102_length_975_cov_41.446347	467	547	8	1	80	0.0125000
NODE_7102_length_975_cov_41.446347	467	547	9	10	80	0.1250000
NODE_7102_length_975_cov_41.446347	467	547	10	19	80	0.2375000
NODE_7102_length_975_cov_41.446347	467	547	11	31	80	0.3875000
NODE_7102_length_975_cov_41.446347	467	547	12	19	80	0.2375000
NODE_7103_length_975_cov_37.618721	375	455	9	22	80	0.2750000
NODE_7103_length_975_cov_37.618721	375	455	10	22	80	0.2750000
NODE_7103_length_975_cov_37.618721	375	455	11	32	80	0.4000000
NODE_7103_length_975_cov_37.618721	375	455	12	4	80	0.0500000
NODE_7103_length_975_cov_37.618721	428	508	6	18	80	0.2250000
NODE_7103_length_975_cov_37.618721	428	508	7	3	80	0.0375000
NODE_7103_length_975_cov_37.618721	428	508	9	10	80	0.1250000
NODE_7103_length_975_cov_37.618721	428	508	10	36	80	0.4500000
NODE_7103_length_975_cov_37.618721	428	508	11	13	80	0.1625000
NODE_7104_length_975_cov_34.265982	424	504	11	7	80	0.0875000
NODE_7104_length_975_cov_34.265982	424	504	12	14	80	0.1750000
NODE_7104_length_975_cov_34.265982	424	504	13	10	80	0.1250000
NODE_7104_length_975_cov_34.265982	424	504	14	49	80	0.6125000
NODE_7104_length_975_cov_34.265982	477	557	4	2	80	0.0250000
NODE_7104_length_975_cov_34.265982	477	557	7	6	80	0.0750000
NODE_7104_length_975_cov_34.265982	477	557	8	15	80	0.1875000
NODE_7104_length_975_cov_34.265982	477	557	9	7	80	0.0875000
NODE_7104_length_975_cov_34.265982	477	557	10	4	80	0.0500000
NODE_7104_length_975_cov_34.265982	477	557	11	11	80	0.1375000
NODE_7104_length_975_cov_34.265982	477	557	12	13	80	0.1625000
NODE_7104_length_975_cov_34.265982	477	557	13	10	80	0.1250000
NODE_7104_length_975_cov_34.265982	477	557	14	12	80	0.1500000
NODE_7105_length_975_cov_31.888128	461	541	8	17	80	0.2125000
NODE_7105_length_975_cov_31.888128	461	541	9	1	80	0.0125000
NODE_7105_length_975_cov_31.888128	461	541	10	62	80	0.7750000
NODE_7105_length_975_cov_31.888128	514	594	2	9	80	0.1125000
NODE_7105_length_975_cov_31.888128	514	594	4	18	80	0.2250000
NODE_7105_length_975_cov_31.888128	514	594	6	17	80	0.2125000
NODE_7105_length_975_cov_31.888128	514	594	8	26	80	0.3250000
NODE_7105_length_975_cov_31.888128	514	594	10	10	80	0.1250000
NODE_7106_length_975_cov_22.093607	392	472	2	14	80	0.1750000
NODE_7106_length_975_cov_22.093607	392	472	3	21	80	0.2625000
NODE_7106_length_975_cov_22.093607	392	472	4	23	80	0.2875000
NODE_7106_length_975_cov_22.093607	392	472	5	16	80	0.2000000
NODE_7106_length_975_cov_22.093607	392	472	6	6	80	0.0750000
NODE_7106_length_975_cov_22.093607	445	525	4	14	80	0.1750000
NODE_7106_length_975_cov_22.093607	445	525	5	7	80	0.0875000
NODE_7106_length_975_cov_22.093607	445	525	6	59	80	0.7375000
NODE_7107_length_975_cov_15.091324	403	483	3	2	80	0.0250000
NODE_7107_length_975_cov_15.091324	403	483	4	37	80	0.4625000
NODE_7107_length_975_cov_15.091324	403	483	5	21	80	0.2625000
NODE_7107_length_975_cov_15.091324	403	483	6	20	80	0.2500000
NODE_7107_length_975_cov_15.091324	456	536	3	24	80	0.3000000
NODE_7107_length_975_cov_15.091324	456	536	5	14	80	0.1750000
NODE_7107_length_975_cov_15.091324	456	536	6	42	80	0.5250000
NODE_7108_length_975_cov_15.046804	63	143	5	5	80	0.0625000
NODE_7108_length_975_cov_15.046804	63	143	6	17	80	0.2125000
NODE_7108_length_975_cov_15.046804	63	143	8	58	80	0.7250000
NODE_7108_length_975_cov_15.046804	116	196	1	3	80	0.0375000
NODE_7108_length_975_cov_15.046804	116	196	3	19	80	0.2375000
NODE_7108_length_975_cov_15.046804	116	196	4	18	80	0.2250000
NODE_7108_length_975_cov_15.046804	116	196	6	11	80	0.1375000
NODE_7108_length_975_cov_15.046804	116	196	8	29	80	0.3625000
NODE_7109_length_975_cov_12.043379	535	615	2	73	80	0.9125000
NODE_7109_length_975_cov_12.043379	535	615	4	7	80	0.0875000
NODE_7109_length_975_cov_12.043379	588	668	2	29	80	0.3625000
NODE_7109_length_975_cov_12.043379	588	668	4	51	80	0.6375000
NODE_7110_length_975_cov_11.772831	276	354	2	18	78	0.2307692
NODE_7110_length_975_cov_11.772831	276	354	3	2	78	0.0256410
NODE_7110_length_975_cov_11.772831	276	354	5	39	78	0.5000000
NODE_7110_length_975_cov_11.772831	276	354	6	19	78	0.2435897
NODE_7110_length_975_cov_11.772831	327	407	4	8	80	0.1000000
NODE_7110_length_975_cov_11.772831	327	407	5	49	80	0.6125000
NODE_7110_length_975_cov_11.772831	327	407	6	23	80	0.2875000
NODE_7111_length_975_cov_10.599315	405	485	0	80	80	1.0000000
NODE_7111_length_975_cov_10.599315	458	538	0	80	80	1.0000000
NODE_7112_length_975_cov_8.089041	430	510	3	2	80	0.0250000
NODE_7112_length_975_cov_8.089041	430	510	4	78	80	0.9750000
NODE_7112_length_975_cov_8.089041	483	563	3	4	80	0.0500000
NODE_7112_length_975_cov_8.089041	483	563	4	76	80	0.9500000
NODE_7114_length_975_cov_3.728311	254	334	0	80	80	1.0000000
NODE_7114_length_975_cov_3.728311	307	387	0	80	80	1.0000000
NODE_7125_length_974_cov_293.334857	564	642	39	4	78	0.0512821
NODE_7125_length_974_cov_293.334857	564	642	40	5	78	0.0641026
NODE_7125_length_974_cov_293.334857	564	642	41	8	78	0.1025641
NODE_7125_length_974_cov_293.334857	564	642	42	18	78	0.2307692
NODE_7125_length_974_cov_293.334857	564	642	43	15	78	0.1923077
NODE_7125_length_974_cov_293.334857	564	642	44	14	78	0.1794872
NODE_7125_length_974_cov_293.334857	564	642	45	4	78	0.0512821
NODE_7125_length_974_cov_293.334857	564	642	46	6	78	0.0769231
NODE_7125_length_974_cov_293.334857	564	642	47	4	78	0.0512821
NODE_7125_length_974_cov_293.334857	564	642	39	4	78	0.0512821
NODE_7125_length_974_cov_293.334857	564	642	40	5	78	0.0641026
NODE_7125_length_974_cov_293.334857	564	642	41	8	78	0.1025641
NODE_7125_length_974_cov_293.334857	564	642	42	18	78	0.2307692
NODE_7125_length_974_cov_293.334857	564	642	43	15	78	0.1923077
NODE_7125_length_974_cov_293.334857	564	642	44	14	78	0.1794872
NODE_7125_length_974_cov_293.334857	564	642	45	4	78	0.0512821
NODE_7125_length_974_cov_293.334857	564	642	46	6	78	0.0769231
NODE_7125_length_974_cov_293.334857	564	642	47	4	78	0.0512821
NODE_7125_length_974_cov_293.334857	564	633	39	4	69	0.0579710
NODE_7125_length_974_cov_293.334857	564	633	40	5	69	0.0724638
NODE_7125_length_974_cov_293.334857	564	633	41	8	69	0.1159420
NODE_7125_length_974_cov_293.334857	564	633	42	18	69	0.2608696
NODE_7125_length_974_cov_293.334857	564	633	43	15	69	0.2173913
NODE_7125_length_974_cov_293.334857	564	633	44	14	69	0.2028985
NODE_7125_length_974_cov_293.334857	564	633	45	4	69	0.0579710
NODE_7125_length_974_cov_293.334857	564	633	46	1	69	0.0144928
NODE_7126_length_974_cov_49.884571	459	539	17	1	80	0.0125000
NODE_7126_length_974_cov_49.884571	459	539	18	17	80	0.2125000
NODE_7126_length_974_cov_49.884571	459	539	20	15	80	0.1875000
NODE_7126_length_974_cov_49.884571	459	539	21	12	80	0.1500000
NODE_7126_length_974_cov_49.884571	459	539	22	3	80	0.0375000
NODE_7126_length_974_cov_49.884571	459	539	23	25	80	0.3125000
NODE_7126_length_974_cov_49.884571	459	539	24	7	80	0.0875000
NODE_7126_length_974_cov_49.884571	512	592	7	4	80	0.0500000
NODE_7126_length_974_cov_49.884571	512	592	8	4	80	0.0500000
NODE_7126_length_974_cov_49.884571	512	592	10	1	80	0.0125000
NODE_7126_length_974_cov_49.884571	512	592	13	2	80	0.0250000
NODE_7126_length_974_cov_49.884571	512	592	15	4	80	0.0500000
NODE_7126_length_974_cov_49.884571	512	592	16	2	80	0.0250000
NODE_7126_length_974_cov_49.884571	512	592	17	24	80	0.3000000
NODE_7126_length_974_cov_49.884571	512	592	18	30	80	0.3750000
NODE_7126_length_974_cov_49.884571	512	592	20	4	80	0.0500000
NODE_7126_length_974_cov_49.884571	512	592	21	5	80	0.0625000
NODE_7127_length_974_cov_38.384000	430	508	5	14	78	0.1794872
NODE_7127_length_974_cov_38.384000	430	508	6	29	78	0.3717949
NODE_7127_length_974_cov_38.384000	430	508	7	4	78	0.0512821
NODE_7127_length_974_cov_38.384000	430	508	8	25	78	0.3205128
NODE_7127_length_974_cov_38.384000	430	508	9	6	78	0.0769231
NODE_7127_length_974_cov_38.384000	483	561	7	3	78	0.0384615
NODE_7127_length_974_cov_38.384000	483	561	8	16	78	0.2051282
NODE_7127_length_974_cov_38.384000	483	561	9	53	78	0.6794872
NODE_7127_length_974_cov_38.384000	483	561	10	6	78	0.0769231
NODE_7128_length_974_cov_26.008000	391	471	0	19	80	0.2375000
NODE_7128_length_974_cov_26.008000	391	471	1	61	80	0.7625000
NODE_7128_length_974_cov_26.008000	444	524	1	44	80	0.5500000
NODE_7128_length_974_cov_26.008000	444	524	2	21	80	0.2625000
NODE_7128_length_974_cov_26.008000	444	524	3	8	80	0.1000000
NODE_7128_length_974_cov_26.008000	444	524	4	7	80	0.0875000
NODE_7128_length_974_cov_26.008000	520	600	4	39	80	0.4875000
NODE_7128_length_974_cov_26.008000	520	600	5	21	80	0.2625000
NODE_7128_length_974_cov_26.008000	520	600	6	1	80	0.0125000
NODE_7128_length_974_cov_26.008000	520	600	7	19	80	0.2375000
NODE_7128_length_974_cov_26.008000	573	653	5	8	80	0.1000000
NODE_7128_length_974_cov_26.008000	573	653	6	15	80	0.1875000
NODE_7128_length_974_cov_26.008000	573	653	7	57	80	0.7125000
NODE_7129_length_974_cov_21.160000	460	540	1	8	80	0.1000000
NODE_7129_length_974_cov_21.160000	460	540	2	7	80	0.0875000
NODE_7129_length_974_cov_21.160000	460	540	3	65	80	0.8125000
NODE_7129_length_974_cov_21.160000	513	593	0	14	80	0.1750000
NODE_7129_length_974_cov_21.160000	513	593	1	12	80	0.1500000
NODE_7129_length_974_cov_21.160000	513	593	3	54	80	0.6750000
NODE_7131_length_974_cov_11.384000	290	370	0	43	80	0.5375000
NODE_7131_length_974_cov_11.384000	290	370	1	37	80	0.4625000
NODE_7131_length_974_cov_11.384000	343	423	1	80	80	1.0000000
NODE_7132_length_974_cov_11.216000	543	623	0	80	80	1.0000000
NODE_7132_length_974_cov_11.216000	596	668	0	72	72	1.0000000
NODE_7133_length_974_cov_9.601143	436	516	1	4	80	0.0500000
NODE_7133_length_974_cov_9.601143	436	516	2	46	80	0.5750000
NODE_7133_length_974_cov_9.601143	436	516	3	1	80	0.0125000
NODE_7133_length_974_cov_9.601143	436	516	4	29	80	0.3625000
NODE_7133_length_974_cov_9.601143	489	569	3	21	80	0.2625000
NODE_7133_length_974_cov_9.601143	489	569	4	59	80	0.7375000
NODE_7134_length_974_cov_7.436571	382	462	2	40	80	0.5000000
NODE_7134_length_974_cov_7.436571	382	462	3	8	80	0.1000000
NODE_7134_length_974_cov_7.436571	382	462	4	26	80	0.3250000
NODE_7134_length_974_cov_7.436571	382	462	5	6	80	0.0750000
NODE_7134_length_974_cov_7.436571	436	515	2	11	79	0.1392405
NODE_7134_length_974_cov_7.436571	436	515	3	8	79	0.1012658
NODE_7134_length_974_cov_7.436571	436	515	4	58	79	0.7341772
NODE_7134_length_974_cov_7.436571	436	515	5	2	79	0.0253165
NODE_7147_length_973_cov_46.012586	349	429	10	12	80	0.1500000
NODE_7147_length_973_cov_46.012586	349	429	11	31	80	0.3875000
NODE_7147_length_973_cov_46.012586	349	429	13	37	80	0.4625000
NODE_7147_length_973_cov_46.012586	402	482	8	13	80	0.1625000
NODE_7147_length_973_cov_46.012586	402	482	10	25	80	0.3125000
NODE_7147_length_973_cov_46.012586	402	482	11	31	80	0.3875000
NODE_7147_length_973_cov_46.012586	402	482	12	7	80	0.0875000
NODE_7147_length_973_cov_46.012586	402	482	13	4	80	0.0500000
NODE_7147_length_973_cov_46.012586	478	558	2	59	80	0.7375000
NODE_7147_length_973_cov_46.012586	478	558	4	8	80	0.1000000
NODE_7147_length_973_cov_46.012586	478	558	5	2	80	0.0250000
NODE_7147_length_973_cov_46.012586	478	558	7	4	80	0.0500000
NODE_7147_length_973_cov_46.012586	478	558	8	7	80	0.0875000
NODE_7147_length_973_cov_46.012586	531	611	1	11	80	0.1375000
NODE_7147_length_973_cov_46.012586	531	611	2	68	80	0.8500000
NODE_7147_length_973_cov_46.012586	531	611	3	1	80	0.0125000
NODE_7148_length_973_cov_40.305492	364	444	9	1	80	0.0125000
NODE_7148_length_973_cov_40.305492	364	444	10	1	80	0.0125000
NODE_7148_length_973_cov_40.305492	364	444	16	8	80	0.1000000
NODE_7148_length_973_cov_40.305492	364	444	18	10	80	0.1250000
NODE_7148_length_973_cov_40.305492	364	444	19	4	80	0.0500000
NODE_7148_length_973_cov_40.305492	364	444	20	3	80	0.0375000
NODE_7148_length_973_cov_40.305492	364	444	22	2	80	0.0250000
NODE_7148_length_973_cov_40.305492	364	444	23	3	80	0.0375000
NODE_7148_length_973_cov_40.305492	364	444	25	5	80	0.0625000
NODE_7148_length_973_cov_40.305492	364	444	27	2	80	0.0250000
NODE_7148_length_973_cov_40.305492	364	444	28	9	80	0.1125000
NODE_7148_length_973_cov_40.305492	364	444	29	20	80	0.2500000
NODE_7148_length_973_cov_40.305492	364	444	30	1	80	0.0125000
NODE_7148_length_973_cov_40.305492	364	444	31	1	80	0.0125000
NODE_7148_length_973_cov_40.305492	364	444	32	10	80	0.1250000
NODE_7148_length_973_cov_40.305492	417	497	17	11	80	0.1375000
NODE_7148_length_973_cov_40.305492	417	497	19	2	80	0.0250000
NODE_7148_length_973_cov_40.305492	417	497	21	16	80	0.2000000
NODE_7148_length_973_cov_40.305492	417	497	27	10	80	0.1250000
NODE_7148_length_973_cov_40.305492	417	497	28	9	80	0.1125000
NODE_7148_length_973_cov_40.305492	417	497	29	32	80	0.4000000
NODE_7149_length_973_cov_24.105263	460	540	6	3	80	0.0375000
NODE_7149_length_973_cov_24.105263	460	540	7	1	80	0.0125000
NODE_7149_length_973_cov_24.105263	460	540	8	6	80	0.0750000
NODE_7149_length_973_cov_24.105263	460	540	9	11	80	0.1375000
NODE_7149_length_973_cov_24.105263	460	540	10	8	80	0.1000000
NODE_7149_length_973_cov_24.105263	460	540	11	29	80	0.3625000
NODE_7149_length_973_cov_24.105263	460	540	12	16	80	0.2000000
NODE_7149_length_973_cov_24.105263	460	540	13	6	80	0.0750000
NODE_7149_length_973_cov_24.105263	513	593	7	4	80	0.0500000
NODE_7149_length_973_cov_24.105263	513	593	8	4	80	0.0500000
NODE_7149_length_973_cov_24.105263	513	593	9	16	80	0.2000000
NODE_7149_length_973_cov_24.105263	513	593	10	18	80	0.2250000
NODE_7149_length_973_cov_24.105263	513	593	11	27	80	0.3375000
NODE_7149_length_973_cov_24.105263	513	593	12	5	80	0.0625000
NODE_7149_length_973_cov_24.105263	513	593	13	6	80	0.0750000
NODE_7150_length_973_cov_22.106407	342	422	5	15	80	0.1875000
NODE_7150_length_973_cov_22.106407	342	422	6	5	80	0.0625000
NODE_7150_length_973_cov_22.106407	342	422	7	52	80	0.6500000
NODE_7150_length_973_cov_22.106407	342	422	8	8	80	0.1000000
NODE_7150_length_973_cov_22.106407	395	475	1	3	80	0.0375000
NODE_7150_length_973_cov_22.106407	395	475	3	22	80	0.2750000
NODE_7150_length_973_cov_22.106407	395	475	5	30	80	0.3750000
NODE_7150_length_973_cov_22.106407	395	475	6	5	80	0.0625000
NODE_7150_length_973_cov_22.106407	395	475	7	12	80	0.1500000
NODE_7150_length_973_cov_22.106407	395	475	8	8	80	0.1000000
NODE_7150_length_973_cov_22.106407	471	550	1	52	79	0.6582279
NODE_7150_length_973_cov_22.106407	471	550	3	27	79	0.3417721
NODE_7150_length_973_cov_22.106407	526	604	2	49	78	0.6282051
NODE_7150_length_973_cov_22.106407	526	604	3	29	78	0.3717949
NODE_7151_length_973_cov_10.994279	430	510	1	20	80	0.2500000
NODE_7151_length_973_cov_10.994279	430	510	2	60	80	0.7500000
NODE_7151_length_973_cov_10.994279	483	563	0	9	80	0.1125000
NODE_7151_length_973_cov_10.994279	483	563	1	58	80	0.7250000
NODE_7151_length_973_cov_10.994279	483	563	2	13	80	0.1625000
NODE_7151_length_973_cov_10.994279	559	635	2	36	76	0.4736842
NODE_7151_length_973_cov_10.994279	559	635	4	40	76	0.5263158
NODE_7151_length_973_cov_10.994279	608	688	0	1	80	0.0125000
NODE_7151_length_973_cov_10.994279	608	688	2	2	80	0.0250000
NODE_7151_length_973_cov_10.994279	608	688	4	77	80	0.9625000
NODE_7153_length_973_cov_2.973684	734	814	0	53	80	0.6625000
NODE_7153_length_973_cov_2.973684	734	814	1	27	80	0.3375000
NODE_7153_length_973_cov_2.973684	820	890	2	70	70	1.0000000
NODE_7153_length_973_cov_2.973684	863	944	1	7	81	0.0864198
NODE_7153_length_973_cov_2.973684	863	944	2	74	81	0.9135802
NODE_7166_length_972_cov_32.547537	299	379	4	46	80	0.5750000
NODE_7166_length_972_cov_32.547537	299	379	5	19	80	0.2375000
NODE_7166_length_972_cov_32.547537	299	379	6	6	80	0.0750000
NODE_7166_length_972_cov_32.547537	299	379	7	9	80	0.1125000
NODE_7166_length_972_cov_32.547537	352	432	4	31	80	0.3875000
NODE_7166_length_972_cov_32.547537	352	432	5	25	80	0.3125000
NODE_7166_length_972_cov_32.547537	352	432	6	18	80	0.2250000
NODE_7166_length_972_cov_32.547537	352	432	7	6	80	0.0750000
NODE_7166_length_972_cov_32.547537	428	508	6	2	80	0.0250000
NODE_7166_length_972_cov_32.547537	428	508	7	18	80	0.2250000
NODE_7166_length_972_cov_32.547537	428	508	8	2	80	0.0250000
NODE_7166_length_972_cov_32.547537	428	508	9	39	80	0.4875000
NODE_7166_length_972_cov_32.547537	428	508	11	19	80	0.2375000
NODE_7166_length_972_cov_32.547537	481	561	4	4	80	0.0500000
NODE_7166_length_972_cov_32.547537	481	561	7	11	80	0.1375000
NODE_7166_length_972_cov_32.547537	481	561	8	36	80	0.4500000
NODE_7166_length_972_cov_32.547537	481	561	9	17	80	0.2125000
NODE_7166_length_972_cov_32.547537	481	561	11	12	80	0.1500000
NODE_7167_length_972_cov_31.010309	474	554	10	1	80	0.0125000
NODE_7167_length_972_cov_31.010309	474	554	11	8	80	0.1000000
NODE_7167_length_972_cov_31.010309	474	554	12	8	80	0.1000000
NODE_7167_length_972_cov_31.010309	474	554	13	6	80	0.0750000
NODE_7167_length_972_cov_31.010309	474	554	16	13	80	0.1625000
NODE_7167_length_972_cov_31.010309	474	554	17	25	80	0.3125000
NODE_7167_length_972_cov_31.010309	474	554	18	16	80	0.2000000
NODE_7167_length_972_cov_31.010309	474	554	19	3	80	0.0375000
NODE_7167_length_972_cov_31.010309	527	607	12	2	80	0.0250000
NODE_7167_length_972_cov_31.010309	527	607	13	38	80	0.4750000
NODE_7167_length_972_cov_31.010309	527	607	14	3	80	0.0375000
NODE_7167_length_972_cov_31.010309	527	607	16	23	80	0.2875000
NODE_7167_length_972_cov_31.010309	527	607	18	14	80	0.1750000
NODE_7168_length_972_cov_29.810997	481	561	3	11	80	0.1375000
NODE_7168_length_972_cov_29.810997	481	561	4	6	80	0.0750000
NODE_7168_length_972_cov_29.810997	481	561	6	2	80	0.0250000
NODE_7168_length_972_cov_29.810997	481	561	8	28	80	0.3500000
NODE_7168_length_972_cov_29.810997	481	561	9	20	80	0.2500000
NODE_7168_length_972_cov_29.810997	481	561	10	13	80	0.1625000
NODE_7168_length_972_cov_29.810997	534	614	8	18	80	0.2250000
NODE_7168_length_972_cov_29.810997	534	614	9	48	80	0.6000000
NODE_7168_length_972_cov_29.810997	534	614	10	7	80	0.0875000
NODE_7168_length_972_cov_29.810997	534	614	11	7	80	0.0875000
NODE_7169_length_972_cov_23.438717	442	522	6	49	80	0.6125000
NODE_7169_length_972_cov_23.438717	442	522	7	18	80	0.2250000
NODE_7169_length_972_cov_23.438717	442	522	8	13	80	0.1625000
NODE_7169_length_972_cov_23.438717	495	575	5	15	80	0.1875000
NODE_7169_length_972_cov_23.438717	495	575	6	14	80	0.1750000
NODE_7169_length_972_cov_23.438717	495	575	7	11	80	0.1375000
NODE_7169_length_972_cov_23.438717	495	575	8	34	80	0.4250000
NODE_7169_length_972_cov_23.438717	495	575	10	6	80	0.0750000
NODE_7170_length_972_cov_18.886598	453	533	0	80	80	1.0000000
NODE_7170_length_972_cov_18.886598	506	585	0	79	79	1.0000000
NODE_7171_length_972_cov_15.100802	329	409	6	12	80	0.1500000
NODE_7171_length_972_cov_15.100802	329	409	7	6	80	0.0750000
NODE_7171_length_972_cov_15.100802	329	409	8	62	80	0.7750000
NODE_7171_length_972_cov_15.100802	382	462	3	28	80	0.3500000
NODE_7171_length_972_cov_15.100802	382	462	6	9	80	0.1125000
NODE_7171_length_972_cov_15.100802	382	462	7	6	80	0.0750000
NODE_7171_length_972_cov_15.100802	382	462	8	37	80	0.4625000
NODE_7172_length_972_cov_12.674685	444	524	5	1	80	0.0125000
NODE_7172_length_972_cov_12.674685	444	524	6	17	80	0.2125000
NODE_7172_length_972_cov_12.674685	444	524	7	38	80	0.4750000
NODE_7172_length_972_cov_12.674685	444	524	8	24	80	0.3000000
NODE_7172_length_972_cov_12.674685	497	577	4	4	80	0.0500000
NODE_7172_length_972_cov_12.674685	497	577	5	24	80	0.3000000
NODE_7172_length_972_cov_12.674685	497	577	6	35	80	0.4375000
NODE_7172_length_972_cov_12.674685	497	577	7	17	80	0.2125000
NODE_7173_length_972_cov_11.235968	504	584	0	26	80	0.3250000
NODE_7173_length_972_cov_11.235968	504	584	1	54	80	0.6750000
NODE_7173_length_972_cov_11.235968	557	637	1	29	80	0.3625000
NODE_7173_length_972_cov_11.235968	557	637	3	51	80	0.6375000
NODE_7174_length_972_cov_10.983963	402	482	0	64	80	0.8000000
NODE_7174_length_972_cov_10.983963	402	482	2	16	80	0.2000000
NODE_7174_length_972_cov_10.983963	455	535	0	11	80	0.1375000
NODE_7174_length_972_cov_10.983963	455	535	2	69	80	0.8625000
NODE_7175_length_972_cov_8.887743	302	382	0	80	80	1.0000000
NODE_7175_length_972_cov_8.887743	355	430	0	75	75	1.0000000
NODE_7176_length_972_cov_8.265750	488	568	3	40	80	0.5000000
NODE_7176_length_972_cov_8.265750	488	568	5	40	80	0.5000000
NODE_7176_length_972_cov_8.265750	541	621	3	52	80	0.6500000
NODE_7176_length_972_cov_8.265750	541	621	5	28	80	0.3500000
NODE_7182_length_972_cov_2.714777	165	241	0	76	76	1.0000000
NODE_7195_length_971_cov_52.575688	398	478	5	7	80	0.0875000
NODE_7195_length_971_cov_52.575688	398	478	6	12	80	0.1500000
NODE_7195_length_971_cov_52.575688	398	478	7	3	80	0.0375000
NODE_7195_length_971_cov_52.575688	398	478	9	14	80	0.1750000
NODE_7195_length_971_cov_52.575688	398	478	10	4	80	0.0500000
NODE_7195_length_971_cov_52.575688	398	478	11	40	80	0.5000000
NODE_7195_length_971_cov_52.575688	451	531	11	45	80	0.5625000
NODE_7195_length_971_cov_52.575688	451	531	12	35	80	0.4375000
NODE_7195_length_971_cov_52.575688	527	607	6	9	80	0.1125000
NODE_7195_length_971_cov_52.575688	527	607	7	2	80	0.0250000
NODE_7195_length_971_cov_52.575688	527	607	8	24	80	0.3000000
NODE_7195_length_971_cov_52.575688	527	607	9	5	80	0.0625000
NODE_7195_length_971_cov_52.575688	527	607	10	8	80	0.1000000
NODE_7195_length_971_cov_52.575688	527	607	11	10	80	0.1250000
NODE_7195_length_971_cov_52.575688	527	607	12	22	80	0.2750000
NODE_7195_length_971_cov_52.575688	580	660	5	20	80	0.2500000
NODE_7195_length_971_cov_52.575688	580	660	6	19	80	0.2375000
NODE_7195_length_971_cov_52.575688	580	660	7	2	80	0.0250000
NODE_7195_length_971_cov_52.575688	580	660	8	35	80	0.4375000
NODE_7195_length_971_cov_52.575688	580	660	9	4	80	0.0500000
NODE_7196_length_971_cov_44.464450	280	360	1	14	80	0.1750000
NODE_7196_length_971_cov_44.464450	280	360	2	49	80	0.6125000
NODE_7196_length_971_cov_44.464450	280	360	4	1	80	0.0125000
NODE_7196_length_971_cov_44.464450	280	360	6	16	80	0.2000000
NODE_7196_length_971_cov_44.464450	333	413	2	10	80	0.1250000
NODE_7196_length_971_cov_44.464450	333	413	4	1	80	0.0125000
NODE_7196_length_971_cov_44.464450	333	413	5	20	80	0.2500000
NODE_7196_length_971_cov_44.464450	333	413	6	46	80	0.5750000
NODE_7196_length_971_cov_44.464450	333	413	7	3	80	0.0375000
NODE_7196_length_971_cov_44.464450	409	489	5	1	80	0.0125000
NODE_7196_length_971_cov_44.464450	409	489	7	3	80	0.0375000
NODE_7196_length_971_cov_44.464450	409	489	8	21	80	0.2625000
NODE_7196_length_971_cov_44.464450	409	489	10	23	80	0.2875000
NODE_7196_length_971_cov_44.464450	409	489	11	32	80	0.4000000
NODE_7196_length_971_cov_44.464450	462	542	2	33	80	0.4125000
NODE_7196_length_971_cov_44.464450	462	542	4	13	80	0.1625000
NODE_7196_length_971_cov_44.464450	462	542	6	2	80	0.0250000
NODE_7196_length_971_cov_44.464450	462	542	8	26	80	0.3250000
NODE_7196_length_971_cov_44.464450	462	542	10	6	80	0.0750000
NODE_7197_length_971_cov_32.721330	509	589	2	39	80	0.4875000
NODE_7197_length_971_cov_32.721330	509	589	4	26	80	0.3250000
NODE_7197_length_971_cov_32.721330	509	589	5	15	80	0.1875000
NODE_7197_length_971_cov_32.721330	562	642	3	29	80	0.3625000
NODE_7197_length_971_cov_32.721330	562	642	4	12	80	0.1500000
NODE_7197_length_971_cov_32.721330	562	642	5	39	80	0.4875000
NODE_7198_length_971_cov_30.264908	474	554	6	4	80	0.0500000
NODE_7198_length_971_cov_30.264908	474	554	8	12	80	0.1500000
NODE_7198_length_971_cov_30.264908	474	554	10	15	80	0.1875000
NODE_7198_length_971_cov_30.264908	474	554	12	18	80	0.2250000
NODE_7198_length_971_cov_30.264908	474	554	13	17	80	0.2125000
NODE_7198_length_971_cov_30.264908	474	554	14	14	80	0.1750000
NODE_7198_length_971_cov_30.264908	527	607	10	6	80	0.0750000
NODE_7198_length_971_cov_30.264908	527	607	11	9	80	0.1125000
NODE_7198_length_971_cov_30.264908	527	607	12	14	80	0.1750000
NODE_7198_length_971_cov_30.264908	527	607	13	45	80	0.5625000
NODE_7198_length_971_cov_30.264908	527	607	14	6	80	0.0750000
NODE_7199_length_971_cov_26.631881	434	514	0	80	80	1.0000000
NODE_7199_length_971_cov_26.631881	487	567	0	80	80	1.0000000
NODE_7200_length_971_cov_25.635321	404	484	5	7	80	0.0875000
NODE_7200_length_971_cov_25.635321	404	484	7	12	80	0.1500000
NODE_7200_length_971_cov_25.635321	404	484	8	16	80	0.2000000
NODE_7200_length_971_cov_25.635321	404	484	9	26	80	0.3250000
NODE_7200_length_971_cov_25.635321	404	484	10	19	80	0.2375000
NODE_7200_length_971_cov_25.635321	457	537	5	2	80	0.0250000
NODE_7200_length_971_cov_25.635321	457	537	6	24	80	0.3000000
NODE_7200_length_971_cov_25.635321	457	537	7	12	80	0.1500000
NODE_7200_length_971_cov_25.635321	457	537	8	6	80	0.0750000
NODE_7200_length_971_cov_25.635321	457	537	9	24	80	0.3000000
NODE_7200_length_971_cov_25.635321	457	537	10	12	80	0.1500000
NODE_7201_length_971_cov_23.334862	363	443	5	17	80	0.2125000
NODE_7201_length_971_cov_23.334862	363	443	7	12	80	0.1500000
NODE_7201_length_971_cov_23.334862	363	443	8	36	80	0.4500000
NODE_7201_length_971_cov_23.334862	363	443	9	15	80	0.1875000
NODE_7201_length_971_cov_23.334862	416	497	4	14	81	0.1728395
NODE_7201_length_971_cov_23.334862	416	497	5	19	81	0.2345679
NODE_7201_length_971_cov_23.334862	416	497	6	5	81	0.0617284
NODE_7201_length_971_cov_23.334862	416	497	7	18	81	0.2222222
NODE_7201_length_971_cov_23.334862	416	497	8	12	81	0.1481481
NODE_7201_length_971_cov_23.334862	416	497	9	13	81	0.1604938
NODE_7202_length_971_cov_18.254587	468	548	0	80	80	1.0000000
NODE_7202_length_971_cov_18.254587	521	601	0	80	80	1.0000000
NODE_7203_length_971_cov_18.229358	392	472	1	7	80	0.0875000
NODE_7203_length_971_cov_18.229358	392	472	2	71	80	0.8875000
NODE_7203_length_971_cov_18.229358	392	472	3	2	80	0.0250000
NODE_7203_length_971_cov_18.229358	445	525	2	42	80	0.5250000
NODE_7203_length_971_cov_18.229358	445	525	3	38	80	0.4750000
NODE_7204_length_971_cov_16.591743	481	561	3	9	80	0.1125000
NODE_7204_length_971_cov_16.591743	481	561	5	18	80	0.2250000
NODE_7204_length_971_cov_16.591743	481	561	7	19	80	0.2375000
NODE_7204_length_971_cov_16.591743	481	561	8	8	80	0.1000000
NODE_7204_length_971_cov_16.591743	481	561	9	26	80	0.3250000
NODE_7204_length_971_cov_16.591743	534	614	7	28	80	0.3500000
NODE_7204_length_971_cov_16.591743	534	614	8	4	80	0.0500000
NODE_7204_length_971_cov_16.591743	534	614	9	48	80	0.6000000
NODE_7205_length_971_cov_15.563073	463	543	3	2	80	0.0250000
NODE_7205_length_971_cov_15.563073	463	543	4	30	80	0.3750000
NODE_7205_length_971_cov_15.563073	463	543	5	19	80	0.2375000
NODE_7205_length_971_cov_15.563073	463	543	6	29	80	0.3625000
NODE_7205_length_971_cov_15.563073	516	596	3	9	80	0.1125000
NODE_7205_length_971_cov_15.563073	516	596	4	4	80	0.0500000
NODE_7205_length_971_cov_15.563073	516	596	5	50	80	0.6250000
NODE_7205_length_971_cov_15.563073	516	596	6	17	80	0.2125000
NODE_7206_length_971_cov_12.141055	415	495	0	40	80	0.5000000
NODE_7206_length_971_cov_12.141055	415	495	1	19	80	0.2375000
NODE_7206_length_971_cov_12.141055	415	495	2	21	80	0.2625000
NODE_7206_length_971_cov_12.141055	468	548	1	6	80	0.0750000
NODE_7206_length_971_cov_12.141055	468	548	2	63	80	0.7875000
NODE_7206_length_971_cov_12.141055	468	548	3	11	80	0.1375000
NODE_7222_length_970_cov_34.928817	438	518	1	7	80	0.0875000
NODE_7222_length_970_cov_34.928817	438	518	2	73	80	0.9125000
NODE_7222_length_970_cov_34.928817	491	571	2	30	80	0.3750000
NODE_7222_length_970_cov_34.928817	491	571	3	49	80	0.6125000
NODE_7222_length_970_cov_34.928817	491	571	4	1	80	0.0125000
NODE_7223_length_970_cov_34.445465	540	620	12	28	80	0.3500000
NODE_7223_length_970_cov_34.445465	540	620	13	14	80	0.1750000
NODE_7223_length_970_cov_34.445465	540	620	14	37	80	0.4625000
NODE_7223_length_970_cov_34.445465	540	620	15	1	80	0.0125000
NODE_7223_length_970_cov_34.445465	593	673	4	35	80	0.4375000
NODE_7223_length_970_cov_34.445465	593	673	5	1	80	0.0125000
NODE_7223_length_970_cov_34.445465	593	673	6	8	80	0.1000000
NODE_7223_length_970_cov_34.445465	593	673	7	8	80	0.1000000
NODE_7223_length_970_cov_34.445465	593	673	11	1	80	0.0125000
NODE_7223_length_970_cov_34.445465	593	673	12	27	80	0.3375000
NODE_7224_length_970_cov_34.257176	352	432	0	80	80	1.0000000
NODE_7224_length_970_cov_34.257176	405	485	0	80	80	1.0000000
NODE_7225_length_970_cov_26.904707	297	372	4	75	75	1.0000000
NODE_7225_length_970_cov_26.904707	303	376	4	73	73	1.0000000
NODE_7225_length_970_cov_26.904707	311	377	4	66	66	1.0000000
NODE_7225_length_970_cov_26.904707	350	429	2	8	79	0.1012658
NODE_7225_length_970_cov_26.904707	350	429	3	31	79	0.3924051
NODE_7225_length_970_cov_26.904707	350	429	4	40	79	0.5063291
NODE_7225_length_970_cov_26.904707	350	429	2	8	79	0.1012658
NODE_7225_length_970_cov_26.904707	350	429	3	31	79	0.3924051
NODE_7225_length_970_cov_26.904707	350	429	4	40	79	0.5063291
NODE_7225_length_970_cov_26.904707	350	429	2	8	79	0.1012658
NODE_7225_length_970_cov_26.904707	350	429	3	31	79	0.3924051
NODE_7225_length_970_cov_26.904707	350	429	4	40	79	0.5063291
NODE_7226_length_970_cov_26.040184	266	346	2	70	80	0.8750000
NODE_7226_length_970_cov_26.040184	266	346	3	10	80	0.1250000
NODE_7226_length_970_cov_26.040184	319	399	2	38	80	0.4750000
NODE_7226_length_970_cov_26.040184	319	399	3	42	80	0.5250000
NODE_7226_length_970_cov_26.040184	395	475	2	15	80	0.1875000
NODE_7226_length_970_cov_26.040184	395	475	3	3	80	0.0375000
NODE_7226_length_970_cov_26.040184	395	475	4	6	80	0.0750000
NODE_7226_length_970_cov_26.040184	395	475	6	13	80	0.1625000
NODE_7226_length_970_cov_26.040184	395	475	8	3	80	0.0375000
NODE_7226_length_970_cov_26.040184	395	475	9	23	80	0.2875000
NODE_7226_length_970_cov_26.040184	395	475	10	10	80	0.1250000
NODE_7226_length_970_cov_26.040184	395	475	12	7	80	0.0875000
NODE_7226_length_970_cov_26.040184	448	528	9	10	80	0.1250000
NODE_7226_length_970_cov_26.040184	448	528	10	10	80	0.1250000
NODE_7226_length_970_cov_26.040184	448	528	11	30	80	0.3750000
NODE_7226_length_970_cov_26.040184	448	528	12	30	80	0.3750000
NODE_7227_length_970_cov_19.291619	415	495	3	3	80	0.0375000
NODE_7227_length_970_cov_19.291619	415	495	4	12	80	0.1500000
NODE_7227_length_970_cov_19.291619	415	495	5	65	80	0.8125000
NODE_7227_length_970_cov_19.291619	468	548	2	6	80	0.0750000
NODE_7227_length_970_cov_19.291619	468	548	3	6	80	0.0750000
NODE_7227_length_970_cov_19.291619	468	548	4	36	80	0.4500000
NODE_7227_length_970_cov_19.291619	468	548	5	32	80	0.4000000
NODE_7228_length_970_cov_17.731343	557	637	6	3	80	0.0375000
NODE_7228_length_970_cov_17.731343	557	637	7	25	80	0.3125000
NODE_7228_length_970_cov_17.731343	557	637	8	52	80	0.6500000
NODE_7228_length_970_cov_17.731343	610	690	5	15	80	0.1875000
NODE_7228_length_970_cov_17.731343	610	690	6	38	80	0.4750000
NODE_7228_length_970_cov_17.731343	610	690	7	1	80	0.0125000
NODE_7228_length_970_cov_17.731343	610	690	8	26	80	0.3250000
NODE_7229_length_970_cov_15.135476	407	487	5	16	80	0.2000000
NODE_7229_length_970_cov_15.135476	407	487	6	32	80	0.4000000
NODE_7229_length_970_cov_15.135476	407	487	7	32	80	0.4000000
NODE_7229_length_970_cov_15.135476	460	540	5	52	80	0.6500000
NODE_7229_length_970_cov_15.135476	460	540	6	19	80	0.2375000
NODE_7229_length_970_cov_15.135476	460	540	7	9	80	0.1125000
NODE_7230_length_970_cov_12.675086	534	614	4	17	80	0.2125000
NODE_7230_length_970_cov_12.675086	534	614	6	50	80	0.6250000
NODE_7230_length_970_cov_12.675086	534	614	8	13	80	0.1625000
NODE_7230_length_970_cov_12.675086	587	667	2	20	80	0.2500000
NODE_7230_length_970_cov_12.675086	587	667	4	15	80	0.1875000
NODE_7230_length_970_cov_12.675086	587	667	6	32	80	0.4000000
NODE_7230_length_970_cov_12.675086	587	667	8	13	80	0.1625000
NODE_7231_length_970_cov_8.095293	487	567	3	80	80	1.0000000
NODE_7231_length_970_cov_8.095293	540	620	0	22	80	0.2750000
NODE_7231_length_970_cov_8.095293	540	620	1	3	80	0.0375000
NODE_7231_length_970_cov_8.095293	540	620	2	17	80	0.2125000
NODE_7231_length_970_cov_8.095293	540	620	3	38	80	0.4750000
NODE_7233_length_970_cov_7.127440	336	416	1	26	80	0.3250000
NODE_7233_length_970_cov_7.127440	336	416	2	54	80	0.6750000
NODE_7233_length_970_cov_7.127440	389	469	0	7	80	0.0875000
NODE_7233_length_970_cov_7.127440	389	469	1	72	80	0.9000000
NODE_7233_length_970_cov_7.127440	389	469	2	1	80	0.0125000
NODE_7234_length_970_cov_5.824340	0	56	0	56	56	1.0000000
NODE_7246_length_969_cov_47.172414	419	499	1	17	80	0.2125000
NODE_7246_length_969_cov_47.172414	419	499	2	13	80	0.1625000
NODE_7246_length_969_cov_47.172414	419	499	3	1	80	0.0125000
NODE_7246_length_969_cov_47.172414	419	499	4	49	80	0.6125000
NODE_7246_length_969_cov_47.172414	472	552	2	25	80	0.3125000
NODE_7246_length_969_cov_47.172414	472	552	3	29	80	0.3625000
NODE_7246_length_969_cov_47.172414	472	552	4	26	80	0.3250000
NODE_7247_length_969_cov_28.234483	327	407	7	33	80	0.4125000
NODE_7247_length_969_cov_28.234483	327	407	8	27	80	0.3375000
NODE_7247_length_969_cov_28.234483	327	407	9	20	80	0.2500000
NODE_7247_length_969_cov_28.234483	380	460	6	6	80	0.0750000
NODE_7247_length_969_cov_28.234483	380	460	7	32	80	0.4000000
NODE_7247_length_969_cov_28.234483	380	460	8	40	80	0.5000000
NODE_7247_length_969_cov_28.234483	380	460	9	2	80	0.0250000
NODE_7248_length_969_cov_27.131034	392	472	1	1	80	0.0125000
NODE_7248_length_969_cov_27.131034	392	472	3	2	80	0.0250000
NODE_7248_length_969_cov_27.131034	392	472	4	13	80	0.1625000
NODE_7248_length_969_cov_27.131034	392	472	5	64	80	0.8000000
NODE_7248_length_969_cov_27.131034	445	525	1	54	80	0.6750000
NODE_7248_length_969_cov_27.131034	445	525	3	2	80	0.0250000
NODE_7248_length_969_cov_27.131034	445	525	4	13	80	0.1625000
NODE_7248_length_969_cov_27.131034	445	525	5	11	80	0.1375000
NODE_7249_length_969_cov_26.345977	466	542	1	46	76	0.6052632
NODE_7249_length_969_cov_26.345977	466	542	2	30	76	0.3947369
NODE_7249_length_969_cov_26.345977	515	595	2	36	80	0.4500000
NODE_7249_length_969_cov_26.345977	515	595	3	44	80	0.5500000
NODE_7250_length_969_cov_18.954023	274	354	4	13	80	0.1625000
NODE_7250_length_969_cov_18.954023	274	354	6	21	80	0.2625000
NODE_7250_length_969_cov_18.954023	274	354	7	46	80	0.5750000
NODE_7250_length_969_cov_18.954023	327	407	5	19	80	0.2375000
NODE_7250_length_969_cov_18.954023	327	407	7	61	80	0.7625000
NODE_7251_length_969_cov_17.952874	410	490	6	5	80	0.0625000
NODE_7251_length_969_cov_17.952874	410	490	8	19	80	0.2375000
NODE_7251_length_969_cov_17.952874	410	490	9	56	80	0.7000000
NODE_7251_length_969_cov_17.952874	463	543	5	15	80	0.1875000
NODE_7251_length_969_cov_17.952874	463	543	7	33	80	0.4125000
NODE_7251_length_969_cov_17.952874	463	543	9	32	80	0.4000000
NODE_7251_length_969_cov_17.952874	693	773	2	9	80	0.1125000
NODE_7251_length_969_cov_17.952874	693	773	4	17	80	0.2125000
NODE_7251_length_969_cov_17.952874	693	773	6	54	80	0.6750000
NODE_7251_length_969_cov_17.952874	746	826	2	16	80	0.2000000
NODE_7251_length_969_cov_17.952874	746	826	4	6	80	0.0750000
NODE_7251_length_969_cov_17.952874	746	826	6	58	80	0.7250000
NODE_7252_length_969_cov_15.942529	446	526	1	32	80	0.4000000
NODE_7252_length_969_cov_15.942529	446	526	3	48	80	0.6000000
NODE_7252_length_969_cov_15.942529	499	579	3	32	80	0.4000000
NODE_7252_length_969_cov_15.942529	499	579	4	41	80	0.5125000
NODE_7252_length_969_cov_15.942529	499	579	5	7	80	0.0875000
NODE_7253_length_969_cov_9.926437	573	653	0	20	80	0.2500000
NODE_7253_length_969_cov_9.926437	573	653	1	45	80	0.5625000
NODE_7253_length_969_cov_9.926437	573	653	2	15	80	0.1875000
NODE_7253_length_969_cov_9.926437	626	706	1	12	80	0.1500000
NODE_7253_length_969_cov_9.926437	626	706	2	68	80	0.8500000
NODE_7265_length_968_cov_59.162255	376	456	10	18	80	0.2250000
NODE_7265_length_968_cov_59.162255	376	456	11	5	80	0.0625000
NODE_7265_length_968_cov_59.162255	376	456	12	32	80	0.4000000
NODE_7265_length_968_cov_59.162255	376	456	13	25	80	0.3125000
NODE_7265_length_968_cov_59.162255	429	509	5	6	80	0.0750000
NODE_7265_length_968_cov_59.162255	429	509	6	10	80	0.1250000
NODE_7265_length_968_cov_59.162255	429	509	7	2	80	0.0250000
NODE_7265_length_968_cov_59.162255	429	509	8	21	80	0.2625000
NODE_7265_length_968_cov_59.162255	429	509	9	6	80	0.0750000
NODE_7265_length_968_cov_59.162255	429	509	10	26	80	0.3250000
NODE_7265_length_968_cov_59.162255	429	509	11	3	80	0.0375000
NODE_7265_length_968_cov_59.162255	429	509	12	4	80	0.0500000
NODE_7265_length_968_cov_59.162255	429	509	13	2	80	0.0250000
NODE_7265_length_968_cov_59.162255	505	585	5	16	80	0.2000000
NODE_7265_length_968_cov_59.162255	505	585	6	50	80	0.6250000
NODE_7265_length_968_cov_59.162255	505	585	7	14	80	0.1750000
NODE_7265_length_968_cov_59.162255	558	638	4	16	80	0.2000000
NODE_7265_length_968_cov_59.162255	558	638	5	17	80	0.2125000
NODE_7265_length_968_cov_59.162255	558	638	6	47	80	0.5875000
NODE_7266_length_968_cov_40.005754	514	594	3	62	80	0.7750000
NODE_7266_length_968_cov_40.005754	514	594	4	18	80	0.2250000
NODE_7266_length_968_cov_40.005754	567	647	0	38	80	0.4750000
NODE_7266_length_968_cov_40.005754	567	647	1	4	80	0.0500000
NODE_7266_length_968_cov_40.005754	567	647	2	1	80	0.0125000
NODE_7266_length_968_cov_40.005754	567	647	3	37	80	0.4625000
NODE_7267_length_968_cov_36.521289	450	530	8	19	80	0.2375000
NODE_7267_length_968_cov_36.521289	450	530	9	3	80	0.0375000
NODE_7267_length_968_cov_36.521289	450	530	11	5	80	0.0625000
NODE_7267_length_968_cov_36.521289	450	530	12	11	80	0.1375000
NODE_7267_length_968_cov_36.521289	450	530	13	22	80	0.2750000
NODE_7267_length_968_cov_36.521289	450	530	14	5	80	0.0625000
NODE_7267_length_968_cov_36.521289	450	530	15	15	80	0.1875000
NODE_7267_length_968_cov_36.521289	503	583	9	5	80	0.0625000
NODE_7267_length_968_cov_36.521289	503	583	10	3	80	0.0375000
NODE_7267_length_968_cov_36.521289	503	583	11	5	80	0.0625000
NODE_7267_length_968_cov_36.521289	503	583	12	33	80	0.4125000
NODE_7267_length_968_cov_36.521289	503	583	13	15	80	0.1875000
NODE_7267_length_968_cov_36.521289	503	583	15	19	80	0.2375000
NODE_7268_length_968_cov_34.799770	474	554	12	9	80	0.1125000
NODE_7268_length_968_cov_34.799770	474	554	13	12	80	0.1500000
NODE_7268_length_968_cov_34.799770	474	554	14	6	80	0.0750000
NODE_7268_length_968_cov_34.799770	474	554	16	17	80	0.2125000
NODE_7268_length_968_cov_34.799770	474	554	17	3	80	0.0375000
NODE_7268_length_968_cov_34.799770	474	554	18	32	80	0.4000000
NODE_7268_length_968_cov_34.799770	474	554	19	1	80	0.0125000
NODE_7268_length_968_cov_34.799770	527	607	12	15	80	0.1875000
NODE_7268_length_968_cov_34.799770	527	607	13	41	80	0.5125000
NODE_7268_length_968_cov_34.799770	527	607	14	2	80	0.0250000
NODE_7268_length_968_cov_34.799770	527	607	16	6	80	0.0750000
NODE_7268_length_968_cov_34.799770	527	607	18	16	80	0.2000000
NODE_7269_length_968_cov_26.929804	293	372	0	79	79	1.0000000
NODE_7269_length_968_cov_26.929804	345	425	0	40	80	0.5000000
NODE_7269_length_968_cov_26.929804	345	425	1	40	80	0.5000000
NODE_7269_length_968_cov_26.929804	421	501	1	12	80	0.1500000
NODE_7269_length_968_cov_26.929804	421	501	3	21	80	0.2625000
NODE_7269_length_968_cov_26.929804	421	501	4	37	80	0.4625000
NODE_7269_length_968_cov_26.929804	421	501	5	5	80	0.0625000
NODE_7269_length_968_cov_26.929804	421	501	6	5	80	0.0625000
NODE_7269_length_968_cov_26.929804	474	554	3	18	80	0.2250000
NODE_7269_length_968_cov_26.929804	474	554	4	17	80	0.2125000
NODE_7269_length_968_cov_26.929804	474	554	5	6	80	0.0750000
NODE_7269_length_968_cov_26.929804	474	554	6	39	80	0.4875000
NODE_7270_length_968_cov_24.468354	434	514	5	3	80	0.0375000
NODE_7270_length_968_cov_24.468354	434	514	6	25	80	0.3125000
NODE_7270_length_968_cov_24.468354	434	514	7	32	80	0.4000000
NODE_7270_length_968_cov_24.468354	434	514	8	20	80	0.2500000
NODE_7270_length_968_cov_24.468354	487	567	4	11	80	0.1375000
NODE_7270_length_968_cov_24.468354	487	567	5	3	80	0.0375000
NODE_7270_length_968_cov_24.468354	487	567	6	6	80	0.0750000
NODE_7270_length_968_cov_24.468354	487	567	7	60	80	0.7500000
NODE_7271_length_968_cov_23.204833	344	424	5	12	80	0.1500000
NODE_7271_length_968_cov_23.204833	344	424	6	6	80	0.0750000
NODE_7271_length_968_cov_23.204833	344	424	7	4	80	0.0500000
NODE_7271_length_968_cov_23.204833	344	424	8	58	80	0.7250000
NODE_7271_length_968_cov_23.204833	397	477	6	14	80	0.1750000
NODE_7271_length_968_cov_23.204833	397	477	7	19	80	0.2375000
NODE_7271_length_968_cov_23.204833	397	477	8	47	80	0.5875000
NODE_7271_length_968_cov_23.204833	473	553	2	4	80	0.0500000
NODE_7271_length_968_cov_23.204833	473	553	3	42	80	0.5250000
NODE_7271_length_968_cov_23.204833	473	553	4	20	80	0.2500000
NODE_7271_length_968_cov_23.204833	473	553	5	6	80	0.0750000
NODE_7271_length_968_cov_23.204833	473	553	6	8	80	0.1000000
NODE_7271_length_968_cov_23.204833	526	606	3	46	80	0.5750000
NODE_7271_length_968_cov_23.204833	526	606	4	34	80	0.4250000
NODE_7272_length_968_cov_22.321059	417	497	4	3	80	0.0375000
NODE_7272_length_968_cov_22.321059	417	497	5	23	80	0.2875000
NODE_7272_length_968_cov_22.321059	417	497	6	12	80	0.1500000
NODE_7272_length_968_cov_22.321059	417	497	9	8	80	0.1000000
NODE_7272_length_968_cov_22.321059	417	497	11	15	80	0.1875000
NODE_7272_length_968_cov_22.321059	417	497	12	4	80	0.0500000
NODE_7272_length_968_cov_22.321059	417	497	13	2	80	0.0250000
NODE_7272_length_968_cov_22.321059	417	497	15	13	80	0.1625000
NODE_7272_length_968_cov_22.321059	470	550	11	8	80	0.1000000
NODE_7272_length_968_cov_22.321059	470	550	12	5	80	0.0625000
NODE_7272_length_968_cov_22.321059	470	550	13	13	80	0.1625000
NODE_7272_length_968_cov_22.321059	470	550	14	7	80	0.0875000
NODE_7272_length_968_cov_22.321059	470	550	15	47	80	0.5875000
NODE_7273_length_968_cov_20.897583	313	393	1	24	80	0.3000000
NODE_7273_length_968_cov_20.897583	313	393	3	56	80	0.7000000
NODE_7273_length_968_cov_20.897583	366	446	3	43	80	0.5375000
NODE_7273_length_968_cov_20.897583	366	446	4	37	80	0.4625000
NODE_7274_length_968_cov_19.296893	401	481	7	10	80	0.1250000
NODE_7274_length_968_cov_19.296893	401	481	8	5	80	0.0625000
NODE_7274_length_968_cov_19.296893	401	481	9	20	80	0.2500000
NODE_7274_length_968_cov_19.296893	401	481	11	3	80	0.0375000
NODE_7274_length_968_cov_19.296893	401	481	12	17	80	0.2125000
NODE_7274_length_968_cov_19.296893	401	481	13	18	80	0.2250000
NODE_7274_length_968_cov_19.296893	401	481	14	3	80	0.0375000
NODE_7274_length_968_cov_19.296893	401	481	15	4	80	0.0500000
NODE_7274_length_968_cov_19.296893	454	534	11	27	80	0.3375000
NODE_7274_length_968_cov_19.296893	454	534	12	10	80	0.1250000
NODE_7274_length_968_cov_19.296893	454	534	13	20	80	0.2500000
NODE_7274_length_968_cov_19.296893	454	534	14	16	80	0.2000000
NODE_7274_length_968_cov_19.296893	454	534	15	4	80	0.0500000
NODE_7274_length_968_cov_19.296893	454	534	16	3	80	0.0375000
NODE_7275_length_968_cov_18.100115	573	653	6	21	80	0.2625000
NODE_7275_length_968_cov_18.100115	573	653	7	30	80	0.3750000
NODE_7275_length_968_cov_18.100115	573	653	8	29	80	0.3625000
NODE_7275_length_968_cov_18.100115	626	706	5	8	80	0.1000000
NODE_7275_length_968_cov_18.100115	626	706	6	38	80	0.4750000
NODE_7275_length_968_cov_18.100115	626	706	7	2	80	0.0250000
NODE_7275_length_968_cov_18.100115	626	706	8	32	80	0.4000000
NODE_7276_length_968_cov_15.576525	472	552	1	21	80	0.2625000
NODE_7276_length_968_cov_15.576525	472	552	3	11	80	0.1375000
NODE_7276_length_968_cov_15.576525	472	552	4	48	80	0.6000000
NODE_7276_length_968_cov_15.576525	525	605	3	7	80	0.0875000
NODE_7276_length_968_cov_15.576525	525	605	4	51	80	0.6375000
NODE_7276_length_968_cov_15.576525	525	605	5	22	80	0.2750000
NODE_7277_length_968_cov_15.024166	329	409	3	36	80	0.4500000
NODE_7277_length_968_cov_15.024166	329	409	4	44	80	0.5500000
NODE_7277_length_968_cov_15.024166	382	462	3	2	80	0.0250000
NODE_7277_length_968_cov_15.024166	382	462	4	37	80	0.4625000
NODE_7277_length_968_cov_15.024166	382	462	5	30	80	0.3750000
NODE_7277_length_968_cov_15.024166	382	462	6	11	80	0.1375000
NODE_7277_length_968_cov_15.024166	458	538	2	18	80	0.2250000
NODE_7277_length_968_cov_15.024166	458	538	3	20	80	0.2500000
NODE_7277_length_968_cov_15.024166	458	538	5	9	80	0.1125000
NODE_7277_length_968_cov_15.024166	458	538	7	33	80	0.4125000
NODE_7277_length_968_cov_15.024166	511	591	5	40	80	0.5000000
NODE_7277_length_968_cov_15.024166	511	591	7	40	80	0.5000000
NODE_7278_length_968_cov_13.911392	674	754	1	4	80	0.0500000
NODE_7278_length_968_cov_13.911392	674	754	3	12	80	0.1500000
NODE_7278_length_968_cov_13.911392	674	754	4	36	80	0.4500000
NODE_7278_length_968_cov_13.911392	674	754	5	19	80	0.2375000
NODE_7278_length_968_cov_13.911392	674	754	6	9	80	0.1125000
NODE_7278_length_968_cov_13.911392	727	807	3	18	80	0.2250000
NODE_7278_length_968_cov_13.911392	727	807	5	31	80	0.3875000
NODE_7278_length_968_cov_13.911392	727	807	6	31	80	0.3875000
NODE_7279_length_968_cov_11.698504	598	678	6	28	80	0.3500000
NODE_7279_length_968_cov_11.698504	598	678	8	52	80	0.6500000
NODE_7279_length_968_cov_11.698504	651	731	3	14	80	0.1750000
NODE_7279_length_968_cov_11.698504	651	731	4	12	80	0.1500000
NODE_7279_length_968_cov_11.698504	651	731	8	54	80	0.6750000
NODE_7280_length_968_cov_6.490219	538	618	0	80	80	1.0000000
NODE_7280_length_968_cov_6.490219	591	671	0	80	80	1.0000000
NODE_7294_length_967_cov_25.572581	332	412	2	6	80	0.0750000
NODE_7294_length_967_cov_25.572581	332	412	3	11	80	0.1375000
NODE_7294_length_967_cov_25.572581	332	412	5	5	80	0.0625000
NODE_7294_length_967_cov_25.572581	332	412	6	1	80	0.0125000
NODE_7294_length_967_cov_25.572581	332	412	8	25	80	0.3125000
NODE_7294_length_967_cov_25.572581	332	412	9	1	80	0.0125000
NODE_7294_length_967_cov_25.572581	332	412	10	16	80	0.2000000
NODE_7294_length_967_cov_25.572581	332	412	11	15	80	0.1875000
NODE_7294_length_967_cov_25.572581	385	465	8	7	80	0.0875000
NODE_7294_length_967_cov_25.572581	385	465	10	41	80	0.5125000
NODE_7294_length_967_cov_25.572581	385	465	11	32	80	0.4000000
NODE_7295_length_967_cov_24.919355	396	476	4	5	80	0.0625000
NODE_7295_length_967_cov_24.919355	396	476	5	15	80	0.1875000
NODE_7295_length_967_cov_24.919355	396	476	6	43	80	0.5375000
NODE_7295_length_967_cov_24.919355	396	476	8	17	80	0.2125000
NODE_7295_length_967_cov_24.919355	449	529	4	1	80	0.0125000
NODE_7295_length_967_cov_24.919355	449	529	5	7	80	0.0875000
NODE_7295_length_967_cov_24.919355	449	529	6	2	80	0.0250000
NODE_7295_length_967_cov_24.919355	449	529	7	16	80	0.2000000
NODE_7295_length_967_cov_24.919355	449	529	8	54	80	0.6750000
NODE_7296_length_967_cov_19.137097	374	454	4	28	80	0.3500000
NODE_7296_length_967_cov_19.137097	374	454	5	31	80	0.3875000
NODE_7296_length_967_cov_19.137097	374	454	6	21	80	0.2625000
NODE_7296_length_967_cov_19.137097	427	507	2	46	80	0.5750000
NODE_7296_length_967_cov_19.137097	427	507	4	34	80	0.4250000
NODE_7296_length_967_cov_19.137097	503	583	0	44	80	0.5500000
NODE_7296_length_967_cov_19.137097	503	583	1	27	80	0.3375000
NODE_7296_length_967_cov_19.137097	503	583	2	9	80	0.1125000
NODE_7296_length_967_cov_19.137097	556	636	0	80	80	1.0000000
NODE_7297_length_967_cov_14.654378	453	533	2	80	80	1.0000000
NODE_7297_length_967_cov_14.654378	506	586	0	9	80	0.1125000
NODE_7297_length_967_cov_14.654378	506	586	2	71	80	0.8875000
NODE_7298_length_967_cov_8.027650	280	360	0	4	80	0.0500000
NODE_7298_length_967_cov_8.027650	280	360	1	15	80	0.1875000
NODE_7298_length_967_cov_8.027650	280	360	2	2	80	0.0250000
NODE_7298_length_967_cov_8.027650	280	360	3	2	80	0.0250000
NODE_7298_length_967_cov_8.027650	280	360	4	1	80	0.0125000
NODE_7298_length_967_cov_8.027650	280	360	5	16	80	0.2000000
NODE_7298_length_967_cov_8.027650	280	360	7	14	80	0.1750000
NODE_7298_length_967_cov_8.027650	280	360	8	26	80	0.3250000
NODE_7298_length_967_cov_8.027650	333	413	7	1	80	0.0125000
NODE_7298_length_967_cov_8.027650	333	413	8	49	80	0.6125000
NODE_7298_length_967_cov_8.027650	333	413	9	30	80	0.3750000
NODE_7310_length_966_cov_43.154556	401	474	10	2	73	0.0273973
NODE_7310_length_966_cov_43.154556	401	474	11	6	73	0.0821918
NODE_7310_length_966_cov_43.154556	401	474	12	14	73	0.1917808
NODE_7310_length_966_cov_43.154556	401	474	13	5	73	0.0684932
NODE_7310_length_966_cov_43.154556	401	474	15	5	73	0.0684932
NODE_7310_length_966_cov_43.154556	401	474	17	6	73	0.0821918
NODE_7310_length_966_cov_43.154556	401	474	18	34	73	0.4657534
NODE_7310_length_966_cov_43.154556	401	474	19	1	73	0.0136986
NODE_7310_length_966_cov_43.154556	447	527	17	2	80	0.0250000
NODE_7310_length_966_cov_43.154556	447	527	18	28	80	0.3500000
NODE_7310_length_966_cov_43.154556	447	527	19	24	80	0.3000000
NODE_7310_length_966_cov_43.154556	447	527	20	6	80	0.0750000
NODE_7310_length_966_cov_43.154556	447	527	21	20	80	0.2500000
NODE_7311_length_966_cov_42.877739	477	557	4	2	80	0.0250000
NODE_7311_length_966_cov_42.877739	477	557	5	48	80	0.6000000
NODE_7311_length_966_cov_42.877739	477	557	6	30	80	0.3750000
NODE_7311_length_966_cov_42.877739	530	610	4	8	80	0.1000000
NODE_7311_length_966_cov_42.877739	530	610	5	29	80	0.3625000
NODE_7311_length_966_cov_42.877739	530	610	6	33	80	0.4125000
NODE_7311_length_966_cov_42.877739	530	610	7	10	80	0.1250000
NODE_7312_length_966_cov_39.956171	283	363	1	10	80	0.1250000
NODE_7312_length_966_cov_39.956171	283	363	2	28	80	0.3500000
NODE_7312_length_966_cov_39.956171	283	363	3	36	80	0.4500000
NODE_7312_length_966_cov_39.956171	283	363	4	6	80	0.0750000
NODE_7312_length_966_cov_39.956171	336	416	3	21	80	0.2625000
NODE_7312_length_966_cov_39.956171	336	416	4	19	80	0.2375000
NODE_7312_length_966_cov_39.956171	336	416	5	21	80	0.2625000
NODE_7312_length_966_cov_39.956171	336	416	6	19	80	0.2375000
NODE_7312_length_966_cov_39.956171	412	494	5	14	82	0.1707317
NODE_7312_length_966_cov_39.956171	412	494	6	49	82	0.5975610
NODE_7312_length_966_cov_39.956171	412	494	7	19	82	0.2317073
NODE_7312_length_966_cov_39.956171	467	547	5	18	80	0.2250000
NODE_7312_length_966_cov_39.956171	467	547	6	29	80	0.3625000
NODE_7312_length_966_cov_39.956171	467	547	7	33	80	0.4125000
NODE_7313_length_966_cov_36.160323	461	541	8	6	80	0.0750000
NODE_7313_length_966_cov_36.160323	461	541	9	2	80	0.0250000
NODE_7313_length_966_cov_36.160323	461	541	11	8	80	0.1000000
NODE_7313_length_966_cov_36.160323	461	541	12	1	80	0.0125000
NODE_7313_length_966_cov_36.160323	461	541	13	4	80	0.0500000
NODE_7313_length_966_cov_36.160323	461	541	15	7	80	0.0875000
NODE_7313_length_966_cov_36.160323	461	541	16	52	80	0.6500000
NODE_7313_length_966_cov_36.160323	461	541	8	6	80	0.0750000
NODE_7313_length_966_cov_36.160323	461	541	9	2	80	0.0250000
NODE_7313_length_966_cov_36.160323	461	541	11	8	80	0.1000000
NODE_7313_length_966_cov_36.160323	461	541	12	1	80	0.0125000
NODE_7313_length_966_cov_36.160323	461	541	13	4	80	0.0500000
NODE_7313_length_966_cov_36.160323	461	541	15	7	80	0.0875000
NODE_7313_length_966_cov_36.160323	461	541	16	52	80	0.6500000
NODE_7313_length_966_cov_36.160323	514	594	6	3	80	0.0375000
NODE_7313_length_966_cov_36.160323	514	594	7	10	80	0.1250000
NODE_7313_length_966_cov_36.160323	514	594	9	1	80	0.0125000
NODE_7313_length_966_cov_36.160323	514	594	11	13	80	0.1625000
NODE_7313_length_966_cov_36.160323	514	594	13	11	80	0.1375000
NODE_7313_length_966_cov_36.160323	514	594	15	7	80	0.0875000
NODE_7313_length_966_cov_36.160323	514	594	16	35	80	0.4375000
NODE_7314_length_966_cov_18.658593	408	488	4	10	80	0.1250000
NODE_7314_length_966_cov_18.658593	408	488	5	26	80	0.3250000
NODE_7314_length_966_cov_18.658593	408	488	6	44	80	0.5500000
NODE_7314_length_966_cov_18.658593	461	541	4	6	80	0.0750000
NODE_7314_length_966_cov_18.658593	461	541	5	44	80	0.5500000
NODE_7314_length_966_cov_18.658593	461	541	6	30	80	0.3750000
NODE_7315_length_966_cov_17.606690	341	421	0	80	80	1.0000000
NODE_7315_length_966_cov_17.606690	394	474	0	80	80	1.0000000
NODE_7316_length_966_cov_16.064591	296	376	5	4	80	0.0500000
NODE_7316_length_966_cov_16.064591	296	376	7	41	80	0.5125000
NODE_7316_length_966_cov_16.064591	296	376	8	34	80	0.4250000
NODE_7316_length_966_cov_16.064591	296	376	9	1	80	0.0125000
NODE_7316_length_966_cov_16.064591	349	429	4	4	80	0.0500000
NODE_7316_length_966_cov_16.064591	349	429	5	2	80	0.0250000
NODE_7316_length_966_cov_16.064591	349	429	7	22	80	0.2750000
NODE_7316_length_966_cov_16.064591	349	429	8	27	80	0.3375000
NODE_7316_length_966_cov_16.064591	349	429	9	1	80	0.0125000
NODE_7316_length_966_cov_16.064591	349	429	10	18	80	0.2250000
NODE_7316_length_966_cov_16.064591	349	429	11	6	80	0.0750000
NODE_7317_length_966_cov_15.155709	562	642	2	4	80	0.0500000
NODE_7317_length_966_cov_15.155709	562	642	3	34	80	0.4250000
NODE_7317_length_966_cov_15.155709	562	642	4	23	80	0.2875000
NODE_7317_length_966_cov_15.155709	562	642	5	19	80	0.2375000
NODE_7317_length_966_cov_15.155709	615	695	4	61	80	0.7625000
NODE_7317_length_966_cov_15.155709	615	695	5	19	80	0.2375000
NODE_7318_length_966_cov_7.726644	280	360	1	11	80	0.1375000
NODE_7318_length_966_cov_7.726644	280	360	3	18	80	0.2250000
NODE_7318_length_966_cov_7.726644	280	360	4	7	80	0.0875000
NODE_7318_length_966_cov_7.726644	280	360	6	9	80	0.1125000
NODE_7318_length_966_cov_7.726644	280	360	7	35	80	0.4375000
NODE_7318_length_966_cov_7.726644	334	414	4	3	80	0.0375000
NODE_7318_length_966_cov_7.726644	334	414	5	20	80	0.2500000
NODE_7318_length_966_cov_7.726644	334	414	7	57	80	0.7125000
NODE_7335_length_965_cov_51.524249	197	277	2	9	80	0.1125000
NODE_7335_length_965_cov_51.524249	197	277	3	9	80	0.1125000
NODE_7335_length_965_cov_51.524249	197	277	5	26	80	0.3250000
NODE_7335_length_965_cov_51.524249	197	277	6	20	80	0.2500000
NODE_7335_length_965_cov_51.524249	197	277	7	8	80	0.1000000
NODE_7335_length_965_cov_51.524249	197	277	8	8	80	0.1000000
NODE_7335_length_965_cov_51.524249	250	327	6	11	77	0.1428571
NODE_7335_length_965_cov_51.524249	250	327	7	9	77	0.1168831
NODE_7335_length_965_cov_51.524249	250	327	8	39	77	0.5064935
NODE_7335_length_965_cov_51.524249	250	327	9	18	77	0.2337662
NODE_7335_length_965_cov_51.524249	329	406	9	9	77	0.1168831
NODE_7335_length_965_cov_51.524249	329	406	10	23	77	0.2987013
NODE_7335_length_965_cov_51.524249	329	406	11	30	77	0.3896104
NODE_7335_length_965_cov_51.524249	329	406	12	15	77	0.1948052
NODE_7335_length_965_cov_51.524249	379	459	9	1	80	0.0125000
NODE_7335_length_965_cov_51.524249	379	459	10	46	80	0.5750000
NODE_7335_length_965_cov_51.524249	379	459	11	23	80	0.2875000
NODE_7335_length_965_cov_51.524249	379	459	12	10	80	0.1250000
NODE_7336_length_965_cov_18.072748	515	595	7	20	80	0.2500000
NODE_7336_length_965_cov_18.072748	515	595	8	40	80	0.5000000
NODE_7336_length_965_cov_18.072748	515	595	9	20	80	0.2500000
NODE_7336_length_965_cov_18.072748	568	648	6	24	80	0.3000000
NODE_7336_length_965_cov_18.072748	568	648	7	35	80	0.4375000
NODE_7336_length_965_cov_18.072748	568	648	8	14	80	0.1750000
NODE_7336_length_965_cov_18.072748	568	648	9	7	80	0.0875000
NODE_7337_length_965_cov_14.277136	342	422	6	17	80	0.2125000
NODE_7337_length_965_cov_14.277136	342	422	7	8	80	0.1000000
NODE_7337_length_965_cov_14.277136	342	422	8	54	80	0.6750000
NODE_7337_length_965_cov_14.277136	342	422	9	1	80	0.0125000
NODE_7337_length_965_cov_14.277136	395	470	3	4	75	0.0533333
NODE_7337_length_965_cov_14.277136	395	470	4	5	75	0.0666667
NODE_7337_length_965_cov_14.277136	395	470	5	34	75	0.4533333
NODE_7337_length_965_cov_14.277136	395	470	6	10	75	0.1333333
NODE_7337_length_965_cov_14.277136	395	470	8	22	75	0.2933333
NODE_7338_length_965_cov_7.808314	567	647	6	30	80	0.3750000
NODE_7338_length_965_cov_7.808314	567	647	7	50	80	0.6250000
NODE_7338_length_965_cov_7.808314	620	700	3	10	80	0.1250000
NODE_7338_length_965_cov_7.808314	620	700	4	11	80	0.1375000
NODE_7338_length_965_cov_7.808314	620	700	5	2	80	0.0250000
NODE_7338_length_965_cov_7.808314	620	700	6	8	80	0.1000000
NODE_7338_length_965_cov_7.808314	620	700	7	49	80	0.6125000
NODE_7344_length_964_cov_60.153757	197	277	3	8	80	0.1000000
NODE_7344_length_964_cov_60.153757	197	277	4	5	80	0.0625000
NODE_7344_length_964_cov_60.153757	197	277	5	18	80	0.2250000
NODE_7344_length_964_cov_60.153757	197	277	6	7	80	0.0875000
NODE_7344_length_964_cov_60.153757	197	277	9	2	80	0.0250000
NODE_7344_length_964_cov_60.153757	197	277	10	1	80	0.0125000
NODE_7344_length_964_cov_60.153757	197	277	11	7	80	0.0875000
NODE_7344_length_964_cov_60.153757	197	277	14	15	80	0.1875000
NODE_7344_length_964_cov_60.153757	197	277	15	1	80	0.0125000
NODE_7344_length_964_cov_60.153757	197	277	18	1	80	0.0125000
NODE_7344_length_964_cov_60.153757	197	277	20	2	80	0.0250000
NODE_7344_length_964_cov_60.153757	197	277	21	12	80	0.1500000
NODE_7344_length_964_cov_60.153757	197	277	22	1	80	0.0125000
NODE_7344_length_964_cov_60.153757	250	314	3	45	64	0.7031250
NODE_7344_length_964_cov_60.153757	250	314	4	5	64	0.0781250
NODE_7344_length_964_cov_60.153757	250	314	5	14	64	0.2187500
NODE_7344_length_964_cov_60.153757	672	752	0	72	80	0.9000000
NODE_7344_length_964_cov_60.153757	672	752	1	8	80	0.1000000
NODE_7344_length_964_cov_60.153757	725	805	0	80	80	1.0000000
NODE_7345_length_964_cov_45.564162	314	394	9	4	80	0.0500000
NODE_7345_length_964_cov_45.564162	314	394	11	20	80	0.2500000
NODE_7345_length_964_cov_45.564162	314	394	12	14	80	0.1750000
NODE_7345_length_964_cov_45.564162	314	394	14	19	80	0.2375000
NODE_7345_length_964_cov_45.564162	314	394	15	19	80	0.2375000
NODE_7345_length_964_cov_45.564162	314	394	16	4	80	0.0500000
NODE_7345_length_964_cov_45.564162	367	447	14	10	80	0.1250000
NODE_7345_length_964_cov_45.564162	367	447	15	41	80	0.5125000
NODE_7345_length_964_cov_45.564162	367	447	16	25	80	0.3125000
NODE_7345_length_964_cov_45.564162	367	447	17	4	80	0.0500000
NODE_7345_length_964_cov_45.564162	443	523	9	18	80	0.2250000
NODE_7345_length_964_cov_45.564162	443	523	10	38	80	0.4750000
NODE_7345_length_964_cov_45.564162	443	523	11	1	80	0.0125000
NODE_7345_length_964_cov_45.564162	443	523	12	1	80	0.0125000
NODE_7345_length_964_cov_45.564162	443	523	13	3	80	0.0375000
NODE_7345_length_964_cov_45.564162	443	523	14	4	80	0.0500000
NODE_7345_length_964_cov_45.564162	443	523	15	5	80	0.0625000
NODE_7345_length_964_cov_45.564162	443	523	16	5	80	0.0625000
NODE_7345_length_964_cov_45.564162	443	523	17	4	80	0.0500000
NODE_7345_length_964_cov_45.564162	443	523	18	1	80	0.0125000
NODE_7345_length_964_cov_45.564162	496	566	5	5	70	0.0714286
NODE_7345_length_964_cov_45.564162	496	566	8	3	70	0.0428571
NODE_7345_length_964_cov_45.564162	496	566	9	51	70	0.7285714
NODE_7345_length_964_cov_45.564162	496	566	10	11	70	0.1571429
NODE_7346_length_964_cov_33.487861	363	443	13	4	80	0.0500000
NODE_7346_length_964_cov_33.487861	363	443	14	7	80	0.0875000
NODE_7346_length_964_cov_33.487861	363	443	16	1	80	0.0125000
NODE_7346_length_964_cov_33.487861	363	443	17	6	80	0.0750000
NODE_7346_length_964_cov_33.487861	363	443	19	27	80	0.3375000
NODE_7346_length_964_cov_33.487861	363	443	20	8	80	0.1000000
NODE_7346_length_964_cov_33.487861	363	443	21	27	80	0.3375000
NODE_7346_length_964_cov_33.487861	416	496	17	6	80	0.0750000
NODE_7346_length_964_cov_33.487861	416	496	18	20	80	0.2500000
NODE_7346_length_964_cov_33.487861	416	496	19	17	80	0.2125000
NODE_7346_length_964_cov_33.487861	416	496	20	32	80	0.4000000
NODE_7346_length_964_cov_33.487861	416	496	21	4	80	0.0500000
NODE_7346_length_964_cov_33.487861	416	496	22	1	80	0.0125000
NODE_7347_length_964_cov_33.077457	408	488	0	80	80	1.0000000
NODE_7347_length_964_cov_33.077457	461	541	0	80	80	1.0000000
NODE_7347_length_964_cov_33.077457	537	617	0	22	80	0.2750000
NODE_7347_length_964_cov_33.077457	537	617	1	58	80	0.7250000
NODE_7347_length_964_cov_33.077457	590	670	1	80	80	1.0000000
NODE_7348_length_964_cov_29.250867	419	499	6	46	80	0.5750000
NODE_7348_length_964_cov_29.250867	419	499	7	1	80	0.0125000
NODE_7348_length_964_cov_29.250867	419	499	8	17	80	0.2125000
NODE_7348_length_964_cov_29.250867	419	499	9	10	80	0.1250000
NODE_7348_length_964_cov_29.250867	419	499	10	6	80	0.0750000
NODE_7348_length_964_cov_29.250867	472	552	4	15	80	0.1875000
NODE_7348_length_964_cov_29.250867	472	552	6	3	80	0.0375000
NODE_7348_length_964_cov_29.250867	472	552	8	39	80	0.4875000
NODE_7348_length_964_cov_29.250867	472	552	9	10	80	0.1250000
NODE_7348_length_964_cov_29.250867	472	552	10	13	80	0.1625000
NODE_7349_length_964_cov_20.191908	228	301	0	10	73	0.1369863
NODE_7349_length_964_cov_20.191908	228	301	2	63	73	0.8630137
NODE_7349_length_964_cov_20.191908	349	429	0	80	80	1.0000000
NODE_7349_length_964_cov_20.191908	402	482	0	80	80	1.0000000
NODE_7350_length_964_cov_18.510983	486	566	5	31	80	0.3875000
NODE_7350_length_964_cov_18.510983	486	566	6	9	80	0.1125000
NODE_7350_length_964_cov_18.510983	486	566	7	40	80	0.5000000
NODE_7350_length_964_cov_18.510983	539	619	3	37	80	0.4625000
NODE_7350_length_964_cov_18.510983	539	619	4	6	80	0.0750000
NODE_7350_length_964_cov_18.510983	539	619	5	18	80	0.2250000
NODE_7350_length_964_cov_18.510983	539	619	7	19	80	0.2375000
NODE_7351_length_964_cov_16.613873	464	544	0	35	80	0.4375000
NODE_7351_length_964_cov_16.613873	464	544	1	45	80	0.5625000
NODE_7351_length_964_cov_16.613873	517	597	0	45	80	0.5625000
NODE_7351_length_964_cov_16.613873	517	597	1	35	80	0.4375000
NODE_7352_length_964_cov_15.717919	411	491	5	7	80	0.0875000
NODE_7352_length_964_cov_15.717919	411	491	6	11	80	0.1375000
NODE_7352_length_964_cov_15.717919	411	491	7	62	80	0.7750000
NODE_7352_length_964_cov_15.717919	464	544	2	16	80	0.2000000
NODE_7352_length_964_cov_15.717919	464	544	4	9	80	0.1125000
NODE_7352_length_964_cov_15.717919	464	544	5	19	80	0.2375000
NODE_7352_length_964_cov_15.717919	464	544	6	27	80	0.3375000
NODE_7352_length_964_cov_15.717919	464	544	7	9	80	0.1125000
NODE_7352_length_964_cov_15.717919	540	620	2	80	80	1.0000000
NODE_7352_length_964_cov_15.717919	593	668	1	4	75	0.0533333
NODE_7352_length_964_cov_15.717919	593	668	2	50	75	0.6666667
NODE_7352_length_964_cov_15.717919	593	668	3	21	75	0.2800000
NODE_7353_length_964_cov_14.591908	521	601	2	16	80	0.2000000
NODE_7353_length_964_cov_14.591908	521	601	4	15	80	0.1875000
NODE_7353_length_964_cov_14.591908	521	601	5	14	80	0.1750000
NODE_7353_length_964_cov_14.591908	521	601	6	14	80	0.1750000
NODE_7353_length_964_cov_14.591908	521	601	7	21	80	0.2625000
NODE_7353_length_964_cov_14.591908	574	654	5	6	80	0.0750000
NODE_7353_length_964_cov_14.591908	574	654	6	29	80	0.3625000
NODE_7353_length_964_cov_14.591908	574	654	7	45	80	0.5625000
NODE_7354_length_964_cov_11.589595	475	555	2	14	80	0.1750000
NODE_7354_length_964_cov_11.589595	475	555	4	66	80	0.8250000
NODE_7354_length_964_cov_11.589595	528	608	1	10	80	0.1250000
NODE_7354_length_964_cov_11.589595	528	608	3	6	80	0.0750000
NODE_7354_length_964_cov_11.589595	528	608	4	64	80	0.8000000
NODE_7355_length_964_cov_7.639306	420	500	1	80	80	1.0000000
NODE_7355_length_964_cov_7.639306	473	553	1	80	80	1.0000000
NODE_7356_length_964_cov_7.596532	534	614	1	14	80	0.1750000
NODE_7356_length_964_cov_7.596532	534	614	2	48	80	0.6000000
NODE_7356_length_964_cov_7.596532	534	614	3	18	80	0.2250000
NODE_7356_length_964_cov_7.596532	587	667	1	7	80	0.0875000
NODE_7356_length_964_cov_7.596532	587	667	2	2	80	0.0250000
NODE_7356_length_964_cov_7.596532	587	667	3	51	80	0.6375000
NODE_7356_length_964_cov_7.596532	587	667	4	20	80	0.2500000
NODE_7357_length_964_cov_6.568786	368	448	2	5	80	0.0625000
NODE_7357_length_964_cov_6.568786	368	448	4	36	80	0.4500000
NODE_7357_length_964_cov_6.568786	368	448	5	18	80	0.2250000
NODE_7357_length_964_cov_6.568786	368	448	6	21	80	0.2625000
NODE_7357_length_964_cov_6.568786	421	501	3	5	80	0.0625000
NODE_7357_length_964_cov_6.568786	421	501	5	66	80	0.8250000
NODE_7357_length_964_cov_6.568786	421	501	6	9	80	0.1125000
NODE_7359_length_964_cov_6.027746	890	940	7	22	50	0.4400000
NODE_7359_length_964_cov_6.027746	890	940	8	28	50	0.5600000
NODE_7361_length_964_cov_4.665896	706	772	0	41	66	0.6212121
NODE_7361_length_964_cov_4.665896	706	772	1	25	66	0.3787879
NODE_7376_length_963_cov_66.251157	456	536	8	5	80	0.0625000
NODE_7376_length_963_cov_66.251157	456	536	9	3	80	0.0375000
NODE_7376_length_963_cov_66.251157	456	536	10	4	80	0.0500000
NODE_7376_length_963_cov_66.251157	456	536	11	3	80	0.0375000
NODE_7376_length_963_cov_66.251157	456	536	12	1	80	0.0125000
NODE_7376_length_963_cov_66.251157	456	536	13	1	80	0.0125000
NODE_7376_length_963_cov_66.251157	456	536	14	4	80	0.0500000
NODE_7376_length_963_cov_66.251157	456	536	16	6	80	0.0750000
NODE_7376_length_963_cov_66.251157	456	536	17	1	80	0.0125000
NODE_7376_length_963_cov_66.251157	456	536	20	9	80	0.1125000
NODE_7376_length_963_cov_66.251157	456	536	21	11	80	0.1375000
NODE_7376_length_963_cov_66.251157	456	536	22	12	80	0.1500000
NODE_7376_length_963_cov_66.251157	456	536	23	6	80	0.0750000
NODE_7376_length_963_cov_66.251157	456	536	24	11	80	0.1375000
NODE_7376_length_963_cov_66.251157	456	536	25	3	80	0.0375000
NODE_7376_length_963_cov_66.251157	509	589	21	20	80	0.2500000
NODE_7376_length_963_cov_66.251157	509	589	22	16	80	0.2000000
NODE_7376_length_963_cov_66.251157	509	589	23	7	80	0.0875000
NODE_7376_length_963_cov_66.251157	509	589	24	22	80	0.2750000
NODE_7376_length_963_cov_66.251157	509	589	25	7	80	0.0875000
NODE_7376_length_963_cov_66.251157	509	589	26	8	80	0.1000000
NODE_7376_length_963_cov_66.251157	585	665	12	10	80	0.1250000
NODE_7376_length_963_cov_66.251157	585	665	13	1	80	0.0125000
NODE_7376_length_963_cov_66.251157	585	665	14	12	80	0.1500000
NODE_7376_length_963_cov_66.251157	585	665	18	8	80	0.1000000
NODE_7376_length_963_cov_66.251157	585	665	19	1	80	0.0125000
NODE_7376_length_963_cov_66.251157	585	665	20	10	80	0.1250000
NODE_7376_length_963_cov_66.251157	585	665	21	8	80	0.1000000
NODE_7376_length_963_cov_66.251157	585	665	22	13	80	0.1625000
NODE_7376_length_963_cov_66.251157	585	665	23	2	80	0.0250000
NODE_7376_length_963_cov_66.251157	585	665	24	5	80	0.0625000
NODE_7376_length_963_cov_66.251157	585	665	25	8	80	0.1000000
NODE_7376_length_963_cov_66.251157	585	665	27	2	80	0.0250000
NODE_7376_length_963_cov_66.251157	638	718	7	8	80	0.1000000
NODE_7376_length_963_cov_66.251157	638	718	8	5	80	0.0625000
NODE_7376_length_963_cov_66.251157	638	718	9	5	80	0.0625000
NODE_7376_length_963_cov_66.251157	638	718	12	23	80	0.2875000
NODE_7376_length_963_cov_66.251157	638	718	13	23	80	0.2875000
NODE_7376_length_963_cov_66.251157	638	718	14	12	80	0.1500000
NODE_7376_length_963_cov_66.251157	638	718	18	4	80	0.0500000
NODE_7377_length_963_cov_35.638889	381	461	1	5	80	0.0625000
NODE_7377_length_963_cov_35.638889	381	461	2	25	80	0.3125000
NODE_7377_length_963_cov_35.638889	381	461	3	37	80	0.4625000
NODE_7377_length_963_cov_35.638889	381	461	5	12	80	0.1500000
NODE_7377_length_963_cov_35.638889	381	461	6	1	80	0.0125000
NODE_7377_length_963_cov_35.638889	434	514	2	8	80	0.1000000
NODE_7377_length_963_cov_35.638889	434	514	3	6	80	0.0750000
NODE_7377_length_963_cov_35.638889	434	514	5	43	80	0.5375000
NODE_7377_length_963_cov_35.638889	434	514	6	23	80	0.2875000
NODE_7377_length_963_cov_35.638889	510	590	4	13	80	0.1625000
NODE_7377_length_963_cov_35.638889	510	590	5	33	80	0.4125000
NODE_7377_length_963_cov_35.638889	510	590	7	34	80	0.4250000
NODE_7377_length_963_cov_35.638889	563	643	0	32	80	0.4000000
NODE_7377_length_963_cov_35.638889	563	643	2	1	80	0.0125000
NODE_7377_length_963_cov_35.638889	563	643	3	18	80	0.2250000
NODE_7377_length_963_cov_35.638889	563	643	4	15	80	0.1875000
NODE_7377_length_963_cov_35.638889	563	643	5	7	80	0.0875000
NODE_7377_length_963_cov_35.638889	563	643	7	7	80	0.0875000
NODE_7378_length_963_cov_33.642361	347	427	5	6	80	0.0750000
NODE_7378_length_963_cov_33.642361	347	427	6	38	80	0.4750000
NODE_7378_length_963_cov_33.642361	347	427	7	1	80	0.0125000
NODE_7378_length_963_cov_33.642361	347	427	8	3	80	0.0375000
NODE_7378_length_963_cov_33.642361	347	427	10	1	80	0.0125000
NODE_7378_length_963_cov_33.642361	347	427	12	10	80	0.1250000
NODE_7378_length_963_cov_33.642361	347	427	14	15	80	0.1875000
NODE_7378_length_963_cov_33.642361	347	427	15	6	80	0.0750000
NODE_7378_length_963_cov_33.642361	400	480	12	29	80	0.3625000
NODE_7378_length_963_cov_33.642361	400	480	13	4	80	0.0500000
NODE_7378_length_963_cov_33.642361	400	480	14	22	80	0.2750000
NODE_7378_length_963_cov_33.642361	400	480	15	9	80	0.1125000
NODE_7378_length_963_cov_33.642361	400	480	16	7	80	0.0875000
NODE_7378_length_963_cov_33.642361	400	480	17	4	80	0.0500000
NODE_7378_length_963_cov_33.642361	400	480	18	5	80	0.0625000
NODE_7379_length_963_cov_18.626157	392	472	8	4	80	0.0500000
NODE_7379_length_963_cov_18.626157	392	472	9	7	80	0.0875000
NODE_7379_length_963_cov_18.626157	392	472	11	21	80	0.2625000
NODE_7379_length_963_cov_18.626157	392	472	12	14	80	0.1750000
NODE_7379_length_963_cov_18.626157	392	472	13	16	80	0.2000000
NODE_7379_length_963_cov_18.626157	392	472	14	14	80	0.1750000
NODE_7379_length_963_cov_18.626157	392	472	16	4	80	0.0500000
NODE_7379_length_963_cov_18.626157	445	525	13	14	80	0.1750000
NODE_7379_length_963_cov_18.626157	445	525	14	42	80	0.5250000
NODE_7379_length_963_cov_18.626157	445	525	15	20	80	0.2500000
NODE_7379_length_963_cov_18.626157	445	525	16	4	80	0.0500000
NODE_7380_length_963_cov_17.750000	402	482	4	16	80	0.2000000
NODE_7380_length_963_cov_17.750000	402	482	5	64	80	0.8000000
NODE_7380_length_963_cov_17.750000	455	535	2	12	80	0.1500000
NODE_7380_length_963_cov_17.750000	455	535	3	11	80	0.1375000
NODE_7380_length_963_cov_17.750000	455	535	4	9	80	0.1125000
NODE_7380_length_963_cov_17.750000	455	535	5	48	80	0.6000000
NODE_7381_length_963_cov_17.023148	542	622	6	44	80	0.5500000
NODE_7381_length_963_cov_17.023148	542	622	7	14	80	0.1750000
NODE_7381_length_963_cov_17.023148	542	622	8	22	80	0.2750000
NODE_7381_length_963_cov_17.023148	595	675	5	2	80	0.0250000
NODE_7381_length_963_cov_17.023148	595	675	6	44	80	0.5500000
NODE_7381_length_963_cov_17.023148	595	675	7	12	80	0.1500000
NODE_7381_length_963_cov_17.023148	595	675	8	22	80	0.2750000
NODE_7382_length_963_cov_16.642361	481	561	0	41	80	0.5125000
NODE_7382_length_963_cov_16.642361	481	561	1	39	80	0.4875000
NODE_7382_length_963_cov_16.642361	534	614	1	39	80	0.4875000
NODE_7382_length_963_cov_16.642361	534	614	2	41	80	0.5125000
NODE_7382_length_963_cov_16.642361	572	629	1	1	57	0.0175439
NODE_7382_length_963_cov_16.642361	572	629	2	56	57	0.9824561
NODE_7383_length_963_cov_14.961806	283	363	1	66	80	0.8250000
NODE_7383_length_963_cov_14.961806	283	363	2	14	80	0.1750000
NODE_7383_length_963_cov_14.961806	336	416	1	34	80	0.4250000
NODE_7383_length_963_cov_14.961806	336	416	3	46	80	0.5750000
NODE_7384_length_963_cov_13.341435	558	638	0	3	80	0.0375000
NODE_7384_length_963_cov_13.341435	558	638	2	11	80	0.1375000
NODE_7384_length_963_cov_13.341435	558	638	3	17	80	0.2125000
NODE_7384_length_963_cov_13.341435	558	638	4	1	80	0.0125000
NODE_7384_length_963_cov_13.341435	558	638	5	48	80	0.6000000
NODE_7384_length_963_cov_13.341435	611	691	1	1	80	0.0125000
NODE_7384_length_963_cov_13.341435	611	691	3	48	80	0.6000000
NODE_7384_length_963_cov_13.341435	611	691	5	31	80	0.3875000
NODE_7386_length_963_cov_9.520833	459	539	0	25	80	0.3125000
NODE_7386_length_963_cov_9.520833	459	539	1	55	80	0.6875000
NODE_7386_length_963_cov_9.520833	512	592	1	80	80	1.0000000
NODE_7386_length_963_cov_9.520833	588	662	0	30	74	0.4054054
NODE_7386_length_963_cov_9.520833	588	662	1	44	74	0.5945946
NODE_7386_length_963_cov_9.520833	641	724	0	47	83	0.5662650
NODE_7386_length_963_cov_9.520833	641	724	1	36	83	0.4337350
NODE_7388_length_963_cov_7.510417	781	842	8	10	61	0.1639344
NODE_7388_length_963_cov_7.510417	781	842	9	6	61	0.0983607
NODE_7388_length_963_cov_7.510417	781	842	11	3	61	0.0491803
NODE_7388_length_963_cov_7.510417	781	842	12	5	61	0.0819672
NODE_7388_length_963_cov_7.510417	781	842	13	19	61	0.3114754
NODE_7388_length_963_cov_7.510417	781	842	15	6	61	0.0983607
NODE_7388_length_963_cov_7.510417	781	842	16	6	61	0.0983607
NODE_7388_length_963_cov_7.510417	781	842	17	6	61	0.0983607
NODE_7388_length_963_cov_7.510417	815	894	13	9	79	0.1139240
NODE_7388_length_963_cov_7.510417	815	894	15	23	79	0.2911392
NODE_7388_length_963_cov_7.510417	815	894	16	11	79	0.1392405
NODE_7388_length_963_cov_7.510417	815	894	17	36	79	0.4556962
NODE_7392_length_963_cov_3.755787	378	458	3	45	80	0.5625000
NODE_7392_length_963_cov_3.755787	378	458	4	35	80	0.4375000
NODE_7392_length_963_cov_3.755787	431	511	1	18	80	0.2250000
NODE_7392_length_963_cov_3.755787	431	511	3	62	80	0.7750000
NODE_7397_length_963_cov_1.931713	426	485	0	59	59	1.0000000
NODE_7404_length_962_cov_37.169177	356	436	6	7	80	0.0875000
NODE_7404_length_962_cov_37.169177	356	436	7	1	80	0.0125000
NODE_7404_length_962_cov_37.169177	356	436	9	11	80	0.1375000
NODE_7404_length_962_cov_37.169177	356	436	10	5	80	0.0625000
NODE_7404_length_962_cov_37.169177	356	436	11	56	80	0.7000000
NODE_7404_length_962_cov_37.169177	409	489	7	8	80	0.1000000
NODE_7404_length_962_cov_37.169177	409	489	8	44	80	0.5500000
NODE_7404_length_962_cov_37.169177	409	489	11	28	80	0.3500000
NODE_7405_length_962_cov_28.852839	474	554	1	8	80	0.1000000
NODE_7405_length_962_cov_28.852839	474	554	2	24	80	0.3000000
NODE_7405_length_962_cov_28.852839	474	554	3	48	80	0.6000000
NODE_7405_length_962_cov_28.852839	527	607	1	16	80	0.2000000
NODE_7405_length_962_cov_28.852839	527	607	2	20	80	0.2500000
NODE_7405_length_962_cov_28.852839	527	607	3	44	80	0.5500000
NODE_7405_length_962_cov_28.852839	603	683	1	15	80	0.1875000
NODE_7405_length_962_cov_28.852839	603	683	2	18	80	0.2250000
NODE_7405_length_962_cov_28.852839	603	683	3	47	80	0.5875000
NODE_7405_length_962_cov_28.852839	656	736	2	28	80	0.3500000
NODE_7405_length_962_cov_28.852839	656	736	3	52	80	0.6500000
NODE_7406_length_962_cov_27.859791	441	521	0	7	80	0.0875000
NODE_7406_length_962_cov_27.859791	441	521	1	73	80	0.9125000
NODE_7406_length_962_cov_27.859791	494	574	1	34	80	0.4250000
NODE_7406_length_962_cov_27.859791	494	574	2	46	80	0.5750000
NODE_7407_length_962_cov_21.019699	318	398	1	29	80	0.3625000
NODE_7407_length_962_cov_21.019699	318	398	2	11	80	0.1375000
NODE_7407_length_962_cov_21.019699	318	398	3	3	80	0.0375000
NODE_7407_length_962_cov_21.019699	318	398	4	14	80	0.1750000
NODE_7407_length_962_cov_21.019699	318	398	5	4	80	0.0500000
NODE_7407_length_962_cov_21.019699	318	398	6	19	80	0.2375000
NODE_7407_length_962_cov_21.019699	371	451	4	4	80	0.0500000
NODE_7407_length_962_cov_21.019699	371	451	5	4	80	0.0500000
NODE_7407_length_962_cov_21.019699	371	451	6	72	80	0.9000000
NODE_7408_length_962_cov_16.792584	350	430	0	9	80	0.1125000
NODE_7408_length_962_cov_16.792584	350	430	2	10	80	0.1250000
NODE_7408_length_962_cov_16.792584	350	430	4	10	80	0.1250000
NODE_7408_length_962_cov_16.792584	350	430	6	51	80	0.6375000
NODE_7408_length_962_cov_16.792584	403	483	2	3	80	0.0375000
NODE_7408_length_962_cov_16.792584	403	483	4	17	80	0.2125000
NODE_7408_length_962_cov_16.792584	403	483	6	60	80	0.7500000
NODE_7409_length_962_cov_14.650058	477	557	4	20	80	0.2500000
NODE_7409_length_962_cov_14.650058	477	557	5	60	80	0.7500000
NODE_7409_length_962_cov_14.650058	530	610	4	45	80	0.5625000
NODE_7409_length_962_cov_14.650058	530	610	5	35	80	0.4375000
NODE_7410_length_962_cov_7.993048	308	345	0	37	37	1.0000000
NODE_7411_length_962_cov_7.835458	447	527	1	1	80	0.0125000
NODE_7411_length_962_cov_7.835458	447	527	2	79	80	0.9875000
NODE_7411_length_962_cov_7.835458	500	580	1	1	80	0.0125000
NODE_7411_length_962_cov_7.835458	500	580	2	53	80	0.6625000
NODE_7411_length_962_cov_7.835458	500	580	3	26	80	0.3250000
NODE_7412_length_962_cov_6.855156	490	570	3	80	80	1.0000000
NODE_7412_length_962_cov_6.855156	543	623	0	10	80	0.1250000
NODE_7412_length_962_cov_6.855156	543	623	2	18	80	0.2250000
NODE_7412_length_962_cov_6.855156	543	623	3	52	80	0.6500000
NODE_7417_length_962_cov_1.840093	88	151	0	1	63	0.0158730
NODE_7417_length_962_cov_1.840093	88	151	2	2	63	0.0317460
NODE_7417_length_962_cov_1.840093	88	151	4	60	63	0.9523810
NODE_7422_length_961_cov_61.019722	453	533	2	46	80	0.5750000
NODE_7422_length_961_cov_61.019722	453	533	3	12	80	0.1500000
NODE_7422_length_961_cov_61.019722	453	533	4	16	80	0.2000000
NODE_7422_length_961_cov_61.019722	453	533	5	6	80	0.0750000
NODE_7422_length_961_cov_61.019722	506	586	2	57	80	0.7125000
NODE_7422_length_961_cov_61.019722	506	586	3	12	80	0.1500000
NODE_7422_length_961_cov_61.019722	506	586	4	11	80	0.1375000
NODE_7422_length_961_cov_61.019722	614	672	0	4	58	0.0689655
NODE_7422_length_961_cov_61.019722	614	672	1	34	58	0.5862069
NODE_7422_length_961_cov_61.019722	614	672	2	20	58	0.3448276
NODE_7423_length_961_cov_51.005800	334	414	19	8	80	0.1000000
NODE_7423_length_961_cov_51.005800	334	414	20	17	80	0.2125000
NODE_7423_length_961_cov_51.005800	334	414	21	22	80	0.2750000
NODE_7423_length_961_cov_51.005800	334	414	22	9	80	0.1125000
NODE_7423_length_961_cov_51.005800	334	414	23	13	80	0.1625000
NODE_7423_length_961_cov_51.005800	334	414	25	11	80	0.1375000
NODE_7423_length_961_cov_51.005800	387	467	14	19	80	0.2375000
NODE_7423_length_961_cov_51.005800	387	467	16	2	80	0.0250000
NODE_7423_length_961_cov_51.005800	387	467	17	9	80	0.1125000
NODE_7423_length_961_cov_51.005800	387	467	18	13	80	0.1625000
NODE_7423_length_961_cov_51.005800	387	467	19	3	80	0.0375000
NODE_7423_length_961_cov_51.005800	387	467	20	8	80	0.1000000
NODE_7423_length_961_cov_51.005800	387	467	21	6	80	0.0750000
NODE_7423_length_961_cov_51.005800	387	467	23	9	80	0.1125000
NODE_7423_length_961_cov_51.005800	387	467	25	11	80	0.1375000
NODE_7424_length_961_cov_45.923434	391	471	16	2	80	0.0250000
NODE_7424_length_961_cov_45.923434	391	471	17	10	80	0.1250000
NODE_7424_length_961_cov_45.923434	391	471	19	2	80	0.0250000
NODE_7424_length_961_cov_45.923434	391	471	20	5	80	0.0625000
NODE_7424_length_961_cov_45.923434	391	471	22	2	80	0.0250000
NODE_7424_length_961_cov_45.923434	391	471	23	27	80	0.3375000
NODE_7424_length_961_cov_45.923434	391	471	24	21	80	0.2625000
NODE_7424_length_961_cov_45.923434	391	471	25	11	80	0.1375000
NODE_7424_length_961_cov_45.923434	444	524	19	4	80	0.0500000
NODE_7424_length_961_cov_45.923434	444	524	20	2	80	0.0250000
NODE_7424_length_961_cov_45.923434	444	524	22	5	80	0.0625000
NODE_7424_length_961_cov_45.923434	444	524	23	5	80	0.0625000
NODE_7424_length_961_cov_45.923434	444	524	24	38	80	0.4750000
NODE_7424_length_961_cov_45.923434	444	524	25	17	80	0.2125000
NODE_7424_length_961_cov_45.923434	444	524	26	9	80	0.1125000
NODE_7426_length_961_cov_21.410673	313	393	8	11	80	0.1375000
NODE_7426_length_961_cov_21.410673	313	393	9	68	80	0.8500000
NODE_7426_length_961_cov_21.410673	313	393	10	1	80	0.0125000
NODE_7426_length_961_cov_21.410673	366	446	1	3	80	0.0375000
NODE_7426_length_961_cov_21.410673	366	446	3	5	80	0.0625000
NODE_7426_length_961_cov_21.410673	366	446	4	1	80	0.0125000
NODE_7426_length_961_cov_21.410673	366	446	5	2	80	0.0250000
NODE_7426_length_961_cov_21.410673	366	446	6	34	80	0.4250000
NODE_7426_length_961_cov_21.410673	366	446	8	19	80	0.2375000
NODE_7426_length_961_cov_21.410673	366	446	9	16	80	0.2000000
NODE_7427_length_961_cov_18.592807	403	483	3	4	80	0.0500000
NODE_7427_length_961_cov_18.592807	403	483	4	9	80	0.1125000
NODE_7427_length_961_cov_18.592807	403	483	5	13	80	0.1625000
NODE_7427_length_961_cov_18.592807	403	483	7	54	80	0.6750000
NODE_7427_length_961_cov_18.592807	456	536	2	52	80	0.6500000
NODE_7427_length_961_cov_18.592807	456	536	3	4	80	0.0500000
NODE_7427_length_961_cov_18.592807	456	536	4	10	80	0.1250000
NODE_7427_length_961_cov_18.592807	456	536	5	13	80	0.1625000
NODE_7427_length_961_cov_18.592807	456	536	7	1	80	0.0125000
NODE_7428_length_961_cov_17.701856	433	513	4	2	80	0.0250000
NODE_7428_length_961_cov_17.701856	433	513	5	5	80	0.0625000
NODE_7428_length_961_cov_17.701856	433	513	6	73	80	0.9125000
NODE_7428_length_961_cov_17.701856	486	566	2	22	80	0.2750000
NODE_7428_length_961_cov_17.701856	486	566	4	5	80	0.0625000
NODE_7428_length_961_cov_17.701856	486	566	5	33	80	0.4125000
NODE_7428_length_961_cov_17.701856	486	566	6	20	80	0.2500000
NODE_7429_length_961_cov_17.020882	505	585	4	7	80	0.0875000
NODE_7429_length_961_cov_17.020882	505	585	5	73	80	0.9125000
NODE_7429_length_961_cov_17.020882	558	638	4	23	80	0.2875000
NODE_7429_length_961_cov_17.020882	558	638	5	56	80	0.7000000
NODE_7429_length_961_cov_17.020882	558	638	6	1	80	0.0125000
NODE_7430_length_961_cov_16.235499	328	408	2	20	80	0.2500000
NODE_7430_length_961_cov_16.235499	328	408	3	21	80	0.2625000
NODE_7430_length_961_cov_16.235499	328	408	4	2	80	0.0250000
NODE_7430_length_961_cov_16.235499	328	408	5	21	80	0.2625000
NODE_7430_length_961_cov_16.235499	328	408	6	16	80	0.2000000
NODE_7430_length_961_cov_16.235499	381	461	4	10	80	0.1250000
NODE_7430_length_961_cov_16.235499	381	461	5	64	80	0.8000000
NODE_7430_length_961_cov_16.235499	381	461	6	6	80	0.0750000
NODE_7432_length_961_cov_12.968677	347	427	2	31	80	0.3875000
NODE_7432_length_961_cov_12.968677	347	427	4	28	80	0.3500000
NODE_7432_length_961_cov_12.968677	347	427	6	21	80	0.2625000
NODE_7432_length_961_cov_12.968677	400	480	4	19	80	0.2375000
NODE_7432_length_961_cov_12.968677	400	480	6	61	80	0.7625000
NODE_7433_length_961_cov_9.875870	439	519	3	24	80	0.3000000
NODE_7433_length_961_cov_9.875870	439	519	4	29	80	0.3625000
NODE_7433_length_961_cov_9.875870	439	519	5	25	80	0.3125000
NODE_7433_length_961_cov_9.875870	439	519	6	2	80	0.0250000
NODE_7433_length_961_cov_9.875870	492	572	2	24	80	0.3000000
NODE_7433_length_961_cov_9.875870	492	572	4	56	80	0.7000000
NODE_7434_length_961_cov_6.172854	624	704	1	64	80	0.8000000
NODE_7434_length_961_cov_6.172854	624	704	2	16	80	0.2000000
NODE_7434_length_961_cov_6.172854	677	757	0	9	80	0.1125000
NODE_7434_length_961_cov_6.172854	677	757	1	71	80	0.8875000
NODE_7435_length_961_cov_4.553364	451	531	0	80	80	1.0000000
NODE_7435_length_961_cov_4.553364	504	584	0	80	80	1.0000000
NODE_7440_length_960_cov_35.649245	65	145	8	23	80	0.2875000
NODE_7440_length_960_cov_35.649245	65	145	9	29	80	0.3625000
NODE_7440_length_960_cov_35.649245	65	145	10	4	80	0.0500000
NODE_7440_length_960_cov_35.649245	65	145	12	24	80	0.3000000
NODE_7440_length_960_cov_35.649245	118	198	5	1	80	0.0125000
NODE_7440_length_960_cov_35.649245	118	198	8	8	80	0.1000000
NODE_7440_length_960_cov_35.649245	118	198	9	9	80	0.1125000
NODE_7440_length_960_cov_35.649245	118	198	10	14	80	0.1750000
NODE_7440_length_960_cov_35.649245	118	198	11	3	80	0.0375000
NODE_7440_length_960_cov_35.649245	118	198	12	45	80	0.5625000
NODE_7440_length_960_cov_35.649245	446	526	3	10	80	0.1250000
NODE_7440_length_960_cov_35.649245	446	526	6	2	80	0.0250000
NODE_7440_length_960_cov_35.649245	446	526	7	5	80	0.0625000
NODE_7440_length_960_cov_35.649245	446	526	8	8	80	0.1000000
NODE_7440_length_960_cov_35.649245	446	526	9	7	80	0.0875000
NODE_7440_length_960_cov_35.649245	446	526	10	48	80	0.6000000
NODE_7440_length_960_cov_35.649245	499	579	8	1	80	0.0125000
NODE_7440_length_960_cov_35.649245	499	579	9	3	80	0.0375000
NODE_7440_length_960_cov_35.649245	499	579	10	36	80	0.4500000
NODE_7440_length_960_cov_35.649245	499	579	11	5	80	0.0625000
NODE_7440_length_960_cov_35.649245	499	579	12	27	80	0.3375000
NODE_7440_length_960_cov_35.649245	499	579	13	8	80	0.1000000
NODE_7441_length_960_cov_34.886179	386	466	5	4	80	0.0500000
NODE_7441_length_960_cov_34.886179	386	466	6	40	80	0.5000000
NODE_7441_length_960_cov_34.886179	386	466	7	13	80	0.1625000
NODE_7441_length_960_cov_34.886179	386	466	8	4	80	0.0500000
NODE_7441_length_960_cov_34.886179	386	466	9	6	80	0.0750000
NODE_7441_length_960_cov_34.886179	386	466	10	13	80	0.1625000
NODE_7441_length_960_cov_34.886179	439	519	7	10	80	0.1250000
NODE_7441_length_960_cov_34.886179	439	519	8	12	80	0.1500000
NODE_7441_length_960_cov_34.886179	439	519	9	19	80	0.2375000
NODE_7441_length_960_cov_34.886179	439	519	10	32	80	0.4000000
NODE_7441_length_960_cov_34.886179	439	519	11	7	80	0.0875000
NODE_7443_length_960_cov_25.133566	413	493	0	80	80	1.0000000
NODE_7443_length_960_cov_25.133566	466	546	0	80	80	1.0000000
NODE_7444_length_960_cov_19.336818	385	465	0	80	80	1.0000000
NODE_7444_length_960_cov_19.336818	438	518	0	80	80	1.0000000
NODE_7445_length_960_cov_13.221835	460	539	3	48	79	0.6075949
NODE_7445_length_960_cov_13.221835	460	539	4	20	79	0.2531646
NODE_7445_length_960_cov_13.221835	460	539	5	11	79	0.1392405
NODE_7445_length_960_cov_13.221835	512	592	3	9	80	0.1125000
NODE_7445_length_960_cov_13.221835	512	592	4	52	80	0.6500000
NODE_7445_length_960_cov_13.221835	512	592	5	19	80	0.2375000
NODE_7446_length_960_cov_12.804878	347	427	3	6	80	0.0750000
NODE_7446_length_960_cov_12.804878	347	427	4	4	80	0.0500000
NODE_7446_length_960_cov_12.804878	347	427	5	32	80	0.4000000
NODE_7446_length_960_cov_12.804878	347	427	6	25	80	0.3125000
NODE_7446_length_960_cov_12.804878	347	427	7	13	80	0.1625000
NODE_7446_length_960_cov_12.804878	400	480	5	17	80	0.2125000
NODE_7446_length_960_cov_12.804878	400	480	6	42	80	0.5250000
NODE_7446_length_960_cov_12.804878	400	480	7	21	80	0.2625000
NODE_7462_length_959_cov_39.394186	326	406	3	18	80	0.2250000
NODE_7462_length_959_cov_39.394186	326	406	4	11	80	0.1375000
NODE_7462_length_959_cov_39.394186	326	406	5	51	80	0.6375000
NODE_7462_length_959_cov_39.394186	379	459	5	80	80	1.0000000
NODE_7463_length_959_cov_28.895349	327	407	0	53	80	0.6625000
NODE_7463_length_959_cov_28.895349	327	407	1	12	80	0.1500000
NODE_7463_length_959_cov_28.895349	327	407	2	15	80	0.1875000
NODE_7463_length_959_cov_28.895349	380	460	0	11	80	0.1375000
NODE_7463_length_959_cov_28.895349	380	460	1	1	80	0.0125000
NODE_7463_length_959_cov_28.895349	380	460	2	68	80	0.8500000
NODE_7464_length_959_cov_26.634884	563	643	2	5	80	0.0625000
NODE_7464_length_959_cov_26.634884	563	643	3	22	80	0.2750000
NODE_7464_length_959_cov_26.634884	563	643	4	53	80	0.6625000
NODE_7464_length_959_cov_26.634884	616	696	0	35	80	0.4375000
NODE_7464_length_959_cov_26.634884	616	696	3	40	80	0.5000000
NODE_7464_length_959_cov_26.634884	616	696	4	5	80	0.0625000
NODE_7464_length_959_cov_26.634884	692	772	0	80	80	1.0000000
NODE_7464_length_959_cov_26.634884	745	825	0	80	80	1.0000000
NODE_7465_length_959_cov_18.862791	320	400	11	1	80	0.0125000
NODE_7465_length_959_cov_18.862791	320	400	12	76	80	0.9500000
NODE_7465_length_959_cov_18.862791	320	400	13	3	80	0.0375000
NODE_7465_length_959_cov_18.862791	373	453	3	7	80	0.0875000
NODE_7465_length_959_cov_18.862791	373	453	5	15	80	0.1875000
NODE_7465_length_959_cov_18.862791	373	453	7	7	80	0.0875000
NODE_7465_length_959_cov_18.862791	373	453	8	1	80	0.0125000
NODE_7465_length_959_cov_18.862791	373	453	9	8	80	0.1000000
NODE_7465_length_959_cov_18.862791	373	453	10	2	80	0.0250000
NODE_7465_length_959_cov_18.862791	373	453	11	13	80	0.1625000
NODE_7465_length_959_cov_18.862791	373	453	12	24	80	0.3000000
NODE_7465_length_959_cov_18.862791	373	453	13	3	80	0.0375000
NODE_7466_length_959_cov_17.910465	358	438	3	59	80	0.7375000
NODE_7466_length_959_cov_17.910465	358	438	4	21	80	0.2625000
NODE_7466_length_959_cov_17.910465	411	491	2	30	80	0.3750000
NODE_7466_length_959_cov_17.910465	411	491	3	50	80	0.6250000
NODE_7467_length_959_cov_15.337209	267	347	1	20	80	0.2500000
NODE_7467_length_959_cov_15.337209	267	347	3	45	80	0.5625000
NODE_7467_length_959_cov_15.337209	267	347	4	15	80	0.1875000
NODE_7467_length_959_cov_15.337209	320	400	1	24	80	0.3000000
NODE_7467_length_959_cov_15.337209	320	400	2	11	80	0.1375000
NODE_7467_length_959_cov_15.337209	320	400	3	30	80	0.3750000
NODE_7467_length_959_cov_15.337209	320	400	4	15	80	0.1875000
NODE_7468_length_959_cov_9.005814	529	609	1	49	80	0.6125000
NODE_7468_length_959_cov_9.005814	529	609	2	31	80	0.3875000
NODE_7468_length_959_cov_9.005814	582	662	1	79	80	0.9875000
NODE_7468_length_959_cov_9.005814	582	662	2	1	80	0.0125000
NODE_7469_length_959_cov_8.163953	392	472	0	7	80	0.0875000
NODE_7469_length_959_cov_8.163953	392	472	2	20	80	0.2500000
NODE_7469_length_959_cov_8.163953	392	472	4	18	80	0.2250000
NODE_7469_length_959_cov_8.163953	392	472	7	35	80	0.4375000
NODE_7469_length_959_cov_8.163953	445	525	7	38	80	0.4750000
NODE_7469_length_959_cov_8.163953	445	525	8	42	80	0.5250000
NODE_7470_length_959_cov_7.097674	401	481	0	18	80	0.2250000
NODE_7470_length_959_cov_7.097674	401	481	2	16	80	0.2000000
NODE_7470_length_959_cov_7.097674	401	481	3	31	80	0.3875000
NODE_7470_length_959_cov_7.097674	401	481	4	15	80	0.1875000
NODE_7470_length_959_cov_7.097674	454	534	3	12	80	0.1500000
NODE_7470_length_959_cov_7.097674	454	534	4	68	80	0.8500000
NODE_7472_length_959_cov_4.603488	596	676	1	9	80	0.1125000
NODE_7472_length_959_cov_4.603488	596	676	2	71	80	0.8875000
NODE_7472_length_959_cov_4.603488	649	729	1	39	80	0.4875000
NODE_7472_length_959_cov_4.603488	649	729	2	41	80	0.5125000
NODE_7486_length_958_cov_57.015134	328	408	2	19	80	0.2375000
NODE_7486_length_958_cov_57.015134	328	408	3	17	80	0.2125000
NODE_7486_length_958_cov_57.015134	328	408	4	2	80	0.0250000
NODE_7486_length_958_cov_57.015134	328	408	5	19	80	0.2375000
NODE_7486_length_958_cov_57.015134	328	408	6	23	80	0.2875000
NODE_7486_length_958_cov_57.015134	381	461	4	12	80	0.1500000
NODE_7486_length_958_cov_57.015134	381	461	5	50	80	0.6250000
NODE_7486_length_958_cov_57.015134	381	461	6	12	80	0.1500000
NODE_7486_length_958_cov_57.015134	381	461	8	6	80	0.0750000
NODE_7486_length_958_cov_57.015134	457	537	7	2	80	0.0250000
NODE_7486_length_958_cov_57.015134	457	537	8	37	80	0.4625000
NODE_7486_length_958_cov_57.015134	457	537	9	5	80	0.0625000
NODE_7486_length_958_cov_57.015134	457	537	10	31	80	0.3875000
NODE_7486_length_958_cov_57.015134	457	537	11	5	80	0.0625000
NODE_7486_length_958_cov_57.015134	510	590	7	2	80	0.0250000
NODE_7486_length_958_cov_57.015134	510	590	8	55	80	0.6875000
NODE_7486_length_958_cov_57.015134	510	590	9	5	80	0.0625000
NODE_7486_length_958_cov_57.015134	510	590	10	18	80	0.2250000
NODE_7487_length_958_cov_42.265425	418	498	3	17	80	0.2125000
NODE_7487_length_958_cov_42.265425	418	498	4	15	80	0.1875000
NODE_7487_length_958_cov_42.265425	418	498	5	8	80	0.1000000
NODE_7487_length_958_cov_42.265425	418	498	6	5	80	0.0625000
NODE_7487_length_958_cov_42.265425	418	498	7	5	80	0.0625000
NODE_7487_length_958_cov_42.265425	418	498	8	30	80	0.3750000
NODE_7487_length_958_cov_42.265425	471	551	2	13	80	0.1625000
NODE_7487_length_958_cov_42.265425	471	551	3	57	80	0.7125000
NODE_7487_length_958_cov_42.265425	471	551	4	10	80	0.1250000
NODE_7488_length_958_cov_28.618161	336	416	6	16	80	0.2000000
NODE_7488_length_958_cov_28.618161	336	416	7	43	80	0.5375000
NODE_7488_length_958_cov_28.618161	336	416	8	21	80	0.2625000
NODE_7488_length_958_cov_28.618161	389	469	2	5	80	0.0625000
NODE_7488_length_958_cov_28.618161	389	469	3	12	80	0.1500000
NODE_7488_length_958_cov_28.618161	389	469	4	17	80	0.2125000
NODE_7488_length_958_cov_28.618161	389	469	5	5	80	0.0625000
NODE_7488_length_958_cov_28.618161	389	469	6	10	80	0.1250000
NODE_7488_length_958_cov_28.618161	389	469	7	21	80	0.2625000
NODE_7488_length_958_cov_28.618161	389	469	8	10	80	0.1250000
NODE_7488_length_958_cov_28.618161	465	545	5	3	80	0.0375000
NODE_7488_length_958_cov_28.618161	465	545	6	60	80	0.7500000
NODE_7488_length_958_cov_28.618161	465	545	7	17	80	0.2125000
NODE_7488_length_958_cov_28.618161	518	598	5	9	80	0.1125000
NODE_7488_length_958_cov_28.618161	518	598	6	53	80	0.6625000
NODE_7488_length_958_cov_28.618161	518	598	7	18	80	0.2250000
NODE_7489_length_958_cov_16.452852	446	526	7	12	80	0.1500000
NODE_7489_length_958_cov_16.452852	446	526	9	15	80	0.1875000
NODE_7489_length_958_cov_16.452852	446	526	11	18	80	0.2250000
NODE_7489_length_958_cov_16.452852	446	526	14	34	80	0.4250000
NODE_7489_length_958_cov_16.452852	446	526	15	1	80	0.0125000
NODE_7489_length_958_cov_16.452852	499	579	9	31	80	0.3875000
NODE_7489_length_958_cov_16.452852	499	579	11	10	80	0.1250000
NODE_7489_length_958_cov_16.452852	499	579	13	9	80	0.1125000
NODE_7489_length_958_cov_16.452852	499	579	14	30	80	0.3750000
NODE_7490_length_958_cov_16.008149	446	526	6	74	80	0.9250000
NODE_7490_length_958_cov_16.008149	446	526	8	6	80	0.0750000
NODE_7490_length_958_cov_16.008149	499	579	2	18	80	0.2250000
NODE_7490_length_958_cov_16.008149	499	579	4	24	80	0.3000000
NODE_7490_length_958_cov_16.008149	499	579	6	38	80	0.4750000
NODE_7491_length_958_cov_14.154831	516	596	0	36	80	0.4500000
NODE_7491_length_958_cov_14.154831	516	596	1	44	80	0.5500000
NODE_7491_length_958_cov_14.154831	569	649	0	80	80	1.0000000
NODE_7492_length_958_cov_12.381839	454	534	4	13	80	0.1625000
NODE_7492_length_958_cov_12.381839	454	534	6	50	80	0.6250000
NODE_7492_length_958_cov_12.381839	454	534	7	1	80	0.0125000
NODE_7492_length_958_cov_12.381839	454	534	8	16	80	0.2000000
NODE_7492_length_958_cov_12.381839	507	587	3	6	80	0.0750000
NODE_7492_length_958_cov_12.381839	507	587	4	23	80	0.2875000
NODE_7492_length_958_cov_12.381839	507	587	6	34	80	0.4250000
NODE_7492_length_958_cov_12.381839	507	587	7	1	80	0.0125000
NODE_7492_length_958_cov_12.381839	507	587	8	16	80	0.2000000
NODE_7493_length_958_cov_11.782305	479	559	3	6	80	0.0750000
NODE_7493_length_958_cov_11.782305	479	559	4	14	80	0.1750000
NODE_7493_length_958_cov_11.782305	479	559	5	60	80	0.7500000
NODE_7493_length_958_cov_11.782305	532	612	2	8	80	0.1000000
NODE_7493_length_958_cov_11.782305	532	612	4	35	80	0.4375000
NODE_7493_length_958_cov_11.782305	532	612	5	37	80	0.4625000
NODE_7501_length_957_cov_40.837995	746	826	7	17	80	0.2125000
NODE_7501_length_957_cov_40.837995	746	826	8	1	80	0.0125000
NODE_7501_length_957_cov_40.837995	746	826	9	3	80	0.0375000
NODE_7501_length_957_cov_40.837995	746	826	10	2	80	0.0250000
NODE_7501_length_957_cov_40.837995	746	826	12	1	80	0.0125000
NODE_7501_length_957_cov_40.837995	746	826	13	18	80	0.2250000
NODE_7501_length_957_cov_40.837995	746	826	14	22	80	0.2750000
NODE_7501_length_957_cov_40.837995	746	826	15	16	80	0.2000000
NODE_7501_length_957_cov_40.837995	799	879	5	15	80	0.1875000
NODE_7501_length_957_cov_40.837995	799	879	6	16	80	0.2000000
NODE_7501_length_957_cov_40.837995	799	879	7	39	80	0.4875000
NODE_7501_length_957_cov_40.837995	799	879	8	1	80	0.0125000
NODE_7501_length_957_cov_40.837995	799	879	9	3	80	0.0375000
NODE_7501_length_957_cov_40.837995	799	879	10	2	80	0.0250000
NODE_7501_length_957_cov_40.837995	799	879	12	1	80	0.0125000
NODE_7501_length_957_cov_40.837995	799	879	13	3	80	0.0375000
NODE_7502_length_957_cov_25.976690	631	711	5	8	80	0.1000000
NODE_7502_length_957_cov_25.976690	631	711	6	2	80	0.0250000
NODE_7502_length_957_cov_25.976690	631	711	7	35	80	0.4375000
NODE_7502_length_957_cov_25.976690	631	711	8	35	80	0.4375000
NODE_7502_length_957_cov_25.976690	684	764	2	16	80	0.2000000
NODE_7502_length_957_cov_25.976690	684	764	4	28	80	0.3500000
NODE_7502_length_957_cov_25.976690	684	764	5	17	80	0.2125000
NODE_7502_length_957_cov_25.976690	684	764	6	2	80	0.0250000
NODE_7502_length_957_cov_25.976690	684	764	7	17	80	0.2125000
NODE_7503_length_957_cov_25.855478	57	131	0	74	74	1.0000000
NODE_7503_length_957_cov_25.855478	414	494	1	14	80	0.1750000
NODE_7503_length_957_cov_25.855478	414	494	2	22	80	0.2750000
NODE_7503_length_957_cov_25.855478	414	494	4	18	80	0.2250000
NODE_7503_length_957_cov_25.855478	414	494	5	5	80	0.0625000
NODE_7503_length_957_cov_25.855478	414	494	7	21	80	0.2625000
NODE_7503_length_957_cov_25.855478	467	547	4	1	80	0.0125000
NODE_7503_length_957_cov_25.855478	467	547	5	5	80	0.0625000
NODE_7503_length_957_cov_25.855478	467	547	6	18	80	0.2250000
NODE_7503_length_957_cov_25.855478	467	547	7	56	80	0.7000000
NODE_7504_length_957_cov_24.625874	445	525	2	9	80	0.1125000
NODE_7504_length_957_cov_24.625874	445	525	3	31	80	0.3875000
NODE_7504_length_957_cov_24.625874	445	525	4	26	80	0.3250000
NODE_7504_length_957_cov_24.625874	445	525	5	14	80	0.1750000
NODE_7504_length_957_cov_24.625874	498	578	2	9	80	0.1125000
NODE_7504_length_957_cov_24.625874	498	578	3	18	80	0.2250000
NODE_7504_length_957_cov_24.625874	498	578	4	9	80	0.1125000
NODE_7504_length_957_cov_24.625874	498	578	5	11	80	0.1375000
NODE_7504_length_957_cov_24.625874	498	578	6	15	80	0.1875000
NODE_7504_length_957_cov_24.625874	498	578	7	18	80	0.2250000
NODE_7505_length_957_cov_19.955711	286	366	2	28	80	0.3500000
NODE_7505_length_957_cov_19.955711	286	366	3	28	80	0.3500000
NODE_7505_length_957_cov_19.955711	286	366	4	2	80	0.0250000
NODE_7505_length_957_cov_19.955711	286	366	6	22	80	0.2750000
NODE_7505_length_957_cov_19.955711	339	419	3	3	80	0.0375000
NODE_7505_length_957_cov_19.955711	339	419	4	2	80	0.0250000
NODE_7505_length_957_cov_19.955711	339	419	5	22	80	0.2750000
NODE_7505_length_957_cov_19.955711	339	419	6	53	80	0.6625000
NODE_7506_length_957_cov_18.861305	414	494	5	15	80	0.1875000
NODE_7506_length_957_cov_18.861305	414	494	7	27	80	0.3375000
NODE_7506_length_957_cov_18.861305	414	494	9	7	80	0.0875000
NODE_7506_length_957_cov_18.861305	414	494	10	31	80	0.3875000
NODE_7506_length_957_cov_18.861305	467	547	5	15	80	0.1875000
NODE_7506_length_957_cov_18.861305	467	547	8	7	80	0.0875000
NODE_7506_length_957_cov_18.861305	467	547	9	2	80	0.0250000
NODE_7506_length_957_cov_18.861305	467	547	10	56	80	0.7000000
NODE_7507_length_957_cov_17.356643	361	441	4	35	80	0.4375000
NODE_7507_length_957_cov_17.356643	361	441	5	45	80	0.5625000
NODE_7507_length_957_cov_17.356643	414	494	3	2	80	0.0250000
NODE_7507_length_957_cov_17.356643	414	494	4	29	80	0.3625000
NODE_7507_length_957_cov_17.356643	414	494	5	46	80	0.5750000
NODE_7507_length_957_cov_17.356643	414	494	6	2	80	0.0250000
NODE_7507_length_957_cov_17.356643	414	494	7	1	80	0.0125000
NODE_7508_length_957_cov_13.569930	162	242	5	29	80	0.3625000
NODE_7508_length_957_cov_13.569930	162	242	6	11	80	0.1375000
NODE_7508_length_957_cov_13.569930	162	242	7	33	80	0.4125000
NODE_7508_length_957_cov_13.569930	162	242	8	7	80	0.0875000
NODE_7508_length_957_cov_13.569930	215	299	4	21	84	0.2500000
NODE_7508_length_957_cov_13.569930	215	299	5	15	84	0.1785714
NODE_7508_length_957_cov_13.569930	215	299	7	34	84	0.4047619
NODE_7508_length_957_cov_13.569930	215	299	8	14	84	0.1666667
NODE_7509_length_957_cov_12.334499	314	394	7	35	80	0.4375000
NODE_7509_length_957_cov_12.334499	314	394	8	27	80	0.3375000
NODE_7509_length_957_cov_12.334499	314	394	9	17	80	0.2125000
NODE_7509_length_957_cov_12.334499	314	394	10	1	80	0.0125000
NODE_7509_length_957_cov_12.334499	367	447	5	16	80	0.2000000
NODE_7509_length_957_cov_12.334499	367	447	6	4	80	0.0500000
NODE_7509_length_957_cov_12.334499	367	447	7	30	80	0.3750000
NODE_7509_length_957_cov_12.334499	367	447	8	9	80	0.1125000
NODE_7509_length_957_cov_12.334499	367	447	9	17	80	0.2125000
NODE_7509_length_957_cov_12.334499	367	447	10	4	80	0.0500000
NODE_7510_length_957_cov_12.017483	173	253	0	32	80	0.4000000
NODE_7510_length_957_cov_12.017483	173	253	2	6	80	0.0750000
NODE_7510_length_957_cov_12.017483	173	253	4	28	80	0.3500000
NODE_7510_length_957_cov_12.017483	173	253	6	14	80	0.1750000
NODE_7510_length_957_cov_12.017483	226	306	4	13	80	0.1625000
NODE_7510_length_957_cov_12.017483	226	306	6	67	80	0.8375000
NODE_7511_length_957_cov_10.026807	446	526	0	5	80	0.0625000
NODE_7511_length_957_cov_10.026807	446	526	2	75	80	0.9375000
NODE_7511_length_957_cov_10.026807	499	579	0	3	80	0.0375000
NODE_7511_length_957_cov_10.026807	499	579	1	28	80	0.3500000
NODE_7511_length_957_cov_10.026807	499	579	2	49	80	0.6125000
NODE_7529_length_956_cov_48.047841	479	559	11	7	80	0.0875000
NODE_7529_length_956_cov_48.047841	479	559	12	7	80	0.0875000
NODE_7529_length_956_cov_48.047841	479	559	13	3	80	0.0375000
NODE_7529_length_956_cov_48.047841	479	559	14	3	80	0.0375000
NODE_7529_length_956_cov_48.047841	479	559	15	9	80	0.1125000
NODE_7529_length_956_cov_48.047841	479	559	16	3	80	0.0375000
NODE_7529_length_956_cov_48.047841	479	559	17	12	80	0.1500000
NODE_7529_length_956_cov_48.047841	479	559	18	7	80	0.0875000
NODE_7529_length_956_cov_48.047841	479	559	19	3	80	0.0375000
NODE_7529_length_956_cov_48.047841	479	559	20	1	80	0.0125000
NODE_7529_length_956_cov_48.047841	479	559	21	22	80	0.2750000
NODE_7529_length_956_cov_48.047841	479	559	22	3	80	0.0375000
NODE_7529_length_956_cov_48.047841	532	612	15	16	80	0.2000000
NODE_7529_length_956_cov_48.047841	532	612	16	22	80	0.2750000
NODE_7529_length_956_cov_48.047841	532	612	17	21	80	0.2625000
NODE_7529_length_956_cov_48.047841	532	612	18	7	80	0.0875000
NODE_7529_length_956_cov_48.047841	532	612	19	2	80	0.0250000
NODE_7529_length_956_cov_48.047841	532	612	20	1	80	0.0125000
NODE_7529_length_956_cov_48.047841	532	612	21	11	80	0.1375000
NODE_7529_length_956_cov_48.047841	608	688	14	12	80	0.1500000
NODE_7529_length_956_cov_48.047841	608	688	15	5	80	0.0625000
NODE_7529_length_956_cov_48.047841	608	688	16	4	80	0.0500000
NODE_7529_length_956_cov_48.047841	608	688	17	4	80	0.0500000
NODE_7529_length_956_cov_48.047841	608	688	18	3	80	0.0375000
NODE_7529_length_956_cov_48.047841	608	688	19	9	80	0.1125000
NODE_7529_length_956_cov_48.047841	608	688	20	6	80	0.0750000
NODE_7529_length_956_cov_48.047841	608	688	21	12	80	0.1500000
NODE_7529_length_956_cov_48.047841	608	688	22	23	80	0.2875000
NODE_7529_length_956_cov_48.047841	608	688	23	2	80	0.0250000
NODE_7529_length_956_cov_48.047841	661	741	11	4	80	0.0500000
NODE_7529_length_956_cov_48.047841	661	741	12	44	80	0.5500000
NODE_7529_length_956_cov_48.047841	661	741	13	2	80	0.0250000
NODE_7529_length_956_cov_48.047841	661	741	14	15	80	0.1875000
NODE_7529_length_956_cov_48.047841	661	741	15	5	80	0.0625000
NODE_7529_length_956_cov_48.047841	661	741	16	4	80	0.0500000
NODE_7529_length_956_cov_48.047841	661	741	19	6	80	0.0750000
NODE_7530_length_956_cov_34.539090	298	378	5	20	80	0.2500000
NODE_7530_length_956_cov_34.539090	298	378	6	16	80	0.2000000
NODE_7530_length_956_cov_34.539090	298	378	7	6	80	0.0750000
NODE_7530_length_956_cov_34.539090	298	378	8	30	80	0.3750000
NODE_7530_length_956_cov_34.539090	298	378	9	8	80	0.1000000
NODE_7530_length_956_cov_34.539090	351	431	7	6	80	0.0750000
NODE_7530_length_956_cov_34.539090	351	431	8	33	80	0.4125000
NODE_7530_length_956_cov_34.539090	351	431	9	41	80	0.5125000
NODE_7530_length_956_cov_34.539090	427	507	5	9	80	0.1125000
NODE_7530_length_956_cov_34.539090	427	507	6	23	80	0.2875000
NODE_7530_length_956_cov_34.539090	427	507	7	17	80	0.2125000
NODE_7530_length_956_cov_34.539090	427	507	9	22	80	0.2750000
NODE_7530_length_956_cov_34.539090	427	507	10	9	80	0.1125000
NODE_7530_length_956_cov_34.539090	480	560	5	9	80	0.1125000
NODE_7530_length_956_cov_34.539090	480	560	6	27	80	0.3375000
NODE_7530_length_956_cov_34.539090	480	560	7	13	80	0.1625000
NODE_7530_length_956_cov_34.539090	480	560	9	12	80	0.1500000
NODE_7530_length_956_cov_34.539090	480	560	10	19	80	0.2375000
NODE_7531_length_956_cov_24.355893	398	478	0	15	80	0.1875000
NODE_7531_length_956_cov_24.355893	398	478	1	34	80	0.4250000
NODE_7531_length_956_cov_24.355893	398	478	3	3	80	0.0375000
NODE_7531_length_956_cov_24.355893	398	478	4	1	80	0.0125000
NODE_7531_length_956_cov_24.355893	398	478	6	7	80	0.0875000
NODE_7531_length_956_cov_24.355893	398	478	7	3	80	0.0375000
NODE_7531_length_956_cov_24.355893	398	478	8	13	80	0.1625000
NODE_7531_length_956_cov_24.355893	398	478	9	4	80	0.0500000
NODE_7531_length_956_cov_24.355893	451	531	6	7	80	0.0875000
NODE_7531_length_956_cov_24.355893	451	531	7	3	80	0.0375000
NODE_7531_length_956_cov_24.355893	451	531	8	13	80	0.1625000
NODE_7531_length_956_cov_24.355893	451	531	9	57	80	0.7125000
NODE_7532_length_956_cov_21.940490	373	453	0	37	80	0.4625000
NODE_7532_length_956_cov_21.940490	373	453	1	43	80	0.5375000
NODE_7532_length_956_cov_21.940490	426	506	0	80	80	1.0000000
NODE_7532_length_956_cov_21.940490	502	582	0	80	80	1.0000000
NODE_7532_length_956_cov_21.940490	555	635	0	80	80	1.0000000
NODE_7533_length_956_cov_19.435239	274	354	2	44	80	0.5500000
NODE_7533_length_956_cov_19.435239	274	354	3	10	80	0.1250000
NODE_7533_length_956_cov_19.435239	274	354	4	9	80	0.1125000
NODE_7533_length_956_cov_19.435239	274	354	5	1	80	0.0125000
NODE_7533_length_956_cov_19.435239	274	354	6	16	80	0.2000000
NODE_7533_length_956_cov_19.435239	274	301	2	21	27	0.7777778
NODE_7533_length_956_cov_19.435239	274	301	3	6	27	0.2222222
NODE_7534_length_956_cov_17.819137	378	458	5	10	80	0.1250000
NODE_7534_length_956_cov_17.819137	378	458	6	27	80	0.3375000
NODE_7534_length_956_cov_17.819137	378	458	7	43	80	0.5375000
NODE_7534_length_956_cov_17.819137	431	511	3	2	80	0.0250000
NODE_7534_length_956_cov_17.819137	431	511	4	34	80	0.4250000
NODE_7534_length_956_cov_17.819137	431	511	5	26	80	0.3250000
NODE_7534_length_956_cov_17.819137	431	511	6	18	80	0.2250000
NODE_7535_length_956_cov_16.098016	551	631	0	3	80	0.0375000
NODE_7535_length_956_cov_16.098016	551	631	2	77	80	0.9625000
NODE_7535_length_956_cov_16.098016	604	684	0	56	80	0.7000000
NODE_7535_length_956_cov_16.098016	604	684	2	24	80	0.3000000
NODE_7536_length_956_cov_15.229872	490	570	6	18	80	0.2250000
NODE_7536_length_956_cov_15.229872	490	570	7	23	80	0.2875000
NODE_7536_length_956_cov_15.229872	490	570	8	39	80	0.4875000
NODE_7536_length_956_cov_15.229872	543	623	3	9	80	0.1125000
NODE_7536_length_956_cov_15.229872	543	623	5	30	80	0.3750000
NODE_7536_length_956_cov_15.229872	543	623	6	32	80	0.4000000
NODE_7536_length_956_cov_15.229872	543	623	8	9	80	0.1125000
NODE_7537_length_956_cov_7.533256	439	519	0	80	80	1.0000000
NODE_7537_length_956_cov_7.533256	497	572	0	75	75	1.0000000
NODE_7545_length_955_cov_30.821262	438	518	2	4	80	0.0500000
NODE_7545_length_955_cov_30.821262	438	518	3	19	80	0.2375000
NODE_7545_length_955_cov_30.821262	438	518	5	43	80	0.5375000
NODE_7545_length_955_cov_30.821262	438	518	7	2	80	0.0250000
NODE_7545_length_955_cov_30.821262	438	518	8	11	80	0.1375000
NODE_7545_length_955_cov_30.821262	438	518	9	1	80	0.0125000
NODE_7545_length_955_cov_30.821262	491	571	5	13	80	0.1625000
NODE_7545_length_955_cov_30.821262	491	571	7	2	80	0.0250000
NODE_7545_length_955_cov_30.821262	491	571	8	14	80	0.1750000
NODE_7545_length_955_cov_30.821262	491	571	9	39	80	0.4875000
NODE_7545_length_955_cov_30.821262	491	571	10	12	80	0.1500000
NODE_7546_length_955_cov_30.574766	380	460	0	26	80	0.3250000
NODE_7546_length_955_cov_30.574766	380	460	1	8	80	0.1000000
NODE_7546_length_955_cov_30.574766	380	460	3	24	80	0.3000000
NODE_7546_length_955_cov_30.574766	380	460	5	12	80	0.1500000
NODE_7546_length_955_cov_30.574766	380	460	6	10	80	0.1250000
NODE_7546_length_955_cov_30.574766	433	513	3	5	80	0.0625000
NODE_7546_length_955_cov_30.574766	433	513	4	8	80	0.1000000
NODE_7546_length_955_cov_30.574766	433	513	5	14	80	0.1750000
NODE_7546_length_955_cov_30.574766	433	513	6	53	80	0.6625000
NODE_7546_length_955_cov_30.574766	509	589	3	63	80	0.7875000
NODE_7546_length_955_cov_30.574766	509	589	4	5	80	0.0625000
NODE_7546_length_955_cov_30.574766	509	589	5	12	80	0.1500000
NODE_7546_length_955_cov_30.574766	562	642	2	42	80	0.5250000
NODE_7546_length_955_cov_30.574766	562	642	3	38	80	0.4750000
NODE_7547_length_955_cov_27.734813	373	453	5	23	80	0.2875000
NODE_7547_length_955_cov_27.734813	373	453	6	11	80	0.1375000
NODE_7547_length_955_cov_27.734813	373	453	7	46	80	0.5750000
NODE_7547_length_955_cov_27.734813	426	506	3	19	80	0.2375000
NODE_7547_length_955_cov_27.734813	426	506	4	1	80	0.0125000
NODE_7547_length_955_cov_27.734813	426	506	5	56	80	0.7000000
NODE_7547_length_955_cov_27.734813	426	506	7	4	80	0.0500000
NODE_7548_length_955_cov_24.475467	439	519	6	1	80	0.0125000
NODE_7548_length_955_cov_24.475467	439	519	7	8	80	0.1000000
NODE_7548_length_955_cov_24.475467	439	519	8	3	80	0.0375000
NODE_7548_length_955_cov_24.475467	439	519	9	11	80	0.1375000
NODE_7548_length_955_cov_24.475467	439	519	10	18	80	0.2250000
NODE_7548_length_955_cov_24.475467	439	519	11	15	80	0.1875000
NODE_7548_length_955_cov_24.475467	439	519	12	22	80	0.2750000
NODE_7548_length_955_cov_24.475467	439	519	13	2	80	0.0250000
NODE_7548_length_955_cov_24.475467	492	572	7	7	80	0.0875000
NODE_7548_length_955_cov_24.475467	492	572	9	14	80	0.1750000
NODE_7548_length_955_cov_24.475467	492	572	10	22	80	0.2750000
NODE_7548_length_955_cov_24.475467	492	572	11	5	80	0.0625000
NODE_7548_length_955_cov_24.475467	492	572	12	30	80	0.3750000
NODE_7548_length_955_cov_24.475467	492	572	13	2	80	0.0250000
NODE_7549_length_955_cov_22.146028	351	431	0	2	80	0.0250000
NODE_7549_length_955_cov_22.146028	351	431	2	14	80	0.1750000
NODE_7549_length_955_cov_22.146028	351	431	4	10	80	0.1250000
NODE_7549_length_955_cov_22.146028	351	431	5	22	80	0.2750000
NODE_7549_length_955_cov_22.146028	351	431	7	32	80	0.4000000
NODE_7549_length_955_cov_22.146028	404	484	6	19	80	0.2375000
NODE_7549_length_955_cov_22.146028	404	484	7	30	80	0.3750000
NODE_7549_length_955_cov_22.146028	404	484	8	31	80	0.3875000
NODE_7550_length_955_cov_16.212617	441	521	2	27	80	0.3375000
NODE_7550_length_955_cov_16.212617	441	521	3	27	80	0.3375000
NODE_7550_length_955_cov_16.212617	441	521	4	26	80	0.3250000
NODE_7550_length_955_cov_16.212617	494	574	3	80	80	1.0000000
NODE_7551_length_955_cov_13.334112	269	349	5	8	80	0.1000000
NODE_7551_length_955_cov_13.334112	269	349	6	58	80	0.7250000
NODE_7551_length_955_cov_13.334112	269	349	7	11	80	0.1375000
NODE_7551_length_955_cov_13.334112	269	349	8	3	80	0.0375000
NODE_7551_length_955_cov_13.334112	322	402	4	36	80	0.4500000
NODE_7551_length_955_cov_13.334112	322	402	5	4	80	0.0500000
NODE_7551_length_955_cov_13.334112	322	402	6	40	80	0.5000000
NODE_7552_length_955_cov_12.544393	363	443	6	22	80	0.2750000
NODE_7552_length_955_cov_12.544393	363	443	7	58	80	0.7250000
NODE_7552_length_955_cov_12.544393	416	496	1	4	80	0.0500000
NODE_7552_length_955_cov_12.544393	416	496	2	5	80	0.0625000
NODE_7552_length_955_cov_12.544393	416	496	3	35	80	0.4375000
NODE_7552_length_955_cov_12.544393	416	496	7	36	80	0.4500000
NODE_7553_length_955_cov_8.204439	358	438	0	3	80	0.0375000
NODE_7553_length_955_cov_8.204439	358	438	2	1	80	0.0125000
NODE_7553_length_955_cov_8.204439	358	438	4	2	80	0.0250000
NODE_7553_length_955_cov_8.204439	358	438	5	3	80	0.0375000
NODE_7553_length_955_cov_8.204439	358	438	6	65	80	0.8125000
NODE_7553_length_955_cov_8.204439	358	438	7	6	80	0.0750000
NODE_7553_length_955_cov_8.204439	411	491	0	56	80	0.7000000
NODE_7553_length_955_cov_8.204439	411	491	2	1	80	0.0125000
NODE_7553_length_955_cov_8.204439	411	491	4	2	80	0.0250000
NODE_7553_length_955_cov_8.204439	411	491	5	3	80	0.0375000
NODE_7553_length_955_cov_8.204439	411	491	6	18	80	0.2250000
NODE_7563_length_954_cov_35.691228	381	461	6	19	80	0.2375000
NODE_7563_length_954_cov_35.691228	381	461	7	4	80	0.0500000
NODE_7563_length_954_cov_35.691228	381	461	8	15	80	0.1875000
NODE_7563_length_954_cov_35.691228	381	461	10	42	80	0.5250000
NODE_7563_length_954_cov_35.691228	434	514	4	38	80	0.4750000
NODE_7563_length_954_cov_35.691228	434	514	6	34	80	0.4250000
NODE_7563_length_954_cov_35.691228	434	514	8	8	80	0.1000000
NODE_7564_length_954_cov_30.769591	408	488	5	3	80	0.0375000
NODE_7564_length_954_cov_30.769591	408	488	6	48	80	0.6000000
NODE_7564_length_954_cov_30.769591	408	488	7	1	80	0.0125000
NODE_7564_length_954_cov_30.769591	408	488	8	28	80	0.3500000
NODE_7564_length_954_cov_30.769591	461	541	7	45	80	0.5625000
NODE_7564_length_954_cov_30.769591	461	541	8	33	80	0.4125000
NODE_7564_length_954_cov_30.769591	461	541	10	2	80	0.0250000
NODE_7565_length_954_cov_27.247953	418	498	4	8	80	0.1000000
NODE_7565_length_954_cov_27.247953	418	498	5	1	80	0.0125000
NODE_7565_length_954_cov_27.247953	418	498	6	6	80	0.0750000
NODE_7565_length_954_cov_27.247953	418	498	7	6	80	0.0750000
NODE_7565_length_954_cov_27.247953	418	498	8	16	80	0.2000000
NODE_7565_length_954_cov_27.247953	418	498	9	43	80	0.5375000
NODE_7565_length_954_cov_27.247953	471	551	7	15	80	0.1875000
NODE_7565_length_954_cov_27.247953	471	551	8	22	80	0.2750000
NODE_7565_length_954_cov_27.247953	471	551	9	43	80	0.5375000
NODE_7566_length_954_cov_22.796491	270	350	7	8	80	0.1000000
NODE_7566_length_954_cov_22.796491	270	350	8	72	80	0.9000000
NODE_7566_length_954_cov_22.796491	323	403	0	7	80	0.0875000
NODE_7566_length_954_cov_22.796491	323	403	2	1	80	0.0125000
NODE_7566_length_954_cov_22.796491	323	403	8	44	80	0.5500000
NODE_7566_length_954_cov_22.796491	323	403	9	28	80	0.3500000
NODE_7567_length_954_cov_15.645614	337	417	6	17	80	0.2125000
NODE_7567_length_954_cov_15.645614	337	417	7	46	80	0.5750000
NODE_7567_length_954_cov_15.645614	337	417	8	17	80	0.2125000
NODE_7567_length_954_cov_15.645614	390	470	2	9	80	0.1125000
NODE_7567_length_954_cov_15.645614	390	470	3	24	80	0.3000000
NODE_7567_length_954_cov_15.645614	390	470	4	16	80	0.2000000
NODE_7567_length_954_cov_15.645614	390	470	5	2	80	0.0250000
NODE_7567_length_954_cov_15.645614	390	470	6	12	80	0.1500000
NODE_7567_length_954_cov_15.645614	390	470	7	17	80	0.2125000
NODE_7568_length_954_cov_13.538012	346	426	7	9	80	0.1125000
NODE_7568_length_954_cov_13.538012	346	426	8	15	80	0.1875000
NODE_7568_length_954_cov_13.538012	346	426	9	53	80	0.6625000
NODE_7568_length_954_cov_13.538012	346	426	10	3	80	0.0375000
NODE_7568_length_954_cov_13.538012	399	479	4	9	80	0.1125000
NODE_7568_length_954_cov_13.538012	399	479	6	23	80	0.2875000
NODE_7568_length_954_cov_13.538012	399	479	8	19	80	0.2375000
NODE_7568_length_954_cov_13.538012	399	479	9	29	80	0.3625000
NODE_7569_length_954_cov_12.162573	155	217	0	62	62	1.0000000
NODE_7570_length_954_cov_10.714620	239	319	2	1	80	0.0125000
NODE_7570_length_954_cov_10.714620	239	319	3	20	80	0.2500000
NODE_7570_length_954_cov_10.714620	239	319	4	19	80	0.2375000
NODE_7570_length_954_cov_10.714620	239	319	6	31	80	0.3875000
NODE_7570_length_954_cov_10.714620	239	319	7	9	80	0.1125000
NODE_7570_length_954_cov_10.714620	292	372	5	38	80	0.4750000
NODE_7570_length_954_cov_10.714620	292	372	6	33	80	0.4125000
NODE_7570_length_954_cov_10.714620	292	372	7	9	80	0.1125000
NODE_7571_length_954_cov_5.670175	431	511	2	10	80	0.1250000
NODE_7571_length_954_cov_5.670175	431	511	3	70	80	0.8750000
NODE_7571_length_954_cov_5.670175	484	564	2	60	80	0.7500000
NODE_7571_length_954_cov_5.670175	484	564	3	20	80	0.2500000
NODE_7582_length_953_cov_35.789227	425	505	6	14	80	0.1750000
NODE_7582_length_953_cov_35.789227	425	505	7	17	80	0.2125000
NODE_7582_length_953_cov_35.789227	425	505	8	24	80	0.3000000
NODE_7582_length_953_cov_35.789227	425	505	9	25	80	0.3125000
NODE_7582_length_953_cov_35.789227	478	558	5	9	80	0.1125000
NODE_7582_length_953_cov_35.789227	478	558	6	10	80	0.1250000
NODE_7582_length_953_cov_35.789227	478	558	7	5	80	0.0625000
NODE_7582_length_953_cov_35.789227	478	558	8	19	80	0.2375000
NODE_7582_length_953_cov_35.789227	478	558	9	37	80	0.4625000
NODE_7583_length_953_cov_33.940281	430	510	5	3	80	0.0375000
NODE_7583_length_953_cov_33.940281	430	510	7	14	80	0.1750000
NODE_7583_length_953_cov_33.940281	430	510	8	9	80	0.1125000
NODE_7583_length_953_cov_33.940281	430	510	9	17	80	0.2125000
NODE_7583_length_953_cov_33.940281	430	510	10	37	80	0.4625000
NODE_7583_length_953_cov_33.940281	483	563	1	11	80	0.1375000
NODE_7583_length_953_cov_33.940281	483	563	3	8	80	0.1000000
NODE_7583_length_953_cov_33.940281	483	563	4	3	80	0.0375000
NODE_7583_length_953_cov_33.940281	483	563	5	21	80	0.2625000
NODE_7583_length_953_cov_33.940281	483	563	6	13	80	0.1625000
NODE_7583_length_953_cov_33.940281	483	563	7	14	80	0.1750000
NODE_7583_length_953_cov_33.940281	483	563	9	10	80	0.1250000
NODE_7584_length_953_cov_26.844262	333	413	0	80	80	1.0000000
NODE_7584_length_953_cov_26.844262	386	466	0	57	80	0.7125000
NODE_7584_length_953_cov_26.844262	386	466	1	16	80	0.2000000
NODE_7584_length_953_cov_26.844262	386	466	2	7	80	0.0875000
NODE_7584_length_953_cov_26.844262	462	542	2	14	80	0.1750000
NODE_7584_length_953_cov_26.844262	462	542	4	8	80	0.1000000
NODE_7584_length_953_cov_26.844262	462	542	6	35	80	0.4375000
NODE_7584_length_953_cov_26.844262	462	542	8	13	80	0.1625000
NODE_7584_length_953_cov_26.844262	462	542	9	10	80	0.1250000
NODE_7584_length_953_cov_26.844262	515	595	4	2	80	0.0250000
NODE_7584_length_953_cov_26.844262	515	595	5	10	80	0.1250000
NODE_7584_length_953_cov_26.844262	515	595	6	4	80	0.0500000
NODE_7584_length_953_cov_26.844262	515	595	7	22	80	0.2750000
NODE_7584_length_953_cov_26.844262	515	595	8	13	80	0.1625000
NODE_7584_length_953_cov_26.844262	515	595	9	29	80	0.3625000
NODE_7585_length_953_cov_20.770492	301	381	4	2	80	0.0250000
NODE_7585_length_953_cov_20.770492	301	381	5	21	80	0.2625000
NODE_7585_length_953_cov_20.770492	301	381	6	5	80	0.0625000
NODE_7585_length_953_cov_20.770492	301	381	8	20	80	0.2500000
NODE_7585_length_953_cov_20.770492	301	381	13	23	80	0.2875000
NODE_7585_length_953_cov_20.770492	301	381	14	4	80	0.0500000
NODE_7585_length_953_cov_20.770492	301	381	15	5	80	0.0625000
NODE_7585_length_953_cov_20.770492	354	434	13	18	80	0.2250000
NODE_7585_length_953_cov_20.770492	354	434	14	29	80	0.3625000
NODE_7585_length_953_cov_20.770492	354	434	15	9	80	0.1125000
NODE_7585_length_953_cov_20.770492	354	434	16	24	80	0.3000000
NODE_7586_length_953_cov_17.514052	421	501	0	80	80	1.0000000
NODE_7586_length_953_cov_17.514052	474	554	0	80	80	1.0000000
NODE_7586_length_953_cov_17.514052	550	630	0	14	80	0.1750000
NODE_7586_length_953_cov_17.514052	550	630	1	17	80	0.2125000
NODE_7586_length_953_cov_17.514052	550	630	2	27	80	0.3375000
NODE_7586_length_953_cov_17.514052	550	630	3	22	80	0.2750000
NODE_7586_length_953_cov_17.514052	603	683	2	5	80	0.0625000
NODE_7586_length_953_cov_17.514052	603	683	3	30	80	0.3750000
NODE_7586_length_953_cov_17.514052	603	683	4	45	80	0.5625000
NODE_7587_length_953_cov_11.579625	332	412	1	11	80	0.1375000
NODE_7587_length_953_cov_11.579625	332	412	2	12	80	0.1500000
NODE_7587_length_953_cov_11.579625	332	412	3	14	80	0.1750000
NODE_7587_length_953_cov_11.579625	332	412	5	2	80	0.0250000
NODE_7587_length_953_cov_11.579625	332	412	6	36	80	0.4500000
NODE_7587_length_953_cov_11.579625	332	412	8	5	80	0.0625000
NODE_7587_length_953_cov_11.579625	385	465	6	22	80	0.2750000
NODE_7587_length_953_cov_11.579625	385	465	8	7	80	0.0875000
NODE_7587_length_953_cov_11.579625	385	465	10	51	80	0.6375000
NODE_7588_length_953_cov_7.281030	276	356	0	52	80	0.6500000
NODE_7588_length_953_cov_7.281030	276	356	2	28	80	0.3500000
NODE_7588_length_953_cov_7.281030	329	409	2	54	80	0.6750000
NODE_7588_length_953_cov_7.281030	329	409	3	26	80	0.3250000
NODE_7599_length_952_cov_44.880422	447	527	9	7	80	0.0875000
NODE_7599_length_952_cov_44.880422	447	527	10	16	80	0.2000000
NODE_7599_length_952_cov_44.880422	447	527	11	57	80	0.7125000
NODE_7599_length_952_cov_44.880422	500	580	2	26	80	0.3250000
NODE_7599_length_952_cov_44.880422	500	580	4	7	80	0.0875000
NODE_7599_length_952_cov_44.880422	500	580	6	5	80	0.0625000
NODE_7599_length_952_cov_44.880422	500	580	8	11	80	0.1375000
NODE_7599_length_952_cov_44.880422	500	580	9	3	80	0.0375000
NODE_7599_length_952_cov_44.880422	500	580	10	9	80	0.1125000
NODE_7599_length_952_cov_44.880422	500	580	11	19	80	0.2375000
NODE_7599_length_952_cov_44.880422	871	951	0	80	80	1.0000000
NODE_7600_length_952_cov_42.485346	402	482	6	51	80	0.6375000
NODE_7600_length_952_cov_42.485346	402	482	8	29	80	0.3625000
NODE_7600_length_952_cov_42.485346	455	535	2	4	80	0.0500000
NODE_7600_length_952_cov_42.485346	455	535	6	22	80	0.2750000
NODE_7600_length_952_cov_42.485346	455	535	8	54	80	0.6750000
NODE_7601_length_952_cov_40.065651	422	502	7	6	80	0.0750000
NODE_7601_length_952_cov_40.065651	422	502	8	23	80	0.2875000
NODE_7601_length_952_cov_40.065651	422	502	9	22	80	0.2750000
NODE_7601_length_952_cov_40.065651	422	502	10	10	80	0.1250000
NODE_7601_length_952_cov_40.065651	422	502	11	19	80	0.2375000
NODE_7601_length_952_cov_40.065651	475	555	7	3	80	0.0375000
NODE_7601_length_952_cov_40.065651	475	555	8	20	80	0.2500000
NODE_7601_length_952_cov_40.065651	475	555	9	25	80	0.3125000
NODE_7601_length_952_cov_40.065651	475	555	10	13	80	0.1625000
NODE_7601_length_952_cov_40.065651	475	555	11	19	80	0.2375000
NODE_7602_length_952_cov_34.813599	308	388	5	7	80	0.0875000
NODE_7602_length_952_cov_34.813599	308	388	6	10	80	0.1250000
NODE_7602_length_952_cov_34.813599	308	388	7	9	80	0.1125000
NODE_7602_length_952_cov_34.813599	308	388	8	43	80	0.5375000
NODE_7602_length_952_cov_34.813599	308	388	9	11	80	0.1375000
NODE_7602_length_952_cov_34.813599	361	441	6	9	80	0.1125000
NODE_7602_length_952_cov_34.813599	361	441	7	3	80	0.0375000
NODE_7602_length_952_cov_34.813599	361	441	8	23	80	0.2875000
NODE_7602_length_952_cov_34.813599	361	441	9	19	80	0.2375000
NODE_7602_length_952_cov_34.813599	361	441	10	26	80	0.3250000
NODE_7603_length_952_cov_28.055100	661	741	10	12	80	0.1500000
NODE_7603_length_952_cov_28.055100	661	741	11	14	80	0.1750000
NODE_7603_length_952_cov_28.055100	661	741	12	54	80	0.6750000
NODE_7603_length_952_cov_28.055100	714	794	11	18	80	0.2250000
NODE_7603_length_952_cov_28.055100	714	794	12	33	80	0.4125000
NODE_7603_length_952_cov_28.055100	714	794	13	18	80	0.2250000
NODE_7603_length_952_cov_28.055100	714	794	14	1	80	0.0125000
NODE_7603_length_952_cov_28.055100	714	794	15	10	80	0.1250000
NODE_7604_length_952_cov_23.739742	435	515	3	19	80	0.2375000
NODE_7604_length_952_cov_23.739742	435	515	4	49	80	0.6125000
NODE_7604_length_952_cov_23.739742	435	515	6	12	80	0.1500000
NODE_7604_length_952_cov_23.739742	488	568	3	3	80	0.0375000
NODE_7604_length_952_cov_23.739742	488	568	4	15	80	0.1875000
NODE_7604_length_952_cov_23.739742	488	568	5	44	80	0.5500000
NODE_7604_length_952_cov_23.739742	488	568	6	18	80	0.2250000
NODE_7606_length_952_cov_11.478312	245	324	5	4	79	0.0506329
NODE_7606_length_952_cov_11.478312	245	324	6	7	79	0.0886076
NODE_7606_length_952_cov_11.478312	245	324	8	1	79	0.0126582
NODE_7606_length_952_cov_11.478312	245	324	9	22	79	0.2784810
NODE_7606_length_952_cov_11.478312	245	324	11	34	79	0.4303797
NODE_7606_length_952_cov_11.478312	245	324	12	11	79	0.1392405
NODE_7606_length_952_cov_11.478312	297	377	6	14	80	0.1750000
NODE_7606_length_952_cov_11.478312	297	377	7	7	80	0.0875000
NODE_7606_length_952_cov_11.478312	297	377	8	1	80	0.0125000
NODE_7606_length_952_cov_11.478312	297	377	9	9	80	0.1125000
NODE_7606_length_952_cov_11.478312	297	377	11	28	80	0.3500000
NODE_7606_length_952_cov_11.478312	297	377	12	21	80	0.2625000
NODE_7607_length_952_cov_11.284877	272	352	0	80	80	1.0000000
NODE_7607_length_952_cov_11.284877	325	405	0	80	80	1.0000000
NODE_7608_length_952_cov_10.807737	458	538	2	5	80	0.0625000
NODE_7608_length_952_cov_10.807737	458	538	3	70	80	0.8750000
NODE_7608_length_952_cov_10.807737	458	538	4	5	80	0.0625000
NODE_7608_length_952_cov_10.807737	511	591	2	8	80	0.1000000
NODE_7608_length_952_cov_10.807737	511	591	3	72	80	0.9000000
NODE_7609_length_952_cov_8.770223	375	455	0	80	80	1.0000000
NODE_7609_length_952_cov_8.770223	428	508	0	64	80	0.8000000
NODE_7609_length_952_cov_8.770223	428	508	1	16	80	0.2000000
NODE_7623_length_951_cov_54.397887	354	434	4	7	80	0.0875000
NODE_7623_length_951_cov_54.397887	354	434	5	2	80	0.0250000
NODE_7623_length_951_cov_54.397887	354	434	6	34	80	0.4250000
NODE_7623_length_951_cov_54.397887	354	434	7	16	80	0.2000000
NODE_7623_length_951_cov_54.397887	354	434	9	2	80	0.0250000
NODE_7623_length_951_cov_54.397887	354	434	10	11	80	0.1375000
NODE_7623_length_951_cov_54.397887	354	434	11	3	80	0.0375000
NODE_7623_length_951_cov_54.397887	354	434	12	2	80	0.0250000
NODE_7623_length_951_cov_54.397887	354	434	13	3	80	0.0375000
NODE_7623_length_951_cov_54.397887	407	487	6	4	80	0.0500000
NODE_7623_length_951_cov_54.397887	407	487	7	2	80	0.0250000
NODE_7623_length_951_cov_54.397887	407	487	9	2	80	0.0250000
NODE_7623_length_951_cov_54.397887	407	487	10	11	80	0.1375000
NODE_7623_length_951_cov_54.397887	407	487	11	10	80	0.1250000
NODE_7623_length_951_cov_54.397887	407	487	12	38	80	0.4750000
NODE_7623_length_951_cov_54.397887	407	487	13	13	80	0.1625000
NODE_7623_length_951_cov_54.397887	483	563	10	19	80	0.2375000
NODE_7623_length_951_cov_54.397887	483	563	11	40	80	0.5000000
NODE_7623_length_951_cov_54.397887	483	563	12	21	80	0.2625000
NODE_7623_length_951_cov_54.397887	544	616	4	14	72	0.1944444
NODE_7623_length_951_cov_54.397887	544	616	5	24	72	0.3333333
NODE_7623_length_951_cov_54.397887	544	616	6	2	72	0.0277778
NODE_7623_length_951_cov_54.397887	544	616	7	11	72	0.1527778
NODE_7623_length_951_cov_54.397887	544	616	8	2	72	0.0277778
NODE_7623_length_951_cov_54.397887	544	616	10	4	72	0.0555556
NODE_7623_length_951_cov_54.397887	544	616	11	15	72	0.2083333
NODE_7624_length_951_cov_47.881455	355	435	3	7	80	0.0875000
NODE_7624_length_951_cov_47.881455	355	435	4	2	80	0.0250000
NODE_7624_length_951_cov_47.881455	355	435	5	7	80	0.0875000
NODE_7624_length_951_cov_47.881455	355	435	6	14	80	0.1750000
NODE_7624_length_951_cov_47.881455	355	435	7	35	80	0.4375000
NODE_7624_length_951_cov_47.881455	355	435	8	15	80	0.1875000
NODE_7624_length_951_cov_47.881455	408	488	6	26	80	0.3250000
NODE_7624_length_951_cov_47.881455	408	488	7	14	80	0.1750000
NODE_7624_length_951_cov_47.881455	408	488	8	15	80	0.1875000
NODE_7624_length_951_cov_47.881455	408	488	9	4	80	0.0500000
NODE_7624_length_951_cov_47.881455	408	488	10	10	80	0.1250000
NODE_7624_length_951_cov_47.881455	408	488	11	11	80	0.1375000
NODE_7624_length_951_cov_47.881455	484	564	5	3	80	0.0375000
NODE_7624_length_951_cov_47.881455	484	564	7	25	80	0.3125000
NODE_7624_length_951_cov_47.881455	484	564	8	15	80	0.1875000
NODE_7624_length_951_cov_47.881455	484	564	9	7	80	0.0875000
NODE_7624_length_951_cov_47.881455	484	564	10	14	80	0.1750000
NODE_7624_length_951_cov_47.881455	484	564	11	16	80	0.2000000
NODE_7624_length_951_cov_47.881455	537	617	5	3	80	0.0375000
NODE_7624_length_951_cov_47.881455	537	617	7	47	80	0.5875000
NODE_7624_length_951_cov_47.881455	537	617	8	30	80	0.3750000
NODE_7625_length_951_cov_24.322770	479	559	3	80	80	1.0000000
NODE_7625_length_951_cov_24.322770	532	612	0	24	80	0.3000000
NODE_7625_length_951_cov_24.322770	532	612	1	2	80	0.0250000
NODE_7625_length_951_cov_24.322770	532	612	2	18	80	0.2250000
NODE_7625_length_951_cov_24.322770	532	612	3	36	80	0.4500000
NODE_7626_length_951_cov_23.001174	470	550	6	13	80	0.1625000
NODE_7626_length_951_cov_23.001174	470	550	8	20	80	0.2500000
NODE_7626_length_951_cov_23.001174	470	550	9	14	80	0.1750000
NODE_7626_length_951_cov_23.001174	470	550	11	2	80	0.0250000
NODE_7626_length_951_cov_23.001174	470	550	12	20	80	0.2500000
NODE_7626_length_951_cov_23.001174	470	550	14	11	80	0.1375000
NODE_7626_length_951_cov_23.001174	523	603	9	5	80	0.0625000
NODE_7626_length_951_cov_23.001174	523	603	10	7	80	0.0875000
NODE_7626_length_951_cov_23.001174	523	603	12	26	80	0.3250000
NODE_7626_length_951_cov_23.001174	523	603	14	42	80	0.5250000
NODE_7627_length_951_cov_22.059859	562	642	4	13	80	0.1625000
NODE_7627_length_951_cov_22.059859	562	642	5	67	80	0.8375000
NODE_7627_length_951_cov_22.059859	615	695	1	36	80	0.4500000
NODE_7627_length_951_cov_22.059859	615	695	3	14	80	0.1750000
NODE_7627_length_951_cov_22.059859	615	695	5	30	80	0.3750000
NODE_7628_length_951_cov_19.413146	456	536	6	7	80	0.0875000
NODE_7628_length_951_cov_19.413146	456	536	7	15	80	0.1875000
NODE_7628_length_951_cov_19.413146	456	536	8	35	80	0.4375000
NODE_7628_length_951_cov_19.413146	456	536	9	23	80	0.2875000
NODE_7628_length_951_cov_19.413146	509	589	3	23	80	0.2875000
NODE_7628_length_951_cov_19.413146	509	589	4	3	80	0.0375000
NODE_7628_length_951_cov_19.413146	509	589	5	5	80	0.0625000
NODE_7628_length_951_cov_19.413146	509	589	6	29	80	0.3625000
NODE_7628_length_951_cov_19.413146	509	589	7	15	80	0.1875000
NODE_7628_length_951_cov_19.413146	509	589	9	5	80	0.0625000
NODE_7628_length_951_cov_19.413146	830	877	0	47	47	1.0000000
NODE_7629_length_951_cov_18.970657	384	464	1	38	80	0.4750000
NODE_7629_length_951_cov_18.970657	384	464	2	35	80	0.4375000
NODE_7629_length_951_cov_18.970657	384	464	3	7	80	0.0875000
NODE_7629_length_951_cov_18.970657	437	517	1	18	80	0.2250000
NODE_7629_length_951_cov_18.970657	437	517	2	40	80	0.5000000
NODE_7629_length_951_cov_18.970657	437	517	3	11	80	0.1375000
NODE_7629_length_951_cov_18.970657	437	517	4	10	80	0.1250000
NODE_7629_length_951_cov_18.970657	437	517	5	1	80	0.0125000
NODE_7629_length_951_cov_18.970657	513	593	3	15	80	0.1875000
NODE_7629_length_951_cov_18.970657	513	593	4	23	80	0.2875000
NODE_7629_length_951_cov_18.970657	513	593	5	42	80	0.5250000
NODE_7629_length_951_cov_18.970657	566	646	3	7	80	0.0875000
NODE_7629_length_951_cov_18.970657	566	646	4	73	80	0.9125000
NODE_7630_length_951_cov_17.164319	409	490	4	30	81	0.3703704
NODE_7630_length_951_cov_17.164319	409	490	5	21	81	0.2592593
NODE_7630_length_951_cov_17.164319	409	490	6	26	81	0.3209876
NODE_7630_length_951_cov_17.164319	409	490	7	4	81	0.0493827
NODE_7630_length_951_cov_17.164319	463	543	4	60	80	0.7500000
NODE_7630_length_951_cov_17.164319	463	543	5	9	80	0.1125000
NODE_7630_length_951_cov_17.164319	463	543	6	11	80	0.1375000
NODE_7631_length_951_cov_17.009390	393	473	5	29	80	0.3625000
NODE_7631_length_951_cov_17.009390	393	473	6	19	80	0.2375000
NODE_7631_length_951_cov_17.009390	393	473	8	28	80	0.3500000
NODE_7631_length_951_cov_17.009390	393	473	9	4	80	0.0500000
NODE_7631_length_951_cov_17.009390	446	526	6	17	80	0.2125000
NODE_7631_length_951_cov_17.009390	446	526	7	12	80	0.1500000
NODE_7631_length_951_cov_17.009390	446	526	8	47	80	0.5875000
NODE_7631_length_951_cov_17.009390	446	526	9	4	80	0.0500000
NODE_7632_length_951_cov_15.551643	520	600	5	12	80	0.1500000
NODE_7632_length_951_cov_15.551643	520	600	6	9	80	0.1125000
NODE_7632_length_951_cov_15.551643	520	600	7	5	80	0.0625000
NODE_7632_length_951_cov_15.551643	520	600	9	54	80	0.6750000
NODE_7632_length_951_cov_15.551643	573	653	3	13	80	0.1625000
NODE_7632_length_951_cov_15.551643	573	653	5	10	80	0.1250000
NODE_7632_length_951_cov_15.551643	573	653	6	7	80	0.0875000
NODE_7632_length_951_cov_15.551643	573	653	8	7	80	0.0875000
NODE_7632_length_951_cov_15.551643	573	653	9	43	80	0.5375000
NODE_7633_length_951_cov_13.562207	364	444	3	39	80	0.4875000
NODE_7633_length_951_cov_13.562207	364	444	4	41	80	0.5125000
NODE_7633_length_951_cov_13.562207	417	497	1	25	80	0.3125000
NODE_7633_length_951_cov_13.562207	417	497	3	43	80	0.5375000
NODE_7633_length_951_cov_13.562207	417	497	4	12	80	0.1500000
NODE_7634_length_951_cov_13.086854	450	530	0	16	80	0.2000000
NODE_7634_length_951_cov_13.086854	450	530	1	50	80	0.6250000
NODE_7634_length_951_cov_13.086854	450	530	2	14	80	0.1750000
NODE_7634_length_951_cov_13.086854	503	583	0	69	80	0.8625000
NODE_7634_length_951_cov_13.086854	503	583	1	11	80	0.1375000
NODE_7635_length_951_cov_6.812207	350	430	6	6	80	0.0750000
NODE_7635_length_951_cov_6.812207	350	430	7	49	80	0.6125000
NODE_7635_length_951_cov_6.812207	350	430	8	25	80	0.3125000
NODE_7635_length_951_cov_6.812207	403	483	2	9	80	0.1125000
NODE_7635_length_951_cov_6.812207	403	483	3	32	80	0.4000000
NODE_7635_length_951_cov_6.812207	403	483	5	9	80	0.1125000
NODE_7635_length_951_cov_6.812207	403	483	7	30	80	0.3750000
NODE_7636_length_951_cov_5.076291	80	160	3	2	80	0.0250000
NODE_7636_length_951_cov_5.076291	80	160	4	24	80	0.3000000
NODE_7636_length_951_cov_5.076291	80	160	5	22	80	0.2750000
NODE_7636_length_951_cov_5.076291	80	160	7	26	80	0.3250000
NODE_7636_length_951_cov_5.076291	80	160	9	6	80	0.0750000
NODE_7636_length_951_cov_5.076291	133	213	7	23	80	0.2875000
NODE_7636_length_951_cov_5.076291	133	213	8	48	80	0.6000000
NODE_7636_length_951_cov_5.076291	133	213	9	9	80	0.1125000
NODE_7649_length_950_cov_62.151586	731	794	4	4	63	0.0634921
NODE_7649_length_950_cov_62.151586	731	794	5	17	63	0.2698413
NODE_7649_length_950_cov_62.151586	731	794	6	11	63	0.1746032
NODE_7649_length_950_cov_62.151586	731	794	7	27	63	0.4285714
NODE_7649_length_950_cov_62.151586	731	794	8	1	63	0.0158730
NODE_7649_length_950_cov_62.151586	731	794	9	3	63	0.0476190
NODE_7650_length_950_cov_56.088132	354	434	11	1	80	0.0125000
NODE_7650_length_950_cov_56.088132	354	434	12	25	80	0.3125000
NODE_7650_length_950_cov_56.088132	354	434	13	27	80	0.3375000
NODE_7650_length_950_cov_56.088132	354	434	14	27	80	0.3375000
NODE_7650_length_950_cov_56.088132	407	487	12	6	80	0.0750000
NODE_7650_length_950_cov_56.088132	407	487	13	25	80	0.3125000
NODE_7650_length_950_cov_56.088132	407	487	14	33	80	0.4125000
NODE_7650_length_950_cov_56.088132	407	487	16	10	80	0.1250000
NODE_7650_length_950_cov_56.088132	407	487	17	1	80	0.0125000
NODE_7650_length_950_cov_56.088132	407	487	18	5	80	0.0625000
NODE_7650_length_950_cov_56.088132	483	563	11	18	80	0.2250000
NODE_7650_length_950_cov_56.088132	483	563	12	1	80	0.0125000
NODE_7650_length_950_cov_56.088132	483	563	13	16	80	0.2000000
NODE_7650_length_950_cov_56.088132	483	563	14	15	80	0.1875000
NODE_7650_length_950_cov_56.088132	483	563	15	11	80	0.1375000
NODE_7650_length_950_cov_56.088132	483	563	16	19	80	0.2375000
NODE_7650_length_950_cov_56.088132	536	616	11	6	80	0.0750000
NODE_7650_length_950_cov_56.088132	536	616	12	24	80	0.3000000
NODE_7650_length_950_cov_56.088132	536	616	13	25	80	0.3125000
NODE_7650_length_950_cov_56.088132	536	616	14	10	80	0.1250000
NODE_7650_length_950_cov_56.088132	536	616	15	8	80	0.1000000
NODE_7650_length_950_cov_56.088132	536	616	16	7	80	0.0875000
NODE_7651_length_950_cov_29.780259	501	581	7	22	80	0.2750000
NODE_7651_length_950_cov_29.780259	501	581	8	28	80	0.3500000
NODE_7651_length_950_cov_29.780259	501	581	9	6	80	0.0750000
NODE_7651_length_950_cov_29.780259	501	581	10	19	80	0.2375000
NODE_7651_length_950_cov_29.780259	501	581	11	5	80	0.0625000
NODE_7651_length_950_cov_29.780259	554	634	8	18	80	0.2250000
NODE_7651_length_950_cov_29.780259	554	634	9	38	80	0.4750000
NODE_7651_length_950_cov_29.780259	554	634	10	24	80	0.3000000
NODE_7652_length_950_cov_27.278496	388	468	0	80	80	1.0000000
NODE_7652_length_950_cov_27.278496	441	519	0	78	78	1.0000000
NODE_7653_length_950_cov_26.766157	322	402	2	16	80	0.2000000
NODE_7653_length_950_cov_26.766157	322	402	3	25	80	0.3125000
NODE_7653_length_950_cov_26.766157	322	402	5	7	80	0.0875000
NODE_7653_length_950_cov_26.766157	322	402	6	19	80	0.2375000
NODE_7653_length_950_cov_26.766157	322	402	7	7	80	0.0875000
NODE_7653_length_950_cov_26.766157	322	402	8	6	80	0.0750000
NODE_7653_length_950_cov_26.766157	375	455	6	16	80	0.2000000
NODE_7653_length_950_cov_26.766157	375	455	7	44	80	0.5500000
NODE_7653_length_950_cov_26.766157	375	455	8	20	80	0.2500000
NODE_7653_length_950_cov_26.766157	451	531	6	30	80	0.3750000
NODE_7653_length_950_cov_26.766157	451	531	7	35	80	0.4375000
NODE_7653_length_950_cov_26.766157	451	531	8	14	80	0.1750000
NODE_7653_length_950_cov_26.766157	451	531	9	1	80	0.0125000
NODE_7653_length_950_cov_26.766157	504	584	4	40	80	0.5000000
NODE_7653_length_950_cov_26.766157	504	584	5	5	80	0.0625000
NODE_7653_length_950_cov_26.766157	504	584	6	22	80	0.2750000
NODE_7653_length_950_cov_26.766157	504	584	7	13	80	0.1625000
NODE_7654_length_950_cov_19.638073	421	501	1	15	80	0.1875000
NODE_7654_length_950_cov_19.638073	421	501	2	9	80	0.1125000
NODE_7654_length_950_cov_19.638073	421	501	3	16	80	0.2000000
NODE_7654_length_950_cov_19.638073	421	501	4	29	80	0.3625000
NODE_7654_length_950_cov_19.638073	421	501	5	6	80	0.0750000
NODE_7654_length_950_cov_19.638073	421	501	6	5	80	0.0625000
NODE_7654_length_950_cov_19.638073	474	554	4	16	80	0.2000000
NODE_7654_length_950_cov_19.638073	474	554	5	6	80	0.0750000
NODE_7654_length_950_cov_19.638073	474	554	6	58	80	0.7250000
NODE_7654_length_950_cov_19.638073	550	630	5	6	80	0.0750000
NODE_7654_length_950_cov_19.638073	550	630	6	45	80	0.5625000
NODE_7654_length_950_cov_19.638073	550	630	7	23	80	0.2875000
NODE_7654_length_950_cov_19.638073	550	630	8	6	80	0.0750000
NODE_7654_length_950_cov_19.638073	603	683	5	37	80	0.4625000
NODE_7654_length_950_cov_19.638073	603	683	6	8	80	0.1000000
NODE_7654_length_950_cov_19.638073	603	683	7	29	80	0.3625000
NODE_7654_length_950_cov_19.638073	603	683	8	6	80	0.0750000
NODE_7655_length_950_cov_14.686251	376	456	1	38	80	0.4750000
NODE_7655_length_950_cov_14.686251	376	456	2	24	80	0.3000000
NODE_7655_length_950_cov_14.686251	376	456	3	18	80	0.2250000
NODE_7655_length_950_cov_14.686251	429	509	2	40	80	0.5000000
NODE_7655_length_950_cov_14.686251	429	509	3	40	80	0.5000000
NODE_7656_length_950_cov_14.215041	339	419	2	24	80	0.3000000
NODE_7656_length_950_cov_14.215041	339	419	3	16	80	0.2000000
NODE_7656_length_950_cov_14.215041	339	419	4	40	80	0.5000000
NODE_7656_length_950_cov_14.215041	392	472	2	17	80	0.2125000
NODE_7656_length_950_cov_14.215041	392	472	4	63	80	0.7875000
NODE_7657_length_950_cov_6.397180	370	450	6	4	80	0.0500000
NODE_7657_length_950_cov_6.397180	370	450	7	23	80	0.2875000
NODE_7657_length_950_cov_6.397180	370	450	8	53	80	0.6625000
NODE_7657_length_950_cov_6.397180	423	504	4	1	81	0.0123457
NODE_7657_length_950_cov_6.397180	423	504	5	1	81	0.0123457
NODE_7657_length_950_cov_6.397180	423	504	6	21	81	0.2592593
NODE_7657_length_950_cov_6.397180	423	504	7	12	81	0.1481481
NODE_7657_length_950_cov_6.397180	423	504	8	46	81	0.5679013
NODE_7659_length_950_cov_4.430082	594	674	0	80	80	1.0000000
NODE_7659_length_950_cov_4.430082	647	727	0	80	80	1.0000000
NODE_7672_length_949_cov_25.550588	371	451	0	78	80	0.9750000
NODE_7672_length_949_cov_25.550588	371	451	2	2	80	0.0250000
NODE_7672_length_949_cov_25.550588	500	580	4	10	80	0.1250000
NODE_7672_length_949_cov_25.550588	500	580	6	14	80	0.1750000
NODE_7672_length_949_cov_25.550588	500	580	8	56	80	0.7000000
NODE_7672_length_949_cov_25.550588	553	633	4	17	80	0.2125000
NODE_7672_length_949_cov_25.550588	553	633	6	17	80	0.2125000
NODE_7672_length_949_cov_25.550588	553	633	7	1	80	0.0125000
NODE_7672_length_949_cov_25.550588	553	633	8	45	80	0.5625000
NODE_7673_length_949_cov_20.949412	252	332	5	16	80	0.2000000
NODE_7673_length_949_cov_20.949412	252	332	6	13	80	0.1625000
NODE_7673_length_949_cov_20.949412	252	332	7	21	80	0.2625000
NODE_7673_length_949_cov_20.949412	252	332	8	11	80	0.1375000
NODE_7673_length_949_cov_20.949412	252	332	9	19	80	0.2375000
NODE_7673_length_949_cov_20.949412	305	385	6	1	80	0.0125000
NODE_7673_length_949_cov_20.949412	305	385	7	34	80	0.4250000
NODE_7673_length_949_cov_20.949412	305	385	8	7	80	0.0875000
NODE_7673_length_949_cov_20.949412	305	385	9	38	80	0.4750000
NODE_7674_length_949_cov_20.601176	364	444	7	5	80	0.0625000
NODE_7674_length_949_cov_20.601176	364	444	8	16	80	0.2000000
NODE_7674_length_949_cov_20.601176	364	444	10	59	80	0.7375000
NODE_7674_length_949_cov_20.601176	417	497	4	13	80	0.1625000
NODE_7674_length_949_cov_20.601176	417	497	6	1	80	0.0125000
NODE_7674_length_949_cov_20.601176	417	497	8	44	80	0.5500000
NODE_7674_length_949_cov_20.601176	417	497	10	22	80	0.2750000
NODE_7674_length_949_cov_20.601176	493	573	2	50	80	0.6250000
NODE_7674_length_949_cov_20.601176	493	573	4	7	80	0.0875000
NODE_7674_length_949_cov_20.601176	493	573	5	6	80	0.0750000
NODE_7674_length_949_cov_20.601176	493	573	6	17	80	0.2125000
NODE_7674_length_949_cov_20.601176	546	626	2	80	80	1.0000000
NODE_7675_length_949_cov_20.575294	481	561	0	80	80	1.0000000
NODE_7675_length_949_cov_20.575294	534	614	0	80	80	1.0000000
NODE_7676_length_949_cov_19.483529	340	420	6	3	80	0.0375000
NODE_7676_length_949_cov_19.483529	340	420	7	1	80	0.0125000
NODE_7676_length_949_cov_19.483529	340	420	8	4	80	0.0500000
NODE_7676_length_949_cov_19.483529	340	420	10	46	80	0.5750000
NODE_7676_length_949_cov_19.483529	340	420	12	26	80	0.3250000
NODE_7676_length_949_cov_19.483529	393	473	6	5	80	0.0625000
NODE_7676_length_949_cov_19.483529	393	473	8	3	80	0.0375000
NODE_7676_length_949_cov_19.483529	393	473	10	70	80	0.8750000
NODE_7676_length_949_cov_19.483529	393	473	12	2	80	0.0250000
NODE_7676_length_949_cov_19.483529	469	549	1	2	80	0.0250000
NODE_7676_length_949_cov_19.483529	469	549	2	28	80	0.3500000
NODE_7676_length_949_cov_19.483529	469	549	4	21	80	0.2625000
NODE_7676_length_949_cov_19.483529	469	549	6	5	80	0.0625000
NODE_7676_length_949_cov_19.483529	469	549	7	1	80	0.0125000
NODE_7676_length_949_cov_19.483529	469	549	8	23	80	0.2875000
NODE_7676_length_949_cov_19.483529	522	602	2	80	80	1.0000000
NODE_7677_length_949_cov_19.407059	433	513	3	3	80	0.0375000
NODE_7677_length_949_cov_19.407059	433	513	4	19	80	0.2375000
NODE_7677_length_949_cov_19.407059	433	513	5	21	80	0.2625000
NODE_7677_length_949_cov_19.407059	433	513	6	37	80	0.4625000
NODE_7677_length_949_cov_19.407059	486	566	4	37	80	0.4625000
NODE_7677_length_949_cov_19.407059	486	566	6	43	80	0.5375000
NODE_7677_length_949_cov_19.407059	562	642	0	16	80	0.2000000
NODE_7677_length_949_cov_19.407059	562	642	1	21	80	0.2625000
NODE_7677_length_949_cov_19.407059	562	642	2	19	80	0.2375000
NODE_7677_length_949_cov_19.407059	562	642	3	11	80	0.1375000
NODE_7677_length_949_cov_19.407059	562	642	4	13	80	0.1625000
NODE_7677_length_949_cov_19.407059	615	695	0	69	80	0.8625000
NODE_7677_length_949_cov_19.407059	615	695	1	11	80	0.1375000
NODE_7678_length_949_cov_10.903529	561	641	0	2	80	0.0250000
NODE_7678_length_949_cov_10.903529	561	641	1	78	80	0.9750000
NODE_7678_length_949_cov_10.903529	614	694	1	51	80	0.6375000
NODE_7678_length_949_cov_10.903529	614	694	2	1	80	0.0125000
NODE_7678_length_949_cov_10.903529	614	694	3	25	80	0.3125000
NODE_7678_length_949_cov_10.903529	614	694	4	3	80	0.0375000
NODE_7679_length_949_cov_7.245882	0	71	0	12	71	0.1690141
NODE_7679_length_949_cov_7.245882	0	71	2	59	71	0.8309859
NODE_7679_length_949_cov_7.245882	0	71	0	12	71	0.1690141
NODE_7679_length_949_cov_7.245882	0	71	2	59	71	0.8309859
NODE_7679_length_949_cov_7.245882	44	124	2	63	80	0.7875000
NODE_7679_length_949_cov_7.245882	44	124	3	17	80	0.2125000
NODE_7680_length_949_cov_6.998824	494	574	0	20	80	0.2500000
NODE_7680_length_949_cov_6.998824	494	574	1	2	80	0.0250000
NODE_7680_length_949_cov_6.998824	494	574	2	45	80	0.5625000
NODE_7680_length_949_cov_6.998824	494	574	3	13	80	0.1625000
NODE_7680_length_949_cov_6.998824	547	627	2	14	80	0.1750000
NODE_7680_length_949_cov_6.998824	547	627	3	66	80	0.8250000
NODE_7702_length_948_cov_37.201413	510	590	7	3	80	0.0375000
NODE_7702_length_948_cov_37.201413	510	590	8	6	80	0.0750000
NODE_7702_length_948_cov_37.201413	510	590	9	4	80	0.0500000
NODE_7702_length_948_cov_37.201413	510	590	10	3	80	0.0375000
NODE_7702_length_948_cov_37.201413	510	590	11	4	80	0.0500000
NODE_7702_length_948_cov_37.201413	510	590	12	32	80	0.4000000
NODE_7702_length_948_cov_37.201413	510	590	13	28	80	0.3500000
NODE_7702_length_948_cov_37.201413	563	643	10	2	80	0.0250000
NODE_7702_length_948_cov_37.201413	563	643	11	28	80	0.3500000
NODE_7702_length_948_cov_37.201413	563	643	12	34	80	0.4250000
NODE_7702_length_948_cov_37.201413	563	643	13	16	80	0.2000000
NODE_7703_length_948_cov_20.082450	58	99	4	41	41	1.0000000
NODE_7703_length_948_cov_20.082450	113	193	4	6	80	0.0750000
NODE_7703_length_948_cov_20.082450	113	193	5	13	80	0.1625000
NODE_7703_length_948_cov_20.082450	113	193	7	2	80	0.0250000
NODE_7703_length_948_cov_20.082450	113	193	9	15	80	0.1875000
NODE_7703_length_948_cov_20.082450	113	193	10	5	80	0.0625000
NODE_7703_length_948_cov_20.082450	113	193	11	15	80	0.1875000
NODE_7703_length_948_cov_20.082450	113	193	12	24	80	0.3000000
NODE_7703_length_948_cov_20.082450	166	246	6	4	80	0.0500000
NODE_7703_length_948_cov_20.082450	166	246	7	4	80	0.0500000
NODE_7703_length_948_cov_20.082450	166	246	8	21	80	0.2625000
NODE_7703_length_948_cov_20.082450	166	246	10	2	80	0.0250000
NODE_7703_length_948_cov_20.082450	166	246	11	24	80	0.3000000
NODE_7703_length_948_cov_20.082450	166	246	12	25	80	0.3125000
NODE_7704_length_948_cov_16.785630	308	388	4	1	80	0.0125000
NODE_7704_length_948_cov_16.785630	308	388	5	58	80	0.7250000
NODE_7704_length_948_cov_16.785630	308	388	6	17	80	0.2125000
NODE_7704_length_948_cov_16.785630	308	388	7	4	80	0.0500000
NODE_7704_length_948_cov_16.785630	361	441	5	42	80	0.5250000
NODE_7704_length_948_cov_16.785630	361	441	6	11	80	0.1375000
NODE_7704_length_948_cov_16.785630	361	441	7	24	80	0.3000000
NODE_7704_length_948_cov_16.785630	361	441	9	3	80	0.0375000
NODE_7704_length_948_cov_16.785630	437	517	7	2	80	0.0250000
NODE_7704_length_948_cov_16.785630	437	517	8	34	80	0.4250000
NODE_7704_length_948_cov_16.785630	437	517	9	44	80	0.5500000
NODE_7704_length_948_cov_16.785630	490	570	1	4	80	0.0500000
NODE_7704_length_948_cov_16.785630	490	570	3	12	80	0.1500000
NODE_7704_length_948_cov_16.785630	490	570	5	21	80	0.2625000
NODE_7704_length_948_cov_16.785630	490	570	7	17	80	0.2125000
NODE_7704_length_948_cov_16.785630	490	570	8	6	80	0.0750000
NODE_7704_length_948_cov_16.785630	490	570	9	20	80	0.2500000
NODE_7705_length_948_cov_12.740872	400	480	3	7	80	0.0875000
NODE_7705_length_948_cov_12.740872	400	480	4	34	80	0.4250000
NODE_7705_length_948_cov_12.740872	400	480	5	16	80	0.2000000
NODE_7705_length_948_cov_12.740872	400	480	6	23	80	0.2875000
NODE_7705_length_948_cov_12.740872	453	533	4	23	80	0.2875000
NODE_7705_length_948_cov_12.740872	453	533	6	10	80	0.1250000
NODE_7705_length_948_cov_12.740872	453	533	7	47	80	0.5875000
NODE_7706_length_948_cov_10.220259	465	545	0	47	80	0.5875000
NODE_7706_length_948_cov_10.220259	465	545	1	31	80	0.3875000
NODE_7706_length_948_cov_10.220259	465	545	2	2	80	0.0250000
NODE_7706_length_948_cov_10.220259	518	598	1	25	80	0.3125000
NODE_7706_length_948_cov_10.220259	518	598	2	11	80	0.1375000
NODE_7706_length_948_cov_10.220259	518	598	4	44	80	0.5500000
NODE_7707_length_948_cov_8.504122	456	536	0	80	80	1.0000000
NODE_7707_length_948_cov_8.504122	509	589	0	80	80	1.0000000
NODE_7709_length_948_cov_5.425206	641	721	2	32	80	0.4000000
NODE_7709_length_948_cov_5.425206	641	721	3	2	80	0.0250000
NODE_7709_length_948_cov_5.425206	641	721	4	22	80	0.2750000
NODE_7709_length_948_cov_5.425206	641	721	5	6	80	0.0750000
NODE_7709_length_948_cov_5.425206	641	721	6	18	80	0.2250000
NODE_7709_length_948_cov_5.425206	694	774	4	49	80	0.6125000
NODE_7709_length_948_cov_5.425206	694	774	5	10	80	0.1250000
NODE_7709_length_948_cov_5.425206	694	774	6	21	80	0.2625000
NODE_7711_length_948_cov_3.586572	696	776	0	80	80	1.0000000
NODE_7715_length_948_cov_2.786808	259	324	0	65	65	1.0000000
NODE_7715_length_948_cov_2.786808	297	377	0	80	80	1.0000000
NODE_7721_length_947_cov_91.466981	393	473	9	13	80	0.1625000
NODE_7721_length_947_cov_91.466981	393	473	10	14	80	0.1750000
NODE_7721_length_947_cov_91.466981	393	473	11	10	80	0.1250000
NODE_7721_length_947_cov_91.466981	393	473	13	11	80	0.1375000
NODE_7721_length_947_cov_91.466981	393	473	14	7	80	0.0875000
NODE_7721_length_947_cov_91.466981	393	473	15	1	80	0.0125000
NODE_7721_length_947_cov_91.466981	393	473	16	24	80	0.3000000
NODE_7721_length_947_cov_91.466981	446	526	10	12	80	0.1500000
NODE_7721_length_947_cov_91.466981	446	526	11	44	80	0.5500000
NODE_7721_length_947_cov_91.466981	446	526	13	9	80	0.1125000
NODE_7721_length_947_cov_91.466981	446	526	16	15	80	0.1875000
NODE_7722_length_947_cov_61.139151	402	482	6	1	80	0.0125000
NODE_7722_length_947_cov_61.139151	402	482	10	16	80	0.2000000
NODE_7722_length_947_cov_61.139151	402	482	11	6	80	0.0750000
NODE_7722_length_947_cov_61.139151	402	482	12	39	80	0.4875000
NODE_7722_length_947_cov_61.139151	402	482	13	4	80	0.0500000
NODE_7722_length_947_cov_61.139151	402	482	14	9	80	0.1125000
NODE_7722_length_947_cov_61.139151	402	482	16	5	80	0.0625000
NODE_7722_length_947_cov_61.139151	455	535	11	32	80	0.4000000
NODE_7722_length_947_cov_61.139151	455	535	12	30	80	0.3750000
NODE_7722_length_947_cov_61.139151	455	535	13	4	80	0.0500000
NODE_7722_length_947_cov_61.139151	455	535	14	9	80	0.1125000
NODE_7722_length_947_cov_61.139151	455	535	16	5	80	0.0625000
NODE_7723_length_947_cov_50.009434	488	568	3	16	80	0.2000000
NODE_7723_length_947_cov_50.009434	488	568	5	3	80	0.0375000
NODE_7723_length_947_cov_50.009434	488	568	6	7	80	0.0875000
NODE_7723_length_947_cov_50.009434	488	568	7	25	80	0.3125000
NODE_7723_length_947_cov_50.009434	488	568	8	29	80	0.3625000
NODE_7723_length_947_cov_50.009434	541	621	2	14	80	0.1750000
NODE_7723_length_947_cov_50.009434	541	621	3	55	80	0.6875000
NODE_7723_length_947_cov_50.009434	541	621	5	3	80	0.0375000
NODE_7723_length_947_cov_50.009434	541	621	6	7	80	0.0875000
NODE_7723_length_947_cov_50.009434	541	621	7	1	80	0.0125000
NODE_7724_length_947_cov_36.271226	511	591	4	18	80	0.2250000
NODE_7724_length_947_cov_36.271226	511	591	5	5	80	0.0625000
NODE_7724_length_947_cov_36.271226	511	591	6	8	80	0.1000000
NODE_7724_length_947_cov_36.271226	511	591	7	31	80	0.3875000
NODE_7724_length_947_cov_36.271226	511	591	8	18	80	0.2250000
NODE_7724_length_947_cov_36.271226	564	644	5	10	80	0.1250000
NODE_7724_length_947_cov_36.271226	564	644	6	36	80	0.4500000
NODE_7724_length_947_cov_36.271226	564	644	7	34	80	0.4250000
NODE_7725_length_947_cov_23.384434	425	505	9	6	80	0.0750000
NODE_7725_length_947_cov_23.384434	425	505	10	74	80	0.9250000
NODE_7725_length_947_cov_23.384434	478	558	1	17	80	0.2125000
NODE_7725_length_947_cov_23.384434	478	558	2	8	80	0.1000000
NODE_7725_length_947_cov_23.384434	478	558	3	4	80	0.0500000
NODE_7725_length_947_cov_23.384434	478	558	6	4	80	0.0500000
NODE_7725_length_947_cov_23.384434	478	558	7	2	80	0.0250000
NODE_7725_length_947_cov_23.384434	478	558	8	14	80	0.1750000
NODE_7725_length_947_cov_23.384434	478	558	10	31	80	0.3875000
NODE_7726_length_947_cov_19.103774	316	396	3	9	80	0.1125000
NODE_7726_length_947_cov_19.103774	316	396	4	2	80	0.0250000
NODE_7726_length_947_cov_19.103774	316	396	5	46	80	0.5750000
NODE_7726_length_947_cov_19.103774	316	396	7	23	80	0.2875000
NODE_7726_length_947_cov_19.103774	369	449	4	12	80	0.1500000
NODE_7726_length_947_cov_19.103774	369	449	5	7	80	0.0875000
NODE_7726_length_947_cov_19.103774	369	449	6	24	80	0.3000000
NODE_7726_length_947_cov_19.103774	369	449	7	37	80	0.4625000
NODE_7727_length_947_cov_18.853774	516	596	7	3	80	0.0375000
NODE_7727_length_947_cov_18.853774	516	596	8	9	80	0.1125000
NODE_7727_length_947_cov_18.853774	516	596	9	42	80	0.5250000
NODE_7727_length_947_cov_18.853774	516	596	10	4	80	0.0500000
NODE_7727_length_947_cov_18.853774	516	596	12	7	80	0.0875000
NODE_7727_length_947_cov_18.853774	516	596	13	10	80	0.1250000
NODE_7727_length_947_cov_18.853774	516	596	14	5	80	0.0625000
NODE_7727_length_947_cov_18.853774	569	649	8	13	80	0.1625000
NODE_7727_length_947_cov_18.853774	569	649	9	9	80	0.1125000
NODE_7727_length_947_cov_18.853774	569	649	10	7	80	0.0875000
NODE_7727_length_947_cov_18.853774	569	649	12	11	80	0.1375000
NODE_7727_length_947_cov_18.853774	569	649	13	35	80	0.4375000
NODE_7727_length_947_cov_18.853774	569	649	14	5	80	0.0625000
NODE_7728_length_947_cov_18.077830	315	395	0	80	80	1.0000000
NODE_7728_length_947_cov_18.077830	368	448	0	80	80	1.0000000
NODE_7729_length_947_cov_17.713443	403	483	2	7	80	0.0875000
NODE_7729_length_947_cov_17.713443	403	483	3	64	80	0.8000000
NODE_7729_length_947_cov_17.713443	403	483	4	9	80	0.1125000
NODE_7729_length_947_cov_17.713443	456	536	3	18	80	0.2250000
NODE_7729_length_947_cov_17.713443	456	536	4	16	80	0.2000000
NODE_7729_length_947_cov_17.713443	456	536	5	11	80	0.1375000
NODE_7729_length_947_cov_17.713443	456	536	6	29	80	0.3625000
NODE_7729_length_947_cov_17.713443	456	536	7	6	80	0.0750000
NODE_7730_length_947_cov_14.492925	358	438	0	80	80	1.0000000
NODE_7730_length_947_cov_14.492925	411	491	0	80	80	1.0000000
NODE_7730_length_947_cov_14.492925	487	567	0	16	80	0.2000000
NODE_7730_length_947_cov_14.492925	487	567	2	64	80	0.8000000
NODE_7730_length_947_cov_14.492925	540	620	0	33	80	0.4125000
NODE_7730_length_947_cov_14.492925	540	620	2	47	80	0.5875000
NODE_7731_length_947_cov_10.573113	550	630	1	8	80	0.1000000
NODE_7731_length_947_cov_10.573113	550	630	2	72	80	0.9000000
NODE_7731_length_947_cov_10.573113	603	683	1	36	80	0.4500000
NODE_7731_length_947_cov_10.573113	603	683	2	44	80	0.5500000
NODE_7732_length_947_cov_7.762972	550	630	2	75	80	0.9375000
NODE_7732_length_947_cov_7.762972	550	630	3	5	80	0.0625000
NODE_7732_length_947_cov_7.762972	607	683	2	18	76	0.2368421
NODE_7732_length_947_cov_7.762972	607	683	3	58	76	0.7631579
NODE_7747_length_946_cov_39.726092	378	458	10	6	80	0.0750000
NODE_7747_length_946_cov_39.726092	378	458	11	20	80	0.2500000
NODE_7747_length_946_cov_39.726092	378	458	13	18	80	0.2250000
NODE_7747_length_946_cov_39.726092	378	458	14	36	80	0.4500000
NODE_7747_length_946_cov_39.726092	431	511	7	5	80	0.0625000
NODE_7747_length_946_cov_39.726092	431	511	8	22	80	0.2750000
NODE_7747_length_946_cov_39.726092	431	511	9	9	80	0.1125000
NODE_7747_length_946_cov_39.726092	431	511	10	20	80	0.2500000
NODE_7747_length_946_cov_39.726092	431	511	11	22	80	0.2750000
NODE_7747_length_946_cov_39.726092	431	511	13	2	80	0.0250000
NODE_7747_length_946_cov_39.726092	507	587	2	46	80	0.5750000
NODE_7747_length_946_cov_39.726092	507	587	6	8	80	0.1000000
NODE_7747_length_946_cov_39.726092	507	587	7	26	80	0.3250000
NODE_7747_length_946_cov_39.726092	560	640	2	8	80	0.1000000
NODE_7747_length_946_cov_39.726092	560	640	5	26	80	0.3250000
NODE_7747_length_946_cov_39.726092	560	640	6	15	80	0.1875000
NODE_7747_length_946_cov_39.726092	560	640	7	31	80	0.3875000
NODE_7748_length_946_cov_32.728453	404	484	0	80	80	1.0000000
NODE_7748_length_946_cov_32.728453	457	537	0	80	80	1.0000000
NODE_7749_length_946_cov_27.548996	280	360	10	2	80	0.0250000
NODE_7749_length_946_cov_27.548996	280	360	11	1	80	0.0125000
NODE_7749_length_946_cov_27.548996	280	360	12	30	80	0.3750000
NODE_7749_length_946_cov_27.548996	280	360	13	31	80	0.3875000
NODE_7749_length_946_cov_27.548996	280	360	14	15	80	0.1875000
NODE_7749_length_946_cov_27.548996	280	360	15	1	80	0.0125000
NODE_7749_length_946_cov_27.548996	333	413	5	7	80	0.0875000
NODE_7749_length_946_cov_27.548996	333	413	6	5	80	0.0625000
NODE_7749_length_946_cov_27.548996	333	413	12	10	80	0.1250000
NODE_7749_length_946_cov_27.548996	333	413	13	27	80	0.3375000
NODE_7749_length_946_cov_27.548996	333	413	14	29	80	0.3625000
NODE_7749_length_946_cov_27.548996	333	413	15	2	80	0.0250000
NODE_7750_length_946_cov_24.622196	352	432	2	5	80	0.0625000
NODE_7750_length_946_cov_24.622196	352	432	3	6	80	0.0750000
NODE_7750_length_946_cov_24.622196	352	432	4	42	80	0.5250000
NODE_7750_length_946_cov_24.622196	352	432	5	4	80	0.0500000
NODE_7750_length_946_cov_24.622196	352	432	6	23	80	0.2875000
NODE_7750_length_946_cov_24.622196	405	486	5	14	81	0.1728395
NODE_7750_length_946_cov_24.622196	405	486	6	67	81	0.8271605
NODE_7751_length_946_cov_18.082645	492	572	6	10	80	0.1250000
NODE_7751_length_946_cov_18.082645	492	572	7	30	80	0.3750000
NODE_7751_length_946_cov_18.082645	492	572	9	40	80	0.5000000
NODE_7751_length_946_cov_18.082645	545	625	3	12	80	0.1500000
NODE_7751_length_946_cov_18.082645	545	625	5	1	80	0.0125000
NODE_7751_length_946_cov_18.082645	545	625	6	25	80	0.3125000
NODE_7751_length_946_cov_18.082645	545	625	7	5	80	0.0625000
NODE_7751_length_946_cov_18.082645	545	625	9	37	80	0.4625000
NODE_7752_length_946_cov_18.031877	433	513	3	16	80	0.2000000
NODE_7752_length_946_cov_18.031877	433	513	4	15	80	0.1875000
NODE_7752_length_946_cov_18.031877	433	513	6	49	80	0.6125000
NODE_7752_length_946_cov_18.031877	486	566	4	39	80	0.4875000
NODE_7752_length_946_cov_18.031877	486	566	5	6	80	0.0750000
NODE_7752_length_946_cov_18.031877	486	566	6	35	80	0.4375000
NODE_7753_length_946_cov_15.188902	472	552	0	3	80	0.0375000
NODE_7753_length_946_cov_15.188902	472	552	1	18	80	0.2250000
NODE_7753_length_946_cov_15.188902	472	552	2	42	80	0.5250000
NODE_7753_length_946_cov_15.188902	472	552	4	17	80	0.2125000
NODE_7753_length_946_cov_15.188902	525	605	2	10	80	0.1250000
NODE_7753_length_946_cov_15.188902	525	605	4	47	80	0.5875000
NODE_7753_length_946_cov_15.188902	525	605	5	23	80	0.2875000
NODE_7754_length_946_cov_11.201889	408	488	0	20	80	0.2500000
NODE_7754_length_946_cov_11.201889	408	488	1	60	80	0.7500000
NODE_7754_length_946_cov_11.201889	461	541	0	73	80	0.9125000
NODE_7754_length_946_cov_11.201889	461	541	1	7	80	0.0875000
NODE_7768_length_945_cov_42.997636	361	441	0	50	80	0.6250000
NODE_7768_length_945_cov_42.997636	361	441	1	30	80	0.3750000
NODE_7768_length_945_cov_42.997636	414	494	1	60	80	0.7500000
NODE_7768_length_945_cov_42.997636	414	494	4	20	80	0.2500000
NODE_7769_length_945_cov_31.223404	357	437	5	33	80	0.4125000
NODE_7769_length_945_cov_31.223404	357	437	6	1	80	0.0125000
NODE_7769_length_945_cov_31.223404	357	437	8	22	80	0.2750000
NODE_7769_length_945_cov_31.223404	357	437	9	24	80	0.3000000
NODE_7769_length_945_cov_31.223404	410	490	6	20	80	0.2500000
NODE_7769_length_945_cov_31.223404	410	490	7	6	80	0.0750000
NODE_7769_length_945_cov_31.223404	410	490	8	22	80	0.2750000
NODE_7769_length_945_cov_31.223404	410	490	9	32	80	0.4000000
NODE_7770_length_945_cov_26.348700	331	411	7	20	80	0.2500000
NODE_7770_length_945_cov_26.348700	331	411	8	31	80	0.3875000
NODE_7770_length_945_cov_26.348700	331	411	9	29	80	0.3625000
NODE_7770_length_945_cov_26.348700	384	464	4	7	80	0.0875000
NODE_7770_length_945_cov_26.348700	384	464	5	27	80	0.3375000
NODE_7770_length_945_cov_26.348700	384	464	6	9	80	0.1125000
NODE_7770_length_945_cov_26.348700	384	464	8	34	80	0.4250000
NODE_7770_length_945_cov_26.348700	384	464	9	3	80	0.0375000
NODE_7771_length_945_cov_20.349882	435	515	7	2	80	0.0250000
NODE_7771_length_945_cov_20.349882	435	515	8	2	80	0.0250000
NODE_7771_length_945_cov_20.349882	435	515	9	29	80	0.3625000
NODE_7771_length_945_cov_20.349882	435	515	10	30	80	0.3750000
NODE_7771_length_945_cov_20.349882	435	515	11	17	80	0.2125000
NODE_7771_length_945_cov_20.349882	488	568	6	8	80	0.1000000
NODE_7771_length_945_cov_20.349882	488	568	7	4	80	0.0500000
NODE_7771_length_945_cov_20.349882	488	568	8	33	80	0.4125000
NODE_7771_length_945_cov_20.349882	488	568	9	6	80	0.0750000
NODE_7771_length_945_cov_20.349882	488	568	10	5	80	0.0625000
NODE_7771_length_945_cov_20.349882	488	568	11	24	80	0.3000000
NODE_7772_length_945_cov_14.771868	386	466	1	2	80	0.0250000
NODE_7772_length_945_cov_14.771868	386	466	3	30	80	0.3750000
NODE_7772_length_945_cov_14.771868	386	466	4	48	80	0.6000000
NODE_7772_length_945_cov_14.771868	439	519	4	50	80	0.6250000
NODE_7772_length_945_cov_14.771868	439	519	6	30	80	0.3750000
NODE_7773_length_945_cov_10.158392	599	679	1	80	80	1.0000000
NODE_7773_length_945_cov_10.158392	652	732	0	22	80	0.2750000
NODE_7773_length_945_cov_10.158392	652	732	1	58	80	0.7250000
NODE_7775_length_945_cov_5.403073	357	437	0	80	80	1.0000000
NODE_7775_length_945_cov_5.403073	410	490	0	80	80	1.0000000
NODE_7785_length_944_cov_42.401183	358	438	9	8	80	0.1000000
NODE_7785_length_944_cov_42.401183	358	438	10	8	80	0.1000000
NODE_7785_length_944_cov_42.401183	358	438	12	4	80	0.0500000
NODE_7785_length_944_cov_42.401183	358	438	14	9	80	0.1125000
NODE_7785_length_944_cov_42.401183	358	438	15	6	80	0.0750000
NODE_7785_length_944_cov_42.401183	358	438	17	3	80	0.0375000
NODE_7785_length_944_cov_42.401183	358	438	18	1	80	0.0125000
NODE_7785_length_944_cov_42.401183	358	438	19	21	80	0.2625000
NODE_7785_length_944_cov_42.401183	358	438	20	2	80	0.0250000
NODE_7785_length_944_cov_42.401183	358	438	21	8	80	0.1000000
NODE_7785_length_944_cov_42.401183	358	438	22	10	80	0.1250000
NODE_7785_length_944_cov_42.401183	411	498	9	4	87	0.0459770
NODE_7785_length_944_cov_42.401183	411	498	10	3	87	0.0344828
NODE_7785_length_944_cov_42.401183	411	498	11	2	87	0.0229885
NODE_7785_length_944_cov_42.401183	411	498	13	5	87	0.0574713
NODE_7785_length_944_cov_42.401183	411	498	14	1	87	0.0114943
NODE_7785_length_944_cov_42.401183	411	498	15	9	87	0.1034483
NODE_7785_length_944_cov_42.401183	411	498	17	38	87	0.4367816
NODE_7785_length_944_cov_42.401183	411	498	18	1	87	0.0114943
NODE_7785_length_944_cov_42.401183	411	498	19	9	87	0.1034483
NODE_7785_length_944_cov_42.401183	411	498	21	5	87	0.0574713
NODE_7785_length_944_cov_42.401183	411	498	22	10	87	0.1149425
NODE_7786_length_944_cov_32.712426	377	457	5	14	80	0.1750000
NODE_7786_length_944_cov_32.712426	377	457	6	24	80	0.3000000
NODE_7786_length_944_cov_32.712426	377	457	7	23	80	0.2875000
NODE_7786_length_944_cov_32.712426	377	457	8	5	80	0.0625000
NODE_7786_length_944_cov_32.712426	377	457	9	14	80	0.1750000
NODE_7786_length_944_cov_32.712426	430	510	4	8	80	0.1000000
NODE_7786_length_944_cov_32.712426	430	510	5	19	80	0.2375000
NODE_7786_length_944_cov_32.712426	430	510	6	50	80	0.6250000
NODE_7786_length_944_cov_32.712426	430	510	8	3	80	0.0375000
NODE_7787_length_944_cov_27.839053	417	497	2	7	80	0.0875000
NODE_7787_length_944_cov_27.839053	417	497	4	6	80	0.0750000
NODE_7787_length_944_cov_27.839053	417	497	5	32	80	0.4000000
NODE_7787_length_944_cov_27.839053	417	497	7	24	80	0.3000000
NODE_7787_length_944_cov_27.839053	417	497	8	11	80	0.1375000
NODE_7787_length_944_cov_27.839053	470	550	6	23	80	0.2875000
NODE_7787_length_944_cov_27.839053	470	550	7	16	80	0.2000000
NODE_7787_length_944_cov_27.839053	470	550	8	41	80	0.5125000
NODE_7788_length_944_cov_24.702959	413	493	0	7	80	0.0875000
NODE_7788_length_944_cov_24.702959	413	493	1	73	80	0.9125000
NODE_7788_length_944_cov_24.702959	466	546	1	80	80	1.0000000
NODE_7789_length_944_cov_11.951479	347	427	2	77	80	0.9625000
NODE_7789_length_944_cov_11.951479	347	427	3	3	80	0.0375000
NODE_7789_length_944_cov_11.951479	400	480	2	33	80	0.4125000
NODE_7789_length_944_cov_11.951479	400	480	3	47	80	0.5875000
NODE_7789_length_944_cov_11.951479	476	556	2	80	80	1.0000000
NODE_7789_length_944_cov_11.951479	529	609	0	9	80	0.1125000
NODE_7789_length_944_cov_11.951479	529	609	1	29	80	0.3625000
NODE_7789_length_944_cov_11.951479	529	609	2	42	80	0.5250000
NODE_7790_length_944_cov_6.745562	366	446	0	80	80	1.0000000
NODE_7790_length_944_cov_6.745562	419	499	0	80	80	1.0000000
NODE_7792_length_944_cov_4.420118	236	316	0	80	80	1.0000000
NODE_7792_length_944_cov_4.420118	289	369	0	80	80	1.0000000
NODE_7800_length_943_cov_40.111374	536	614	3	1	78	0.0128205
NODE_7800_length_943_cov_40.111374	536	614	5	67	78	0.8589743
NODE_7800_length_943_cov_40.111374	536	614	6	4	78	0.0512821
NODE_7800_length_943_cov_40.111374	536	614	7	3	78	0.0384615
NODE_7800_length_943_cov_40.111374	536	614	8	3	78	0.0384615
NODE_7800_length_943_cov_40.111374	587	667	2	10	80	0.1250000
NODE_7800_length_943_cov_40.111374	587	667	3	44	80	0.5500000
NODE_7800_length_943_cov_40.111374	587	667	5	26	80	0.3250000
NODE_7801_length_943_cov_29.446682	338	418	0	18	80	0.2250000
NODE_7801_length_943_cov_29.446682	338	418	1	3	80	0.0375000
NODE_7801_length_943_cov_29.446682	338	418	2	20	80	0.2500000
NODE_7801_length_943_cov_29.446682	338	418	3	21	80	0.2625000
NODE_7801_length_943_cov_29.446682	338	418	4	2	80	0.0250000
NODE_7801_length_943_cov_29.446682	338	418	5	16	80	0.2000000
NODE_7801_length_943_cov_29.446682	391	471	3	9	80	0.1125000
NODE_7801_length_943_cov_29.446682	391	471	4	2	80	0.0250000
NODE_7801_length_943_cov_29.446682	391	471	5	66	80	0.8250000
NODE_7801_length_943_cov_29.446682	391	471	6	3	80	0.0375000
NODE_7802_length_943_cov_28.289100	393	473	6	1	80	0.0125000
NODE_7802_length_943_cov_28.289100	393	473	7	37	80	0.4625000
NODE_7802_length_943_cov_28.289100	393	473	8	42	80	0.5250000
NODE_7802_length_943_cov_28.289100	446	526	5	28	80	0.3500000
NODE_7802_length_943_cov_28.289100	446	526	6	13	80	0.1625000
NODE_7802_length_943_cov_28.289100	446	526	7	6	80	0.0750000
NODE_7802_length_943_cov_28.289100	446	526	8	33	80	0.4125000
NODE_7803_length_943_cov_27.225118	343	423	1	10	80	0.1250000
NODE_7803_length_943_cov_27.225118	343	423	2	35	80	0.4375000
NODE_7803_length_943_cov_27.225118	343	423	3	32	80	0.4000000
NODE_7803_length_943_cov_27.225118	343	423	7	3	80	0.0375000
NODE_7803_length_943_cov_27.225118	396	476	3	24	80	0.3000000
NODE_7803_length_943_cov_27.225118	396	476	7	42	80	0.5250000
NODE_7803_length_943_cov_27.225118	396	476	8	14	80	0.1750000
NODE_7804_length_943_cov_26.536730	275	303	3	9	28	0.3214286
NODE_7804_length_943_cov_26.536730	275	303	4	17	28	0.6071429
NODE_7804_length_943_cov_26.536730	275	303	5	2	28	0.0714286
NODE_7804_length_943_cov_26.536730	299	379	2	2	80	0.0250000
NODE_7804_length_943_cov_26.536730	299	379	3	78	80	0.9750000
NODE_7804_length_943_cov_26.536730	352	432	2	44	80	0.5500000
NODE_7804_length_943_cov_26.536730	352	432	3	36	80	0.4500000
NODE_7805_length_943_cov_24.992891	374	454	2	13	80	0.1625000
NODE_7805_length_943_cov_24.992891	374	454	3	1	80	0.0125000
NODE_7805_length_943_cov_24.992891	374	454	4	28	80	0.3500000
NODE_7805_length_943_cov_24.992891	374	454	5	38	80	0.4750000
NODE_7805_length_943_cov_24.992891	427	507	1	27	80	0.3375000
NODE_7805_length_943_cov_24.992891	427	507	2	12	80	0.1500000
NODE_7805_length_943_cov_24.992891	427	507	4	41	80	0.5125000
NODE_7805_length_943_cov_24.992891	503	583	0	24	80	0.3000000
NODE_7805_length_943_cov_24.992891	503	583	1	45	80	0.5625000
NODE_7805_length_943_cov_24.992891	503	583	2	11	80	0.1375000
NODE_7805_length_943_cov_24.992891	556	636	0	5	80	0.0625000
NODE_7805_length_943_cov_24.992891	556	636	1	11	80	0.1375000
NODE_7805_length_943_cov_24.992891	556	636	2	20	80	0.2500000
NODE_7805_length_943_cov_24.992891	556	636	4	9	80	0.1125000
NODE_7805_length_943_cov_24.992891	556	636	5	27	80	0.3375000
NODE_7805_length_943_cov_24.992891	556	636	6	8	80	0.1000000
NODE_7806_length_943_cov_24.758294	403	483	1	40	80	0.5000000
NODE_7806_length_943_cov_24.758294	403	483	3	1	80	0.0125000
NODE_7806_length_943_cov_24.758294	403	483	6	1	80	0.0125000
NODE_7806_length_943_cov_24.758294	403	483	7	38	80	0.4750000
NODE_7806_length_943_cov_24.758294	456	536	7	80	80	1.0000000
NODE_7807_length_943_cov_22.316351	432	512	2	14	80	0.1750000
NODE_7807_length_943_cov_22.316351	432	512	3	16	80	0.2000000
NODE_7807_length_943_cov_22.316351	432	512	4	50	80	0.6250000
NODE_7807_length_943_cov_22.316351	485	565	2	12	80	0.1500000
NODE_7807_length_943_cov_22.316351	485	565	3	19	80	0.2375000
NODE_7807_length_943_cov_22.316351	485	565	4	49	80	0.6125000
NODE_7808_length_943_cov_22.149289	393	473	7	15	80	0.1875000
NODE_7808_length_943_cov_22.149289	393	473	8	14	80	0.1750000
NODE_7808_length_943_cov_22.149289	393	473	9	3	80	0.0375000
NODE_7808_length_943_cov_22.149289	393	473	10	14	80	0.1750000
NODE_7808_length_943_cov_22.149289	393	473	11	22	80	0.2750000
NODE_7808_length_943_cov_22.149289	393	473	12	12	80	0.1500000
NODE_7808_length_943_cov_22.149289	446	526	7	29	80	0.3625000
NODE_7808_length_943_cov_22.149289	446	526	11	16	80	0.2000000
NODE_7808_length_943_cov_22.149289	446	526	12	35	80	0.4375000
NODE_7809_length_943_cov_20.055687	412	492	4	21	80	0.2625000
NODE_7809_length_943_cov_20.055687	412	492	5	17	80	0.2125000
NODE_7809_length_943_cov_20.055687	412	492	6	42	80	0.5250000
NODE_7809_length_943_cov_20.055687	465	545	2	19	80	0.2375000
NODE_7809_length_943_cov_20.055687	465	545	4	55	80	0.6875000
NODE_7809_length_943_cov_20.055687	465	545	6	6	80	0.0750000
NODE_7810_length_943_cov_16.022512	338	418	4	19	80	0.2375000
NODE_7810_length_943_cov_16.022512	338	418	5	35	80	0.4375000
NODE_7810_length_943_cov_16.022512	338	418	6	24	80	0.3000000
NODE_7810_length_943_cov_16.022512	338	418	7	2	80	0.0250000
NODE_7810_length_943_cov_16.022512	391	471	5	29	80	0.3625000
NODE_7810_length_943_cov_16.022512	391	471	6	47	80	0.5875000
NODE_7810_length_943_cov_16.022512	391	471	7	4	80	0.0500000
NODE_7811_length_943_cov_10.939573	474	554	5	22	80	0.2750000
NODE_7811_length_943_cov_10.939573	474	554	7	5	80	0.0625000
NODE_7811_length_943_cov_10.939573	474	554	8	2	80	0.0250000
NODE_7811_length_943_cov_10.939573	474	554	9	1	80	0.0125000
NODE_7811_length_943_cov_10.939573	474	554	10	7	80	0.0875000
NODE_7811_length_943_cov_10.939573	474	554	11	6	80	0.0750000
NODE_7811_length_943_cov_10.939573	474	554	12	3	80	0.0375000
NODE_7811_length_943_cov_10.939573	474	554	13	2	80	0.0250000
NODE_7811_length_943_cov_10.939573	474	554	14	32	80	0.4000000
NODE_7811_length_943_cov_10.939573	527	607	9	23	80	0.2875000
NODE_7811_length_943_cov_10.939573	527	607	10	1	80	0.0125000
NODE_7811_length_943_cov_10.939573	527	607	11	9	80	0.1125000
NODE_7811_length_943_cov_10.939573	527	607	12	9	80	0.1125000
NODE_7811_length_943_cov_10.939573	527	607	14	38	80	0.4750000
NODE_7812_length_943_cov_9.483412	422	502	4	80	80	1.0000000
NODE_7812_length_943_cov_9.483412	475	555	0	23	80	0.2875000
NODE_7812_length_943_cov_9.483412	475	555	1	2	80	0.0250000
NODE_7812_length_943_cov_9.483412	475	555	3	1	80	0.0125000
NODE_7812_length_943_cov_9.483412	475	555	4	54	80	0.6750000
NODE_7830_length_942_cov_58.088968	384	464	17	2	80	0.0250000
NODE_7830_length_942_cov_58.088968	384	464	18	1	80	0.0125000
NODE_7830_length_942_cov_58.088968	384	464	19	6	80	0.0750000
NODE_7830_length_942_cov_58.088968	384	464	20	13	80	0.1625000
NODE_7830_length_942_cov_58.088968	384	464	22	7	80	0.0875000
NODE_7830_length_942_cov_58.088968	384	464	24	11	80	0.1375000
NODE_7830_length_942_cov_58.088968	384	464	25	19	80	0.2375000
NODE_7830_length_942_cov_58.088968	384	464	26	17	80	0.2125000
NODE_7830_length_942_cov_58.088968	384	464	27	4	80	0.0500000
NODE_7830_length_942_cov_58.088968	437	517	11	23	80	0.2875000
NODE_7830_length_942_cov_58.088968	437	517	13	3	80	0.0375000
NODE_7830_length_942_cov_58.088968	437	517	15	4	80	0.0500000
NODE_7830_length_942_cov_58.088968	437	517	16	11	80	0.1375000
NODE_7830_length_942_cov_58.088968	437	517	17	4	80	0.0500000
NODE_7830_length_942_cov_58.088968	437	517	20	14	80	0.1750000
NODE_7830_length_942_cov_58.088968	437	517	22	4	80	0.0500000
NODE_7830_length_942_cov_58.088968	437	517	24	1	80	0.0125000
NODE_7830_length_942_cov_58.088968	437	517	25	2	80	0.0250000
NODE_7830_length_942_cov_58.088968	437	517	26	10	80	0.1250000
NODE_7830_length_942_cov_58.088968	437	517	27	4	80	0.0500000
NODE_7832_length_942_cov_27.466192	360	440	3	50	80	0.6250000
NODE_7832_length_942_cov_27.466192	360	440	4	30	80	0.3750000
NODE_7832_length_942_cov_27.466192	413	493	3	67	80	0.8375000
NODE_7832_length_942_cov_27.466192	413	493	4	13	80	0.1625000
NODE_7833_length_942_cov_26.914591	346	426	2	6	80	0.0750000
NODE_7833_length_942_cov_26.914591	346	426	3	13	80	0.1625000
NODE_7833_length_942_cov_26.914591	346	426	4	19	80	0.2375000
NODE_7833_length_942_cov_26.914591	346	426	5	33	80	0.4125000
NODE_7833_length_942_cov_26.914591	346	426	6	9	80	0.1125000
NODE_7833_length_942_cov_26.914591	399	479	4	21	80	0.2625000
NODE_7833_length_942_cov_26.914591	399	479	5	23	80	0.2875000
NODE_7833_length_942_cov_26.914591	399	479	6	36	80	0.4500000
NODE_7834_length_942_cov_17.911032	390	470	5	3	80	0.0375000
NODE_7834_length_942_cov_17.911032	390	470	6	35	80	0.4375000
NODE_7834_length_942_cov_17.911032	390	470	7	3	80	0.0375000
NODE_7834_length_942_cov_17.911032	390	470	8	9	80	0.1125000
NODE_7834_length_942_cov_17.911032	390	470	9	27	80	0.3375000
NODE_7834_length_942_cov_17.911032	390	470	10	3	80	0.0375000
NODE_7834_length_942_cov_17.911032	443	523	6	26	80	0.3250000
NODE_7834_length_942_cov_17.911032	443	523	7	13	80	0.1625000
NODE_7834_length_942_cov_17.911032	443	523	8	7	80	0.0875000
NODE_7834_length_942_cov_17.911032	443	523	9	31	80	0.3875000
NODE_7834_length_942_cov_17.911032	443	523	10	3	80	0.0375000
NODE_7835_length_942_cov_14.695136	442	522	6	71	80	0.8875000
NODE_7835_length_942_cov_14.695136	442	522	7	9	80	0.1125000
NODE_7835_length_942_cov_14.695136	495	575	1	6	80	0.0750000
NODE_7835_length_942_cov_14.695136	495	575	5	20	80	0.2500000
NODE_7835_length_942_cov_14.695136	495	575	6	54	80	0.6750000
NODE_7836_length_942_cov_14.097272	547	627	1	22	80	0.2750000
NODE_7836_length_942_cov_14.097272	547	627	2	25	80	0.3125000
NODE_7836_length_942_cov_14.097272	547	627	4	33	80	0.4125000
NODE_7836_length_942_cov_14.097272	600	680	4	80	80	1.0000000
NODE_7837_length_942_cov_13.174377	322	402	1	80	80	1.0000000
NODE_7837_length_942_cov_13.174377	375	455	1	80	80	1.0000000
NODE_7858_length_941_cov_36.592637	259	339	4	29	80	0.3625000
NODE_7858_length_941_cov_36.592637	259	339	5	1	80	0.0125000
NODE_7858_length_941_cov_36.592637	259	339	6	23	80	0.2875000
NODE_7858_length_941_cov_36.592637	259	339	7	20	80	0.2500000
NODE_7858_length_941_cov_36.592637	259	339	8	5	80	0.0625000
NODE_7858_length_941_cov_36.592637	259	339	9	2	80	0.0250000
NODE_7858_length_941_cov_36.592637	312	392	6	3	80	0.0375000
NODE_7858_length_941_cov_36.592637	312	392	7	53	80	0.6625000
NODE_7858_length_941_cov_36.592637	312	392	8	22	80	0.2750000
NODE_7858_length_941_cov_36.592637	312	392	9	2	80	0.0250000
NODE_7858_length_941_cov_36.592637	388	468	8	23	80	0.2875000
NODE_7858_length_941_cov_36.592637	388	468	9	3	80	0.0375000
NODE_7858_length_941_cov_36.592637	388	468	10	16	80	0.2000000
NODE_7858_length_941_cov_36.592637	388	468	11	1	80	0.0125000
NODE_7858_length_941_cov_36.592637	388	468	12	24	80	0.3000000
NODE_7858_length_941_cov_36.592637	388	468	13	13	80	0.1625000
NODE_7858_length_941_cov_36.592637	441	521	12	43	80	0.5375000
NODE_7858_length_941_cov_36.592637	441	521	13	26	80	0.3250000
NODE_7858_length_941_cov_36.592637	441	521	14	11	80	0.1375000
NODE_7859_length_941_cov_35.375297	352	432	0	21	80	0.2625000
NODE_7859_length_941_cov_35.375297	352	432	2	59	80	0.7375000
NODE_7859_length_941_cov_35.375297	405	485	0	21	80	0.2625000
NODE_7859_length_941_cov_35.375297	405	485	2	59	80	0.7375000
NODE_7859_length_941_cov_35.375297	481	561	0	31	80	0.3875000
NODE_7859_length_941_cov_35.375297	481	561	2	49	80	0.6125000
NODE_7859_length_941_cov_35.375297	534	614	0	10	80	0.1250000
NODE_7859_length_941_cov_35.375297	534	614	2	70	80	0.8750000
NODE_7860_length_941_cov_32.222090	407	487	0	10	80	0.1250000
NODE_7860_length_941_cov_32.222090	407	487	2	11	80	0.1375000
NODE_7860_length_941_cov_32.222090	407	487	3	4	80	0.0500000
NODE_7860_length_941_cov_32.222090	407	487	4	18	80	0.2250000
NODE_7860_length_941_cov_32.222090	407	487	5	4	80	0.0500000
NODE_7860_length_941_cov_32.222090	407	487	6	10	80	0.1250000
NODE_7860_length_941_cov_32.222090	407	487	8	23	80	0.2875000
NODE_7860_length_941_cov_32.222090	460	540	6	4	80	0.0500000
NODE_7860_length_941_cov_32.222090	460	540	8	76	80	0.9500000
NODE_7861_length_941_cov_28.442993	391	471	5	30	80	0.3750000
NODE_7861_length_941_cov_28.442993	391	471	6	32	80	0.4000000
NODE_7861_length_941_cov_28.442993	391	471	7	18	80	0.2250000
NODE_7861_length_941_cov_28.442993	444	524	4	2	80	0.0250000
NODE_7861_length_941_cov_28.442993	444	524	5	4	80	0.0500000
NODE_7861_length_941_cov_28.442993	444	524	6	60	80	0.7500000
NODE_7861_length_941_cov_28.442993	444	524	7	14	80	0.1750000
NODE_7862_length_941_cov_20.788599	341	421	2	21	80	0.2625000
NODE_7862_length_941_cov_20.788599	341	421	3	25	80	0.3125000
NODE_7862_length_941_cov_20.788599	341	421	4	16	80	0.2000000
NODE_7862_length_941_cov_20.788599	341	421	5	2	80	0.0250000
NODE_7862_length_941_cov_20.788599	341	421	6	12	80	0.1500000
NODE_7862_length_941_cov_20.788599	341	421	7	4	80	0.0500000
NODE_7862_length_941_cov_20.788599	394	474	4	9	80	0.1125000
NODE_7862_length_941_cov_20.788599	394	474	5	24	80	0.3000000
NODE_7862_length_941_cov_20.788599	394	474	6	12	80	0.1500000
NODE_7862_length_941_cov_20.788599	394	474	7	35	80	0.4375000
NODE_7863_length_941_cov_18.000000	364	444	9	24	80	0.3000000
NODE_7863_length_941_cov_18.000000	364	444	10	27	80	0.3375000
NODE_7863_length_941_cov_18.000000	364	444	11	5	80	0.0625000
NODE_7863_length_941_cov_18.000000	364	444	12	24	80	0.3000000
NODE_7863_length_941_cov_18.000000	417	497	3	18	80	0.2250000
NODE_7863_length_941_cov_18.000000	417	497	4	7	80	0.0875000
NODE_7863_length_941_cov_18.000000	417	497	6	10	80	0.1250000
NODE_7863_length_941_cov_18.000000	417	497	7	6	80	0.0750000
NODE_7863_length_941_cov_18.000000	417	497	9	14	80	0.1750000
NODE_7863_length_941_cov_18.000000	417	497	10	7	80	0.0875000
NODE_7863_length_941_cov_18.000000	417	497	11	5	80	0.0625000
NODE_7863_length_941_cov_18.000000	417	497	12	13	80	0.1625000
NODE_7864_length_941_cov_11.020190	325	405	0	80	80	1.0000000
NODE_7864_length_941_cov_11.020190	378	458	0	80	80	1.0000000
NODE_7865_length_941_cov_6.020190	260	287	2	12	27	0.4444444
NODE_7865_length_941_cov_6.020190	260	287	4	13	27	0.4814815
NODE_7865_length_941_cov_6.020190	260	287	5	1	27	0.0370370
NODE_7865_length_941_cov_6.020190	260	287	6	1	27	0.0370370
NODE_7865_length_941_cov_6.020190	260	340	2	65	80	0.8125000
NODE_7865_length_941_cov_6.020190	260	340	4	13	80	0.1625000
NODE_7865_length_941_cov_6.020190	260	340	5	1	80	0.0125000
NODE_7865_length_941_cov_6.020190	260	340	6	1	80	0.0125000
NODE_7867_length_941_cov_3.745843	867	941	0	74	74	1.0000000
NODE_7877_length_940_cov_43.954816	243	323	5	50	80	0.6250000
NODE_7877_length_940_cov_43.954816	243	323	6	30	80	0.3750000
NODE_7877_length_940_cov_43.954816	296	376	1	6	80	0.0750000
NODE_7877_length_940_cov_43.954816	296	376	2	8	80	0.1000000
NODE_7877_length_940_cov_43.954816	296	376	3	9	80	0.1125000
NODE_7877_length_940_cov_43.954816	296	376	5	42	80	0.5250000
NODE_7877_length_940_cov_43.954816	296	376	6	15	80	0.1875000
NODE_7877_length_940_cov_43.954816	372	452	0	21	80	0.2625000
NODE_7877_length_940_cov_43.954816	372	452	1	59	80	0.7375000
NODE_7877_length_940_cov_43.954816	425	505	0	74	80	0.9250000
NODE_7877_length_940_cov_43.954816	425	505	1	6	80	0.0750000
NODE_7878_length_940_cov_27.763377	423	503	0	30	80	0.3750000
NODE_7878_length_940_cov_27.763377	423	503	1	16	80	0.2000000
NODE_7878_length_940_cov_27.763377	423	503	2	21	80	0.2625000
NODE_7878_length_940_cov_27.763377	423	503	3	13	80	0.1625000
NODE_7878_length_940_cov_27.763377	476	556	2	14	80	0.1750000
NODE_7878_length_940_cov_27.763377	476	556	3	25	80	0.3125000
NODE_7878_length_940_cov_27.763377	476	556	4	41	80	0.5125000
NODE_7897_length_939_cov_58.982143	363	443	20	3	80	0.0375000
NODE_7897_length_939_cov_58.982143	363	443	21	1	80	0.0125000
NODE_7897_length_939_cov_58.982143	363	443	23	1	80	0.0125000
NODE_7897_length_939_cov_58.982143	363	443	24	4	80	0.0500000
NODE_7897_length_939_cov_58.982143	363	443	25	28	80	0.3500000
NODE_7897_length_939_cov_58.982143	363	443	26	5	80	0.0625000
NODE_7897_length_939_cov_58.982143	363	443	27	25	80	0.3125000
NODE_7897_length_939_cov_58.982143	363	443	28	13	80	0.1625000
NODE_7897_length_939_cov_58.982143	416	496	10	5	80	0.0625000
NODE_7897_length_939_cov_58.982143	416	496	11	2	80	0.0250000
NODE_7897_length_939_cov_58.982143	416	496	12	8	80	0.1000000
NODE_7897_length_939_cov_58.982143	416	496	13	2	80	0.0250000
NODE_7897_length_939_cov_58.982143	416	496	14	1	80	0.0125000
NODE_7897_length_939_cov_58.982143	416	496	15	8	80	0.1000000
NODE_7897_length_939_cov_58.982143	416	496	16	1	80	0.0125000
NODE_7897_length_939_cov_58.982143	416	496	20	11	80	0.1375000
NODE_7897_length_939_cov_58.982143	416	496	21	4	80	0.0500000
NODE_7897_length_939_cov_58.982143	416	496	24	1	80	0.0125000
NODE_7897_length_939_cov_58.982143	416	496	25	2	80	0.0250000
NODE_7897_length_939_cov_58.982143	416	496	26	6	80	0.0750000
NODE_7897_length_939_cov_58.982143	416	496	27	14	80	0.1750000
NODE_7897_length_939_cov_58.982143	416	496	28	15	80	0.1875000
NODE_7898_length_939_cov_32.469048	327	407	8	5	80	0.0625000
NODE_7898_length_939_cov_32.469048	327	407	9	20	80	0.2500000
NODE_7898_length_939_cov_32.469048	327	407	10	7	80	0.0875000
NODE_7898_length_939_cov_32.469048	327	407	11	2	80	0.0250000
NODE_7898_length_939_cov_32.469048	327	407	12	20	80	0.2500000
NODE_7898_length_939_cov_32.469048	327	407	13	26	80	0.3250000
NODE_7898_length_939_cov_32.469048	380	460	10	3	80	0.0375000
NODE_7898_length_939_cov_32.469048	380	460	11	22	80	0.2750000
NODE_7898_length_939_cov_32.469048	380	460	12	44	80	0.5500000
NODE_7898_length_939_cov_32.469048	380	460	13	11	80	0.1375000
NODE_7899_length_939_cov_31.895238	265	345	5	60	80	0.7500000
NODE_7899_length_939_cov_31.895238	265	345	7	2	80	0.0250000
NODE_7899_length_939_cov_31.895238	265	345	8	8	80	0.1000000
NODE_7899_length_939_cov_31.895238	265	345	9	10	80	0.1250000
NODE_7899_length_939_cov_31.895238	318	398	5	7	80	0.0875000
NODE_7899_length_939_cov_31.895238	318	398	7	22	80	0.2750000
NODE_7899_length_939_cov_31.895238	318	398	8	37	80	0.4625000
NODE_7899_length_939_cov_31.895238	318	398	9	14	80	0.1750000
NODE_7900_length_939_cov_25.354762	439	519	5	12	80	0.1500000
NODE_7900_length_939_cov_25.354762	439	519	7	10	80	0.1250000
NODE_7900_length_939_cov_25.354762	439	519	8	24	80	0.3000000
NODE_7900_length_939_cov_25.354762	439	519	9	34	80	0.4250000
NODE_7900_length_939_cov_25.354762	492	572	3	4	80	0.0500000
NODE_7900_length_939_cov_25.354762	492	572	4	1	80	0.0125000
NODE_7900_length_939_cov_25.354762	492	572	6	30	80	0.3750000
NODE_7900_length_939_cov_25.354762	492	572	7	6	80	0.0750000
NODE_7900_length_939_cov_25.354762	492	572	8	36	80	0.4500000
NODE_7900_length_939_cov_25.354762	492	572	9	3	80	0.0375000
NODE_7901_length_939_cov_24.892857	370	450	2	21	80	0.2625000
NODE_7901_length_939_cov_24.892857	370	450	3	59	80	0.7375000
NODE_7901_length_939_cov_24.892857	423	503	3	80	80	1.0000000
NODE_7902_length_939_cov_24.246429	422	502	1	26	80	0.3250000
NODE_7902_length_939_cov_24.246429	422	502	2	43	80	0.5375000
NODE_7902_length_939_cov_24.246429	422	502	3	11	80	0.1375000
NODE_7902_length_939_cov_24.246429	475	555	1	12	80	0.1500000
NODE_7902_length_939_cov_24.246429	475	555	2	4	80	0.0500000
NODE_7902_length_939_cov_24.246429	475	555	3	12	80	0.1500000
NODE_7902_length_939_cov_24.246429	475	555	4	5	80	0.0625000
NODE_7902_length_939_cov_24.246429	475	555	6	31	80	0.3875000
NODE_7902_length_939_cov_24.246429	475	555	7	16	80	0.2000000
NODE_7902_length_939_cov_24.246429	551	631	5	3	80	0.0375000
NODE_7902_length_939_cov_24.246429	551	631	6	65	80	0.8125000
NODE_7902_length_939_cov_24.246429	551	631	7	12	80	0.1500000
NODE_7902_length_939_cov_24.246429	604	684	1	23	80	0.2875000
NODE_7902_length_939_cov_24.246429	604	684	2	8	80	0.1000000
NODE_7902_length_939_cov_24.246429	604	684	3	12	80	0.1500000
NODE_7902_length_939_cov_24.246429	604	684	4	4	80	0.0500000
NODE_7902_length_939_cov_24.246429	604	684	5	9	80	0.1125000
NODE_7902_length_939_cov_24.246429	604	684	6	12	80	0.1500000
NODE_7902_length_939_cov_24.246429	604	684	7	12	80	0.1500000
NODE_7903_length_939_cov_21.141667	368	448	7	4	80	0.0500000
NODE_7903_length_939_cov_21.141667	368	448	8	18	80	0.2250000
NODE_7903_length_939_cov_21.141667	368	448	9	29	80	0.3625000
NODE_7903_length_939_cov_21.141667	368	448	10	29	80	0.3625000
NODE_7903_length_939_cov_21.141667	421	501	2	10	80	0.1250000
NODE_7903_length_939_cov_21.141667	421	501	4	10	80	0.1250000
NODE_7903_length_939_cov_21.141667	421	501	5	19	80	0.2375000
NODE_7903_length_939_cov_21.141667	421	501	6	1	80	0.0125000
NODE_7903_length_939_cov_21.141667	421	501	7	2	80	0.0250000
NODE_7903_length_939_cov_21.141667	421	501	8	7	80	0.0875000
NODE_7903_length_939_cov_21.141667	421	501	9	21	80	0.2625000
NODE_7903_length_939_cov_21.141667	421	501	10	10	80	0.1250000
NODE_7904_length_939_cov_16.425000	327	407	4	7	80	0.0875000
NODE_7904_length_939_cov_16.425000	327	407	5	9	80	0.1125000
NODE_7904_length_939_cov_16.425000	327	407	6	48	80	0.6000000
NODE_7904_length_939_cov_16.425000	327	407	7	16	80	0.2000000
NODE_7904_length_939_cov_16.425000	380	460	5	33	80	0.4125000
NODE_7904_length_939_cov_16.425000	380	460	6	31	80	0.3875000
NODE_7904_length_939_cov_16.425000	380	460	7	16	80	0.2000000
NODE_7905_length_939_cov_13.828571	469	548	3	20	79	0.2531646
NODE_7905_length_939_cov_13.828571	469	548	4	51	79	0.6455696
NODE_7905_length_939_cov_13.828571	469	548	5	8	79	0.1012658
NODE_7905_length_939_cov_13.828571	522	603	3	75	81	0.9259259
NODE_7905_length_939_cov_13.828571	522	603	5	6	81	0.0740741
NODE_7906_length_939_cov_13.521429	402	482	1	3	80	0.0375000
NODE_7906_length_939_cov_13.521429	402	482	3	28	80	0.3500000
NODE_7906_length_939_cov_13.521429	402	482	4	49	80	0.6125000
NODE_7906_length_939_cov_13.521429	455	535	1	56	80	0.7000000
NODE_7906_length_939_cov_13.521429	455	535	3	9	80	0.1125000
NODE_7906_length_939_cov_13.521429	455	535	4	15	80	0.1875000
NODE_7907_length_939_cov_12.955952	398	478	0	29	80	0.3625000
NODE_7907_length_939_cov_12.955952	398	478	2	9	80	0.1125000
NODE_7907_length_939_cov_12.955952	398	478	4	42	80	0.5250000
NODE_7907_length_939_cov_12.955952	451	531	2	1	80	0.0125000
NODE_7907_length_939_cov_12.955952	451	531	4	79	80	0.9875000
NODE_7908_length_939_cov_6.564286	523	545	0	22	22	1.0000000
NODE_7922_length_938_cov_44.458880	362	442	6	3	80	0.0375000
NODE_7922_length_938_cov_44.458880	362	442	7	21	80	0.2625000
NODE_7922_length_938_cov_44.458880	362	442	9	2	80	0.0250000
NODE_7922_length_938_cov_44.458880	362	442	10	6	80	0.0750000
NODE_7922_length_938_cov_44.458880	362	442	11	12	80	0.1500000
NODE_7922_length_938_cov_44.458880	362	442	12	7	80	0.0875000
NODE_7922_length_938_cov_44.458880	362	442	14	2	80	0.0250000
NODE_7922_length_938_cov_44.458880	362	442	16	2	80	0.0250000
NODE_7922_length_938_cov_44.458880	362	442	17	1	80	0.0125000
NODE_7922_length_938_cov_44.458880	362	442	18	21	80	0.2625000
NODE_7922_length_938_cov_44.458880	362	442	19	3	80	0.0375000
NODE_7922_length_938_cov_44.458880	415	495	12	1	80	0.0125000
NODE_7922_length_938_cov_44.458880	415	495	14	21	80	0.2625000
NODE_7922_length_938_cov_44.458880	415	495	16	9	80	0.1125000
NODE_7922_length_938_cov_44.458880	415	495	17	5	80	0.0625000
NODE_7922_length_938_cov_44.458880	415	495	18	41	80	0.5125000
NODE_7922_length_938_cov_44.458880	415	495	19	3	80	0.0375000
NODE_7923_length_938_cov_44.435042	748	815	3	22	67	0.3283582
NODE_7923_length_938_cov_44.435042	748	815	4	45	67	0.6716418
NODE_7924_length_938_cov_32.177592	466	546	13	34	80	0.4250000
NODE_7924_length_938_cov_32.177592	466	546	14	29	80	0.3625000
NODE_7924_length_938_cov_32.177592	466	546	15	17	80	0.2125000
NODE_7924_length_938_cov_32.177592	519	599	5	4	80	0.0500000
NODE_7924_length_938_cov_32.177592	519	599	6	7	80	0.0875000
NODE_7924_length_938_cov_32.177592	519	599	7	18	80	0.2250000
NODE_7924_length_938_cov_32.177592	519	599	9	2	80	0.0250000
NODE_7924_length_938_cov_32.177592	519	599	11	6	80	0.0750000
NODE_7924_length_938_cov_32.177592	519	599	13	16	80	0.2000000
NODE_7924_length_938_cov_32.177592	519	599	14	16	80	0.2000000
NODE_7924_length_938_cov_32.177592	519	599	15	11	80	0.1375000
NODE_7925_length_938_cov_21.139452	474	554	3	80	80	1.0000000
NODE_7925_length_938_cov_21.139452	527	607	3	39	80	0.4875000
NODE_7925_length_938_cov_21.139452	527	607	4	41	80	0.5125000
NODE_7927_length_938_cov_8.791418	300	380	0	80	80	1.0000000
NODE_7927_length_938_cov_8.791418	353	433	0	80	80	1.0000000
NODE_7932_length_938_cov_2.693683	59	139	0	80	80	1.0000000
NODE_7932_length_938_cov_2.693683	112	192	0	80	80	1.0000000
NODE_7946_length_937_cov_31.890215	407	487	6	6	80	0.0750000
NODE_7946_length_937_cov_31.890215	407	487	7	11	80	0.1375000
NODE_7946_length_937_cov_31.890215	407	487	8	38	80	0.4750000
NODE_7946_length_937_cov_31.890215	407	487	9	25	80	0.3125000
NODE_7946_length_937_cov_31.890215	460	536	7	3	76	0.0394737
NODE_7946_length_937_cov_31.890215	460	536	8	24	76	0.3157895
NODE_7946_length_937_cov_31.890215	460	536	9	49	76	0.6447368
NODE_7947_length_937_cov_31.198091	425	505	2	9	80	0.1125000
NODE_7947_length_937_cov_31.198091	425	505	3	27	80	0.3375000
NODE_7947_length_937_cov_31.198091	425	505	4	19	80	0.2375000
NODE_7947_length_937_cov_31.198091	425	505	5	9	80	0.1125000
NODE_7947_length_937_cov_31.198091	425	505	6	16	80	0.2000000
NODE_7947_length_937_cov_31.198091	478	558	4	11	80	0.1375000
NODE_7947_length_937_cov_31.198091	478	558	6	51	80	0.6375000
NODE_7947_length_937_cov_31.198091	478	558	7	18	80	0.2250000
NODE_7948_length_937_cov_29.742243	296	376	2	5	80	0.0625000
NODE_7948_length_937_cov_29.742243	296	376	3	38	80	0.4750000
NODE_7948_length_937_cov_29.742243	296	376	4	33	80	0.4125000
NODE_7948_length_937_cov_29.742243	296	376	5	4	80	0.0500000
NODE_7948_length_937_cov_29.742243	349	429	3	16	80	0.2000000
NODE_7948_length_937_cov_29.742243	349	429	4	30	80	0.3750000
NODE_7948_length_937_cov_29.742243	349	429	5	4	80	0.0500000
NODE_7948_length_937_cov_29.742243	349	429	6	5	80	0.0625000
NODE_7948_length_937_cov_29.742243	349	429	7	25	80	0.3125000
NODE_7948_length_937_cov_29.742243	425	505	6	1	80	0.0125000
NODE_7948_length_937_cov_29.742243	425	505	7	31	80	0.3875000
NODE_7948_length_937_cov_29.742243	425	505	8	14	80	0.1750000
NODE_7948_length_937_cov_29.742243	425	505	9	22	80	0.2750000
NODE_7948_length_937_cov_29.742243	425	505	10	12	80	0.1500000
NODE_7948_length_937_cov_29.742243	478	558	5	4	80	0.0500000
NODE_7948_length_937_cov_29.742243	478	558	6	16	80	0.2000000
NODE_7948_length_937_cov_29.742243	478	558	7	1	80	0.0125000
NODE_7948_length_937_cov_29.742243	478	558	8	36	80	0.4500000
NODE_7948_length_937_cov_29.742243	478	558	9	22	80	0.2750000
NODE_7948_length_937_cov_29.742243	478	558	10	1	80	0.0125000
NODE_7950_length_937_cov_26.153938	487	567	0	80	80	1.0000000
NODE_7950_length_937_cov_26.153938	540	620	0	80	80	1.0000000
NODE_7951_length_937_cov_20.898568	515	595	0	19	80	0.2375000
NODE_7951_length_937_cov_20.898568	515	595	2	61	80	0.7625000
NODE_7951_length_937_cov_20.898568	568	648	2	73	80	0.9125000
NODE_7951_length_937_cov_20.898568	568	648	4	7	80	0.0875000
NODE_7952_length_937_cov_20.502387	181	261	0	80	80	1.0000000
NODE_7952_length_937_cov_20.502387	234	314	0	80	80	1.0000000
NODE_7952_length_937_cov_20.502387	310	390	0	18	80	0.2250000
NODE_7952_length_937_cov_20.502387	310	390	1	7	80	0.0875000
NODE_7952_length_937_cov_20.502387	310	390	2	49	80	0.6125000
NODE_7952_length_937_cov_20.502387	310	390	4	6	80	0.0750000
NODE_7952_length_937_cov_20.502387	363	443	2	21	80	0.2625000
NODE_7952_length_937_cov_20.502387	363	443	4	30	80	0.3750000
NODE_7952_length_937_cov_20.502387	363	443	5	29	80	0.3625000
NODE_7953_length_937_cov_15.219570	526	606	5	17	80	0.2125000
NODE_7953_length_937_cov_15.219570	526	606	6	4	80	0.0500000
NODE_7953_length_937_cov_15.219570	526	606	7	7	80	0.0875000
NODE_7953_length_937_cov_15.219570	526	606	8	9	80	0.1125000
NODE_7953_length_937_cov_15.219570	526	606	9	43	80	0.5375000
NODE_7953_length_937_cov_15.219570	579	659	4	2	80	0.0250000
NODE_7953_length_937_cov_15.219570	579	659	5	10	80	0.1250000
NODE_7953_length_937_cov_15.219570	579	659	6	35	80	0.4375000
NODE_7953_length_937_cov_15.219570	579	659	7	11	80	0.1375000
NODE_7953_length_937_cov_15.219570	579	659	8	9	80	0.1125000
NODE_7953_length_937_cov_15.219570	579	659	9	13	80	0.1625000
NODE_7954_length_937_cov_9.633652	521	601	3	80	80	1.0000000
NODE_7954_length_937_cov_9.633652	574	654	0	16	80	0.2000000
NODE_7954_length_937_cov_9.633652	574	654	1	2	80	0.0250000
NODE_7954_length_937_cov_9.633652	574	654	3	62	80	0.7750000
NODE_7956_length_937_cov_6.630072	305	385	4	22	80	0.2750000
NODE_7956_length_937_cov_6.630072	305	385	5	11	80	0.1375000
NODE_7956_length_937_cov_6.630072	305	385	6	47	80	0.5875000
NODE_7956_length_937_cov_6.630072	358	438	2	7	80	0.0875000
NODE_7956_length_937_cov_6.630072	358	438	3	19	80	0.2375000
NODE_7956_length_937_cov_6.630072	358	438	4	49	80	0.6125000
NODE_7956_length_937_cov_6.630072	358	438	6	5	80	0.0625000
NODE_7957_length_937_cov_4.649165	470	550	5	10	80	0.1250000
NODE_7957_length_937_cov_4.649165	470	550	6	21	80	0.2625000
NODE_7957_length_937_cov_4.649165	470	550	7	49	80	0.6125000
NODE_7957_length_937_cov_4.649165	523	603	3	12	80	0.1500000
NODE_7957_length_937_cov_4.649165	523	603	4	9	80	0.1125000
NODE_7957_length_937_cov_4.649165	523	603	5	9	80	0.1125000
NODE_7957_length_937_cov_4.649165	523	603	6	11	80	0.1375000
NODE_7957_length_937_cov_4.649165	523	603	7	39	80	0.4875000
NODE_7969_length_936_cov_57.105137	267	347	1	10	80	0.1250000
NODE_7969_length_936_cov_57.105137	267	347	2	50	80	0.6250000
NODE_7969_length_936_cov_57.105137	267	347	3	9	80	0.1125000
NODE_7969_length_936_cov_57.105137	267	347	5	11	80	0.1375000
NODE_7969_length_936_cov_57.105137	320	400	2	7	80	0.0875000
NODE_7969_length_936_cov_57.105137	320	400	3	9	80	0.1125000
NODE_7969_length_936_cov_57.105137	320	400	5	14	80	0.1750000
NODE_7969_length_936_cov_57.105137	320	400	6	25	80	0.3125000
NODE_7969_length_936_cov_57.105137	320	400	7	16	80	0.2000000
NODE_7969_length_936_cov_57.105137	320	400	8	9	80	0.1125000
NODE_7969_length_936_cov_57.105137	396	476	8	25	80	0.3125000
NODE_7969_length_936_cov_57.105137	396	476	9	16	80	0.2000000
NODE_7969_length_936_cov_57.105137	396	476	10	7	80	0.0875000
NODE_7969_length_936_cov_57.105137	396	476	12	29	80	0.3625000
NODE_7969_length_936_cov_57.105137	396	476	13	3	80	0.0375000
NODE_7969_length_936_cov_57.105137	449	529	8	18	80	0.2250000
NODE_7969_length_936_cov_57.105137	449	529	10	12	80	0.1500000
NODE_7969_length_936_cov_57.105137	449	529	11	20	80	0.2500000
NODE_7969_length_936_cov_57.105137	449	529	12	26	80	0.3250000
NODE_7969_length_936_cov_57.105137	449	529	13	4	80	0.0500000
NODE_7970_length_936_cov_39.983274	433	513	12	2	80	0.0250000
NODE_7970_length_936_cov_39.983274	433	513	13	3	80	0.0375000
NODE_7970_length_936_cov_39.983274	433	513	14	2	80	0.0250000
NODE_7970_length_936_cov_39.983274	433	513	15	12	80	0.1500000
NODE_7970_length_936_cov_39.983274	433	513	16	24	80	0.3000000
NODE_7970_length_936_cov_39.983274	433	513	17	8	80	0.1000000
NODE_7970_length_936_cov_39.983274	433	513	18	29	80	0.3625000
NODE_7970_length_936_cov_39.983274	486	566	9	8	80	0.1000000
NODE_7970_length_936_cov_39.983274	486	566	10	5	80	0.0625000
NODE_7970_length_936_cov_39.983274	486	566	12	10	80	0.1250000
NODE_7970_length_936_cov_39.983274	486	566	13	31	80	0.3875000
NODE_7970_length_936_cov_39.983274	486	566	15	12	80	0.1500000
NODE_7970_length_936_cov_39.983274	486	566	16	14	80	0.1750000
NODE_7971_length_936_cov_22.486260	534	614	4	18	80	0.2250000
NODE_7971_length_936_cov_22.486260	534	614	8	57	80	0.7125000
NODE_7971_length_936_cov_22.486260	534	614	9	5	80	0.0625000
NODE_7971_length_936_cov_22.486260	587	667	1	4	80	0.0500000
NODE_7971_length_936_cov_22.486260	587	667	5	21	80	0.2625000
NODE_7971_length_936_cov_22.486260	587	667	6	5	80	0.0625000
NODE_7971_length_936_cov_22.486260	587	667	7	23	80	0.2875000
NODE_7971_length_936_cov_22.486260	587	667	8	27	80	0.3375000
NODE_7972_length_936_cov_19.639188	409	489	1	15	80	0.1875000
NODE_7972_length_936_cov_19.639188	409	489	2	37	80	0.4625000
NODE_7972_length_936_cov_19.639188	409	489	3	18	80	0.2250000
NODE_7972_length_936_cov_19.639188	409	489	4	10	80	0.1250000
NODE_7972_length_936_cov_19.639188	462	542	3	17	80	0.2125000
NODE_7972_length_936_cov_19.639188	462	542	4	63	80	0.7875000
NODE_7973_length_936_cov_15.083632	322	402	0	27	80	0.3375000
NODE_7973_length_936_cov_15.083632	322	402	2	8	80	0.1000000
NODE_7973_length_936_cov_15.083632	322	402	3	6	80	0.0750000
NODE_7973_length_936_cov_15.083632	322	402	4	14	80	0.1750000
NODE_7973_length_936_cov_15.083632	322	402	5	25	80	0.3125000
NODE_7973_length_936_cov_15.083632	375	455	4	2	80	0.0250000
NODE_7973_length_936_cov_15.083632	375	455	5	78	80	0.9750000
NODE_7974_length_936_cov_13.962963	356	424	2	43	68	0.6323529
NODE_7974_length_936_cov_13.962963	356	424	3	1	68	0.0147059
NODE_7974_length_936_cov_13.962963	356	424	4	24	68	0.3529412
NODE_7975_length_936_cov_12.502987	447	527	3	3	80	0.0375000
NODE_7975_length_936_cov_12.502987	447	527	5	32	80	0.4000000
NODE_7975_length_936_cov_12.502987	447	527	6	45	80	0.5625000
NODE_7975_length_936_cov_12.502987	500	580	3	26	80	0.3250000
NODE_7975_length_936_cov_12.502987	500	580	4	1	80	0.0125000
NODE_7975_length_936_cov_12.502987	500	580	5	53	80	0.6625000
NODE_7976_length_936_cov_12.279570	340	420	2	63	80	0.7875000
NODE_7976_length_936_cov_12.279570	340	420	4	17	80	0.2125000
NODE_7976_length_936_cov_12.279570	393	473	0	30	80	0.3750000
NODE_7976_length_936_cov_12.279570	393	473	2	50	80	0.6250000
NODE_7977_length_936_cov_7.906810	587	667	1	8	80	0.1000000
NODE_7977_length_936_cov_7.906810	587	667	2	22	80	0.2750000
NODE_7977_length_936_cov_7.906810	587	667	3	50	80	0.6250000
NODE_7977_length_936_cov_7.906810	640	720	2	27	80	0.3375000
NODE_7977_length_936_cov_7.906810	640	720	3	53	80	0.6625000
NODE_7978_length_936_cov_6.845878	322	402	0	80	80	1.0000000
NODE_7978_length_936_cov_6.845878	375	455	0	80	80	1.0000000
NODE_7979_length_936_cov_6.434886	556	635	0	22	79	0.2784810
NODE_7979_length_936_cov_6.434886	556	635	2	57	79	0.7215190
NODE_7979_length_936_cov_6.434886	608	688	0	75	80	0.9375000
NODE_7979_length_936_cov_6.434886	608	688	2	5	80	0.0625000
NODE_7993_length_935_cov_38.209330	57	137	16	18	80	0.2250000
NODE_7993_length_935_cov_38.209330	57	137	18	8	80	0.1000000
NODE_7993_length_935_cov_38.209330	57	137	20	54	80	0.6750000
NODE_7994_length_935_cov_27.306220	439	519	10	3	80	0.0375000
NODE_7994_length_935_cov_27.306220	439	519	11	2	80	0.0250000
NODE_7994_length_935_cov_27.306220	439	519	14	3	80	0.0375000
NODE_7994_length_935_cov_27.306220	439	519	19	22	80	0.2750000
NODE_7994_length_935_cov_27.306220	439	519	20	12	80	0.1500000
NODE_7994_length_935_cov_27.306220	439	519	21	2	80	0.0250000
NODE_7994_length_935_cov_27.306220	439	519	22	6	80	0.0750000
NODE_7994_length_935_cov_27.306220	439	519	23	29	80	0.3625000
NODE_7994_length_935_cov_27.306220	439	519	24	1	80	0.0125000
NODE_7994_length_935_cov_27.306220	492	572	18	5	80	0.0625000
NODE_7994_length_935_cov_27.306220	492	572	19	32	80	0.4000000
NODE_7994_length_935_cov_27.306220	492	572	21	10	80	0.1250000
NODE_7994_length_935_cov_27.306220	492	572	22	12	80	0.1500000
NODE_7994_length_935_cov_27.306220	492	572	23	20	80	0.2500000
NODE_7994_length_935_cov_27.306220	492	572	24	1	80	0.0125000
NODE_7995_length_935_cov_26.562201	321	401	5	27	80	0.3375000
NODE_7995_length_935_cov_26.562201	321	401	6	53	80	0.6625000
NODE_7995_length_935_cov_26.562201	374	454	4	24	80	0.3000000
NODE_7995_length_935_cov_26.562201	374	454	6	56	80	0.7000000
NODE_7995_length_935_cov_26.562201	450	530	2	32	80	0.4000000
NODE_7995_length_935_cov_26.562201	450	530	3	36	80	0.4500000
NODE_7995_length_935_cov_26.562201	450	530	5	6	80	0.0750000
NODE_7995_length_935_cov_26.562201	450	530	6	6	80	0.0750000
NODE_7995_length_935_cov_26.562201	503	583	0	20	80	0.2500000
NODE_7995_length_935_cov_26.562201	503	583	2	60	80	0.7500000
NODE_7996_length_935_cov_25.098086	356	436	4	29	80	0.3625000
NODE_7996_length_935_cov_25.098086	356	436	5	51	80	0.6375000
NODE_7996_length_935_cov_25.098086	409	489	4	21	80	0.2625000
NODE_7996_length_935_cov_25.098086	409	489	5	44	80	0.5500000
NODE_7996_length_935_cov_25.098086	409	489	6	15	80	0.1875000
NODE_7997_length_935_cov_24.316986	467	547	1	39	80	0.4875000
NODE_7997_length_935_cov_24.316986	467	547	2	41	80	0.5125000
NODE_7997_length_935_cov_24.316986	520	600	0	18	80	0.2250000
NODE_7997_length_935_cov_24.316986	520	600	1	62	80	0.7750000
NODE_7998_length_935_cov_19.221292	397	477	1	80	80	1.0000000
NODE_7998_length_935_cov_19.221292	450	530	1	47	80	0.5875000
NODE_7998_length_935_cov_19.221292	450	530	2	33	80	0.4125000
NODE_7999_length_935_cov_15.016746	404	484	0	80	80	1.0000000
NODE_7999_length_935_cov_15.016746	457	537	0	80	80	1.0000000
NODE_8000_length_935_cov_13.138756	341	421	0	50	80	0.6250000
NODE_8000_length_935_cov_13.138756	341	421	2	30	80	0.3750000
NODE_8000_length_935_cov_13.138756	394	474	0	18	80	0.2250000
NODE_8000_length_935_cov_13.138756	394	474	2	62	80	0.7750000
NODE_8002_length_935_cov_6.485646	512	592	1	2	80	0.0250000
NODE_8002_length_935_cov_6.485646	512	592	2	33	80	0.4125000
NODE_8002_length_935_cov_6.485646	512	592	4	11	80	0.1375000
NODE_8002_length_935_cov_6.485646	512	592	5	12	80	0.1500000
NODE_8002_length_935_cov_6.485646	512	592	6	9	80	0.1125000
NODE_8002_length_935_cov_6.485646	512	592	7	13	80	0.1625000
NODE_8002_length_935_cov_6.485646	565	645	4	4	80	0.0500000
NODE_8002_length_935_cov_6.485646	565	645	5	5	80	0.0625000
NODE_8002_length_935_cov_6.485646	565	645	6	58	80	0.7250000
NODE_8002_length_935_cov_6.485646	565	645	7	13	80	0.1625000
NODE_8003_length_935_cov_6.467703	250	330	0	8	80	0.1000000
NODE_8003_length_935_cov_6.467703	250	330	1	5	80	0.0625000
NODE_8003_length_935_cov_6.467703	250	330	2	28	80	0.3500000
NODE_8003_length_935_cov_6.467703	250	330	4	39	80	0.4875000
NODE_8003_length_935_cov_6.467703	303	383	4	80	80	1.0000000
NODE_8004_length_935_cov_6.144737	478	558	2	24	80	0.3000000
NODE_8004_length_935_cov_6.144737	478	558	3	52	80	0.6500000
NODE_8004_length_935_cov_6.144737	478	558	4	4	80	0.0500000
NODE_8004_length_935_cov_6.144737	531	611	0	37	80	0.4625000
NODE_8004_length_935_cov_6.144737	531	611	2	40	80	0.5000000
NODE_8004_length_935_cov_6.144737	531	611	3	3	80	0.0375000
NODE_8005_length_935_cov_3.905502	39	119	5	4	80	0.0500000
NODE_8005_length_935_cov_3.905502	39	119	6	76	80	0.9500000
NODE_8005_length_935_cov_3.905502	92	166	1	26	74	0.3513514
NODE_8005_length_935_cov_3.905502	92	166	2	8	74	0.1081081
NODE_8005_length_935_cov_3.905502	92	166	4	10	74	0.1351351
NODE_8005_length_935_cov_3.905502	92	166	6	30	74	0.4054054
NODE_8028_length_934_cov_22.898204	403	483	4	1	80	0.0125000
NODE_8028_length_934_cov_22.898204	403	483	5	2	80	0.0250000
NODE_8028_length_934_cov_22.898204	403	483	6	19	80	0.2375000
NODE_8028_length_934_cov_22.898204	403	483	7	1	80	0.0125000
NODE_8028_length_934_cov_22.898204	403	483	8	15	80	0.1875000
NODE_8028_length_934_cov_22.898204	403	483	9	21	80	0.2625000
NODE_8028_length_934_cov_22.898204	403	483	10	21	80	0.2625000
NODE_8028_length_934_cov_22.898204	456	536	7	14	80	0.1750000
NODE_8028_length_934_cov_22.898204	456	536	8	50	80	0.6250000
NODE_8028_length_934_cov_22.898204	456	536	9	7	80	0.0875000
NODE_8028_length_934_cov_22.898204	456	536	10	9	80	0.1125000
NODE_8029_length_934_cov_17.746108	246	326	2	45	80	0.5625000
NODE_8029_length_934_cov_17.746108	246	326	3	13	80	0.1625000
NODE_8029_length_934_cov_17.746108	246	326	4	14	80	0.1750000
NODE_8029_length_934_cov_17.746108	246	326	5	8	80	0.1000000
NODE_8029_length_934_cov_17.746108	299	379	3	5	80	0.0625000
NODE_8029_length_934_cov_17.746108	299	379	4	67	80	0.8375000
NODE_8029_length_934_cov_17.746108	299	379	5	8	80	0.1000000
NODE_8030_length_934_cov_16.049102	367	447	5	20	80	0.2500000
NODE_8030_length_934_cov_16.049102	367	447	6	13	80	0.1625000
NODE_8030_length_934_cov_16.049102	367	447	7	33	80	0.4125000
NODE_8030_length_934_cov_16.049102	367	447	8	14	80	0.1750000
NODE_8030_length_934_cov_16.049102	420	500	7	52	80	0.6500000
NODE_8030_length_934_cov_16.049102	420	500	8	19	80	0.2375000
NODE_8030_length_934_cov_16.049102	420	500	9	9	80	0.1125000
NODE_8031_length_934_cov_13.738922	379	459	0	42	80	0.5250000
NODE_8031_length_934_cov_13.738922	379	459	1	38	80	0.4750000
NODE_8031_length_934_cov_13.738922	432	459	1	27	27	1.0000000
NODE_8031_length_934_cov_13.738922	470	512	1	15	42	0.3571429
NODE_8031_length_934_cov_13.738922	470	512	2	27	42	0.6428571
NODE_8032_length_934_cov_9.091018	407	487	2	27	80	0.3375000
NODE_8032_length_934_cov_9.091018	407	487	4	5	80	0.0625000
NODE_8032_length_934_cov_9.091018	407	487	5	20	80	0.2500000
NODE_8032_length_934_cov_9.091018	407	487	6	28	80	0.3500000
NODE_8032_length_934_cov_9.091018	460	540	3	10	80	0.1250000
NODE_8032_length_934_cov_9.091018	460	540	4	7	80	0.0875000
NODE_8032_length_934_cov_9.091018	460	540	5	28	80	0.3500000
NODE_8032_length_934_cov_9.091018	460	540	6	35	80	0.4375000
NODE_8034_length_934_cov_5.349701	583	663	0	80	80	1.0000000
NODE_8050_length_933_cov_36.557554	462	542	4	4	80	0.0500000
NODE_8050_length_933_cov_36.557554	462	542	6	12	80	0.1500000
NODE_8050_length_933_cov_36.557554	462	542	7	57	80	0.7125000
NODE_8050_length_933_cov_36.557554	462	542	8	7	80	0.0875000
NODE_8050_length_933_cov_36.557554	515	595	2	8	80	0.1000000
NODE_8050_length_933_cov_36.557554	515	595	3	23	80	0.2875000
NODE_8050_length_933_cov_36.557554	515	595	5	17	80	0.2125000
NODE_8050_length_933_cov_36.557554	515	595	7	32	80	0.4000000
NODE_8051_length_933_cov_27.645084	476	556	8	23	80	0.2875000
NODE_8051_length_933_cov_27.645084	476	556	9	11	80	0.1375000
NODE_8051_length_933_cov_27.645084	476	556	10	12	80	0.1500000
NODE_8051_length_933_cov_27.645084	476	556	11	25	80	0.3125000
NODE_8051_length_933_cov_27.645084	476	556	12	9	80	0.1125000
NODE_8051_length_933_cov_27.645084	529	609	7	3	80	0.0375000
NODE_8051_length_933_cov_27.645084	529	609	8	3	80	0.0375000
NODE_8051_length_933_cov_27.645084	529	609	10	51	80	0.6375000
NODE_8051_length_933_cov_27.645084	529	609	11	14	80	0.1750000
NODE_8051_length_933_cov_27.645084	529	609	12	9	80	0.1125000
NODE_8052_length_933_cov_26.749400	611	691	0	43	80	0.5375000
NODE_8052_length_933_cov_26.749400	611	691	2	9	80	0.1125000
NODE_8052_length_933_cov_26.749400	611	691	4	28	80	0.3500000
NODE_8052_length_933_cov_26.749400	664	744	4	30	80	0.3750000
NODE_8052_length_933_cov_26.749400	664	744	6	4	80	0.0500000
NODE_8052_length_933_cov_26.749400	664	744	7	46	80	0.5750000
NODE_8053_length_933_cov_26.308153	430	510	0	80	80	1.0000000
NODE_8053_length_933_cov_26.308153	483	563	0	36	80	0.4500000
NODE_8053_length_933_cov_26.308153	483	563	1	44	80	0.5500000
NODE_8054_length_933_cov_19.966427	444	530	5	20	86	0.2325581
NODE_8054_length_933_cov_19.966427	444	530	6	9	86	0.1046512
NODE_8054_length_933_cov_19.966427	444	530	7	5	86	0.0581395
NODE_8054_length_933_cov_19.966427	444	530	8	14	86	0.1627907
NODE_8054_length_933_cov_19.966427	444	530	10	38	86	0.4418605
NODE_8054_length_933_cov_19.966427	497	583	7	11	86	0.1279070
NODE_8054_length_933_cov_19.966427	497	583	8	20	86	0.2325581
NODE_8054_length_933_cov_19.966427	497	583	10	55	86	0.6395349
NODE_8055_length_933_cov_16.870504	284	364	0	5	80	0.0625000
NODE_8055_length_933_cov_16.870504	284	364	2	31	80	0.3875000
NODE_8055_length_933_cov_16.870504	284	364	4	44	80	0.5500000
NODE_8055_length_933_cov_16.870504	337	415	4	46	78	0.5897436
NODE_8055_length_933_cov_16.870504	337	415	6	32	78	0.4102564
NODE_8056_length_933_cov_16.699041	366	446	0	41	80	0.5125000
NODE_8056_length_933_cov_16.699041	366	446	1	28	80	0.3500000
NODE_8056_length_933_cov_16.699041	366	446	2	4	80	0.0500000
NODE_8056_length_933_cov_16.699041	366	446	3	7	80	0.0875000
NODE_8056_length_933_cov_16.699041	419	499	0	16	80	0.2000000
NODE_8056_length_933_cov_16.699041	419	499	2	4	80	0.0500000
NODE_8056_length_933_cov_16.699041	419	499	3	25	80	0.3125000
NODE_8056_length_933_cov_16.699041	419	499	4	27	80	0.3375000
NODE_8056_length_933_cov_16.699041	419	499	5	8	80	0.1000000
NODE_8057_length_933_cov_11.171463	197	277	0	42	80	0.5250000
NODE_8057_length_933_cov_11.171463	197	277	1	38	80	0.4750000
NODE_8057_length_933_cov_11.171463	250	330	1	68	80	0.8500000
NODE_8057_length_933_cov_11.171463	250	330	2	12	80	0.1500000
NODE_8073_length_932_cov_26.656663	397	477	14	8	80	0.1000000
NODE_8073_length_932_cov_26.656663	397	477	15	21	80	0.2625000
NODE_8073_length_932_cov_26.656663	397	477	16	11	80	0.1375000
NODE_8073_length_932_cov_26.656663	397	477	17	16	80	0.2000000
NODE_8073_length_932_cov_26.656663	397	477	18	6	80	0.0750000
NODE_8073_length_932_cov_26.656663	397	477	19	1	80	0.0125000
NODE_8073_length_932_cov_26.656663	397	477	20	17	80	0.2125000
NODE_8073_length_932_cov_26.656663	450	530	9	12	80	0.1500000
NODE_8073_length_932_cov_26.656663	450	530	11	11	80	0.1375000
NODE_8073_length_932_cov_26.656663	450	530	13	21	80	0.2625000
NODE_8073_length_932_cov_26.656663	450	530	14	17	80	0.2125000
NODE_8073_length_932_cov_26.656663	450	530	15	19	80	0.2375000
NODE_8074_length_932_cov_16.581032	407	485	9	26	78	0.3333333
NODE_8074_length_932_cov_16.581032	407	485	10	52	78	0.6666667
NODE_8074_length_932_cov_16.581032	460	538	3	23	78	0.2948718
NODE_8074_length_932_cov_16.581032	460	538	4	8	78	0.1025641
NODE_8074_length_932_cov_16.581032	460	538	6	6	78	0.0769231
NODE_8074_length_932_cov_16.581032	460	538	7	12	78	0.1538462
NODE_8074_length_932_cov_16.581032	460	538	9	12	78	0.1538462
NODE_8074_length_932_cov_16.581032	460	538	10	17	78	0.2179487
NODE_8075_length_932_cov_13.462185	413	493	7	41	80	0.5125000
NODE_8075_length_932_cov_13.462185	413	493	9	22	80	0.2750000
NODE_8075_length_932_cov_13.462185	413	493	10	17	80	0.2125000
NODE_8075_length_932_cov_13.462185	466	546	3	13	80	0.1625000
NODE_8075_length_932_cov_13.462185	466	546	5	4	80	0.0500000
NODE_8075_length_932_cov_13.462185	466	546	7	55	80	0.6875000
NODE_8075_length_932_cov_13.462185	466	546	9	8	80	0.1000000
NODE_8076_length_932_cov_13.442977	386	466	0	11	80	0.1375000
NODE_8076_length_932_cov_13.442977	386	466	2	69	80	0.8625000
NODE_8076_length_932_cov_13.442977	439	519	2	80	80	1.0000000
NODE_8077_length_932_cov_11.947179	344	424	4	9	80	0.1125000
NODE_8077_length_932_cov_11.947179	344	424	5	42	80	0.5250000
NODE_8077_length_932_cov_11.947179	344	424	6	29	80	0.3625000
NODE_8077_length_932_cov_11.947179	397	477	2	21	80	0.2625000
NODE_8077_length_932_cov_11.947179	397	477	3	2	80	0.0250000
NODE_8077_length_932_cov_11.947179	397	477	4	39	80	0.4875000
NODE_8077_length_932_cov_11.947179	397	477	5	18	80	0.2250000
NODE_8079_length_932_cov_10.849940	409	489	2	41	80	0.5125000
NODE_8079_length_932_cov_10.849940	409	489	3	18	80	0.2250000
NODE_8079_length_932_cov_10.849940	409	489	4	21	80	0.2625000
NODE_8079_length_932_cov_10.849940	462	542	2	54	80	0.6750000
NODE_8079_length_932_cov_10.849940	462	542	3	5	80	0.0625000
NODE_8079_length_932_cov_10.849940	462	542	4	21	80	0.2625000
NODE_8080_length_932_cov_10.174070	342	422	4	14	80	0.1750000
NODE_8080_length_932_cov_10.174070	342	422	7	60	80	0.7500000
NODE_8080_length_932_cov_10.174070	342	422	8	6	80	0.0750000
NODE_8080_length_932_cov_10.174070	395	475	4	14	80	0.1750000
NODE_8080_length_932_cov_10.174070	395	475	6	53	80	0.6625000
NODE_8080_length_932_cov_10.174070	395	475	7	7	80	0.0875000
NODE_8080_length_932_cov_10.174070	395	475	8	6	80	0.0750000
NODE_8082_length_932_cov_9.200480	184	264	3	15	80	0.1875000
NODE_8082_length_932_cov_9.200480	184	264	4	12	80	0.1500000
NODE_8082_length_932_cov_9.200480	184	264	6	12	80	0.1500000
NODE_8082_length_932_cov_9.200480	184	264	7	18	80	0.2250000
NODE_8082_length_932_cov_9.200480	184	264	8	23	80	0.2875000
NODE_8082_length_932_cov_9.200480	237	317	6	3	80	0.0375000
NODE_8082_length_932_cov_9.200480	237	317	7	25	80	0.3125000
NODE_8082_length_932_cov_9.200480	237	317	8	52	80	0.6500000
NODE_8090_length_932_cov_2.689076	598	676	0	78	78	1.0000000
NODE_8090_length_932_cov_2.689076	798	845	0	47	47	1.0000000
NODE_8103_length_931_cov_51.451923	320	400	20	6	80	0.0750000
NODE_8103_length_931_cov_51.451923	320	400	21	11	80	0.1375000
NODE_8103_length_931_cov_51.451923	320	400	22	19	80	0.2375000
NODE_8103_length_931_cov_51.451923	320	400	23	27	80	0.3375000
NODE_8103_length_931_cov_51.451923	320	400	24	5	80	0.0625000
NODE_8103_length_931_cov_51.451923	320	400	25	6	80	0.0750000
NODE_8103_length_931_cov_51.451923	320	400	26	6	80	0.0750000
NODE_8103_length_931_cov_51.451923	373	453	12	11	80	0.1375000
NODE_8103_length_931_cov_51.451923	373	453	14	1	80	0.0125000
NODE_8103_length_931_cov_51.451923	373	453	16	1	80	0.0125000
NODE_8103_length_931_cov_51.451923	373	453	18	6	80	0.0750000
NODE_8103_length_931_cov_51.451923	373	453	19	7	80	0.0875000
NODE_8103_length_931_cov_51.451923	373	453	20	6	80	0.0750000
NODE_8103_length_931_cov_51.451923	373	453	21	12	80	0.1500000
NODE_8103_length_931_cov_51.451923	373	453	22	2	80	0.0250000
NODE_8103_length_931_cov_51.451923	373	453	23	25	80	0.3125000
NODE_8103_length_931_cov_51.451923	373	453	25	3	80	0.0375000
NODE_8103_length_931_cov_51.451923	373	453	26	6	80	0.0750000
NODE_8104_length_931_cov_46.621394	527	607	18	8	80	0.1000000
NODE_8104_length_931_cov_46.621394	527	607	19	2	80	0.0250000
NODE_8104_length_931_cov_46.621394	527	607	23	17	80	0.2125000
NODE_8104_length_931_cov_46.621394	527	607	24	4	80	0.0500000
NODE_8104_length_931_cov_46.621394	527	607	25	20	80	0.2500000
NODE_8104_length_931_cov_46.621394	527	607	26	26	80	0.3250000
NODE_8104_length_931_cov_46.621394	527	607	27	3	80	0.0375000
NODE_8104_length_931_cov_46.621394	580	660	14	2	80	0.0250000
NODE_8104_length_931_cov_46.621394	580	660	15	2	80	0.0250000
NODE_8104_length_931_cov_46.621394	580	660	17	24	80	0.3000000
NODE_8104_length_931_cov_46.621394	580	660	18	1	80	0.0125000
NODE_8104_length_931_cov_46.621394	580	660	19	1	80	0.0125000
NODE_8104_length_931_cov_46.621394	580	660	20	1	80	0.0125000
NODE_8104_length_931_cov_46.621394	580	660	22	11	80	0.1375000
NODE_8104_length_931_cov_46.621394	580	660	23	3	80	0.0375000
NODE_8104_length_931_cov_46.621394	580	660	24	12	80	0.1500000
NODE_8104_length_931_cov_46.621394	580	660	25	18	80	0.2250000
NODE_8104_length_931_cov_46.621394	580	660	26	5	80	0.0625000
NODE_8105_length_931_cov_36.334135	347	427	0	4	80	0.0500000
NODE_8105_length_931_cov_36.334135	347	427	2	17	80	0.2125000
NODE_8105_length_931_cov_36.334135	347	427	4	31	80	0.3875000
NODE_8105_length_931_cov_36.334135	347	427	6	16	80	0.2000000
NODE_8105_length_931_cov_36.334135	347	427	8	12	80	0.1500000
NODE_8105_length_931_cov_36.334135	400	480	6	52	80	0.6500000
NODE_8105_length_931_cov_36.334135	400	480	8	28	80	0.3500000
NODE_8106_length_931_cov_32.495192	482	562	6	23	80	0.2875000
NODE_8106_length_931_cov_32.495192	482	562	7	44	80	0.5500000
NODE_8106_length_931_cov_32.495192	482	562	8	13	80	0.1625000
NODE_8106_length_931_cov_32.495192	535	617	3	9	82	0.1097561
NODE_8106_length_931_cov_32.495192	535	617	5	15	82	0.1829268
NODE_8106_length_931_cov_32.495192	535	617	6	42	82	0.5121951
NODE_8106_length_931_cov_32.495192	535	617	7	3	82	0.0365854
NODE_8106_length_931_cov_32.495192	535	617	8	13	82	0.1585366
NODE_8107_length_931_cov_22.100962	375	455	8	7	80	0.0875000
NODE_8107_length_931_cov_22.100962	375	455	9	13	80	0.1625000
NODE_8107_length_931_cov_22.100962	375	455	10	14	80	0.1750000
NODE_8107_length_931_cov_22.100962	375	455	11	13	80	0.1625000
NODE_8107_length_931_cov_22.100962	375	455	12	30	80	0.3750000
NODE_8107_length_931_cov_22.100962	375	455	13	3	80	0.0375000
NODE_8107_length_931_cov_22.100962	428	508	5	4	80	0.0500000
NODE_8107_length_931_cov_22.100962	428	508	6	8	80	0.1000000
NODE_8107_length_931_cov_22.100962	428	508	7	3	80	0.0375000
NODE_8107_length_931_cov_22.100962	428	508	8	36	80	0.4500000
NODE_8107_length_931_cov_22.100962	428	508	9	22	80	0.2750000
NODE_8107_length_931_cov_22.100962	428	508	10	7	80	0.0875000
NODE_8108_length_931_cov_21.781250	347	427	4	1	80	0.0125000
NODE_8108_length_931_cov_21.781250	347	427	6	38	80	0.4750000
NODE_8108_length_931_cov_21.781250	347	427	7	17	80	0.2125000
NODE_8108_length_931_cov_21.781250	347	427	9	24	80	0.3000000
NODE_8108_length_931_cov_21.781250	400	480	3	4	80	0.0500000
NODE_8108_length_931_cov_21.781250	400	480	5	4	80	0.0500000
NODE_8108_length_931_cov_21.781250	400	480	6	18	80	0.2250000
NODE_8108_length_931_cov_21.781250	400	480	7	3	80	0.0375000
NODE_8108_length_931_cov_21.781250	400	480	8	14	80	0.1750000
NODE_8108_length_931_cov_21.781250	400	480	9	37	80	0.4625000
NODE_8109_length_931_cov_19.084135	411	491	3	3	80	0.0375000
NODE_8109_length_931_cov_19.084135	411	491	5	24	80	0.3000000
NODE_8109_length_931_cov_19.084135	411	491	6	4	80	0.0500000
NODE_8109_length_931_cov_19.084135	411	491	7	49	80	0.6125000
NODE_8109_length_931_cov_19.084135	464	544	3	12	80	0.1500000
NODE_8109_length_931_cov_19.084135	464	544	4	23	80	0.2875000
NODE_8109_length_931_cov_19.084135	464	544	5	22	80	0.2750000
NODE_8109_length_931_cov_19.084135	464	544	7	23	80	0.2875000
NODE_8110_length_931_cov_14.879808	444	524	4	5	80	0.0625000
NODE_8110_length_931_cov_14.879808	444	524	5	16	80	0.2000000
NODE_8110_length_931_cov_14.879808	444	524	6	59	80	0.7375000
NODE_8110_length_931_cov_14.879808	497	577	4	10	80	0.1250000
NODE_8110_length_931_cov_14.879808	497	577	5	19	80	0.2375000
NODE_8110_length_931_cov_14.879808	497	577	6	51	80	0.6375000
NODE_8111_length_931_cov_13.087740	759	800	0	41	41	1.0000000
NODE_8112_length_931_cov_10.534856	399	479	2	21	80	0.2625000
NODE_8112_length_931_cov_10.534856	399	479	3	21	80	0.2625000
NODE_8112_length_931_cov_10.534856	399	479	5	38	80	0.4750000
NODE_8112_length_931_cov_10.534856	452	532	4	26	80	0.3250000
NODE_8112_length_931_cov_10.534856	452	532	5	54	80	0.6750000
NODE_8113_length_931_cov_9.865385	236	316	0	80	80	1.0000000
NODE_8113_length_931_cov_9.865385	289	369	0	80	80	1.0000000
NODE_8115_length_931_cov_6.201923	479	559	4	80	80	1.0000000
NODE_8115_length_931_cov_6.201923	532	612	1	6	80	0.0750000
NODE_8115_length_931_cov_6.201923	532	612	2	23	80	0.2875000
NODE_8115_length_931_cov_6.201923	532	612	3	7	80	0.0875000
NODE_8115_length_931_cov_6.201923	532	612	4	44	80	0.5500000
NODE_8124_length_931_cov_1.780048	832	902	0	70	70	1.0000000
NODE_8126_length_931_cov_1.433894	220	284	2	49	64	0.7656250
NODE_8126_length_931_cov_1.433894	220	284	4	15	64	0.2343750
NODE_8131_length_930_cov_49.052948	252	332	5	23	80	0.2875000
NODE_8131_length_930_cov_49.052948	252	332	6	4	80	0.0500000
NODE_8131_length_930_cov_49.052948	252	332	7	30	80	0.3750000
NODE_8131_length_930_cov_49.052948	252	332	8	23	80	0.2875000
NODE_8131_length_930_cov_49.052948	305	385	4	11	80	0.1375000
NODE_8131_length_930_cov_49.052948	305	385	5	34	80	0.4250000
NODE_8131_length_930_cov_49.052948	305	385	6	7	80	0.0875000
NODE_8131_length_930_cov_49.052948	305	385	7	23	80	0.2875000
NODE_8131_length_930_cov_49.052948	305	385	8	5	80	0.0625000
NODE_8131_length_930_cov_49.052948	381	462	6	39	81	0.4814815
NODE_8131_length_930_cov_49.052948	381	462	7	9	81	0.1111111
NODE_8131_length_930_cov_49.052948	381	462	8	26	81	0.3209876
NODE_8131_length_930_cov_49.052948	381	462	9	7	81	0.0864198
NODE_8131_length_930_cov_49.052948	435	515	5	13	80	0.1625000
NODE_8131_length_930_cov_49.052948	435	515	6	62	80	0.7750000
NODE_8131_length_930_cov_49.052948	435	515	7	5	80	0.0625000
NODE_8132_length_930_cov_31.510229	400	482	8	2	82	0.0243902
NODE_8132_length_930_cov_31.510229	400	482	9	6	82	0.0731707
NODE_8132_length_930_cov_31.510229	400	482	10	29	82	0.3536585
NODE_8132_length_930_cov_31.510229	400	482	11	12	82	0.1463415
NODE_8132_length_930_cov_31.510229	400	482	12	33	82	0.4024390
NODE_8132_length_930_cov_31.510229	453	535	6	9	82	0.1097561
NODE_8132_length_930_cov_31.510229	453	535	7	24	82	0.2926829
NODE_8132_length_930_cov_31.510229	453	535	9	3	82	0.0365854
NODE_8132_length_930_cov_31.510229	453	535	10	24	82	0.2926829
NODE_8132_length_930_cov_31.510229	453	535	11	22	82	0.2682927
NODE_8133_length_930_cov_29.139591	329	409	8	4	80	0.0500000
NODE_8133_length_930_cov_29.139591	329	409	9	23	80	0.2875000
NODE_8133_length_930_cov_29.139591	329	409	11	4	80	0.0500000
NODE_8133_length_930_cov_29.139591	329	409	13	15	80	0.1875000
NODE_8133_length_930_cov_29.139591	329	409	14	34	80	0.4250000
NODE_8133_length_930_cov_29.139591	382	462	13	24	80	0.3000000
NODE_8133_length_930_cov_29.139591	382	462	14	48	80	0.6000000
NODE_8133_length_930_cov_29.139591	382	462	16	8	80	0.1000000
NODE_8134_length_930_cov_24.787004	518	598	5	10	80	0.1250000
NODE_8134_length_930_cov_24.787004	518	598	6	19	80	0.2375000
NODE_8134_length_930_cov_24.787004	518	598	7	26	80	0.3250000
NODE_8134_length_930_cov_24.787004	518	598	8	2	80	0.0250000
NODE_8134_length_930_cov_24.787004	518	598	9	23	80	0.2875000
NODE_8134_length_930_cov_24.787004	571	651	4	12	80	0.1500000
NODE_8134_length_930_cov_24.787004	571	651	5	2	80	0.0250000
NODE_8134_length_930_cov_24.787004	571	651	6	19	80	0.2375000
NODE_8134_length_930_cov_24.787004	571	651	7	22	80	0.2750000
NODE_8134_length_930_cov_24.787004	571	651	8	2	80	0.0250000
NODE_8134_length_930_cov_24.787004	571	651	9	23	80	0.2875000
NODE_8135_length_930_cov_24.608905	300	380	8	2	80	0.0250000
NODE_8135_length_930_cov_24.608905	300	380	9	38	80	0.4750000
NODE_8135_length_930_cov_24.608905	300	380	10	40	80	0.5000000
NODE_8135_length_930_cov_24.608905	353	433	5	13	80	0.1625000
NODE_8135_length_930_cov_24.608905	353	433	6	17	80	0.2125000
NODE_8135_length_930_cov_24.608905	353	433	7	2	80	0.0250000
NODE_8135_length_930_cov_24.608905	353	433	8	5	80	0.0625000
NODE_8135_length_930_cov_24.608905	353	433	9	31	80	0.3875000
NODE_8135_length_930_cov_24.608905	353	433	10	12	80	0.1500000
NODE_8136_length_930_cov_16.494585	482	562	4	1	80	0.0125000
NODE_8136_length_930_cov_16.494585	482	562	5	14	80	0.1750000
NODE_8136_length_930_cov_16.494585	482	562	6	43	80	0.5375000
NODE_8136_length_930_cov_16.494585	482	562	7	14	80	0.1750000
NODE_8136_length_930_cov_16.494585	482	562	8	8	80	0.1000000
NODE_8136_length_930_cov_16.494585	535	615	4	34	80	0.4250000
NODE_8136_length_930_cov_16.494585	535	615	5	34	80	0.4250000
NODE_8136_length_930_cov_16.494585	535	615	6	12	80	0.1500000
NODE_8137_length_930_cov_13.296029	249	329	1	3	80	0.0375000
NODE_8137_length_930_cov_13.296029	249	329	2	35	80	0.4375000
NODE_8137_length_930_cov_13.296029	249	329	3	42	80	0.5250000
NODE_8137_length_930_cov_13.296029	302	382	2	32	80	0.4000000
NODE_8137_length_930_cov_13.296029	302	382	3	39	80	0.4875000
NODE_8137_length_930_cov_13.296029	302	382	4	9	80	0.1125000
NODE_8137_length_930_cov_13.296029	378	458	2	8	80	0.1000000
NODE_8137_length_930_cov_13.296029	378	458	3	10	80	0.1250000
NODE_8137_length_930_cov_13.296029	378	458	4	29	80	0.3625000
NODE_8137_length_930_cov_13.296029	378	458	6	17	80	0.2125000
NODE_8137_length_930_cov_13.296029	378	458	7	16	80	0.2000000
NODE_8137_length_930_cov_13.296029	431	511	6	19	80	0.2375000
NODE_8137_length_930_cov_13.296029	431	511	7	61	80	0.7625000
NODE_8138_length_930_cov_11.758123	463	543	4	39	80	0.4875000
NODE_8138_length_930_cov_11.758123	463	543	6	36	80	0.4500000
NODE_8138_length_930_cov_11.758123	463	543	8	5	80	0.0625000
NODE_8138_length_930_cov_11.758123	516	596	4	14	80	0.1750000
NODE_8138_length_930_cov_11.758123	516	596	6	55	80	0.6875000
NODE_8138_length_930_cov_11.758123	516	596	7	1	80	0.0125000
NODE_8138_length_930_cov_11.758123	516	596	8	10	80	0.1250000
NODE_8139_length_930_cov_7.576414	531	611	1	13	80	0.1625000
NODE_8139_length_930_cov_7.576414	531	611	2	11	80	0.1375000
NODE_8139_length_930_cov_7.576414	531	611	5	1	80	0.0125000
NODE_8139_length_930_cov_7.576414	531	611	6	55	80	0.6875000
NODE_8139_length_930_cov_7.576414	584	664	6	80	80	1.0000000
NODE_8156_length_930_cov_0.821901	676	736	0	60	60	1.0000000
NODE_8157_length_929_cov_54.485542	313	393	3	6	80	0.0750000
NODE_8157_length_929_cov_54.485542	313	393	4	13	80	0.1625000
NODE_8157_length_929_cov_54.485542	313	393	5	15	80	0.1875000
NODE_8157_length_929_cov_54.485542	313	393	6	42	80	0.5250000
NODE_8157_length_929_cov_54.485542	313	393	7	4	80	0.0500000
NODE_8157_length_929_cov_54.485542	366	446	5	67	80	0.8375000
NODE_8157_length_929_cov_54.485542	366	446	6	13	80	0.1625000
NODE_8157_length_929_cov_54.485542	442	522	1	20	80	0.2500000
NODE_8157_length_929_cov_54.485542	442	522	2	23	80	0.2875000
NODE_8157_length_929_cov_54.485542	442	522	4	27	80	0.3375000
NODE_8157_length_929_cov_54.485542	442	522	5	10	80	0.1250000
NODE_8157_length_929_cov_54.485542	495	575	1	64	80	0.8000000
NODE_8157_length_929_cov_54.485542	495	575	2	16	80	0.2000000
NODE_8158_length_929_cov_49.865060	429	509	0	7	80	0.0875000
NODE_8158_length_929_cov_49.865060	429	509	2	50	80	0.6250000
NODE_8158_length_929_cov_49.865060	429	509	6	13	80	0.1625000
NODE_8158_length_929_cov_49.865060	429	509	7	10	80	0.1250000
NODE_8158_length_929_cov_49.865060	482	562	0	4	80	0.0500000
NODE_8158_length_929_cov_49.865060	482	562	6	13	80	0.1625000
NODE_8158_length_929_cov_49.865060	482	562	7	63	80	0.7875000
NODE_8159_length_929_cov_34.634940	358	438	9	12	80	0.1500000
NODE_8159_length_929_cov_34.634940	358	438	10	17	80	0.2125000
NODE_8159_length_929_cov_34.634940	358	438	11	34	80	0.4250000
NODE_8159_length_929_cov_34.634940	358	438	12	11	80	0.1375000
NODE_8159_length_929_cov_34.634940	358	438	13	6	80	0.0750000
NODE_8159_length_929_cov_34.634940	411	491	7	22	80	0.2750000
NODE_8159_length_929_cov_34.634940	411	491	8	1	80	0.0125000
NODE_8159_length_929_cov_34.634940	411	491	9	10	80	0.1250000
NODE_8159_length_929_cov_34.634940	411	491	10	37	80	0.4625000
NODE_8159_length_929_cov_34.634940	411	491	11	7	80	0.0875000
NODE_8159_length_929_cov_34.634940	411	491	13	3	80	0.0375000
NODE_8161_length_929_cov_20.815663	365	445	4	29	80	0.3625000
NODE_8161_length_929_cov_20.815663	365	445	5	23	80	0.2875000
NODE_8161_length_929_cov_20.815663	365	445	6	28	80	0.3500000
NODE_8161_length_929_cov_20.815663	418	498	2	11	80	0.1375000
NODE_8161_length_929_cov_20.815663	418	498	3	4	80	0.0500000
NODE_8161_length_929_cov_20.815663	418	498	5	61	80	0.7625000
NODE_8161_length_929_cov_20.815663	418	498	6	4	80	0.0500000
NODE_8162_length_929_cov_17.798795	376	456	3	15	80	0.1875000
NODE_8162_length_929_cov_17.798795	376	456	5	7	80	0.0875000
NODE_8162_length_929_cov_17.798795	376	456	6	9	80	0.1125000
NODE_8162_length_929_cov_17.798795	376	456	8	49	80	0.6125000
NODE_8162_length_929_cov_17.798795	429	509	3	18	80	0.2250000
NODE_8162_length_929_cov_17.798795	429	509	5	10	80	0.1250000
NODE_8162_length_929_cov_17.798795	429	509	6	24	80	0.3000000
NODE_8162_length_929_cov_17.798795	429	509	7	1	80	0.0125000
NODE_8162_length_929_cov_17.798795	429	509	8	27	80	0.3375000
NODE_8163_length_929_cov_16.622892	331	408	5	30	77	0.3896104
NODE_8163_length_929_cov_16.622892	331	408	6	20	77	0.2597403
NODE_8163_length_929_cov_16.622892	331	408	7	25	77	0.3246753
NODE_8163_length_929_cov_16.622892	331	408	8	2	77	0.0259740
NODE_8163_length_929_cov_16.622892	381	461	4	18	80	0.2250000
NODE_8163_length_929_cov_16.622892	381	461	6	9	80	0.1125000
NODE_8163_length_929_cov_16.622892	381	461	7	22	80	0.2750000
NODE_8163_length_929_cov_16.622892	381	461	8	31	80	0.3875000
NODE_8163_length_929_cov_16.622892	457	537	4	21	80	0.2625000
NODE_8163_length_929_cov_16.622892	457	537	5	8	80	0.1000000
NODE_8163_length_929_cov_16.622892	457	537	6	51	80	0.6375000
NODE_8163_length_929_cov_16.622892	510	590	2	17	80	0.2125000
NODE_8163_length_929_cov_16.622892	510	590	3	11	80	0.1375000
NODE_8163_length_929_cov_16.622892	510	590	4	15	80	0.1875000
NODE_8163_length_929_cov_16.622892	510	590	5	18	80	0.2250000
NODE_8163_length_929_cov_16.622892	510	590	6	19	80	0.2375000
NODE_8164_length_929_cov_15.242169	302	382	2	65	80	0.8125000
NODE_8164_length_929_cov_15.242169	302	382	3	15	80	0.1875000
NODE_8164_length_929_cov_15.242169	355	435	1	15	80	0.1875000
NODE_8164_length_929_cov_15.242169	355	435	2	50	80	0.6250000
NODE_8164_length_929_cov_15.242169	355	435	3	15	80	0.1875000
NODE_8164_length_929_cov_15.242169	431	511	1	7	80	0.0875000
NODE_8164_length_929_cov_15.242169	431	511	2	73	80	0.9125000
NODE_8164_length_929_cov_15.242169	484	564	0	4	80	0.0500000
NODE_8164_length_929_cov_15.242169	484	564	1	56	80	0.7000000
NODE_8164_length_929_cov_15.242169	484	564	2	20	80	0.2500000
NODE_8165_length_929_cov_13.197590	259	339	5	80	80	1.0000000
NODE_8165_length_929_cov_13.197590	312	392	3	37	80	0.4625000
NODE_8165_length_929_cov_13.197590	312	392	4	5	80	0.0625000
NODE_8165_length_929_cov_13.197590	312	392	5	38	80	0.4750000
NODE_8167_length_929_cov_7.766265	385	465	1	48	80	0.6000000
NODE_8167_length_929_cov_7.766265	385	465	2	32	80	0.4000000
NODE_8167_length_929_cov_7.766265	438	518	0	42	80	0.5250000
NODE_8167_length_929_cov_7.766265	438	518	1	38	80	0.4750000
NODE_8168_length_929_cov_5.750602	382	462	1	28	80	0.3500000
NODE_8168_length_929_cov_5.750602	382	462	2	5	80	0.0625000
NODE_8168_length_929_cov_5.750602	382	462	3	47	80	0.5875000
NODE_8168_length_929_cov_5.750602	435	515	2	48	80	0.6000000
NODE_8168_length_929_cov_5.750602	435	515	3	32	80	0.4000000
NODE_8181_length_928_cov_35.226779	273	353	3	11	80	0.1375000
NODE_8181_length_928_cov_35.226779	273	353	4	8	80	0.1000000
NODE_8181_length_928_cov_35.226779	273	353	6	28	80	0.3500000
NODE_8181_length_928_cov_35.226779	273	353	7	7	80	0.0875000
NODE_8181_length_928_cov_35.226779	273	353	8	5	80	0.0625000
NODE_8181_length_928_cov_35.226779	273	353	9	15	80	0.1875000
NODE_8181_length_928_cov_35.226779	273	353	10	4	80	0.0500000
NODE_8181_length_928_cov_35.226779	273	353	11	2	80	0.0250000
NODE_8181_length_928_cov_35.226779	326	406	7	1	80	0.0125000
NODE_8181_length_928_cov_35.226779	326	406	8	5	80	0.0625000
NODE_8181_length_928_cov_35.226779	326	406	9	15	80	0.1875000
NODE_8181_length_928_cov_35.226779	326	406	10	7	80	0.0875000
NODE_8181_length_928_cov_35.226779	326	406	11	27	80	0.3375000
NODE_8181_length_928_cov_35.226779	326	406	12	10	80	0.1250000
NODE_8181_length_928_cov_35.226779	326	406	13	9	80	0.1125000
NODE_8181_length_928_cov_35.226779	326	406	14	6	80	0.0750000
NODE_8181_length_928_cov_35.226779	402	482	10	8	80	0.1000000
NODE_8181_length_928_cov_35.226779	402	482	11	9	80	0.1125000
NODE_8181_length_928_cov_35.226779	402	482	12	7	80	0.0875000
NODE_8181_length_928_cov_35.226779	402	482	13	11	80	0.1375000
NODE_8181_length_928_cov_35.226779	402	482	14	13	80	0.1625000
NODE_8181_length_928_cov_35.226779	402	482	15	32	80	0.4000000
NODE_8181_length_928_cov_35.226779	455	535	4	1	80	0.0125000
NODE_8181_length_928_cov_35.226779	455	535	5	6	80	0.0750000
NODE_8181_length_928_cov_35.226779	455	535	7	1	80	0.0125000
NODE_8181_length_928_cov_35.226779	455	535	8	20	80	0.2500000
NODE_8181_length_928_cov_35.226779	455	535	10	6	80	0.0750000
NODE_8181_length_928_cov_35.226779	455	535	11	4	80	0.0500000
NODE_8181_length_928_cov_35.226779	455	535	12	15	80	0.1875000
NODE_8181_length_928_cov_35.226779	455	535	13	5	80	0.0625000
NODE_8181_length_928_cov_35.226779	455	535	14	7	80	0.0875000
NODE_8181_length_928_cov_35.226779	455	535	15	15	80	0.1875000
NODE_8182_length_928_cov_25.218335	299	379	2	9	80	0.1125000
NODE_8182_length_928_cov_25.218335	299	379	3	17	80	0.2125000
NODE_8182_length_928_cov_25.218335	299	379	4	24	80	0.3000000
NODE_8182_length_928_cov_25.218335	299	379	5	30	80	0.3750000
NODE_8182_length_928_cov_25.218335	352	432	3	49	80	0.6125000
NODE_8182_length_928_cov_25.218335	352	432	4	23	80	0.2875000
NODE_8182_length_928_cov_25.218335	352	432	5	8	80	0.1000000
NODE_8183_length_928_cov_22.815440	342	422	2	24	80	0.3000000
NODE_8183_length_928_cov_22.815440	342	422	3	7	80	0.0875000
NODE_8183_length_928_cov_22.815440	342	422	5	46	80	0.5750000
NODE_8183_length_928_cov_22.815440	342	422	6	3	80	0.0375000
NODE_8183_length_928_cov_22.815440	395	475	5	43	80	0.5375000
NODE_8183_length_928_cov_22.815440	395	475	6	11	80	0.1375000
NODE_8183_length_928_cov_22.815440	395	475	7	26	80	0.3250000
NODE_8183_length_928_cov_22.815440	471	551	4	10	80	0.1250000
NODE_8183_length_928_cov_22.815440	471	551	5	26	80	0.3250000
NODE_8183_length_928_cov_22.815440	471	551	6	24	80	0.3000000
NODE_8183_length_928_cov_22.815440	471	551	7	20	80	0.2500000
NODE_8183_length_928_cov_22.815440	524	604	3	14	80	0.1750000
NODE_8183_length_928_cov_22.815440	524	604	4	49	80	0.6125000
NODE_8183_length_928_cov_22.815440	524	604	6	15	80	0.1875000
NODE_8183_length_928_cov_22.815440	524	604	7	2	80	0.0250000
NODE_8184_length_928_cov_20.718938	365	445	6	56	80	0.7000000
NODE_8184_length_928_cov_20.718938	365	445	7	24	80	0.3000000
NODE_8184_length_928_cov_20.718938	418	498	2	13	80	0.1625000
NODE_8184_length_928_cov_20.718938	418	498	3	8	80	0.1000000
NODE_8184_length_928_cov_20.718938	418	498	4	15	80	0.1875000
NODE_8184_length_928_cov_20.718938	418	498	5	8	80	0.1000000
NODE_8184_length_928_cov_20.718938	418	498	6	36	80	0.4500000
NODE_8185_length_928_cov_19.418577	420	500	0	22	80	0.2750000
NODE_8185_length_928_cov_19.418577	420	500	1	58	80	0.7250000
NODE_8185_length_928_cov_19.418577	473	553	0	75	80	0.9375000
NODE_8185_length_928_cov_19.418577	473	553	1	5	80	0.0625000
NODE_8185_length_928_cov_19.418577	549	591	0	42	42	1.0000000
NODE_8186_length_928_cov_13.354644	323	403	2	5	80	0.0625000
NODE_8186_length_928_cov_13.354644	323	403	3	75	80	0.9375000
NODE_8186_length_928_cov_13.354644	376	456	2	7	80	0.0875000
NODE_8186_length_928_cov_13.354644	376	456	3	73	80	0.9125000
NODE_8187_length_928_cov_13.096502	361	441	0	20	80	0.2500000
NODE_8187_length_928_cov_13.096502	361	441	1	60	80	0.7500000
NODE_8187_length_928_cov_13.096502	414	494	0	73	80	0.9125000
NODE_8187_length_928_cov_13.096502	414	494	1	7	80	0.0875000
NODE_8189_length_928_cov_10.399276	447	527	1	13	80	0.1625000
NODE_8189_length_928_cov_10.399276	447	527	2	22	80	0.2750000
NODE_8189_length_928_cov_10.399276	447	527	3	45	80	0.5625000
NODE_8189_length_928_cov_10.399276	500	580	3	67	80	0.8375000
NODE_8189_length_928_cov_10.399276	500	580	4	13	80	0.1625000
NODE_8207_length_927_cov_19.516908	398	478	6	7	80	0.0875000
NODE_8207_length_927_cov_19.516908	398	478	7	37	80	0.4625000
NODE_8207_length_927_cov_19.516908	398	478	8	36	80	0.4500000
NODE_8207_length_927_cov_19.516908	451	531	3	47	80	0.5875000
NODE_8207_length_927_cov_19.516908	451	531	4	4	80	0.0500000
NODE_8207_length_927_cov_19.516908	451	531	7	17	80	0.2125000
NODE_8207_length_927_cov_19.516908	451	531	8	12	80	0.1500000
NODE_8208_length_927_cov_11.190821	358	438	0	80	80	1.0000000
NODE_8208_length_927_cov_11.190821	411	491	0	80	80	1.0000000
NODE_8209_length_927_cov_8.123188	239	319	2	15	80	0.1875000
NODE_8209_length_927_cov_8.123188	239	319	3	46	80	0.5750000
NODE_8209_length_927_cov_8.123188	239	319	4	1	80	0.0125000
NODE_8209_length_927_cov_8.123188	239	319	5	18	80	0.2250000
NODE_8209_length_927_cov_8.123188	292	372	3	9	80	0.1125000
NODE_8209_length_927_cov_8.123188	292	372	4	53	80	0.6625000
NODE_8209_length_927_cov_8.123188	292	372	5	18	80	0.2250000
NODE_8210_length_927_cov_4.585749	515	595	0	80	80	1.0000000
NODE_8210_length_927_cov_4.585749	568	648	0	80	80	1.0000000
NODE_8222_length_927_cov_1.250000	626	706	5	1	80	0.0125000
NODE_8222_length_927_cov_1.250000	626	706	8	31	80	0.3875000
NODE_8222_length_927_cov_1.250000	626	706	9	10	80	0.1250000
NODE_8222_length_927_cov_1.250000	626	706	10	10	80	0.1250000
NODE_8222_length_927_cov_1.250000	626	706	11	3	80	0.0375000
NODE_8222_length_927_cov_1.250000	626	706	13	19	80	0.2375000
NODE_8222_length_927_cov_1.250000	626	706	14	1	80	0.0125000
NODE_8222_length_927_cov_1.250000	626	706	15	5	80	0.0625000
NODE_8222_length_927_cov_1.250000	679	759	7	11	80	0.1375000
NODE_8222_length_927_cov_1.250000	679	759	9	1	80	0.0125000
NODE_8222_length_927_cov_1.250000	679	759	10	25	80	0.3125000
NODE_8222_length_927_cov_1.250000	679	759	11	3	80	0.0375000
NODE_8222_length_927_cov_1.250000	679	759	12	1	80	0.0125000
NODE_8222_length_927_cov_1.250000	679	759	13	33	80	0.4125000
NODE_8222_length_927_cov_1.250000	679	759	14	1	80	0.0125000
NODE_8222_length_927_cov_1.250000	679	759	15	5	80	0.0625000
NODE_8227_length_926_cov_78.382104	433	513	11	1	80	0.0125000
NODE_8227_length_926_cov_78.382104	433	513	13	4	80	0.0500000
NODE_8227_length_926_cov_78.382104	433	513	15	13	80	0.1625000
NODE_8227_length_926_cov_78.382104	433	513	16	7	80	0.0875000
NODE_8227_length_926_cov_78.382104	433	513	17	19	80	0.2375000
NODE_8227_length_926_cov_78.382104	433	513	18	15	80	0.1875000
NODE_8227_length_926_cov_78.382104	433	513	19	14	80	0.1750000
NODE_8227_length_926_cov_78.382104	433	513	20	7	80	0.0875000
NODE_8227_length_926_cov_78.382104	486	566	10	3	80	0.0375000
NODE_8227_length_926_cov_78.382104	486	566	12	16	80	0.2000000
NODE_8227_length_926_cov_78.382104	486	566	14	12	80	0.1500000
NODE_8227_length_926_cov_78.382104	486	566	15	11	80	0.1375000
NODE_8227_length_926_cov_78.382104	486	566	16	2	80	0.0250000
NODE_8227_length_926_cov_78.382104	486	566	17	23	80	0.2875000
NODE_8227_length_926_cov_78.382104	486	566	18	13	80	0.1625000
NODE_8228_length_926_cov_44.385732	383	463	11	4	80	0.0500000
NODE_8228_length_926_cov_44.385732	383	463	12	31	80	0.3875000
NODE_8228_length_926_cov_44.385732	383	463	13	20	80	0.2500000
NODE_8228_length_926_cov_44.385732	383	463	14	25	80	0.3125000
NODE_8228_length_926_cov_44.385732	436	516	7	1	80	0.0125000
NODE_8228_length_926_cov_44.385732	436	516	8	11	80	0.1375000
NODE_8228_length_926_cov_44.385732	436	516	9	14	80	0.1750000
NODE_8228_length_926_cov_44.385732	436	516	10	20	80	0.2500000
NODE_8228_length_926_cov_44.385732	436	516	11	10	80	0.1250000
NODE_8228_length_926_cov_44.385732	436	516	12	4	80	0.0500000
NODE_8228_length_926_cov_44.385732	436	516	13	1	80	0.0125000
NODE_8228_length_926_cov_44.385732	436	516	14	19	80	0.2375000
NODE_8229_length_926_cov_43.446191	362	442	9	4	80	0.0500000
NODE_8229_length_926_cov_43.446191	362	442	11	6	80	0.0750000
NODE_8229_length_926_cov_43.446191	362	442	12	10	80	0.1250000
NODE_8229_length_926_cov_43.446191	362	442	13	19	80	0.2375000
NODE_8229_length_926_cov_43.446191	362	442	14	20	80	0.2500000
NODE_8229_length_926_cov_43.446191	362	442	15	9	80	0.1125000
NODE_8229_length_926_cov_43.446191	362	442	16	1	80	0.0125000
NODE_8229_length_926_cov_43.446191	362	442	17	11	80	0.1375000
NODE_8229_length_926_cov_43.446191	415	495	13	13	80	0.1625000
NODE_8229_length_926_cov_43.446191	415	495	14	13	80	0.1625000
NODE_8229_length_926_cov_43.446191	415	495	15	25	80	0.3125000
NODE_8229_length_926_cov_43.446191	415	495	16	1	80	0.0125000
NODE_8229_length_926_cov_43.446191	415	495	17	17	80	0.2125000
NODE_8229_length_926_cov_43.446191	415	495	18	2	80	0.0250000
NODE_8229_length_926_cov_43.446191	415	495	19	4	80	0.0500000
NODE_8229_length_926_cov_43.446191	415	495	20	5	80	0.0625000
NODE_8229_length_926_cov_43.446191	491	571	18	7	80	0.0875000
NODE_8229_length_926_cov_43.446191	491	571	19	21	80	0.2625000
NODE_8229_length_926_cov_43.446191	491	571	20	28	80	0.3500000
NODE_8229_length_926_cov_43.446191	491	571	21	2	80	0.0250000
NODE_8229_length_926_cov_43.446191	491	571	22	1	80	0.0125000
NODE_8229_length_926_cov_43.446191	491	571	24	21	80	0.2625000
NODE_8229_length_926_cov_43.446191	544	624	11	11	80	0.1375000
NODE_8229_length_926_cov_43.446191	544	624	13	16	80	0.2000000
NODE_8229_length_926_cov_43.446191	544	624	16	1	80	0.0125000
NODE_8229_length_926_cov_43.446191	544	624	17	17	80	0.2125000
NODE_8229_length_926_cov_43.446191	544	624	18	7	80	0.0875000
NODE_8229_length_926_cov_43.446191	544	624	19	28	80	0.3500000
NODE_8230_length_926_cov_40.163241	42	61	0	19	19	1.0000000
NODE_8230_length_926_cov_40.163241	279	359	4	3	80	0.0375000
NODE_8230_length_926_cov_40.163241	279	359	5	58	80	0.7250000
NODE_8230_length_926_cov_40.163241	279	359	8	19	80	0.2375000
NODE_8230_length_926_cov_40.163241	332	412	1	22	80	0.2750000
NODE_8230_length_926_cov_40.163241	332	412	2	23	80	0.2875000
NODE_8230_length_926_cov_40.163241	332	412	4	6	80	0.0750000
NODE_8230_length_926_cov_40.163241	332	412	5	29	80	0.3625000
NODE_8230_length_926_cov_40.163241	408	488	1	80	80	1.0000000
NODE_8230_length_926_cov_40.163241	461	541	0	47	80	0.5875000
NODE_8230_length_926_cov_40.163241	461	541	1	33	80	0.4125000
NODE_8231_length_926_cov_29.923821	372	452	3	7	80	0.0875000
NODE_8231_length_926_cov_29.923821	372	452	4	5	80	0.0625000
NODE_8231_length_926_cov_29.923821	372	452	6	6	80	0.0750000
NODE_8231_length_926_cov_29.923821	372	452	8	18	80	0.2250000
NODE_8231_length_926_cov_29.923821	372	452	9	14	80	0.1750000
NODE_8231_length_926_cov_29.923821	372	452	10	30	80	0.3750000
NODE_8231_length_926_cov_29.923821	425	505	8	56	80	0.7000000
NODE_8231_length_926_cov_29.923821	425	505	9	24	80	0.3000000
NODE_8232_length_926_cov_24.657799	350	430	2	59	80	0.7375000
NODE_8232_length_926_cov_24.657799	350	430	3	21	80	0.2625000
NODE_8232_length_926_cov_24.657799	403	483	1	5	80	0.0625000
NODE_8232_length_926_cov_24.657799	403	483	2	14	80	0.1750000
NODE_8232_length_926_cov_24.657799	403	483	3	61	80	0.7625000
NODE_8233_length_926_cov_17.438936	360	440	2	5	80	0.0625000
NODE_8233_length_926_cov_17.438936	360	440	3	6	80	0.0750000
NODE_8233_length_926_cov_17.438936	360	440	4	39	80	0.4875000
NODE_8233_length_926_cov_17.438936	360	440	5	30	80	0.3750000
NODE_8233_length_926_cov_17.438936	413	493	4	13	80	0.1625000
NODE_8233_length_926_cov_17.438936	413	493	5	67	80	0.8375000
NODE_8234_length_926_cov_12.413543	418	491	4	12	73	0.1643836
NODE_8234_length_926_cov_12.413543	418	491	5	11	73	0.1506849
NODE_8234_length_926_cov_12.413543	418	491	6	18	73	0.2465753
NODE_8234_length_926_cov_12.413543	418	491	8	32	73	0.4383562
NODE_8234_length_926_cov_12.413543	464	544	7	3	80	0.0375000
NODE_8234_length_926_cov_12.413543	464	544	8	54	80	0.6750000
NODE_8234_length_926_cov_12.413543	464	544	10	23	80	0.2875000
NODE_8235_length_926_cov_5.771463	453	533	1	45	80	0.5625000
NODE_8235_length_926_cov_5.771463	453	533	2	5	80	0.0625000
NODE_8235_length_926_cov_5.771463	453	533	3	23	80	0.2875000
NODE_8235_length_926_cov_5.771463	453	533	4	7	80	0.0875000
NODE_8235_length_926_cov_5.771463	505	586	1	12	81	0.1481481
NODE_8235_length_926_cov_5.771463	505	586	2	5	81	0.0617284
NODE_8235_length_926_cov_5.771463	505	586	3	46	81	0.5679013
NODE_8235_length_926_cov_5.771463	505	586	4	18	81	0.2222222
NODE_8236_length_926_cov_5.209190	435	515	0	80	80	1.0000000
NODE_8236_length_926_cov_5.209190	488	568	0	80	80	1.0000000
NODE_8247_length_925_cov_40.767554	514	594	3	16	80	0.2000000
NODE_8247_length_925_cov_40.767554	514	594	5	56	80	0.7000000
NODE_8247_length_925_cov_40.767554	514	594	6	8	80	0.1000000
NODE_8247_length_925_cov_40.767554	567	647	3	7	80	0.0875000
NODE_8247_length_925_cov_40.767554	567	647	5	40	80	0.5000000
NODE_8247_length_925_cov_40.767554	567	647	6	12	80	0.1500000
NODE_8247_length_925_cov_40.767554	567	647	7	21	80	0.2625000
NODE_8248_length_925_cov_30.226392	262	342	1	78	80	0.9750000
NODE_8248_length_925_cov_30.226392	262	342	2	2	80	0.0250000
NODE_8248_length_925_cov_30.226392	315	395	1	33	80	0.4125000
NODE_8248_length_925_cov_30.226392	315	395	2	47	80	0.5875000
NODE_8248_length_925_cov_30.226392	391	471	1	80	80	1.0000000
NODE_8248_length_925_cov_30.226392	444	524	0	38	80	0.4750000
NODE_8248_length_925_cov_30.226392	444	524	1	42	80	0.5250000
NODE_8249_length_925_cov_22.075061	334	414	5	25	80	0.3125000
NODE_8249_length_925_cov_22.075061	334	414	9	55	80	0.6875000
NODE_8249_length_925_cov_22.075061	387	467	0	21	80	0.2625000
NODE_8249_length_925_cov_22.075061	387	467	4	4	80	0.0500000
NODE_8249_length_925_cov_22.075061	387	467	6	7	80	0.0875000
NODE_8249_length_925_cov_22.075061	387	467	8	14	80	0.1750000
NODE_8249_length_925_cov_22.075061	387	467	9	34	80	0.4250000
NODE_8250_length_925_cov_18.164649	410	490	2	47	80	0.5875000
NODE_8250_length_925_cov_18.164649	410	490	3	33	80	0.4125000
NODE_8250_length_925_cov_18.164649	464	543	2	20	79	0.2531646
NODE_8250_length_925_cov_18.164649	464	543	3	55	79	0.6962025
NODE_8250_length_925_cov_18.164649	464	543	4	4	79	0.0506329
NODE_8251_length_925_cov_14.067797	472	548	4	9	76	0.1184211
NODE_8251_length_925_cov_14.067797	472	548	5	43	76	0.5657895
NODE_8251_length_925_cov_14.067797	472	548	6	24	76	0.3157895
NODE_8251_length_925_cov_14.067797	525	601	3	50	76	0.6578947
NODE_8251_length_925_cov_14.067797	525	601	5	26	76	0.3421053
NODE_8252_length_925_cov_7.098063	418	498	0	12	80	0.1500000
NODE_8252_length_925_cov_7.098063	418	498	2	68	80	0.8500000
NODE_8252_length_925_cov_7.098063	471	551	0	65	80	0.8125000
NODE_8252_length_925_cov_7.098063	471	551	2	15	80	0.1875000
NODE_8266_length_924_cov_61.292121	397	477	4	16	80	0.2000000
NODE_8266_length_924_cov_61.292121	397	477	5	10	80	0.1250000
NODE_8266_length_924_cov_61.292121	397	477	6	1	80	0.0125000
NODE_8266_length_924_cov_61.292121	397	477	7	1	80	0.0125000
NODE_8266_length_924_cov_61.292121	397	477	8	10	80	0.1250000
NODE_8266_length_924_cov_61.292121	397	477	9	19	80	0.2375000
NODE_8266_length_924_cov_61.292121	397	477	10	23	80	0.2875000
NODE_8266_length_924_cov_61.292121	450	530	8	23	80	0.2875000
NODE_8266_length_924_cov_61.292121	450	530	9	4	80	0.0500000
NODE_8266_length_924_cov_61.292121	450	530	10	53	80	0.6625000
NODE_8267_length_924_cov_31.522424	375	455	4	38	80	0.4750000
NODE_8267_length_924_cov_31.522424	375	455	6	42	80	0.5250000
NODE_8267_length_924_cov_31.522424	428	508	3	11	80	0.1375000
NODE_8267_length_924_cov_31.522424	428	508	4	45	80	0.5625000
NODE_8267_length_924_cov_31.522424	428	508	6	24	80	0.3000000
NODE_8268_length_924_cov_30.446061	299	379	2	80	80	1.0000000
NODE_8268_length_924_cov_30.446061	352	432	0	10	80	0.1250000
NODE_8268_length_924_cov_30.446061	352	432	2	70	80	0.8750000
NODE_8268_length_924_cov_30.446061	428	508	0	58	80	0.7250000
NODE_8268_length_924_cov_30.446061	428	508	1	22	80	0.2750000
NODE_8268_length_924_cov_30.446061	481	561	0	5	80	0.0625000
NODE_8268_length_924_cov_30.446061	481	561	1	75	80	0.9375000
NODE_8269_length_924_cov_28.877576	542	622	2	19	80	0.2375000
NODE_8269_length_924_cov_28.877576	542	622	3	58	80	0.7250000
NODE_8269_length_924_cov_28.877576	542	622	4	3	80	0.0375000
NODE_8269_length_924_cov_28.877576	595	675	2	61	80	0.7625000
NODE_8269_length_924_cov_28.877576	595	675	3	19	80	0.2375000
NODE_8270_length_924_cov_27.261818	506	586	1	1	80	0.0125000
NODE_8270_length_924_cov_27.261818	506	586	2	6	80	0.0750000
NODE_8270_length_924_cov_27.261818	506	586	4	5	80	0.0625000
NODE_8270_length_924_cov_27.261818	506	586	5	68	80	0.8500000
NODE_8270_length_924_cov_27.261818	559	639	0	14	80	0.1750000
NODE_8270_length_924_cov_27.261818	559	639	1	40	80	0.5000000
NODE_8270_length_924_cov_27.261818	559	639	2	6	80	0.0750000
NODE_8270_length_924_cov_27.261818	559	639	4	5	80	0.0625000
NODE_8270_length_924_cov_27.261818	559	639	5	15	80	0.1875000
NODE_8271_length_924_cov_25.946667	371	451	1	14	80	0.1750000
NODE_8271_length_924_cov_25.946667	371	451	2	8	80	0.1000000
NODE_8271_length_924_cov_25.946667	371	451	3	58	80	0.7250000
NODE_8271_length_924_cov_25.946667	424	504	0	1	80	0.0125000
NODE_8271_length_924_cov_25.946667	424	504	1	66	80	0.8250000
NODE_8271_length_924_cov_25.946667	424	504	2	8	80	0.1000000
NODE_8271_length_924_cov_25.946667	424	504	3	5	80	0.0625000
NODE_8271_length_924_cov_25.946667	500	580	0	26	80	0.3250000
NODE_8271_length_924_cov_25.946667	500	580	1	3	80	0.0375000
NODE_8271_length_924_cov_25.946667	500	580	2	10	80	0.1250000
NODE_8271_length_924_cov_25.946667	500	580	3	16	80	0.2000000
NODE_8271_length_924_cov_25.946667	500	580	4	25	80	0.3125000
NODE_8271_length_924_cov_25.946667	553	633	3	2	80	0.0250000
NODE_8271_length_924_cov_25.946667	553	633	4	78	80	0.9750000
NODE_8272_length_924_cov_25.113939	305	385	1	42	80	0.5250000
NODE_8272_length_924_cov_25.113939	305	385	2	27	80	0.3375000
NODE_8272_length_924_cov_25.113939	305	385	3	11	80	0.1375000
NODE_8272_length_924_cov_25.113939	358	438	1	38	80	0.4750000
NODE_8272_length_924_cov_25.113939	358	438	2	8	80	0.1000000
NODE_8272_length_924_cov_25.113939	358	438	4	34	80	0.4250000
NODE_8272_length_924_cov_25.113939	434	514	1	9	80	0.1125000
NODE_8272_length_924_cov_25.113939	434	514	3	23	80	0.2875000
NODE_8272_length_924_cov_25.113939	434	514	4	48	80	0.6000000
NODE_8272_length_924_cov_25.113939	487	567	0	21	80	0.2625000
NODE_8272_length_924_cov_25.113939	487	567	1	41	80	0.5125000
NODE_8272_length_924_cov_25.113939	487	567	3	18	80	0.2250000
NODE_8273_length_924_cov_16.343030	481	561	3	7	80	0.0875000
NODE_8273_length_924_cov_16.343030	481	561	4	14	80	0.1750000
NODE_8273_length_924_cov_16.343030	481	561	6	59	80	0.7375000
NODE_8273_length_924_cov_16.343030	534	614	0	39	80	0.4875000
NODE_8273_length_924_cov_16.343030	534	614	2	12	80	0.1500000
NODE_8273_length_924_cov_16.343030	534	614	3	9	80	0.1125000
NODE_8273_length_924_cov_16.343030	534	614	4	3	80	0.0375000
NODE_8273_length_924_cov_16.343030	534	614	6	17	80	0.2125000
NODE_8274_length_924_cov_14.793939	299	379	0	24	80	0.3000000
NODE_8274_length_924_cov_14.793939	299	379	2	56	80	0.7000000
NODE_8274_length_924_cov_14.793939	352	432	0	3	80	0.0375000
NODE_8274_length_924_cov_14.793939	352	432	2	77	80	0.9625000
NODE_8275_length_924_cov_14.209697	485	562	0	14	77	0.1818182
NODE_8275_length_924_cov_14.209697	485	562	1	63	77	0.8181818
NODE_8275_length_924_cov_14.209697	535	615	1	47	80	0.5875000
NODE_8275_length_924_cov_14.209697	535	615	2	33	80	0.4125000
NODE_8276_length_924_cov_13.423030	287	367	4	31	80	0.3875000
NODE_8276_length_924_cov_13.423030	287	367	5	37	80	0.4625000
NODE_8276_length_924_cov_13.423030	287	367	6	12	80	0.1500000
NODE_8276_length_924_cov_13.423030	340	420	2	11	80	0.1375000
NODE_8276_length_924_cov_13.423030	340	420	4	67	80	0.8375000
NODE_8276_length_924_cov_13.423030	340	420	5	2	80	0.0250000
NODE_8277_length_924_cov_12.008485	237	307	6	18	70	0.2571429
NODE_8277_length_924_cov_12.008485	237	307	8	52	70	0.7428572
NODE_8279_length_924_cov_8.619394	560	640	8	4	80	0.0500000
NODE_8279_length_924_cov_8.619394	560	640	9	9	80	0.1125000
NODE_8279_length_924_cov_8.619394	560	640	11	67	80	0.8375000
NODE_8279_length_924_cov_8.619394	613	693	5	4	80	0.0500000
NODE_8279_length_924_cov_8.619394	613	693	6	1	80	0.0125000
NODE_8279_length_924_cov_8.619394	613	693	7	28	80	0.3500000
NODE_8279_length_924_cov_8.619394	613	693	8	10	80	0.1250000
NODE_8279_length_924_cov_8.619394	613	693	10	8	80	0.1000000
NODE_8279_length_924_cov_8.619394	613	693	11	29	80	0.3625000
NODE_8280_length_924_cov_4.640000	426	506	2	27	80	0.3375000
NODE_8280_length_924_cov_4.640000	426	506	4	53	80	0.6625000
NODE_8280_length_924_cov_4.640000	479	559	2	17	80	0.2125000
NODE_8280_length_924_cov_4.640000	479	559	4	63	80	0.7875000
NODE_8290_length_924_cov_1.467879	352	381	0	29	29	1.0000000
NODE_8296_length_924_cov_0.648485	830	890	0	60	60	1.0000000
NODE_8296_length_924_cov_0.648485	863	924	0	61	61	1.0000000
NODE_8297_length_923_cov_43.213592	371	451	10	6	80	0.0750000
NODE_8297_length_923_cov_43.213592	371	451	11	18	80	0.2250000
NODE_8297_length_923_cov_43.213592	371	451	12	23	80	0.2875000
NODE_8297_length_923_cov_43.213592	371	451	13	25	80	0.3125000
NODE_8297_length_923_cov_43.213592	371	451	14	8	80	0.1000000
NODE_8297_length_923_cov_43.213592	424	504	7	7	80	0.0875000
NODE_8297_length_923_cov_43.213592	424	504	8	16	80	0.2000000
NODE_8297_length_923_cov_43.213592	424	504	9	18	80	0.2250000
NODE_8297_length_923_cov_43.213592	424	504	10	7	80	0.0875000
NODE_8297_length_923_cov_43.213592	424	504	11	21	80	0.2625000
NODE_8297_length_923_cov_43.213592	424	504	12	11	80	0.1375000
NODE_8297_length_923_cov_43.213592	500	580	6	17	80	0.2125000
NODE_8297_length_923_cov_43.213592	500	580	7	16	80	0.2000000
NODE_8297_length_923_cov_43.213592	500	580	8	47	80	0.5875000
NODE_8297_length_923_cov_43.213592	553	633	2	2	80	0.0250000
NODE_8297_length_923_cov_43.213592	553	633	3	7	80	0.0875000
NODE_8297_length_923_cov_43.213592	553	633	4	4	80	0.0500000
NODE_8297_length_923_cov_43.213592	553	633	5	12	80	0.1500000
NODE_8297_length_923_cov_43.213592	553	633	6	27	80	0.3375000
NODE_8297_length_923_cov_43.213592	553	633	7	5	80	0.0625000
NODE_8297_length_923_cov_43.213592	553	633	8	23	80	0.2875000
NODE_8298_length_923_cov_34.108010	370	450	7	2	80	0.0250000
NODE_8298_length_923_cov_34.108010	370	450	8	6	80	0.0750000
NODE_8298_length_923_cov_34.108010	370	450	9	72	80	0.9000000
NODE_8298_length_923_cov_34.108010	423	503	6	14	80	0.1750000
NODE_8298_length_923_cov_34.108010	423	503	7	29	80	0.3625000
NODE_8298_length_923_cov_34.108010	423	503	8	16	80	0.2000000
NODE_8298_length_923_cov_34.108010	423	503	9	21	80	0.2625000
NODE_8299_length_923_cov_29.163835	392	472	4	33	80	0.4125000
NODE_8299_length_923_cov_29.163835	392	472	5	47	80	0.5875000
NODE_8299_length_923_cov_29.163835	445	525	3	1	80	0.0125000
NODE_8299_length_923_cov_29.163835	445	525	4	13	80	0.1625000
NODE_8299_length_923_cov_29.163835	445	525	5	47	80	0.5875000
NODE_8299_length_923_cov_29.163835	445	525	6	19	80	0.2375000
NODE_8300_length_923_cov_19.139563	375	455	2	10	80	0.1250000
NODE_8300_length_923_cov_19.139563	375	455	4	54	80	0.6750000
NODE_8300_length_923_cov_19.139563	375	455	5	3	80	0.0375000
NODE_8300_length_923_cov_19.139563	375	455	6	13	80	0.1625000
NODE_8300_length_923_cov_19.139563	428	508	4	16	80	0.2000000
NODE_8300_length_923_cov_19.139563	428	508	5	3	80	0.0375000
NODE_8300_length_923_cov_19.139563	428	508	6	61	80	0.7625000
NODE_8301_length_923_cov_17.433252	512	592	8	2	80	0.0250000
NODE_8301_length_923_cov_17.433252	512	592	10	8	80	0.1000000
NODE_8301_length_923_cov_17.433252	512	592	12	8	80	0.1000000
NODE_8301_length_923_cov_17.433252	512	592	14	8	80	0.1000000
NODE_8301_length_923_cov_17.433252	512	592	16	14	80	0.1750000
NODE_8301_length_923_cov_17.433252	512	592	18	2	80	0.0250000
NODE_8301_length_923_cov_17.433252	512	592	19	38	80	0.4750000
NODE_8301_length_923_cov_17.433252	565	645	10	16	80	0.2000000
NODE_8301_length_923_cov_17.433252	565	645	11	12	80	0.1500000
NODE_8301_length_923_cov_17.433252	565	645	13	3	80	0.0375000
NODE_8301_length_923_cov_17.433252	565	645	15	2	80	0.0250000
NODE_8301_length_923_cov_17.433252	565	645	17	4	80	0.0500000
NODE_8301_length_923_cov_17.433252	565	645	18	2	80	0.0250000
NODE_8301_length_923_cov_17.433252	565	645	19	41	80	0.5125000
NODE_8302_length_923_cov_16.597087	279	359	7	7	80	0.0875000
NODE_8302_length_923_cov_16.597087	279	359	8	72	80	0.9000000
NODE_8302_length_923_cov_16.597087	279	359	9	1	80	0.0125000
NODE_8302_length_923_cov_16.597087	332	412	5	28	80	0.3500000
NODE_8302_length_923_cov_16.597087	332	412	6	6	80	0.0750000
NODE_8302_length_923_cov_16.597087	332	412	8	35	80	0.4375000
NODE_8302_length_923_cov_16.597087	332	412	9	11	80	0.1375000
NODE_8303_length_923_cov_15.229369	446	526	0	46	80	0.5750000
NODE_8303_length_923_cov_15.229369	446	526	1	34	80	0.4250000
NODE_8303_length_923_cov_15.229369	499	579	1	31	80	0.3875000
NODE_8303_length_923_cov_15.229369	499	579	2	49	80	0.6125000
NODE_8304_length_923_cov_14.007282	304	349	0	43	45	0.9555556
NODE_8304_length_923_cov_14.007282	304	349	3	2	45	0.0444444
NODE_8304_length_923_cov_14.007282	345	427	0	28	82	0.3414634
NODE_8304_length_923_cov_14.007282	345	427	1	46	82	0.5609756
NODE_8304_length_923_cov_14.007282	345	427	2	8	82	0.0975610
NODE_8304_length_923_cov_14.007282	397	480	1	22	83	0.2650602
NODE_8304_length_923_cov_14.007282	397	480	2	61	83	0.7349398
NODE_8305_length_923_cov_6.500000	308	388	5	6	80	0.0750000
NODE_8305_length_923_cov_6.500000	308	388	6	20	80	0.2500000
NODE_8305_length_923_cov_6.500000	308	388	7	44	80	0.5500000
NODE_8305_length_923_cov_6.500000	308	388	8	5	80	0.0625000
NODE_8305_length_923_cov_6.500000	308	388	9	5	80	0.0625000
NODE_8305_length_923_cov_6.500000	361	441	6	11	80	0.1375000
NODE_8305_length_923_cov_6.500000	361	441	7	41	80	0.5125000
NODE_8305_length_923_cov_6.500000	361	441	8	23	80	0.2875000
NODE_8305_length_923_cov_6.500000	361	441	9	5	80	0.0625000
NODE_8307_length_923_cov_6.115291	447	527	1	80	80	1.0000000
NODE_8307_length_923_cov_6.115291	500	580	0	25	80	0.3125000
NODE_8307_length_923_cov_6.115291	500	580	1	55	80	0.6875000
NODE_8308_length_923_cov_5.351942	363	445	0	16	82	0.1951219
NODE_8308_length_923_cov_5.351942	363	445	2	66	82	0.8048781
NODE_8308_length_923_cov_5.351942	365	445	0	14	80	0.1750000
NODE_8308_length_923_cov_5.351942	365	445	2	66	80	0.8250000
NODE_8317_length_923_cov_1.059466	63	143	0	51	80	0.6375000
NODE_8317_length_923_cov_1.059466	63	143	2	29	80	0.3625000
NODE_8320_length_922_cov_40.331713	243	289	11	15	46	0.3260870
NODE_8320_length_922_cov_40.331713	243	289	12	7	46	0.1521739
NODE_8320_length_922_cov_40.331713	243	289	13	5	46	0.1086956
NODE_8320_length_922_cov_40.331713	243	289	14	8	46	0.1739130
NODE_8320_length_922_cov_40.331713	243	289	15	1	46	0.0217391
NODE_8320_length_922_cov_40.331713	243	289	16	5	46	0.1086956
NODE_8320_length_922_cov_40.331713	243	289	17	1	46	0.0217391
NODE_8320_length_922_cov_40.331713	243	289	19	3	46	0.0652174
NODE_8320_length_922_cov_40.331713	243	289	20	1	46	0.0217391
NODE_8320_length_922_cov_40.331713	262	342	11	5	80	0.0625000
NODE_8320_length_922_cov_40.331713	262	342	12	5	80	0.0625000
NODE_8320_length_922_cov_40.331713	262	342	13	5	80	0.0625000
NODE_8320_length_922_cov_40.331713	262	342	14	1	80	0.0125000
NODE_8320_length_922_cov_40.331713	262	342	15	1	80	0.0125000
NODE_8320_length_922_cov_40.331713	262	342	16	5	80	0.0625000
NODE_8320_length_922_cov_40.331713	262	342	17	1	80	0.0125000
NODE_8320_length_922_cov_40.331713	262	342	19	3	80	0.0375000
NODE_8320_length_922_cov_40.331713	262	342	20	1	80	0.0125000
NODE_8320_length_922_cov_40.331713	262	342	21	2	80	0.0250000
NODE_8320_length_922_cov_40.331713	262	342	23	3	80	0.0375000
NODE_8320_length_922_cov_40.331713	262	342	24	5	80	0.0625000
NODE_8320_length_922_cov_40.331713	262	342	25	6	80	0.0750000
NODE_8320_length_922_cov_40.331713	262	342	26	7	80	0.0875000
NODE_8320_length_922_cov_40.331713	262	342	27	21	80	0.2625000
NODE_8320_length_922_cov_40.331713	262	342	28	9	80	0.1125000
NODE_8320_length_922_cov_40.331713	780	860	4	80	80	1.0000000
NODE_8320_length_922_cov_40.331713	833	913	0	18	80	0.2250000
NODE_8320_length_922_cov_40.331713	833	913	1	3	80	0.0375000
NODE_8320_length_922_cov_40.331713	833	913	3	18	80	0.2250000
NODE_8320_length_922_cov_40.331713	833	913	4	41	80	0.5125000
NODE_8321_length_922_cov_38.549210	126	177	37	1	51	0.0196078
NODE_8321_length_922_cov_38.549210	126	177	39	3	51	0.0588235
NODE_8321_length_922_cov_38.549210	126	177	42	4	51	0.0784314
NODE_8321_length_922_cov_38.549210	126	177	44	2	51	0.0392157
NODE_8321_length_922_cov_38.549210	126	177	45	2	51	0.0392157
NODE_8321_length_922_cov_38.549210	126	177	46	1	51	0.0196078
NODE_8321_length_922_cov_38.549210	126	177	48	1	51	0.0196078
NODE_8321_length_922_cov_38.549210	126	177	51	3	51	0.0588235
NODE_8321_length_922_cov_38.549210	126	177	53	1	51	0.0196078
NODE_8321_length_922_cov_38.549210	126	177	54	7	51	0.1372549
NODE_8321_length_922_cov_38.549210	126	177	55	6	51	0.1176471
NODE_8321_length_922_cov_38.549210	126	177	56	7	51	0.1372549
NODE_8321_length_922_cov_38.549210	126	177	57	1	51	0.0196078
NODE_8321_length_922_cov_38.549210	126	177	58	4	51	0.0784314
NODE_8321_length_922_cov_38.549210	126	177	60	1	51	0.0196078
NODE_8321_length_922_cov_38.549210	126	177	65	2	51	0.0392157
NODE_8321_length_922_cov_38.549210	126	177	66	1	51	0.0196078
NODE_8321_length_922_cov_38.549210	126	177	69	2	51	0.0392157
NODE_8321_length_922_cov_38.549210	126	177	70	2	51	0.0392157
NODE_8321_length_922_cov_38.549210	308	383	0	75	75	1.0000000
NODE_8321_length_922_cov_38.549210	356	393	0	37	37	1.0000000
NODE_8321_length_922_cov_38.549210	818	898	0	80	80	1.0000000
NODE_8321_length_922_cov_38.549210	871	908	0	37	37	1.0000000
NODE_8322_length_922_cov_35.041312	385	465	3	17	80	0.2125000
NODE_8322_length_922_cov_35.041312	385	465	5	48	80	0.6000000
NODE_8322_length_922_cov_35.041312	385	465	6	1	80	0.0125000
NODE_8322_length_922_cov_35.041312	385	465	7	10	80	0.1250000
NODE_8322_length_922_cov_35.041312	385	465	10	4	80	0.0500000
NODE_8322_length_922_cov_35.041312	438	518	5	12	80	0.1500000
NODE_8322_length_922_cov_35.041312	438	518	6	1	80	0.0125000
NODE_8322_length_922_cov_35.041312	438	518	7	10	80	0.1250000
NODE_8322_length_922_cov_35.041312	438	518	9	2	80	0.0250000
NODE_8322_length_922_cov_35.041312	438	518	10	26	80	0.3250000
NODE_8322_length_922_cov_35.041312	438	518	11	29	80	0.3625000
NODE_8323_length_922_cov_30.749696	426	506	5	2	80	0.0250000
NODE_8323_length_922_cov_30.749696	426	506	6	22	80	0.2750000
NODE_8323_length_922_cov_30.749696	426	506	7	5	80	0.0625000
NODE_8323_length_922_cov_30.749696	426	506	8	51	80	0.6375000
NODE_8323_length_922_cov_30.749696	479	559	2	8	80	0.1000000
NODE_8323_length_922_cov_30.749696	479	559	3	9	80	0.1125000
NODE_8323_length_922_cov_30.749696	479	559	4	21	80	0.2625000
NODE_8323_length_922_cov_30.749696	479	559	5	17	80	0.2125000
NODE_8323_length_922_cov_30.749696	479	559	6	22	80	0.2750000
NODE_8323_length_922_cov_30.749696	479	559	7	3	80	0.0375000
NODE_8324_length_922_cov_25.558931	291	370	4	2	79	0.0253165
NODE_8324_length_922_cov_25.558931	291	370	5	35	79	0.4430380
NODE_8324_length_922_cov_25.558931	291	370	6	8	79	0.1012658
NODE_8324_length_922_cov_25.558931	291	370	7	34	79	0.4303797
NODE_8324_length_922_cov_25.558931	344	423	4	2	79	0.0253165
NODE_8324_length_922_cov_25.558931	344	423	5	75	79	0.9493671
NODE_8324_length_922_cov_25.558931	344	423	6	2	79	0.0253165
NODE_8325_length_922_cov_25.527339	391	471	5	76	80	0.9500000
NODE_8325_length_922_cov_25.527339	391	471	6	4	80	0.0500000
NODE_8325_length_922_cov_25.527339	444	524	2	2	80	0.0250000
NODE_8325_length_922_cov_25.527339	444	524	3	11	80	0.1375000
NODE_8325_length_922_cov_25.527339	444	524	4	6	80	0.0750000
NODE_8325_length_922_cov_25.527339	444	524	5	30	80	0.3750000
NODE_8325_length_922_cov_25.527339	444	524	6	31	80	0.3875000
NODE_8326_length_922_cov_23.630620	224	304	9	3	80	0.0375000
NODE_8326_length_922_cov_23.630620	224	304	10	4	80	0.0500000
NODE_8326_length_922_cov_23.630620	224	304	12	3	80	0.0375000
NODE_8326_length_922_cov_23.630620	224	304	14	28	80	0.3500000
NODE_8326_length_922_cov_23.630620	224	304	16	9	80	0.1125000
NODE_8326_length_922_cov_23.630620	224	304	17	32	80	0.4000000
NODE_8326_length_922_cov_23.630620	224	304	18	1	80	0.0125000
NODE_8326_length_922_cov_23.630620	277	357	5	10	80	0.1250000
NODE_8326_length_922_cov_23.630620	277	357	6	8	80	0.1000000
NODE_8326_length_922_cov_23.630620	277	357	7	3	80	0.0375000
NODE_8326_length_922_cov_23.630620	277	357	11	17	80	0.2125000
NODE_8326_length_922_cov_23.630620	277	357	13	1	80	0.0125000
NODE_8326_length_922_cov_23.630620	277	357	15	13	80	0.1625000
NODE_8326_length_922_cov_23.630620	277	357	16	9	80	0.1125000
NODE_8326_length_922_cov_23.630620	277	357	17	18	80	0.2250000
NODE_8326_length_922_cov_23.630620	277	357	18	1	80	0.0125000
NODE_8326_length_922_cov_23.630620	353	433	1	20	80	0.2500000
NODE_8326_length_922_cov_23.630620	353	433	2	35	80	0.4375000
NODE_8326_length_922_cov_23.630620	353	433	4	1	80	0.0125000
NODE_8326_length_922_cov_23.630620	353	433	5	24	80	0.3000000
NODE_8326_length_922_cov_23.630620	406	486	0	4	80	0.0500000
NODE_8326_length_922_cov_23.630620	406	486	1	39	80	0.4875000
NODE_8326_length_922_cov_23.630620	406	486	2	20	80	0.2500000
NODE_8326_length_922_cov_23.630620	406	486	3	17	80	0.2125000
NODE_8327_length_922_cov_22.388821	465	545	5	5	80	0.0625000
NODE_8327_length_922_cov_22.388821	465	545	7	17	80	0.2125000
NODE_8327_length_922_cov_22.388821	465	545	9	32	80	0.4000000
NODE_8327_length_922_cov_22.388821	465	545	10	9	80	0.1125000
NODE_8327_length_922_cov_22.388821	465	545	11	17	80	0.2125000
NODE_8327_length_922_cov_22.388821	518	598	5	2	80	0.0250000
NODE_8327_length_922_cov_22.388821	518	598	7	59	80	0.7375000
NODE_8327_length_922_cov_22.388821	518	598	9	7	80	0.0875000
NODE_8327_length_922_cov_22.388821	518	598	10	1	80	0.0125000
NODE_8327_length_922_cov_22.388821	518	598	11	11	80	0.1375000
NODE_8328_length_922_cov_20.320778	421	501	2	25	80	0.3125000
NODE_8328_length_922_cov_20.320778	421	501	4	53	80	0.6625000
NODE_8328_length_922_cov_20.320778	421	501	5	2	80	0.0250000
NODE_8328_length_922_cov_20.320778	474	554	3	9	80	0.1125000
NODE_8328_length_922_cov_20.320778	474	554	4	42	80	0.5250000
NODE_8328_length_922_cov_20.320778	474	554	5	29	80	0.3625000
NODE_8329_length_922_cov_17.645200	413	479	2	66	66	1.0000000
NODE_8330_length_922_cov_12.574727	454	534	11	9	80	0.1125000
NODE_8330_length_922_cov_12.574727	454	534	12	14	80	0.1750000
NODE_8330_length_922_cov_12.574727	454	534	13	14	80	0.1750000
NODE_8330_length_922_cov_12.574727	454	534	14	1	80	0.0125000
NODE_8330_length_922_cov_12.574727	454	534	17	19	80	0.2375000
NODE_8330_length_922_cov_12.574727	454	534	18	23	80	0.2875000
NODE_8330_length_922_cov_12.574727	507	587	10	2	80	0.0250000
NODE_8330_length_922_cov_12.574727	507	587	11	12	80	0.1500000
NODE_8330_length_922_cov_12.574727	507	587	13	27	80	0.3375000
NODE_8330_length_922_cov_12.574727	507	587	14	1	80	0.0125000
NODE_8330_length_922_cov_12.574727	507	587	15	9	80	0.1125000
NODE_8330_length_922_cov_12.574727	507	587	16	1	80	0.0125000
NODE_8330_length_922_cov_12.574727	507	587	17	5	80	0.0625000
NODE_8330_length_922_cov_12.574727	507	587	18	23	80	0.2875000
NODE_8331_length_922_cov_11.934386	255	335	0	18	80	0.2250000
NODE_8331_length_922_cov_11.934386	255	335	1	39	80	0.4875000
NODE_8331_length_922_cov_11.934386	255	335	2	23	80	0.2875000
NODE_8331_length_922_cov_11.934386	308	388	0	71	80	0.8875000
NODE_8331_length_922_cov_11.934386	308	388	1	9	80	0.1125000
NODE_8332_length_922_cov_11.068044	423	503	3	19	80	0.2375000
NODE_8332_length_922_cov_11.068044	423	503	4	23	80	0.2875000
NODE_8332_length_922_cov_11.068044	423	503	6	11	80	0.1375000
NODE_8332_length_922_cov_11.068044	423	503	8	27	80	0.3375000
NODE_8332_length_922_cov_11.068044	476	557	1	11	81	0.1358025
NODE_8332_length_922_cov_11.068044	476	557	3	10	81	0.1234568
NODE_8332_length_922_cov_11.068044	476	557	5	23	81	0.2839506
NODE_8332_length_922_cov_11.068044	476	557	7	10	81	0.1234568
NODE_8332_length_922_cov_11.068044	476	557	8	27	81	0.3333333
NODE_8333_length_922_cov_7.907655	441	521	0	80	80	1.0000000
NODE_8333_length_922_cov_7.907655	494	574	0	80	80	1.0000000
NODE_8334_length_922_cov_7.737546	463	543	0	80	80	1.0000000
NODE_8334_length_922_cov_7.737546	516	596	0	80	80	1.0000000
NODE_8335_length_922_cov_7.241798	298	378	1	49	80	0.6125000
NODE_8335_length_922_cov_7.241798	298	378	2	3	80	0.0375000
NODE_8335_length_922_cov_7.241798	298	378	3	19	80	0.2375000
NODE_8335_length_922_cov_7.241798	298	378	4	9	80	0.1125000
NODE_8335_length_922_cov_7.241798	351	431	3	71	80	0.8875000
NODE_8335_length_922_cov_7.241798	351	431	4	9	80	0.1125000
NODE_8347_length_921_cov_21.317518	457	537	0	80	80	1.0000000
NODE_8347_length_921_cov_21.317518	510	590	0	80	80	1.0000000
NODE_8348_length_921_cov_18.462287	519	599	0	24	80	0.3000000
NODE_8348_length_921_cov_18.462287	519	599	1	56	80	0.7000000
NODE_8348_length_921_cov_18.462287	572	652	0	77	80	0.9625000
NODE_8348_length_921_cov_18.462287	572	652	1	3	80	0.0375000
NODE_8349_length_921_cov_15.440389	373	453	2	80	80	1.0000000
NODE_8349_length_921_cov_15.440389	426	506	1	36	80	0.4500000
NODE_8349_length_921_cov_15.440389	426	506	2	44	80	0.5500000
NODE_8350_length_921_cov_13.216545	465	545	1	17	80	0.2125000
NODE_8350_length_921_cov_13.216545	465	545	2	63	80	0.7875000
NODE_8350_length_921_cov_13.216545	518	598	1	70	80	0.8750000
NODE_8350_length_921_cov_13.216545	518	598	2	10	80	0.1250000
NODE_8351_length_921_cov_9.283455	399	439	0	33	40	0.8250000
NODE_8351_length_921_cov_9.283455	399	439	1	7	40	0.1750000
NODE_8351_length_921_cov_9.283455	532	612	0	80	80	1.0000000
NODE_8351_length_921_cov_9.283455	585	665	0	80	80	1.0000000
NODE_8352_length_921_cov_8.253041	289	369	3	45	80	0.5625000
NODE_8352_length_921_cov_8.253041	289	369	4	35	80	0.4375000
NODE_8352_length_921_cov_8.253041	342	422	0	1	80	0.0125000
NODE_8352_length_921_cov_8.253041	342	422	1	19	80	0.2375000
NODE_8352_length_921_cov_8.253041	342	422	3	60	80	0.7500000
NODE_8364_length_920_cov_47.493301	543	623	2	4	80	0.0500000
NODE_8364_length_920_cov_47.493301	543	623	3	15	80	0.1875000
NODE_8364_length_920_cov_47.493301	543	623	4	1	80	0.0125000
NODE_8364_length_920_cov_47.493301	543	623	5	2	80	0.0250000
NODE_8364_length_920_cov_47.493301	543	623	7	5	80	0.0625000
NODE_8364_length_920_cov_47.493301	543	623	8	15	80	0.1875000
NODE_8364_length_920_cov_47.493301	543	623	9	6	80	0.0750000
NODE_8364_length_920_cov_47.493301	543	623	10	29	80	0.3625000
NODE_8364_length_920_cov_47.493301	543	623	11	3	80	0.0375000
NODE_8364_length_920_cov_47.493301	596	676	9	22	80	0.2750000
NODE_8364_length_920_cov_47.493301	596	676	10	24	80	0.3000000
NODE_8364_length_920_cov_47.493301	596	676	11	34	80	0.4250000
NODE_8365_length_920_cov_30.404385	543	623	3	17	80	0.2125000
NODE_8365_length_920_cov_30.404385	543	623	5	8	80	0.1000000
NODE_8365_length_920_cov_30.404385	543	623	6	4	80	0.0500000
NODE_8365_length_920_cov_30.404385	543	623	7	51	80	0.6375000
NODE_8365_length_920_cov_30.404385	596	676	6	29	80	0.3625000
NODE_8365_length_920_cov_30.404385	596	676	7	51	80	0.6375000
NODE_8366_length_920_cov_25.360536	413	493	2	3	80	0.0375000
NODE_8366_length_920_cov_25.360536	413	493	3	7	80	0.0875000
NODE_8366_length_920_cov_25.360536	413	493	5	4	80	0.0500000
NODE_8366_length_920_cov_25.360536	413	493	6	2	80	0.0250000
NODE_8366_length_920_cov_25.360536	413	493	7	9	80	0.1125000
NODE_8366_length_920_cov_25.360536	413	493	8	10	80	0.1250000
NODE_8366_length_920_cov_25.360536	413	493	10	5	80	0.0625000
NODE_8366_length_920_cov_25.360536	413	493	11	11	80	0.1375000
NODE_8366_length_920_cov_25.360536	413	493	12	29	80	0.3625000
NODE_8366_length_920_cov_25.360536	466	546	11	1	80	0.0125000
NODE_8366_length_920_cov_25.360536	466	546	12	48	80	0.6000000
NODE_8366_length_920_cov_25.360536	466	546	13	2	80	0.0250000
NODE_8366_length_920_cov_25.360536	466	546	14	11	80	0.1375000
NODE_8366_length_920_cov_25.360536	466	546	15	1	80	0.0125000
NODE_8366_length_920_cov_25.360536	466	546	16	17	80	0.2125000
NODE_8366_length_920_cov_25.360536	542	615	10	3	73	0.0410959
NODE_8366_length_920_cov_25.360536	542	615	12	6	73	0.0821918
NODE_8366_length_920_cov_25.360536	542	615	13	8	73	0.1095890
NODE_8366_length_920_cov_25.360536	542	615	14	6	73	0.0821918
NODE_8366_length_920_cov_25.360536	542	615	15	22	73	0.3013699
NODE_8366_length_920_cov_25.360536	542	615	16	4	73	0.0547945
NODE_8366_length_920_cov_25.360536	542	615	17	10	73	0.1369863
NODE_8366_length_920_cov_25.360536	542	615	18	12	73	0.1643836
NODE_8366_length_920_cov_25.360536	542	615	19	2	73	0.0273973
NODE_8366_length_920_cov_25.360536	588	668	6	11	80	0.1375000
NODE_8366_length_920_cov_25.360536	588	668	7	2	80	0.0250000
NODE_8366_length_920_cov_25.360536	588	668	8	8	80	0.1000000
NODE_8366_length_920_cov_25.360536	588	668	9	12	80	0.1500000
NODE_8366_length_920_cov_25.360536	588	668	10	23	80	0.2875000
NODE_8366_length_920_cov_25.360536	588	668	12	6	80	0.0750000
NODE_8366_length_920_cov_25.360536	588	668	13	2	80	0.0250000
NODE_8366_length_920_cov_25.360536	588	668	15	16	80	0.2000000
NODE_8367_length_920_cov_24.918392	403	483	5	11	80	0.1375000
NODE_8367_length_920_cov_24.918392	403	483	6	35	80	0.4375000
NODE_8367_length_920_cov_24.918392	403	483	7	34	80	0.4250000
NODE_8367_length_920_cov_24.918392	456	536	3	12	80	0.1500000
NODE_8367_length_920_cov_24.918392	456	536	4	1	80	0.0125000
NODE_8367_length_920_cov_24.918392	456	536	6	57	80	0.7125000
NODE_8367_length_920_cov_24.918392	456	536	7	10	80	0.1250000
NODE_8368_length_920_cov_18.517661	353	433	2	80	80	1.0000000
NODE_8368_length_920_cov_18.517661	406	486	0	10	80	0.1250000
NODE_8368_length_920_cov_18.517661	406	486	2	70	80	0.8750000
NODE_8369_length_920_cov_17.710110	310	390	6	31	80	0.3875000
NODE_8369_length_920_cov_17.710110	310	390	7	27	80	0.3375000
NODE_8369_length_920_cov_17.710110	310	390	8	22	80	0.2750000
NODE_8369_length_920_cov_17.710110	363	443	4	36	80	0.4500000
NODE_8369_length_920_cov_17.710110	363	443	5	11	80	0.1375000
NODE_8369_length_920_cov_17.710110	363	443	7	33	80	0.4125000
NODE_8370_length_920_cov_15.650426	403	458	0	53	55	0.9636363
NODE_8370_length_920_cov_15.650426	403	458	1	2	55	0.0363636
NODE_8371_length_920_cov_12.588307	454	534	8	2	80	0.0250000
NODE_8371_length_920_cov_12.588307	454	534	9	28	80	0.3500000
NODE_8371_length_920_cov_12.588307	454	534	10	14	80	0.1750000
NODE_8371_length_920_cov_12.588307	454	534	11	29	80	0.3625000
NODE_8371_length_920_cov_12.588307	454	534	12	7	80	0.0875000
NODE_8371_length_920_cov_12.588307	507	586	5	33	79	0.4177215
NODE_8371_length_920_cov_12.588307	507	586	6	5	79	0.0632911
NODE_8371_length_920_cov_12.588307	507	586	8	2	79	0.0253165
NODE_8371_length_920_cov_12.588307	507	586	9	23	79	0.2911392
NODE_8371_length_920_cov_12.588307	507	586	10	7	79	0.0886076
NODE_8371_length_920_cov_12.588307	507	586	11	2	79	0.0253165
NODE_8371_length_920_cov_12.588307	507	586	12	7	79	0.0886076
NODE_8372_length_920_cov_10.822168	354	434	2	3	80	0.0375000
NODE_8372_length_920_cov_10.822168	354	434	3	23	80	0.2875000
NODE_8372_length_920_cov_10.822168	354	434	4	17	80	0.2125000
NODE_8372_length_920_cov_10.822168	354	434	5	37	80	0.4625000
NODE_8372_length_920_cov_10.822168	407	487	3	40	80	0.5000000
NODE_8372_length_920_cov_10.822168	407	487	5	40	80	0.5000000
NODE_8374_length_920_cov_8.297199	453	533	0	80	80	1.0000000
NODE_8374_length_920_cov_8.297199	506	583	0	77	77	1.0000000
NODE_8378_length_920_cov_2.992692	501	581	1	80	80	1.0000000
NODE_8378_length_920_cov_2.992692	554	634	1	51	80	0.6375000
NODE_8378_length_920_cov_2.992692	554	634	2	29	80	0.3625000
NODE_8389_length_919_cov_44.813415	338	418	2	37	80	0.4625000
NODE_8389_length_919_cov_44.813415	338	418	3	28	80	0.3500000
NODE_8389_length_919_cov_44.813415	338	418	4	15	80	0.1875000
NODE_8389_length_919_cov_44.813415	391	471	3	71	80	0.8875000
NODE_8389_length_919_cov_44.813415	391	471	4	9	80	0.1125000
NODE_8389_length_919_cov_44.813415	467	547	2	66	80	0.8250000
NODE_8389_length_919_cov_44.813415	467	547	3	11	80	0.1375000
NODE_8389_length_919_cov_44.813415	467	547	4	3	80	0.0375000
NODE_8389_length_919_cov_44.813415	520	600	2	28	80	0.3500000
NODE_8389_length_919_cov_44.813415	520	600	3	18	80	0.2250000
NODE_8389_length_919_cov_44.813415	520	600	4	34	80	0.4250000
NODE_8390_length_919_cov_37.459756	389	469	6	7	80	0.0875000
NODE_8390_length_919_cov_37.459756	389	469	7	49	80	0.6125000
NODE_8390_length_919_cov_37.459756	389	469	8	16	80	0.2000000
NODE_8390_length_919_cov_37.459756	389	469	9	8	80	0.1000000
NODE_8390_length_919_cov_37.459756	442	522	6	17	80	0.2125000
NODE_8390_length_919_cov_37.459756	442	522	7	39	80	0.4875000
NODE_8390_length_919_cov_37.459756	442	522	8	16	80	0.2000000
NODE_8390_length_919_cov_37.459756	442	522	9	8	80	0.1000000
NODE_8390_length_919_cov_37.459756	518	598	3	15	80	0.1875000
NODE_8390_length_919_cov_37.459756	518	598	4	4	80	0.0500000
NODE_8390_length_919_cov_37.459756	518	598	5	38	80	0.4750000
NODE_8390_length_919_cov_37.459756	518	598	6	23	80	0.2875000
NODE_8390_length_919_cov_37.459756	571	651	3	6	80	0.0750000
NODE_8390_length_919_cov_37.459756	571	651	4	20	80	0.2500000
NODE_8390_length_919_cov_37.459756	571	651	5	54	80	0.6750000
NODE_8391_length_919_cov_35.002439	474	554	2	47	80	0.5875000
NODE_8391_length_919_cov_35.002439	474	554	4	33	80	0.4125000
NODE_8391_length_919_cov_35.002439	527	607	2	3	80	0.0375000
NODE_8391_length_919_cov_35.002439	527	607	4	77	80	0.9625000
NODE_8392_length_919_cov_29.935366	246	326	0	23	80	0.2875000
NODE_8392_length_919_cov_29.935366	246	326	1	42	80	0.5250000
NODE_8392_length_919_cov_29.935366	246	326	2	15	80	0.1875000
NODE_8392_length_919_cov_29.935366	299	379	1	12	80	0.1500000
NODE_8392_length_919_cov_29.935366	299	379	2	61	80	0.7625000
NODE_8392_length_919_cov_29.935366	299	379	3	7	80	0.0875000
NODE_8393_length_919_cov_28.190244	470	550	3	14	80	0.1750000
NODE_8393_length_919_cov_28.190244	470	550	4	4	80	0.0500000
NODE_8393_length_919_cov_28.190244	470	550	5	2	80	0.0250000
NODE_8393_length_919_cov_28.190244	470	550	8	8	80	0.1000000
NODE_8393_length_919_cov_28.190244	470	550	9	29	80	0.3625000
NODE_8393_length_919_cov_28.190244	470	550	10	23	80	0.2875000
NODE_8393_length_919_cov_28.190244	523	603	4	22	80	0.2750000
NODE_8393_length_919_cov_28.190244	523	603	8	39	80	0.4875000
NODE_8393_length_919_cov_28.190244	523	603	9	11	80	0.1375000
NODE_8393_length_919_cov_28.190244	523	603	10	8	80	0.1000000
NODE_8394_length_919_cov_27.119512	454	534	15	3	80	0.0375000
NODE_8394_length_919_cov_27.119512	454	534	18	17	80	0.2125000
NODE_8394_length_919_cov_27.119512	454	534	19	4	80	0.0500000
NODE_8394_length_919_cov_27.119512	454	534	22	10	80	0.1250000
NODE_8394_length_919_cov_27.119512	454	534	23	28	80	0.3500000
NODE_8394_length_919_cov_27.119512	454	534	24	18	80	0.2250000
NODE_8394_length_919_cov_27.119512	507	587	9	13	80	0.1625000
NODE_8394_length_919_cov_27.119512	507	587	10	1	80	0.0125000
NODE_8394_length_919_cov_27.119512	507	587	11	22	80	0.2750000
NODE_8394_length_919_cov_27.119512	507	587	14	1	80	0.0125000
NODE_8394_length_919_cov_27.119512	507	587	15	4	80	0.0500000
NODE_8394_length_919_cov_27.119512	507	587	16	2	80	0.0250000
NODE_8394_length_919_cov_27.119512	507	587	18	27	80	0.3375000
NODE_8394_length_919_cov_27.119512	507	587	23	10	80	0.1250000
NODE_8395_length_919_cov_21.836585	545	625	5	21	80	0.2625000
NODE_8395_length_919_cov_21.836585	545	625	7	18	80	0.2250000
NODE_8395_length_919_cov_21.836585	545	625	8	41	80	0.5125000
NODE_8395_length_919_cov_21.836585	598	677	7	21	79	0.2658228
NODE_8395_length_919_cov_21.836585	598	677	8	19	79	0.2405063
NODE_8395_length_919_cov_21.836585	598	677	9	39	79	0.4936709
NODE_8396_length_919_cov_17.442683	385	465	9	35	80	0.4375000
NODE_8396_length_919_cov_17.442683	385	465	11	44	80	0.5500000
NODE_8396_length_919_cov_17.442683	385	465	12	1	80	0.0125000
NODE_8396_length_919_cov_17.442683	438	518	3	9	80	0.1125000
NODE_8396_length_919_cov_17.442683	438	518	4	5	80	0.0625000
NODE_8396_length_919_cov_17.442683	438	518	6	3	80	0.0375000
NODE_8396_length_919_cov_17.442683	438	518	7	19	80	0.2375000
NODE_8396_length_919_cov_17.442683	438	518	8	1	80	0.0125000
NODE_8396_length_919_cov_17.442683	438	518	10	9	80	0.1125000
NODE_8396_length_919_cov_17.442683	438	518	11	34	80	0.4250000
NODE_8397_length_919_cov_16.685366	309	389	3	17	80	0.2125000
NODE_8397_length_919_cov_16.685366	309	389	4	30	80	0.3750000
NODE_8397_length_919_cov_16.685366	309	389	5	33	80	0.4125000
NODE_8397_length_919_cov_16.685366	362	442	0	14	80	0.1750000
NODE_8397_length_919_cov_16.685366	362	442	2	16	80	0.2000000
NODE_8397_length_919_cov_16.685366	362	442	4	50	80	0.6250000
NODE_8398_length_919_cov_14.013415	435	515	0	7	80	0.0875000
NODE_8398_length_919_cov_14.013415	435	515	1	20	80	0.2500000
NODE_8398_length_919_cov_14.013415	435	515	2	53	80	0.6625000
NODE_8398_length_919_cov_14.013415	488	568	2	80	80	1.0000000
NODE_8399_length_919_cov_12.013415	340	420	0	4	80	0.0500000
NODE_8399_length_919_cov_12.013415	340	420	2	76	80	0.9500000
NODE_8399_length_919_cov_12.013415	393	473	2	80	80	1.0000000
NODE_8403_length_919_cov_3.529268	424	504	0	80	80	1.0000000
NODE_8403_length_919_cov_3.529268	477	557	0	80	80	1.0000000
NODE_8404_length_919_cov_3.200000	444	524	1	23	80	0.2875000
NODE_8404_length_919_cov_3.200000	444	524	2	18	80	0.2250000
NODE_8404_length_919_cov_3.200000	444	524	3	39	80	0.4875000
NODE_8404_length_919_cov_3.200000	497	577	2	41	80	0.5125000
NODE_8404_length_919_cov_3.200000	497	577	3	39	80	0.4875000
NODE_8415_length_918_cov_41.115995	387	467	18	5	80	0.0625000
NODE_8415_length_918_cov_41.115995	387	467	20	25	80	0.3125000
NODE_8415_length_918_cov_41.115995	387	467	21	8	80	0.1000000
NODE_8415_length_918_cov_41.115995	387	467	22	3	80	0.0375000
NODE_8415_length_918_cov_41.115995	387	467	23	13	80	0.1625000
NODE_8415_length_918_cov_41.115995	387	467	24	11	80	0.1375000
NODE_8415_length_918_cov_41.115995	387	467	25	15	80	0.1875000
NODE_8415_length_918_cov_41.115995	440	520	9	14	80	0.1750000
NODE_8415_length_918_cov_41.115995	440	520	10	2	80	0.0250000
NODE_8415_length_918_cov_41.115995	440	520	12	7	80	0.0875000
NODE_8415_length_918_cov_41.115995	440	520	13	2	80	0.0250000
NODE_8415_length_918_cov_41.115995	440	520	15	1	80	0.0125000
NODE_8415_length_918_cov_41.115995	440	520	16	4	80	0.0500000
NODE_8415_length_918_cov_41.115995	440	520	17	10	80	0.1250000
NODE_8415_length_918_cov_41.115995	440	520	18	2	80	0.0250000
NODE_8415_length_918_cov_41.115995	440	520	20	4	80	0.0500000
NODE_8415_length_918_cov_41.115995	440	520	21	12	80	0.1500000
NODE_8415_length_918_cov_41.115995	440	520	22	2	80	0.0250000
NODE_8415_length_918_cov_41.115995	440	520	23	12	80	0.1500000
NODE_8415_length_918_cov_41.115995	440	520	24	6	80	0.0750000
NODE_8415_length_918_cov_41.115995	440	520	25	2	80	0.0250000
NODE_8416_length_918_cov_37.405372	427	507	4	15	80	0.1875000
NODE_8416_length_918_cov_37.405372	427	507	5	48	80	0.6000000
NODE_8416_length_918_cov_37.405372	427	507	6	17	80	0.2125000
NODE_8416_length_918_cov_37.405372	480	560	3	13	80	0.1625000
NODE_8416_length_918_cov_37.405372	480	560	4	10	80	0.1250000
NODE_8416_length_918_cov_37.405372	480	560	5	49	80	0.6125000
NODE_8416_length_918_cov_37.405372	480	560	6	8	80	0.1000000
NODE_8417_length_918_cov_31.559219	289	369	2	74	80	0.9250000
NODE_8417_length_918_cov_31.559219	289	369	3	6	80	0.0750000
NODE_8417_length_918_cov_31.559219	342	422	2	21	80	0.2625000
NODE_8417_length_918_cov_31.559219	342	422	3	47	80	0.5875000
NODE_8417_length_918_cov_31.559219	342	422	4	12	80	0.1500000
NODE_8417_length_918_cov_31.559219	418	498	3	43	80	0.5375000
NODE_8417_length_918_cov_31.559219	418	498	4	37	80	0.4625000
NODE_8417_length_918_cov_31.559219	471	551	2	14	80	0.1750000
NODE_8417_length_918_cov_31.559219	471	551	3	24	80	0.3000000
NODE_8417_length_918_cov_31.559219	471	551	4	42	80	0.5250000
NODE_8418_length_918_cov_25.195360	429	509	7	5	80	0.0625000
NODE_8418_length_918_cov_25.195360	429	509	8	39	80	0.4875000
NODE_8418_length_918_cov_25.195360	429	509	14	36	80	0.4500000
NODE_8418_length_918_cov_25.195360	482	562	7	14	80	0.1750000
NODE_8418_length_918_cov_25.195360	482	562	8	8	80	0.1000000
NODE_8418_length_918_cov_25.195360	482	562	10	18	80	0.2250000
NODE_8418_length_918_cov_25.195360	482	562	14	40	80	0.5000000
NODE_8420_length_918_cov_10.537241	361	441	0	80	80	1.0000000
NODE_8420_length_918_cov_10.537241	414	492	0	78	78	1.0000000
NODE_8421_length_918_cov_9.821734	283	363	0	34	80	0.4250000
NODE_8421_length_918_cov_9.821734	283	363	1	46	80	0.5750000
NODE_8421_length_918_cov_9.821734	336	416	0	80	80	1.0000000
NODE_8422_length_918_cov_9.714286	365	445	2	5	80	0.0625000
NODE_8422_length_918_cov_9.714286	365	445	4	12	80	0.1500000
NODE_8422_length_918_cov_9.714286	365	445	5	29	80	0.3625000
NODE_8422_length_918_cov_9.714286	365	445	6	34	80	0.4250000
NODE_8422_length_918_cov_9.714286	418	498	2	29	80	0.3625000
NODE_8422_length_918_cov_9.714286	418	498	4	13	80	0.1625000
NODE_8422_length_918_cov_9.714286	418	498	6	38	80	0.4750000
NODE_8441_length_917_cov_38.845966	405	476	4	5	71	0.0704225
NODE_8441_length_917_cov_38.845966	405	476	5	16	71	0.2253521
NODE_8441_length_917_cov_38.845966	405	476	7	33	71	0.4647887
NODE_8441_length_917_cov_38.845966	405	476	9	13	71	0.1830986
NODE_8441_length_917_cov_38.845966	405	476	10	4	71	0.0563380
NODE_8441_length_917_cov_38.845966	458	538	6	20	80	0.2500000
NODE_8441_length_917_cov_38.845966	458	538	7	1	80	0.0125000
NODE_8441_length_917_cov_38.845966	458	538	8	9	80	0.1125000
NODE_8441_length_917_cov_38.845966	458	538	9	13	80	0.1625000
NODE_8441_length_917_cov_38.845966	458	538	10	37	80	0.4625000
NODE_8442_length_917_cov_37.775061	505	585	8	13	80	0.1625000
NODE_8442_length_917_cov_37.775061	505	585	9	11	80	0.1375000
NODE_8442_length_917_cov_37.775061	505	585	10	1	80	0.0125000
NODE_8442_length_917_cov_37.775061	505	585	11	9	80	0.1125000
NODE_8442_length_917_cov_37.775061	505	585	12	12	80	0.1500000
NODE_8442_length_917_cov_37.775061	505	585	13	34	80	0.4250000
NODE_8442_length_917_cov_37.775061	558	638	8	11	80	0.1375000
NODE_8442_length_917_cov_37.775061	558	638	9	17	80	0.2125000
NODE_8442_length_917_cov_37.775061	558	638	10	9	80	0.1125000
NODE_8442_length_917_cov_37.775061	558	638	11	14	80	0.1750000
NODE_8442_length_917_cov_37.775061	558	638	13	29	80	0.3625000
NODE_8443_length_917_cov_33.195599	335	415	0	18	80	0.2250000
NODE_8443_length_917_cov_33.195599	335	415	2	62	80	0.7750000
NODE_8443_length_917_cov_33.195599	388	468	0	71	80	0.8875000
NODE_8443_length_917_cov_33.195599	388	468	2	9	80	0.1125000
NODE_8443_length_917_cov_33.195599	464	544	0	80	80	1.0000000
NODE_8443_length_917_cov_33.195599	517	597	0	80	80	1.0000000
NODE_8444_length_917_cov_22.871638	463	543	2	70	80	0.8750000
NODE_8444_length_917_cov_22.871638	463	543	3	4	80	0.0500000
NODE_8444_length_917_cov_22.871638	463	543	4	6	80	0.0750000
NODE_8444_length_917_cov_22.871638	516	593	2	49	77	0.6363636
NODE_8444_length_917_cov_22.871638	516	593	3	28	77	0.3636364
NODE_8445_length_917_cov_16.899756	321	401	3	2	80	0.0250000
NODE_8445_length_917_cov_16.899756	321	401	4	24	80	0.3000000
NODE_8445_length_917_cov_16.899756	321	401	5	16	80	0.2000000
NODE_8445_length_917_cov_16.899756	321	401	6	26	80	0.3250000
NODE_8445_length_917_cov_16.899756	321	401	8	12	80	0.1500000
NODE_8445_length_917_cov_16.899756	374	454	5	4	80	0.0500000
NODE_8445_length_917_cov_16.899756	374	454	6	20	80	0.2500000
NODE_8445_length_917_cov_16.899756	374	454	8	56	80	0.7000000
NODE_8446_length_917_cov_12.283619	397	477	1	3	80	0.0375000
NODE_8446_length_917_cov_12.283619	397	477	2	77	80	0.9625000
NODE_8446_length_917_cov_12.283619	450	530	1	9	80	0.1125000
NODE_8446_length_917_cov_12.283619	450	530	2	71	80	0.8875000
NODE_8447_length_917_cov_12.172372	380	460	6	4	80	0.0500000
NODE_8447_length_917_cov_12.172372	380	460	7	12	80	0.1500000
NODE_8447_length_917_cov_12.172372	380	460	8	25	80	0.3125000
NODE_8447_length_917_cov_12.172372	380	460	9	13	80	0.1625000
NODE_8447_length_917_cov_12.172372	380	460	10	10	80	0.1250000
NODE_8447_length_917_cov_12.172372	380	460	11	2	80	0.0250000
NODE_8447_length_917_cov_12.172372	380	460	14	14	80	0.1750000
NODE_8447_length_917_cov_12.172372	433	513	9	1	80	0.0125000
NODE_8447_length_917_cov_12.172372	433	513	10	10	80	0.1250000
NODE_8447_length_917_cov_12.172372	433	513	11	2	80	0.0250000
NODE_8447_length_917_cov_12.172372	433	513	13	33	80	0.4125000
NODE_8447_length_917_cov_12.172372	433	513	14	28	80	0.3500000
NODE_8447_length_917_cov_12.172372	433	513	15	6	80	0.0750000
NODE_8447_length_917_cov_12.172372	545	597	3	2	52	0.0384615
NODE_8447_length_917_cov_12.172372	545	597	4	14	52	0.2692308
NODE_8447_length_917_cov_12.172372	545	597	5	17	52	0.3269231
NODE_8447_length_917_cov_12.172372	545	597	8	19	52	0.3653846
NODE_8448_length_917_cov_8.277506	564	644	2	6	80	0.0750000
NODE_8448_length_917_cov_8.277506	564	644	3	66	80	0.8250000
NODE_8448_length_917_cov_8.277506	564	644	4	8	80	0.1000000
NODE_8448_length_917_cov_8.277506	617	697	2	59	80	0.7375000
NODE_8448_length_917_cov_8.277506	617	697	3	21	80	0.2625000
NODE_8449_length_917_cov_8.145477	155	235	2	10	80	0.1250000
NODE_8449_length_917_cov_8.145477	155	235	4	58	80	0.7250000
NODE_8449_length_917_cov_8.145477	155	235	6	12	80	0.1500000
NODE_8449_length_917_cov_8.145477	208	288	2	63	80	0.7875000
NODE_8449_length_917_cov_8.145477	208	288	4	9	80	0.1125000
NODE_8449_length_917_cov_8.145477	208	288	6	8	80	0.1000000
NODE_8451_length_917_cov_6.073350	366	446	0	18	80	0.2250000
NODE_8451_length_917_cov_6.073350	366	446	1	16	80	0.2000000
NODE_8451_length_917_cov_6.073350	366	446	2	26	80	0.3250000
NODE_8451_length_917_cov_6.073350	366	446	4	20	80	0.2500000
NODE_8451_length_917_cov_6.073350	419	499	2	7	80	0.0875000
NODE_8451_length_917_cov_6.073350	419	499	4	21	80	0.2625000
NODE_8451_length_917_cov_6.073350	419	499	5	2	80	0.0250000
NODE_8451_length_917_cov_6.073350	419	499	6	50	80	0.6250000
NODE_8463_length_916_cov_32.867809	347	427	5	8	80	0.1000000
NODE_8463_length_916_cov_32.867809	347	427	6	19	80	0.2375000
NODE_8463_length_916_cov_32.867809	347	427	7	34	80	0.4250000
NODE_8463_length_916_cov_32.867809	347	427	8	13	80	0.1625000
NODE_8463_length_916_cov_32.867809	347	427	9	6	80	0.0750000
NODE_8463_length_916_cov_32.867809	400	480	4	46	80	0.5750000
NODE_8463_length_916_cov_32.867809	400	480	5	11	80	0.1375000
NODE_8463_length_916_cov_32.867809	400	480	7	23	80	0.2875000
NODE_8464_length_916_cov_27.673195	450	530	4	2	80	0.0250000
NODE_8464_length_916_cov_27.673195	450	530	5	8	80	0.1000000
NODE_8464_length_916_cov_27.673195	450	530	6	13	80	0.1625000
NODE_8464_length_916_cov_27.673195	450	530	7	41	80	0.5125000
NODE_8464_length_916_cov_27.673195	450	530	9	16	80	0.2000000
NODE_8464_length_916_cov_27.673195	503	583	4	10	80	0.1250000
NODE_8464_length_916_cov_27.673195	503	583	6	14	80	0.1750000
NODE_8464_length_916_cov_27.673195	503	583	7	40	80	0.5000000
NODE_8464_length_916_cov_27.673195	503	583	9	16	80	0.2000000
NODE_8465_length_916_cov_27.146879	223	303	4	1	80	0.0125000
NODE_8465_length_916_cov_27.146879	223	303	6	1	80	0.0125000
NODE_8465_length_916_cov_27.146879	223	303	7	30	80	0.3750000
NODE_8465_length_916_cov_27.146879	223	303	9	48	80	0.6000000
NODE_8465_length_916_cov_27.146879	276	356	2	23	80	0.2875000
NODE_8465_length_916_cov_27.146879	276	356	3	21	80	0.2625000
NODE_8465_length_916_cov_27.146879	276	356	4	10	80	0.1250000
NODE_8465_length_916_cov_27.146879	276	356	6	1	80	0.0125000
NODE_8465_length_916_cov_27.146879	276	356	7	25	80	0.3125000
NODE_8466_length_916_cov_25.604651	398	478	8	4	80	0.0500000
NODE_8466_length_916_cov_25.604651	398	478	9	2	80	0.0250000
NODE_8466_length_916_cov_25.604651	398	478	10	9	80	0.1125000
NODE_8466_length_916_cov_25.604651	398	478	11	10	80	0.1250000
NODE_8466_length_916_cov_25.604651	398	478	12	12	80	0.1500000
NODE_8466_length_916_cov_25.604651	398	478	14	20	80	0.2500000
NODE_8466_length_916_cov_25.604651	398	478	15	5	80	0.0625000
NODE_8466_length_916_cov_25.604651	398	478	16	18	80	0.2250000
NODE_8466_length_916_cov_25.604651	451	531	10	5	80	0.0625000
NODE_8466_length_916_cov_25.604651	451	531	12	11	80	0.1375000
NODE_8466_length_916_cov_25.604651	451	531	13	9	80	0.1125000
NODE_8466_length_916_cov_25.604651	451	531	14	32	80	0.4000000
NODE_8466_length_916_cov_25.604651	451	531	15	5	80	0.0625000
NODE_8466_length_916_cov_25.604651	451	531	16	18	80	0.2250000
NODE_8467_length_916_cov_18.035496	456	536	6	33	80	0.4125000
NODE_8467_length_916_cov_18.035496	456	536	8	6	80	0.0750000
NODE_8467_length_916_cov_18.035496	456	536	10	1	80	0.0125000
NODE_8467_length_916_cov_18.035496	456	536	11	7	80	0.0875000
NODE_8467_length_916_cov_18.035496	456	536	12	3	80	0.0375000
NODE_8467_length_916_cov_18.035496	456	536	13	5	80	0.0625000
NODE_8467_length_916_cov_18.035496	456	536	14	25	80	0.3125000
NODE_8467_length_916_cov_18.035496	509	589	12	14	80	0.1750000
NODE_8467_length_916_cov_18.035496	509	589	13	41	80	0.5125000
NODE_8467_length_916_cov_18.035496	509	589	14	25	80	0.3125000
NODE_8468_length_916_cov_12.651163	500	580	5	68	80	0.8500000
NODE_8468_length_916_cov_12.651163	500	580	6	12	80	0.1500000
NODE_8468_length_916_cov_12.651163	553	633	1	38	80	0.4750000
NODE_8468_length_916_cov_12.651163	553	633	5	42	80	0.5250000
NODE_8469_length_916_cov_11.337821	530	610	0	15	80	0.1875000
NODE_8469_length_916_cov_11.337821	530	610	2	65	80	0.8125000
NODE_8469_length_916_cov_11.337821	583	663	2	80	80	1.0000000
NODE_8470_length_916_cov_9.640147	293	373	1	55	80	0.6875000
NODE_8470_length_916_cov_9.640147	293	373	2	25	80	0.3125000
NODE_8470_length_916_cov_9.640147	346	426	1	48	80	0.6000000
NODE_8470_length_916_cov_9.640147	346	426	2	32	80	0.4000000
NODE_8472_length_916_cov_8.042840	426	506	1	64	80	0.8000000
NODE_8472_length_916_cov_8.042840	426	506	2	16	80	0.2000000
NODE_8472_length_916_cov_8.042840	479	559	0	35	80	0.4375000
NODE_8472_length_916_cov_8.042840	479	559	1	45	80	0.5625000
NODE_8473_length_916_cov_7.123623	785	847	0	62	62	1.0000000
NODE_8473_length_916_cov_7.123623	820	900	0	80	80	1.0000000
NODE_8481_length_915_cov_59.289216	398	478	6	14	80	0.1750000
NODE_8481_length_915_cov_59.289216	398	478	7	34	80	0.4250000
NODE_8481_length_915_cov_59.289216	398	478	8	17	80	0.2125000
NODE_8481_length_915_cov_59.289216	398	478	9	15	80	0.1875000
NODE_8481_length_915_cov_59.289216	451	531	6	19	80	0.2375000
NODE_8481_length_915_cov_59.289216	451	531	8	16	80	0.2000000
NODE_8481_length_915_cov_59.289216	451	531	9	2	80	0.0250000
NODE_8481_length_915_cov_59.289216	451	531	11	8	80	0.1000000
NODE_8481_length_915_cov_59.289216	451	531	12	16	80	0.2000000
NODE_8481_length_915_cov_59.289216	451	531	13	13	80	0.1625000
NODE_8481_length_915_cov_59.289216	451	531	14	1	80	0.0125000
NODE_8481_length_915_cov_59.289216	451	531	15	5	80	0.0625000
NODE_8481_length_915_cov_59.289216	527	607	13	3	80	0.0375000
NODE_8481_length_915_cov_59.289216	527	607	15	22	80	0.2750000
NODE_8481_length_915_cov_59.289216	527	607	16	8	80	0.1000000
NODE_8481_length_915_cov_59.289216	527	607	17	18	80	0.2250000
NODE_8481_length_915_cov_59.289216	527	607	18	1	80	0.0125000
NODE_8481_length_915_cov_59.289216	527	607	19	14	80	0.1750000
NODE_8481_length_915_cov_59.289216	527	607	20	14	80	0.1750000
NODE_8481_length_915_cov_59.289216	580	660	11	24	80	0.3000000
NODE_8481_length_915_cov_59.289216	580	660	12	1	80	0.0125000
NODE_8481_length_915_cov_59.289216	580	660	13	3	80	0.0375000
NODE_8481_length_915_cov_59.289216	580	660	15	29	80	0.3625000
NODE_8481_length_915_cov_59.289216	580	660	17	18	80	0.2250000
NODE_8481_length_915_cov_59.289216	580	660	18	1	80	0.0125000
NODE_8481_length_915_cov_59.289216	580	660	19	4	80	0.0500000
NODE_8482_length_915_cov_45.104167	153	228	3	8	75	0.1066667
NODE_8482_length_915_cov_45.104167	153	228	4	49	75	0.6533333
NODE_8482_length_915_cov_45.104167	153	228	5	1	75	0.0133333
NODE_8482_length_915_cov_45.104167	153	228	8	2	75	0.0266667
NODE_8482_length_915_cov_45.104167	153	228	9	14	75	0.1866667
NODE_8482_length_915_cov_45.104167	153	228	10	1	75	0.0133333
NODE_8482_length_915_cov_45.104167	206	286	4	4	80	0.0500000
NODE_8482_length_915_cov_45.104167	206	286	5	1	80	0.0125000
NODE_8482_length_915_cov_45.104167	206	286	8	2	80	0.0250000
NODE_8482_length_915_cov_45.104167	206	286	9	14	80	0.1750000
NODE_8482_length_915_cov_45.104167	206	286	10	20	80	0.2500000
NODE_8482_length_915_cov_45.104167	206	286	11	10	80	0.1250000
NODE_8482_length_915_cov_45.104167	206	286	12	1	80	0.0125000
NODE_8482_length_915_cov_45.104167	206	286	13	6	80	0.0750000
NODE_8482_length_915_cov_45.104167	206	286	14	1	80	0.0125000
NODE_8482_length_915_cov_45.104167	206	286	15	17	80	0.2125000
NODE_8482_length_915_cov_45.104167	206	286	16	4	80	0.0500000
NODE_8482_length_915_cov_45.104167	282	362	15	2	80	0.0250000
NODE_8482_length_915_cov_45.104167	282	362	16	4	80	0.0500000
NODE_8482_length_915_cov_45.104167	282	362	17	8	80	0.1000000
NODE_8482_length_915_cov_45.104167	282	362	18	1	80	0.0125000
NODE_8482_length_915_cov_45.104167	282	362	19	5	80	0.0625000
NODE_8482_length_915_cov_45.104167	282	362	20	40	80	0.5000000
NODE_8482_length_915_cov_45.104167	282	362	21	20	80	0.2500000
NODE_8482_length_915_cov_45.104167	335	415	7	1	80	0.0125000
NODE_8482_length_915_cov_45.104167	335	415	8	1	80	0.0125000
NODE_8482_length_915_cov_45.104167	335	415	9	5	80	0.0625000
NODE_8482_length_915_cov_45.104167	335	415	10	1	80	0.0125000
NODE_8482_length_915_cov_45.104167	335	415	11	10	80	0.1250000
NODE_8482_length_915_cov_45.104167	335	415	12	9	80	0.1125000
NODE_8482_length_915_cov_45.104167	335	415	13	4	80	0.0500000
NODE_8482_length_915_cov_45.104167	335	415	14	14	80	0.1750000
NODE_8482_length_915_cov_45.104167	335	415	16	7	80	0.0875000
NODE_8482_length_915_cov_45.104167	335	415	17	2	80	0.0250000
NODE_8482_length_915_cov_45.104167	335	415	18	1	80	0.0125000
NODE_8482_length_915_cov_45.104167	335	415	20	5	80	0.0625000
NODE_8482_length_915_cov_45.104167	335	415	21	20	80	0.2500000
NODE_8483_length_915_cov_37.599265	397	477	5	3	80	0.0375000
NODE_8483_length_915_cov_37.599265	397	477	7	22	80	0.2750000
NODE_8483_length_915_cov_37.599265	397	477	11	11	80	0.1375000
NODE_8483_length_915_cov_37.599265	397	477	12	1	80	0.0125000
NODE_8483_length_915_cov_37.599265	397	477	13	4	80	0.0500000
NODE_8483_length_915_cov_37.599265	397	477	14	4	80	0.0500000
NODE_8483_length_915_cov_37.599265	397	477	15	4	80	0.0500000
NODE_8483_length_915_cov_37.599265	397	477	16	31	80	0.3875000
NODE_8483_length_915_cov_37.599265	450	530	13	6	80	0.0750000
NODE_8483_length_915_cov_37.599265	450	530	15	2	80	0.0250000
NODE_8483_length_915_cov_37.599265	450	530	16	43	80	0.5375000
NODE_8483_length_915_cov_37.599265	450	530	17	29	80	0.3625000
NODE_8485_length_915_cov_20.458333	297	377	0	4	80	0.0500000
NODE_8485_length_915_cov_20.458333	297	377	1	11	80	0.1375000
NODE_8485_length_915_cov_20.458333	297	377	2	16	80	0.2000000
NODE_8485_length_915_cov_20.458333	297	377	4	49	80	0.6125000
NODE_8485_length_915_cov_20.458333	350	430	4	63	80	0.7875000
NODE_8485_length_915_cov_20.458333	350	430	5	17	80	0.2125000
NODE_8485_length_915_cov_20.458333	426	506	2	44	80	0.5500000
NODE_8485_length_915_cov_20.458333	426	506	5	16	80	0.2000000
NODE_8485_length_915_cov_20.458333	426	506	6	20	80	0.2500000
NODE_8485_length_915_cov_20.458333	479	559	2	80	80	1.0000000
NODE_8486_length_915_cov_14.397059	175	255	3	74	80	0.9250000
NODE_8486_length_915_cov_14.397059	175	255	4	6	80	0.0750000
NODE_8486_length_915_cov_14.397059	228	308	3	21	80	0.2625000
NODE_8486_length_915_cov_14.397059	228	308	4	31	80	0.3875000
NODE_8486_length_915_cov_14.397059	228	308	5	19	80	0.2375000
NODE_8486_length_915_cov_14.397059	228	308	6	9	80	0.1125000
NODE_8487_length_915_cov_8.741422	295	375	2	80	80	1.0000000
NODE_8487_length_915_cov_8.741422	348	428	2	80	80	1.0000000
NODE_8488_length_915_cov_7.719363	823	894	0	27	71	0.3802817
NODE_8488_length_915_cov_7.719363	823	894	1	44	71	0.6197183
NODE_8488_length_915_cov_7.719363	828	894	0	27	66	0.4090909
NODE_8488_length_915_cov_7.719363	828	894	1	39	66	0.5909091
NODE_8488_length_915_cov_7.719363	867	915	0	48	48	1.0000000
NODE_8488_length_915_cov_7.719363	867	915	0	48	48	1.0000000
NODE_8488_length_915_cov_7.719363	867	915	0	48	48	1.0000000
NODE_8489_length_915_cov_7.648284	370	450	2	1	80	0.0125000
NODE_8489_length_915_cov_7.648284	370	450	3	39	80	0.4875000
NODE_8489_length_915_cov_7.648284	370	450	4	8	80	0.1000000
NODE_8489_length_915_cov_7.648284	370	450	6	32	80	0.4000000
NODE_8489_length_915_cov_7.648284	423	503	1	2	80	0.0250000
NODE_8489_length_915_cov_7.648284	423	503	3	36	80	0.4500000
NODE_8489_length_915_cov_7.648284	423	503	5	14	80	0.1750000
NODE_8489_length_915_cov_7.648284	423	503	6	28	80	0.3500000
NODE_8490_length_915_cov_6.848039	434	514	0	80	80	1.0000000
NODE_8490_length_915_cov_6.848039	487	567	0	80	80	1.0000000
NODE_8497_length_915_cov_2.011029	24	99	3	75	75	1.0000000
NODE_8505_length_914_cov_89.814724	0	41	5	1	41	0.0243902
NODE_8505_length_914_cov_89.814724	0	41	7	1	41	0.0243902
NODE_8505_length_914_cov_89.814724	0	41	8	1	41	0.0243902
NODE_8505_length_914_cov_89.814724	0	41	10	7	41	0.1707317
NODE_8505_length_914_cov_89.814724	0	41	11	4	41	0.0975610
NODE_8505_length_914_cov_89.814724	0	41	12	2	41	0.0487805
NODE_8505_length_914_cov_89.814724	0	41	13	1	41	0.0243902
NODE_8505_length_914_cov_89.814724	0	41	14	2	41	0.0487805
NODE_8505_length_914_cov_89.814724	0	41	15	2	41	0.0487805
NODE_8505_length_914_cov_89.814724	0	41	17	2	41	0.0487805
NODE_8505_length_914_cov_89.814724	0	41	21	6	41	0.1463415
NODE_8505_length_914_cov_89.814724	0	41	23	3	41	0.0731707
NODE_8505_length_914_cov_89.814724	0	41	25	2	41	0.0487805
NODE_8505_length_914_cov_89.814724	0	41	26	5	41	0.1219512
NODE_8505_length_914_cov_89.814724	0	41	27	1	41	0.0243902
NODE_8505_length_914_cov_89.814724	0	41	28	1	41	0.0243902
NODE_8505_length_914_cov_89.814724	19	94	15	2	75	0.0266667
NODE_8505_length_914_cov_89.814724	19	94	17	2	75	0.0266667
NODE_8505_length_914_cov_89.814724	19	94	21	6	75	0.0800000
NODE_8505_length_914_cov_89.814724	19	94	23	3	75	0.0400000
NODE_8505_length_914_cov_89.814724	19	94	25	2	75	0.0266667
NODE_8505_length_914_cov_89.814724	19	94	26	5	75	0.0666667
NODE_8505_length_914_cov_89.814724	19	94	27	1	75	0.0133333
NODE_8505_length_914_cov_89.814724	19	94	28	1	75	0.0133333
NODE_8505_length_914_cov_89.814724	19	94	31	1	75	0.0133333
NODE_8505_length_914_cov_89.814724	19	94	35	2	75	0.0266667
NODE_8505_length_914_cov_89.814724	19	94	36	7	75	0.0933333
NODE_8505_length_914_cov_89.814724	19	94	38	9	75	0.1200000
NODE_8505_length_914_cov_89.814724	19	94	39	3	75	0.0400000
NODE_8505_length_914_cov_89.814724	19	94	40	5	75	0.0666667
NODE_8505_length_914_cov_89.814724	19	94	41	1	75	0.0133333
NODE_8505_length_914_cov_89.814724	19	94	42	6	75	0.0800000
NODE_8505_length_914_cov_89.814724	19	94	43	3	75	0.0400000
NODE_8505_length_914_cov_89.814724	19	94	44	4	75	0.0533333
NODE_8505_length_914_cov_89.814724	19	94	47	2	75	0.0266667
NODE_8505_length_914_cov_89.814724	19	94	50	6	75	0.0800000
NODE_8505_length_914_cov_89.814724	19	94	51	4	75	0.0533333
NODE_8506_length_914_cov_33.755828	400	480	2	12	80	0.1500000
NODE_8506_length_914_cov_33.755828	400	480	3	14	80	0.1750000
NODE_8506_length_914_cov_33.755828	400	480	5	30	80	0.3750000
NODE_8506_length_914_cov_33.755828	400	480	6	10	80	0.1250000
NODE_8506_length_914_cov_33.755828	400	480	7	14	80	0.1750000
NODE_8506_length_914_cov_33.755828	453	533	3	4	80	0.0500000
NODE_8506_length_914_cov_33.755828	453	533	5	76	80	0.9500000
NODE_8507_length_914_cov_31.557055	368	448	6	9	80	0.1125000
NODE_8507_length_914_cov_31.557055	368	448	7	13	80	0.1625000
NODE_8507_length_914_cov_31.557055	368	448	8	3	80	0.0375000
NODE_8507_length_914_cov_31.557055	368	448	9	19	80	0.2375000
NODE_8507_length_914_cov_31.557055	368	448	10	22	80	0.2750000
NODE_8507_length_914_cov_31.557055	368	448	11	11	80	0.1375000
NODE_8507_length_914_cov_31.557055	368	448	12	3	80	0.0375000
NODE_8507_length_914_cov_31.557055	421	501	9	6	80	0.0750000
NODE_8507_length_914_cov_31.557055	421	501	10	14	80	0.1750000
NODE_8507_length_914_cov_31.557055	421	501	11	15	80	0.1875000
NODE_8507_length_914_cov_31.557055	421	501	12	8	80	0.1000000
NODE_8507_length_914_cov_31.557055	421	501	13	37	80	0.4625000
NODE_8508_length_914_cov_29.087117	331	411	0	80	80	1.0000000
NODE_8508_length_914_cov_29.087117	384	464	0	80	80	1.0000000
NODE_8509_length_914_cov_28.490798	273	353	1	36	80	0.4500000
NODE_8509_length_914_cov_28.490798	273	353	2	17	80	0.2125000
NODE_8509_length_914_cov_28.490798	273	353	4	27	80	0.3375000
NODE_8509_length_914_cov_28.490798	326	406	2	6	80	0.0750000
NODE_8509_length_914_cov_28.490798	326	406	3	27	80	0.3375000
NODE_8509_length_914_cov_28.490798	326	406	4	47	80	0.5875000
NODE_8509_length_914_cov_28.490798	402	482	2	38	80	0.4750000
NODE_8509_length_914_cov_28.490798	402	482	3	42	80	0.5250000
NODE_8509_length_914_cov_28.490798	455	535	2	76	80	0.9500000
NODE_8509_length_914_cov_28.490798	455	535	3	4	80	0.0500000
NODE_8510_length_914_cov_25.429448	393	473	8	9	80	0.1125000
NODE_8510_length_914_cov_25.429448	393	473	9	15	80	0.1875000
NODE_8510_length_914_cov_25.429448	393	473	10	2	80	0.0250000
NODE_8510_length_914_cov_25.429448	393	473	12	3	80	0.0375000
NODE_8510_length_914_cov_25.429448	393	473	13	10	80	0.1250000
NODE_8510_length_914_cov_25.429448	393	473	14	10	80	0.1250000
NODE_8510_length_914_cov_25.429448	393	473	15	31	80	0.3875000
NODE_8510_length_914_cov_25.429448	446	526	9	2	80	0.0250000
NODE_8510_length_914_cov_25.429448	446	526	10	9	80	0.1125000
NODE_8510_length_914_cov_25.429448	446	526	11	8	80	0.1000000
NODE_8510_length_914_cov_25.429448	446	526	12	12	80	0.1500000
NODE_8510_length_914_cov_25.429448	446	526	13	25	80	0.3125000
NODE_8510_length_914_cov_25.429448	446	526	14	5	80	0.0625000
NODE_8510_length_914_cov_25.429448	446	526	15	19	80	0.2375000
NODE_8510_length_914_cov_25.429448	522	602	7	19	80	0.2375000
NODE_8510_length_914_cov_25.429448	522	602	8	26	80	0.3250000
NODE_8510_length_914_cov_25.429448	522	602	9	11	80	0.1375000
NODE_8510_length_914_cov_25.429448	522	602	10	24	80	0.3000000
NODE_8510_length_914_cov_25.429448	575	655	4	16	80	0.2000000
NODE_8510_length_914_cov_25.429448	575	655	5	1	80	0.0125000
NODE_8510_length_914_cov_25.429448	575	655	6	20	80	0.2500000
NODE_8510_length_914_cov_25.429448	575	655	7	34	80	0.4250000
NODE_8510_length_914_cov_25.429448	575	655	8	9	80	0.1125000
NODE_8511_length_914_cov_19.111656	354	434	5	30	80	0.3750000
NODE_8511_length_914_cov_19.111656	354	434	6	33	80	0.4125000
NODE_8511_length_914_cov_19.111656	354	434	7	17	80	0.2125000
NODE_8511_length_914_cov_19.111656	407	487	6	45	80	0.5625000
NODE_8511_length_914_cov_19.111656	407	487	7	23	80	0.2875000
NODE_8511_length_914_cov_19.111656	407	487	8	12	80	0.1500000
NODE_8512_length_914_cov_13.423313	603	683	1	34	80	0.4250000
NODE_8512_length_914_cov_13.423313	603	683	2	46	80	0.5750000
NODE_8512_length_914_cov_13.423313	656	736	1	42	80	0.5250000
NODE_8512_length_914_cov_13.423313	656	736	2	38	80	0.4750000
NODE_8513_length_914_cov_10.947239	341	411	1	70	70	1.0000000
NODE_8513_length_914_cov_10.947239	384	464	0	42	80	0.5250000
NODE_8513_length_914_cov_10.947239	384	464	1	38	80	0.4750000
NODE_8518_length_914_cov_1.931288	833	873	0	40	40	1.0000000
NODE_8526_length_913_cov_49.665848	31	111	6	4	80	0.0500000
NODE_8526_length_913_cov_49.665848	31	111	8	2	80	0.0250000
NODE_8526_length_913_cov_49.665848	31	111	10	3	80	0.0375000
NODE_8526_length_913_cov_49.665848	31	111	11	9	80	0.1125000
NODE_8526_length_913_cov_49.665848	31	111	15	1	80	0.0125000
NODE_8526_length_913_cov_49.665848	31	111	16	3	80	0.0375000
NODE_8526_length_913_cov_49.665848	31	111	18	4	80	0.0500000
NODE_8526_length_913_cov_49.665848	31	111	20	5	80	0.0625000
NODE_8526_length_913_cov_49.665848	31	111	21	3	80	0.0375000
NODE_8526_length_913_cov_49.665848	31	111	22	1	80	0.0125000
NODE_8526_length_913_cov_49.665848	31	111	24	7	80	0.0875000
NODE_8526_length_913_cov_49.665848	31	111	25	2	80	0.0250000
NODE_8526_length_913_cov_49.665848	31	111	26	5	80	0.0625000
NODE_8526_length_913_cov_49.665848	31	111	27	2	80	0.0250000
NODE_8526_length_913_cov_49.665848	31	111	29	1	80	0.0125000
NODE_8526_length_913_cov_49.665848	31	111	30	1	80	0.0125000
NODE_8526_length_913_cov_49.665848	31	111	31	2	80	0.0250000
NODE_8526_length_913_cov_49.665848	31	111	32	1	80	0.0125000
NODE_8526_length_913_cov_49.665848	31	111	33	4	80	0.0500000
NODE_8526_length_913_cov_49.665848	31	111	34	1	80	0.0125000
NODE_8526_length_913_cov_49.665848	31	111	35	2	80	0.0250000
NODE_8526_length_913_cov_49.665848	31	111	36	2	80	0.0250000
NODE_8526_length_913_cov_49.665848	31	111	37	3	80	0.0375000
NODE_8526_length_913_cov_49.665848	31	111	39	7	80	0.0875000
NODE_8526_length_913_cov_49.665848	31	111	40	4	80	0.0500000
NODE_8526_length_913_cov_49.665848	31	111	41	1	80	0.0125000
NODE_8526_length_913_cov_49.665848	136	155	50	2	19	0.1052632
NODE_8526_length_913_cov_49.665848	136	155	51	4	19	0.2105263
NODE_8526_length_913_cov_49.665848	136	155	53	9	19	0.4736842
NODE_8526_length_913_cov_49.665848	136	155	55	4	19	0.2105263
NODE_8527_length_913_cov_47.115479	367	447	10	5	80	0.0625000
NODE_8527_length_913_cov_47.115479	367	447	11	4	80	0.0500000
NODE_8527_length_913_cov_47.115479	367	447	13	5	80	0.0625000
NODE_8527_length_913_cov_47.115479	367	447	14	10	80	0.1250000
NODE_8527_length_913_cov_47.115479	367	447	15	16	80	0.2000000
NODE_8527_length_913_cov_47.115479	367	447	17	7	80	0.0875000
NODE_8527_length_913_cov_47.115479	367	447	19	6	80	0.0750000
NODE_8527_length_913_cov_47.115479	367	447	21	3	80	0.0375000
NODE_8527_length_913_cov_47.115479	367	447	23	13	80	0.1625000
NODE_8527_length_913_cov_47.115479	367	447	24	8	80	0.1000000
NODE_8527_length_913_cov_47.115479	367	447	25	3	80	0.0375000
NODE_8527_length_913_cov_47.115479	420	500	18	8	80	0.1000000
NODE_8527_length_913_cov_47.115479	420	500	19	1	80	0.0125000
NODE_8527_length_913_cov_47.115479	420	500	20	9	80	0.1125000
NODE_8527_length_913_cov_47.115479	420	500	21	3	80	0.0375000
NODE_8527_length_913_cov_47.115479	420	500	23	34	80	0.4250000
NODE_8527_length_913_cov_47.115479	420	500	24	19	80	0.2375000
NODE_8527_length_913_cov_47.115479	420	500	25	6	80	0.0750000
NODE_8528_length_913_cov_36.541769	502	582	2	18	80	0.2250000
NODE_8528_length_913_cov_36.541769	502	582	4	4	80	0.0500000
NODE_8528_length_913_cov_36.541769	502	582	5	9	80	0.1125000
NODE_8528_length_913_cov_36.541769	502	582	7	6	80	0.0750000
NODE_8528_length_913_cov_36.541769	502	582	9	3	80	0.0375000
NODE_8528_length_913_cov_36.541769	502	582	10	3	80	0.0375000
NODE_8528_length_913_cov_36.541769	502	582	11	37	80	0.4625000
NODE_8528_length_913_cov_36.541769	555	635	9	8	80	0.1000000
NODE_8528_length_913_cov_36.541769	555	635	10	8	80	0.1000000
NODE_8528_length_913_cov_36.541769	555	635	11	31	80	0.3875000
NODE_8528_length_913_cov_36.541769	555	635	12	33	80	0.4125000
NODE_8529_length_913_cov_33.679361	433	513	0	5	80	0.0625000
NODE_8529_length_913_cov_33.679361	433	513	1	7	80	0.0875000
NODE_8529_length_913_cov_33.679361	433	513	3	16	80	0.2000000
NODE_8529_length_913_cov_33.679361	433	513	4	1	80	0.0125000
NODE_8529_length_913_cov_33.679361	433	513	6	27	80	0.3375000
NODE_8529_length_913_cov_33.679361	433	513	8	1	80	0.0125000
NODE_8529_length_913_cov_33.679361	433	513	9	8	80	0.1000000
NODE_8529_length_913_cov_33.679361	433	513	10	9	80	0.1125000
NODE_8529_length_913_cov_33.679361	433	513	11	6	80	0.0750000
NODE_8529_length_913_cov_33.679361	486	566	6	3	80	0.0375000
NODE_8529_length_913_cov_33.679361	486	566	8	1	80	0.0125000
NODE_8529_length_913_cov_33.679361	486	566	9	19	80	0.2375000
NODE_8529_length_913_cov_33.679361	486	566	10	37	80	0.4625000
NODE_8529_length_913_cov_33.679361	486	566	11	20	80	0.2500000
NODE_8530_length_913_cov_29.675676	408	488	0	11	80	0.1375000
NODE_8530_length_913_cov_29.675676	408	488	1	34	80	0.4250000
NODE_8530_length_913_cov_29.675676	408	488	2	13	80	0.1625000
NODE_8530_length_913_cov_29.675676	408	488	3	22	80	0.2750000
NODE_8530_length_913_cov_29.675676	461	541	2	5	80	0.0625000
NODE_8530_length_913_cov_29.675676	461	541	3	75	80	0.9375000
NODE_8531_length_913_cov_24.901720	342	422	6	28	80	0.3500000
NODE_8531_length_913_cov_24.901720	342	422	7	12	80	0.1500000
NODE_8531_length_913_cov_24.901720	342	422	8	18	80	0.2250000
NODE_8531_length_913_cov_24.901720	342	422	9	22	80	0.2750000
NODE_8531_length_913_cov_24.901720	395	475	5	6	80	0.0750000
NODE_8531_length_913_cov_24.901720	395	475	6	27	80	0.3375000
NODE_8531_length_913_cov_24.901720	395	475	7	41	80	0.5125000
NODE_8531_length_913_cov_24.901720	395	475	8	6	80	0.0750000
NODE_8532_length_913_cov_24.625307	396	476	4	5	80	0.0625000
NODE_8532_length_913_cov_24.625307	396	476	5	2	80	0.0250000
NODE_8532_length_913_cov_24.625307	396	476	6	73	80	0.9125000
NODE_8532_length_913_cov_24.625307	449	529	2	15	80	0.1875000
NODE_8532_length_913_cov_24.625307	449	529	3	6	80	0.0750000
NODE_8532_length_913_cov_24.625307	449	529	4	20	80	0.2500000
NODE_8532_length_913_cov_24.625307	449	529	5	19	80	0.2375000
NODE_8532_length_913_cov_24.625307	449	529	6	20	80	0.2500000
NODE_8533_length_913_cov_15.094595	525	589	2	25	64	0.3906250
NODE_8533_length_913_cov_15.094595	525	589	4	39	64	0.6093750
NODE_8533_length_913_cov_15.094595	562	642	2	12	80	0.1500000
NODE_8533_length_913_cov_15.094595	562	642	4	68	80	0.8500000
NODE_8534_length_913_cov_8.633907	305	385	1	51	80	0.6375000
NODE_8534_length_913_cov_8.633907	305	385	3	29	80	0.3625000
NODE_8534_length_913_cov_8.633907	358	429	3	71	71	1.0000000
NODE_8546_length_912_cov_25.110701	419	499	7	5	80	0.0625000
NODE_8546_length_912_cov_25.110701	419	499	9	16	80	0.2000000
NODE_8546_length_912_cov_25.110701	419	499	10	29	80	0.3625000
NODE_8546_length_912_cov_25.110701	419	499	11	7	80	0.0875000
NODE_8546_length_912_cov_25.110701	419	499	12	22	80	0.2750000
NODE_8546_length_912_cov_25.110701	419	499	14	1	80	0.0125000
NODE_8546_length_912_cov_25.110701	472	552	11	4	80	0.0500000
NODE_8546_length_912_cov_25.110701	472	552	12	22	80	0.2750000
NODE_8546_length_912_cov_25.110701	472	552	13	11	80	0.1375000
NODE_8546_length_912_cov_25.110701	472	552	14	37	80	0.4625000
NODE_8546_length_912_cov_25.110701	472	552	15	2	80	0.0250000
NODE_8546_length_912_cov_25.110701	472	552	16	4	80	0.0500000
NODE_8547_length_912_cov_20.045510	306	386	1	32	80	0.4000000
NODE_8547_length_912_cov_20.045510	306	386	2	14	80	0.1750000
NODE_8547_length_912_cov_20.045510	306	386	3	34	80	0.4250000
NODE_8547_length_912_cov_20.045510	359	439	1	78	80	0.9750000
NODE_8547_length_912_cov_20.045510	359	439	2	2	80	0.0250000
NODE_8548_length_912_cov_19.635916	326	406	4	8	80	0.1000000
NODE_8548_length_912_cov_19.635916	326	406	5	9	80	0.1125000
NODE_8548_length_912_cov_19.635916	326	406	6	21	80	0.2625000
NODE_8548_length_912_cov_19.635916	326	406	7	41	80	0.5125000
NODE_8548_length_912_cov_19.635916	326	406	8	1	80	0.0125000
NODE_8548_length_912_cov_19.635916	379	459	7	46	80	0.5750000
NODE_8548_length_912_cov_19.635916	379	459	8	9	80	0.1125000
NODE_8548_length_912_cov_19.635916	379	459	9	25	80	0.3125000
NODE_8549_length_912_cov_17.714637	395	475	2	80	80	1.0000000
NODE_8549_length_912_cov_17.714637	448	528	0	43	80	0.5375000
NODE_8549_length_912_cov_17.714637	448	528	2	37	80	0.4625000
NODE_8550_length_912_cov_15.546125	355	435	1	40	80	0.5000000
NODE_8550_length_912_cov_15.546125	355	435	3	24	80	0.3000000
NODE_8550_length_912_cov_15.546125	355	435	5	5	80	0.0625000
NODE_8550_length_912_cov_15.546125	355	435	6	11	80	0.1375000
NODE_8550_length_912_cov_15.546125	408	488	3	11	80	0.1375000
NODE_8550_length_912_cov_15.546125	408	488	5	12	80	0.1500000
NODE_8550_length_912_cov_15.546125	408	488	6	57	80	0.7125000
NODE_8551_length_912_cov_15.077491	255	291	0	36	36	1.0000000
NODE_8551_length_912_cov_15.077491	264	328	0	61	64	0.9531250
NODE_8551_length_912_cov_15.077491	264	328	1	3	64	0.0468750
NODE_8551_length_912_cov_15.077491	415	495	1	20	80	0.2500000
NODE_8551_length_912_cov_15.077491	415	495	2	60	80	0.7500000
NODE_8551_length_912_cov_15.077491	468	548	0	31	80	0.3875000
NODE_8551_length_912_cov_15.077491	468	548	1	42	80	0.5250000
NODE_8551_length_912_cov_15.077491	468	548	2	7	80	0.0875000
NODE_8552_length_912_cov_15.023370	361	441	4	1	80	0.0125000
NODE_8552_length_912_cov_15.023370	361	441	5	25	80	0.3125000
NODE_8552_length_912_cov_15.023370	361	441	6	7	80	0.0875000
NODE_8552_length_912_cov_15.023370	361	441	7	1	80	0.0125000
NODE_8552_length_912_cov_15.023370	361	441	9	8	80	0.1000000
NODE_8552_length_912_cov_15.023370	361	441	10	3	80	0.0375000
NODE_8552_length_912_cov_15.023370	361	441	11	35	80	0.4375000
NODE_8552_length_912_cov_15.023370	414	494	8	2	80	0.0250000
NODE_8552_length_912_cov_15.023370	414	494	9	22	80	0.2750000
NODE_8552_length_912_cov_15.023370	414	494	10	20	80	0.2500000
NODE_8552_length_912_cov_15.023370	414	494	11	36	80	0.4500000
NODE_8553_length_912_cov_13.600246	61	141	0	80	80	1.0000000
NODE_8553_length_912_cov_13.600246	460	540	3	10	80	0.1250000
NODE_8553_length_912_cov_13.600246	460	540	4	11	80	0.1375000
NODE_8553_length_912_cov_13.600246	460	540	6	3	80	0.0375000
NODE_8553_length_912_cov_13.600246	460	540	7	38	80	0.4750000
NODE_8553_length_912_cov_13.600246	460	540	10	2	80	0.0250000
NODE_8553_length_912_cov_13.600246	460	540	11	7	80	0.0875000
NODE_8553_length_912_cov_13.600246	460	540	13	6	80	0.0750000
NODE_8553_length_912_cov_13.600246	460	540	14	3	80	0.0375000
NODE_8553_length_912_cov_13.600246	513	593	7	9	80	0.1125000
NODE_8553_length_912_cov_13.600246	513	593	10	2	80	0.0250000
NODE_8553_length_912_cov_13.600246	513	593	11	7	80	0.0875000
NODE_8553_length_912_cov_13.600246	513	593	13	11	80	0.1375000
NODE_8553_length_912_cov_13.600246	513	593	14	27	80	0.3375000
NODE_8553_length_912_cov_13.600246	513	593	15	24	80	0.3000000
NODE_8554_length_912_cov_13.113161	385	465	0	27	80	0.3375000
NODE_8554_length_912_cov_13.113161	385	465	1	53	80	0.6625000
NODE_8554_length_912_cov_13.113161	438	518	1	64	80	0.8000000
NODE_8554_length_912_cov_13.113161	438	518	2	16	80	0.2000000
NODE_8555_length_912_cov_11.110701	353	433	3	47	80	0.5875000
NODE_8555_length_912_cov_11.110701	353	433	4	33	80	0.4125000
NODE_8555_length_912_cov_11.110701	406	486	1	12	80	0.1500000
NODE_8555_length_912_cov_11.110701	406	486	2	5	80	0.0625000
NODE_8555_length_912_cov_11.110701	406	486	3	62	80	0.7750000
NODE_8555_length_912_cov_11.110701	406	486	4	1	80	0.0125000
NODE_8555_length_912_cov_11.110701	827	907	0	80	80	1.0000000
NODE_8555_length_912_cov_11.110701	831	854	0	23	23	1.0000000
NODE_8584_length_911_cov_173.171182	580	660	128	4	80	0.0500000
NODE_8584_length_911_cov_173.171182	580	660	129	6	80	0.0750000
NODE_8584_length_911_cov_173.171182	580	660	130	5	80	0.0625000
NODE_8584_length_911_cov_173.171182	580	660	131	5	80	0.0625000
NODE_8584_length_911_cov_173.171182	580	660	132	10	80	0.1250000
NODE_8584_length_911_cov_173.171182	580	660	133	3	80	0.0375000
NODE_8584_length_911_cov_173.171182	580	660	134	2	80	0.0250000
NODE_8584_length_911_cov_173.171182	580	660	135	9	80	0.1125000
NODE_8584_length_911_cov_173.171182	580	660	136	1	80	0.0125000
NODE_8584_length_911_cov_173.171182	580	660	137	4	80	0.0500000
NODE_8584_length_911_cov_173.171182	580	660	147	2	80	0.0250000
NODE_8584_length_911_cov_173.171182	580	660	148	1	80	0.0125000
NODE_8584_length_911_cov_173.171182	580	660	149	4	80	0.0500000
NODE_8584_length_911_cov_173.171182	580	660	150	2	80	0.0250000
NODE_8584_length_911_cov_173.171182	580	660	151	3	80	0.0375000
NODE_8584_length_911_cov_173.171182	580	660	152	1	80	0.0125000
NODE_8584_length_911_cov_173.171182	580	660	153	1	80	0.0125000
NODE_8584_length_911_cov_173.171182	580	660	154	2	80	0.0250000
NODE_8584_length_911_cov_173.171182	580	660	155	7	80	0.0875000
NODE_8584_length_911_cov_173.171182	580	660	156	2	80	0.0250000
NODE_8584_length_911_cov_173.171182	580	660	157	3	80	0.0375000
NODE_8584_length_911_cov_173.171182	580	660	158	2	80	0.0250000
NODE_8584_length_911_cov_173.171182	580	660	159	1	80	0.0125000
NODE_8584_length_911_cov_173.171182	633	713	121	1	80	0.0125000
NODE_8584_length_911_cov_173.171182	633	713	126	1	80	0.0125000
NODE_8584_length_911_cov_173.171182	633	713	127	1	80	0.0125000
NODE_8584_length_911_cov_173.171182	633	713	128	2	80	0.0250000
NODE_8584_length_911_cov_173.171182	633	713	129	5	80	0.0625000
NODE_8584_length_911_cov_173.171182	633	713	130	2	80	0.0250000
NODE_8584_length_911_cov_173.171182	633	713	131	3	80	0.0375000
NODE_8584_length_911_cov_173.171182	633	713	132	8	80	0.1000000
NODE_8584_length_911_cov_173.171182	633	713	133	6	80	0.0750000
NODE_8584_length_911_cov_173.171182	633	713	134	6	80	0.0750000
NODE_8584_length_911_cov_173.171182	633	713	135	21	80	0.2625000
NODE_8584_length_911_cov_173.171182	633	713	136	3	80	0.0375000
NODE_8584_length_911_cov_173.171182	633	713	137	11	80	0.1375000
NODE_8584_length_911_cov_173.171182	633	713	138	2	80	0.0250000
NODE_8584_length_911_cov_173.171182	633	713	139	4	80	0.0500000
NODE_8584_length_911_cov_173.171182	633	713	140	4	80	0.0500000
NODE_8585_length_911_cov_88.250000	525	605	16	7	80	0.0875000
NODE_8585_length_911_cov_88.250000	525	605	17	10	80	0.1250000
NODE_8585_length_911_cov_88.250000	525	605	18	3	80	0.0375000
NODE_8585_length_911_cov_88.250000	525	605	19	34	80	0.4250000
NODE_8585_length_911_cov_88.250000	525	605	20	17	80	0.2125000
NODE_8585_length_911_cov_88.250000	525	605	21	2	80	0.0250000
NODE_8585_length_911_cov_88.250000	525	605	22	7	80	0.0875000
NODE_8585_length_911_cov_88.250000	578	658	10	2	80	0.0250000
NODE_8585_length_911_cov_88.250000	578	658	11	9	80	0.1125000
NODE_8585_length_911_cov_88.250000	578	658	15	5	80	0.0625000
NODE_8585_length_911_cov_88.250000	578	658	16	39	80	0.4875000
NODE_8585_length_911_cov_88.250000	578	658	17	5	80	0.0625000
NODE_8585_length_911_cov_88.250000	578	658	18	1	80	0.0125000
NODE_8585_length_911_cov_88.250000	578	658	19	19	80	0.2375000
NODE_8586_length_911_cov_46.854680	255	335	6	22	80	0.2750000
NODE_8586_length_911_cov_46.854680	255	335	7	1	80	0.0125000
NODE_8586_length_911_cov_46.854680	255	335	8	8	80	0.1000000
NODE_8586_length_911_cov_46.854680	255	335	9	5	80	0.0625000
NODE_8586_length_911_cov_46.854680	255	335	10	9	80	0.1125000
NODE_8586_length_911_cov_46.854680	255	335	11	2	80	0.0250000
NODE_8586_length_911_cov_46.854680	255	335	12	11	80	0.1375000
NODE_8586_length_911_cov_46.854680	255	335	14	19	80	0.2375000
NODE_8586_length_911_cov_46.854680	255	335	15	3	80	0.0375000
NODE_8586_length_911_cov_46.854680	308	388	11	1	80	0.0125000
NODE_8586_length_911_cov_46.854680	308	388	12	10	80	0.1250000
NODE_8586_length_911_cov_46.854680	308	388	13	23	80	0.2875000
NODE_8586_length_911_cov_46.854680	308	388	14	43	80	0.5375000
NODE_8586_length_911_cov_46.854680	308	388	15	3	80	0.0375000
NODE_8586_length_911_cov_46.854680	384	464	6	6	80	0.0750000
NODE_8586_length_911_cov_46.854680	384	464	8	6	80	0.0750000
NODE_8586_length_911_cov_46.854680	384	464	9	1	80	0.0125000
NODE_8586_length_911_cov_46.854680	384	464	10	10	80	0.1250000
NODE_8586_length_911_cov_46.854680	384	464	11	5	80	0.0625000
NODE_8586_length_911_cov_46.854680	384	464	12	7	80	0.0875000
NODE_8586_length_911_cov_46.854680	384	464	13	41	80	0.5125000
NODE_8586_length_911_cov_46.854680	384	464	14	4	80	0.0500000
NODE_8586_length_911_cov_46.854680	437	517	3	26	80	0.3250000
NODE_8586_length_911_cov_46.854680	437	517	4	24	80	0.3000000
NODE_8586_length_911_cov_46.854680	437	517	6	9	80	0.1125000
NODE_8586_length_911_cov_46.854680	437	517	8	6	80	0.0750000
NODE_8586_length_911_cov_46.854680	437	517	9	1	80	0.0125000
NODE_8586_length_911_cov_46.854680	437	517	10	10	80	0.1250000
NODE_8586_length_911_cov_46.854680	437	517	11	4	80	0.0500000
NODE_8587_length_911_cov_31.362069	301	381	7	2	80	0.0250000
NODE_8587_length_911_cov_31.362069	301	381	9	3	80	0.0375000
NODE_8587_length_911_cov_31.362069	301	381	10	15	80	0.1875000
NODE_8587_length_911_cov_31.362069	301	381	11	1	80	0.0125000
NODE_8587_length_911_cov_31.362069	301	381	12	2	80	0.0250000
NODE_8587_length_911_cov_31.362069	301	381	13	8	80	0.1000000
NODE_8587_length_911_cov_31.362069	301	381	14	2	80	0.0250000
NODE_8587_length_911_cov_31.362069	301	381	15	5	80	0.0625000
NODE_8587_length_911_cov_31.362069	301	381	16	7	80	0.0875000
NODE_8587_length_911_cov_31.362069	301	381	17	11	80	0.1375000
NODE_8587_length_911_cov_31.362069	301	381	18	1	80	0.0125000
NODE_8587_length_911_cov_31.362069	301	381	19	14	80	0.1750000
NODE_8587_length_911_cov_31.362069	301	381	20	9	80	0.1125000
NODE_8587_length_911_cov_31.362069	354	434	16	9	80	0.1125000
NODE_8587_length_911_cov_31.362069	354	434	17	6	80	0.0750000
NODE_8587_length_911_cov_31.362069	354	434	18	1	80	0.0125000
NODE_8587_length_911_cov_31.362069	354	434	19	37	80	0.4625000
NODE_8587_length_911_cov_31.362069	354	434	20	15	80	0.1875000
NODE_8587_length_911_cov_31.362069	354	434	21	3	80	0.0375000
NODE_8587_length_911_cov_31.362069	354	434	22	9	80	0.1125000
NODE_8588_length_911_cov_19.235222	445	525	3	3	80	0.0375000
NODE_8588_length_911_cov_19.235222	445	525	4	77	80	0.9625000
NODE_8588_length_911_cov_19.235222	498	578	3	36	80	0.4500000
NODE_8588_length_911_cov_19.235222	498	578	4	44	80	0.5500000
NODE_8589_length_911_cov_16.230296	233	313	2	21	80	0.2625000
NODE_8589_length_911_cov_16.230296	233	313	3	1	80	0.0125000
NODE_8589_length_911_cov_16.230296	233	313	4	33	80	0.4125000
NODE_8589_length_911_cov_16.230296	233	313	5	25	80	0.3125000
NODE_8589_length_911_cov_16.230296	286	366	4	30	80	0.3750000
NODE_8589_length_911_cov_16.230296	286	366	5	50	80	0.6250000
NODE_8590_length_911_cov_14.979064	472	552	5	80	80	1.0000000
NODE_8590_length_911_cov_14.979064	525	605	1	7	80	0.0875000
NODE_8590_length_911_cov_14.979064	525	605	2	35	80	0.4375000
NODE_8590_length_911_cov_14.979064	525	605	3	5	80	0.0625000
NODE_8590_length_911_cov_14.979064	525	605	5	33	80	0.4125000
NODE_8591_length_911_cov_12.089901	357	409	4	18	52	0.3461539
NODE_8591_length_911_cov_12.089901	357	409	5	16	52	0.3076923
NODE_8591_length_911_cov_12.089901	357	409	7	18	52	0.3461539
NODE_8591_length_911_cov_12.089901	401	462	5	9	61	0.1475410
NODE_8591_length_911_cov_12.089901	401	462	7	52	61	0.8524590
NODE_8606_length_910_cov_27.838471	347	427	5	2	80	0.0250000
NODE_8606_length_910_cov_27.838471	347	427	7	32	80	0.4000000
NODE_8606_length_910_cov_27.838471	347	427	8	39	80	0.4875000
NODE_8606_length_910_cov_27.838471	347	427	9	7	80	0.0875000
NODE_8606_length_910_cov_27.838471	400	480	4	2	80	0.0250000
NODE_8606_length_910_cov_27.838471	400	480	5	19	80	0.2375000
NODE_8606_length_910_cov_27.838471	400	480	6	15	80	0.1875000
NODE_8606_length_910_cov_27.838471	400	480	8	22	80	0.2750000
NODE_8606_length_910_cov_27.838471	400	480	9	8	80	0.1000000
NODE_8606_length_910_cov_27.838471	400	480	10	14	80	0.1750000
NODE_8607_length_910_cov_25.895191	361	441	4	10	80	0.1250000
NODE_8607_length_910_cov_25.895191	361	441	5	8	80	0.1000000
NODE_8607_length_910_cov_25.895191	361	441	6	4	80	0.0500000
NODE_8607_length_910_cov_25.895191	361	441	7	17	80	0.2125000
NODE_8607_length_910_cov_25.895191	361	441	8	41	80	0.5125000
NODE_8607_length_910_cov_25.895191	414	494	6	8	80	0.1000000
NODE_8607_length_910_cov_25.895191	414	494	7	50	80	0.6250000
NODE_8607_length_910_cov_25.895191	414	494	8	22	80	0.2750000
NODE_8608_length_910_cov_25.604192	294	374	2	6	80	0.0750000
NODE_8608_length_910_cov_25.604192	294	374	4	1	80	0.0125000
NODE_8608_length_910_cov_25.604192	294	374	6	33	80	0.4125000
NODE_8608_length_910_cov_25.604192	294	374	7	40	80	0.5000000
NODE_8608_length_910_cov_25.604192	347	427	3	8	80	0.1000000
NODE_8608_length_910_cov_25.604192	347	427	4	13	80	0.1625000
NODE_8608_length_910_cov_25.604192	347	427	5	4	80	0.0500000
NODE_8608_length_910_cov_25.604192	347	427	6	11	80	0.1375000
NODE_8608_length_910_cov_25.604192	347	427	7	44	80	0.5500000
NODE_8608_length_910_cov_25.604192	423	503	4	20	80	0.2500000
NODE_8608_length_910_cov_25.604192	423	503	5	10	80	0.1250000
NODE_8608_length_910_cov_25.604192	423	503	7	33	80	0.4125000
NODE_8608_length_910_cov_25.604192	423	503	8	17	80	0.2125000
NODE_8608_length_910_cov_25.604192	476	556	7	29	80	0.3625000
NODE_8608_length_910_cov_25.604192	476	556	8	51	80	0.6375000
NODE_8609_length_910_cov_16.066584	656	736	7	18	80	0.2250000
NODE_8609_length_910_cov_16.066584	656	736	9	9	80	0.1125000
NODE_8609_length_910_cov_16.066584	656	736	10	23	80	0.2875000
NODE_8609_length_910_cov_16.066584	656	736	12	12	80	0.1500000
NODE_8609_length_910_cov_16.066584	656	736	13	18	80	0.2250000
NODE_8609_length_910_cov_16.066584	709	789	7	9	80	0.1125000
NODE_8609_length_910_cov_16.066584	709	789	8	1	80	0.0125000
NODE_8609_length_910_cov_16.066584	709	789	9	7	80	0.0875000
NODE_8609_length_910_cov_16.066584	709	789	11	23	80	0.2875000
NODE_8609_length_910_cov_16.066584	709	789	12	9	80	0.1125000
NODE_8609_length_910_cov_16.066584	709	789	13	31	80	0.3875000
NODE_8610_length_910_cov_14.696671	417	497	0	22	80	0.2750000
NODE_8610_length_910_cov_14.696671	417	497	4	58	80	0.7250000
NODE_8610_length_910_cov_14.696671	470	550	0	1	80	0.0125000
NODE_8610_length_910_cov_14.696671	470	550	2	24	80	0.3000000
NODE_8610_length_910_cov_14.696671	470	550	3	28	80	0.3500000
NODE_8610_length_910_cov_14.696671	470	550	4	27	80	0.3375000
NODE_8612_length_910_cov_7.114673	442	522	3	3	80	0.0375000
NODE_8612_length_910_cov_7.114673	442	522	5	77	80	0.9625000
NODE_8612_length_910_cov_7.114673	495	575	1	9	80	0.1125000
NODE_8612_length_910_cov_7.114673	495	575	3	20	80	0.2500000
NODE_8612_length_910_cov_7.114673	495	575	5	51	80	0.6375000
NODE_8614_length_910_cov_2.992602	196	269	2	2	73	0.0273973
NODE_8614_length_910_cov_2.992602	196	269	3	6	73	0.0821918
NODE_8614_length_910_cov_2.992602	196	269	4	10	73	0.1369863
NODE_8614_length_910_cov_2.992602	196	269	6	8	73	0.1095890
NODE_8614_length_910_cov_2.992602	196	269	9	2	73	0.0273973
NODE_8614_length_910_cov_2.992602	196	269	10	27	73	0.3698630
NODE_8614_length_910_cov_2.992602	196	269	11	11	73	0.1506849
NODE_8614_length_910_cov_2.992602	196	269	13	7	73	0.0958904
NODE_8614_length_910_cov_2.992602	249	329	10	2	80	0.0250000
NODE_8614_length_910_cov_2.992602	249	329	11	11	80	0.1375000
NODE_8614_length_910_cov_2.992602	249	329	13	11	80	0.1375000
NODE_8614_length_910_cov_2.992602	249	329	14	2	80	0.0250000
NODE_8614_length_910_cov_2.992602	249	329	15	36	80	0.4500000
NODE_8614_length_910_cov_2.992602	249	329	16	18	80	0.2250000
NODE_8614_length_910_cov_2.992602	386	439	1	35	53	0.6603774
NODE_8614_length_910_cov_2.992602	386	439	2	15	53	0.2830189
NODE_8614_length_910_cov_2.992602	386	439	4	3	53	0.0566038
NODE_8623_length_909_cov_35.291358	426	506	3	22	80	0.2750000
NODE_8623_length_909_cov_35.291358	426	506	4	56	80	0.7000000
NODE_8623_length_909_cov_35.291358	426	506	5	2	80	0.0250000
NODE_8623_length_909_cov_35.291358	479	559	3	20	80	0.2500000
NODE_8623_length_909_cov_35.291358	479	559	4	60	80	0.7500000
NODE_8624_length_909_cov_27.449383	311	391	2	1	80	0.0125000
NODE_8624_length_909_cov_27.449383	311	391	3	7	80	0.0875000
NODE_8624_length_909_cov_27.449383	311	391	4	6	80	0.0750000
NODE_8624_length_909_cov_27.449383	311	391	6	64	80	0.8000000
NODE_8624_length_909_cov_27.449383	311	391	7	2	80	0.0250000
NODE_8624_length_909_cov_27.449383	364	444	6	32	80	0.4000000
NODE_8624_length_909_cov_27.449383	364	444	7	29	80	0.3625000
NODE_8624_length_909_cov_27.449383	364	444	8	19	80	0.2375000
NODE_8625_length_909_cov_25.212346	295	375	3	34	80	0.4250000
NODE_8625_length_909_cov_25.212346	295	375	4	6	80	0.0750000
NODE_8625_length_909_cov_25.212346	295	375	6	9	80	0.1125000
NODE_8625_length_909_cov_25.212346	295	375	7	31	80	0.3875000
NODE_8625_length_909_cov_25.212346	348	428	6	19	80	0.2375000
NODE_8625_length_909_cov_25.212346	348	428	7	20	80	0.2500000
NODE_8625_length_909_cov_25.212346	348	428	8	6	80	0.0750000
NODE_8625_length_909_cov_25.212346	348	428	9	35	80	0.4375000
NODE_8626_length_909_cov_23.604938	403	483	10	13	80	0.1625000
NODE_8626_length_909_cov_23.604938	403	483	11	67	80	0.8375000
NODE_8626_length_909_cov_23.604938	456	536	3	15	80	0.1875000
NODE_8626_length_909_cov_23.604938	456	536	5	14	80	0.1750000
NODE_8626_length_909_cov_23.604938	456	536	7	16	80	0.2000000
NODE_8626_length_909_cov_23.604938	456	536	8	2	80	0.0250000
NODE_8626_length_909_cov_23.604938	456	536	9	1	80	0.0125000
NODE_8626_length_909_cov_23.604938	456	536	10	18	80	0.2250000
NODE_8626_length_909_cov_23.604938	456	536	11	14	80	0.1750000
NODE_8627_length_909_cov_19.070370	441	521	6	15	80	0.1875000
NODE_8627_length_909_cov_19.070370	441	521	7	12	80	0.1500000
NODE_8627_length_909_cov_19.070370	441	521	8	24	80	0.3000000
NODE_8627_length_909_cov_19.070370	441	521	9	27	80	0.3375000
NODE_8627_length_909_cov_19.070370	441	521	10	2	80	0.0250000
NODE_8627_length_909_cov_19.070370	494	574	7	30	80	0.3750000
NODE_8627_length_909_cov_19.070370	494	574	8	5	80	0.0625000
NODE_8627_length_909_cov_19.070370	494	574	9	33	80	0.4125000
NODE_8627_length_909_cov_19.070370	494	574	10	12	80	0.1500000
NODE_8628_length_909_cov_11.533333	332	412	0	80	80	1.0000000
NODE_8628_length_909_cov_11.533333	385	465	0	80	80	1.0000000
NODE_8629_length_909_cov_10.229630	497	577	6	80	80	1.0000000
NODE_8629_length_909_cov_10.229630	550	622	2	5	72	0.0694444
NODE_8629_length_909_cov_10.229630	550	622	4	3	72	0.0416667
NODE_8629_length_909_cov_10.229630	550	622	5	34	72	0.4722222
NODE_8629_length_909_cov_10.229630	550	622	6	30	72	0.4166667
NODE_8631_length_909_cov_7.122222	328	408	0	80	80	1.0000000
NODE_8631_length_909_cov_7.122222	381	461	0	68	80	0.8500000
NODE_8631_length_909_cov_7.122222	381	461	1	12	80	0.1500000
NODE_8632_length_909_cov_4.664198	775	855	0	45	80	0.5625000
NODE_8632_length_909_cov_4.664198	775	855	2	11	80	0.1375000
NODE_8632_length_909_cov_4.664198	775	855	4	24	80	0.3000000
NODE_8632_length_909_cov_4.664198	828	885	0	57	57	1.0000000
NODE_8644_length_908_cov_55.546354	409	489	18	7	80	0.0875000
NODE_8644_length_908_cov_55.546354	409	489	19	4	80	0.0500000
NODE_8644_length_908_cov_55.546354	409	489	22	6	80	0.0750000
NODE_8644_length_908_cov_55.546354	409	489	23	3	80	0.0375000
NODE_8644_length_908_cov_55.546354	409	489	24	8	80	0.1000000
NODE_8644_length_908_cov_55.546354	409	489	25	8	80	0.1000000
NODE_8644_length_908_cov_55.546354	409	489	26	12	80	0.1500000
NODE_8644_length_908_cov_55.546354	409	489	27	27	80	0.3375000
NODE_8644_length_908_cov_55.546354	409	489	28	1	80	0.0125000
NODE_8644_length_908_cov_55.546354	409	489	29	4	80	0.0500000
NODE_8644_length_908_cov_55.546354	462	542	14	6	80	0.0750000
NODE_8644_length_908_cov_55.546354	462	542	15	6	80	0.0750000
NODE_8644_length_908_cov_55.546354	462	542	16	5	80	0.0625000
NODE_8644_length_908_cov_55.546354	462	542	17	3	80	0.0375000
NODE_8644_length_908_cov_55.546354	462	542	18	5	80	0.0625000
NODE_8644_length_908_cov_55.546354	462	542	19	7	80	0.0875000
NODE_8644_length_908_cov_55.546354	462	542	21	18	80	0.2250000
NODE_8644_length_908_cov_55.546354	462	542	22	8	80	0.1000000
NODE_8644_length_908_cov_55.546354	462	542	24	2	80	0.0250000
NODE_8644_length_908_cov_55.546354	462	542	25	1	80	0.0125000
NODE_8644_length_908_cov_55.546354	462	542	26	11	80	0.1375000
NODE_8644_length_908_cov_55.546354	462	542	27	8	80	0.1000000
NODE_8645_length_908_cov_18.720643	329	409	14	1	80	0.0125000
NODE_8645_length_908_cov_18.720643	329	409	15	9	80	0.1125000
NODE_8645_length_908_cov_18.720643	329	409	19	13	80	0.1625000
NODE_8645_length_908_cov_18.720643	329	409	20	4	80	0.0500000
NODE_8645_length_908_cov_18.720643	329	409	21	13	80	0.1625000
NODE_8645_length_908_cov_18.720643	329	409	24	2	80	0.0250000
NODE_8645_length_908_cov_18.720643	329	409	25	3	80	0.0375000
NODE_8645_length_908_cov_18.720643	329	409	26	7	80	0.0875000
NODE_8645_length_908_cov_18.720643	329	409	27	1	80	0.0125000
NODE_8645_length_908_cov_18.720643	329	409	29	6	80	0.0750000
NODE_8645_length_908_cov_18.720643	329	409	30	10	80	0.1250000
NODE_8645_length_908_cov_18.720643	329	409	31	11	80	0.1375000
NODE_8645_length_908_cov_18.720643	382	462	14	2	80	0.0250000
NODE_8645_length_908_cov_18.720643	382	462	15	2	80	0.0250000
NODE_8645_length_908_cov_18.720643	382	462	16	3	80	0.0375000
NODE_8645_length_908_cov_18.720643	382	462	17	1	80	0.0125000
NODE_8645_length_908_cov_18.720643	382	462	20	5	80	0.0625000
NODE_8645_length_908_cov_18.720643	382	462	21	4	80	0.0500000
NODE_8645_length_908_cov_18.720643	382	462	22	8	80	0.1000000
NODE_8645_length_908_cov_18.720643	382	462	26	10	80	0.1250000
NODE_8645_length_908_cov_18.720643	382	462	27	1	80	0.0125000
NODE_8645_length_908_cov_18.720643	382	462	28	11	80	0.1375000
NODE_8645_length_908_cov_18.720643	382	462	29	10	80	0.1250000
NODE_8645_length_908_cov_18.720643	382	462	30	12	80	0.1500000
NODE_8645_length_908_cov_18.720643	382	462	31	11	80	0.1375000
NODE_8646_length_908_cov_14.640297	430	510	4	19	80	0.2375000
NODE_8646_length_908_cov_14.640297	430	510	5	61	80	0.7625000
NODE_8646_length_908_cov_14.640297	483	562	1	8	79	0.1012658
NODE_8646_length_908_cov_14.640297	483	562	3	12	79	0.1518987
NODE_8646_length_908_cov_14.640297	483	562	5	59	79	0.7468355
NODE_8648_length_908_cov_10.789864	370	450	3	2	80	0.0250000
NODE_8648_length_908_cov_10.789864	370	450	4	9	80	0.1125000
NODE_8648_length_908_cov_10.789864	370	450	5	26	80	0.3250000
NODE_8648_length_908_cov_10.789864	370	450	6	28	80	0.3500000
NODE_8648_length_908_cov_10.789864	370	450	7	1	80	0.0125000
NODE_8648_length_908_cov_10.789864	370	450	8	14	80	0.1750000
NODE_8648_length_908_cov_10.789864	423	503	2	11	80	0.1375000
NODE_8648_length_908_cov_10.789864	423	503	3	44	80	0.5500000
NODE_8648_length_908_cov_10.789864	423	503	4	9	80	0.1125000
NODE_8648_length_908_cov_10.789864	423	503	5	16	80	0.2000000
NODE_8651_length_908_cov_3.737948	251	331	0	80	80	1.0000000
NODE_8651_length_908_cov_3.737948	304	384	0	80	80	1.0000000
NODE_8664_length_907_cov_22.110149	459	539	3	38	80	0.4750000
NODE_8664_length_907_cov_22.110149	459	539	4	2	80	0.0250000
NODE_8664_length_907_cov_22.110149	459	539	5	40	80	0.5000000
NODE_8664_length_907_cov_22.110149	512	592	3	38	80	0.4750000
NODE_8664_length_907_cov_22.110149	512	592	4	12	80	0.1500000
NODE_8664_length_907_cov_22.110149	512	592	5	30	80	0.3750000
NODE_8665_length_907_cov_20.943069	410	490	3	24	80	0.3000000
NODE_8665_length_907_cov_20.943069	410	490	5	56	80	0.7000000
NODE_8665_length_907_cov_20.943069	463	543	1	4	80	0.0500000
NODE_8665_length_907_cov_20.943069	463	543	2	2	80	0.0250000
NODE_8665_length_907_cov_20.943069	463	543	3	31	80	0.3875000
NODE_8665_length_907_cov_20.943069	463	543	5	43	80	0.5375000
NODE_8666_length_907_cov_19.519802	411	488	3	1	77	0.0129870
NODE_8666_length_907_cov_19.519802	411	488	4	21	77	0.2727273
NODE_8666_length_907_cov_19.519802	411	488	5	24	77	0.3116883
NODE_8666_length_907_cov_19.519802	411	488	6	5	77	0.0649351
NODE_8666_length_907_cov_19.519802	411	488	7	13	77	0.1688312
NODE_8666_length_907_cov_19.519802	411	488	8	13	77	0.1688312
NODE_8666_length_907_cov_19.519802	461	541	5	1	80	0.0125000
NODE_8666_length_907_cov_19.519802	461	541	7	20	80	0.2500000
NODE_8666_length_907_cov_19.519802	461	541	8	59	80	0.7375000
NODE_8667_length_907_cov_17.928218	329	405	7	19	76	0.2500000
NODE_8667_length_907_cov_17.928218	329	405	9	57	76	0.7500000
NODE_8667_length_907_cov_17.928218	382	462	0	5	80	0.0625000
NODE_8667_length_907_cov_17.928218	382	462	2	9	80	0.1125000
NODE_8667_length_907_cov_17.928218	382	462	3	32	80	0.4000000
NODE_8667_length_907_cov_17.928218	382	462	6	1	80	0.0125000
NODE_8667_length_907_cov_17.928218	382	462	7	5	80	0.0625000
NODE_8667_length_907_cov_17.928218	382	462	9	28	80	0.3500000
NODE_8668_length_907_cov_13.060644	293	373	1	66	80	0.8250000
NODE_8668_length_907_cov_13.060644	293	373	2	14	80	0.1750000
NODE_8668_length_907_cov_13.060644	346	426	1	13	80	0.1625000
NODE_8668_length_907_cov_13.060644	346	426	2	31	80	0.3875000
NODE_8668_length_907_cov_13.060644	346	426	3	17	80	0.2125000
NODE_8668_length_907_cov_13.060644	346	426	4	19	80	0.2375000
NODE_8669_length_907_cov_11.155941	401	462	0	23	61	0.3770492
NODE_8669_length_907_cov_11.155941	401	462	1	38	61	0.6229508
NODE_8669_length_907_cov_11.155941	607	687	0	80	80	1.0000000
NODE_8670_length_907_cov_9.237624	247	327	0	80	80	1.0000000
NODE_8670_length_907_cov_9.237624	300	380	0	80	80	1.0000000
NODE_8671_length_907_cov_8.686881	275	365	1	19	90	0.2111111
NODE_8671_length_907_cov_8.686881	275	365	2	71	90	0.7888889
NODE_8671_length_907_cov_8.686881	338	418	2	80	80	1.0000000
NODE_8680_length_907_cov_2.949257	503	526	0	23	23	1.0000000
NODE_8686_length_906_cov_32.369269	447	527	2	2	80	0.0250000
NODE_8686_length_906_cov_32.369269	447	527	3	21	80	0.2625000
NODE_8686_length_906_cov_32.369269	447	527	5	14	80	0.1750000
NODE_8686_length_906_cov_32.369269	447	527	6	8	80	0.1000000
NODE_8686_length_906_cov_32.369269	447	527	7	3	80	0.0375000
NODE_8686_length_906_cov_32.369269	447	527	9	32	80	0.4000000
NODE_8686_length_906_cov_32.369269	500	580	7	7	80	0.0875000
NODE_8686_length_906_cov_32.369269	500	580	9	73	80	0.9125000
NODE_8687_length_906_cov_23.594796	196	276	2	7	80	0.0875000
NODE_8687_length_906_cov_23.594796	196	276	4	1	80	0.0125000
NODE_8687_length_906_cov_23.594796	196	276	5	2	80	0.0250000
NODE_8687_length_906_cov_23.594796	196	276	6	26	80	0.3250000
NODE_8687_length_906_cov_23.594796	196	276	8	37	80	0.4625000
NODE_8687_length_906_cov_23.594796	196	276	9	7	80	0.0875000
NODE_8687_length_906_cov_23.594796	249	329	8	36	80	0.4500000
NODE_8687_length_906_cov_23.594796	249	329	9	9	80	0.1125000
NODE_8687_length_906_cov_23.594796	249	329	10	35	80	0.4375000
NODE_8688_length_906_cov_21.443618	404	484	4	52	80	0.6500000
NODE_8688_length_906_cov_21.443618	404	484	6	10	80	0.1250000
NODE_8688_length_906_cov_21.443618	404	484	8	18	80	0.2250000
NODE_8688_length_906_cov_21.443618	457	537	5	21	80	0.2625000
NODE_8688_length_906_cov_21.443618	457	537	6	31	80	0.3875000
NODE_8688_length_906_cov_21.443618	457	537	7	6	80	0.0750000
NODE_8688_length_906_cov_21.443618	457	537	8	22	80	0.2750000
NODE_8689_length_906_cov_20.596035	593	634	1	36	41	0.8780488
NODE_8689_length_906_cov_20.596035	593	634	2	1	41	0.0243902
NODE_8689_length_906_cov_20.596035	593	634	3	4	41	0.0975610
NODE_8690_length_906_cov_20.429988	410	490	4	1	80	0.0125000
NODE_8690_length_906_cov_20.429988	410	490	5	27	80	0.3375000
NODE_8690_length_906_cov_20.429988	410	490	6	5	80	0.0625000
NODE_8690_length_906_cov_20.429988	410	490	7	12	80	0.1500000
NODE_8690_length_906_cov_20.429988	410	490	9	1	80	0.0125000
NODE_8690_length_906_cov_20.429988	410	490	10	17	80	0.2125000
NODE_8690_length_906_cov_20.429988	410	490	11	17	80	0.2125000
NODE_8690_length_906_cov_20.429988	463	543	9	11	80	0.1375000
NODE_8690_length_906_cov_20.429988	463	543	10	23	80	0.2875000
NODE_8690_length_906_cov_20.429988	463	543	11	30	80	0.3750000
NODE_8690_length_906_cov_20.429988	463	543	12	8	80	0.1000000
NODE_8690_length_906_cov_20.429988	463	543	13	8	80	0.1000000
NODE_8691_length_906_cov_20.395291	523	603	4	19	80	0.2375000
NODE_8691_length_906_cov_20.395291	523	603	5	11	80	0.1375000
NODE_8691_length_906_cov_20.395291	523	603	6	39	80	0.4875000
NODE_8691_length_906_cov_20.395291	523	603	7	11	80	0.1375000
NODE_8691_length_906_cov_20.395291	576	656	5	19	80	0.2375000
NODE_8691_length_906_cov_20.395291	576	656	6	46	80	0.5750000
NODE_8691_length_906_cov_20.395291	576	656	7	15	80	0.1875000
NODE_8692_length_906_cov_19.297398	255	335	0	19	80	0.2375000
NODE_8692_length_906_cov_19.297398	255	335	1	52	80	0.6500000
NODE_8692_length_906_cov_19.297398	255	335	3	9	80	0.1125000
NODE_8692_length_906_cov_19.297398	308	388	1	18	80	0.2250000
NODE_8692_length_906_cov_19.297398	308	388	3	62	80	0.7750000
NODE_8693_length_906_cov_18.505576	357	437	3	1	80	0.0125000
NODE_8693_length_906_cov_18.505576	357	437	4	55	80	0.6875000
NODE_8693_length_906_cov_18.505576	357	437	5	8	80	0.1000000
NODE_8693_length_906_cov_18.505576	357	437	6	16	80	0.2000000
NODE_8693_length_906_cov_18.505576	410	490	3	17	80	0.2125000
NODE_8693_length_906_cov_18.505576	410	490	4	21	80	0.2625000
NODE_8693_length_906_cov_18.505576	410	490	5	32	80	0.4000000
NODE_8693_length_906_cov_18.505576	410	490	6	10	80	0.1250000
NODE_8694_length_906_cov_10.068154	191	271	2	43	80	0.5375000
NODE_8694_length_906_cov_10.068154	191	271	3	37	80	0.4625000
NODE_8694_length_906_cov_10.068154	244	324	2	56	80	0.7000000
NODE_8694_length_906_cov_10.068154	244	324	3	24	80	0.3000000
NODE_8695_length_906_cov_10.006196	304	384	0	80	80	1.0000000
NODE_8695_length_906_cov_10.006196	357	437	0	80	80	1.0000000
NODE_8696_length_906_cov_8.562577	370	454	0	33	84	0.3928571
NODE_8696_length_906_cov_8.562577	370	454	2	51	84	0.6071429
NODE_8696_length_906_cov_8.562577	423	507	0	26	84	0.3095238
NODE_8696_length_906_cov_8.562577	423	507	2	58	84	0.6904762
NODE_8716_length_905_cov_39.203474	406	486	4	28	80	0.3500000
NODE_8716_length_905_cov_39.203474	406	486	5	12	80	0.1500000
NODE_8716_length_905_cov_39.203474	406	486	6	40	80	0.5000000
NODE_8716_length_905_cov_39.203474	459	539	5	37	80	0.4625000
NODE_8716_length_905_cov_39.203474	459	539	6	43	80	0.5375000
NODE_8717_length_905_cov_37.053350	411	491	8	11	80	0.1375000
NODE_8717_length_905_cov_37.053350	411	491	9	10	80	0.1250000
NODE_8717_length_905_cov_37.053350	411	491	10	23	80	0.2875000
NODE_8717_length_905_cov_37.053350	411	491	11	1	80	0.0125000
NODE_8717_length_905_cov_37.053350	411	491	12	18	80	0.2250000
NODE_8717_length_905_cov_37.053350	411	491	13	17	80	0.2125000
NODE_8717_length_905_cov_37.053350	464	544	3	11	80	0.1375000
NODE_8717_length_905_cov_37.053350	464	544	4	18	80	0.2250000
NODE_8717_length_905_cov_37.053350	464	544	6	7	80	0.0875000
NODE_8717_length_905_cov_37.053350	464	544	7	17	80	0.2125000
NODE_8717_length_905_cov_37.053350	464	544	8	11	80	0.1375000
NODE_8717_length_905_cov_37.053350	464	544	9	10	80	0.1250000
NODE_8717_length_905_cov_37.053350	464	544	10	4	80	0.0500000
NODE_8717_length_905_cov_37.053350	464	544	11	1	80	0.0125000
NODE_8717_length_905_cov_37.053350	464	544	13	1	80	0.0125000
NODE_8718_length_905_cov_27.426799	288	368	5	38	80	0.4750000
NODE_8718_length_905_cov_27.426799	288	368	7	13	80	0.1625000
NODE_8718_length_905_cov_27.426799	288	368	8	15	80	0.1875000
NODE_8718_length_905_cov_27.426799	288	368	10	4	80	0.0500000
NODE_8718_length_905_cov_27.426799	288	368	11	10	80	0.1250000
NODE_8718_length_905_cov_27.426799	341	421	8	13	80	0.1625000
NODE_8718_length_905_cov_27.426799	341	421	9	3	80	0.0375000
NODE_8718_length_905_cov_27.426799	341	421	10	5	80	0.0625000
NODE_8718_length_905_cov_27.426799	341	421	11	55	80	0.6875000
NODE_8718_length_905_cov_27.426799	341	421	12	4	80	0.0500000
NODE_8719_length_905_cov_26.332506	375	455	2	9	80	0.1125000
NODE_8719_length_905_cov_26.332506	375	455	3	27	80	0.3375000
NODE_8719_length_905_cov_26.332506	375	455	5	35	80	0.4375000
NODE_8719_length_905_cov_26.332506	375	455	6	9	80	0.1125000
NODE_8719_length_905_cov_26.332506	428	508	5	22	80	0.2750000
NODE_8719_length_905_cov_26.332506	428	508	6	58	80	0.7250000
NODE_8720_length_905_cov_20.651365	377	457	0	80	80	1.0000000
NODE_8720_length_905_cov_20.651365	430	510	0	80	80	1.0000000
NODE_8721_length_905_cov_19.718362	365	445	2	9	80	0.1125000
NODE_8721_length_905_cov_19.718362	365	445	3	16	80	0.2000000
NODE_8721_length_905_cov_19.718362	365	445	4	19	80	0.2375000
NODE_8721_length_905_cov_19.718362	365	445	5	36	80	0.4500000
NODE_8721_length_905_cov_19.718362	418	498	3	12	80	0.1500000
NODE_8721_length_905_cov_19.718362	418	498	4	41	80	0.5125000
NODE_8721_length_905_cov_19.718362	418	498	5	27	80	0.3375000
NODE_8722_length_905_cov_13.696030	366	420	9	54	54	1.0000000
NODE_8723_length_905_cov_9.978908	222	302	2	80	80	1.0000000
NODE_8723_length_905_cov_9.978908	275	355	0	51	80	0.6375000
NODE_8723_length_905_cov_9.978908	275	355	2	29	80	0.3625000
NODE_8725_length_905_cov_7.980149	321	401	5	40	80	0.5000000
NODE_8725_length_905_cov_7.980149	321	401	6	40	80	0.5000000
NODE_8725_length_905_cov_7.980149	374	454	0	1	80	0.0125000
NODE_8725_length_905_cov_7.980149	374	454	4	1	80	0.0125000
NODE_8725_length_905_cov_7.980149	374	454	5	78	80	0.9750000
NODE_8727_length_905_cov_6.064516	459	539	1	10	80	0.1250000
NODE_8727_length_905_cov_6.064516	459	539	2	39	80	0.4875000
NODE_8727_length_905_cov_6.064516	459	539	3	31	80	0.3875000
NODE_8727_length_905_cov_6.064516	512	592	2	46	80	0.5750000
NODE_8727_length_905_cov_6.064516	512	592	3	34	80	0.4250000
NODE_8742_length_905_cov_1.040943	73	119	6	46	46	1.0000000
NODE_8742_length_905_cov_1.040943	126	172	1	1	46	0.0217391
NODE_8742_length_905_cov_1.040943	126	172	2	4	46	0.0869565
NODE_8742_length_905_cov_1.040943	126	172	3	9	46	0.1956522
NODE_8742_length_905_cov_1.040943	126	172	4	9	46	0.1956522
NODE_8742_length_905_cov_1.040943	126	172	6	23	46	0.5000000
NODE_8743_length_904_cov_29.532919	338	418	8	32	80	0.4000000
NODE_8743_length_904_cov_29.532919	338	418	10	46	80	0.5750000
NODE_8743_length_904_cov_29.532919	338	418	12	2	80	0.0250000
NODE_8743_length_904_cov_29.532919	391	471	7	25	80	0.3125000
NODE_8743_length_904_cov_29.532919	391	471	8	17	80	0.2125000
NODE_8743_length_904_cov_29.532919	391	471	9	12	80	0.1500000
NODE_8743_length_904_cov_29.532919	391	471	10	26	80	0.3250000
NODE_8743_length_904_cov_29.532919	467	547	8	10	80	0.1250000
NODE_8743_length_904_cov_29.532919	467	547	9	25	80	0.3125000
NODE_8743_length_904_cov_29.532919	467	547	10	5	80	0.0625000
NODE_8743_length_904_cov_29.532919	467	547	11	27	80	0.3375000
NODE_8743_length_904_cov_29.532919	467	547	12	3	80	0.0375000
NODE_8743_length_904_cov_29.532919	467	547	13	10	80	0.1250000
NODE_8743_length_904_cov_29.532919	520	600	9	2	80	0.0250000
NODE_8743_length_904_cov_29.532919	520	600	10	12	80	0.1500000
NODE_8743_length_904_cov_29.532919	520	600	11	37	80	0.4625000
NODE_8743_length_904_cov_29.532919	520	600	12	3	80	0.0375000
NODE_8743_length_904_cov_29.532919	520	600	13	26	80	0.3250000
NODE_8744_length_904_cov_28.844720	371	451	0	35	80	0.4375000
NODE_8744_length_904_cov_28.844720	371	451	1	5	80	0.0625000
NODE_8744_length_904_cov_28.844720	371	451	2	40	80	0.5000000
NODE_8744_length_904_cov_28.844720	424	504	0	80	80	1.0000000
NODE_8745_length_904_cov_26.977640	488	568	9	37	80	0.4625000
NODE_8745_length_904_cov_26.977640	488	568	10	20	80	0.2500000
NODE_8745_length_904_cov_26.977640	488	568	11	23	80	0.2875000
NODE_8745_length_904_cov_26.977640	541	621	5	18	80	0.2250000
NODE_8745_length_904_cov_26.977640	541	621	6	1	80	0.0125000
NODE_8745_length_904_cov_26.977640	541	621	7	5	80	0.0625000
NODE_8745_length_904_cov_26.977640	541	621	8	4	80	0.0500000
NODE_8745_length_904_cov_26.977640	541	621	9	34	80	0.4250000
NODE_8745_length_904_cov_26.977640	541	621	10	18	80	0.2250000
NODE_8746_length_904_cov_24.529193	464	544	4	37	80	0.4625000
NODE_8746_length_904_cov_24.529193	464	544	5	28	80	0.3500000
NODE_8746_length_904_cov_24.529193	464	544	6	15	80	0.1875000
NODE_8746_length_904_cov_24.529193	517	597	3	1	80	0.0125000
NODE_8746_length_904_cov_24.529193	517	597	5	33	80	0.4125000
NODE_8746_length_904_cov_24.529193	517	597	6	46	80	0.5750000
NODE_8747_length_904_cov_24.452174	507	587	3	13	80	0.1625000
NODE_8747_length_904_cov_24.452174	507	587	4	3	80	0.0375000
NODE_8747_length_904_cov_24.452174	507	587	5	16	80	0.2000000
NODE_8747_length_904_cov_24.452174	507	587	6	48	80	0.6000000
NODE_8747_length_904_cov_24.452174	560	640	2	16	80	0.2000000
NODE_8747_length_904_cov_24.452174	560	640	3	18	80	0.2250000
NODE_8747_length_904_cov_24.452174	560	640	4	35	80	0.4375000
NODE_8747_length_904_cov_24.452174	560	640	5	11	80	0.1375000
NODE_8748_length_904_cov_19.649689	307	387	3	48	80	0.6000000
NODE_8748_length_904_cov_19.649689	307	387	4	32	80	0.4000000
NODE_8748_length_904_cov_19.649689	360	440	1	35	80	0.4375000
NODE_8748_length_904_cov_19.649689	360	440	3	45	80	0.5625000
NODE_8748_length_904_cov_19.649689	595	675	1	13	80	0.1625000
NODE_8748_length_904_cov_19.649689	595	675	2	67	80	0.8375000
NODE_8748_length_904_cov_19.649689	648	728	1	44	80	0.5500000
NODE_8748_length_904_cov_19.649689	648	728	2	36	80	0.4500000
NODE_8750_length_904_cov_16.608696	252	332	0	80	80	1.0000000
NODE_8750_length_904_cov_16.608696	305	385	0	80	80	1.0000000
NODE_8750_length_904_cov_16.608696	381	461	0	80	80	1.0000000
NODE_8750_length_904_cov_16.608696	434	514	0	80	80	1.0000000
NODE_8751_length_904_cov_15.811180	431	511	0	5	80	0.0625000
NODE_8751_length_904_cov_15.811180	431	511	2	75	80	0.9375000
NODE_8751_length_904_cov_15.811180	484	564	2	80	80	1.0000000
NODE_8752_length_904_cov_9.249689	581	661	0	80	80	1.0000000
NODE_8752_length_904_cov_9.249689	634	714	0	80	80	1.0000000
NODE_8756_length_904_cov_4.772671	318	398	2	27	80	0.3375000
NODE_8756_length_904_cov_4.772671	318	398	4	53	80	0.6625000
NODE_8756_length_904_cov_4.772671	371	451	1	4	80	0.0500000
NODE_8756_length_904_cov_4.772671	371	451	3	2	80	0.0250000
NODE_8756_length_904_cov_4.772671	371	451	4	74	80	0.9250000
NODE_8773_length_903_cov_58.723881	386	466	6	4	80	0.0500000
NODE_8773_length_903_cov_58.723881	386	466	7	12	80	0.1500000
NODE_8773_length_903_cov_58.723881	386	466	8	16	80	0.2000000
NODE_8773_length_903_cov_58.723881	386	466	9	4	80	0.0500000
NODE_8773_length_903_cov_58.723881	386	466	11	2	80	0.0250000
NODE_8773_length_903_cov_58.723881	386	466	12	5	80	0.0625000
NODE_8773_length_903_cov_58.723881	386	466	13	17	80	0.2125000
NODE_8773_length_903_cov_58.723881	386	466	14	19	80	0.2375000
NODE_8773_length_903_cov_58.723881	386	466	15	1	80	0.0125000
NODE_8773_length_903_cov_58.723881	439	519	13	7	80	0.0875000
NODE_8773_length_903_cov_58.723881	439	519	14	28	80	0.3500000
NODE_8773_length_903_cov_58.723881	439	519	15	30	80	0.3750000
NODE_8773_length_903_cov_58.723881	439	519	16	12	80	0.1500000
NODE_8773_length_903_cov_58.723881	439	519	17	3	80	0.0375000
NODE_8773_length_903_cov_58.723881	515	595	5	16	80	0.2000000
NODE_8773_length_903_cov_58.723881	515	595	7	7	80	0.0875000
NODE_8773_length_903_cov_58.723881	515	595	8	5	80	0.0625000
NODE_8773_length_903_cov_58.723881	515	595	9	3	80	0.0375000
NODE_8773_length_903_cov_58.723881	515	595	11	1	80	0.0125000
NODE_8773_length_903_cov_58.723881	515	595	13	13	80	0.1625000
NODE_8773_length_903_cov_58.723881	515	595	14	24	80	0.3000000
NODE_8773_length_903_cov_58.723881	515	595	15	11	80	0.1375000
NODE_8773_length_903_cov_58.723881	568	648	0	3	80	0.0375000
NODE_8773_length_903_cov_58.723881	568	648	1	12	80	0.1500000
NODE_8773_length_903_cov_58.723881	568	648	2	7	80	0.0875000
NODE_8773_length_903_cov_58.723881	568	648	3	24	80	0.3000000
NODE_8773_length_903_cov_58.723881	568	648	4	6	80	0.0750000
NODE_8773_length_903_cov_58.723881	568	648	5	17	80	0.2125000
NODE_8773_length_903_cov_58.723881	568	648	7	7	80	0.0875000
NODE_8773_length_903_cov_58.723881	568	648	8	4	80	0.0500000
NODE_8774_length_903_cov_41.298507	397	477	4	6	80	0.0750000
NODE_8774_length_903_cov_41.298507	397	477	6	74	80	0.9250000
NODE_8774_length_903_cov_41.298507	450	530	1	1	80	0.0125000
NODE_8774_length_903_cov_41.298507	450	530	3	1	80	0.0125000
NODE_8774_length_903_cov_41.298507	450	530	4	20	80	0.2500000
NODE_8774_length_903_cov_41.298507	450	530	6	58	80	0.7250000
NODE_8775_length_903_cov_28.691542	394	474	3	52	80	0.6500000
NODE_8775_length_903_cov_28.691542	394	474	4	3	80	0.0375000
NODE_8775_length_903_cov_28.691542	394	474	5	13	80	0.1625000
NODE_8775_length_903_cov_28.691542	394	474	6	12	80	0.1500000
NODE_8775_length_903_cov_28.691542	447	527	4	2	80	0.0250000
NODE_8775_length_903_cov_28.691542	447	527	5	13	80	0.1625000
NODE_8775_length_903_cov_28.691542	447	527	6	17	80	0.2125000
NODE_8775_length_903_cov_28.691542	447	527	8	24	80	0.3000000
NODE_8775_length_903_cov_28.691542	447	527	9	7	80	0.0875000
NODE_8775_length_903_cov_28.691542	447	527	10	13	80	0.1625000
NODE_8775_length_903_cov_28.691542	447	527	11	4	80	0.0500000
NODE_8776_length_903_cov_26.276119	441	521	9	1	80	0.0125000
NODE_8776_length_903_cov_26.276119	441	521	10	11	80	0.1375000
NODE_8776_length_903_cov_26.276119	441	521	11	16	80	0.2000000
NODE_8776_length_903_cov_26.276119	441	521	12	4	80	0.0500000
NODE_8776_length_903_cov_26.276119	441	521	13	13	80	0.1625000
NODE_8776_length_903_cov_26.276119	441	521	14	1	80	0.0125000
NODE_8776_length_903_cov_26.276119	441	521	15	34	80	0.4250000
NODE_8776_length_903_cov_26.276119	494	574	7	4	80	0.0500000
NODE_8776_length_903_cov_26.276119	494	574	9	7	80	0.0875000
NODE_8776_length_903_cov_26.276119	494	574	10	21	80	0.2625000
NODE_8776_length_903_cov_26.276119	494	574	11	15	80	0.1875000
NODE_8776_length_903_cov_26.276119	494	574	12	10	80	0.1250000
NODE_8776_length_903_cov_26.276119	494	574	13	8	80	0.1000000
NODE_8776_length_903_cov_26.276119	494	574	15	15	80	0.1875000
NODE_8778_length_903_cov_18.166667	351	431	0	20	80	0.2500000
NODE_8778_length_903_cov_18.166667	351	431	2	60	80	0.7500000
NODE_8778_length_903_cov_18.166667	404	484	0	73	80	0.9125000
NODE_8778_length_903_cov_18.166667	404	484	2	7	80	0.0875000
NODE_8779_length_903_cov_15.460199	440	520	4	80	80	1.0000000
NODE_8779_length_903_cov_15.460199	493	573	0	21	80	0.2625000
NODE_8779_length_903_cov_15.460199	493	573	2	10	80	0.1250000
NODE_8779_length_903_cov_15.460199	493	573	3	6	80	0.0750000
NODE_8779_length_903_cov_15.460199	493	573	4	43	80	0.5375000
NODE_8780_length_903_cov_15.084577	352	432	5	1	80	0.0125000
NODE_8780_length_903_cov_15.084577	352	432	6	30	80	0.3750000
NODE_8780_length_903_cov_15.084577	352	432	7	4	80	0.0500000
NODE_8780_length_903_cov_15.084577	352	432	8	45	80	0.5625000
NODE_8780_length_903_cov_15.084577	405	485	5	11	80	0.1375000
NODE_8780_length_903_cov_15.084577	405	485	6	2	80	0.0250000
NODE_8780_length_903_cov_15.084577	405	485	7	14	80	0.1750000
NODE_8780_length_903_cov_15.084577	405	485	8	53	80	0.6625000
NODE_8781_length_903_cov_15.070896	367	447	2	47	80	0.5875000
NODE_8781_length_903_cov_15.070896	367	447	3	24	80	0.3000000
NODE_8781_length_903_cov_15.070896	367	447	4	9	80	0.1125000
NODE_8781_length_903_cov_15.070896	420	500	2	39	80	0.4875000
NODE_8781_length_903_cov_15.070896	420	500	3	12	80	0.1500000
NODE_8781_length_903_cov_15.070896	420	500	4	29	80	0.3625000
NODE_8782_length_903_cov_14.004975	318	399	2	81	81	1.0000000
NODE_8782_length_903_cov_14.004975	372	452	0	41	80	0.5125000
NODE_8782_length_903_cov_14.004975	372	452	2	39	80	0.4875000
NODE_8783_length_903_cov_10.546020	150	230	0	61	80	0.7625000
NODE_8783_length_903_cov_10.546020	150	230	2	19	80	0.2375000
NODE_8783_length_903_cov_10.546020	203	283	0	8	80	0.1000000
NODE_8783_length_903_cov_10.546020	203	283	2	72	80	0.9000000
NODE_8784_length_903_cov_9.288557	373	453	2	2	80	0.0250000
NODE_8784_length_903_cov_9.288557	373	453	3	4	80	0.0500000
NODE_8784_length_903_cov_9.288557	373	453	4	11	80	0.1375000
NODE_8784_length_903_cov_9.288557	373	453	5	61	80	0.7625000
NODE_8784_length_903_cov_9.288557	373	453	6	2	80	0.0250000
NODE_8784_length_903_cov_9.288557	426	506	1	12	80	0.1500000
NODE_8784_length_903_cov_9.288557	426	506	2	43	80	0.5375000
NODE_8784_length_903_cov_9.288557	426	506	3	4	80	0.0500000
NODE_8784_length_903_cov_9.288557	426	506	4	11	80	0.1375000
NODE_8784_length_903_cov_9.288557	426	506	5	8	80	0.1000000
NODE_8784_length_903_cov_9.288557	426	506	6	2	80	0.0250000
NODE_8785_length_903_cov_8.052239	439	519	0	80	80	1.0000000
NODE_8785_length_903_cov_8.052239	492	572	0	80	80	1.0000000
NODE_8798_length_902_cov_64.459527	355	435	16	3	80	0.0375000
NODE_8798_length_902_cov_64.459527	355	435	17	23	80	0.2875000
NODE_8798_length_902_cov_64.459527	355	435	18	8	80	0.1000000
NODE_8798_length_902_cov_64.459527	355	435	19	3	80	0.0375000
NODE_8798_length_902_cov_64.459527	355	435	20	1	80	0.0125000
NODE_8798_length_902_cov_64.459527	355	435	21	9	80	0.1125000
NODE_8798_length_902_cov_64.459527	355	435	23	7	80	0.0875000
NODE_8798_length_902_cov_64.459527	355	435	25	3	80	0.0375000
NODE_8798_length_902_cov_64.459527	355	435	26	1	80	0.0125000
NODE_8798_length_902_cov_64.459527	355	435	27	5	80	0.0625000
NODE_8798_length_902_cov_64.459527	355	435	28	7	80	0.0875000
NODE_8798_length_902_cov_64.459527	355	435	29	5	80	0.0625000
NODE_8798_length_902_cov_64.459527	355	435	30	5	80	0.0625000
NODE_8798_length_902_cov_64.459527	408	488	23	2	80	0.0250000
NODE_8798_length_902_cov_64.459527	408	488	24	13	80	0.1625000
NODE_8798_length_902_cov_64.459527	408	488	25	22	80	0.2750000
NODE_8798_length_902_cov_64.459527	408	488	26	5	80	0.0625000
NODE_8798_length_902_cov_64.459527	408	488	27	21	80	0.2625000
NODE_8798_length_902_cov_64.459527	408	488	28	7	80	0.0875000
NODE_8798_length_902_cov_64.459527	408	488	29	5	80	0.0625000
NODE_8798_length_902_cov_64.459527	408	488	30	5	80	0.0625000
NODE_8798_length_902_cov_64.459527	484	564	20	2	80	0.0250000
NODE_8798_length_902_cov_64.459527	484	564	21	2	80	0.0250000
NODE_8798_length_902_cov_64.459527	484	564	22	10	80	0.1250000
NODE_8798_length_902_cov_64.459527	484	564	23	11	80	0.1375000
NODE_8798_length_902_cov_64.459527	484	564	24	39	80	0.4875000
NODE_8798_length_902_cov_64.459527	484	564	25	6	80	0.0750000
NODE_8798_length_902_cov_64.459527	484	564	26	5	80	0.0625000
NODE_8798_length_902_cov_64.459527	484	564	27	5	80	0.0625000
NODE_8798_length_902_cov_64.459527	537	617	14	2	80	0.0250000
NODE_8798_length_902_cov_64.459527	537	617	16	17	80	0.2125000
NODE_8798_length_902_cov_64.459527	537	617	17	1	80	0.0125000
NODE_8798_length_902_cov_64.459527	537	617	18	9	80	0.1125000
NODE_8798_length_902_cov_64.459527	537	617	19	20	80	0.2500000
NODE_8798_length_902_cov_64.459527	537	617	20	4	80	0.0500000
NODE_8798_length_902_cov_64.459527	537	617	21	2	80	0.0250000
NODE_8798_length_902_cov_64.459527	537	617	22	9	80	0.1125000
NODE_8798_length_902_cov_64.459527	537	617	23	3	80	0.0375000
NODE_8798_length_902_cov_64.459527	537	617	24	11	80	0.1375000
NODE_8798_length_902_cov_64.459527	537	617	25	1	80	0.0125000
NODE_8798_length_902_cov_64.459527	537	617	26	1	80	0.0125000
NODE_8799_length_902_cov_60.823163	395	475	12	15	80	0.1875000
NODE_8799_length_902_cov_60.823163	395	475	13	5	80	0.0625000
NODE_8799_length_902_cov_60.823163	395	475	14	19	80	0.2375000
NODE_8799_length_902_cov_60.823163	395	475	15	37	80	0.4625000
NODE_8799_length_902_cov_60.823163	395	475	16	4	80	0.0500000
NODE_8799_length_902_cov_60.823163	448	528	5	4	80	0.0500000
NODE_8799_length_902_cov_60.823163	448	528	8	2	80	0.0250000
NODE_8799_length_902_cov_60.823163	448	528	10	12	80	0.1500000
NODE_8799_length_902_cov_60.823163	448	528	11	21	80	0.2625000
NODE_8799_length_902_cov_60.823163	448	528	12	12	80	0.1500000
NODE_8799_length_902_cov_60.823163	448	528	14	12	80	0.1500000
NODE_8799_length_902_cov_60.823163	448	528	15	17	80	0.2125000
NODE_8800_length_902_cov_44.002491	383	463	3	2	80	0.0250000
NODE_8800_length_902_cov_44.002491	383	463	4	5	80	0.0625000
NODE_8800_length_902_cov_44.002491	383	463	5	48	80	0.6000000
NODE_8800_length_902_cov_44.002491	383	463	6	25	80	0.3125000
NODE_8800_length_902_cov_44.002491	436	516	4	11	80	0.1375000
NODE_8800_length_902_cov_44.002491	436	516	5	41	80	0.5125000
NODE_8800_length_902_cov_44.002491	436	516	6	28	80	0.3500000
NODE_8801_length_902_cov_41.059776	378	458	7	14	80	0.1750000
NODE_8801_length_902_cov_41.059776	378	458	8	17	80	0.2125000
NODE_8801_length_902_cov_41.059776	378	458	9	12	80	0.1500000
NODE_8801_length_902_cov_41.059776	378	458	10	29	80	0.3625000
NODE_8801_length_902_cov_41.059776	378	458	11	8	80	0.1000000
NODE_8801_length_902_cov_41.059776	431	511	3	12	80	0.1500000
NODE_8801_length_902_cov_41.059776	431	511	5	2	80	0.0250000
NODE_8801_length_902_cov_41.059776	431	511	6	30	80	0.3750000
NODE_8801_length_902_cov_41.059776	431	511	7	19	80	0.2375000
NODE_8801_length_902_cov_41.059776	431	511	8	17	80	0.2125000
NODE_8802_length_902_cov_38.952677	372	452	5	18	80	0.2250000
NODE_8802_length_902_cov_38.952677	372	452	6	15	80	0.1875000
NODE_8802_length_902_cov_38.952677	372	452	8	27	80	0.3375000
NODE_8802_length_902_cov_38.952677	372	452	9	15	80	0.1875000
NODE_8802_length_902_cov_38.952677	372	452	10	5	80	0.0625000
NODE_8802_length_902_cov_38.952677	425	505	7	16	80	0.2000000
NODE_8802_length_902_cov_38.952677	425	505	8	11	80	0.1375000
NODE_8802_length_902_cov_38.952677	425	505	9	50	80	0.6250000
NODE_8802_length_902_cov_38.952677	425	505	10	3	80	0.0375000
NODE_8803_length_902_cov_34.156912	373	453	4	23	80	0.2875000
NODE_8803_length_902_cov_34.156912	373	453	5	6	80	0.0750000
NODE_8803_length_902_cov_34.156912	373	453	6	51	80	0.6375000
NODE_8803_length_902_cov_34.156912	426	506	5	6	80	0.0750000
NODE_8803_length_902_cov_34.156912	426	506	6	28	80	0.3500000
NODE_8803_length_902_cov_34.156912	426	506	7	1	80	0.0125000
NODE_8803_length_902_cov_34.156912	426	506	8	13	80	0.1625000
NODE_8803_length_902_cov_34.156912	426	506	10	32	80	0.4000000
NODE_8804_length_902_cov_23.007472	295	375	2	5	80	0.0625000
NODE_8804_length_902_cov_23.007472	295	375	3	71	80	0.8875000
NODE_8804_length_902_cov_23.007472	295	375	4	4	80	0.0500000
NODE_8804_length_902_cov_23.007472	348	428	3	23	80	0.2875000
NODE_8804_length_902_cov_23.007472	348	428	4	32	80	0.4000000
NODE_8804_length_902_cov_23.007472	348	428	5	25	80	0.3125000
NODE_8805_length_902_cov_19.491905	238	291	5	29	53	0.5471698
NODE_8805_length_902_cov_19.491905	238	291	6	6	53	0.1132075
NODE_8805_length_902_cov_19.491905	238	291	7	18	53	0.3396226
NODE_8805_length_902_cov_19.491905	264	344	5	29	80	0.3625000
NODE_8805_length_902_cov_19.491905	264	344	6	11	80	0.1375000
NODE_8805_length_902_cov_19.491905	264	344	7	40	80	0.5000000
NODE_8806_length_902_cov_10.794521	214	294	0	1	80	0.0125000
NODE_8806_length_902_cov_10.794521	214	294	1	19	80	0.2375000
NODE_8806_length_902_cov_10.794521	214	294	3	60	80	0.7500000
NODE_8806_length_902_cov_10.794521	267	347	3	56	80	0.7000000
NODE_8806_length_902_cov_10.794521	267	347	4	1	80	0.0125000
NODE_8806_length_902_cov_10.794521	267	347	5	23	80	0.2875000
NODE_8807_length_902_cov_9.520548	518	598	0	22	80	0.2750000
NODE_8807_length_902_cov_9.520548	518	598	1	58	80	0.7250000
NODE_8807_length_902_cov_9.520548	571	651	1	80	80	1.0000000
NODE_8808_length_902_cov_8.323786	337	417	1	80	80	1.0000000
NODE_8808_length_902_cov_8.323786	390	470	1	79	80	0.9875000
NODE_8808_length_902_cov_8.323786	390	470	2	1	80	0.0125000
NODE_8811_length_902_cov_7.300125	434	514	1	4	80	0.0500000
NODE_8811_length_902_cov_7.300125	434	514	2	76	80	0.9500000
NODE_8811_length_902_cov_7.300125	487	567	2	80	80	1.0000000
NODE_8812_length_902_cov_4.185554	505	585	2	68	80	0.8500000
NODE_8812_length_902_cov_4.185554	505	585	3	12	80	0.1500000
NODE_8812_length_902_cov_4.185554	558	588	2	30	30	1.0000000
NODE_8812_length_902_cov_4.185554	610	662	0	27	52	0.5192308
NODE_8812_length_902_cov_4.185554	610	662	1	25	52	0.4807692
NODE_8830_length_902_cov_0.963885	82	106	1	24	24	1.0000000
NODE_8832_length_901_cov_36.066085	412	490	5	41	78	0.5256410
NODE_8832_length_901_cov_36.066085	412	490	9	37	78	0.4743590
NODE_8832_length_901_cov_36.066085	463	543	5	39	80	0.4875000
NODE_8832_length_901_cov_36.066085	463	543	7	10	80	0.1250000
NODE_8832_length_901_cov_36.066085	463	543	9	31	80	0.3875000
NODE_8833_length_901_cov_28.129676	377	457	1	80	80	1.0000000
NODE_8833_length_901_cov_28.129676	430	510	0	53	80	0.6625000
NODE_8833_length_901_cov_28.129676	430	510	1	27	80	0.3375000
NODE_8834_length_901_cov_26.763092	272	352	0	10	80	0.1250000
NODE_8834_length_901_cov_26.763092	272	352	2	70	80	0.8750000
NODE_8834_length_901_cov_26.763092	325	405	2	80	80	1.0000000
NODE_8834_length_901_cov_26.763092	401	481	0	52	80	0.6500000
NODE_8834_length_901_cov_26.763092	401	481	2	28	80	0.3500000
NODE_8834_length_901_cov_26.763092	454	534	0	42	80	0.5250000
NODE_8834_length_901_cov_26.763092	454	534	1	5	80	0.0625000
NODE_8834_length_901_cov_26.763092	454	534	2	33	80	0.4125000
NODE_8835_length_901_cov_25.628429	369	449	6	13	80	0.1625000
NODE_8835_length_901_cov_25.628429	369	449	7	2	80	0.0250000
NODE_8835_length_901_cov_25.628429	369	449	8	7	80	0.0875000
NODE_8835_length_901_cov_25.628429	369	449	10	6	80	0.0750000
NODE_8835_length_901_cov_25.628429	369	449	12	4	80	0.0500000
NODE_8835_length_901_cov_25.628429	369	449	13	4	80	0.0500000
NODE_8835_length_901_cov_25.628429	369	449	14	6	80	0.0750000
NODE_8835_length_901_cov_25.628429	369	449	15	38	80	0.4750000
NODE_8835_length_901_cov_25.628429	422	502	10	8	80	0.1000000
NODE_8835_length_901_cov_25.628429	422	502	12	4	80	0.0500000
NODE_8835_length_901_cov_25.628429	422	502	13	6	80	0.0750000
NODE_8835_length_901_cov_25.628429	422	502	14	37	80	0.4625000
NODE_8835_length_901_cov_25.628429	422	502	15	25	80	0.3125000
NODE_8836_length_901_cov_17.857855	408	488	1	9	80	0.1125000
NODE_8836_length_901_cov_17.857855	408	488	2	64	80	0.8000000
NODE_8836_length_901_cov_17.857855	408	488	3	7	80	0.0875000
NODE_8836_length_901_cov_17.857855	461	541	2	21	80	0.2625000
NODE_8836_length_901_cov_17.857855	461	541	3	59	80	0.7375000
NODE_8837_length_901_cov_16.254364	362	442	5	9	80	0.1125000
NODE_8837_length_901_cov_16.254364	362	442	6	71	80	0.8875000
NODE_8837_length_901_cov_16.254364	415	495	1	10	80	0.1250000
NODE_8837_length_901_cov_16.254364	415	495	2	9	80	0.1125000
NODE_8837_length_901_cov_16.254364	415	495	3	5	80	0.0625000
NODE_8837_length_901_cov_16.254364	415	495	4	17	80	0.2125000
NODE_8837_length_901_cov_16.254364	415	495	5	21	80	0.2625000
NODE_8837_length_901_cov_16.254364	415	495	6	18	80	0.2250000
NODE_8838_length_901_cov_8.346633	321	401	0	80	80	1.0000000
NODE_8838_length_901_cov_8.346633	374	454	0	80	80	1.0000000
NODE_8840_length_901_cov_6.044888	363	443	4	33	80	0.4125000
NODE_8840_length_901_cov_6.044888	363	443	6	26	80	0.3250000
NODE_8840_length_901_cov_6.044888	363	443	7	14	80	0.1750000
NODE_8840_length_901_cov_6.044888	363	443	10	7	80	0.0875000
NODE_8840_length_901_cov_6.044888	416	496	6	8	80	0.1000000
NODE_8840_length_901_cov_6.044888	416	496	7	18	80	0.2250000
NODE_8840_length_901_cov_6.044888	416	496	8	27	80	0.3375000
NODE_8840_length_901_cov_6.044888	416	496	9	16	80	0.2000000
NODE_8840_length_901_cov_6.044888	416	496	10	11	80	0.1375000
NODE_8845_length_901_cov_3.814214	194	274	1	80	80	1.0000000
NODE_8845_length_901_cov_3.814214	247	326	1	79	79	1.0000000
NODE_8857_length_900_cov_30.284644	407	487	5	13	80	0.1625000
NODE_8857_length_900_cov_30.284644	407	487	6	32	80	0.4000000
NODE_8857_length_900_cov_30.284644	407	487	8	35	80	0.4375000
NODE_8857_length_900_cov_30.284644	460	540	0	35	80	0.4375000
NODE_8857_length_900_cov_30.284644	460	540	1	11	80	0.1375000
NODE_8857_length_900_cov_30.284644	460	540	4	2	80	0.0250000
NODE_8857_length_900_cov_30.284644	460	540	5	18	80	0.2250000
NODE_8857_length_900_cov_30.284644	460	540	6	14	80	0.1750000
NODE_8858_length_900_cov_29.679151	425	505	8	1	80	0.0125000
NODE_8858_length_900_cov_29.679151	425	505	9	11	80	0.1375000
NODE_8858_length_900_cov_29.679151	425	505	10	32	80	0.4000000
NODE_8858_length_900_cov_29.679151	425	505	11	36	80	0.4500000
NODE_8858_length_900_cov_29.679151	478	558	3	17	80	0.2125000
NODE_8858_length_900_cov_29.679151	478	558	4	5	80	0.0625000
NODE_8858_length_900_cov_29.679151	478	558	5	5	80	0.0625000
NODE_8858_length_900_cov_29.679151	478	558	6	1	80	0.0125000
NODE_8858_length_900_cov_29.679151	478	558	7	3	80	0.0375000
NODE_8858_length_900_cov_29.679151	478	558	8	6	80	0.0750000
NODE_8858_length_900_cov_29.679151	478	558	9	25	80	0.3125000
NODE_8858_length_900_cov_29.679151	478	558	10	18	80	0.2250000
NODE_8859_length_900_cov_25.963795	321	401	5	3	80	0.0375000
NODE_8859_length_900_cov_25.963795	321	401	6	9	80	0.1125000
NODE_8859_length_900_cov_25.963795	321	401	7	20	80	0.2500000
NODE_8859_length_900_cov_25.963795	321	401	8	2	80	0.0250000
NODE_8859_length_900_cov_25.963795	321	401	9	5	80	0.0625000
NODE_8859_length_900_cov_25.963795	321	401	10	13	80	0.1625000
NODE_8859_length_900_cov_25.963795	321	401	11	3	80	0.0375000
NODE_8859_length_900_cov_25.963795	321	401	12	19	80	0.2375000
NODE_8859_length_900_cov_25.963795	321	401	13	6	80	0.0750000
NODE_8859_length_900_cov_25.963795	374	454	9	6	80	0.0750000
NODE_8859_length_900_cov_25.963795	374	454	11	5	80	0.0625000
NODE_8859_length_900_cov_25.963795	374	454	12	36	80	0.4500000
NODE_8859_length_900_cov_25.963795	374	454	13	19	80	0.2375000
NODE_8859_length_900_cov_25.963795	374	454	14	14	80	0.1750000
NODE_8860_length_900_cov_17.681648	530	606	6	8	76	0.1052632
NODE_8860_length_900_cov_17.681648	530	606	7	4	76	0.0526316
NODE_8860_length_900_cov_17.681648	530	606	8	9	76	0.1184211
NODE_8860_length_900_cov_17.681648	530	606	9	6	76	0.0789474
NODE_8860_length_900_cov_17.681648	530	606	11	6	76	0.0789474
NODE_8860_length_900_cov_17.681648	530	606	12	43	76	0.5657895
NODE_8860_length_900_cov_17.681648	583	659	8	21	76	0.2763158
NODE_8860_length_900_cov_17.681648	583	659	10	18	76	0.2368421
NODE_8860_length_900_cov_17.681648	583	659	12	37	76	0.4868421
NODE_8861_length_900_cov_16.294632	316	396	4	6	80	0.0750000
NODE_8861_length_900_cov_16.294632	316	396	6	74	80	0.9250000
NODE_8861_length_900_cov_16.294632	369	449	0	5	80	0.0625000
NODE_8861_length_900_cov_16.294632	369	449	2	34	80	0.4250000
NODE_8861_length_900_cov_16.294632	369	449	6	41	80	0.5125000
NODE_8863_length_900_cov_5.962547	0	70	0	70	70	1.0000000
NODE_8863_length_900_cov_5.962547	43	108	0	65	65	1.0000000
NODE_8870_length_900_cov_2.521848	85	165	0	80	80	1.0000000
NODE_8870_length_900_cov_2.521848	138	218	0	51	80	0.6375000
NODE_8870_length_900_cov_2.521848	138	218	2	29	80	0.3625000
NODE_8879_length_899_cov_45.853750	380	460	3	7	80	0.0875000
NODE_8879_length_899_cov_45.853750	380	460	4	46	80	0.5750000
NODE_8879_length_899_cov_45.853750	380	460	5	5	80	0.0625000
NODE_8879_length_899_cov_45.853750	380	460	6	22	80	0.2750000
NODE_8879_length_899_cov_45.853750	433	516	3	53	83	0.6385542
NODE_8879_length_899_cov_45.853750	433	516	4	30	83	0.3614458
NODE_8880_length_899_cov_37.758750	381	461	4	46	80	0.5750000
NODE_8880_length_899_cov_37.758750	381	461	5	9	80	0.1125000
NODE_8880_length_899_cov_37.758750	381	461	6	25	80	0.3125000
NODE_8880_length_899_cov_37.758750	434	514	4	37	80	0.4625000
NODE_8880_length_899_cov_37.758750	434	514	5	25	80	0.3125000
NODE_8880_length_899_cov_37.758750	434	514	6	18	80	0.2250000
NODE_8881_length_899_cov_27.362500	413	493	3	53	80	0.6625000
NODE_8881_length_899_cov_27.362500	413	493	5	17	80	0.2125000
NODE_8881_length_899_cov_27.362500	413	493	6	10	80	0.1250000
NODE_8881_length_899_cov_27.362500	466	546	4	6	80	0.0750000
NODE_8881_length_899_cov_27.362500	466	546	5	64	80	0.8000000
NODE_8881_length_899_cov_27.362500	466	546	6	10	80	0.1250000
NODE_8882_length_899_cov_20.563750	379	459	4	26	80	0.3250000
NODE_8882_length_899_cov_20.563750	379	459	5	7	80	0.0875000
NODE_8882_length_899_cov_20.563750	379	459	6	47	80	0.5875000
NODE_8882_length_899_cov_20.563750	432	507	3	15	75	0.2000000
NODE_8882_length_899_cov_20.563750	432	507	4	31	75	0.4133333
NODE_8882_length_899_cov_20.563750	432	507	5	17	75	0.2266667
NODE_8882_length_899_cov_20.563750	432	507	6	12	75	0.1600000
NODE_8884_length_899_cov_17.130000	319	399	0	41	80	0.5125000
NODE_8884_length_899_cov_17.130000	319	399	2	12	80	0.1500000
NODE_8884_length_899_cov_17.130000	319	399	3	27	80	0.3375000
NODE_8884_length_899_cov_17.130000	372	452	3	80	80	1.0000000
NODE_8885_length_899_cov_16.317500	270	350	3	3	80	0.0375000
NODE_8885_length_899_cov_16.317500	270	350	4	37	80	0.4625000
NODE_8885_length_899_cov_16.317500	270	350	6	38	80	0.4750000
NODE_8885_length_899_cov_16.317500	270	350	8	2	80	0.0250000
NODE_8885_length_899_cov_16.317500	323	403	6	25	80	0.3125000
NODE_8885_length_899_cov_16.317500	323	403	7	6	80	0.0750000
NODE_8885_length_899_cov_16.317500	323	403	8	22	80	0.2750000
NODE_8885_length_899_cov_16.317500	323	403	9	7	80	0.0875000
NODE_8885_length_899_cov_16.317500	323	403	10	20	80	0.2500000
NODE_8886_length_899_cov_16.190000	284	364	3	28	80	0.3500000
NODE_8886_length_899_cov_16.190000	284	364	4	44	80	0.5500000
NODE_8886_length_899_cov_16.190000	284	364	5	3	80	0.0375000
NODE_8886_length_899_cov_16.190000	284	364	6	5	80	0.0625000
NODE_8886_length_899_cov_16.190000	337	417	4	19	80	0.2375000
NODE_8886_length_899_cov_16.190000	337	417	5	20	80	0.2500000
NODE_8886_length_899_cov_16.190000	337	417	6	41	80	0.5125000
NODE_8887_length_899_cov_13.873750	317	397	9	39	80	0.4875000
NODE_8887_length_899_cov_13.873750	317	397	10	41	80	0.5125000
NODE_8887_length_899_cov_13.873750	370	450	7	11	80	0.1375000
NODE_8887_length_899_cov_13.873750	370	450	8	5	80	0.0625000
NODE_8887_length_899_cov_13.873750	370	450	9	17	80	0.2125000
NODE_8887_length_899_cov_13.873750	370	450	10	47	80	0.5875000
NODE_8888_length_899_cov_12.957500	240	320	2	8	80	0.1000000
NODE_8888_length_899_cov_12.957500	240	320	3	10	80	0.1250000
NODE_8888_length_899_cov_12.957500	240	320	4	62	80	0.7750000
NODE_8888_length_899_cov_12.957500	293	373	0	10	80	0.1250000
NODE_8888_length_899_cov_12.957500	293	373	2	6	80	0.0750000
NODE_8888_length_899_cov_12.957500	293	373	4	64	80	0.8000000
NODE_8889_length_899_cov_12.516250	387	467	2	59	80	0.7375000
NODE_8889_length_899_cov_12.516250	387	467	3	18	80	0.2250000
NODE_8889_length_899_cov_12.516250	387	467	4	3	80	0.0375000
NODE_8889_length_899_cov_12.516250	440	520	2	24	80	0.3000000
NODE_8889_length_899_cov_12.516250	440	520	4	30	80	0.3750000
NODE_8889_length_899_cov_12.516250	440	520	5	26	80	0.3250000
NODE_8890_length_899_cov_10.846250	348	428	2	16	80	0.2000000
NODE_8890_length_899_cov_10.846250	348	428	3	5	80	0.0625000
NODE_8890_length_899_cov_10.846250	348	428	5	24	80	0.3000000
NODE_8890_length_899_cov_10.846250	348	428	7	35	80	0.4375000
NODE_8890_length_899_cov_10.846250	401	485	1	2	84	0.0238095
NODE_8890_length_899_cov_10.846250	401	485	2	1	84	0.0119048
NODE_8890_length_899_cov_10.846250	401	485	4	13	84	0.1547619
NODE_8890_length_899_cov_10.846250	401	485	6	25	84	0.2976190
NODE_8890_length_899_cov_10.846250	401	485	7	43	84	0.5119048
NODE_8891_length_899_cov_9.185000	347	427	2	49	80	0.6125000
NODE_8891_length_899_cov_9.185000	347	427	3	16	80	0.2000000
NODE_8891_length_899_cov_9.185000	347	427	4	4	80	0.0500000
NODE_8891_length_899_cov_9.185000	347	427	5	11	80	0.1375000
NODE_8891_length_899_cov_9.185000	400	480	3	12	80	0.1500000
NODE_8891_length_899_cov_9.185000	400	480	4	4	80	0.0500000
NODE_8891_length_899_cov_9.185000	400	480	5	17	80	0.2125000
NODE_8891_length_899_cov_9.185000	400	480	6	38	80	0.4750000
NODE_8891_length_899_cov_9.185000	400	480	7	9	80	0.1125000
NODE_8892_length_899_cov_8.655000	498	578	3	7	80	0.0875000
NODE_8892_length_899_cov_8.655000	498	578	4	16	80	0.2000000
NODE_8892_length_899_cov_8.655000	498	578	5	9	80	0.1125000
NODE_8892_length_899_cov_8.655000	498	578	6	44	80	0.5500000
NODE_8892_length_899_cov_8.655000	498	578	7	4	80	0.0500000
NODE_8892_length_899_cov_8.655000	551	631	3	60	80	0.7500000
NODE_8892_length_899_cov_8.655000	551	631	4	16	80	0.2000000
NODE_8892_length_899_cov_8.655000	551	631	6	4	80	0.0500000
NODE_8893_length_899_cov_3.551250	0	54	0	54	54	1.0000000
NODE_8893_length_899_cov_3.551250	27	107	0	80	80	1.0000000
NODE_8893_length_899_cov_3.551250	103	183	0	80	80	1.0000000
NODE_8893_length_899_cov_3.551250	156	179	0	23	23	1.0000000
NODE_8914_length_898_cov_52.405507	299	379	9	20	80	0.2500000
NODE_8914_length_898_cov_52.405507	299	379	10	29	80	0.3625000
NODE_8914_length_898_cov_52.405507	299	379	11	31	80	0.3875000
NODE_8914_length_898_cov_52.405507	352	432	7	4	80	0.0500000
NODE_8914_length_898_cov_52.405507	352	432	8	10	80	0.1250000
NODE_8914_length_898_cov_52.405507	352	432	9	22	80	0.2750000
NODE_8914_length_898_cov_52.405507	352	432	10	32	80	0.4000000
NODE_8914_length_898_cov_52.405507	352	432	11	12	80	0.1500000
NODE_8914_length_898_cov_52.405507	428	508	4	11	80	0.1375000
NODE_8914_length_898_cov_52.405507	428	508	5	32	80	0.4000000
NODE_8914_length_898_cov_52.405507	428	508	6	16	80	0.2000000
NODE_8914_length_898_cov_52.405507	428	508	7	18	80	0.2250000
NODE_8914_length_898_cov_52.405507	428	508	8	3	80	0.0375000
NODE_8914_length_898_cov_52.405507	481	561	4	21	80	0.2625000
NODE_8914_length_898_cov_52.405507	481	561	5	41	80	0.5125000
NODE_8914_length_898_cov_52.405507	481	561	6	16	80	0.2000000
NODE_8914_length_898_cov_52.405507	481	561	7	2	80	0.0250000
NODE_8915_length_898_cov_44.973717	363	443	8	13	80	0.1625000
NODE_8915_length_898_cov_44.973717	363	443	9	2	80	0.0250000
NODE_8915_length_898_cov_44.973717	363	443	10	33	80	0.4125000
NODE_8915_length_898_cov_44.973717	363	443	11	11	80	0.1375000
NODE_8915_length_898_cov_44.973717	363	443	12	21	80	0.2625000
NODE_8915_length_898_cov_44.973717	416	496	5	12	80	0.1500000
NODE_8915_length_898_cov_44.973717	416	496	6	10	80	0.1250000
NODE_8915_length_898_cov_44.973717	416	496	7	5	80	0.0625000
NODE_8915_length_898_cov_44.973717	416	496	10	20	80	0.2500000
NODE_8915_length_898_cov_44.973717	416	496	11	29	80	0.3625000
NODE_8915_length_898_cov_44.973717	416	496	12	4	80	0.0500000
NODE_8916_length_898_cov_38.269086	425	505	0	80	80	1.0000000
NODE_8916_length_898_cov_38.269086	478	558	0	80	80	1.0000000
NODE_8917_length_898_cov_27.006258	465	545	2	13	80	0.1625000
NODE_8917_length_898_cov_27.006258	465	545	3	4	80	0.0500000
NODE_8917_length_898_cov_27.006258	465	545	4	3	80	0.0375000
NODE_8917_length_898_cov_27.006258	465	545	5	2	80	0.0250000
NODE_8917_length_898_cov_27.006258	465	545	8	6	80	0.0750000
NODE_8917_length_898_cov_27.006258	465	545	9	7	80	0.0875000
NODE_8917_length_898_cov_27.006258	465	545	11	22	80	0.2750000
NODE_8917_length_898_cov_27.006258	465	545	12	10	80	0.1250000
NODE_8917_length_898_cov_27.006258	465	545	13	9	80	0.1125000
NODE_8917_length_898_cov_27.006258	465	545	14	4	80	0.0500000
NODE_8917_length_898_cov_27.006258	518	598	11	4	80	0.0500000
NODE_8917_length_898_cov_27.006258	518	598	12	10	80	0.1250000
NODE_8917_length_898_cov_27.006258	518	598	13	9	80	0.1125000
NODE_8917_length_898_cov_27.006258	518	598	14	7	80	0.0875000
NODE_8917_length_898_cov_27.006258	518	598	16	37	80	0.4625000
NODE_8917_length_898_cov_27.006258	518	598	17	2	80	0.0250000
NODE_8917_length_898_cov_27.006258	518	598	18	11	80	0.1375000
NODE_8918_length_898_cov_25.902378	185	265	0	11	80	0.1375000
NODE_8918_length_898_cov_25.902378	185	265	1	69	80	0.8625000
NODE_8918_length_898_cov_25.902378	238	318	1	73	80	0.9125000
NODE_8918_length_898_cov_25.902378	238	318	2	7	80	0.0875000
NODE_8918_length_898_cov_25.902378	314	394	2	75	80	0.9375000
NODE_8918_length_898_cov_25.902378	314	394	3	5	80	0.0625000
NODE_8918_length_898_cov_25.902378	367	447	2	80	80	1.0000000
NODE_8919_length_898_cov_25.209011	368	448	5	14	80	0.1750000
NODE_8919_length_898_cov_25.209011	368	448	7	9	80	0.1125000
NODE_8919_length_898_cov_25.209011	368	448	8	4	80	0.0500000
NODE_8919_length_898_cov_25.209011	368	448	10	1	80	0.0125000
NODE_8919_length_898_cov_25.209011	368	448	12	17	80	0.2125000
NODE_8919_length_898_cov_25.209011	368	448	13	2	80	0.0250000
NODE_8919_length_898_cov_25.209011	368	448	14	18	80	0.2250000
NODE_8919_length_898_cov_25.209011	368	448	15	15	80	0.1875000
NODE_8919_length_898_cov_25.209011	421	501	9	3	80	0.0375000
NODE_8919_length_898_cov_25.209011	421	501	10	1	80	0.0125000
NODE_8919_length_898_cov_25.209011	421	501	11	13	80	0.1625000
NODE_8919_length_898_cov_25.209011	421	501	13	38	80	0.4750000
NODE_8919_length_898_cov_25.209011	421	501	14	10	80	0.1250000
NODE_8919_length_898_cov_25.209011	421	501	15	15	80	0.1875000
NODE_8920_length_898_cov_21.923655	325	405	2	10	80	0.1250000
NODE_8920_length_898_cov_21.923655	325	405	3	46	80	0.5750000
NODE_8920_length_898_cov_21.923655	325	405	4	24	80	0.3000000
NODE_8920_length_898_cov_21.923655	378	458	3	32	80	0.4000000
NODE_8920_length_898_cov_21.923655	378	458	4	48	80	0.6000000
NODE_8921_length_898_cov_21.065081	306	386	2	5	80	0.0625000
NODE_8921_length_898_cov_21.065081	306	386	3	1	80	0.0125000
NODE_8921_length_898_cov_21.065081	306	386	5	35	80	0.4375000
NODE_8921_length_898_cov_21.065081	306	386	6	39	80	0.4875000
NODE_8921_length_898_cov_21.065081	359	439	5	11	80	0.1375000
NODE_8921_length_898_cov_21.065081	359	439	6	24	80	0.3000000
NODE_8921_length_898_cov_21.065081	359	439	7	45	80	0.5625000
NODE_8922_length_898_cov_20.954944	374	454	0	8	80	0.1000000
NODE_8922_length_898_cov_20.954944	374	454	1	6	80	0.0750000
NODE_8922_length_898_cov_20.954944	374	454	3	17	80	0.2125000
NODE_8922_length_898_cov_20.954944	374	454	5	48	80	0.6000000
NODE_8922_length_898_cov_20.954944	374	454	6	1	80	0.0125000
NODE_8922_length_898_cov_20.954944	427	507	5	26	80	0.3250000
NODE_8922_length_898_cov_20.954944	427	507	6	54	80	0.6750000
NODE_8923_length_898_cov_17.387985	398	478	0	80	80	1.0000000
NODE_8923_length_898_cov_17.387985	451	531	0	80	80	1.0000000
NODE_8924_length_898_cov_17.252816	265	345	5	24	80	0.3000000
NODE_8924_length_898_cov_17.252816	265	345	6	1	80	0.0125000
NODE_8924_length_898_cov_17.252816	265	345	7	37	80	0.4625000
NODE_8924_length_898_cov_17.252816	265	345	8	1	80	0.0125000
NODE_8924_length_898_cov_17.252816	265	345	9	17	80	0.2125000
NODE_8924_length_898_cov_17.252816	318	398	4	35	80	0.4375000
NODE_8924_length_898_cov_17.252816	318	398	6	11	80	0.1375000
NODE_8924_length_898_cov_17.252816	318	398	7	22	80	0.2750000
NODE_8924_length_898_cov_17.252816	318	398	9	12	80	0.1500000
NODE_8926_length_898_cov_13.152691	455	535	2	25	80	0.3125000
NODE_8926_length_898_cov_13.152691	455	535	3	4	80	0.0500000
NODE_8926_length_898_cov_13.152691	455	535	4	14	80	0.1750000
NODE_8926_length_898_cov_13.152691	455	535	6	31	80	0.3875000
NODE_8926_length_898_cov_13.152691	455	535	7	6	80	0.0750000
NODE_8926_length_898_cov_13.152691	508	588	6	61	80	0.7625000
NODE_8926_length_898_cov_13.152691	508	588	7	19	80	0.2375000
NODE_8927_length_898_cov_12.612015	375	455	7	14	80	0.1750000
NODE_8927_length_898_cov_12.612015	375	455	8	3	80	0.0375000
NODE_8927_length_898_cov_12.612015	375	455	9	8	80	0.1000000
NODE_8927_length_898_cov_12.612015	375	455	11	24	80	0.3000000
NODE_8927_length_898_cov_12.612015	375	455	12	31	80	0.3875000
NODE_8927_length_898_cov_12.612015	428	508	5	13	80	0.1625000
NODE_8927_length_898_cov_12.612015	428	508	6	6	80	0.0750000
NODE_8927_length_898_cov_12.612015	428	508	7	1	80	0.0125000
NODE_8927_length_898_cov_12.612015	428	508	8	3	80	0.0375000
NODE_8927_length_898_cov_12.612015	428	508	9	12	80	0.1500000
NODE_8927_length_898_cov_12.612015	428	508	11	22	80	0.2750000
NODE_8927_length_898_cov_12.612015	428	508	12	23	80	0.2875000
NODE_8928_length_898_cov_12.498123	428	508	5	78	80	0.9750000
NODE_8928_length_898_cov_12.498123	428	508	7	2	80	0.0250000
NODE_8928_length_898_cov_12.498123	481	561	1	15	80	0.1875000
NODE_8928_length_898_cov_12.498123	481	561	2	1	80	0.0125000
NODE_8928_length_898_cov_12.498123	481	561	5	64	80	0.8000000
NODE_8932_length_898_cov_1.790989	0	56	0	56	56	1.0000000
NODE_8932_length_898_cov_1.790989	29	93	0	62	64	0.9687500
NODE_8932_length_898_cov_1.790989	29	93	2	2	64	0.0312500
NODE_8944_length_897_cov_63.921053	350	430	5	3	80	0.0375000
NODE_8944_length_897_cov_63.921053	350	430	6	4	80	0.0500000
NODE_8944_length_897_cov_63.921053	350	430	8	64	80	0.8000000
NODE_8944_length_897_cov_63.921053	350	430	10	9	80	0.1125000
NODE_8944_length_897_cov_63.921053	403	483	5	13	80	0.1625000
NODE_8944_length_897_cov_63.921053	403	483	6	4	80	0.0500000
NODE_8944_length_897_cov_63.921053	403	483	7	15	80	0.1875000
NODE_8944_length_897_cov_63.921053	403	483	8	39	80	0.4875000
NODE_8944_length_897_cov_63.921053	403	483	10	9	80	0.1125000
NODE_8945_length_897_cov_58.921053	316	396	9	1	80	0.0125000
NODE_8945_length_897_cov_58.921053	316	396	10	2	80	0.0250000
NODE_8945_length_897_cov_58.921053	316	396	12	2	80	0.0250000
NODE_8945_length_897_cov_58.921053	316	396	14	8	80	0.1000000
NODE_8945_length_897_cov_58.921053	316	396	15	25	80	0.3125000
NODE_8945_length_897_cov_58.921053	316	396	16	7	80	0.0875000
NODE_8945_length_897_cov_58.921053	316	396	18	8	80	0.1000000
NODE_8945_length_897_cov_58.921053	316	396	20	6	80	0.0750000
NODE_8945_length_897_cov_58.921053	316	396	21	9	80	0.1125000
NODE_8945_length_897_cov_58.921053	316	396	22	12	80	0.1500000
NODE_8945_length_897_cov_58.921053	369	449	15	12	80	0.1500000
NODE_8945_length_897_cov_58.921053	369	449	16	5	80	0.0625000
NODE_8945_length_897_cov_58.921053	369	449	17	4	80	0.0500000
NODE_8945_length_897_cov_58.921053	369	449	19	13	80	0.1625000
NODE_8945_length_897_cov_58.921053	369	449	20	6	80	0.0750000
NODE_8945_length_897_cov_58.921053	369	449	21	14	80	0.1750000
NODE_8945_length_897_cov_58.921053	369	449	22	26	80	0.3250000
NODE_8946_length_897_cov_35.946115	324	404	4	80	80	1.0000000
NODE_8946_length_897_cov_35.946115	377	457	1	10	80	0.1250000
NODE_8946_length_897_cov_35.946115	377	457	2	21	80	0.2625000
NODE_8946_length_897_cov_35.946115	377	457	4	49	80	0.6125000
NODE_8947_length_897_cov_25.548872	238	318	10	25	80	0.3125000
NODE_8947_length_897_cov_25.548872	238	318	11	18	80	0.2250000
NODE_8947_length_897_cov_25.548872	238	318	12	5	80	0.0625000
NODE_8947_length_897_cov_25.548872	238	318	13	1	80	0.0125000
NODE_8947_length_897_cov_25.548872	238	318	14	31	80	0.3875000
NODE_8947_length_897_cov_25.548872	291	371	5	15	80	0.1875000
NODE_8947_length_897_cov_25.548872	291	371	6	15	80	0.1875000
NODE_8947_length_897_cov_25.548872	291	371	7	4	80	0.0500000
NODE_8947_length_897_cov_25.548872	291	371	8	6	80	0.0750000
NODE_8947_length_897_cov_25.548872	291	371	10	6	80	0.0750000
NODE_8947_length_897_cov_25.548872	291	371	11	24	80	0.3000000
NODE_8947_length_897_cov_25.548872	291	371	12	3	80	0.0375000
NODE_8947_length_897_cov_25.548872	291	371	13	1	80	0.0125000
NODE_8947_length_897_cov_25.548872	291	371	14	6	80	0.0750000
NODE_8948_length_897_cov_24.913534	399	479	0	63	80	0.7875000
NODE_8948_length_897_cov_24.913534	399	479	2	17	80	0.2125000
NODE_8948_length_897_cov_24.913534	452	532	0	10	80	0.1250000
NODE_8948_length_897_cov_24.913534	452	532	2	70	80	0.8750000
NODE_8949_length_897_cov_21.839599	308	388	7	27	80	0.3375000
NODE_8949_length_897_cov_21.839599	308	388	8	5	80	0.0625000
NODE_8949_length_897_cov_21.839599	308	388	9	10	80	0.1250000
NODE_8949_length_897_cov_21.839599	308	388	10	23	80	0.2875000
NODE_8949_length_897_cov_21.839599	308	388	11	12	80	0.1500000
NODE_8949_length_897_cov_21.839599	308	388	12	3	80	0.0375000
NODE_8949_length_897_cov_21.839599	361	441	3	4	80	0.0500000
NODE_8949_length_897_cov_21.839599	361	441	5	22	80	0.2750000
NODE_8949_length_897_cov_21.839599	361	441	6	3	80	0.0375000
NODE_8949_length_897_cov_21.839599	361	441	8	3	80	0.0375000
NODE_8949_length_897_cov_21.839599	361	441	9	31	80	0.3875000
NODE_8949_length_897_cov_21.839599	361	441	10	4	80	0.0500000
NODE_8949_length_897_cov_21.839599	361	441	11	12	80	0.1500000
NODE_8949_length_897_cov_21.839599	361	441	12	1	80	0.0125000
NODE_8950_length_897_cov_19.355890	489	569	4	31	80	0.3875000
NODE_8950_length_897_cov_19.355890	489	569	5	49	80	0.6125000
NODE_8950_length_897_cov_19.355890	542	622	0	5	80	0.0625000
NODE_8950_length_897_cov_19.355890	542	622	1	8	80	0.1000000
NODE_8950_length_897_cov_19.355890	542	622	2	10	80	0.1250000
NODE_8950_length_897_cov_19.355890	542	622	3	30	80	0.3750000
NODE_8950_length_897_cov_19.355890	542	622	4	27	80	0.3375000
NODE_8951_length_897_cov_16.295739	209	289	14	68	80	0.8500000
NODE_8951_length_897_cov_16.295739	209	289	15	7	80	0.0875000
NODE_8951_length_897_cov_16.295739	209	289	16	5	80	0.0625000
NODE_8951_length_897_cov_16.295739	262	342	6	2	80	0.0250000
NODE_8951_length_897_cov_16.295739	262	342	8	2	80	0.0250000
NODE_8951_length_897_cov_16.295739	262	342	9	1	80	0.0125000
NODE_8951_length_897_cov_16.295739	262	342	10	9	80	0.1125000
NODE_8951_length_897_cov_16.295739	262	342	11	1	80	0.0125000
NODE_8951_length_897_cov_16.295739	262	342	13	2	80	0.0250000
NODE_8951_length_897_cov_16.295739	262	342	14	42	80	0.5250000
NODE_8951_length_897_cov_16.295739	262	342	15	16	80	0.2000000
NODE_8951_length_897_cov_16.295739	262	342	16	5	80	0.0625000
NODE_8952_length_897_cov_14.766917	395	475	2	27	80	0.3375000
NODE_8952_length_897_cov_14.766917	395	475	3	1	80	0.0125000
NODE_8952_length_897_cov_14.766917	395	475	5	8	80	0.1000000
NODE_8952_length_897_cov_14.766917	395	475	6	39	80	0.4875000
NODE_8952_length_897_cov_14.766917	395	475	7	1	80	0.0125000
NODE_8952_length_897_cov_14.766917	395	475	8	4	80	0.0500000
NODE_8952_length_897_cov_14.766917	448	528	6	57	80	0.7125000
NODE_8952_length_897_cov_14.766917	448	528	7	19	80	0.2375000
NODE_8952_length_897_cov_14.766917	448	528	8	4	80	0.0500000
NODE_8953_length_897_cov_14.219298	253	333	0	18	80	0.2250000
NODE_8953_length_897_cov_14.219298	253	333	1	62	80	0.7750000
NODE_8953_length_897_cov_14.219298	306	386	1	28	80	0.3500000
NODE_8953_length_897_cov_14.219298	306	386	2	18	80	0.2250000
NODE_8953_length_897_cov_14.219298	306	386	3	20	80	0.2500000
NODE_8953_length_897_cov_14.219298	306	386	5	14	80	0.1750000
NODE_8954_length_897_cov_11.116541	182	262	0	62	80	0.7750000
NODE_8954_length_897_cov_11.116541	182	262	2	5	80	0.0625000
NODE_8954_length_897_cov_11.116541	182	262	4	13	80	0.1625000
NODE_8954_length_897_cov_11.116541	235	315	0	9	80	0.1125000
NODE_8954_length_897_cov_11.116541	235	315	2	5	80	0.0625000
NODE_8954_length_897_cov_11.116541	235	315	4	17	80	0.2125000
NODE_8954_length_897_cov_11.116541	235	315	6	49	80	0.6125000
NODE_8955_length_897_cov_8.211779	303	383	0	18	80	0.2250000
NODE_8955_length_897_cov_8.211779	303	383	2	62	80	0.7750000
NODE_8955_length_897_cov_8.211779	356	436	0	1	80	0.0125000
NODE_8955_length_897_cov_8.211779	356	436	2	79	80	0.9875000
NODE_8973_length_896_cov_48.249686	397	477	3	29	80	0.3625000
NODE_8973_length_896_cov_48.249686	397	477	4	29	80	0.3625000
NODE_8973_length_896_cov_48.249686	397	477	5	22	80	0.2750000
NODE_8973_length_896_cov_48.249686	450	530	3	22	80	0.2750000
NODE_8973_length_896_cov_48.249686	450	530	4	57	80	0.7125000
NODE_8973_length_896_cov_48.249686	450	530	5	1	80	0.0125000
NODE_8974_length_896_cov_24.824341	213	293	1	24	80	0.3000000
NODE_8974_length_896_cov_24.824341	213	293	2	51	80	0.6375000
NODE_8974_length_896_cov_24.824341	213	293	4	5	80	0.0625000
NODE_8974_length_896_cov_24.824341	266	346	2	22	80	0.2750000
NODE_8974_length_896_cov_24.824341	266	346	4	58	80	0.7250000
NODE_8975_length_896_cov_23.130489	333	413	4	4	80	0.0500000
NODE_8975_length_896_cov_23.130489	333	413	5	29	80	0.3625000
NODE_8975_length_896_cov_23.130489	333	413	6	47	80	0.5875000
NODE_8975_length_896_cov_23.130489	386	466	3	12	80	0.1500000
NODE_8975_length_896_cov_23.130489	386	466	4	25	80	0.3125000
NODE_8975_length_896_cov_23.130489	386	466	5	23	80	0.2875000
NODE_8975_length_896_cov_23.130489	386	466	6	20	80	0.2500000
NODE_8975_length_896_cov_23.130489	462	542	6	14	80	0.1750000
NODE_8975_length_896_cov_23.130489	462	542	7	44	80	0.5500000
NODE_8975_length_896_cov_23.130489	462	542	8	22	80	0.2750000
NODE_8975_length_896_cov_23.130489	515	595	5	18	80	0.2250000
NODE_8975_length_896_cov_23.130489	515	595	6	29	80	0.3625000
NODE_8975_length_896_cov_23.130489	515	595	7	33	80	0.4125000
NODE_8976_length_896_cov_20.673777	361	441	3	42	80	0.5250000
NODE_8976_length_896_cov_20.673777	361	441	5	38	80	0.4750000
NODE_8976_length_896_cov_20.673777	414	497	3	7	83	0.0843373
NODE_8976_length_896_cov_20.673777	414	497	4	33	83	0.3975904
NODE_8976_length_896_cov_20.673777	414	497	5	43	83	0.5180723
NODE_8977_length_896_cov_18.979925	418	498	3	41	80	0.5125000
NODE_8977_length_896_cov_18.979925	418	498	4	1	80	0.0125000
NODE_8977_length_896_cov_18.979925	418	498	5	38	80	0.4750000
NODE_8977_length_896_cov_18.979925	471	551	3	11	80	0.1375000
NODE_8977_length_896_cov_18.979925	471	551	4	1	80	0.0125000
NODE_8977_length_896_cov_18.979925	471	551	5	57	80	0.7125000
NODE_8977_length_896_cov_18.979925	471	551	6	11	80	0.1375000
NODE_8978_length_896_cov_15.875784	340	420	1	32	80	0.4000000
NODE_8978_length_896_cov_15.875784	340	420	3	32	80	0.4000000
NODE_8978_length_896_cov_15.875784	340	420	4	16	80	0.2000000
NODE_8978_length_896_cov_15.875784	393	473	3	28	80	0.3500000
NODE_8978_length_896_cov_15.875784	393	473	4	52	80	0.6500000
NODE_8980_length_896_cov_10.646173	337	417	3	9	80	0.1125000
NODE_8980_length_896_cov_10.646173	337	417	4	38	80	0.4750000
NODE_8980_length_896_cov_10.646173	337	417	5	12	80	0.1500000
NODE_8980_length_896_cov_10.646173	337	417	6	21	80	0.2625000
NODE_8980_length_896_cov_10.646173	390	470	1	11	80	0.1375000
NODE_8980_length_896_cov_10.646173	390	470	2	9	80	0.1125000
NODE_8980_length_896_cov_10.646173	390	470	3	42	80	0.5250000
NODE_8980_length_896_cov_10.646173	390	470	4	18	80	0.2250000
NODE_8981_length_896_cov_10.351317	327	407	0	40	80	0.5000000
NODE_8981_length_896_cov_10.351317	327	407	1	20	80	0.2500000
NODE_8981_length_896_cov_10.351317	327	407	2	20	80	0.2500000
NODE_8981_length_896_cov_10.351317	380	460	1	7	80	0.0875000
NODE_8981_length_896_cov_10.351317	380	460	2	73	80	0.9125000
NODE_8982_length_896_cov_9.754078	411	491	0	80	80	1.0000000
NODE_8982_length_896_cov_9.754078	464	544	0	80	80	1.0000000
NODE_8983_length_896_cov_8.069009	340	422	2	82	82	1.0000000
NODE_8983_length_896_cov_8.069009	395	475	1	41	80	0.5125000
NODE_8983_length_896_cov_8.069009	395	475	2	39	80	0.4875000
NODE_8986_length_896_cov_4.939774	384	464	3	3	80	0.0375000
NODE_8986_length_896_cov_4.939774	384	464	4	76	80	0.9500000
NODE_8986_length_896_cov_4.939774	384	464	5	1	80	0.0125000
NODE_8986_length_896_cov_4.939774	437	517	2	11	80	0.1375000
NODE_8986_length_896_cov_4.939774	437	517	4	68	80	0.8500000
NODE_8986_length_896_cov_4.939774	437	517	5	1	80	0.0125000
NODE_9005_length_895_cov_54.949749	378	458	11	4	80	0.0500000
NODE_9005_length_895_cov_54.949749	378	458	12	26	80	0.3250000
NODE_9005_length_895_cov_54.949749	378	458	14	6	80	0.0750000
NODE_9005_length_895_cov_54.949749	378	458	15	23	80	0.2875000
NODE_9005_length_895_cov_54.949749	378	458	16	1	80	0.0125000
NODE_9005_length_895_cov_54.949749	378	458	17	20	80	0.2500000
NODE_9005_length_895_cov_54.949749	431	511	10	6	80	0.0750000
NODE_9005_length_895_cov_54.949749	431	511	11	15	80	0.1875000
NODE_9005_length_895_cov_54.949749	431	511	12	11	80	0.1375000
NODE_9005_length_895_cov_54.949749	431	511	14	6	80	0.0750000
NODE_9005_length_895_cov_54.949749	431	511	15	24	80	0.3000000
NODE_9005_length_895_cov_54.949749	431	511	16	13	80	0.1625000
NODE_9005_length_895_cov_54.949749	431	511	17	5	80	0.0625000
NODE_9006_length_895_cov_53.945980	306	386	20	5	80	0.0625000
NODE_9006_length_895_cov_53.945980	306	386	22	8	80	0.1000000
NODE_9006_length_895_cov_53.945980	306	386	24	7	80	0.0875000
NODE_9006_length_895_cov_53.945980	306	386	25	1	80	0.0125000
NODE_9006_length_895_cov_53.945980	306	386	26	6	80	0.0750000
NODE_9006_length_895_cov_53.945980	306	386	27	5	80	0.0625000
NODE_9006_length_895_cov_53.945980	306	386	28	19	80	0.2375000
NODE_9006_length_895_cov_53.945980	306	386	29	29	80	0.3625000
NODE_9006_length_895_cov_53.945980	359	439	16	4	80	0.0500000
NODE_9006_length_895_cov_53.945980	359	439	17	2	80	0.0250000
NODE_9006_length_895_cov_53.945980	359	439	20	7	80	0.0875000
NODE_9006_length_895_cov_53.945980	359	439	21	3	80	0.0375000
NODE_9006_length_895_cov_53.945980	359	439	24	7	80	0.0875000
NODE_9006_length_895_cov_53.945980	359	439	25	7	80	0.0875000
NODE_9006_length_895_cov_53.945980	359	439	27	17	80	0.2125000
NODE_9006_length_895_cov_53.945980	359	439	28	9	80	0.1125000
NODE_9006_length_895_cov_53.945980	359	439	29	24	80	0.3000000
NODE_9007_length_895_cov_48.915829	369	449	10	1	80	0.0125000
NODE_9007_length_895_cov_48.915829	369	449	11	2	80	0.0250000
NODE_9007_length_895_cov_48.915829	369	449	13	3	80	0.0375000
NODE_9007_length_895_cov_48.915829	369	449	15	7	80	0.0875000
NODE_9007_length_895_cov_48.915829	369	449	16	23	80	0.2875000
NODE_9007_length_895_cov_48.915829	369	449	17	15	80	0.1875000
NODE_9007_length_895_cov_48.915829	369	449	18	2	80	0.0250000
NODE_9007_length_895_cov_48.915829	369	449	19	25	80	0.3125000
NODE_9007_length_895_cov_48.915829	369	449	20	2	80	0.0250000
NODE_9007_length_895_cov_48.915829	422	502	11	8	80	0.1000000
NODE_9007_length_895_cov_48.915829	422	502	13	14	80	0.1750000
NODE_9007_length_895_cov_48.915829	422	502	14	6	80	0.0750000
NODE_9007_length_895_cov_48.915829	422	502	15	2	80	0.0250000
NODE_9007_length_895_cov_48.915829	422	502	16	33	80	0.4125000
NODE_9007_length_895_cov_48.915829	422	502	17	4	80	0.0500000
NODE_9007_length_895_cov_48.915829	422	502	18	2	80	0.0250000
NODE_9007_length_895_cov_48.915829	422	502	19	9	80	0.1125000
NODE_9007_length_895_cov_48.915829	422	502	20	2	80	0.0250000
NODE_9007_length_895_cov_48.915829	498	578	2	21	80	0.2625000
NODE_9007_length_895_cov_48.915829	498	578	3	2	80	0.0250000
NODE_9007_length_895_cov_48.915829	498	578	4	23	80	0.2875000
NODE_9007_length_895_cov_48.915829	498	578	5	7	80	0.0875000
NODE_9007_length_895_cov_48.915829	498	578	7	6	80	0.0750000
NODE_9007_length_895_cov_48.915829	498	578	8	8	80	0.1000000
NODE_9007_length_895_cov_48.915829	498	578	9	6	80	0.0750000
NODE_9007_length_895_cov_48.915829	498	578	11	7	80	0.0875000
NODE_9007_length_895_cov_48.915829	551	631	2	19	80	0.2375000
NODE_9007_length_895_cov_48.915829	551	631	3	53	80	0.6625000
NODE_9007_length_895_cov_48.915829	551	631	4	8	80	0.1000000
NODE_9008_length_895_cov_38.347990	452	532	3	22	80	0.2750000
NODE_9008_length_895_cov_38.347990	452	532	4	20	80	0.2500000
NODE_9008_length_895_cov_38.347990	452	532	5	38	80	0.4750000
NODE_9008_length_895_cov_38.347990	505	585	3	9	80	0.1125000
NODE_9008_length_895_cov_38.347990	505	585	4	59	80	0.7375000
NODE_9008_length_895_cov_38.347990	505	585	5	2	80	0.0250000
NODE_9008_length_895_cov_38.347990	505	585	6	10	80	0.1250000
NODE_9009_length_895_cov_33.716080	418	499	0	1	81	0.0123457
NODE_9009_length_895_cov_33.716080	418	499	1	56	81	0.6913580
NODE_9009_length_895_cov_33.716080	418	499	2	24	81	0.2962963
NODE_9009_length_895_cov_33.716080	472	552	1	80	80	1.0000000
NODE_9010_length_895_cov_21.630653	392	468	0	76	76	1.0000000
NODE_9010_length_895_cov_21.630653	441	521	0	80	80	1.0000000
NODE_9011_length_895_cov_19.932161	331	411	0	16	80	0.2000000
NODE_9011_length_895_cov_19.932161	331	411	1	29	80	0.3625000
NODE_9011_length_895_cov_19.932161	331	411	2	35	80	0.4375000
NODE_9011_length_895_cov_19.932161	384	464	1	31	80	0.3875000
NODE_9011_length_895_cov_19.932161	384	464	2	1	80	0.0125000
NODE_9011_length_895_cov_19.932161	384	464	3	10	80	0.1250000
NODE_9011_length_895_cov_19.932161	384	464	5	38	80	0.4750000
NODE_9011_length_895_cov_19.932161	460	540	3	7	80	0.0875000
NODE_9011_length_895_cov_19.932161	460	540	4	46	80	0.5750000
NODE_9011_length_895_cov_19.932161	460	540	5	25	80	0.3125000
NODE_9011_length_895_cov_19.932161	460	540	6	2	80	0.0250000
NODE_9011_length_895_cov_19.932161	513	593	3	8	80	0.1000000
NODE_9011_length_895_cov_19.932161	513	593	4	51	80	0.6375000
NODE_9011_length_895_cov_19.932161	513	593	5	19	80	0.2375000
NODE_9011_length_895_cov_19.932161	513	593	6	2	80	0.0250000
NODE_9012_length_895_cov_16.037688	403	479	3	6	76	0.0789474
NODE_9012_length_895_cov_16.037688	403	479	5	18	76	0.2368421
NODE_9012_length_895_cov_16.037688	403	479	6	20	76	0.2631579
NODE_9012_length_895_cov_16.037688	403	479	7	32	76	0.4210526
NODE_9012_length_895_cov_16.037688	452	532	3	22	80	0.2750000
NODE_9012_length_895_cov_16.037688	452	532	4	37	80	0.4625000
NODE_9012_length_895_cov_16.037688	452	532	5	2	80	0.0250000
NODE_9012_length_895_cov_16.037688	452	532	7	19	80	0.2375000
NODE_9013_length_895_cov_13.003769	372	452	6	15	80	0.1875000
NODE_9013_length_895_cov_13.003769	372	452	7	25	80	0.3125000
NODE_9013_length_895_cov_13.003769	372	452	8	40	80	0.5000000
NODE_9013_length_895_cov_13.003769	425	491	6	22	66	0.3333333
NODE_9013_length_895_cov_13.003769	425	491	7	33	66	0.5000000
NODE_9013_length_895_cov_13.003769	425	491	8	11	66	0.1666667
NODE_9014_length_895_cov_12.736181	280	360	0	80	80	1.0000000
NODE_9014_length_895_cov_12.736181	333	413	0	80	80	1.0000000
NODE_9015_length_895_cov_11.090452	505	585	10	25	80	0.3125000
NODE_9015_length_895_cov_11.090452	505	585	11	12	80	0.1500000
NODE_9015_length_895_cov_11.090452	505	585	12	43	80	0.5375000
NODE_9015_length_895_cov_11.090452	558	638	6	12	80	0.1500000
NODE_9015_length_895_cov_11.090452	558	638	8	14	80	0.1750000
NODE_9015_length_895_cov_11.090452	558	638	10	15	80	0.1875000
NODE_9015_length_895_cov_11.090452	558	638	11	17	80	0.2125000
NODE_9015_length_895_cov_11.090452	558	638	12	22	80	0.2750000
NODE_9016_length_895_cov_9.266332	468	548	4	65	80	0.8125000
NODE_9016_length_895_cov_9.266332	468	548	5	15	80	0.1875000
NODE_9016_length_895_cov_9.266332	521	601	1	16	80	0.2000000
NODE_9016_length_895_cov_9.266332	521	601	2	7	80	0.0875000
NODE_9016_length_895_cov_9.266332	521	601	3	14	80	0.1750000
NODE_9016_length_895_cov_9.266332	521	601	4	12	80	0.1500000
NODE_9016_length_895_cov_9.266332	521	601	5	31	80	0.3875000
NODE_9018_length_895_cov_5.659548	472	552	2	25	80	0.3125000
NODE_9018_length_895_cov_5.659548	472	552	3	55	80	0.6875000
NODE_9018_length_895_cov_5.659548	525	605	1	12	80	0.1500000
NODE_9018_length_895_cov_5.659548	525	605	2	29	80	0.3625000
NODE_9018_length_895_cov_5.659548	525	605	3	39	80	0.4875000
NODE_9019_length_895_cov_5.383166	42	123	0	15	81	0.1851852
NODE_9019_length_895_cov_5.383166	42	123	1	27	81	0.3333333
NODE_9019_length_895_cov_5.383166	42	123	3	39	81	0.4814815
NODE_9030_length_894_cov_60.153459	446	526	6	2	80	0.0250000
NODE_9030_length_894_cov_60.153459	446	526	7	17	80	0.2125000
NODE_9030_length_894_cov_60.153459	446	526	8	61	80	0.7625000
NODE_9030_length_894_cov_60.153459	499	579	0	17	80	0.2125000
NODE_9030_length_894_cov_60.153459	499	579	1	4	80	0.0500000
NODE_9030_length_894_cov_60.153459	499	579	3	3	80	0.0375000
NODE_9030_length_894_cov_60.153459	499	579	5	17	80	0.2125000
NODE_9030_length_894_cov_60.153459	499	579	7	29	80	0.3625000
NODE_9030_length_894_cov_60.153459	499	579	8	10	80	0.1250000
NODE_9031_length_894_cov_49.618868	373	453	7	11	80	0.1375000
NODE_9031_length_894_cov_49.618868	373	453	9	2	80	0.0250000
NODE_9031_length_894_cov_49.618868	373	453	10	12	80	0.1500000
NODE_9031_length_894_cov_49.618868	373	453	12	18	80	0.2250000
NODE_9031_length_894_cov_49.618868	373	453	14	2	80	0.0250000
NODE_9031_length_894_cov_49.618868	373	453	15	4	80	0.0500000
NODE_9031_length_894_cov_49.618868	373	453	17	31	80	0.3875000
NODE_9031_length_894_cov_49.618868	426	506	11	14	80	0.1750000
NODE_9031_length_894_cov_49.618868	426	506	12	1	80	0.0125000
NODE_9031_length_894_cov_49.618868	426	506	13	11	80	0.1375000
NODE_9031_length_894_cov_49.618868	426	506	14	2	80	0.0250000
NODE_9031_length_894_cov_49.618868	426	506	15	29	80	0.3625000
NODE_9031_length_894_cov_49.618868	426	506	17	23	80	0.2875000
NODE_9032_length_894_cov_33.228931	459	539	14	4	80	0.0500000
NODE_9032_length_894_cov_33.228931	459	539	15	9	80	0.1125000
NODE_9032_length_894_cov_33.228931	459	539	16	3	80	0.0375000
NODE_9032_length_894_cov_33.228931	459	539	18	24	80	0.3000000
NODE_9032_length_894_cov_33.228931	459	539	19	2	80	0.0250000
NODE_9032_length_894_cov_33.228931	459	539	20	38	80	0.4750000
NODE_9032_length_894_cov_33.228931	512	592	5	8	80	0.1000000
NODE_9032_length_894_cov_33.228931	512	592	7	8	80	0.1000000
NODE_9032_length_894_cov_33.228931	512	592	9	4	80	0.0500000
NODE_9032_length_894_cov_33.228931	512	592	10	13	80	0.1625000
NODE_9032_length_894_cov_33.228931	512	592	12	2	80	0.0250000
NODE_9032_length_894_cov_33.228931	512	592	13	7	80	0.0875000
NODE_9032_length_894_cov_33.228931	512	592	15	8	80	0.1000000
NODE_9032_length_894_cov_33.228931	512	592	16	2	80	0.0250000
NODE_9032_length_894_cov_33.228931	512	592	18	25	80	0.3125000
NODE_9032_length_894_cov_33.228931	512	592	20	3	80	0.0375000
NODE_9033_length_894_cov_31.933333	411	491	4	16	80	0.2000000
NODE_9033_length_894_cov_31.933333	411	491	5	64	80	0.8000000
NODE_9033_length_894_cov_31.933333	464	544	2	18	80	0.2250000
NODE_9033_length_894_cov_31.933333	464	544	3	10	80	0.1250000
NODE_9033_length_894_cov_31.933333	464	544	4	6	80	0.0750000
NODE_9033_length_894_cov_31.933333	464	544	5	46	80	0.5750000
NODE_9034_length_894_cov_30.499371	270	350	5	6	80	0.0750000
NODE_9034_length_894_cov_30.499371	270	350	6	15	80	0.1875000
NODE_9034_length_894_cov_30.499371	270	350	7	32	80	0.4000000
NODE_9034_length_894_cov_30.499371	270	350	8	1	80	0.0125000
NODE_9034_length_894_cov_30.499371	270	350	9	14	80	0.1750000
NODE_9034_length_894_cov_30.499371	270	350	10	12	80	0.1500000
NODE_9034_length_894_cov_30.499371	323	403	7	6	80	0.0750000
NODE_9034_length_894_cov_30.499371	323	403	8	1	80	0.0125000
NODE_9034_length_894_cov_30.499371	323	403	9	41	80	0.5125000
NODE_9034_length_894_cov_30.499371	323	403	10	32	80	0.4000000
NODE_9034_length_894_cov_30.499371	399	479	4	5	80	0.0625000
NODE_9034_length_894_cov_30.499371	399	479	5	3	80	0.0375000
NODE_9034_length_894_cov_30.499371	399	479	6	52	80	0.6500000
NODE_9034_length_894_cov_30.499371	399	479	7	19	80	0.2375000
NODE_9034_length_894_cov_30.499371	399	479	8	1	80	0.0125000
NODE_9034_length_894_cov_30.499371	452	532	3	1	80	0.0125000
NODE_9034_length_894_cov_30.499371	452	532	4	14	80	0.1750000
NODE_9034_length_894_cov_30.499371	452	532	5	44	80	0.5500000
NODE_9034_length_894_cov_30.499371	452	532	6	21	80	0.2625000
NODE_9035_length_894_cov_23.046541	79	159	0	80	80	1.0000000
NODE_9035_length_894_cov_23.046541	132	212	0	80	80	1.0000000
NODE_9036_length_894_cov_22.266667	381	461	0	2	80	0.0250000
NODE_9036_length_894_cov_22.266667	381	461	2	78	80	0.9750000
NODE_9036_length_894_cov_22.266667	434	514	0	26	80	0.3250000
NODE_9036_length_894_cov_22.266667	434	514	2	54	80	0.6750000
NODE_9037_length_894_cov_21.997484	332	412	2	6	80	0.0750000
NODE_9037_length_894_cov_21.997484	332	412	3	13	80	0.1625000
NODE_9037_length_894_cov_21.997484	332	412	4	7	80	0.0875000
NODE_9037_length_894_cov_21.997484	332	412	5	54	80	0.6750000
NODE_9037_length_894_cov_21.997484	385	465	4	38	80	0.4750000
NODE_9037_length_894_cov_21.997484	385	465	5	42	80	0.5250000
NODE_9038_length_894_cov_21.205031	319	399	9	4	80	0.0500000
NODE_9038_length_894_cov_21.205031	319	399	10	28	80	0.3500000
NODE_9038_length_894_cov_21.205031	319	399	11	22	80	0.2750000
NODE_9038_length_894_cov_21.205031	319	399	12	13	80	0.1625000
NODE_9038_length_894_cov_21.205031	319	399	13	13	80	0.1625000
NODE_9038_length_894_cov_21.205031	372	452	5	41	80	0.5125000
NODE_9038_length_894_cov_21.205031	372	452	6	2	80	0.0250000
NODE_9038_length_894_cov_21.205031	372	452	7	3	80	0.0375000
NODE_9038_length_894_cov_21.205031	372	452	9	11	80	0.1375000
NODE_9038_length_894_cov_21.205031	372	452	10	14	80	0.1750000
NODE_9038_length_894_cov_21.205031	372	452	11	6	80	0.0750000
NODE_9038_length_894_cov_21.205031	372	452	12	3	80	0.0375000
NODE_9038_length_894_cov_21.205031	448	528	1	53	80	0.6625000
NODE_9038_length_894_cov_21.205031	448	528	2	15	80	0.1875000
NODE_9038_length_894_cov_21.205031	448	528	3	3	80	0.0375000
NODE_9038_length_894_cov_21.205031	448	528	5	9	80	0.1125000
NODE_9038_length_894_cov_21.205031	501	581	1	80	80	1.0000000
NODE_9039_length_894_cov_21.132075	422	502	0	18	80	0.2250000
NODE_9039_length_894_cov_21.132075	422	502	2	22	80	0.2750000
NODE_9039_length_894_cov_21.132075	422	502	4	10	80	0.1250000
NODE_9039_length_894_cov_21.132075	422	502	5	1	80	0.0125000
NODE_9039_length_894_cov_21.132075	422	502	6	1	80	0.0125000
NODE_9039_length_894_cov_21.132075	422	502	7	7	80	0.0875000
NODE_9039_length_894_cov_21.132075	422	502	8	19	80	0.2375000
NODE_9039_length_894_cov_21.132075	422	502	9	2	80	0.0250000
NODE_9039_length_894_cov_21.132075	475	555	7	13	80	0.1625000
NODE_9039_length_894_cov_21.132075	475	555	8	30	80	0.3750000
NODE_9039_length_894_cov_21.132075	475	555	9	37	80	0.4625000
NODE_9040_length_894_cov_15.598742	338	418	0	80	80	1.0000000
NODE_9040_length_894_cov_15.598742	391	471	0	80	80	1.0000000
NODE_9041_length_894_cov_14.079245	344	424	0	22	80	0.2750000
NODE_9041_length_894_cov_14.079245	344	424	1	40	80	0.5000000
NODE_9041_length_894_cov_14.079245	344	424	2	18	80	0.2250000
NODE_9041_length_894_cov_14.079245	397	477	1	9	80	0.1125000
NODE_9041_length_894_cov_14.079245	397	477	2	71	80	0.8875000
NODE_9042_length_894_cov_13.031447	336	416	2	30	80	0.3750000
NODE_9042_length_894_cov_13.031447	336	416	4	50	80	0.6250000
NODE_9042_length_894_cov_13.031447	389	469	1	5	80	0.0625000
NODE_9042_length_894_cov_13.031447	389	469	3	35	80	0.4375000
NODE_9042_length_894_cov_13.031447	389	469	4	40	80	0.5000000
NODE_9043_length_894_cov_13.031447	353	433	4	8	80	0.1000000
NODE_9043_length_894_cov_13.031447	353	433	6	8	80	0.1000000
NODE_9043_length_894_cov_13.031447	353	433	7	4	80	0.0500000
NODE_9043_length_894_cov_13.031447	353	433	8	21	80	0.2625000
NODE_9043_length_894_cov_13.031447	353	433	9	13	80	0.1625000
NODE_9043_length_894_cov_13.031447	353	433	10	14	80	0.1750000
NODE_9043_length_894_cov_13.031447	353	433	11	12	80	0.1500000
NODE_9043_length_894_cov_13.031447	406	486	7	2	80	0.0250000
NODE_9043_length_894_cov_13.031447	406	486	8	2	80	0.0250000
NODE_9043_length_894_cov_13.031447	406	486	9	38	80	0.4750000
NODE_9043_length_894_cov_13.031447	406	486	11	38	80	0.4750000
NODE_9044_length_894_cov_9.706918	330	410	9	48	80	0.6000000
NODE_9044_length_894_cov_9.706918	330	410	10	3	80	0.0375000
NODE_9044_length_894_cov_9.706918	330	410	11	29	80	0.3625000
NODE_9045_length_894_cov_6.963522	378	458	0	16	80	0.2000000
NODE_9045_length_894_cov_6.963522	378	458	2	64	80	0.8000000
NODE_9045_length_894_cov_6.963522	431	511	0	69	80	0.8625000
NODE_9045_length_894_cov_6.963522	431	511	2	11	80	0.1375000
NODE_9046_length_894_cov_4.993711	365	445	2	14	80	0.1750000
NODE_9046_length_894_cov_4.993711	365	445	3	1	80	0.0125000
NODE_9046_length_894_cov_4.993711	365	445	4	27	80	0.3375000
NODE_9046_length_894_cov_4.993711	365	445	5	38	80	0.4750000
NODE_9046_length_894_cov_4.993711	418	498	2	67	80	0.8375000
NODE_9046_length_894_cov_4.993711	418	498	3	1	80	0.0125000
NODE_9046_length_894_cov_4.993711	418	498	4	12	80	0.1500000
NODE_9066_length_893_cov_59.134761	261	341	21	9	80	0.1125000
NODE_9066_length_893_cov_59.134761	261	341	22	3	80	0.0375000
NODE_9066_length_893_cov_59.134761	261	341	24	9	80	0.1125000
NODE_9066_length_893_cov_59.134761	261	341	26	8	80	0.1000000
NODE_9066_length_893_cov_59.134761	261	341	27	36	80	0.4500000
NODE_9066_length_893_cov_59.134761	261	341	28	8	80	0.1000000
NODE_9066_length_893_cov_59.134761	261	341	30	7	80	0.0875000
NODE_9066_length_893_cov_59.134761	314	394	13	9	80	0.1125000
NODE_9066_length_893_cov_59.134761	314	394	15	3	80	0.0375000
NODE_9066_length_893_cov_59.134761	314	394	16	5	80	0.0625000
NODE_9066_length_893_cov_59.134761	314	394	17	7	80	0.0875000
NODE_9066_length_893_cov_59.134761	314	394	18	1	80	0.0125000
NODE_9066_length_893_cov_59.134761	314	394	20	12	80	0.1500000
NODE_9066_length_893_cov_59.134761	314	394	21	6	80	0.0750000
NODE_9066_length_893_cov_59.134761	314	394	22	1	80	0.0125000
NODE_9066_length_893_cov_59.134761	314	394	23	1	80	0.0125000
NODE_9066_length_893_cov_59.134761	314	394	26	16	80	0.2000000
NODE_9066_length_893_cov_59.134761	314	394	27	5	80	0.0625000
NODE_9066_length_893_cov_59.134761	314	394	28	7	80	0.0875000
NODE_9066_length_893_cov_59.134761	314	394	30	7	80	0.0875000
NODE_9067_length_893_cov_58.991184	388	468	2	21	80	0.2625000
NODE_9067_length_893_cov_58.991184	388	468	4	32	80	0.4000000
NODE_9067_length_893_cov_58.991184	388	468	5	27	80	0.3375000
NODE_9067_length_893_cov_58.991184	441	521	4	20	80	0.2500000
NODE_9067_length_893_cov_58.991184	441	521	5	52	80	0.6500000
NODE_9067_length_893_cov_58.991184	441	521	6	8	80	0.1000000
NODE_9067_length_893_cov_58.991184	517	597	5	2	80	0.0250000
NODE_9067_length_893_cov_58.991184	517	597	6	2	80	0.0250000
NODE_9067_length_893_cov_58.991184	517	597	7	28	80	0.3500000
NODE_9067_length_893_cov_58.991184	517	597	8	6	80	0.0750000
NODE_9067_length_893_cov_58.991184	517	597	9	29	80	0.3625000
NODE_9067_length_893_cov_58.991184	517	597	10	11	80	0.1375000
NODE_9067_length_893_cov_58.991184	517	597	11	2	80	0.0250000
NODE_9067_length_893_cov_58.991184	570	650	6	31	80	0.3875000
NODE_9067_length_893_cov_58.991184	570	650	8	6	80	0.0750000
NODE_9067_length_893_cov_58.991184	570	650	9	11	80	0.1375000
NODE_9067_length_893_cov_58.991184	570	650	10	32	80	0.4000000
NODE_9068_length_893_cov_55.644836	434	514	2	37	80	0.4625000
NODE_9068_length_893_cov_55.644836	434	514	3	18	80	0.2250000
NODE_9068_length_893_cov_55.644836	434	514	4	25	80	0.3125000
NODE_9068_length_893_cov_55.644836	487	567	3	14	80	0.1750000
NODE_9068_length_893_cov_55.644836	487	567	4	66	80	0.8250000
NODE_9068_length_893_cov_55.644836	563	643	4	29	80	0.3625000
NODE_9068_length_893_cov_55.644836	563	643	6	51	80	0.6375000
NODE_9068_length_893_cov_55.644836	616	696	5	40	80	0.5000000
NODE_9068_length_893_cov_55.644836	616	696	6	40	80	0.5000000
NODE_9069_length_893_cov_54.803526	479	559	4	31	80	0.3875000
NODE_9069_length_893_cov_54.803526	479	559	5	42	80	0.5250000
NODE_9069_length_893_cov_54.803526	479	559	6	7	80	0.0875000
NODE_9069_length_893_cov_54.803526	532	612	4	62	80	0.7750000
NODE_9069_length_893_cov_54.803526	532	612	5	4	80	0.0500000
NODE_9069_length_893_cov_54.803526	532	612	6	14	80	0.1750000
NODE_9070_length_893_cov_38.147355	391	471	0	17	80	0.2125000
NODE_9070_length_893_cov_38.147355	391	471	1	63	80	0.7875000
NODE_9070_length_893_cov_38.147355	444	524	1	80	80	1.0000000
NODE_9071_length_893_cov_33.690176	387	467	4	2	80	0.0250000
NODE_9071_length_893_cov_33.690176	387	467	5	6	80	0.0750000
NODE_9071_length_893_cov_33.690176	387	467	7	9	80	0.1125000
NODE_9071_length_893_cov_33.690176	387	467	8	9	80	0.1125000
NODE_9071_length_893_cov_33.690176	387	467	9	23	80	0.2875000
NODE_9071_length_893_cov_33.690176	387	467	10	8	80	0.1000000
NODE_9071_length_893_cov_33.690176	387	467	11	23	80	0.2875000
NODE_9071_length_893_cov_33.690176	440	520	8	26	80	0.3250000
NODE_9071_length_893_cov_33.690176	440	520	9	28	80	0.3500000
NODE_9071_length_893_cov_33.690176	440	520	10	3	80	0.0375000
NODE_9071_length_893_cov_33.690176	440	520	11	23	80	0.2875000
NODE_9072_length_893_cov_32.162469	524	604	6	4	80	0.0500000
NODE_9072_length_893_cov_32.162469	524	604	7	3	80	0.0375000
NODE_9072_length_893_cov_32.162469	524	604	8	11	80	0.1375000
NODE_9072_length_893_cov_32.162469	524	604	9	19	80	0.2375000
NODE_9072_length_893_cov_32.162469	524	604	10	27	80	0.3375000
NODE_9072_length_893_cov_32.162469	524	604	11	16	80	0.2000000
NODE_9072_length_893_cov_32.162469	577	657	9	2	80	0.0250000
NODE_9072_length_893_cov_32.162469	577	657	10	41	80	0.5125000
NODE_9072_length_893_cov_32.162469	577	657	11	17	80	0.2125000
NODE_9072_length_893_cov_32.162469	577	657	12	20	80	0.2500000
NODE_9073_length_893_cov_31.916877	344	424	2	7	80	0.0875000
NODE_9073_length_893_cov_31.916877	344	424	4	1	80	0.0125000
NODE_9073_length_893_cov_31.916877	344	424	6	5	80	0.0625000
NODE_9073_length_893_cov_31.916877	344	424	10	13	80	0.1625000
NODE_9073_length_893_cov_31.916877	344	424	14	54	80	0.6750000
NODE_9073_length_893_cov_31.916877	397	477	7	3	80	0.0375000
NODE_9073_length_893_cov_31.916877	397	477	8	11	80	0.1375000
NODE_9073_length_893_cov_31.916877	397	477	13	13	80	0.1625000
NODE_9073_length_893_cov_31.916877	397	477	14	37	80	0.4625000
NODE_9073_length_893_cov_31.916877	397	477	15	16	80	0.2000000
NODE_9074_length_893_cov_28.693955	437	517	3	8	80	0.1000000
NODE_9074_length_893_cov_28.693955	437	517	4	1	80	0.0125000
NODE_9074_length_893_cov_28.693955	437	517	5	1	80	0.0125000
NODE_9074_length_893_cov_28.693955	437	517	6	32	80	0.4000000
NODE_9074_length_893_cov_28.693955	437	517	7	38	80	0.4750000
NODE_9074_length_893_cov_28.693955	490	570	1	16	80	0.2000000
NODE_9074_length_893_cov_28.693955	490	570	2	5	80	0.0625000
NODE_9074_length_893_cov_28.693955	490	570	3	40	80	0.5000000
NODE_9074_length_893_cov_28.693955	490	570	4	1	80	0.0125000
NODE_9074_length_893_cov_28.693955	490	570	5	1	80	0.0125000
NODE_9074_length_893_cov_28.693955	490	570	6	12	80	0.1500000
NODE_9074_length_893_cov_28.693955	490	570	7	5	80	0.0625000
NODE_9075_length_893_cov_23.564232	363	443	5	5	80	0.0625000
NODE_9075_length_893_cov_23.564232	363	443	6	41	80	0.5125000
NODE_9075_length_893_cov_23.564232	363	443	7	34	80	0.4250000
NODE_9075_length_893_cov_23.564232	416	496	2	2	80	0.0250000
NODE_9075_length_893_cov_23.564232	416	496	3	23	80	0.2875000
NODE_9075_length_893_cov_23.564232	416	496	4	25	80	0.3125000
NODE_9075_length_893_cov_23.564232	416	496	6	30	80	0.3750000
NODE_9076_length_893_cov_22.633501	272	352	0	80	80	1.0000000
NODE_9076_length_893_cov_22.633501	272	352	0	80	80	1.0000000
NODE_9076_length_893_cov_22.633501	272	352	0	80	80	1.0000000
NODE_9076_length_893_cov_22.633501	325	405	0	80	80	1.0000000
NODE_9076_length_893_cov_22.633501	325	405	0	80	80	1.0000000
NODE_9076_length_893_cov_22.633501	325	405	0	80	80	1.0000000
NODE_9076_length_893_cov_22.633501	401	481	0	32	80	0.4000000
NODE_9076_length_893_cov_22.633501	401	481	3	11	80	0.1375000
NODE_9076_length_893_cov_22.633501	401	481	5	37	80	0.4625000
NODE_9076_length_893_cov_22.633501	454	534	5	80	80	1.0000000
NODE_9077_length_893_cov_22.403023	453	533	9	4	80	0.0500000
NODE_9077_length_893_cov_22.403023	453	533	10	25	80	0.3125000
NODE_9077_length_893_cov_22.403023	453	533	11	16	80	0.2000000
NODE_9077_length_893_cov_22.403023	453	533	12	5	80	0.0625000
NODE_9077_length_893_cov_22.403023	453	533	13	23	80	0.2875000
NODE_9077_length_893_cov_22.403023	453	533	14	7	80	0.0875000
NODE_9077_length_893_cov_22.403023	506	586	5	2	80	0.0250000
NODE_9077_length_893_cov_22.403023	506	586	6	19	80	0.2375000
NODE_9077_length_893_cov_22.403023	506	586	7	17	80	0.2125000
NODE_9077_length_893_cov_22.403023	506	586	9	19	80	0.2375000
NODE_9077_length_893_cov_22.403023	506	586	10	3	80	0.0375000
NODE_9077_length_893_cov_22.403023	506	586	11	1	80	0.0125000
NODE_9077_length_893_cov_22.403023	506	586	12	5	80	0.0625000
NODE_9077_length_893_cov_22.403023	506	586	13	7	80	0.0875000
NODE_9077_length_893_cov_22.403023	506	586	14	7	80	0.0875000
NODE_9078_length_893_cov_19.423174	298	378	0	80	80	1.0000000
NODE_9078_length_893_cov_19.423174	351	431	0	80	80	1.0000000
NODE_9078_length_893_cov_19.423174	427	507	0	61	80	0.7625000
NODE_9078_length_893_cov_19.423174	427	507	2	19	80	0.2375000
NODE_9078_length_893_cov_19.423174	480	560	0	8	80	0.1000000
NODE_9078_length_893_cov_19.423174	480	560	2	72	80	0.9000000
NODE_9079_length_893_cov_19.389169	360	440	0	80	80	1.0000000
NODE_9079_length_893_cov_19.389169	413	493	0	80	80	1.0000000
NODE_9079_length_893_cov_19.389169	489	569	0	67	80	0.8375000
NODE_9079_length_893_cov_19.389169	489	569	2	13	80	0.1625000
NODE_9079_length_893_cov_19.389169	542	622	0	14	80	0.1750000
NODE_9079_length_893_cov_19.389169	542	622	2	66	80	0.8250000
NODE_9080_length_893_cov_18.152393	394	474	4	80	80	1.0000000
NODE_9080_length_893_cov_18.152393	447	527	0	30	80	0.3750000
NODE_9080_length_893_cov_18.152393	447	527	1	12	80	0.1500000
NODE_9080_length_893_cov_18.152393	447	527	4	38	80	0.4750000
NODE_9081_length_893_cov_15.960957	442	522	4	14	80	0.1750000
NODE_9081_length_893_cov_15.960957	442	522	5	42	80	0.5250000
NODE_9081_length_893_cov_15.960957	442	522	7	11	80	0.1375000
NODE_9081_length_893_cov_15.960957	442	522	8	13	80	0.1625000
NODE_9081_length_893_cov_15.960957	495	575	5	3	80	0.0375000
NODE_9081_length_893_cov_15.960957	495	575	6	28	80	0.3500000
NODE_9081_length_893_cov_15.960957	495	575	7	20	80	0.2500000
NODE_9081_length_893_cov_15.960957	495	575	8	29	80	0.3625000
NODE_9082_length_893_cov_13.119647	473	553	0	80	80	1.0000000
NODE_9082_length_893_cov_13.119647	526	606	0	80	80	1.0000000
NODE_9084_length_893_cov_5.549118	353	415	9	21	62	0.3387097
NODE_9084_length_893_cov_5.549118	353	415	10	29	62	0.4677419
NODE_9084_length_893_cov_5.549118	353	415	11	12	62	0.1935484
NODE_9100_length_893_cov_1.141058	28	108	2	80	80	1.0000000
NODE_9104_length_892_cov_74.968474	333	413	8	6	80	0.0750000
NODE_9104_length_892_cov_74.968474	333	413	9	6	80	0.0750000
NODE_9104_length_892_cov_74.968474	333	413	10	1	80	0.0125000
NODE_9104_length_892_cov_74.968474	333	413	11	3	80	0.0375000
NODE_9104_length_892_cov_74.968474	333	413	12	9	80	0.1125000
NODE_9104_length_892_cov_74.968474	333	413	13	2	80	0.0250000
NODE_9104_length_892_cov_74.968474	333	413	14	30	80	0.3750000
NODE_9104_length_892_cov_74.968474	333	413	15	23	80	0.2875000
NODE_9104_length_892_cov_74.968474	386	466	11	6	80	0.0750000
NODE_9104_length_892_cov_74.968474	386	466	12	11	80	0.1375000
NODE_9104_length_892_cov_74.968474	386	466	13	5	80	0.0625000
NODE_9104_length_892_cov_74.968474	386	466	14	4	80	0.0500000
NODE_9104_length_892_cov_74.968474	386	466	15	54	80	0.6750000
NODE_9104_length_892_cov_74.968474	462	542	4	2	80	0.0250000
NODE_9104_length_892_cov_74.968474	462	542	5	34	80	0.4250000
NODE_9104_length_892_cov_74.968474	462	542	6	5	80	0.0625000
NODE_9104_length_892_cov_74.968474	462	542	7	6	80	0.0750000
NODE_9104_length_892_cov_74.968474	462	542	8	6	80	0.0750000
NODE_9104_length_892_cov_74.968474	462	542	9	8	80	0.1000000
NODE_9104_length_892_cov_74.968474	462	542	10	11	80	0.1375000
NODE_9104_length_892_cov_74.968474	462	542	11	8	80	0.1000000
NODE_9104_length_892_cov_74.968474	515	595	3	6	80	0.0750000
NODE_9104_length_892_cov_74.968474	515	595	4	49	80	0.6125000
NODE_9104_length_892_cov_74.968474	515	595	5	25	80	0.3125000
NODE_9105_length_892_cov_54.549811	463	550	0	87	87	1.0000000
NODE_9105_length_892_cov_54.549811	523	603	0	80	80	1.0000000
NODE_9105_length_892_cov_54.549811	599	679	0	80	80	1.0000000
NODE_9106_length_892_cov_37.887768	373	453	4	15	80	0.1875000
NODE_9106_length_892_cov_37.887768	373	453	5	29	80	0.3625000
NODE_9106_length_892_cov_37.887768	373	453	6	18	80	0.2250000
NODE_9106_length_892_cov_37.887768	373	453	7	18	80	0.2250000
NODE_9106_length_892_cov_37.887768	426	506	5	22	80	0.2750000
NODE_9106_length_892_cov_37.887768	426	506	6	4	80	0.0500000
NODE_9106_length_892_cov_37.887768	426	506	7	48	80	0.6000000
NODE_9106_length_892_cov_37.887768	426	506	8	6	80	0.0750000
NODE_9107_length_892_cov_19.732661	361	441	0	38	80	0.4750000
NODE_9107_length_892_cov_19.732661	361	441	2	42	80	0.5250000
NODE_9107_length_892_cov_19.732661	414	494	2	80	80	1.0000000
NODE_9108_length_892_cov_19.052963	290	370	1	31	80	0.3875000
NODE_9108_length_892_cov_19.052963	290	370	2	1	80	0.0125000
NODE_9108_length_892_cov_19.052963	290	370	3	23	80	0.2875000
NODE_9108_length_892_cov_19.052963	290	370	4	25	80	0.3125000
NODE_9108_length_892_cov_19.052963	343	423	3	4	80	0.0500000
NODE_9108_length_892_cov_19.052963	343	423	4	76	80	0.9500000
NODE_9108_length_892_cov_19.052963	419	499	3	38	80	0.4750000
NODE_9108_length_892_cov_19.052963	419	499	4	20	80	0.2500000
NODE_9108_length_892_cov_19.052963	419	499	5	8	80	0.1000000
NODE_9108_length_892_cov_19.052963	419	499	6	14	80	0.1750000
NODE_9108_length_892_cov_19.052963	472	552	4	5	80	0.0625000
NODE_9108_length_892_cov_19.052963	472	552	5	38	80	0.4750000
NODE_9108_length_892_cov_19.052963	472	552	6	37	80	0.4625000
NODE_9109_length_892_cov_17.276166	341	421	3	33	80	0.4125000
NODE_9109_length_892_cov_17.276166	341	421	5	20	80	0.2500000
NODE_9109_length_892_cov_17.276166	341	421	7	27	80	0.3375000
NODE_9109_length_892_cov_17.276166	394	474	3	4	80	0.0500000
NODE_9109_length_892_cov_17.276166	394	474	5	68	80	0.8500000
NODE_9109_length_892_cov_17.276166	394	474	7	8	80	0.1000000
NODE_9110_length_892_cov_16.312736	411	491	3	4	80	0.0500000
NODE_9110_length_892_cov_16.312736	411	491	4	14	80	0.1750000
NODE_9110_length_892_cov_16.312736	411	491	5	5	80	0.0625000
NODE_9110_length_892_cov_16.312736	411	491	6	57	80	0.7125000
NODE_9110_length_892_cov_16.312736	464	544	0	4	80	0.0500000
NODE_9110_length_892_cov_16.312736	464	544	1	18	80	0.2250000
NODE_9110_length_892_cov_16.312736	464	544	3	35	80	0.4375000
NODE_9110_length_892_cov_16.312736	464	544	4	14	80	0.1750000
NODE_9110_length_892_cov_16.312736	464	544	5	5	80	0.0625000
NODE_9110_length_892_cov_16.312736	464	544	6	4	80	0.0500000
NODE_9111_length_892_cov_15.808323	395	475	2	7	80	0.0875000
NODE_9111_length_892_cov_15.808323	395	475	4	73	80	0.9125000
NODE_9111_length_892_cov_15.808323	448	528	0	4	80	0.0500000
NODE_9111_length_892_cov_15.808323	448	528	2	23	80	0.2875000
NODE_9111_length_892_cov_15.808323	448	528	4	53	80	0.6625000
NODE_9112_length_892_cov_14.020177	522	602	6	22	80	0.2750000
NODE_9112_length_892_cov_14.020177	522	602	7	16	80	0.2000000
NODE_9112_length_892_cov_14.020177	522	602	8	22	80	0.2750000
NODE_9112_length_892_cov_14.020177	522	602	9	1	80	0.0125000
NODE_9112_length_892_cov_14.020177	522	602	10	19	80	0.2375000
NODE_9112_length_892_cov_14.020177	575	655	0	8	80	0.1000000
NODE_9112_length_892_cov_14.020177	575	655	2	24	80	0.3000000
NODE_9112_length_892_cov_14.020177	575	655	4	8	80	0.1000000
NODE_9112_length_892_cov_14.020177	575	655	5	1	80	0.0125000
NODE_9112_length_892_cov_14.020177	575	655	6	34	80	0.4250000
NODE_9112_length_892_cov_14.020177	575	655	7	5	80	0.0625000
NODE_9114_length_892_cov_8.798235	400	480	5	18	80	0.2250000
NODE_9114_length_892_cov_8.798235	400	480	6	56	80	0.7000000
NODE_9114_length_892_cov_8.798235	400	480	7	3	80	0.0375000
NODE_9114_length_892_cov_8.798235	400	480	8	3	80	0.0375000
NODE_9114_length_892_cov_8.798235	453	533	5	8	80	0.1000000
NODE_9114_length_892_cov_8.798235	453	533	6	21	80	0.2625000
NODE_9114_length_892_cov_8.798235	453	533	7	25	80	0.3125000
NODE_9114_length_892_cov_8.798235	453	533	8	26	80	0.3250000
NODE_9115_length_892_cov_8.413619	428	508	2	9	80	0.1125000
NODE_9115_length_892_cov_8.413619	428	508	3	36	80	0.4500000
NODE_9115_length_892_cov_8.413619	428	508	4	8	80	0.1000000
NODE_9115_length_892_cov_8.413619	428	508	5	27	80	0.3375000
NODE_9115_length_892_cov_8.413619	481	561	3	19	80	0.2375000
NODE_9115_length_892_cov_8.413619	481	561	4	47	80	0.5875000
NODE_9115_length_892_cov_8.413619	481	561	5	14	80	0.1750000
NODE_9116_length_892_cov_6.694830	374	454	0	5	80	0.0625000
NODE_9116_length_892_cov_6.694830	374	454	2	75	80	0.9375000
NODE_9116_length_892_cov_6.694830	427	507	0	36	80	0.4500000
NODE_9116_length_892_cov_6.694830	427	507	2	44	80	0.5500000
NODE_9134_length_891_cov_30.166667	295	375	8	27	80	0.3375000
NODE_9134_length_891_cov_30.166667	295	375	9	14	80	0.1750000
NODE_9134_length_891_cov_30.166667	295	375	10	4	80	0.0500000
NODE_9134_length_891_cov_30.166667	295	375	11	11	80	0.1375000
NODE_9134_length_891_cov_30.166667	295	375	12	24	80	0.3000000
NODE_9134_length_891_cov_30.166667	348	428	6	37	80	0.4625000
NODE_9134_length_891_cov_30.166667	348	428	7	4	80	0.0500000
NODE_9134_length_891_cov_30.166667	348	428	8	28	80	0.3500000
NODE_9134_length_891_cov_30.166667	348	428	9	10	80	0.1250000
NODE_9134_length_891_cov_30.166667	348	428	10	1	80	0.0125000
NODE_9135_length_891_cov_26.333333	319	399	10	20	80	0.2500000
NODE_9135_length_891_cov_26.333333	319	399	11	21	80	0.2625000
NODE_9135_length_891_cov_26.333333	319	399	12	39	80	0.4875000
NODE_9135_length_891_cov_26.333333	372	452	3	12	80	0.1500000
NODE_9135_length_891_cov_26.333333	372	452	5	9	80	0.1125000
NODE_9135_length_891_cov_26.333333	372	452	6	11	80	0.1375000
NODE_9135_length_891_cov_26.333333	372	452	7	6	80	0.0750000
NODE_9135_length_891_cov_26.333333	372	452	9	8	80	0.1000000
NODE_9135_length_891_cov_26.333333	372	452	10	27	80	0.3375000
NODE_9135_length_891_cov_26.333333	372	452	11	7	80	0.0875000
NODE_9136_length_891_cov_22.228535	336	416	8	11	80	0.1375000
NODE_9136_length_891_cov_22.228535	336	416	9	11	80	0.1375000
NODE_9136_length_891_cov_22.228535	336	416	10	35	80	0.4375000
NODE_9136_length_891_cov_22.228535	336	416	11	13	80	0.1625000
NODE_9136_length_891_cov_22.228535	336	416	12	5	80	0.0625000
NODE_9136_length_891_cov_22.228535	336	416	13	5	80	0.0625000
NODE_9136_length_891_cov_22.228535	389	469	8	22	80	0.2750000
NODE_9136_length_891_cov_22.228535	389	469	10	16	80	0.2000000
NODE_9136_length_891_cov_22.228535	389	469	11	13	80	0.1625000
NODE_9136_length_891_cov_22.228535	389	469	12	24	80	0.3000000
NODE_9136_length_891_cov_22.228535	389	469	13	5	80	0.0625000
NODE_9137_length_891_cov_20.446970	377	457	0	70	80	0.8750000
NODE_9137_length_891_cov_20.446970	377	457	2	10	80	0.1250000
NODE_9137_length_891_cov_20.446970	430	510	0	17	80	0.2125000
NODE_9137_length_891_cov_20.446970	430	510	2	63	80	0.7875000
NODE_9138_length_891_cov_20.226010	310	390	0	14	80	0.1750000
NODE_9138_length_891_cov_20.226010	310	390	2	66	80	0.8250000
NODE_9138_length_891_cov_20.226010	363	443	0	14	80	0.1750000
NODE_9138_length_891_cov_20.226010	363	443	2	66	80	0.8250000
NODE_9140_length_891_cov_13.207071	392	472	2	6	80	0.0750000
NODE_9140_length_891_cov_13.207071	392	472	3	20	80	0.2500000
NODE_9140_length_891_cov_13.207071	392	472	4	9	80	0.1125000
NODE_9140_length_891_cov_13.207071	392	472	5	32	80	0.4000000
NODE_9140_length_891_cov_13.207071	392	472	6	13	80	0.1625000
NODE_9140_length_891_cov_13.207071	445	525	5	14	80	0.1750000
NODE_9140_length_891_cov_13.207071	445	525	6	66	80	0.8250000
NODE_9141_length_891_cov_11.579545	379	459	3	34	80	0.4250000
NODE_9141_length_891_cov_11.579545	379	459	4	46	80	0.5750000
NODE_9141_length_891_cov_11.579545	432	512	1	31	80	0.3875000
NODE_9141_length_891_cov_11.579545	432	512	3	9	80	0.1125000
NODE_9141_length_891_cov_11.579545	432	512	4	40	80	0.5000000
NODE_9142_length_891_cov_11.117424	499	579	0	13	80	0.1625000
NODE_9142_length_891_cov_11.117424	499	579	2	39	80	0.4875000
NODE_9142_length_891_cov_11.117424	499	579	3	28	80	0.3500000
NODE_9142_length_891_cov_11.117424	552	632	1	18	80	0.2250000
NODE_9142_length_891_cov_11.117424	552	632	2	22	80	0.2750000
NODE_9142_length_891_cov_11.117424	552	632	3	40	80	0.5000000
NODE_9153_length_890_cov_29.070796	284	364	1	12	80	0.1500000
NODE_9153_length_890_cov_29.070796	284	364	2	51	80	0.6375000
NODE_9153_length_890_cov_29.070796	284	364	3	14	80	0.1750000
NODE_9153_length_890_cov_29.070796	284	364	4	3	80	0.0375000
NODE_9153_length_890_cov_29.070796	337	417	2	10	80	0.1250000
NODE_9153_length_890_cov_29.070796	337	417	3	14	80	0.1750000
NODE_9153_length_890_cov_29.070796	337	417	4	43	80	0.5375000
NODE_9153_length_890_cov_29.070796	337	417	6	13	80	0.1625000
NODE_9153_length_890_cov_29.070796	413	497	4	40	84	0.4761905
NODE_9153_length_890_cov_29.070796	413	497	5	13	84	0.1547619
NODE_9153_length_890_cov_29.070796	413	497	6	31	84	0.3690476
NODE_9153_length_890_cov_29.070796	470	550	3	12	80	0.1500000
NODE_9153_length_890_cov_29.070796	470	550	4	40	80	0.5000000
NODE_9153_length_890_cov_29.070796	470	550	5	16	80	0.2000000
NODE_9153_length_890_cov_29.070796	470	550	6	12	80	0.1500000
NODE_9154_length_890_cov_27.295828	550	630	0	6	80	0.0750000
NODE_9154_length_890_cov_27.295828	550	630	2	74	80	0.9250000
NODE_9154_length_890_cov_27.295828	603	683	0	59	80	0.7375000
NODE_9154_length_890_cov_27.295828	603	683	2	21	80	0.2625000
NODE_9155_length_890_cov_18.088496	80	135	0	55	55	1.0000000
NODE_9155_length_890_cov_18.088496	276	356	0	80	80	1.0000000
NODE_9155_length_890_cov_18.088496	329	406	0	77	77	1.0000000
NODE_9156_length_890_cov_16.831858	402	482	1	10	80	0.1250000
NODE_9156_length_890_cov_16.831858	402	482	2	20	80	0.2500000
NODE_9156_length_890_cov_16.831858	402	482	3	50	80	0.6250000
NODE_9156_length_890_cov_16.831858	455	535	2	55	80	0.6875000
NODE_9156_length_890_cov_16.831858	455	535	3	25	80	0.3125000
NODE_9157_length_890_cov_11.881163	222	302	1	12	80	0.1500000
NODE_9157_length_890_cov_11.881163	222	302	3	26	80	0.3250000
NODE_9157_length_890_cov_11.881163	222	302	5	4	80	0.0500000
NODE_9157_length_890_cov_11.881163	222	302	7	38	80	0.4750000
NODE_9157_length_890_cov_11.881163	275	355	2	24	80	0.3000000
NODE_9157_length_890_cov_11.881163	275	355	4	5	80	0.0625000
NODE_9157_length_890_cov_11.881163	275	355	6	22	80	0.2750000
NODE_9157_length_890_cov_11.881163	275	355	7	29	80	0.3625000
NODE_9158_length_890_cov_8.676359	335	415	0	34	80	0.4250000
NODE_9158_length_890_cov_8.676359	335	415	2	46	80	0.5750000
NODE_9158_length_890_cov_8.676359	388	468	2	80	80	1.0000000
NODE_9183_length_889_cov_61.520253	334	414	4	1	80	0.0125000
NODE_9183_length_889_cov_61.520253	334	414	5	21	80	0.2625000
NODE_9183_length_889_cov_61.520253	334	414	7	21	80	0.2625000
NODE_9183_length_889_cov_61.520253	334	414	8	8	80	0.1000000
NODE_9183_length_889_cov_61.520253	334	414	9	16	80	0.2000000
NODE_9183_length_889_cov_61.520253	334	414	10	13	80	0.1625000
NODE_9183_length_889_cov_61.520253	387	467	7	4	80	0.0500000
NODE_9183_length_889_cov_61.520253	387	467	8	5	80	0.0625000
NODE_9183_length_889_cov_61.520253	387	467	9	17	80	0.2125000
NODE_9183_length_889_cov_61.520253	387	467	10	54	80	0.6750000
NODE_9183_length_889_cov_61.520253	463	543	5	10	80	0.1250000
NODE_9183_length_889_cov_61.520253	463	543	6	45	80	0.5625000
NODE_9183_length_889_cov_61.520253	463	543	7	10	80	0.1250000
NODE_9183_length_889_cov_61.520253	463	543	8	8	80	0.1000000
NODE_9183_length_889_cov_61.520253	463	543	9	7	80	0.0875000
NODE_9183_length_889_cov_61.520253	516	596	2	2	80	0.0250000
NODE_9183_length_889_cov_61.520253	516	596	3	5	80	0.0625000
NODE_9183_length_889_cov_61.520253	516	596	4	38	80	0.4750000
NODE_9183_length_889_cov_61.520253	516	596	5	18	80	0.2250000
NODE_9183_length_889_cov_61.520253	516	596	6	17	80	0.2125000
NODE_9184_length_889_cov_30.012658	311	391	1	4	80	0.0500000
NODE_9184_length_889_cov_30.012658	311	391	3	6	80	0.0750000
NODE_9184_length_889_cov_30.012658	311	391	4	5	80	0.0625000
NODE_9184_length_889_cov_30.012658	311	391	5	1	80	0.0125000
NODE_9184_length_889_cov_30.012658	311	391	7	3	80	0.0375000
NODE_9184_length_889_cov_30.012658	311	391	8	7	80	0.0875000
NODE_9184_length_889_cov_30.012658	311	391	9	15	80	0.1875000
NODE_9184_length_889_cov_30.012658	311	391	10	5	80	0.0625000
NODE_9184_length_889_cov_30.012658	311	391	11	8	80	0.1000000
NODE_9184_length_889_cov_30.012658	311	391	12	9	80	0.1125000
NODE_9184_length_889_cov_30.012658	311	391	13	17	80	0.2125000
NODE_9184_length_889_cov_30.012658	364	444	11	1	80	0.0125000
NODE_9184_length_889_cov_30.012658	364	444	12	24	80	0.3000000
NODE_9184_length_889_cov_30.012658	364	444	13	38	80	0.4750000
NODE_9184_length_889_cov_30.012658	364	444	14	17	80	0.2125000
NODE_9185_length_889_cov_28.217722	413	483	2	7	70	0.1000000
NODE_9185_length_889_cov_28.217722	413	483	3	10	70	0.1428571
NODE_9185_length_889_cov_28.217722	413	483	4	24	70	0.3428572
NODE_9185_length_889_cov_28.217722	413	483	5	29	70	0.4142857
NODE_9185_length_889_cov_28.217722	466	542	3	14	76	0.1842105
NODE_9185_length_889_cov_28.217722	466	542	4	55	76	0.7236842
NODE_9185_length_889_cov_28.217722	466	542	5	7	76	0.0921053
NODE_9186_length_889_cov_27.924051	379	449	4	17	70	0.2428571
NODE_9186_length_889_cov_27.924051	379	449	6	9	70	0.1285714
NODE_9186_length_889_cov_27.924051	379	449	8	10	70	0.1428571
NODE_9186_length_889_cov_27.924051	379	449	10	2	70	0.0285714
NODE_9186_length_889_cov_27.924051	379	449	11	10	70	0.1428571
NODE_9186_length_889_cov_27.924051	379	449	12	22	70	0.3142857
NODE_9186_length_889_cov_27.924051	432	512	11	5	80	0.0625000
NODE_9186_length_889_cov_27.924051	432	512	12	20	80	0.2500000
NODE_9186_length_889_cov_27.924051	432	512	13	55	80	0.6875000
NODE_9187_length_889_cov_25.887342	227	285	6	28	58	0.4827586
NODE_9187_length_889_cov_25.887342	227	285	8	13	58	0.2241379
NODE_9187_length_889_cov_25.887342	227	285	10	10	58	0.1724138
NODE_9187_length_889_cov_25.887342	227	285	11	7	58	0.1206897
NODE_9187_length_889_cov_25.887342	258	337	8	10	79	0.1265823
NODE_9187_length_889_cov_25.887342	258	337	10	10	79	0.1265823
NODE_9187_length_889_cov_25.887342	258	337	11	13	79	0.1645570
NODE_9187_length_889_cov_25.887342	258	337	12	16	79	0.2025317
NODE_9187_length_889_cov_25.887342	258	337	14	30	79	0.3797468
NODE_9188_length_889_cov_22.992405	451	531	8	6	80	0.0750000
NODE_9188_length_889_cov_22.992405	451	531	9	1	80	0.0125000
NODE_9188_length_889_cov_22.992405	451	531	13	7	80	0.0875000
NODE_9188_length_889_cov_22.992405	451	531	14	57	80	0.7125000
NODE_9188_length_889_cov_22.992405	451	531	15	9	80	0.1125000
NODE_9188_length_889_cov_22.992405	504	584	2	6	80	0.0750000
NODE_9188_length_889_cov_22.992405	504	584	3	5	80	0.0625000
NODE_9188_length_889_cov_22.992405	504	584	4	13	80	0.1625000
NODE_9188_length_889_cov_22.992405	504	584	5	1	80	0.0125000
NODE_9188_length_889_cov_22.992405	504	584	7	21	80	0.2625000
NODE_9188_length_889_cov_22.992405	504	584	8	13	80	0.1625000
NODE_9188_length_889_cov_22.992405	504	584	9	1	80	0.0125000
NODE_9188_length_889_cov_22.992405	504	584	13	7	80	0.0875000
NODE_9188_length_889_cov_22.992405	504	584	14	4	80	0.0500000
NODE_9188_length_889_cov_22.992405	504	584	15	9	80	0.1125000
NODE_9189_length_889_cov_20.703797	331	411	2	80	80	1.0000000
NODE_9189_length_889_cov_20.703797	384	464	0	20	80	0.2500000
NODE_9189_length_889_cov_20.703797	384	464	2	60	80	0.7500000
NODE_9190_length_889_cov_20.226582	234	314	4	80	80	1.0000000
NODE_9190_length_889_cov_20.226582	287	367	1	24	80	0.3000000
NODE_9190_length_889_cov_20.226582	287	367	3	2	80	0.0250000
NODE_9190_length_889_cov_20.226582	287	367	4	54	80	0.6750000
NODE_9191_length_889_cov_15.587342	407	487	4	4	80	0.0500000
NODE_9191_length_889_cov_15.587342	407	487	6	7	80	0.0875000
NODE_9191_length_889_cov_15.587342	407	487	7	4	80	0.0500000
NODE_9191_length_889_cov_15.587342	407	487	8	52	80	0.6500000
NODE_9191_length_889_cov_15.587342	407	487	9	10	80	0.1250000
NODE_9191_length_889_cov_15.587342	407	487	10	3	80	0.0375000
NODE_9191_length_889_cov_15.587342	460	540	7	2	80	0.0250000
NODE_9191_length_889_cov_15.587342	460	540	8	24	80	0.3000000
NODE_9191_length_889_cov_15.587342	460	540	9	32	80	0.4000000
NODE_9191_length_889_cov_15.587342	460	540	10	7	80	0.0875000
NODE_9191_length_889_cov_15.587342	460	540	11	1	80	0.0125000
NODE_9191_length_889_cov_15.587342	460	540	12	14	80	0.1750000
NODE_9192_length_889_cov_12.669620	313	393	5	33	80	0.4125000
NODE_9192_length_889_cov_12.669620	313	393	6	5	80	0.0625000
NODE_9192_length_889_cov_12.669620	313	393	7	19	80	0.2375000
NODE_9192_length_889_cov_12.669620	313	393	8	23	80	0.2875000
NODE_9192_length_889_cov_12.669620	366	446	3	6	80	0.0750000
NODE_9192_length_889_cov_12.669620	366	446	4	1	80	0.0125000
NODE_9192_length_889_cov_12.669620	366	446	5	14	80	0.1750000
NODE_9192_length_889_cov_12.669620	366	446	6	30	80	0.3750000
NODE_9192_length_889_cov_12.669620	366	446	7	21	80	0.2625000
NODE_9192_length_889_cov_12.669620	366	446	8	8	80	0.1000000
NODE_9193_length_889_cov_12.198734	399	479	2	80	80	1.0000000
NODE_9193_length_889_cov_12.198734	452	532	0	2	80	0.0250000
NODE_9193_length_889_cov_12.198734	452	532	1	14	80	0.1750000
NODE_9193_length_889_cov_12.198734	452	532	2	64	80	0.8000000
NODE_9197_length_889_cov_3.841772	187	267	2	29	80	0.3625000
NODE_9197_length_889_cov_3.841772	187	267	3	11	80	0.1375000
NODE_9197_length_889_cov_3.841772	187	267	4	40	80	0.5000000
NODE_9197_length_889_cov_3.841772	240	320	1	39	80	0.4875000
NODE_9197_length_889_cov_3.841772	240	320	2	21	80	0.2625000
NODE_9197_length_889_cov_3.841772	240	320	3	13	80	0.1625000
NODE_9197_length_889_cov_3.841772	240	320	4	7	80	0.0875000
NODE_9213_length_888_cov_37.102662	490	570	4	12	80	0.1500000
NODE_9213_length_888_cov_37.102662	490	570	5	3	80	0.0375000
NODE_9213_length_888_cov_37.102662	490	570	6	2	80	0.0250000
NODE_9213_length_888_cov_37.102662	490	570	7	59	80	0.7375000
NODE_9213_length_888_cov_37.102662	490	570	8	4	80	0.0500000
NODE_9213_length_888_cov_37.102662	543	623	4	2	80	0.0250000
NODE_9213_length_888_cov_37.102662	543	623	5	23	80	0.2875000
NODE_9213_length_888_cov_37.102662	543	623	6	6	80	0.0750000
NODE_9213_length_888_cov_37.102662	543	623	7	49	80	0.6125000
NODE_9214_length_888_cov_28.230672	366	446	4	2	80	0.0250000
NODE_9214_length_888_cov_28.230672	366	446	5	9	80	0.1125000
NODE_9214_length_888_cov_28.230672	366	446	6	39	80	0.4875000
NODE_9214_length_888_cov_28.230672	366	446	7	30	80	0.3750000
NODE_9214_length_888_cov_28.230672	419	499	6	6	80	0.0750000
NODE_9214_length_888_cov_28.230672	419	499	7	37	80	0.4625000
NODE_9214_length_888_cov_28.230672	419	499	8	14	80	0.1750000
NODE_9214_length_888_cov_28.230672	419	499	9	23	80	0.2875000
NODE_9215_length_888_cov_25.243346	391	471	9	11	80	0.1375000
NODE_9215_length_888_cov_25.243346	391	471	11	4	80	0.0500000
NODE_9215_length_888_cov_25.243346	391	471	15	7	80	0.0875000
NODE_9215_length_888_cov_25.243346	391	471	16	13	80	0.1625000
NODE_9215_length_888_cov_25.243346	391	471	17	14	80	0.1750000
NODE_9215_length_888_cov_25.243346	391	471	18	10	80	0.1250000
NODE_9215_length_888_cov_25.243346	391	471	19	21	80	0.2625000
NODE_9215_length_888_cov_25.243346	444	524	11	4	80	0.0500000
NODE_9215_length_888_cov_25.243346	444	524	12	16	80	0.2000000
NODE_9215_length_888_cov_25.243346	444	524	14	6	80	0.0750000
NODE_9215_length_888_cov_25.243346	444	524	15	6	80	0.0750000
NODE_9215_length_888_cov_25.243346	444	524	16	33	80	0.4125000
NODE_9215_length_888_cov_25.243346	444	524	17	4	80	0.0500000
NODE_9215_length_888_cov_25.243346	444	524	19	11	80	0.1375000
NODE_9216_length_888_cov_21.045627	236	316	0	26	80	0.3250000
NODE_9216_length_888_cov_21.045627	236	316	1	1	80	0.0125000
NODE_9216_length_888_cov_21.045627	236	316	2	53	80	0.6625000
NODE_9216_length_888_cov_21.045627	289	367	2	60	78	0.7692308
NODE_9216_length_888_cov_21.045627	289	367	4	18	78	0.2307692
NODE_9218_length_888_cov_13.447402	515	595	6	15	80	0.1875000
NODE_9218_length_888_cov_13.447402	515	595	7	54	80	0.6750000
NODE_9218_length_888_cov_13.447402	515	595	8	11	80	0.1375000
NODE_9218_length_888_cov_13.447402	568	648	3	14	80	0.1750000
NODE_9218_length_888_cov_13.447402	568	648	4	37	80	0.4625000
NODE_9218_length_888_cov_13.447402	568	648	5	2	80	0.0250000
NODE_9218_length_888_cov_13.447402	568	648	6	15	80	0.1875000
NODE_9218_length_888_cov_13.447402	568	648	7	12	80	0.1500000
NODE_9219_length_888_cov_12.806084	179	259	1	80	80	1.0000000
NODE_9219_length_888_cov_12.806084	232	312	1	63	80	0.7875000
NODE_9219_length_888_cov_12.806084	232	312	2	17	80	0.2125000
NODE_9219_length_888_cov_12.806084	308	388	1	31	80	0.3875000
NODE_9219_length_888_cov_12.806084	308	388	2	13	80	0.1625000
NODE_9219_length_888_cov_12.806084	308	388	3	29	80	0.3625000
NODE_9219_length_888_cov_12.806084	308	388	4	7	80	0.0875000
NODE_9219_length_888_cov_12.806084	361	441	3	55	80	0.6875000
NODE_9219_length_888_cov_12.806084	361	441	4	7	80	0.0875000
NODE_9219_length_888_cov_12.806084	361	441	5	18	80	0.2250000
NODE_9220_length_888_cov_12.551331	365	445	4	37	80	0.4625000
NODE_9220_length_888_cov_12.551331	365	445	5	7	80	0.0875000
NODE_9220_length_888_cov_12.551331	365	445	6	36	80	0.4500000
NODE_9220_length_888_cov_12.551331	418	498	2	14	80	0.1750000
NODE_9220_length_888_cov_12.551331	418	498	3	9	80	0.1125000
NODE_9220_length_888_cov_12.551331	418	498	4	27	80	0.3375000
NODE_9220_length_888_cov_12.551331	418	498	5	10	80	0.1250000
NODE_9220_length_888_cov_12.551331	418	498	6	20	80	0.2500000
NODE_9228_length_888_cov_2.041825	42	102	0	60	60	1.0000000
NODE_9237_length_887_cov_32.927665	514	594	1	13	80	0.1625000
NODE_9237_length_887_cov_32.927665	514	594	3	1	80	0.0125000
NODE_9237_length_887_cov_32.927665	514	594	4	12	80	0.1500000
NODE_9237_length_887_cov_32.927665	514	594	5	9	80	0.1125000
NODE_9237_length_887_cov_32.927665	514	594	7	1	80	0.0125000
NODE_9237_length_887_cov_32.927665	514	594	9	2	80	0.0250000
NODE_9237_length_887_cov_32.927665	514	594	10	7	80	0.0875000
NODE_9237_length_887_cov_32.927665	514	594	11	1	80	0.0125000
NODE_9237_length_887_cov_32.927665	514	594	12	3	80	0.0375000
NODE_9237_length_887_cov_32.927665	514	594	13	3	80	0.0375000
NODE_9237_length_887_cov_32.927665	514	594	14	12	80	0.1500000
NODE_9237_length_887_cov_32.927665	514	594	15	13	80	0.1625000
NODE_9237_length_887_cov_32.927665	514	594	17	3	80	0.0375000
NODE_9237_length_887_cov_32.927665	567	647	14	11	80	0.1375000
NODE_9237_length_887_cov_32.927665	567	647	15	13	80	0.1625000
NODE_9237_length_887_cov_32.927665	567	647	17	41	80	0.5125000
NODE_9237_length_887_cov_32.927665	567	647	18	15	80	0.1875000
NODE_9238_length_887_cov_26.920051	358	438	8	16	80	0.2000000
NODE_9238_length_887_cov_26.920051	358	438	9	64	80	0.8000000
NODE_9238_length_887_cov_26.920051	411	491	3	16	80	0.2000000
NODE_9238_length_887_cov_26.920051	411	491	4	15	80	0.1875000
NODE_9238_length_887_cov_26.920051	411	491	6	7	80	0.0875000
NODE_9238_length_887_cov_26.920051	411	491	7	5	80	0.0625000
NODE_9238_length_887_cov_26.920051	411	491	9	37	80	0.4625000
NODE_9239_length_887_cov_20.714467	304	384	6	6	80	0.0750000
NODE_9239_length_887_cov_20.714467	304	384	7	74	80	0.9250000
NODE_9239_length_887_cov_20.714467	357	433	2	21	76	0.2763158
NODE_9239_length_887_cov_20.714467	357	433	4	1	76	0.0131579
NODE_9239_length_887_cov_20.714467	357	433	6	15	76	0.1973684
NODE_9239_length_887_cov_20.714467	357	433	7	39	76	0.5131579
NODE_9240_length_887_cov_19.771574	407	487	4	40	80	0.5000000
NODE_9240_length_887_cov_19.771574	407	487	5	34	80	0.4250000
NODE_9240_length_887_cov_19.771574	407	487	6	6	80	0.0750000
NODE_9240_length_887_cov_19.771574	460	540	4	45	80	0.5625000
NODE_9240_length_887_cov_19.771574	460	540	5	29	80	0.3625000
NODE_9240_length_887_cov_19.771574	460	540	6	6	80	0.0750000
NODE_9241_length_887_cov_14.535533	333	413	3	21	80	0.2625000
NODE_9241_length_887_cov_14.535533	333	413	4	11	80	0.1375000
NODE_9241_length_887_cov_14.535533	333	413	5	48	80	0.6000000
NODE_9241_length_887_cov_14.535533	386	466	4	3	80	0.0375000
NODE_9241_length_887_cov_14.535533	386	466	5	70	80	0.8750000
NODE_9241_length_887_cov_14.535533	386	466	6	7	80	0.0875000
NODE_9242_length_887_cov_14.114213	345	425	1	64	80	0.8000000
NODE_9242_length_887_cov_14.114213	345	425	2	16	80	0.2000000
NODE_9242_length_887_cov_14.114213	398	478	0	47	80	0.5875000
NODE_9242_length_887_cov_14.114213	398	478	1	33	80	0.4125000
NODE_9243_length_887_cov_9.451777	406	486	2	41	80	0.5125000
NODE_9243_length_887_cov_9.451777	406	486	4	39	80	0.4875000
NODE_9243_length_887_cov_9.451777	459	539	2	19	80	0.2375000
NODE_9243_length_887_cov_9.451777	459	539	3	7	80	0.0875000
NODE_9243_length_887_cov_9.451777	459	539	4	54	80	0.6750000
NODE_9245_length_887_cov_6.656091	473	553	0	2	80	0.0250000
NODE_9245_length_887_cov_6.656091	473	553	2	3	80	0.0375000
NODE_9245_length_887_cov_6.656091	473	553	4	75	80	0.9375000
NODE_9245_length_887_cov_6.656091	526	606	0	55	80	0.6875000
NODE_9245_length_887_cov_6.656091	526	606	2	3	80	0.0375000
NODE_9245_length_887_cov_6.656091	526	606	4	22	80	0.2750000
NODE_9246_length_887_cov_4.719543	420	500	2	64	80	0.8000000
NODE_9246_length_887_cov_4.719543	420	500	4	16	80	0.2000000
NODE_9246_length_887_cov_4.719543	473	553	2	64	80	0.8000000
NODE_9246_length_887_cov_4.719543	473	553	4	16	80	0.2000000
NODE_9250_length_887_cov_2.583756	385	429	0	44	44	1.0000000
NODE_9250_length_887_cov_2.583756	393	428	0	35	35	1.0000000
NODE_9261_length_887_cov_1.087563	754	829	0	9	75	0.1200000
NODE_9261_length_887_cov_1.087563	754	829	2	66	75	0.8800000
NODE_9264_length_886_cov_35.482846	365	445	9	16	80	0.2000000
NODE_9264_length_886_cov_35.482846	365	445	11	18	80	0.2250000
NODE_9264_length_886_cov_35.482846	365	445	12	46	80	0.5750000
NODE_9264_length_886_cov_35.482846	418	498	6	20	80	0.2500000
NODE_9264_length_886_cov_35.482846	418	498	8	1	80	0.0125000
NODE_9264_length_886_cov_35.482846	418	498	10	20	80	0.2500000
NODE_9264_length_886_cov_35.482846	418	498	11	4	80	0.0500000
NODE_9264_length_886_cov_35.482846	418	498	12	25	80	0.3125000
NODE_9264_length_886_cov_35.482846	418	498	13	10	80	0.1250000
NODE_9265_length_886_cov_31.939009	438	518	0	69	80	0.8625000
NODE_9265_length_886_cov_31.939009	438	518	1	11	80	0.1375000
NODE_9265_length_886_cov_31.939009	491	571	0	80	80	1.0000000
NODE_9266_length_886_cov_25.301144	326	406	0	54	80	0.6750000
NODE_9266_length_886_cov_25.301144	326	406	1	26	80	0.3250000
NODE_9266_length_886_cov_25.301144	326	406	0	54	80	0.6750000
NODE_9266_length_886_cov_25.301144	326	406	1	26	80	0.3250000
NODE_9266_length_886_cov_25.301144	379	459	0	1	80	0.0125000
NODE_9266_length_886_cov_25.301144	379	459	1	61	80	0.7625000
NODE_9266_length_886_cov_25.301144	379	459	2	18	80	0.2250000
NODE_9266_length_886_cov_25.301144	379	459	0	1	80	0.0125000
NODE_9266_length_886_cov_25.301144	379	459	1	61	80	0.7625000
NODE_9266_length_886_cov_25.301144	379	459	2	18	80	0.2250000
NODE_9267_length_886_cov_14.463787	327	407	6	39	80	0.4875000
NODE_9267_length_886_cov_14.463787	327	407	8	41	80	0.5125000
NODE_9267_length_886_cov_14.463787	380	460	2	9	80	0.1125000
NODE_9267_length_886_cov_14.463787	380	460	4	26	80	0.3250000
NODE_9267_length_886_cov_14.463787	380	460	5	1	80	0.0125000
NODE_9267_length_886_cov_14.463787	380	460	6	40	80	0.5000000
NODE_9267_length_886_cov_14.463787	380	460	8	4	80	0.0500000
NODE_9286_length_885_cov_35.510178	373	453	9	12	80	0.1500000
NODE_9286_length_885_cov_35.510178	373	453	11	4	80	0.0500000
NODE_9286_length_885_cov_35.510178	373	453	12	25	80	0.3125000
NODE_9286_length_885_cov_35.510178	373	453	13	39	80	0.4875000
NODE_9286_length_885_cov_35.510178	426	506	7	12	80	0.1500000
NODE_9286_length_885_cov_35.510178	426	506	9	2	80	0.0250000
NODE_9286_length_885_cov_35.510178	426	506	10	11	80	0.1375000
NODE_9286_length_885_cov_35.510178	426	506	11	21	80	0.2625000
NODE_9286_length_885_cov_35.510178	426	506	13	34	80	0.4250000
NODE_9287_length_885_cov_31.857506	368	448	5	3	80	0.0375000
NODE_9287_length_885_cov_31.857506	368	448	7	57	80	0.7125000
NODE_9287_length_885_cov_31.857506	368	448	8	20	80	0.2500000
NODE_9287_length_885_cov_31.857506	421	501	5	11	80	0.1375000
NODE_9287_length_885_cov_31.857506	421	501	6	14	80	0.1750000
NODE_9287_length_885_cov_31.857506	421	501	7	55	80	0.6875000
NODE_9288_length_885_cov_31.195929	395	475	3	8	80	0.1000000
NODE_9288_length_885_cov_31.195929	395	475	4	9	80	0.1125000
NODE_9288_length_885_cov_31.195929	395	475	5	63	80	0.7875000
NODE_9288_length_885_cov_31.195929	448	528	3	7	80	0.0875000
NODE_9288_length_885_cov_31.195929	448	528	4	15	80	0.1875000
NODE_9288_length_885_cov_31.195929	448	528	5	58	80	0.7250000
NODE_9289_length_885_cov_23.735369	356	436	0	14	80	0.1750000
NODE_9289_length_885_cov_23.735369	356	436	1	1	80	0.0125000
NODE_9289_length_885_cov_23.735369	356	436	2	49	80	0.6125000
NODE_9289_length_885_cov_23.735369	356	436	3	12	80	0.1500000
NODE_9289_length_885_cov_23.735369	356	436	4	4	80	0.0500000
NODE_9289_length_885_cov_23.735369	409	489	2	11	80	0.1375000
NODE_9289_length_885_cov_23.735369	409	489	3	12	80	0.1500000
NODE_9289_length_885_cov_23.735369	409	489	4	8	80	0.1000000
NODE_9289_length_885_cov_23.735369	409	489	5	11	80	0.1375000
NODE_9289_length_885_cov_23.735369	409	489	6	38	80	0.4750000
NODE_9289_length_885_cov_23.735369	485	565	5	12	80	0.1500000
NODE_9289_length_885_cov_23.735369	485	565	6	40	80	0.5000000
NODE_9289_length_885_cov_23.735369	485	565	7	28	80	0.3500000
NODE_9289_length_885_cov_23.735369	538	618	2	16	80	0.2000000
NODE_9289_length_885_cov_23.735369	538	618	3	11	80	0.1375000
NODE_9289_length_885_cov_23.735369	538	618	4	9	80	0.1125000
NODE_9289_length_885_cov_23.735369	538	618	5	11	80	0.1375000
NODE_9289_length_885_cov_23.735369	538	618	6	33	80	0.4125000
NODE_9290_length_885_cov_22.174300	340	420	2	22	80	0.2750000
NODE_9290_length_885_cov_22.174300	340	420	3	2	80	0.0250000
NODE_9290_length_885_cov_22.174300	340	420	4	11	80	0.1375000
NODE_9290_length_885_cov_22.174300	340	420	5	18	80	0.2250000
NODE_9290_length_885_cov_22.174300	340	420	6	27	80	0.3375000
NODE_9290_length_885_cov_22.174300	393	473	5	6	80	0.0750000
NODE_9290_length_885_cov_22.174300	393	473	6	65	80	0.8125000
NODE_9290_length_885_cov_22.174300	393	473	8	9	80	0.1125000
NODE_9290_length_885_cov_22.174300	469	549	3	12	80	0.1500000
NODE_9290_length_885_cov_22.174300	469	549	4	12	80	0.1500000
NODE_9290_length_885_cov_22.174300	469	549	5	11	80	0.1375000
NODE_9290_length_885_cov_22.174300	469	549	6	2	80	0.0250000
NODE_9290_length_885_cov_22.174300	469	549	7	30	80	0.3750000
NODE_9290_length_885_cov_22.174300	469	549	8	13	80	0.1625000
NODE_9290_length_885_cov_22.174300	522	602	0	23	80	0.2875000
NODE_9290_length_885_cov_22.174300	522	602	2	15	80	0.1875000
NODE_9290_length_885_cov_22.174300	522	602	3	27	80	0.3375000
NODE_9290_length_885_cov_22.174300	522	602	4	12	80	0.1500000
NODE_9290_length_885_cov_22.174300	522	602	5	3	80	0.0375000
NODE_9291_length_885_cov_17.852417	413	493	6	16	80	0.2000000
NODE_9291_length_885_cov_17.852417	413	493	7	11	80	0.1375000
NODE_9291_length_885_cov_17.852417	413	493	8	4	80	0.0500000
NODE_9291_length_885_cov_17.852417	413	493	9	42	80	0.5250000
NODE_9291_length_885_cov_17.852417	413	493	10	7	80	0.0875000
NODE_9291_length_885_cov_17.852417	466	546	6	14	80	0.1750000
NODE_9291_length_885_cov_17.852417	466	546	7	7	80	0.0875000
NODE_9291_length_885_cov_17.852417	466	546	8	21	80	0.2625000
NODE_9291_length_885_cov_17.852417	466	546	9	29	80	0.3625000
NODE_9291_length_885_cov_17.852417	466	546	10	9	80	0.1125000
NODE_9292_length_885_cov_15.652672	346	426	2	60	80	0.7500000
NODE_9292_length_885_cov_15.652672	346	426	3	20	80	0.2500000
NODE_9292_length_885_cov_15.652672	399	479	1	39	80	0.4875000
NODE_9292_length_885_cov_15.652672	399	479	2	7	80	0.0875000
NODE_9292_length_885_cov_15.652672	399	479	3	34	80	0.4250000
NODE_9292_length_885_cov_15.652672	475	555	1	24	80	0.3000000
NODE_9292_length_885_cov_15.652672	475	555	2	11	80	0.1375000
NODE_9292_length_885_cov_15.652672	475	555	3	45	80	0.5625000
NODE_9292_length_885_cov_15.652672	528	608	2	47	80	0.5875000
NODE_9292_length_885_cov_15.652672	528	608	3	28	80	0.3500000
NODE_9292_length_885_cov_15.652672	528	608	5	5	80	0.0625000
NODE_9293_length_885_cov_11.648855	530	610	0	73	80	0.9125000
NODE_9293_length_885_cov_11.648855	530	610	2	7	80	0.0875000
NODE_9293_length_885_cov_11.648855	583	663	0	20	80	0.2500000
NODE_9293_length_885_cov_11.648855	583	663	2	60	80	0.7500000
NODE_9294_length_885_cov_9.707379	611	691	2	4	80	0.0500000
NODE_9294_length_885_cov_9.707379	611	691	3	72	80	0.9000000
NODE_9294_length_885_cov_9.707379	611	691	4	1	80	0.0125000
NODE_9294_length_885_cov_9.707379	611	691	6	3	80	0.0375000
NODE_9294_length_885_cov_9.707379	664	744	3	23	80	0.2875000
NODE_9294_length_885_cov_9.707379	664	744	4	1	80	0.0125000
NODE_9294_length_885_cov_9.707379	664	744	5	47	80	0.5875000
NODE_9294_length_885_cov_9.707379	664	744	6	9	80	0.1125000
NODE_9311_length_884_cov_73.050955	536	616	4	3	80	0.0375000
NODE_9311_length_884_cov_73.050955	536	616	6	8	80	0.1000000
NODE_9311_length_884_cov_73.050955	536	616	8	8	80	0.1000000
NODE_9311_length_884_cov_73.050955	536	616	10	10	80	0.1250000
NODE_9311_length_884_cov_73.050955	536	616	12	34	80	0.4250000
NODE_9311_length_884_cov_73.050955	536	616	13	17	80	0.2125000
NODE_9311_length_884_cov_73.050955	589	669	1	9	80	0.1125000
NODE_9311_length_884_cov_73.050955	589	669	3	3	80	0.0375000
NODE_9311_length_884_cov_73.050955	589	669	5	4	80	0.0500000
NODE_9311_length_884_cov_73.050955	589	669	7	15	80	0.1875000
NODE_9311_length_884_cov_73.050955	589	669	8	2	80	0.0250000
NODE_9311_length_884_cov_73.050955	589	669	10	22	80	0.2750000
NODE_9311_length_884_cov_73.050955	589	669	12	18	80	0.2250000
NODE_9311_length_884_cov_73.050955	589	669	13	7	80	0.0875000
NODE_9312_length_884_cov_28.373248	381	461	3	7	80	0.0875000
NODE_9312_length_884_cov_28.373248	381	461	4	1	80	0.0125000
NODE_9312_length_884_cov_28.373248	381	461	5	9	80	0.1125000
NODE_9312_length_884_cov_28.373248	381	461	7	19	80	0.2375000
NODE_9312_length_884_cov_28.373248	381	461	9	25	80	0.3125000
NODE_9312_length_884_cov_28.373248	381	461	10	19	80	0.2375000
NODE_9312_length_884_cov_28.373248	434	514	5	7	80	0.0875000
NODE_9312_length_884_cov_28.373248	434	514	7	14	80	0.1750000
NODE_9312_length_884_cov_28.373248	434	514	9	13	80	0.1625000
NODE_9312_length_884_cov_28.373248	434	514	10	46	80	0.5750000
NODE_9313_length_884_cov_20.649682	463	543	3	78	80	0.9750000
NODE_9313_length_884_cov_20.649682	463	543	4	2	80	0.0250000
NODE_9313_length_884_cov_20.649682	516	596	2	26	80	0.3250000
NODE_9313_length_884_cov_20.649682	516	596	3	54	80	0.6750000
NODE_9314_length_884_cov_13.391083	225	305	3	28	80	0.3500000
NODE_9314_length_884_cov_13.391083	225	305	4	8	80	0.1000000
NODE_9314_length_884_cov_13.391083	225	305	5	43	80	0.5375000
NODE_9314_length_884_cov_13.391083	225	305	6	1	80	0.0125000
NODE_9314_length_884_cov_13.391083	278	358	3	23	80	0.2875000
NODE_9314_length_884_cov_13.391083	278	358	5	31	80	0.3875000
NODE_9314_length_884_cov_13.391083	278	358	6	26	80	0.3250000
NODE_9315_length_884_cov_9.192357	278	358	2	19	80	0.2375000
NODE_9315_length_884_cov_9.192357	278	358	3	20	80	0.2500000
NODE_9315_length_884_cov_9.192357	278	358	4	19	80	0.2375000
NODE_9315_length_884_cov_9.192357	278	358	5	22	80	0.2750000
NODE_9315_length_884_cov_9.192357	331	411	3	15	80	0.1875000
NODE_9315_length_884_cov_9.192357	331	411	4	30	80	0.3750000
NODE_9315_length_884_cov_9.192357	331	411	5	35	80	0.4375000
NODE_9315_length_884_cov_9.192357	407	487	3	7	80	0.0875000
NODE_9315_length_884_cov_9.192357	407	487	4	19	80	0.2375000
NODE_9315_length_884_cov_9.192357	407	487	5	26	80	0.3250000
NODE_9315_length_884_cov_9.192357	407	487	6	28	80	0.3500000
NODE_9315_length_884_cov_9.192357	460	540	3	54	80	0.6750000
NODE_9315_length_884_cov_9.192357	460	540	4	19	80	0.2375000
NODE_9315_length_884_cov_9.192357	460	540	5	7	80	0.0875000
NODE_9335_length_883_cov_46.780612	344	424	0	7	80	0.0875000
NODE_9335_length_883_cov_46.780612	344	424	1	73	80	0.9125000
NODE_9335_length_883_cov_46.780612	397	477	1	80	80	1.0000000
NODE_9336_length_883_cov_46.304847	387	467	2	9	80	0.1125000
NODE_9336_length_883_cov_46.304847	387	467	3	19	80	0.2375000
NODE_9336_length_883_cov_46.304847	387	467	4	52	80	0.6500000
NODE_9336_length_883_cov_46.304847	440	520	3	43	80	0.5375000
NODE_9336_length_883_cov_46.304847	440	520	4	37	80	0.4625000
NODE_9337_length_883_cov_39.579082	410	490	5	14	80	0.1750000
NODE_9337_length_883_cov_39.579082	410	490	6	2	80	0.0250000
NODE_9337_length_883_cov_39.579082	410	490	7	39	80	0.4875000
NODE_9337_length_883_cov_39.579082	410	490	8	16	80	0.2000000
NODE_9337_length_883_cov_39.579082	410	490	9	9	80	0.1125000
NODE_9337_length_883_cov_39.579082	463	543	7	35	80	0.4375000
NODE_9337_length_883_cov_39.579082	463	543	8	26	80	0.3250000
NODE_9337_length_883_cov_39.579082	463	543	9	19	80	0.2375000
NODE_9338_length_883_cov_28.307398	379	459	3	3	80	0.0375000
NODE_9338_length_883_cov_28.307398	379	459	4	5	80	0.0625000
NODE_9338_length_883_cov_28.307398	379	459	5	72	80	0.9000000
NODE_9338_length_883_cov_28.307398	432	512	5	80	80	1.0000000
NODE_9339_length_883_cov_24.927296	429	509	1	19	80	0.2375000
NODE_9339_length_883_cov_24.927296	429	509	3	8	80	0.1000000
NODE_9339_length_883_cov_24.927296	429	509	4	32	80	0.4000000
NODE_9339_length_883_cov_24.927296	429	509	5	21	80	0.2625000
NODE_9339_length_883_cov_24.927296	482	562	2	44	80	0.5500000
NODE_9339_length_883_cov_24.927296	482	562	4	36	80	0.4500000
NODE_9341_length_883_cov_17.445153	326	406	4	17	80	0.2125000
NODE_9341_length_883_cov_17.445153	326	406	5	26	80	0.3250000
NODE_9341_length_883_cov_17.445153	326	406	7	8	80	0.1000000
NODE_9341_length_883_cov_17.445153	326	406	10	7	80	0.0875000
NODE_9341_length_883_cov_17.445153	326	406	11	5	80	0.0625000
NODE_9341_length_883_cov_17.445153	326	406	12	17	80	0.2125000
NODE_9341_length_883_cov_17.445153	379	459	10	5	80	0.0625000
NODE_9341_length_883_cov_17.445153	379	459	11	5	80	0.0625000
NODE_9341_length_883_cov_17.445153	379	459	12	70	80	0.8750000
NODE_9342_length_883_cov_14.660714	319	395	0	31	76	0.4078947
NODE_9342_length_883_cov_14.660714	319	395	1	9	76	0.1184211
NODE_9342_length_883_cov_14.660714	319	395	2	36	76	0.4736842
NODE_9342_length_883_cov_14.660714	740	816	0	76	76	1.0000000
NODE_9343_length_883_cov_11.052296	223	303	1	3	80	0.0375000
NODE_9343_length_883_cov_11.052296	223	303	2	36	80	0.4500000
NODE_9343_length_883_cov_11.052296	223	303	4	41	80	0.5125000
NODE_9343_length_883_cov_11.052296	276	356	1	37	80	0.4625000
NODE_9343_length_883_cov_11.052296	276	356	2	43	80	0.5375000
NODE_9344_length_883_cov_6.873724	0	66	0	20	66	0.3030303
NODE_9344_length_883_cov_6.873724	0	66	1	46	66	0.6969697
NODE_9345_length_883_cov_3.873724	471	551	0	80	80	1.0000000
NODE_9345_length_883_cov_3.873724	524	604	0	80	80	1.0000000
NODE_9346_length_883_cov_3.247449	294	374	2	66	80	0.8250000
NODE_9346_length_883_cov_3.247449	294	374	3	14	80	0.1750000
NODE_9346_length_883_cov_3.247449	347	427	0	33	80	0.4125000
NODE_9346_length_883_cov_3.247449	347	427	2	47	80	0.5875000
NODE_9370_length_882_cov_24.241379	438	518	3	8	80	0.1000000
NODE_9370_length_882_cov_24.241379	438	518	5	2	80	0.0250000
NODE_9370_length_882_cov_24.241379	438	518	6	11	80	0.1375000
NODE_9370_length_882_cov_24.241379	438	518	7	32	80	0.4000000
NODE_9370_length_882_cov_24.241379	438	518	8	27	80	0.3375000
NODE_9370_length_882_cov_24.241379	491	571	6	3	80	0.0375000
NODE_9370_length_882_cov_24.241379	491	571	7	43	80	0.5375000
NODE_9370_length_882_cov_24.241379	491	571	8	25	80	0.3125000
NODE_9370_length_882_cov_24.241379	491	571	9	9	80	0.1125000
NODE_9371_length_882_cov_23.145594	355	435	2	9	80	0.1125000
NODE_9371_length_882_cov_23.145594	355	435	4	36	80	0.4500000
NODE_9371_length_882_cov_23.145594	355	435	5	10	80	0.1250000
NODE_9371_length_882_cov_23.145594	355	435	7	25	80	0.3125000
NODE_9371_length_882_cov_23.145594	408	488	5	16	80	0.2000000
NODE_9371_length_882_cov_23.145594	408	488	6	5	80	0.0625000
NODE_9371_length_882_cov_23.145594	408	488	7	59	80	0.7375000
NODE_9372_length_882_cov_21.401022	335	415	2	1	80	0.0125000
NODE_9372_length_882_cov_21.401022	335	415	3	60	80	0.7500000
NODE_9372_length_882_cov_21.401022	335	415	4	5	80	0.0625000
NODE_9372_length_882_cov_21.401022	335	415	5	14	80	0.1750000
NODE_9372_length_882_cov_21.401022	388	468	3	13	80	0.1625000
NODE_9372_length_882_cov_21.401022	388	468	5	26	80	0.3250000
NODE_9372_length_882_cov_21.401022	388	468	6	17	80	0.2125000
NODE_9372_length_882_cov_21.401022	388	468	7	24	80	0.3000000
NODE_9373_length_882_cov_19.579821	456	511	5	44	55	0.8000000
NODE_9373_length_882_cov_19.579821	456	511	7	1	55	0.0181818
NODE_9373_length_882_cov_19.579821	456	511	8	10	55	0.1818182
NODE_9373_length_882_cov_19.579821	506	586	8	9	80	0.1125000
NODE_9373_length_882_cov_19.579821	506	586	9	26	80	0.3250000
NODE_9373_length_882_cov_19.579821	506	586	10	23	80	0.2875000
NODE_9373_length_882_cov_19.579821	506	586	11	7	80	0.0875000
NODE_9373_length_882_cov_19.579821	506	586	13	15	80	0.1875000
NODE_9373_length_882_cov_19.579821	559	639	10	30	80	0.3750000
NODE_9373_length_882_cov_19.579821	559	639	11	32	80	0.4000000
NODE_9373_length_882_cov_19.579821	559	639	13	18	80	0.2250000
NODE_9374_length_882_cov_19.342273	298	378	0	19	80	0.2375000
NODE_9374_length_882_cov_19.342273	298	378	1	28	80	0.3500000
NODE_9374_length_882_cov_19.342273	298	378	3	31	80	0.3875000
NODE_9374_length_882_cov_19.342273	298	378	4	2	80	0.0250000
NODE_9374_length_882_cov_19.342273	351	431	3	25	80	0.3125000
NODE_9374_length_882_cov_19.342273	351	431	4	55	80	0.6875000
NODE_9374_length_882_cov_19.342273	427	508	0	20	81	0.2469136
NODE_9374_length_882_cov_19.342273	427	508	2	24	81	0.2962963
NODE_9374_length_882_cov_19.342273	427	508	4	37	81	0.4567901
NODE_9374_length_882_cov_19.342273	481	561	0	73	80	0.9125000
NODE_9374_length_882_cov_19.342273	481	561	2	7	80	0.0875000
NODE_9375_length_882_cov_11.873563	267	347	2	80	80	1.0000000
NODE_9375_length_882_cov_11.873563	320	400	0	9	80	0.1125000
NODE_9375_length_882_cov_11.873563	320	400	1	5	80	0.0625000
NODE_9375_length_882_cov_11.873563	320	400	2	66	80	0.8250000
NODE_9376_length_882_cov_8.794381	430	510	0	80	80	1.0000000
NODE_9376_length_882_cov_8.794381	483	563	0	80	80	1.0000000
NODE_9377_length_882_cov_7.537676	527	608	0	81	81	1.0000000
NODE_9379_length_882_cov_6.696041	355	435	2	35	80	0.4375000
NODE_9379_length_882_cov_6.696041	355	435	3	29	80	0.3625000
NODE_9379_length_882_cov_6.696041	355	435	4	16	80	0.2000000
NODE_9379_length_882_cov_6.696041	408	488	2	80	80	1.0000000
NODE_9380_length_882_cov_4.734355	585	665	0	80	80	1.0000000
NODE_9380_length_882_cov_4.734355	638	718	0	80	80	1.0000000
NODE_9398_length_881_cov_32.875959	444	524	13	2	80	0.0250000
NODE_9398_length_881_cov_32.875959	444	524	14	12	80	0.1500000
NODE_9398_length_881_cov_32.875959	444	524	15	5	80	0.0625000
NODE_9398_length_881_cov_32.875959	444	524	16	57	80	0.7125000
NODE_9398_length_881_cov_32.875959	444	524	17	4	80	0.0500000
NODE_9398_length_881_cov_32.875959	497	577	11	13	80	0.1625000
NODE_9398_length_881_cov_32.875959	497	577	12	23	80	0.2875000
NODE_9398_length_881_cov_32.875959	497	577	13	3	80	0.0375000
NODE_9398_length_881_cov_32.875959	497	577	14	18	80	0.2250000
NODE_9398_length_881_cov_32.875959	497	577	16	19	80	0.2375000
NODE_9398_length_881_cov_32.875959	497	577	17	4	80	0.0500000
NODE_9399_length_881_cov_25.750639	43	117	0	74	74	1.0000000
NODE_9399_length_881_cov_25.750639	116	193	0	77	77	1.0000000
NODE_9400_length_881_cov_23.897698	286	365	2	14	79	0.1772152
NODE_9400_length_881_cov_23.897698	286	365	3	6	79	0.0759494
NODE_9400_length_881_cov_23.897698	286	365	4	3	79	0.0379747
NODE_9400_length_881_cov_23.897698	286	365	6	9	79	0.1139240
NODE_9400_length_881_cov_23.897698	286	365	8	2	79	0.0253165
NODE_9400_length_881_cov_23.897698	286	365	9	16	79	0.2025317
NODE_9400_length_881_cov_23.897698	286	365	11	21	79	0.2658228
NODE_9400_length_881_cov_23.897698	286	365	12	8	79	0.1012658
NODE_9400_length_881_cov_23.897698	338	418	11	26	80	0.3250000
NODE_9400_length_881_cov_23.897698	338	418	12	25	80	0.3125000
NODE_9400_length_881_cov_23.897698	338	418	13	29	80	0.3625000
NODE_9401_length_881_cov_20.656010	359	439	6	13	80	0.1625000
NODE_9401_length_881_cov_20.656010	359	439	7	13	80	0.1625000
NODE_9401_length_881_cov_20.656010	359	439	8	12	80	0.1500000
NODE_9401_length_881_cov_20.656010	359	439	9	17	80	0.2125000
NODE_9401_length_881_cov_20.656010	359	439	10	25	80	0.3125000
NODE_9401_length_881_cov_20.656010	412	492	6	15	80	0.1875000
NODE_9401_length_881_cov_20.656010	412	492	7	29	80	0.3625000
NODE_9401_length_881_cov_20.656010	412	492	8	4	80	0.0500000
NODE_9401_length_881_cov_20.656010	412	492	9	17	80	0.2125000
NODE_9401_length_881_cov_20.656010	412	492	10	15	80	0.1875000
NODE_9402_length_881_cov_20.340153	242	322	2	13	80	0.1625000
NODE_9402_length_881_cov_20.340153	242	322	3	50	80	0.6250000
NODE_9402_length_881_cov_20.340153	242	322	6	17	80	0.2125000
NODE_9402_length_881_cov_20.340153	295	375	1	15	80	0.1875000
NODE_9402_length_881_cov_20.340153	295	375	3	65	80	0.8125000
NODE_9403_length_881_cov_18.234015	420	500	3	17	80	0.2125000
NODE_9403_length_881_cov_18.234015	420	500	4	63	80	0.7875000
NODE_9403_length_881_cov_18.234015	473	553	0	24	80	0.3000000
NODE_9403_length_881_cov_18.234015	473	553	1	2	80	0.0250000
NODE_9403_length_881_cov_18.234015	473	553	2	6	80	0.0750000
NODE_9403_length_881_cov_18.234015	473	553	3	38	80	0.4750000
NODE_9403_length_881_cov_18.234015	473	553	4	10	80	0.1250000
NODE_9404_length_881_cov_17.748082	291	371	4	2	80	0.0250000
NODE_9404_length_881_cov_17.748082	291	371	5	2	80	0.0250000
NODE_9404_length_881_cov_17.748082	291	371	6	76	80	0.9500000
NODE_9404_length_881_cov_17.748082	344	424	4	22	80	0.2750000
NODE_9404_length_881_cov_17.748082	344	424	5	25	80	0.3125000
NODE_9404_length_881_cov_17.748082	344	424	6	33	80	0.4125000
NODE_9405_length_881_cov_12.884910	332	412	1	80	80	1.0000000
NODE_9405_length_881_cov_12.884910	385	465	0	23	80	0.2875000
NODE_9405_length_881_cov_12.884910	385	465	1	57	80	0.7125000
NODE_9406_length_881_cov_6.473146	474	553	0	50	79	0.6329114
NODE_9406_length_881_cov_6.473146	474	553	2	29	79	0.3670886
NODE_9406_length_881_cov_6.473146	514	594	0	80	80	1.0000000
NODE_9406_length_881_cov_6.473146	526	565	0	39	39	1.0000000
NODE_9406_length_881_cov_6.473146	555	606	0	51	51	1.0000000
NODE_9406_length_881_cov_6.473146	567	647	0	80	80	1.0000000
NODE_9407_length_881_cov_5.615090	547	627	0	80	80	1.0000000
NODE_9407_length_881_cov_5.615090	600	680	0	80	80	1.0000000
NODE_9424_length_880_cov_26.663252	320	400	8	28	80	0.3500000
NODE_9424_length_880_cov_26.663252	320	400	9	8	80	0.1000000
NODE_9424_length_880_cov_26.663252	320	400	11	13	80	0.1625000
NODE_9424_length_880_cov_26.663252	320	400	12	19	80	0.2375000
NODE_9424_length_880_cov_26.663252	320	400	13	12	80	0.1500000
NODE_9424_length_880_cov_26.663252	373	453	9	1	80	0.0125000
NODE_9424_length_880_cov_26.663252	373	453	10	12	80	0.1500000
NODE_9424_length_880_cov_26.663252	373	453	11	16	80	0.2000000
NODE_9424_length_880_cov_26.663252	373	453	12	15	80	0.1875000
NODE_9424_length_880_cov_26.663252	373	453	13	18	80	0.2250000
NODE_9424_length_880_cov_26.663252	373	453	14	2	80	0.0250000
NODE_9424_length_880_cov_26.663252	373	453	15	9	80	0.1125000
NODE_9424_length_880_cov_26.663252	373	453	16	7	80	0.0875000
NODE_9425_length_880_cov_21.828425	328	408	3	2	80	0.0250000
NODE_9425_length_880_cov_21.828425	328	408	4	2	80	0.0250000
NODE_9425_length_880_cov_21.828425	328	408	5	76	80	0.9500000
NODE_9425_length_880_cov_21.828425	381	461	4	53	80	0.6625000
NODE_9425_length_880_cov_21.828425	381	461	5	27	80	0.3375000
NODE_9426_length_880_cov_20.245839	427	507	1	8	80	0.1000000
NODE_9426_length_880_cov_20.245839	427	507	3	8	80	0.1000000
NODE_9426_length_880_cov_20.245839	427	507	4	15	80	0.1875000
NODE_9426_length_880_cov_20.245839	427	507	5	39	80	0.4875000
NODE_9426_length_880_cov_20.245839	427	507	6	10	80	0.1250000
NODE_9426_length_880_cov_20.245839	480	560	1	61	80	0.7625000
NODE_9426_length_880_cov_20.245839	480	560	3	8	80	0.1000000
NODE_9426_length_880_cov_20.245839	480	560	4	11	80	0.1375000
NODE_9427_length_880_cov_19.434059	0	69	0	69	69	1.0000000
NODE_9428_length_880_cov_11.843790	363	430	5	25	67	0.3731343
NODE_9428_length_880_cov_11.843790	363	430	6	21	67	0.3134328
NODE_9428_length_880_cov_11.843790	363	430	7	21	67	0.3134328
NODE_9429_length_880_cov_11.544174	185	265	0	26	80	0.3250000
NODE_9429_length_880_cov_11.544174	185	265	1	54	80	0.6750000
NODE_9429_length_880_cov_11.544174	238	318	1	80	80	1.0000000
NODE_9430_length_880_cov_10.956466	354	434	4	28	80	0.3500000
NODE_9430_length_880_cov_10.956466	354	434	5	20	80	0.2500000
NODE_9430_length_880_cov_10.956466	354	434	7	32	80	0.4000000
NODE_9430_length_880_cov_10.956466	407	487	6	9	80	0.1125000
NODE_9430_length_880_cov_10.956466	407	487	7	69	80	0.8625000
NODE_9430_length_880_cov_10.956466	407	487	8	2	80	0.0250000
NODE_9431_length_880_cov_10.008963	395	474	4	20	79	0.2531646
NODE_9431_length_880_cov_10.008963	395	474	6	42	79	0.5316456
NODE_9431_length_880_cov_10.008963	395	474	7	14	79	0.1772152
NODE_9431_length_880_cov_10.008963	395	474	8	3	79	0.0379747
NODE_9431_length_880_cov_10.008963	448	527	2	22	79	0.2784810
NODE_9431_length_880_cov_10.008963	448	527	5	4	79	0.0506329
NODE_9431_length_880_cov_10.008963	448	527	6	9	79	0.1139240
NODE_9431_length_880_cov_10.008963	448	527	7	41	79	0.5189874
NODE_9431_length_880_cov_10.008963	448	527	8	3	79	0.0379747
NODE_9453_length_879_cov_23.565385	326	406	0	6	80	0.0750000
NODE_9453_length_879_cov_23.565385	326	406	2	42	80	0.5250000
NODE_9453_length_879_cov_23.565385	326	406	3	9	80	0.1125000
NODE_9453_length_879_cov_23.565385	326	406	5	23	80	0.2875000
NODE_9453_length_879_cov_23.565385	379	459	3	4	80	0.0500000
NODE_9453_length_879_cov_23.565385	379	459	5	59	80	0.7375000
NODE_9453_length_879_cov_23.565385	379	459	7	17	80	0.2125000
NODE_9453_length_879_cov_23.565385	455	535	3	6	80	0.0750000
NODE_9453_length_879_cov_23.565385	455	535	4	13	80	0.1625000
NODE_9453_length_879_cov_23.565385	455	535	5	48	80	0.6000000
NODE_9453_length_879_cov_23.565385	455	535	7	13	80	0.1625000
NODE_9453_length_879_cov_23.565385	508	586	2	32	78	0.4102564
NODE_9453_length_879_cov_23.565385	508	586	3	6	78	0.0769231
NODE_9453_length_879_cov_23.565385	508	586	4	32	78	0.4102564
NODE_9453_length_879_cov_23.565385	508	586	5	8	78	0.1025641
NODE_9454_length_879_cov_20.758974	355	439	3	8	84	0.0952381
NODE_9454_length_879_cov_20.758974	355	439	4	4	84	0.0476190
NODE_9454_length_879_cov_20.758974	355	439	6	24	84	0.2857143
NODE_9454_length_879_cov_20.758974	355	439	7	15	84	0.1785714
NODE_9454_length_879_cov_20.758974	355	439	8	33	84	0.3928571
NODE_9454_length_879_cov_20.758974	412	492	1	2	80	0.0250000
NODE_9454_length_879_cov_20.758974	412	492	2	10	80	0.1250000
NODE_9454_length_879_cov_20.758974	412	492	3	49	80	0.6125000
NODE_9454_length_879_cov_20.758974	412	492	4	4	80	0.0500000
NODE_9454_length_879_cov_20.758974	412	492	6	4	80	0.0500000
NODE_9454_length_879_cov_20.758974	412	492	7	11	80	0.1375000
NODE_9455_length_879_cov_19.685897	295	375	4	29	80	0.3625000
NODE_9455_length_879_cov_19.685897	295	375	6	3	80	0.0375000
NODE_9455_length_879_cov_19.685897	295	375	7	38	80	0.4750000
NODE_9455_length_879_cov_19.685897	295	375	9	10	80	0.1250000
NODE_9455_length_879_cov_19.685897	348	428	5	1	80	0.0125000
NODE_9455_length_879_cov_19.685897	348	428	7	35	80	0.4375000
NODE_9455_length_879_cov_19.685897	348	428	8	34	80	0.4250000
NODE_9455_length_879_cov_19.685897	348	428	9	10	80	0.1250000
NODE_9456_length_879_cov_17.738462	413	488	5	13	75	0.1733333
NODE_9456_length_879_cov_17.738462	413	488	6	4	75	0.0533333
NODE_9456_length_879_cov_17.738462	413	488	7	2	75	0.0266667
NODE_9456_length_879_cov_17.738462	413	488	8	26	75	0.3466667
NODE_9456_length_879_cov_17.738462	413	488	9	30	75	0.4000000
NODE_9456_length_879_cov_17.738462	569	649	0	55	80	0.6875000
NODE_9456_length_879_cov_17.738462	569	649	1	18	80	0.2250000
NODE_9456_length_879_cov_17.738462	569	649	2	7	80	0.0875000
NODE_9456_length_879_cov_17.738462	569	649	0	55	80	0.6875000
NODE_9456_length_879_cov_17.738462	569	649	1	18	80	0.2250000
NODE_9456_length_879_cov_17.738462	569	649	2	7	80	0.0875000
NODE_9456_length_879_cov_17.738462	569	649	0	55	80	0.6875000
NODE_9456_length_879_cov_17.738462	569	649	1	18	80	0.2250000
NODE_9456_length_879_cov_17.738462	569	649	2	7	80	0.0875000
NODE_9456_length_879_cov_17.738462	622	676	0	54	54	1.0000000
NODE_9458_length_879_cov_10.756410	335	415	0	25	80	0.3125000
NODE_9458_length_879_cov_10.756410	335	415	1	55	80	0.6875000
NODE_9458_length_879_cov_10.756410	388	468	0	78	80	0.9750000
NODE_9458_length_879_cov_10.756410	388	468	1	2	80	0.0250000
NODE_9459_length_879_cov_7.432051	234	314	2	19	80	0.2375000
NODE_9459_length_879_cov_7.432051	234	314	3	61	80	0.7625000
NODE_9459_length_879_cov_7.432051	288	367	2	38	79	0.4810127
NODE_9459_length_879_cov_7.432051	288	367	3	41	79	0.5189874
NODE_9473_length_878_cov_230.436457	415	495	28	4	80	0.0500000
NODE_9473_length_878_cov_230.436457	415	495	30	5	80	0.0625000
NODE_9473_length_878_cov_230.436457	415	495	34	1	80	0.0125000
NODE_9473_length_878_cov_230.436457	415	495	35	5	80	0.0625000
NODE_9473_length_878_cov_230.436457	415	495	36	1	80	0.0125000
NODE_9473_length_878_cov_230.436457	415	495	37	3	80	0.0375000
NODE_9473_length_878_cov_230.436457	415	495	39	4	80	0.0500000
NODE_9473_length_878_cov_230.436457	415	495	40	1	80	0.0125000
NODE_9473_length_878_cov_230.436457	415	495	41	3	80	0.0375000
NODE_9473_length_878_cov_230.436457	415	495	44	2	80	0.0250000
NODE_9473_length_878_cov_230.436457	415	495	45	7	80	0.0875000
NODE_9473_length_878_cov_230.436457	415	495	46	6	80	0.0750000
NODE_9473_length_878_cov_230.436457	415	495	47	1	80	0.0125000
NODE_9473_length_878_cov_230.436457	415	495	48	1	80	0.0125000
NODE_9473_length_878_cov_230.436457	415	495	49	1	80	0.0125000
NODE_9473_length_878_cov_230.436457	415	495	51	3	80	0.0375000
NODE_9473_length_878_cov_230.436457	415	495	52	2	80	0.0250000
NODE_9473_length_878_cov_230.436457	415	495	53	7	80	0.0875000
NODE_9473_length_878_cov_230.436457	415	495	54	4	80	0.0500000
NODE_9473_length_878_cov_230.436457	415	495	56	4	80	0.0500000
NODE_9473_length_878_cov_230.436457	415	495	57	2	80	0.0250000
NODE_9473_length_878_cov_230.436457	415	495	58	1	80	0.0125000
NODE_9473_length_878_cov_230.436457	415	495	59	4	80	0.0500000
NODE_9473_length_878_cov_230.436457	415	495	61	6	80	0.0750000
NODE_9473_length_878_cov_230.436457	415	495	62	2	80	0.0250000
NODE_9473_length_878_cov_230.436457	468	548	53	4	80	0.0500000
NODE_9473_length_878_cov_230.436457	468	548	54	4	80	0.0500000
NODE_9473_length_878_cov_230.436457	468	548	56	4	80	0.0500000
NODE_9473_length_878_cov_230.436457	468	548	57	2	80	0.0250000
NODE_9473_length_878_cov_230.436457	468	548	58	1	80	0.0125000
NODE_9473_length_878_cov_230.436457	468	548	59	4	80	0.0500000
NODE_9473_length_878_cov_230.436457	468	548	61	7	80	0.0875000
NODE_9473_length_878_cov_230.436457	468	548	62	14	80	0.1750000
NODE_9473_length_878_cov_230.436457	468	548	63	12	80	0.1500000
NODE_9473_length_878_cov_230.436457	468	548	64	15	80	0.1875000
NODE_9473_length_878_cov_230.436457	468	548	65	12	80	0.1500000
NODE_9473_length_878_cov_230.436457	468	548	66	1	80	0.0125000
NODE_9474_length_878_cov_49.514763	410	490	9	16	80	0.2000000
NODE_9474_length_878_cov_49.514763	410	490	10	8	80	0.1000000
NODE_9474_length_878_cov_49.514763	410	490	12	49	80	0.6125000
NODE_9474_length_878_cov_49.514763	410	490	13	7	80	0.0875000
NODE_9474_length_878_cov_49.514763	463	543	1	13	80	0.1625000
NODE_9474_length_878_cov_49.514763	463	543	4	25	80	0.3125000
NODE_9474_length_878_cov_49.514763	463	543	6	5	80	0.0625000
NODE_9474_length_878_cov_49.514763	463	543	7	2	80	0.0250000
NODE_9474_length_878_cov_49.514763	463	543	9	24	80	0.3000000
NODE_9474_length_878_cov_49.514763	463	543	10	8	80	0.1000000
NODE_9474_length_878_cov_49.514763	463	543	12	3	80	0.0375000
NODE_9475_length_878_cov_38.862644	365	445	9	5	80	0.0625000
NODE_9475_length_878_cov_38.862644	365	445	10	7	80	0.0875000
NODE_9475_length_878_cov_38.862644	365	445	11	3	80	0.0375000
NODE_9475_length_878_cov_38.862644	365	445	13	11	80	0.1375000
NODE_9475_length_878_cov_38.862644	365	445	15	12	80	0.1500000
NODE_9475_length_878_cov_38.862644	365	445	16	4	80	0.0500000
NODE_9475_length_878_cov_38.862644	365	445	17	13	80	0.1625000
NODE_9475_length_878_cov_38.862644	365	445	18	8	80	0.1000000
NODE_9475_length_878_cov_38.862644	365	445	20	7	80	0.0875000
NODE_9475_length_878_cov_38.862644	365	445	21	10	80	0.1250000
NODE_9475_length_878_cov_38.862644	418	498	16	1	80	0.0125000
NODE_9475_length_878_cov_38.862644	418	498	17	7	80	0.0875000
NODE_9475_length_878_cov_38.862644	418	498	18	8	80	0.1000000
NODE_9475_length_878_cov_38.862644	418	498	19	18	80	0.2250000
NODE_9475_length_878_cov_38.862644	418	498	20	13	80	0.1625000
NODE_9475_length_878_cov_38.862644	418	498	21	10	80	0.1250000
NODE_9475_length_878_cov_38.862644	418	498	22	23	80	0.2875000
NODE_9476_length_878_cov_36.517330	346	426	5	70	80	0.8750000
NODE_9476_length_878_cov_36.517330	346	426	6	10	80	0.1250000
NODE_9476_length_878_cov_36.517330	399	479	3	2	80	0.0250000
NODE_9476_length_878_cov_36.517330	399	479	4	19	80	0.2375000
NODE_9476_length_878_cov_36.517330	399	479	5	59	80	0.7375000
NODE_9476_length_878_cov_36.517330	475	555	2	12	80	0.1500000
NODE_9476_length_878_cov_36.517330	475	555	3	49	80	0.6125000
NODE_9476_length_878_cov_36.517330	475	555	4	19	80	0.2375000
NODE_9476_length_878_cov_36.517330	528	608	1	6	80	0.0750000
NODE_9476_length_878_cov_36.517330	528	608	2	59	80	0.7375000
NODE_9476_length_878_cov_36.517330	528	608	3	15	80	0.1875000
NODE_9477_length_878_cov_34.404365	627	707	2	10	80	0.1250000
NODE_9477_length_878_cov_34.404365	627	707	3	18	80	0.2250000
NODE_9477_length_878_cov_34.404365	627	707	4	5	80	0.0625000
NODE_9477_length_878_cov_34.404365	627	707	5	29	80	0.3625000
NODE_9477_length_878_cov_34.404365	627	707	6	18	80	0.2250000
NODE_9477_length_878_cov_34.404365	627	695	3	16	68	0.2352941
NODE_9477_length_878_cov_34.404365	627	695	4	5	68	0.0735294
NODE_9477_length_878_cov_34.404365	627	695	5	29	68	0.4264706
NODE_9477_length_878_cov_34.404365	627	695	6	18	68	0.2647059
NODE_9477_length_878_cov_34.404365	680	760	2	13	80	0.1625000
NODE_9477_length_878_cov_34.404365	680	760	3	17	80	0.2125000
NODE_9477_length_878_cov_34.404365	680	760	4	5	80	0.0625000
NODE_9477_length_878_cov_34.404365	680	760	5	2	80	0.0250000
NODE_9477_length_878_cov_34.404365	680	760	6	5	80	0.0625000
NODE_9477_length_878_cov_34.404365	680	760	10	2	80	0.0250000
NODE_9477_length_878_cov_34.404365	680	760	11	1	80	0.0125000
NODE_9477_length_878_cov_34.404365	680	760	12	35	80	0.4375000
NODE_9478_length_878_cov_28.761232	467	547	1	14	80	0.1750000
NODE_9478_length_878_cov_28.761232	467	547	2	35	80	0.4375000
NODE_9478_length_878_cov_28.761232	467	547	3	9	80	0.1125000
NODE_9478_length_878_cov_28.761232	467	547	4	22	80	0.2750000
NODE_9478_length_878_cov_28.761232	520	600	3	5	80	0.0625000
NODE_9478_length_878_cov_28.761232	520	600	4	27	80	0.3375000
NODE_9478_length_878_cov_28.761232	520	600	5	48	80	0.6000000
NODE_9479_length_878_cov_24.899872	316	396	1	57	80	0.7125000
NODE_9479_length_878_cov_24.899872	316	396	2	23	80	0.2875000
NODE_9479_length_878_cov_24.899872	369	449	0	13	80	0.1625000
NODE_9479_length_878_cov_24.899872	369	449	1	67	80	0.8375000
NODE_9479_length_878_cov_24.899872	445	525	0	76	80	0.9500000
NODE_9479_length_878_cov_24.899872	445	525	2	4	80	0.0500000
NODE_9479_length_878_cov_24.899872	498	578	0	23	80	0.2875000
NODE_9479_length_878_cov_24.899872	498	578	2	57	80	0.7125000
NODE_9480_length_878_cov_21.446727	377	457	6	11	80	0.1375000
NODE_9480_length_878_cov_21.446727	377	457	8	56	80	0.7000000
NODE_9480_length_878_cov_21.446727	377	457	10	13	80	0.1625000
NODE_9480_length_878_cov_21.446727	430	510	4	1	80	0.0125000
NODE_9480_length_878_cov_21.446727	430	510	6	63	80	0.7875000
NODE_9480_length_878_cov_21.446727	430	510	8	16	80	0.2000000
NODE_9481_length_878_cov_20.553273	424	504	0	80	80	1.0000000
NODE_9481_length_878_cov_20.553273	477	557	0	80	80	1.0000000
NODE_9482_length_878_cov_14.016688	214	294	1	54	80	0.6750000
NODE_9482_length_878_cov_14.016688	214	294	3	26	80	0.3250000
NODE_9482_length_878_cov_14.016688	267	347	1	1	80	0.0125000
NODE_9482_length_878_cov_14.016688	267	347	3	71	80	0.8875000
NODE_9482_length_878_cov_14.016688	267	347	4	8	80	0.1000000
NODE_9483_length_878_cov_9.252888	423	503	7	51	80	0.6375000
NODE_9483_length_878_cov_9.252888	423	503	8	29	80	0.3625000
NODE_9483_length_878_cov_9.252888	476	556	4	18	80	0.2250000
NODE_9483_length_878_cov_9.252888	476	556	5	28	80	0.3500000
NODE_9483_length_878_cov_9.252888	476	556	6	7	80	0.0875000
NODE_9483_length_878_cov_9.252888	476	556	7	10	80	0.1250000
NODE_9483_length_878_cov_9.252888	476	556	8	17	80	0.2125000
NODE_9484_length_878_cov_8.695764	333	413	0	80	80	1.0000000
NODE_9484_length_878_cov_8.695764	386	466	0	80	80	1.0000000
NODE_9485_length_878_cov_6.686778	65	145	0	13	80	0.1625000
NODE_9485_length_878_cov_6.686778	65	145	2	2	80	0.0250000
NODE_9485_length_878_cov_6.686778	65	145	4	50	80	0.6250000
NODE_9485_length_878_cov_6.686778	65	145	6	15	80	0.1875000
NODE_9485_length_878_cov_6.686778	118	198	4	65	80	0.8125000
NODE_9485_length_878_cov_6.686778	118	198	6	15	80	0.1875000
NODE_9487_length_878_cov_6.328626	426	506	0	25	80	0.3125000
NODE_9487_length_878_cov_6.328626	426	506	2	16	80	0.2000000
NODE_9487_length_878_cov_6.328626	426	506	4	39	80	0.4875000
NODE_9487_length_878_cov_6.328626	479	559	2	18	80	0.2250000
NODE_9487_length_878_cov_6.328626	479	559	4	62	80	0.7750000
NODE_9488_length_878_cov_5.771502	470	513	2	43	43	1.0000000
NODE_9490_length_878_cov_2.672657	499	579	2	80	80	1.0000000
NODE_9490_length_878_cov_2.672657	552	631	0	11	79	0.1392405
NODE_9490_length_878_cov_2.672657	552	631	2	68	79	0.8607595
NODE_9507_length_877_cov_59.021851	324	404	0	66	80	0.8250000
NODE_9507_length_877_cov_59.021851	324	404	1	2	80	0.0250000
NODE_9507_length_877_cov_59.021851	324	404	2	12	80	0.1500000
NODE_9507_length_877_cov_59.021851	377	457	0	13	80	0.1625000
NODE_9507_length_877_cov_59.021851	377	457	1	2	80	0.0250000
NODE_9507_length_877_cov_59.021851	377	457	2	65	80	0.8125000
NODE_9508_length_877_cov_54.422879	418	498	2	48	80	0.6000000
NODE_9508_length_877_cov_54.422879	418	498	3	18	80	0.2250000
NODE_9508_length_877_cov_54.422879	418	498	5	14	80	0.1750000
NODE_9508_length_877_cov_54.422879	471	551	3	13	80	0.1625000
NODE_9508_length_877_cov_54.422879	471	551	4	30	80	0.3750000
NODE_9508_length_877_cov_54.422879	471	551	5	37	80	0.4625000
NODE_9509_length_877_cov_47.672237	451	527	0	76	76	1.0000000
NODE_9509_length_877_cov_47.672237	500	580	0	80	80	1.0000000
NODE_9510_length_877_cov_29.884319	349	429	2	12	80	0.1500000
NODE_9510_length_877_cov_29.884319	349	429	4	68	80	0.8500000
NODE_9510_length_877_cov_29.884319	402	482	0	21	80	0.2625000
NODE_9510_length_877_cov_29.884319	402	482	2	34	80	0.4250000
NODE_9510_length_877_cov_29.884319	402	482	4	25	80	0.3125000
NODE_9511_length_877_cov_17.681234	423	503	2	20	80	0.2500000
NODE_9511_length_877_cov_17.681234	423	503	3	14	80	0.1750000
NODE_9511_length_877_cov_17.681234	423	503	4	21	80	0.2625000
NODE_9511_length_877_cov_17.681234	423	503	5	25	80	0.3125000
NODE_9511_length_877_cov_17.681234	476	556	3	34	80	0.4250000
NODE_9511_length_877_cov_17.681234	476	556	4	31	80	0.3875000
NODE_9511_length_877_cov_17.681234	476	556	5	15	80	0.1875000
NODE_9512_length_877_cov_17.520566	228	308	1	14	80	0.1750000
NODE_9512_length_877_cov_17.520566	228	308	3	29	80	0.3625000
NODE_9512_length_877_cov_17.520566	228	308	4	37	80	0.4625000
NODE_9512_length_877_cov_17.520566	281	361	3	13	80	0.1625000
NODE_9512_length_877_cov_17.520566	281	361	4	67	80	0.8375000
NODE_9513_length_877_cov_17.374036	362	442	7	5	80	0.0625000
NODE_9513_length_877_cov_17.374036	362	442	8	7	80	0.0875000
NODE_9513_length_877_cov_17.374036	362	442	10	11	80	0.1375000
NODE_9513_length_877_cov_17.374036	362	442	11	8	80	0.1000000
NODE_9513_length_877_cov_17.374036	362	442	12	3	80	0.0375000
NODE_9513_length_877_cov_17.374036	362	442	13	7	80	0.0875000
NODE_9513_length_877_cov_17.374036	362	442	15	14	80	0.1750000
NODE_9513_length_877_cov_17.374036	362	442	16	25	80	0.3125000
NODE_9513_length_877_cov_17.374036	415	495	8	1	80	0.0125000
NODE_9513_length_877_cov_17.374036	415	495	9	15	80	0.1875000
NODE_9513_length_877_cov_17.374036	415	495	11	1	80	0.0125000
NODE_9513_length_877_cov_17.374036	415	495	13	10	80	0.1250000
NODE_9513_length_877_cov_17.374036	415	495	14	10	80	0.1250000
NODE_9513_length_877_cov_17.374036	415	495	15	5	80	0.0625000
NODE_9513_length_877_cov_17.374036	415	495	16	38	80	0.4750000
NODE_9515_length_877_cov_9.320051	395	475	0	80	80	1.0000000
NODE_9515_length_877_cov_9.320051	448	528	0	70	80	0.8750000
NODE_9515_length_877_cov_9.320051	448	528	1	10	80	0.1250000
NODE_9517_length_877_cov_6.755784	222	302	0	80	80	1.0000000
NODE_9517_length_877_cov_6.755784	275	354	0	79	79	1.0000000
NODE_9537_length_876_cov_46.021879	389	469	2	29	80	0.3625000
NODE_9537_length_876_cov_46.021879	389	469	3	2	80	0.0250000
NODE_9537_length_876_cov_46.021879	389	469	4	5	80	0.0625000
NODE_9537_length_876_cov_46.021879	389	469	5	6	80	0.0750000
NODE_9537_length_876_cov_46.021879	389	469	6	3	80	0.0375000
NODE_9537_length_876_cov_46.021879	389	469	7	5	80	0.0625000
NODE_9537_length_876_cov_46.021879	389	469	8	14	80	0.1750000
NODE_9537_length_876_cov_46.021879	389	469	9	16	80	0.2000000
NODE_9537_length_876_cov_46.021879	442	522	7	16	80	0.2000000
NODE_9537_length_876_cov_46.021879	442	522	8	19	80	0.2375000
NODE_9537_length_876_cov_46.021879	442	522	9	45	80	0.5625000
NODE_9538_length_876_cov_34.441441	379	459	4	5	80	0.0625000
NODE_9538_length_876_cov_34.441441	379	459	6	23	80	0.2875000
NODE_9538_length_876_cov_34.441441	379	459	7	13	80	0.1625000
NODE_9538_length_876_cov_34.441441	379	459	8	1	80	0.0125000
NODE_9538_length_876_cov_34.441441	379	459	9	2	80	0.0250000
NODE_9538_length_876_cov_34.441441	379	459	10	10	80	0.1250000
NODE_9538_length_876_cov_34.441441	379	459	12	26	80	0.3250000
NODE_9538_length_876_cov_34.441441	432	512	9	14	80	0.1750000
NODE_9538_length_876_cov_34.441441	432	512	10	9	80	0.1125000
NODE_9538_length_876_cov_34.441441	432	512	11	1	80	0.0125000
NODE_9538_length_876_cov_34.441441	432	512	12	35	80	0.4375000
NODE_9538_length_876_cov_34.441441	432	512	13	14	80	0.1750000
NODE_9538_length_876_cov_34.441441	432	512	14	7	80	0.0875000
NODE_9539_length_876_cov_30.742600	344	424	1	51	80	0.6375000
NODE_9539_length_876_cov_30.742600	344	424	2	29	80	0.3625000
NODE_9539_length_876_cov_30.742600	397	477	1	23	80	0.2875000
NODE_9539_length_876_cov_30.742600	397	477	2	57	80	0.7125000
NODE_9540_length_876_cov_28.476190	345	425	6	5	80	0.0625000
NODE_9540_length_876_cov_28.476190	345	425	7	14	80	0.1750000
NODE_9540_length_876_cov_28.476190	345	425	9	8	80	0.1000000
NODE_9540_length_876_cov_28.476190	345	425	11	7	80	0.0875000
NODE_9540_length_876_cov_28.476190	345	425	12	18	80	0.2250000
NODE_9540_length_876_cov_28.476190	345	425	13	28	80	0.3500000
NODE_9540_length_876_cov_28.476190	398	478	7	24	80	0.3000000
NODE_9540_length_876_cov_28.476190	398	478	9	2	80	0.0250000
NODE_9540_length_876_cov_28.476190	398	478	10	4	80	0.0500000
NODE_9540_length_876_cov_28.476190	398	478	11	2	80	0.0250000
NODE_9540_length_876_cov_28.476190	398	478	12	10	80	0.1250000
NODE_9540_length_876_cov_28.476190	398	478	13	38	80	0.4750000
NODE_9541_length_876_cov_22.722008	324	404	2	2	80	0.0250000
NODE_9541_length_876_cov_22.722008	324	404	3	2	80	0.0250000
NODE_9541_length_876_cov_22.722008	324	404	7	44	80	0.5500000
NODE_9541_length_876_cov_22.722008	324	404	8	23	80	0.2875000
NODE_9541_length_876_cov_22.722008	324	404	9	9	80	0.1125000
NODE_9541_length_876_cov_22.722008	377	457	4	7	80	0.0875000
NODE_9541_length_876_cov_22.722008	377	457	5	3	80	0.0375000
NODE_9541_length_876_cov_22.722008	377	457	7	4	80	0.0500000
NODE_9541_length_876_cov_22.722008	377	457	8	14	80	0.1750000
NODE_9541_length_876_cov_22.722008	377	457	9	52	80	0.6500000
NODE_9542_length_876_cov_17.458172	367	447	1	44	80	0.5500000
NODE_9542_length_876_cov_17.458172	367	447	2	36	80	0.4500000
NODE_9542_length_876_cov_17.458172	420	500	1	80	80	1.0000000
NODE_9561_length_875_cov_52.965206	190	270	0	21	80	0.2625000
NODE_9561_length_875_cov_52.965206	190	270	1	56	80	0.7000000
NODE_9561_length_875_cov_52.965206	190	270	2	3	80	0.0375000
NODE_9561_length_875_cov_52.965206	243	323	1	24	80	0.3000000
NODE_9561_length_875_cov_52.965206	243	323	2	11	80	0.1375000
NODE_9561_length_875_cov_52.965206	243	323	4	27	80	0.3375000
NODE_9561_length_875_cov_52.965206	243	323	6	8	80	0.1000000
NODE_9561_length_875_cov_52.965206	243	323	7	1	80	0.0125000
NODE_9561_length_875_cov_52.965206	243	323	9	9	80	0.1125000
NODE_9561_length_875_cov_52.965206	319	399	9	5	80	0.0625000
NODE_9561_length_875_cov_52.965206	319	399	10	4	80	0.0500000
NODE_9561_length_875_cov_52.965206	319	399	11	45	80	0.5625000
NODE_9561_length_875_cov_52.965206	319	399	12	26	80	0.3250000
NODE_9561_length_875_cov_52.965206	372	447	6	28	75	0.3733333
NODE_9561_length_875_cov_52.965206	372	447	7	1	75	0.0133333
NODE_9561_length_875_cov_52.965206	372	447	8	9	75	0.1200000
NODE_9561_length_875_cov_52.965206	372	447	10	1	75	0.0133333
NODE_9561_length_875_cov_52.965206	372	447	11	36	75	0.4800000
NODE_9562_length_875_cov_35.634021	260	340	7	15	80	0.1875000
NODE_9562_length_875_cov_35.634021	260	340	8	15	80	0.1875000
NODE_9562_length_875_cov_35.634021	260	340	9	46	80	0.5750000
NODE_9562_length_875_cov_35.634021	260	340	10	4	80	0.0500000
NODE_9562_length_875_cov_35.634021	313	393	2	13	80	0.1625000
NODE_9562_length_875_cov_35.634021	313	393	3	2	80	0.0250000
NODE_9562_length_875_cov_35.634021	313	393	4	23	80	0.2875000
NODE_9562_length_875_cov_35.634021	313	393	6	7	80	0.0875000
NODE_9562_length_875_cov_35.634021	313	393	7	10	80	0.1250000
NODE_9562_length_875_cov_35.634021	313	393	8	10	80	0.1250000
NODE_9562_length_875_cov_35.634021	313	393	9	15	80	0.1875000
NODE_9562_length_875_cov_35.634021	389	469	2	2	80	0.0250000
NODE_9562_length_875_cov_35.634021	389	469	3	7	80	0.0875000
NODE_9562_length_875_cov_35.634021	389	469	5	15	80	0.1875000
NODE_9562_length_875_cov_35.634021	389	469	6	16	80	0.2000000
NODE_9562_length_875_cov_35.634021	389	469	7	38	80	0.4750000
NODE_9562_length_875_cov_35.634021	389	469	8	2	80	0.0250000
NODE_9562_length_875_cov_35.634021	442	522	6	16	80	0.2000000
NODE_9562_length_875_cov_35.634021	442	522	7	16	80	0.2000000
NODE_9562_length_875_cov_35.634021	442	522	8	48	80	0.6000000
NODE_9563_length_875_cov_33.771907	363	441	2	32	78	0.4102564
NODE_9563_length_875_cov_33.771907	363	441	3	22	78	0.2820513
NODE_9563_length_875_cov_33.771907	363	441	4	1	78	0.0128205
NODE_9563_length_875_cov_33.771907	363	441	5	23	78	0.2948718
NODE_9563_length_875_cov_33.771907	414	494	3	3	80	0.0375000
NODE_9563_length_875_cov_33.771907	414	494	4	22	80	0.2750000
NODE_9563_length_875_cov_33.771907	414	494	5	55	80	0.6875000
NODE_9564_length_875_cov_29.698454	322	402	2	52	80	0.6500000
NODE_9564_length_875_cov_29.698454	322	402	3	28	80	0.3500000
NODE_9564_length_875_cov_29.698454	375	455	2	31	80	0.3875000
NODE_9564_length_875_cov_29.698454	375	455	3	38	80	0.4750000
NODE_9564_length_875_cov_29.698454	375	455	4	11	80	0.1375000
NODE_9565_length_875_cov_23.041237	364	444	2	16	80	0.2000000
NODE_9565_length_875_cov_23.041237	364	444	3	49	80	0.6125000
NODE_9565_length_875_cov_23.041237	364	444	4	15	80	0.1875000
NODE_9565_length_875_cov_23.041237	417	497	3	14	80	0.1750000
NODE_9565_length_875_cov_23.041237	417	497	4	64	80	0.8000000
NODE_9565_length_875_cov_23.041237	417	497	5	2	80	0.0250000
NODE_9565_length_875_cov_23.041237	493	573	2	43	80	0.5375000
NODE_9565_length_875_cov_23.041237	493	573	3	35	80	0.4375000
NODE_9565_length_875_cov_23.041237	493	573	4	2	80	0.0250000
NODE_9565_length_875_cov_23.041237	546	626	2	39	80	0.4875000
NODE_9565_length_875_cov_23.041237	546	626	3	35	80	0.4375000
NODE_9565_length_875_cov_23.041237	546	626	4	6	80	0.0750000
NODE_9566_length_875_cov_9.800258	242	322	5	32	80	0.4000000
NODE_9566_length_875_cov_9.800258	242	322	6	22	80	0.2750000
NODE_9566_length_875_cov_9.800258	242	322	7	26	80	0.3250000
NODE_9566_length_875_cov_9.800258	295	376	2	2	81	0.0246914
NODE_9566_length_875_cov_9.800258	295	376	4	2	81	0.0246914
NODE_9566_length_875_cov_9.800258	295	376	5	54	81	0.6666667
NODE_9566_length_875_cov_9.800258	295	376	6	23	81	0.2839506
NODE_9567_length_875_cov_8.195876	407	487	1	41	80	0.5125000
NODE_9567_length_875_cov_8.195876	407	487	2	39	80	0.4875000
NODE_9567_length_875_cov_8.195876	460	540	0	20	80	0.2500000
NODE_9567_length_875_cov_8.195876	460	540	1	60	80	0.7500000
NODE_9585_length_874_cov_48.925161	185	265	5	2	80	0.0250000
NODE_9585_length_874_cov_48.925161	185	265	6	7	80	0.0875000
NODE_9585_length_874_cov_48.925161	185	265	7	5	80	0.0625000
NODE_9585_length_874_cov_48.925161	185	265	8	7	80	0.0875000
NODE_9585_length_874_cov_48.925161	185	265	9	52	80	0.6500000
NODE_9585_length_874_cov_48.925161	185	265	10	7	80	0.0875000
NODE_9585_length_874_cov_48.925161	238	318	7	22	80	0.2750000
NODE_9585_length_874_cov_48.925161	238	318	8	31	80	0.3875000
NODE_9585_length_874_cov_48.925161	238	318	9	20	80	0.2500000
NODE_9585_length_874_cov_48.925161	238	318	10	7	80	0.0875000
NODE_9587_length_874_cov_37.354839	199	279	6	54	80	0.6750000
NODE_9587_length_874_cov_37.354839	199	279	8	26	80	0.3250000
NODE_9587_length_874_cov_37.354839	252	332	4	51	80	0.6375000
NODE_9587_length_874_cov_37.354839	252	332	6	29	80	0.3625000
NODE_9588_length_874_cov_35.040000	231	311	7	4	80	0.0500000
NODE_9588_length_874_cov_35.040000	231	311	8	23	80	0.2875000
NODE_9588_length_874_cov_35.040000	231	311	9	39	80	0.4875000
NODE_9588_length_874_cov_35.040000	231	311	10	14	80	0.1750000
NODE_9588_length_874_cov_35.040000	284	364	7	42	80	0.5250000
NODE_9588_length_874_cov_35.040000	284	364	8	18	80	0.2250000
NODE_9588_length_874_cov_35.040000	284	364	9	6	80	0.0750000
NODE_9588_length_874_cov_35.040000	284	364	10	14	80	0.1750000
NODE_9589_length_874_cov_23.415484	327	407	0	34	80	0.4250000
NODE_9589_length_874_cov_23.415484	327	407	1	46	80	0.5750000
NODE_9589_length_874_cov_23.415484	380	460	1	39	80	0.4875000
NODE_9589_length_874_cov_23.415484	380	460	2	14	80	0.1750000
NODE_9589_length_874_cov_23.415484	380	460	3	22	80	0.2750000
NODE_9589_length_874_cov_23.415484	380	460	4	4	80	0.0500000
NODE_9589_length_874_cov_23.415484	380	460	5	1	80	0.0125000
NODE_9589_length_874_cov_23.415484	456	536	4	3	80	0.0375000
NODE_9589_length_874_cov_23.415484	456	536	5	6	80	0.0750000
NODE_9589_length_874_cov_23.415484	456	536	6	60	80	0.7500000
NODE_9589_length_874_cov_23.415484	456	536	7	11	80	0.1375000
NODE_9589_length_874_cov_23.415484	509	589	5	6	80	0.0750000
NODE_9589_length_874_cov_23.415484	509	589	6	33	80	0.4125000
NODE_9589_length_874_cov_23.415484	509	589	7	41	80	0.5125000
NODE_9590_length_874_cov_21.885161	279	359	3	80	80	1.0000000
NODE_9590_length_874_cov_21.885161	332	412	3	63	80	0.7875000
NODE_9590_length_874_cov_21.885161	332	412	4	17	80	0.2125000
NODE_9591_length_874_cov_11.172903	67	147	6	7	80	0.0875000
NODE_9591_length_874_cov_11.172903	67	147	8	73	80	0.9125000
NODE_9591_length_874_cov_11.172903	120	200	4	15	80	0.1875000
NODE_9591_length_874_cov_11.172903	120	200	6	33	80	0.4125000
NODE_9591_length_874_cov_11.172903	120	200	8	32	80	0.4000000
NODE_9592_length_874_cov_9.645161	424	504	0	22	80	0.2750000
NODE_9592_length_874_cov_9.645161	424	504	1	58	80	0.7250000
NODE_9592_length_874_cov_9.645161	477	557	1	30	80	0.3750000
NODE_9592_length_874_cov_9.645161	477	557	2	50	80	0.6250000
NODE_9593_length_874_cov_8.637419	359	439	0	80	80	1.0000000
NODE_9593_length_874_cov_8.637419	412	499	0	87	87	1.0000000
NODE_9596_length_874_cov_4.785806	829	874	0	45	45	1.0000000
NODE_9618_length_873_cov_100.625323	50	130	4	6	80	0.0750000
NODE_9618_length_873_cov_100.625323	50	130	6	2	80	0.0250000
NODE_9618_length_873_cov_100.625323	50	130	8	72	80	0.9000000
NODE_9619_length_873_cov_45.633075	226	306	5	35	80	0.4375000
NODE_9619_length_873_cov_45.633075	226	306	6	45	80	0.5625000
NODE_9619_length_873_cov_45.633075	279	359	4	1	80	0.0125000
NODE_9619_length_873_cov_45.633075	279	359	5	23	80	0.2875000
NODE_9619_length_873_cov_45.633075	279	359	6	18	80	0.2250000
NODE_9619_length_873_cov_45.633075	279	359	7	33	80	0.4125000
NODE_9619_length_873_cov_45.633075	279	359	8	5	80	0.0625000
NODE_9619_length_873_cov_45.633075	693	773	7	7	80	0.0875000
NODE_9619_length_873_cov_45.633075	693	773	8	8	80	0.1000000
NODE_9619_length_873_cov_45.633075	693	773	9	42	80	0.5250000
NODE_9619_length_873_cov_45.633075	693	773	10	11	80	0.1375000
NODE_9619_length_873_cov_45.633075	693	773	11	12	80	0.1500000
NODE_9619_length_873_cov_45.633075	746	826	6	32	80	0.4000000
NODE_9619_length_873_cov_45.633075	746	826	8	2	80	0.0250000
NODE_9619_length_873_cov_45.633075	746	826	9	38	80	0.4750000
NODE_9619_length_873_cov_45.633075	746	826	11	8	80	0.1000000
NODE_9620_length_873_cov_39.224806	190	270	0	21	80	0.2625000
NODE_9620_length_873_cov_39.224806	190	270	1	59	80	0.7375000
NODE_9620_length_873_cov_39.224806	243	307	0	2	64	0.0312500
NODE_9620_length_873_cov_39.224806	243	307	1	62	64	0.9687500
NODE_9620_length_873_cov_39.224806	390	470	0	74	80	0.9250000
NODE_9620_length_873_cov_39.224806	390	470	2	1	80	0.0125000
NODE_9620_length_873_cov_39.224806	390	470	3	5	80	0.0625000
NODE_9620_length_873_cov_39.224806	443	523	0	30	80	0.3750000
NODE_9620_length_873_cov_39.224806	443	523	1	7	80	0.0875000
NODE_9620_length_873_cov_39.224806	443	523	2	8	80	0.1000000
NODE_9620_length_873_cov_39.224806	443	523	3	12	80	0.1500000
NODE_9620_length_873_cov_39.224806	443	523	5	7	80	0.0875000
NODE_9620_length_873_cov_39.224806	443	523	6	16	80	0.2000000
NODE_9620_length_873_cov_39.224806	504	523	5	3	19	0.1578947
NODE_9620_length_873_cov_39.224806	504	523	6	16	19	0.8421053
NODE_9620_length_873_cov_39.224806	519	599	4	15	80	0.1875000
NODE_9620_length_873_cov_39.224806	519	599	6	65	80	0.8125000
NODE_9620_length_873_cov_39.224806	572	652	2	12	80	0.1500000
NODE_9620_length_873_cov_39.224806	572	652	3	8	80	0.1000000
NODE_9620_length_873_cov_39.224806	572	652	4	25	80	0.3125000
NODE_9620_length_873_cov_39.224806	572	652	5	23	80	0.2875000
NODE_9620_length_873_cov_39.224806	572	652	6	12	80	0.1500000
NODE_9621_length_873_cov_27.992248	372	452	0	2	80	0.0250000
NODE_9621_length_873_cov_27.992248	372	452	2	24	80	0.3000000
NODE_9621_length_873_cov_27.992248	372	452	3	54	80	0.6750000
NODE_9621_length_873_cov_27.992248	425	505	3	27	80	0.3375000
NODE_9621_length_873_cov_27.992248	425	505	4	53	80	0.6625000
NODE_9622_length_873_cov_23.270026	390	470	4	1	80	0.0125000
NODE_9622_length_873_cov_23.270026	390	470	5	34	80	0.4250000
NODE_9622_length_873_cov_23.270026	390	470	6	45	80	0.5625000
NODE_9622_length_873_cov_23.270026	443	528	3	35	85	0.4117647
NODE_9622_length_873_cov_23.270026	443	528	5	35	85	0.4117647
NODE_9622_length_873_cov_23.270026	443	528	6	15	85	0.1764706
NODE_9623_length_873_cov_23.197674	293	373	3	58	80	0.7250000
NODE_9623_length_873_cov_23.197674	293	373	4	21	80	0.2625000
NODE_9623_length_873_cov_23.197674	293	373	5	1	80	0.0125000
NODE_9623_length_873_cov_23.197674	346	426	3	5	80	0.0625000
NODE_9623_length_873_cov_23.197674	346	426	4	21	80	0.2625000
NODE_9623_length_873_cov_23.197674	346	426	5	5	80	0.0625000
NODE_9623_length_873_cov_23.197674	346	426	6	5	80	0.0625000
NODE_9623_length_873_cov_23.197674	346	426	7	18	80	0.2250000
NODE_9623_length_873_cov_23.197674	346	426	8	26	80	0.3250000
NODE_9624_length_873_cov_20.432817	347	427	0	80	80	1.0000000
NODE_9624_length_873_cov_20.432817	400	480	0	80	80	1.0000000
NODE_9624_length_873_cov_20.432817	476	556	0	80	80	1.0000000
NODE_9624_length_873_cov_20.432817	529	609	0	80	80	1.0000000
NODE_9625_length_873_cov_19.913437	445	525	5	19	80	0.2375000
NODE_9625_length_873_cov_19.913437	445	525	6	29	80	0.3625000
NODE_9625_length_873_cov_19.913437	445	525	7	32	80	0.4000000
NODE_9625_length_873_cov_19.913437	498	578	4	7	80	0.0875000
NODE_9625_length_873_cov_19.913437	498	578	5	40	80	0.5000000
NODE_9625_length_873_cov_19.913437	498	578	6	33	80	0.4125000
NODE_9626_length_873_cov_16.718346	276	356	0	32	80	0.4000000
NODE_9626_length_873_cov_16.718346	276	356	1	48	80	0.6000000
NODE_9626_length_873_cov_16.718346	329	409	1	80	80	1.0000000
NODE_9627_length_873_cov_16.422481	423	503	2	45	80	0.5625000
NODE_9627_length_873_cov_16.422481	423	503	4	15	80	0.1875000
NODE_9627_length_873_cov_16.422481	423	503	6	20	80	0.2500000
NODE_9627_length_873_cov_16.422481	476	556	2	14	80	0.1750000
NODE_9627_length_873_cov_16.422481	476	556	4	7	80	0.0875000
NODE_9627_length_873_cov_16.422481	476	556	6	59	80	0.7375000
NODE_9628_length_873_cov_11.198966	410	490	2	15	80	0.1875000
NODE_9628_length_873_cov_11.198966	410	490	3	36	80	0.4500000
NODE_9628_length_873_cov_11.198966	410	490	4	29	80	0.3625000
NODE_9628_length_873_cov_11.198966	463	543	1	2	80	0.0250000
NODE_9628_length_873_cov_11.198966	463	543	2	12	80	0.1500000
NODE_9628_length_873_cov_11.198966	463	543	3	53	80	0.6625000
NODE_9628_length_873_cov_11.198966	463	543	4	13	80	0.1625000
NODE_9629_length_873_cov_9.799742	334	414	3	1	80	0.0125000
NODE_9629_length_873_cov_9.799742	334	414	4	8	80	0.1000000
NODE_9629_length_873_cov_9.799742	334	414	5	7	80	0.0875000
NODE_9629_length_873_cov_9.799742	334	414	7	11	80	0.1375000
NODE_9629_length_873_cov_9.799742	334	414	8	53	80	0.6625000
NODE_9629_length_873_cov_9.799742	387	467	4	4	80	0.0500000
NODE_9629_length_873_cov_9.799742	387	467	6	5	80	0.0625000
NODE_9629_length_873_cov_9.799742	387	467	7	10	80	0.1250000
NODE_9629_length_873_cov_9.799742	387	467	8	61	80	0.7625000
NODE_9632_length_873_cov_3.828165	490	570	0	80	80	1.0000000
NODE_9632_length_873_cov_3.828165	543	583	0	40	40	1.0000000
NODE_9632_length_873_cov_3.828165	690	735	2	44	45	0.9777778
NODE_9632_length_873_cov_3.828165	690	735	4	1	45	0.0222222
NODE_9633_length_873_cov_3.443152	716	746	0	1	30	0.0333333
NODE_9633_length_873_cov_3.443152	716	746	1	29	30	0.9666666
NODE_9647_length_873_cov_1.239018	593	658	0	65	65	1.0000000
NODE_9651_length_872_cov_47.732212	432	512	4	32	80	0.4000000
NODE_9651_length_872_cov_47.732212	432	512	5	39	80	0.4875000
NODE_9651_length_872_cov_47.732212	432	512	6	6	80	0.0750000
NODE_9651_length_872_cov_47.732212	432	512	7	3	80	0.0375000
NODE_9651_length_872_cov_47.732212	484	564	4	13	80	0.1625000
NODE_9651_length_872_cov_47.732212	484	564	5	7	80	0.0875000
NODE_9651_length_872_cov_47.732212	484	564	6	25	80	0.3125000
NODE_9651_length_872_cov_47.732212	484	564	7	24	80	0.3000000
NODE_9651_length_872_cov_47.732212	484	564	9	5	80	0.0625000
NODE_9651_length_872_cov_47.732212	484	564	11	6	80	0.0750000
NODE_9651_length_872_cov_47.732212	560	640	10	5	80	0.0625000
NODE_9651_length_872_cov_47.732212	560	640	11	27	80	0.3375000
NODE_9651_length_872_cov_47.732212	560	640	12	19	80	0.2375000
NODE_9651_length_872_cov_47.732212	560	640	13	4	80	0.0500000
NODE_9651_length_872_cov_47.732212	560	640	14	16	80	0.2000000
NODE_9651_length_872_cov_47.732212	560	640	15	9	80	0.1125000
NODE_9651_length_872_cov_47.732212	613	693	9	4	80	0.0500000
NODE_9651_length_872_cov_47.732212	613	693	10	8	80	0.1000000
NODE_9651_length_872_cov_47.732212	613	693	11	2	80	0.0250000
NODE_9651_length_872_cov_47.732212	613	693	12	22	80	0.2750000
NODE_9651_length_872_cov_47.732212	613	693	13	5	80	0.0625000
NODE_9651_length_872_cov_47.732212	613	693	14	23	80	0.2875000
NODE_9651_length_872_cov_47.732212	613	693	15	16	80	0.2000000
NODE_9652_length_872_cov_16.204398	349	429	0	20	80	0.2500000
NODE_9652_length_872_cov_16.204398	349	429	2	2	80	0.0250000
NODE_9652_length_872_cov_16.204398	349	429	3	17	80	0.2125000
NODE_9652_length_872_cov_16.204398	349	429	4	19	80	0.2375000
NODE_9652_length_872_cov_16.204398	349	429	5	22	80	0.2750000
NODE_9652_length_872_cov_16.204398	402	482	3	18	80	0.2250000
NODE_9652_length_872_cov_16.204398	402	482	4	5	80	0.0625000
NODE_9652_length_872_cov_16.204398	402	482	5	57	80	0.7125000
NODE_9652_length_872_cov_16.204398	478	558	3	4	80	0.0500000
NODE_9652_length_872_cov_16.204398	478	558	4	52	80	0.6500000
NODE_9652_length_872_cov_16.204398	478	558	5	24	80	0.3000000
NODE_9652_length_872_cov_16.204398	531	611	4	36	80	0.4500000
NODE_9652_length_872_cov_16.204398	531	611	5	44	80	0.5500000
NODE_9653_length_872_cov_12.835705	376	456	2	11	80	0.1375000
NODE_9653_length_872_cov_12.835705	376	456	3	4	80	0.0500000
NODE_9653_length_872_cov_12.835705	376	456	4	65	80	0.8125000
NODE_9653_length_872_cov_12.835705	429	509	2	64	80	0.8000000
NODE_9653_length_872_cov_12.835705	429	509	4	16	80	0.2000000
NODE_9654_length_872_cov_9.657180	356	431	0	75	75	1.0000000
NODE_9660_length_872_cov_3.531695	425	505	0	80	80	1.0000000
NODE_9660_length_872_cov_3.531695	478	559	0	81	81	1.0000000
NODE_9673_length_871_cov_56.841969	265	345	1	23	80	0.2875000
NODE_9673_length_871_cov_56.841969	265	345	2	57	80	0.7125000
NODE_9673_length_871_cov_56.841969	318	398	2	28	80	0.3500000
NODE_9673_length_871_cov_56.841969	318	398	3	11	80	0.1375000
NODE_9673_length_871_cov_56.841969	318	398	4	1	80	0.0125000
NODE_9673_length_871_cov_56.841969	318	398	6	22	80	0.2750000
NODE_9673_length_871_cov_56.841969	318	398	7	4	80	0.0500000
NODE_9673_length_871_cov_56.841969	318	398	8	14	80	0.1750000
NODE_9673_length_871_cov_56.841969	394	474	8	8	80	0.1000000
NODE_9673_length_871_cov_56.841969	394	474	9	60	80	0.7500000
NODE_9673_length_871_cov_56.841969	394	474	10	12	80	0.1500000
NODE_9673_length_871_cov_56.841969	447	527	0	20	80	0.2500000
NODE_9673_length_871_cov_56.841969	447	527	1	1	80	0.0125000
NODE_9673_length_871_cov_56.841969	447	527	6	10	80	0.1250000
NODE_9673_length_871_cov_56.841969	447	527	7	22	80	0.2750000
NODE_9673_length_871_cov_56.841969	447	527	9	27	80	0.3375000
NODE_9674_length_871_cov_47.528497	461	541	2	2	80	0.0250000
NODE_9674_length_871_cov_47.528497	461	541	4	2	80	0.0250000
NODE_9674_length_871_cov_47.528497	461	541	5	13	80	0.1625000
NODE_9674_length_871_cov_47.528497	461	541	6	7	80	0.0875000
NODE_9674_length_871_cov_47.528497	461	541	7	2	80	0.0250000
NODE_9674_length_871_cov_47.528497	461	541	8	34	80	0.4250000
NODE_9674_length_871_cov_47.528497	461	541	9	20	80	0.2500000
NODE_9674_length_871_cov_47.528497	514	594	5	35	80	0.4375000
NODE_9674_length_871_cov_47.528497	514	594	7	10	80	0.1250000
NODE_9674_length_871_cov_47.528497	514	594	8	7	80	0.0875000
NODE_9674_length_871_cov_47.528497	514	594	9	28	80	0.3500000
NODE_9675_length_871_cov_31.145078	326	406	0	20	80	0.2500000
NODE_9675_length_871_cov_31.145078	326	406	1	16	80	0.2000000
NODE_9675_length_871_cov_31.145078	326	406	2	21	80	0.2625000
NODE_9675_length_871_cov_31.145078	326	406	3	23	80	0.2875000
NODE_9675_length_871_cov_31.145078	379	459	1	4	80	0.0500000
NODE_9675_length_871_cov_31.145078	379	459	2	11	80	0.1375000
NODE_9675_length_871_cov_31.145078	379	459	3	32	80	0.4000000
NODE_9675_length_871_cov_31.145078	379	459	4	33	80	0.4125000
NODE_9676_length_871_cov_27.993523	379	459	7	9	80	0.1125000
NODE_9676_length_871_cov_27.993523	379	459	9	3	80	0.0375000
NODE_9676_length_871_cov_27.993523	379	459	10	4	80	0.0500000
NODE_9676_length_871_cov_27.993523	379	459	12	6	80	0.0750000
NODE_9676_length_871_cov_27.993523	379	459	14	3	80	0.0375000
NODE_9676_length_871_cov_27.993523	379	459	16	32	80	0.4000000
NODE_9676_length_871_cov_27.993523	379	459	20	23	80	0.2875000
NODE_9676_length_871_cov_27.993523	432	512	8	4	80	0.0500000
NODE_9676_length_871_cov_27.993523	432	512	10	6	80	0.0750000
NODE_9676_length_871_cov_27.993523	432	512	12	4	80	0.0500000
NODE_9676_length_871_cov_27.993523	432	512	14	10	80	0.1250000
NODE_9676_length_871_cov_27.993523	432	512	16	7	80	0.0875000
NODE_9676_length_871_cov_27.993523	432	512	20	49	80	0.6125000
NODE_9677_length_871_cov_25.954663	463	543	3	64	80	0.8000000
NODE_9677_length_871_cov_25.954663	463	543	4	16	80	0.2000000
NODE_9677_length_871_cov_25.954663	516	596	0	40	80	0.5000000
NODE_9677_length_871_cov_25.954663	516	596	2	13	80	0.1625000
NODE_9677_length_871_cov_25.954663	516	596	3	27	80	0.3375000
NODE_9678_length_871_cov_24.069948	492	558	3	13	66	0.1969697
NODE_9678_length_871_cov_24.069948	492	558	4	11	66	0.1666667
NODE_9678_length_871_cov_24.069948	492	558	5	3	66	0.0454545
NODE_9678_length_871_cov_24.069948	492	558	6	39	66	0.5909091
NODE_9678_length_871_cov_24.069948	558	634	3	2	76	0.0263158
NODE_9678_length_871_cov_24.069948	558	634	4	36	76	0.4736842
NODE_9678_length_871_cov_24.069948	558	634	5	38	76	0.5000000
NODE_9679_length_871_cov_23.953368	445	522	2	46	77	0.5974026
NODE_9679_length_871_cov_23.953368	445	522	3	13	77	0.1688312
NODE_9679_length_871_cov_23.953368	445	522	4	4	77	0.0519481
NODE_9679_length_871_cov_23.953368	445	522	5	14	77	0.1818182
NODE_9680_length_871_cov_19.304404	335	415	4	80	80	1.0000000
NODE_9680_length_871_cov_19.304404	388	468	0	17	80	0.2125000
NODE_9680_length_871_cov_19.304404	388	468	1	2	80	0.0250000
NODE_9680_length_871_cov_19.304404	388	468	2	13	80	0.1625000
NODE_9680_length_871_cov_19.304404	388	468	4	48	80	0.6000000
NODE_9682_length_871_cov_18.108808	370	450	0	5	80	0.0625000
NODE_9682_length_871_cov_18.108808	370	450	2	75	80	0.9375000
NODE_9682_length_871_cov_18.108808	423	503	2	44	80	0.5500000
NODE_9682_length_871_cov_18.108808	423	503	4	36	80	0.4500000
NODE_9683_length_871_cov_17.034974	362	442	0	80	80	1.0000000
NODE_9683_length_871_cov_17.034974	415	495	0	80	80	1.0000000
NODE_9684_length_871_cov_16.768135	374	454	2	80	80	1.0000000
NODE_9685_length_871_cov_14.196891	267	347	1	17	80	0.2125000
NODE_9685_length_871_cov_14.196891	267	347	2	63	80	0.7875000
NODE_9685_length_871_cov_14.196891	320	400	2	80	80	1.0000000
NODE_9686_length_871_cov_13.443005	246	326	4	14	80	0.1750000
NODE_9686_length_871_cov_13.443005	246	326	5	7	80	0.0875000
NODE_9686_length_871_cov_13.443005	246	326	6	2	80	0.0250000
NODE_9686_length_871_cov_13.443005	246	326	7	8	80	0.1000000
NODE_9686_length_871_cov_13.443005	246	326	8	16	80	0.2000000
NODE_9686_length_871_cov_13.443005	246	326	9	33	80	0.4125000
NODE_9686_length_871_cov_13.443005	299	322	4	10	23	0.4347826
NODE_9686_length_871_cov_13.443005	299	322	5	7	23	0.3043478
NODE_9686_length_871_cov_13.443005	299	322	6	2	23	0.0869565
NODE_9686_length_871_cov_13.443005	299	322	7	4	23	0.1739130
NODE_9687_length_871_cov_11.839378	29	109	0	29	80	0.3625000
NODE_9687_length_871_cov_11.839378	29	109	2	51	80	0.6375000
NODE_9687_length_871_cov_11.839378	82	149	2	67	67	1.0000000
NODE_9687_length_871_cov_11.839378	331	411	2	2	80	0.0250000
NODE_9687_length_871_cov_11.839378	331	411	4	48	80	0.6000000
NODE_9687_length_871_cov_11.839378	331	411	5	3	80	0.0375000
NODE_9687_length_871_cov_11.839378	331	411	6	27	80	0.3375000
NODE_9687_length_871_cov_11.839378	384	464	3	14	80	0.1750000
NODE_9687_length_871_cov_11.839378	384	464	5	4	80	0.0500000
NODE_9687_length_871_cov_11.839378	384	464	6	62	80	0.7750000
NODE_9689_length_871_cov_5.730570	316	373	0	45	57	0.7894737
NODE_9689_length_871_cov_5.730570	316	373	2	12	57	0.2105263
NODE_9694_length_871_cov_3.544041	428	508	1	33	80	0.4125000
NODE_9694_length_871_cov_3.544041	428	508	2	47	80	0.5875000
NODE_9694_length_871_cov_3.544041	481	561	1	40	80	0.5000000
NODE_9694_length_871_cov_3.544041	481	561	2	40	80	0.5000000
NODE_9716_length_870_cov_43.400778	542	622	8	8	80	0.1000000
NODE_9716_length_870_cov_43.400778	542	622	9	17	80	0.2125000
NODE_9716_length_870_cov_43.400778	542	622	10	5	80	0.0625000
NODE_9716_length_870_cov_43.400778	542	622	11	2	80	0.0250000
NODE_9716_length_870_cov_43.400778	542	622	12	1	80	0.0125000
NODE_9716_length_870_cov_43.400778	542	622	14	16	80	0.2000000
NODE_9716_length_870_cov_43.400778	542	622	15	22	80	0.2750000
NODE_9716_length_870_cov_43.400778	542	622	17	9	80	0.1125000
NODE_9716_length_870_cov_43.400778	595	675	11	10	80	0.1250000
NODE_9716_length_870_cov_43.400778	595	675	13	1	80	0.0125000
NODE_9716_length_870_cov_43.400778	595	675	14	11	80	0.1375000
NODE_9716_length_870_cov_43.400778	595	675	15	32	80	0.4000000
NODE_9716_length_870_cov_43.400778	595	675	16	2	80	0.0250000
NODE_9716_length_870_cov_43.400778	595	675	17	24	80	0.3000000
NODE_9719_length_870_cov_28.249027	442	524	9	14	82	0.1707317
NODE_9719_length_870_cov_28.249027	442	524	10	21	82	0.2560976
NODE_9719_length_870_cov_28.249027	442	524	11	16	82	0.1951219
NODE_9719_length_870_cov_28.249027	442	524	12	31	82	0.3780488
NODE_9719_length_870_cov_28.249027	497	577	8	2	80	0.0250000
NODE_9719_length_870_cov_28.249027	497	577	9	3	80	0.0375000
NODE_9719_length_870_cov_28.249027	497	577	10	4	80	0.0500000
NODE_9719_length_870_cov_28.249027	497	577	11	37	80	0.4625000
NODE_9719_length_870_cov_28.249027	497	577	12	34	80	0.4250000
NODE_9720_length_870_cov_26.992218	240	320	3	45	80	0.5625000
NODE_9720_length_870_cov_26.992218	240	320	4	35	80	0.4375000
NODE_9720_length_870_cov_26.992218	293	373	3	56	80	0.7000000
NODE_9720_length_870_cov_26.992218	293	373	4	24	80	0.3000000
NODE_9720_length_870_cov_26.992218	369	449	1	2	80	0.0250000
NODE_9720_length_870_cov_26.992218	369	449	2	34	80	0.4250000
NODE_9720_length_870_cov_26.992218	369	449	3	44	80	0.5500000
NODE_9720_length_870_cov_26.992218	422	502	3	68	80	0.8500000
NODE_9720_length_870_cov_26.992218	422	502	4	12	80	0.1500000
NODE_9721_length_870_cov_25.806744	186	237	0	39	51	0.7647059
NODE_9721_length_870_cov_25.806744	186	237	2	10	51	0.1960784
NODE_9721_length_870_cov_25.806744	186	237	3	2	51	0.0392157
NODE_9721_length_870_cov_25.806744	391	471	0	3	80	0.0375000
NODE_9721_length_870_cov_25.806744	391	471	1	35	80	0.4375000
NODE_9721_length_870_cov_25.806744	391	471	2	10	80	0.1250000
NODE_9721_length_870_cov_25.806744	391	471	6	11	80	0.1375000
NODE_9721_length_870_cov_25.806744	391	471	7	21	80	0.2625000
NODE_9721_length_870_cov_25.806744	444	524	6	6	80	0.0750000
NODE_9721_length_870_cov_25.806744	444	524	7	61	80	0.7625000
NODE_9721_length_870_cov_25.806744	444	524	8	13	80	0.1625000
NODE_9722_length_870_cov_18.862516	345	425	1	18	80	0.2250000
NODE_9722_length_870_cov_18.862516	345	425	3	5	80	0.0625000
NODE_9722_length_870_cov_18.862516	345	425	4	1	80	0.0125000
NODE_9722_length_870_cov_18.862516	345	425	5	16	80	0.2000000
NODE_9722_length_870_cov_18.862516	345	425	6	1	80	0.0125000
NODE_9722_length_870_cov_18.862516	345	425	7	39	80	0.4875000
NODE_9722_length_870_cov_18.862516	398	478	3	2	80	0.0250000
NODE_9722_length_870_cov_18.862516	398	478	5	26	80	0.3250000
NODE_9722_length_870_cov_18.862516	398	478	6	1	80	0.0125000
NODE_9722_length_870_cov_18.862516	398	478	7	51	80	0.6375000
NODE_9723_length_870_cov_15.686122	330	410	6	15	80	0.1875000
NODE_9723_length_870_cov_15.686122	330	410	8	65	80	0.8125000
NODE_9723_length_870_cov_15.686122	383	463	5	45	80	0.5625000
NODE_9723_length_870_cov_15.686122	383	463	6	18	80	0.2250000
NODE_9723_length_870_cov_15.686122	383	463	8	17	80	0.2125000
NODE_9725_length_870_cov_13.334630	479	559	4	7	80	0.0875000
NODE_9725_length_870_cov_13.334630	479	559	6	22	80	0.2750000
NODE_9725_length_870_cov_13.334630	479	559	7	9	80	0.1125000
NODE_9725_length_870_cov_13.334630	479	559	8	29	80	0.3625000
NODE_9725_length_870_cov_13.334630	479	559	9	13	80	0.1625000
NODE_9725_length_870_cov_13.334630	532	612	4	1	80	0.0125000
NODE_9725_length_870_cov_13.334630	532	612	6	24	80	0.3000000
NODE_9725_length_870_cov_13.334630	532	612	7	7	80	0.0875000
NODE_9725_length_870_cov_13.334630	532	612	8	35	80	0.4375000
NODE_9725_length_870_cov_13.334630	532	612	9	13	80	0.1625000
NODE_9726_length_870_cov_9.712062	410	490	0	80	80	1.0000000
NODE_9726_length_870_cov_9.712062	463	542	0	79	79	1.0000000
NODE_9728_length_870_cov_7.556420	448	528	0	80	80	1.0000000
NODE_9728_length_870_cov_7.556420	501	581	0	80	80	1.0000000
NODE_9746_length_869_cov_42.784416	395	475	10	5	80	0.0625000
NODE_9746_length_869_cov_42.784416	395	475	11	7	80	0.0875000
NODE_9746_length_869_cov_42.784416	395	475	12	12	80	0.1500000
NODE_9746_length_869_cov_42.784416	395	475	13	5	80	0.0625000
NODE_9746_length_869_cov_42.784416	395	475	14	1	80	0.0125000
NODE_9746_length_869_cov_42.784416	395	475	15	36	80	0.4500000
NODE_9746_length_869_cov_42.784416	395	475	17	14	80	0.1750000
NODE_9746_length_869_cov_42.784416	448	528	10	14	80	0.1750000
NODE_9746_length_869_cov_42.784416	448	528	11	14	80	0.1750000
NODE_9746_length_869_cov_42.784416	448	528	12	12	80	0.1500000
NODE_9746_length_869_cov_42.784416	448	528	14	14	80	0.1750000
NODE_9746_length_869_cov_42.784416	448	528	15	26	80	0.3250000
NODE_9747_length_869_cov_29.525974	211	291	8	38	80	0.4750000
NODE_9747_length_869_cov_29.525974	211	291	9	42	80	0.5250000
NODE_9747_length_869_cov_29.525974	264	344	5	2	80	0.0250000
NODE_9747_length_869_cov_29.525974	264	344	6	33	80	0.4125000
NODE_9747_length_869_cov_29.525974	264	344	7	16	80	0.2000000
NODE_9747_length_869_cov_29.525974	264	344	8	14	80	0.1750000
NODE_9747_length_869_cov_29.525974	264	344	9	15	80	0.1875000
NODE_9748_length_869_cov_16.258442	389	469	7	65	80	0.8125000
NODE_9748_length_869_cov_16.258442	389	469	8	15	80	0.1875000
NODE_9748_length_869_cov_16.258442	442	522	0	15	80	0.1875000
NODE_9748_length_869_cov_16.258442	442	522	1	1	80	0.0125000
NODE_9748_length_869_cov_16.258442	442	522	3	22	80	0.2750000
NODE_9748_length_869_cov_16.258442	442	522	4	4	80	0.0500000
NODE_9748_length_869_cov_16.258442	442	522	5	10	80	0.1250000
NODE_9748_length_869_cov_16.258442	442	522	6	1	80	0.0125000
NODE_9748_length_869_cov_16.258442	442	522	7	27	80	0.3375000
NODE_9749_length_869_cov_15.940260	321	401	3	10	80	0.1250000
NODE_9749_length_869_cov_15.940260	321	401	4	7	80	0.0875000
NODE_9749_length_869_cov_15.940260	321	401	5	63	80	0.7875000
NODE_9749_length_869_cov_15.940260	374	454	3	16	80	0.2000000
NODE_9749_length_869_cov_15.940260	374	454	5	64	80	0.8000000
NODE_9750_length_869_cov_9.619481	402	442	29	2	40	0.0500000
NODE_9750_length_869_cov_9.619481	402	442	31	7	40	0.1750000
NODE_9750_length_869_cov_9.619481	402	442	32	6	40	0.1500000
NODE_9750_length_869_cov_9.619481	402	442	33	17	40	0.4250000
NODE_9750_length_869_cov_9.619481	402	442	34	2	40	0.0500000
NODE_9750_length_869_cov_9.619481	402	442	35	3	40	0.0750000
NODE_9750_length_869_cov_9.619481	402	442	36	2	40	0.0500000
NODE_9750_length_869_cov_9.619481	402	442	37	1	40	0.0250000
NODE_9751_length_869_cov_7.123377	392	472	2	80	80	1.0000000
NODE_9751_length_869_cov_7.123377	445	525	1	42	80	0.5250000
NODE_9751_length_869_cov_7.123377	445	525	2	38	80	0.4750000
NODE_9753_length_869_cov_3.658442	310	378	0	68	68	1.0000000
NODE_9777_length_868_cov_57.465540	355	435	1	10	80	0.1250000
NODE_9777_length_868_cov_57.465540	355	435	3	2	80	0.0250000
NODE_9777_length_868_cov_57.465540	355	435	5	48	80	0.6000000
NODE_9777_length_868_cov_57.465540	355	435	6	4	80	0.0500000
NODE_9777_length_868_cov_57.465540	355	435	7	16	80	0.2000000
NODE_9778_length_868_cov_46.509753	0	65	0	13	65	0.2000000
NODE_9778_length_868_cov_46.509753	0	65	2	52	65	0.8000000
NODE_9778_length_868_cov_46.509753	0	65	0	13	65	0.2000000
NODE_9778_length_868_cov_46.509753	0	65	2	52	65	0.8000000
NODE_9778_length_868_cov_46.509753	0	65	0	13	65	0.2000000
NODE_9778_length_868_cov_46.509753	0	65	2	52	65	0.8000000
NODE_9778_length_868_cov_46.509753	0	65	0	13	65	0.2000000
NODE_9778_length_868_cov_46.509753	0	65	2	52	65	0.8000000
NODE_9778_length_868_cov_46.509753	61	141	0	28	80	0.3500000
NODE_9778_length_868_cov_46.509753	61	141	2	52	80	0.6500000
NODE_9778_length_868_cov_46.509753	61	141	0	28	80	0.3500000
NODE_9778_length_868_cov_46.509753	61	141	2	52	80	0.6500000
NODE_9778_length_868_cov_46.509753	114	194	0	80	80	1.0000000
NODE_9778_length_868_cov_46.509753	114	194	0	80	80	1.0000000
NODE_9779_length_868_cov_26.092328	318	398	6	34	80	0.4250000
NODE_9779_length_868_cov_26.092328	318	398	8	46	80	0.5750000
NODE_9779_length_868_cov_26.092328	371	451	5	36	80	0.4500000
NODE_9779_length_868_cov_26.092328	371	451	6	10	80	0.1250000
NODE_9779_length_868_cov_26.092328	371	451	8	34	80	0.4250000
NODE_9781_length_868_cov_22.555267	377	457	4	30	80	0.3750000
NODE_9781_length_868_cov_22.555267	377	457	5	23	80	0.2875000
NODE_9781_length_868_cov_22.555267	377	457	6	19	80	0.2375000
NODE_9781_length_868_cov_22.555267	377	457	7	8	80	0.1000000
NODE_9781_length_868_cov_22.555267	430	510	4	6	80	0.0750000
NODE_9781_length_868_cov_22.555267	430	510	5	55	80	0.6875000
NODE_9781_length_868_cov_22.555267	430	510	6	11	80	0.1375000
NODE_9781_length_868_cov_22.555267	430	510	7	8	80	0.1000000
NODE_9782_length_868_cov_20.466840	259	339	0	5	80	0.0625000
NODE_9782_length_868_cov_20.466840	259	339	1	75	80	0.9375000
NODE_9782_length_868_cov_20.466840	312	392	0	24	80	0.3000000
NODE_9782_length_868_cov_20.466840	312	392	1	42	80	0.5250000
NODE_9782_length_868_cov_20.466840	312	392	3	9	80	0.1125000
NODE_9782_length_868_cov_20.466840	312	392	4	5	80	0.0625000
NODE_9782_length_868_cov_20.466840	388	468	4	12	80	0.1500000
NODE_9782_length_868_cov_20.466840	388	468	5	19	80	0.2375000
NODE_9782_length_868_cov_20.466840	388	468	7	14	80	0.1750000
NODE_9782_length_868_cov_20.466840	388	468	8	19	80	0.2375000
NODE_9782_length_868_cov_20.466840	388	468	11	1	80	0.0125000
NODE_9782_length_868_cov_20.466840	388	468	12	3	80	0.0375000
NODE_9782_length_868_cov_20.466840	388	468	13	12	80	0.1500000
NODE_9782_length_868_cov_20.466840	441	521	8	24	80	0.3000000
NODE_9782_length_868_cov_20.466840	441	521	9	30	80	0.3750000
NODE_9782_length_868_cov_20.466840	441	521	11	2	80	0.0250000
NODE_9782_length_868_cov_20.466840	441	521	12	3	80	0.0375000
NODE_9782_length_868_cov_20.466840	441	521	13	21	80	0.2625000
NODE_9783_length_868_cov_20.414824	311	391	1	80	80	1.0000000
NODE_9783_length_868_cov_20.414824	364	444	1	47	80	0.5875000
NODE_9783_length_868_cov_20.414824	364	444	2	33	80	0.4125000
NODE_9784_length_868_cov_17.613784	340	420	2	72	80	0.9000000
NODE_9784_length_868_cov_17.613784	340	420	3	8	80	0.1000000
NODE_9784_length_868_cov_17.613784	393	473	0	33	80	0.4125000
NODE_9784_length_868_cov_17.613784	393	473	2	47	80	0.5875000
NODE_9785_length_868_cov_15.768531	353	433	0	80	80	1.0000000
NODE_9785_length_868_cov_15.768531	406	486	0	80	80	1.0000000
NODE_9786_length_868_cov_13.997399	611	691	7	30	80	0.3750000
NODE_9786_length_868_cov_13.997399	611	691	8	50	80	0.6250000
NODE_9786_length_868_cov_13.997399	664	744	4	10	80	0.1250000
NODE_9786_length_868_cov_13.997399	664	744	5	5	80	0.0625000
NODE_9786_length_868_cov_13.997399	664	744	7	56	80	0.7000000
NODE_9786_length_868_cov_13.997399	664	744	8	9	80	0.1125000
NODE_9787_length_868_cov_13.224967	451	531	4	31	80	0.3875000
NODE_9787_length_868_cov_13.224967	451	531	6	31	80	0.3875000
NODE_9787_length_868_cov_13.224967	451	531	7	11	80	0.1375000
NODE_9787_length_868_cov_13.224967	451	531	8	7	80	0.0875000
NODE_9787_length_868_cov_13.224967	504	583	6	20	79	0.2531646
NODE_9787_length_868_cov_13.224967	504	583	7	45	79	0.5696203
NODE_9787_length_868_cov_13.224967	504	583	8	14	79	0.1772152
NODE_9788_length_868_cov_11.851756	363	422	0	59	59	1.0000000
NODE_9788_length_868_cov_11.851756	395	475	0	80	80	1.0000000
NODE_9789_length_868_cov_11.352406	361	441	2	80	80	1.0000000
NODE_9789_length_868_cov_11.352406	414	494	0	7	80	0.0875000
NODE_9789_length_868_cov_11.352406	414	494	1	21	80	0.2625000
NODE_9789_length_868_cov_11.352406	414	494	2	52	80	0.6500000
NODE_9790_length_868_cov_11.335501	289	369	2	2	80	0.0250000
NODE_9790_length_868_cov_11.335501	289	369	4	78	80	0.9750000
NODE_9790_length_868_cov_11.335501	342	422	0	22	80	0.2750000
NODE_9790_length_868_cov_11.335501	342	422	1	1	80	0.0125000
NODE_9790_length_868_cov_11.335501	342	422	2	18	80	0.2250000
NODE_9790_length_868_cov_11.335501	342	422	4	39	80	0.4875000
NODE_9791_length_868_cov_8.455137	401	481	1	80	80	1.0000000
NODE_9791_length_868_cov_8.455137	454	534	1	80	80	1.0000000
NODE_9816_length_867_cov_27.756510	333	376	0	3	43	0.0697674
NODE_9816_length_867_cov_27.756510	333	376	1	40	43	0.9302326
NODE_9816_length_867_cov_27.756510	349	429	1	80	80	1.0000000
NODE_9816_length_867_cov_27.756510	425	505	1	8	80	0.1000000
NODE_9816_length_867_cov_27.756510	425	505	2	32	80	0.4000000
NODE_9816_length_867_cov_27.756510	425	505	3	40	80	0.5000000
NODE_9816_length_867_cov_27.756510	478	542	2	46	64	0.7187500
NODE_9816_length_867_cov_27.756510	478	542	3	18	64	0.2812500
NODE_9817_length_867_cov_25.354167	280	345	0	65	65	1.0000000
NODE_9817_length_867_cov_25.354167	325	397	0	72	72	1.0000000
NODE_9818_length_867_cov_23.968750	369	449	9	6	80	0.0750000
NODE_9818_length_867_cov_23.968750	369	449	11	1	80	0.0125000
NODE_9818_length_867_cov_23.968750	369	449	12	40	80	0.5000000
NODE_9818_length_867_cov_23.968750	369	449	13	14	80	0.1750000
NODE_9818_length_867_cov_23.968750	369	449	14	19	80	0.2375000
NODE_9818_length_867_cov_23.968750	422	502	6	9	80	0.1125000
NODE_9818_length_867_cov_23.968750	422	502	8	2	80	0.0250000
NODE_9818_length_867_cov_23.968750	422	502	9	20	80	0.2500000
NODE_9818_length_867_cov_23.968750	422	502	10	11	80	0.1375000
NODE_9818_length_867_cov_23.968750	422	502	11	12	80	0.1500000
NODE_9818_length_867_cov_23.968750	422	502	12	4	80	0.0500000
NODE_9818_length_867_cov_23.968750	422	502	13	13	80	0.1625000
NODE_9818_length_867_cov_23.968750	422	502	14	9	80	0.1125000
NODE_9819_length_867_cov_21.220052	524	604	2	50	80	0.6250000
NODE_9819_length_867_cov_21.220052	524	604	3	8	80	0.1000000
NODE_9819_length_867_cov_21.220052	524	604	5	22	80	0.2750000
NODE_9819_length_867_cov_21.220052	577	657	2	5	80	0.0625000
NODE_9819_length_867_cov_21.220052	577	657	5	75	80	0.9375000
NODE_9820_length_867_cov_15.042969	287	364	0	10	77	0.1298701
NODE_9820_length_867_cov_15.042969	287	364	2	67	77	0.8701299
NODE_9821_length_867_cov_11.057292	305	373	5	27	68	0.3970588
NODE_9821_length_867_cov_11.057292	305	373	6	41	68	0.6029412
NODE_9821_length_867_cov_11.057292	346	426	5	29	80	0.3625000
NODE_9821_length_867_cov_11.057292	346	426	6	51	80	0.6375000
NODE_9821_length_867_cov_11.057292	475	555	0	73	80	0.9125000
NODE_9821_length_867_cov_11.057292	475	555	1	7	80	0.0875000
NODE_9822_length_867_cov_8.127604	347	427	2	80	80	1.0000000
NODE_9822_length_867_cov_8.127604	400	480	0	25	80	0.3125000
NODE_9822_length_867_cov_8.127604	400	480	1	28	80	0.3500000
NODE_9822_length_867_cov_8.127604	400	480	2	27	80	0.3375000
NODE_9823_length_867_cov_7.621094	292	372	0	80	80	1.0000000
NODE_9823_length_867_cov_7.621094	345	425	0	55	80	0.6875000
NODE_9823_length_867_cov_7.621094	345	425	2	25	80	0.3125000
NODE_9826_length_867_cov_5.494792	445	525	0	80	80	1.0000000
NODE_9826_length_867_cov_5.494792	498	578	0	80	80	1.0000000
NODE_9857_length_866_cov_49.224250	269	349	0	80	80	1.0000000
NODE_9857_length_866_cov_49.224250	322	402	0	80	80	1.0000000
NODE_9858_length_866_cov_47.160365	428	508	1	8	80	0.1000000
NODE_9858_length_866_cov_47.160365	428	508	2	72	80	0.9000000
NODE_9858_length_866_cov_47.160365	481	561	2	45	80	0.5625000
NODE_9858_length_866_cov_47.160365	481	561	3	21	80	0.2625000
NODE_9858_length_866_cov_47.160365	481	561	4	14	80	0.1750000
NODE_9858_length_866_cov_47.160365	557	637	3	30	80	0.3750000
NODE_9858_length_866_cov_47.160365	557	637	4	16	80	0.2000000
NODE_9858_length_866_cov_47.160365	557	637	5	30	80	0.3750000
NODE_9858_length_866_cov_47.160365	557	637	6	4	80	0.0500000
NODE_9858_length_866_cov_47.160365	610	690	4	35	80	0.4375000
NODE_9858_length_866_cov_47.160365	610	690	5	23	80	0.2875000
NODE_9858_length_866_cov_47.160365	610	690	6	22	80	0.2750000
NODE_9859_length_866_cov_23.398957	281	361	3	22	80	0.2750000
NODE_9859_length_866_cov_23.398957	281	361	4	10	80	0.1250000
NODE_9859_length_866_cov_23.398957	281	361	5	13	80	0.1625000
NODE_9859_length_866_cov_23.398957	281	361	6	6	80	0.0750000
NODE_9859_length_866_cov_23.398957	281	361	7	29	80	0.3625000
NODE_9859_length_866_cov_23.398957	334	414	7	72	80	0.9000000
NODE_9859_length_866_cov_23.398957	334	414	8	8	80	0.1000000
NODE_9860_length_866_cov_22.186441	455	535	4	31	80	0.3875000
NODE_9860_length_866_cov_22.186441	455	535	5	15	80	0.1875000
NODE_9860_length_866_cov_22.186441	455	535	6	5	80	0.0625000
NODE_9860_length_866_cov_22.186441	455	535	7	25	80	0.3125000
NODE_9860_length_866_cov_22.186441	455	535	8	4	80	0.0500000
NODE_9860_length_866_cov_22.186441	508	588	4	7	80	0.0875000
NODE_9860_length_866_cov_22.186441	508	588	6	38	80	0.4750000
NODE_9860_length_866_cov_22.186441	508	588	7	23	80	0.2875000
NODE_9860_length_866_cov_22.186441	508	588	8	12	80	0.1500000
NODE_9861_length_866_cov_18.362451	451	531	4	17	80	0.2125000
NODE_9861_length_866_cov_18.362451	451	531	5	25	80	0.3125000
NODE_9861_length_866_cov_18.362451	451	531	6	13	80	0.1625000
NODE_9861_length_866_cov_18.362451	451	531	7	25	80	0.3125000
NODE_9861_length_866_cov_18.362451	504	584	2	1	80	0.0125000
NODE_9861_length_866_cov_18.362451	504	584	3	42	80	0.5250000
NODE_9861_length_866_cov_18.362451	504	584	4	27	80	0.3375000
NODE_9861_length_866_cov_18.362451	504	584	7	10	80	0.1250000
NODE_9862_length_866_cov_16.830508	372	452	3	15	80	0.1875000
NODE_9862_length_866_cov_16.830508	372	452	4	6	80	0.0750000
NODE_9862_length_866_cov_16.830508	372	452	5	59	80	0.7375000
NODE_9862_length_866_cov_16.830508	425	505	1	11	80	0.1375000
NODE_9862_length_866_cov_16.830508	425	505	2	36	80	0.4500000
NODE_9862_length_866_cov_16.830508	425	505	3	15	80	0.1875000
NODE_9862_length_866_cov_16.830508	425	505	4	12	80	0.1500000
NODE_9862_length_866_cov_16.830508	425	505	5	6	80	0.0750000
NODE_9882_length_865_cov_63.137076	288	368	4	6	80	0.0750000
NODE_9882_length_865_cov_63.137076	288	368	5	26	80	0.3250000
NODE_9882_length_865_cov_63.137076	288	368	6	48	80	0.6000000
NODE_9882_length_865_cov_63.137076	341	421	3	3	80	0.0375000
NODE_9882_length_865_cov_63.137076	341	421	4	10	80	0.1250000
NODE_9882_length_865_cov_63.137076	341	421	6	67	80	0.8375000
NODE_9883_length_865_cov_19.882507	335	415	1	23	80	0.2875000
NODE_9883_length_865_cov_19.882507	335	415	2	12	80	0.1500000
NODE_9883_length_865_cov_19.882507	335	415	3	14	80	0.1750000
NODE_9883_length_865_cov_19.882507	335	415	4	14	80	0.1750000
NODE_9883_length_865_cov_19.882507	335	415	6	17	80	0.2125000
NODE_9883_length_865_cov_19.882507	388	468	4	10	80	0.1250000
NODE_9883_length_865_cov_19.882507	388	468	5	27	80	0.3375000
NODE_9883_length_865_cov_19.882507	388	468	6	43	80	0.5375000
NODE_9884_length_865_cov_17.784595	306	386	2	1	80	0.0125000
NODE_9884_length_865_cov_17.784595	306	386	4	19	80	0.2375000
NODE_9884_length_865_cov_17.784595	306	386	5	10	80	0.1250000
NODE_9884_length_865_cov_17.784595	306	386	6	50	80	0.6250000
NODE_9884_length_865_cov_17.784595	359	439	4	28	80	0.3500000
NODE_9884_length_865_cov_17.784595	359	439	5	35	80	0.4375000
NODE_9884_length_865_cov_17.784595	359	439	6	17	80	0.2125000
NODE_9885_length_865_cov_16.150131	451	531	5	37	80	0.4625000
NODE_9885_length_865_cov_16.150131	451	531	7	2	80	0.0250000
NODE_9885_length_865_cov_16.150131	451	531	8	39	80	0.4875000
NODE_9885_length_865_cov_16.150131	451	531	9	2	80	0.0250000
NODE_9885_length_865_cov_16.150131	504	584	3	11	80	0.1375000
NODE_9885_length_865_cov_16.150131	504	584	5	5	80	0.0625000
NODE_9885_length_865_cov_16.150131	504	584	6	16	80	0.2000000
NODE_9885_length_865_cov_16.150131	504	584	8	32	80	0.4000000
NODE_9885_length_865_cov_16.150131	504	584	9	16	80	0.2000000
NODE_9886_length_865_cov_14.751958	473	553	0	80	80	1.0000000
NODE_9886_length_865_cov_14.751958	473	553	0	80	80	1.0000000
NODE_9886_length_865_cov_14.751958	526	589	0	63	63	1.0000000
NODE_9886_length_865_cov_14.751958	526	606	0	80	80	1.0000000
NODE_9887_length_865_cov_10.937337	422	502	2	21	80	0.2625000
NODE_9887_length_865_cov_10.937337	422	502	4	22	80	0.2750000
NODE_9887_length_865_cov_10.937337	422	502	6	37	80	0.4625000
NODE_9887_length_865_cov_10.937337	475	555	4	52	80	0.6500000
NODE_9887_length_865_cov_10.937337	475	555	6	28	80	0.3500000
NODE_9889_length_865_cov_9.167102	389	469	0	16	80	0.2000000
NODE_9889_length_865_cov_9.167102	389	469	2	64	80	0.8000000
NODE_9889_length_865_cov_9.167102	442	522	0	19	80	0.2375000
NODE_9889_length_865_cov_9.167102	442	522	2	61	80	0.7625000
NODE_9912_length_864_cov_13.398693	491	571	3	2	80	0.0250000
NODE_9912_length_864_cov_13.398693	491	571	5	2	80	0.0250000
NODE_9912_length_864_cov_13.398693	491	571	7	10	80	0.1250000
NODE_9912_length_864_cov_13.398693	491	571	8	41	80	0.5125000
NODE_9912_length_864_cov_13.398693	491	571	9	25	80	0.3125000
NODE_9912_length_864_cov_13.398693	544	624	5	20	80	0.2500000
NODE_9912_length_864_cov_13.398693	544	624	7	6	80	0.0750000
NODE_9912_length_864_cov_13.398693	544	624	8	54	80	0.6750000
NODE_9913_length_864_cov_8.466667	308	388	5	32	80	0.4000000
NODE_9913_length_864_cov_8.466667	308	388	6	44	80	0.5500000
NODE_9913_length_864_cov_8.466667	308	388	7	4	80	0.0500000
NODE_9913_length_864_cov_8.466667	361	441	4	29	80	0.3625000
NODE_9913_length_864_cov_8.466667	361	441	6	51	80	0.6375000
NODE_9917_length_864_cov_3.947712	651	676	0	25	25	1.0000000
NODE_9917_length_864_cov_3.947712	725	805	2	15	80	0.1875000
NODE_9917_length_864_cov_3.947712	725	805	4	65	80	0.8125000
NODE_9917_length_864_cov_3.947712	778	844	2	14	66	0.2121212
NODE_9917_length_864_cov_3.947712	778	844	4	52	66	0.7878788
NODE_9931_length_863_cov_72.856021	241	321	3	31	80	0.3875000
NODE_9931_length_863_cov_72.856021	241	321	5	24	80	0.3000000
NODE_9931_length_863_cov_72.856021	241	321	6	22	80	0.2750000
NODE_9931_length_863_cov_72.856021	241	321	7	3	80	0.0375000
NODE_9931_length_863_cov_72.856021	294	374	3	14	80	0.1750000
NODE_9931_length_863_cov_72.856021	294	374	4	1	80	0.0125000
NODE_9931_length_863_cov_72.856021	294	374	5	6	80	0.0750000
NODE_9931_length_863_cov_72.856021	294	374	6	22	80	0.2750000
NODE_9931_length_863_cov_72.856021	294	374	7	31	80	0.3875000
NODE_9931_length_863_cov_72.856021	294	374	9	2	80	0.0250000
NODE_9931_length_863_cov_72.856021	294	374	11	4	80	0.0500000
NODE_9931_length_863_cov_72.856021	370	450	10	5	80	0.0625000
NODE_9931_length_863_cov_72.856021	370	450	11	21	80	0.2625000
NODE_9931_length_863_cov_72.856021	370	450	13	15	80	0.1875000
NODE_9931_length_863_cov_72.856021	370	450	14	18	80	0.2250000
NODE_9931_length_863_cov_72.856021	370	450	15	6	80	0.0750000
NODE_9931_length_863_cov_72.856021	370	450	16	4	80	0.0500000
NODE_9931_length_863_cov_72.856021	370	450	17	11	80	0.1375000
NODE_9931_length_863_cov_72.856021	423	503	14	28	80	0.3500000
NODE_9931_length_863_cov_72.856021	423	503	15	12	80	0.1500000
NODE_9931_length_863_cov_72.856021	423	503	16	29	80	0.3625000
NODE_9931_length_863_cov_72.856021	423	503	17	11	80	0.1375000
NODE_9932_length_863_cov_37.130890	363	443	5	1	80	0.0125000
NODE_9932_length_863_cov_37.130890	363	443	6	10	80	0.1250000
NODE_9932_length_863_cov_37.130890	363	443	7	21	80	0.2625000
NODE_9932_length_863_cov_37.130890	363	443	8	48	80	0.6000000
NODE_9932_length_863_cov_37.130890	416	496	2	4	80	0.0500000
NODE_9932_length_863_cov_37.130890	416	496	3	1	80	0.0125000
NODE_9932_length_863_cov_37.130890	416	496	4	11	80	0.1375000
NODE_9932_length_863_cov_37.130890	416	496	5	38	80	0.4750000
NODE_9932_length_863_cov_37.130890	416	496	7	10	80	0.1250000
NODE_9932_length_863_cov_37.130890	416	496	8	16	80	0.2000000
NODE_9932_length_863_cov_37.130890	492	572	0	24	80	0.3000000
NODE_9932_length_863_cov_37.130890	492	572	1	11	80	0.1375000
NODE_9932_length_863_cov_37.130890	492	572	2	45	80	0.5625000
NODE_9932_length_863_cov_37.130890	545	617	0	67	72	0.9305556
NODE_9932_length_863_cov_37.130890	545	617	1	3	72	0.0416667
NODE_9932_length_863_cov_37.130890	545	617	4	1	72	0.0138889
NODE_9932_length_863_cov_37.130890	545	617	6	1	72	0.0138889
NODE_9933_length_863_cov_33.159686	287	367	0	6	80	0.0750000
NODE_9933_length_863_cov_33.159686	287	367	1	3	80	0.0375000
NODE_9933_length_863_cov_33.159686	287	367	4	32	80	0.4000000
NODE_9933_length_863_cov_33.159686	287	367	5	6	80	0.0750000
NODE_9933_length_863_cov_33.159686	287	367	6	8	80	0.1000000
NODE_9933_length_863_cov_33.159686	287	367	7	16	80	0.2000000
NODE_9933_length_863_cov_33.159686	287	367	8	9	80	0.1125000
NODE_9933_length_863_cov_33.159686	340	420	6	2	80	0.0250000
NODE_9933_length_863_cov_33.159686	340	420	7	16	80	0.2000000
NODE_9933_length_863_cov_33.159686	340	420	8	14	80	0.1750000
NODE_9933_length_863_cov_33.159686	340	420	9	48	80	0.6000000
NODE_9934_length_863_cov_24.714660	370	450	2	29	80	0.3625000
NODE_9934_length_863_cov_24.714660	370	450	3	1	80	0.0125000
NODE_9934_length_863_cov_24.714660	370	450	4	23	80	0.2875000
NODE_9934_length_863_cov_24.714660	370	450	5	9	80	0.1125000
NODE_9934_length_863_cov_24.714660	370	450	7	18	80	0.2250000
NODE_9934_length_863_cov_24.714660	423	503	5	33	80	0.4125000
NODE_9934_length_863_cov_24.714660	423	503	6	21	80	0.2625000
NODE_9934_length_863_cov_24.714660	423	503	7	26	80	0.3250000
NODE_9935_length_863_cov_21.945026	341	421	4	80	80	1.0000000
NODE_9935_length_863_cov_21.945026	394	474	4	80	80	1.0000000
NODE_9936_length_863_cov_19.794503	393	473	5	54	80	0.6750000
NODE_9936_length_863_cov_19.794503	393	473	6	4	80	0.0500000
NODE_9936_length_863_cov_19.794503	393	473	7	22	80	0.2750000
NODE_9936_length_863_cov_19.794503	446	526	5	1	80	0.0125000
NODE_9936_length_863_cov_19.794503	446	526	6	57	80	0.7125000
NODE_9936_length_863_cov_19.794503	446	526	7	22	80	0.2750000
NODE_9937_length_863_cov_11.778796	303	383	4	2	80	0.0250000
NODE_9937_length_863_cov_11.778796	303	383	5	22	80	0.2750000
NODE_9937_length_863_cov_11.778796	303	383	6	1	80	0.0125000
NODE_9937_length_863_cov_11.778796	303	383	7	32	80	0.4000000
NODE_9937_length_863_cov_11.778796	303	383	8	5	80	0.0625000
NODE_9937_length_863_cov_11.778796	303	383	9	18	80	0.2250000
NODE_9937_length_863_cov_11.778796	356	436	7	5	80	0.0625000
NODE_9937_length_863_cov_11.778796	356	436	8	57	80	0.7125000
NODE_9937_length_863_cov_11.778796	356	436	9	18	80	0.2250000
NODE_9938_length_863_cov_10.026178	283	363	5	9	80	0.1125000
NODE_9938_length_863_cov_10.026178	283	363	6	65	80	0.8125000
NODE_9938_length_863_cov_10.026178	283	363	7	6	80	0.0750000
NODE_9938_length_863_cov_10.026178	336	416	5	5	80	0.0625000
NODE_9938_length_863_cov_10.026178	336	416	6	24	80	0.3000000
NODE_9938_length_863_cov_10.026178	336	416	7	49	80	0.6125000
NODE_9938_length_863_cov_10.026178	336	416	8	2	80	0.0250000
NODE_9957_length_862_cov_46.811271	272	352	0	80	80	1.0000000
NODE_9957_length_862_cov_46.811271	325	405	0	80	80	1.0000000
NODE_9957_length_862_cov_46.811271	401	481	0	80	80	1.0000000
NODE_9957_length_862_cov_46.811271	454	534	0	80	80	1.0000000
NODE_9958_length_862_cov_34.638270	259	339	1	7	80	0.0875000
NODE_9958_length_862_cov_34.638270	259	339	2	10	80	0.1250000
NODE_9958_length_862_cov_34.638270	259	339	3	16	80	0.2000000
NODE_9958_length_862_cov_34.638270	259	339	4	47	80	0.5875000
NODE_9958_length_862_cov_34.638270	312	392	3	8	80	0.1000000
NODE_9958_length_862_cov_34.638270	312	392	4	48	80	0.6000000
NODE_9958_length_862_cov_34.638270	312	392	5	24	80	0.3000000
NODE_9958_length_862_cov_34.638270	388	468	4	1	80	0.0125000
NODE_9958_length_862_cov_34.638270	388	468	5	19	80	0.2375000
NODE_9958_length_862_cov_34.638270	388	468	6	55	80	0.6875000
NODE_9958_length_862_cov_34.638270	388	468	7	5	80	0.0625000
NODE_9958_length_862_cov_34.638270	441	521	6	22	80	0.2750000
NODE_9958_length_862_cov_34.638270	441	521	7	10	80	0.1250000
NODE_9958_length_862_cov_34.638270	441	521	8	26	80	0.3250000
NODE_9958_length_862_cov_34.638270	441	521	9	22	80	0.2750000
NODE_9959_length_862_cov_32.068152	468	548	4	7	80	0.0875000
NODE_9959_length_862_cov_32.068152	468	548	5	37	80	0.4625000
NODE_9959_length_862_cov_32.068152	468	548	6	1	80	0.0125000
NODE_9959_length_862_cov_32.068152	468	548	7	35	80	0.4375000
NODE_9959_length_862_cov_32.068152	521	601	3	32	80	0.4000000
NODE_9959_length_862_cov_32.068152	521	601	4	28	80	0.3500000
NODE_9959_length_862_cov_32.068152	521	601	5	20	80	0.2500000
NODE_9960_length_862_cov_23.584535	526	606	5	8	80	0.1000000
NODE_9960_length_862_cov_23.584535	526	606	6	51	80	0.6375000
NODE_9960_length_862_cov_23.584535	526	606	7	21	80	0.2625000
NODE_9960_length_862_cov_23.584535	579	659	1	21	80	0.2625000
NODE_9960_length_862_cov_23.584535	579	659	2	13	80	0.1625000
NODE_9960_length_862_cov_23.584535	579	659	4	11	80	0.1375000
NODE_9960_length_862_cov_23.584535	579	659	5	10	80	0.1250000
NODE_9960_length_862_cov_23.584535	579	659	6	25	80	0.3125000
NODE_9961_length_862_cov_19.980341	347	427	2	6	80	0.0750000
NODE_9961_length_862_cov_19.980341	347	427	3	40	80	0.5000000
NODE_9961_length_862_cov_19.980341	347	427	4	10	80	0.1250000
NODE_9961_length_862_cov_19.980341	347	427	5	14	80	0.1750000
NODE_9961_length_862_cov_19.980341	347	427	6	10	80	0.1250000
NODE_9961_length_862_cov_19.980341	400	480	4	3	80	0.0375000
NODE_9961_length_862_cov_19.980341	400	480	5	58	80	0.7250000
NODE_9961_length_862_cov_19.980341	400	480	6	19	80	0.2375000
NODE_9962_length_862_cov_19.079948	379	459	2	4	80	0.0500000
NODE_9962_length_862_cov_19.079948	379	459	3	10	80	0.1250000
NODE_9962_length_862_cov_19.079948	379	459	4	52	80	0.6500000
NODE_9962_length_862_cov_19.079948	379	459	5	14	80	0.1750000
NODE_9962_length_862_cov_19.079948	432	512	1	40	80	0.5000000
NODE_9962_length_862_cov_19.079948	432	512	2	17	80	0.2125000
NODE_9962_length_862_cov_19.079948	432	512	3	10	80	0.1250000
NODE_9962_length_862_cov_19.079948	432	512	4	13	80	0.1625000
NODE_9963_length_862_cov_18.425950	94	174	0	80	80	1.0000000
NODE_9963_length_862_cov_18.425950	147	201	0	54	54	1.0000000
NODE_9963_length_862_cov_18.425950	392	472	3	5	80	0.0625000
NODE_9963_length_862_cov_18.425950	392	472	4	9	80	0.1125000
NODE_9963_length_862_cov_18.425950	392	472	6	3	80	0.0375000
NODE_9963_length_862_cov_18.425950	392	472	7	12	80	0.1500000
NODE_9963_length_862_cov_18.425950	392	472	8	39	80	0.4875000
NODE_9963_length_862_cov_18.425950	392	472	9	12	80	0.1500000
NODE_9963_length_862_cov_18.425950	445	525	8	15	80	0.1875000
NODE_9963_length_862_cov_18.425950	445	525	9	24	80	0.3000000
NODE_9963_length_862_cov_18.425950	445	525	10	32	80	0.4000000
NODE_9963_length_862_cov_18.425950	445	525	11	9	80	0.1125000
NODE_9964_length_862_cov_11.740498	348	428	1	10	80	0.1250000
NODE_9964_length_862_cov_11.740498	348	428	5	18	80	0.2250000
NODE_9964_length_862_cov_11.740498	348	428	7	52	80	0.6500000
NODE_9964_length_862_cov_11.740498	401	481	2	14	80	0.1750000
NODE_9964_length_862_cov_11.740498	401	481	6	14	80	0.1750000
NODE_9964_length_862_cov_11.740498	401	481	7	52	80	0.6500000
NODE_9965_length_862_cov_11.685452	292	372	4	31	80	0.3875000
NODE_9965_length_862_cov_11.685452	292	372	6	49	80	0.6125000
NODE_9965_length_862_cov_11.685452	345	425	2	18	80	0.2250000
NODE_9965_length_862_cov_11.685452	345	425	4	62	80	0.7750000
NODE_9966_length_862_cov_8.259502	385	465	0	29	80	0.3625000
NODE_9966_length_862_cov_8.259502	385	465	1	6	80	0.0750000
NODE_9966_length_862_cov_8.259502	385	465	2	45	80	0.5625000
NODE_9966_length_862_cov_8.259502	438	518	2	80	80	1.0000000
NODE_9970_length_862_cov_2.895151	388	468	0	80	80	1.0000000
NODE_9970_length_862_cov_2.895151	441	521	0	80	80	1.0000000
NODE_9984_length_861_cov_52.679790	450	530	2	80	80	1.0000000
NODE_9984_length_861_cov_52.679790	503	583	1	1	80	0.0125000
NODE_9984_length_861_cov_52.679790	503	583	2	59	80	0.7375000
NODE_9984_length_861_cov_52.679790	503	583	3	20	80	0.2500000
NODE_9985_length_861_cov_34.868766	470	550	11	4	80	0.0500000
NODE_9985_length_861_cov_34.868766	470	550	12	1	80	0.0125000
NODE_9985_length_861_cov_34.868766	470	550	13	29	80	0.3625000
NODE_9985_length_861_cov_34.868766	470	550	15	3	80	0.0375000
NODE_9985_length_861_cov_34.868766	470	550	16	2	80	0.0250000
NODE_9985_length_861_cov_34.868766	470	550	17	15	80	0.1875000
NODE_9985_length_861_cov_34.868766	470	550	18	14	80	0.1750000
NODE_9985_length_861_cov_34.868766	470	550	19	12	80	0.1500000
NODE_9985_length_861_cov_34.868766	523	603	3	3	80	0.0375000
NODE_9985_length_861_cov_34.868766	523	603	4	2	80	0.0250000
NODE_9985_length_861_cov_34.868766	523	603	5	3	80	0.0375000
NODE_9985_length_861_cov_34.868766	523	603	6	3	80	0.0375000
NODE_9985_length_861_cov_34.868766	523	603	7	12	80	0.1500000
NODE_9985_length_861_cov_34.868766	523	603	8	19	80	0.2375000
NODE_9985_length_861_cov_34.868766	523	603	9	7	80	0.0875000
NODE_9985_length_861_cov_34.868766	523	603	11	8	80	0.1000000
NODE_9985_length_861_cov_34.868766	523	603	12	1	80	0.0125000
NODE_9985_length_861_cov_34.868766	523	603	13	22	80	0.2750000
NODE_9986_length_861_cov_25.622047	145	225	6	17	80	0.2125000
NODE_9986_length_861_cov_25.622047	145	225	7	22	80	0.2750000
NODE_9986_length_861_cov_25.622047	145	225	8	19	80	0.2375000
NODE_9986_length_861_cov_25.622047	145	225	9	22	80	0.2750000
NODE_9986_length_861_cov_25.622047	198	278	5	1	80	0.0125000
NODE_9986_length_861_cov_25.622047	198	278	7	18	80	0.2250000
NODE_9986_length_861_cov_25.622047	198	278	8	31	80	0.3875000
NODE_9986_length_861_cov_25.622047	198	278	9	30	80	0.3750000
NODE_9987_length_861_cov_22.052493	401	481	5	5	80	0.0625000
NODE_9987_length_861_cov_22.052493	401	481	8	8	80	0.1000000
NODE_9987_length_861_cov_22.052493	401	481	9	18	80	0.2250000
NODE_9987_length_861_cov_22.052493	401	481	10	2	80	0.0250000
NODE_9987_length_861_cov_22.052493	401	481	11	7	80	0.0875000
NODE_9987_length_861_cov_22.052493	401	481	12	8	80	0.1000000
NODE_9987_length_861_cov_22.052493	401	481	13	13	80	0.1625000
NODE_9987_length_861_cov_22.052493	401	481	15	15	80	0.1875000
NODE_9987_length_861_cov_22.052493	401	481	16	4	80	0.0500000
NODE_9987_length_861_cov_22.052493	454	534	10	26	80	0.3250000
NODE_9987_length_861_cov_22.052493	454	534	13	8	80	0.1000000
NODE_9987_length_861_cov_22.052493	454	534	14	15	80	0.1875000
NODE_9987_length_861_cov_22.052493	454	534	15	27	80	0.3375000
NODE_9987_length_861_cov_22.052493	454	534	16	4	80	0.0500000
NODE_9988_length_861_cov_19.913386	400	480	4	3	80	0.0375000
NODE_9988_length_861_cov_19.913386	400	480	5	63	80	0.7875000
NODE_9988_length_861_cov_19.913386	400	480	6	14	80	0.1750000
NODE_9988_length_861_cov_19.913386	453	533	2	15	80	0.1875000
NODE_9988_length_861_cov_19.913386	453	533	4	6	80	0.0750000
NODE_9988_length_861_cov_19.913386	453	533	5	39	80	0.4875000
NODE_9988_length_861_cov_19.913386	453	533	6	20	80	0.2500000
NODE_9989_length_861_cov_15.237533	492	572	2	80	80	1.0000000
NODE_9989_length_861_cov_15.237533	545	625	0	37	80	0.4625000
NODE_9989_length_861_cov_15.237533	545	625	2	43	80	0.5375000
NODE_9990_length_861_cov_12.460630	451	531	0	12	80	0.1500000
NODE_9990_length_861_cov_12.460630	451	531	2	47	80	0.5875000
NODE_9990_length_861_cov_12.460630	451	531	3	2	80	0.0250000
NODE_9990_length_861_cov_12.460630	451	531	4	19	80	0.2375000
NODE_9990_length_861_cov_12.460630	504	584	2	6	80	0.0750000
NODE_9990_length_861_cov_12.460630	504	584	3	2	80	0.0250000
NODE_9990_length_861_cov_12.460630	504	584	4	72	80	0.9000000
NODE_9991_length_861_cov_9.463255	446	526	1	47	80	0.5875000
NODE_9991_length_861_cov_9.463255	446	526	2	33	80	0.4125000
NODE_9991_length_861_cov_9.463255	499	579	1	79	80	0.9875000
NODE_9991_length_861_cov_9.463255	499	579	2	1	80	0.0125000
NODE_9992_length_861_cov_9.435696	348	423	5	75	75	1.0000000
NODE_9993_length_861_cov_7.009186	51	91	0	40	40	1.0000000
NODE_9993_length_861_cov_7.009186	185	265	0	80	80	1.0000000
NODE_9993_length_861_cov_7.009186	238	318	0	32	80	0.4000000
NODE_9993_length_861_cov_7.009186	238	318	2	48	80	0.6000000
NODE_10019_length_860_cov_54.315375	245	325	0	80	80	1.0000000
NODE_10019_length_860_cov_54.315375	298	378	0	47	80	0.5875000
NODE_10019_length_860_cov_54.315375	298	378	1	12	80	0.1500000
NODE_10019_length_860_cov_54.315375	298	378	3	21	80	0.2625000
NODE_10019_length_860_cov_54.315375	374	454	3	22	80	0.2750000
NODE_10019_length_860_cov_54.315375	374	454	4	58	80	0.7250000
NODE_10019_length_860_cov_54.315375	427	507	4	27	80	0.3375000
NODE_10019_length_860_cov_54.315375	427	507	5	51	80	0.6375000
NODE_10019_length_860_cov_54.315375	427	507	6	2	80	0.0250000
NODE_10020_length_860_cov_29.618922	356	436	1	31	80	0.3875000
NODE_10020_length_860_cov_29.618922	356	436	2	1	80	0.0125000
NODE_10020_length_860_cov_29.618922	356	436	4	1	80	0.0125000
NODE_10020_length_860_cov_29.618922	356	436	5	42	80	0.5250000
NODE_10020_length_860_cov_29.618922	356	436	6	5	80	0.0625000
NODE_10020_length_860_cov_29.618922	409	489	5	80	80	1.0000000
NODE_10021_length_860_cov_15.152431	393	473	2	65	80	0.8125000
NODE_10021_length_860_cov_15.152431	393	473	4	15	80	0.1875000
NODE_10021_length_860_cov_15.152431	446	526	0	4	80	0.0500000
NODE_10021_length_860_cov_15.152431	446	526	2	46	80	0.5750000
NODE_10021_length_860_cov_15.152431	446	526	4	30	80	0.3750000
NODE_10022_length_860_cov_11.320631	343	423	2	52	80	0.6500000
NODE_10022_length_860_cov_11.320631	343	423	3	2	80	0.0250000
NODE_10022_length_860_cov_11.320631	343	423	4	7	80	0.0875000
NODE_10022_length_860_cov_11.320631	343	423	5	4	80	0.0500000
NODE_10022_length_860_cov_11.320631	343	423	6	15	80	0.1875000
NODE_10022_length_860_cov_11.320631	396	476	3	1	80	0.0125000
NODE_10022_length_860_cov_11.320631	396	476	4	47	80	0.5875000
NODE_10022_length_860_cov_11.320631	396	476	5	17	80	0.2125000
NODE_10022_length_860_cov_11.320631	396	476	6	15	80	0.1875000
NODE_10049_length_859_cov_48.173684	432	512	1	20	80	0.2500000
NODE_10049_length_859_cov_48.173684	432	512	2	32	80	0.4000000
NODE_10049_length_859_cov_48.173684	432	512	3	28	80	0.3500000
NODE_10049_length_859_cov_48.173684	485	565	2	49	80	0.6125000
NODE_10049_length_859_cov_48.173684	485	565	3	31	80	0.3875000
NODE_10050_length_859_cov_24.957895	402	482	6	80	80	1.0000000
NODE_10050_length_859_cov_24.957895	455	535	2	11	80	0.1375000
NODE_10050_length_859_cov_24.957895	455	535	3	32	80	0.4000000
NODE_10050_length_859_cov_24.957895	455	535	4	8	80	0.1000000
NODE_10050_length_859_cov_24.957895	455	535	6	29	80	0.3625000
NODE_10051_length_859_cov_23.431579	251	331	12	4	80	0.0500000
NODE_10051_length_859_cov_23.431579	251	331	13	4	80	0.0500000
NODE_10051_length_859_cov_23.431579	251	331	14	1	80	0.0125000
NODE_10051_length_859_cov_23.431579	251	331	15	18	80	0.2250000
NODE_10051_length_859_cov_23.431579	251	331	16	19	80	0.2375000
NODE_10051_length_859_cov_23.431579	251	331	17	11	80	0.1375000
NODE_10051_length_859_cov_23.431579	251	331	19	8	80	0.1000000
NODE_10051_length_859_cov_23.431579	251	331	20	14	80	0.1750000
NODE_10051_length_859_cov_23.431579	251	331	21	1	80	0.0125000
NODE_10051_length_859_cov_23.431579	304	384	17	4	80	0.0500000
NODE_10051_length_859_cov_23.431579	304	384	18	7	80	0.0875000
NODE_10051_length_859_cov_23.431579	304	384	19	31	80	0.3875000
NODE_10051_length_859_cov_23.431579	304	384	20	15	80	0.1875000
NODE_10051_length_859_cov_23.431579	304	384	21	23	80	0.2875000
NODE_10052_length_859_cov_20.523684	341	421	3	25	80	0.3125000
NODE_10052_length_859_cov_20.523684	341	421	4	48	80	0.6000000
NODE_10052_length_859_cov_20.523684	341	421	5	7	80	0.0875000
NODE_10052_length_859_cov_20.523684	394	474	4	55	80	0.6875000
NODE_10052_length_859_cov_20.523684	394	474	5	10	80	0.1250000
NODE_10052_length_859_cov_20.523684	394	474	6	15	80	0.1875000
NODE_10053_length_859_cov_17.996053	316	396	1	55	80	0.6875000
NODE_10053_length_859_cov_17.996053	316	396	3	25	80	0.3125000
NODE_10053_length_859_cov_17.996053	369	449	0	39	80	0.4875000
NODE_10053_length_859_cov_17.996053	369	449	1	41	80	0.5125000
NODE_10054_length_859_cov_16.757895	404	484	7	12	80	0.1500000
NODE_10054_length_859_cov_16.757895	404	484	8	12	80	0.1500000
NODE_10054_length_859_cov_16.757895	404	484	10	10	80	0.1250000
NODE_10054_length_859_cov_16.757895	404	484	11	19	80	0.2375000
NODE_10054_length_859_cov_16.757895	404	484	12	5	80	0.0625000
NODE_10054_length_859_cov_16.757895	404	484	13	1	80	0.0125000
NODE_10054_length_859_cov_16.757895	404	484	14	21	80	0.2625000
NODE_10054_length_859_cov_16.757895	457	537	10	12	80	0.1500000
NODE_10054_length_859_cov_16.757895	457	537	12	26	80	0.3250000
NODE_10054_length_859_cov_16.757895	457	537	13	21	80	0.2625000
NODE_10054_length_859_cov_16.757895	457	537	14	21	80	0.2625000
NODE_10055_length_859_cov_15.852632	346	426	10	1	80	0.0125000
NODE_10055_length_859_cov_15.852632	346	426	11	75	80	0.9375000
NODE_10055_length_859_cov_15.852632	346	426	12	4	80	0.0500000
NODE_10055_length_859_cov_15.852632	399	479	3	18	80	0.2250000
NODE_10055_length_859_cov_15.852632	399	479	4	9	80	0.1125000
NODE_10055_length_859_cov_15.852632	399	479	6	15	80	0.1875000
NODE_10055_length_859_cov_15.852632	399	479	8	1	80	0.0125000
NODE_10055_length_859_cov_15.852632	399	479	10	11	80	0.1375000
NODE_10055_length_859_cov_15.852632	399	479	11	22	80	0.2750000
NODE_10055_length_859_cov_15.852632	399	479	12	4	80	0.0500000
NODE_10056_length_859_cov_11.584211	407	487	5	9	80	0.1125000
NODE_10056_length_859_cov_11.584211	407	487	6	8	80	0.1000000
NODE_10056_length_859_cov_11.584211	407	487	7	63	80	0.7875000
NODE_10056_length_859_cov_11.584211	460	540	2	14	80	0.1750000
NODE_10056_length_859_cov_11.584211	460	540	4	8	80	0.1000000
NODE_10056_length_859_cov_11.584211	460	540	6	12	80	0.1500000
NODE_10056_length_859_cov_11.584211	460	540	7	46	80	0.5750000
NODE_10057_length_859_cov_10.296053	368	448	2	6	80	0.0750000
NODE_10057_length_859_cov_10.296053	368	448	3	45	80	0.5625000
NODE_10057_length_859_cov_10.296053	368	448	4	7	80	0.0875000
NODE_10057_length_859_cov_10.296053	368	448	5	9	80	0.1125000
NODE_10057_length_859_cov_10.296053	368	448	6	13	80	0.1625000
NODE_10057_length_859_cov_10.296053	421	501	4	10	80	0.1250000
NODE_10057_length_859_cov_10.296053	421	501	5	57	80	0.7125000
NODE_10057_length_859_cov_10.296053	421	501	6	13	80	0.1625000
NODE_10066_length_859_cov_2.359211	498	578	2	21	80	0.2625000
NODE_10066_length_859_cov_2.359211	498	578	3	20	80	0.2500000
NODE_10066_length_859_cov_2.359211	498	578	4	39	80	0.4875000
NODE_10066_length_859_cov_2.359211	551	631	2	54	80	0.6750000
NODE_10066_length_859_cov_2.359211	551	631	3	20	80	0.2500000
NODE_10066_length_859_cov_2.359211	551	631	4	6	80	0.0750000
NODE_10079_length_858_cov_54.677207	277	357	0	3	80	0.0375000
NODE_10079_length_858_cov_54.677207	277	357	1	9	80	0.1125000
NODE_10079_length_858_cov_54.677207	277	357	2	68	80	0.8500000
NODE_10079_length_858_cov_54.677207	330	410	0	56	80	0.7000000
NODE_10079_length_858_cov_54.677207	330	410	1	9	80	0.1125000
NODE_10079_length_858_cov_54.677207	330	410	2	15	80	0.1875000
NODE_10080_length_858_cov_40.584980	500	580	9	2	80	0.0250000
NODE_10080_length_858_cov_40.584980	500	580	10	25	80	0.3125000
NODE_10080_length_858_cov_40.584980	500	580	11	9	80	0.1125000
NODE_10080_length_858_cov_40.584980	500	580	12	40	80	0.5000000
NODE_10080_length_858_cov_40.584980	500	580	14	4	80	0.0500000
NODE_10080_length_858_cov_40.584980	553	633	2	10	80	0.1250000
NODE_10080_length_858_cov_40.584980	553	633	3	6	80	0.0750000
NODE_10080_length_858_cov_40.584980	553	633	5	3	80	0.0375000
NODE_10080_length_858_cov_40.584980	553	633	7	9	80	0.1125000
NODE_10080_length_858_cov_40.584980	553	633	9	27	80	0.3375000
NODE_10080_length_858_cov_40.584980	553	633	10	16	80	0.2000000
NODE_10080_length_858_cov_40.584980	553	633	11	9	80	0.1125000
NODE_10081_length_858_cov_30.177866	363	443	7	15	80	0.1875000
NODE_10081_length_858_cov_30.177866	363	443	8	34	80	0.4250000
NODE_10081_length_858_cov_30.177866	363	443	10	1	80	0.0125000
NODE_10081_length_858_cov_30.177866	363	443	11	25	80	0.3125000
NODE_10081_length_858_cov_30.177866	363	443	12	5	80	0.0625000
NODE_10081_length_858_cov_30.177866	416	496	2	27	80	0.3375000
NODE_10081_length_858_cov_30.177866	416	496	3	10	80	0.1250000
NODE_10081_length_858_cov_30.177866	416	496	4	9	80	0.1125000
NODE_10081_length_858_cov_30.177866	416	496	5	2	80	0.0250000
NODE_10081_length_858_cov_30.177866	416	496	7	20	80	0.2500000
NODE_10081_length_858_cov_30.177866	416	496	8	12	80	0.1500000
NODE_10081_length_858_cov_30.177866	492	572	0	37	80	0.4625000
NODE_10081_length_858_cov_30.177866	492	572	1	29	80	0.3625000
NODE_10081_length_858_cov_30.177866	492	572	2	14	80	0.1750000
NODE_10081_length_858_cov_30.177866	545	625	1	80	80	1.0000000
NODE_10082_length_858_cov_18.534914	371	451	8	29	80	0.3625000
NODE_10082_length_858_cov_18.534914	371	451	9	6	80	0.0750000
NODE_10082_length_858_cov_18.534914	371	451	10	5	80	0.0625000
NODE_10082_length_858_cov_18.534914	371	451	11	15	80	0.1875000
NODE_10082_length_858_cov_18.534914	371	451	13	2	80	0.0250000
NODE_10082_length_858_cov_18.534914	371	451	14	14	80	0.1750000
NODE_10082_length_858_cov_18.534914	371	451	15	9	80	0.1125000
NODE_10082_length_858_cov_18.534914	424	504	8	47	80	0.5875000
NODE_10082_length_858_cov_18.534914	424	504	10	4	80	0.0500000
NODE_10082_length_858_cov_18.534914	424	504	11	2	80	0.0250000
NODE_10082_length_858_cov_18.534914	424	504	12	1	80	0.0125000
NODE_10082_length_858_cov_18.534914	424	504	13	3	80	0.0375000
NODE_10082_length_858_cov_18.534914	424	504	14	14	80	0.1750000
NODE_10082_length_858_cov_18.534914	424	504	15	9	80	0.1125000
NODE_10083_length_858_cov_15.378129	232	312	1	6	80	0.0750000
NODE_10083_length_858_cov_15.378129	232	312	2	74	80	0.9250000
NODE_10083_length_858_cov_15.378129	285	365	1	29	80	0.3625000
NODE_10083_length_858_cov_15.378129	285	365	2	51	80	0.6375000
NODE_10084_length_858_cov_12.310935	335	415	2	30	80	0.3750000
NODE_10084_length_858_cov_12.310935	335	415	4	50	80	0.6250000
NODE_10084_length_858_cov_12.310935	388	468	0	41	80	0.5125000
NODE_10084_length_858_cov_12.310935	388	468	2	39	80	0.4875000
NODE_10085_length_858_cov_7.835310	396	479	2	17	83	0.2048193
NODE_10085_length_858_cov_7.835310	396	479	3	4	83	0.0481928
NODE_10085_length_858_cov_7.835310	396	479	4	25	83	0.3012048
NODE_10085_length_858_cov_7.835310	396	479	5	37	83	0.4457831
NODE_10085_length_858_cov_7.835310	452	532	3	17	80	0.2125000
NODE_10085_length_858_cov_7.835310	452	532	5	63	80	0.7875000
NODE_10088_length_858_cov_4.953887	474	554	0	5	80	0.0625000
NODE_10088_length_858_cov_4.953887	474	554	2	75	80	0.9375000
NODE_10088_length_858_cov_4.953887	527	607	0	58	80	0.7250000
NODE_10088_length_858_cov_4.953887	527	607	2	22	80	0.2750000
NODE_10091_length_858_cov_3.475626	428	502	0	37	74	0.5000000
NODE_10091_length_858_cov_3.475626	428	502	2	37	74	0.5000000
NODE_10091_length_858_cov_3.475626	498	578	0	80	80	1.0000000
NODE_10091_length_858_cov_3.475626	551	631	0	80	80	1.0000000
NODE_10108_length_857_cov_33.449868	384	455	0	2	71	0.0281690
NODE_10108_length_857_cov_33.449868	384	455	2	21	71	0.2957746
NODE_10108_length_857_cov_33.449868	384	455	3	9	71	0.1267606
NODE_10108_length_857_cov_33.449868	384	455	7	39	71	0.5492958
NODE_10108_length_857_cov_33.449868	437	518	0	65	81	0.8024691
NODE_10108_length_857_cov_33.449868	437	518	2	16	81	0.1975309
NODE_10109_length_857_cov_32.527704	391	471	0	1	80	0.0125000
NODE_10109_length_857_cov_32.527704	391	471	1	3	80	0.0375000
NODE_10109_length_857_cov_32.527704	391	471	7	9	80	0.1125000
NODE_10109_length_857_cov_32.527704	391	471	9	67	80	0.8375000
NODE_10109_length_857_cov_32.527704	444	524	0	19	80	0.2375000
NODE_10109_length_857_cov_32.527704	444	524	2	20	80	0.2500000
NODE_10109_length_857_cov_32.527704	444	524	3	5	80	0.0625000
NODE_10109_length_857_cov_32.527704	444	524	7	7	80	0.0875000
NODE_10109_length_857_cov_32.527704	444	524	9	29	80	0.3625000
NODE_10110_length_857_cov_27.853562	310	390	1	15	80	0.1875000
NODE_10110_length_857_cov_27.853562	310	390	3	43	80	0.5375000
NODE_10110_length_857_cov_27.853562	310	390	4	9	80	0.1125000
NODE_10110_length_857_cov_27.853562	310	390	5	13	80	0.1625000
NODE_10110_length_857_cov_27.853562	363	443	2	24	80	0.3000000
NODE_10110_length_857_cov_27.853562	363	443	3	5	80	0.0625000
NODE_10110_length_857_cov_27.853562	363	443	4	38	80	0.4750000
NODE_10110_length_857_cov_27.853562	363	443	5	13	80	0.1625000
NODE_10111_length_857_cov_24.654354	282	362	5	2	80	0.0250000
NODE_10111_length_857_cov_24.654354	282	362	6	13	80	0.1625000
NODE_10111_length_857_cov_24.654354	282	362	8	6	80	0.0750000
NODE_10111_length_857_cov_24.654354	282	362	9	50	80	0.6250000
NODE_10111_length_857_cov_24.654354	282	362	10	9	80	0.1125000
NODE_10111_length_857_cov_24.654354	335	415	1	14	80	0.1750000
NODE_10111_length_857_cov_24.654354	335	415	3	2	80	0.0250000
NODE_10111_length_857_cov_24.654354	335	415	4	6	80	0.0750000
NODE_10111_length_857_cov_24.654354	335	415	6	38	80	0.4750000
NODE_10111_length_857_cov_24.654354	335	415	9	20	80	0.2500000
NODE_10112_length_857_cov_22.604222	374	456	4	15	82	0.1829268
NODE_10112_length_857_cov_22.604222	374	456	5	30	82	0.3658537
NODE_10112_length_857_cov_22.604222	374	456	6	31	82	0.3780488
NODE_10112_length_857_cov_22.604222	374	456	7	6	82	0.0731707
NODE_10112_length_857_cov_22.604222	427	509	4	18	82	0.2195122
NODE_10112_length_857_cov_22.604222	427	509	5	21	82	0.2560976
NODE_10112_length_857_cov_22.604222	427	509	6	12	82	0.1463415
NODE_10112_length_857_cov_22.604222	427	509	7	31	82	0.3780488
NODE_10113_length_857_cov_17.399736	320	400	3	55	80	0.6875000
NODE_10113_length_857_cov_17.399736	320	400	4	25	80	0.3125000
NODE_10113_length_857_cov_17.399736	373	453	2	23	80	0.2875000
NODE_10113_length_857_cov_17.399736	373	453	3	17	80	0.2125000
NODE_10113_length_857_cov_17.399736	373	453	4	40	80	0.5000000
NODE_10114_length_857_cov_17.069921	388	468	10	1	80	0.0125000
NODE_10114_length_857_cov_17.069921	388	468	11	40	80	0.5000000
NODE_10114_length_857_cov_17.069921	388	468	12	28	80	0.3500000
NODE_10114_length_857_cov_17.069921	388	468	13	4	80	0.0500000
NODE_10114_length_857_cov_17.069921	388	468	14	7	80	0.0875000
NODE_10114_length_857_cov_17.069921	441	521	6	2	80	0.0250000
NODE_10114_length_857_cov_17.069921	441	521	7	7	80	0.0875000
NODE_10114_length_857_cov_17.069921	441	521	9	15	80	0.1875000
NODE_10114_length_857_cov_17.069921	441	521	10	28	80	0.3500000
NODE_10114_length_857_cov_17.069921	441	521	12	23	80	0.2875000
NODE_10114_length_857_cov_17.069921	441	521	14	5	80	0.0625000
NODE_10115_length_857_cov_11.816623	433	513	1	9	80	0.1125000
NODE_10115_length_857_cov_11.816623	433	513	2	52	80	0.6500000
NODE_10115_length_857_cov_11.816623	433	513	3	19	80	0.2375000
NODE_10115_length_857_cov_11.816623	486	566	2	69	80	0.8625000
NODE_10115_length_857_cov_11.816623	486	566	3	11	80	0.1375000
NODE_10116_length_857_cov_6.733509	513	593	2	32	80	0.4000000
NODE_10116_length_857_cov_6.733509	513	593	3	25	80	0.3125000
NODE_10116_length_857_cov_6.733509	513	593	4	23	80	0.2875000
NODE_10117_length_857_cov_6.251979	298	378	2	80	80	1.0000000
NODE_10117_length_857_cov_6.251979	351	431	1	48	80	0.6000000
NODE_10117_length_857_cov_6.251979	351	431	2	32	80	0.4000000
NODE_10118_length_857_cov_5.827177	323	403	4	12	80	0.1500000
NODE_10118_length_857_cov_5.827177	323	403	5	68	80	0.8500000
NODE_10118_length_857_cov_5.827177	376	456	4	65	80	0.8125000
NODE_10118_length_857_cov_5.827177	376	456	5	15	80	0.1875000
NODE_10120_length_857_cov_4.530343	362	442	0	19	80	0.2375000
NODE_10120_length_857_cov_4.530343	362	442	2	21	80	0.2625000
NODE_10120_length_857_cov_4.530343	362	442	4	4	80	0.0500000
NODE_10120_length_857_cov_4.530343	362	442	6	36	80	0.4500000
NODE_10120_length_857_cov_4.530343	415	495	4	35	80	0.4375000
NODE_10120_length_857_cov_4.530343	415	495	6	45	80	0.5625000
NODE_10128_length_857_cov_1.464380	179	249	2	64	70	0.9142857
NODE_10128_length_857_cov_1.464380	179	249	3	6	70	0.0857143
NODE_10128_length_857_cov_1.464380	222	288	2	66	66	1.0000000
NODE_10138_length_856_cov_39.147952	157	237	2	31	80	0.3875000
NODE_10138_length_856_cov_39.147952	157	237	3	25	80	0.3125000
NODE_10138_length_856_cov_39.147952	157	237	4	17	80	0.2125000
NODE_10138_length_856_cov_39.147952	157	237	6	4	80	0.0500000
NODE_10138_length_856_cov_39.147952	157	237	7	3	80	0.0375000
NODE_10138_length_856_cov_39.147952	210	290	3	3	80	0.0375000
NODE_10138_length_856_cov_39.147952	210	290	4	17	80	0.2125000
NODE_10138_length_856_cov_39.147952	210	290	6	4	80	0.0500000
NODE_10138_length_856_cov_39.147952	210	290	7	6	80	0.0750000
NODE_10138_length_856_cov_39.147952	210	290	9	39	80	0.4875000
NODE_10138_length_856_cov_39.147952	210	290	10	5	80	0.0625000
NODE_10138_length_856_cov_39.147952	210	290	11	6	80	0.0750000
NODE_10138_length_856_cov_39.147952	286	366	9	15	80	0.1875000
NODE_10138_length_856_cov_39.147952	286	366	10	11	80	0.1375000
NODE_10138_length_856_cov_39.147952	286	366	11	34	80	0.4250000
NODE_10138_length_856_cov_39.147952	286	366	12	15	80	0.1875000
NODE_10138_length_856_cov_39.147952	286	366	13	5	80	0.0625000
NODE_10138_length_856_cov_39.147952	339	419	5	35	80	0.4375000
NODE_10138_length_856_cov_39.147952	339	419	6	17	80	0.2125000
NODE_10138_length_856_cov_39.147952	339	419	10	4	80	0.0500000
NODE_10138_length_856_cov_39.147952	339	419	11	19	80	0.2375000
NODE_10138_length_856_cov_39.147952	339	419	13	5	80	0.0625000
NODE_10139_length_856_cov_21.937913	353	433	2	60	80	0.7500000
NODE_10139_length_856_cov_21.937913	353	433	3	20	80	0.2500000
NODE_10139_length_856_cov_21.937913	406	486	0	7	80	0.0875000
NODE_10139_length_856_cov_21.937913	406	486	1	26	80	0.3250000
NODE_10139_length_856_cov_21.937913	406	486	2	47	80	0.5875000
NODE_10140_length_856_cov_20.227213	375	459	4	56	84	0.6666667
NODE_10140_length_856_cov_20.227213	375	459	5	28	84	0.3333333
NODE_10140_length_856_cov_20.227213	432	512	2	15	80	0.1875000
NODE_10140_length_856_cov_20.227213	432	512	4	30	80	0.3750000
NODE_10140_length_856_cov_20.227213	432	512	5	35	80	0.4375000
NODE_10141_length_856_cov_18.445178	340	420	4	10	80	0.1250000
NODE_10141_length_856_cov_18.445178	340	420	6	39	80	0.4875000
NODE_10141_length_856_cov_18.445178	340	420	7	31	80	0.3875000
NODE_10141_length_856_cov_18.445178	393	473	3	16	80	0.2000000
NODE_10141_length_856_cov_18.445178	393	473	4	30	80	0.3750000
NODE_10141_length_856_cov_18.445178	393	473	6	34	80	0.4250000
NODE_10142_length_856_cov_16.564069	462	543	0	22	81	0.2716049
NODE_10142_length_856_cov_16.564069	462	543	2	39	81	0.4814815
NODE_10142_length_856_cov_16.564069	462	543	3	20	81	0.2469136
NODE_10142_length_856_cov_16.564069	516	596	2	7	80	0.0875000
NODE_10142_length_856_cov_16.564069	516	596	3	20	80	0.2500000
NODE_10142_length_856_cov_16.564069	516	596	4	53	80	0.6625000
NODE_10142_length_856_cov_16.564069	516	593	2	7	77	0.0909091
NODE_10142_length_856_cov_16.564069	516	593	3	20	77	0.2597403
NODE_10142_length_856_cov_16.564069	516	593	4	50	77	0.6493506
NODE_10143_length_856_cov_15.803170	403	483	2	71	80	0.8875000
NODE_10143_length_856_cov_15.803170	403	483	4	9	80	0.1125000
NODE_10143_length_856_cov_15.803170	456	536	2	69	80	0.8625000
NODE_10143_length_856_cov_15.803170	456	536	4	11	80	0.1375000
NODE_10144_length_856_cov_12.904888	345	425	4	16	80	0.2000000
NODE_10144_length_856_cov_12.904888	345	425	6	35	80	0.4375000
NODE_10144_length_856_cov_12.904888	345	425	7	8	80	0.1000000
NODE_10144_length_856_cov_12.904888	345	425	8	7	80	0.0875000
NODE_10144_length_856_cov_12.904888	345	425	10	4	80	0.0500000
NODE_10144_length_856_cov_12.904888	345	425	11	10	80	0.1250000
NODE_10144_length_856_cov_12.904888	398	478	7	6	80	0.0750000
NODE_10144_length_856_cov_12.904888	398	478	8	32	80	0.4000000
NODE_10144_length_856_cov_12.904888	398	478	10	12	80	0.1500000
NODE_10144_length_856_cov_12.904888	398	478	11	30	80	0.3750000
NODE_10145_length_856_cov_9.881110	338	418	2	12	80	0.1500000
NODE_10145_length_856_cov_9.881110	338	418	3	17	80	0.2125000
NODE_10145_length_856_cov_9.881110	338	418	4	51	80	0.6375000
NODE_10145_length_856_cov_9.881110	391	471	0	3	80	0.0375000
NODE_10145_length_856_cov_9.881110	391	471	1	32	80	0.4000000
NODE_10145_length_856_cov_9.881110	391	471	2	30	80	0.3750000
NODE_10145_length_856_cov_9.881110	391	471	3	15	80	0.1875000
NODE_10146_length_856_cov_5.875826	405	485	0	80	80	1.0000000
NODE_10146_length_856_cov_5.875826	458	538	0	80	80	1.0000000
NODE_10149_length_856_cov_4.821664	466	546	0	80	80	1.0000000
NODE_10149_length_856_cov_4.821664	519	599	0	80	80	1.0000000
NODE_10151_length_856_cov_4.195509	248	328	1	80	80	1.0000000
NODE_10151_length_856_cov_4.195509	301	381	1	46	80	0.5750000
NODE_10151_length_856_cov_4.195509	301	381	2	34	80	0.4250000
NODE_10152_length_856_cov_3.899604	262	339	3	40	77	0.5194805
NODE_10152_length_856_cov_3.899604	262	339	4	37	77	0.4805195
NODE_10152_length_856_cov_3.899604	312	392	1	52	80	0.6500000
NODE_10152_length_856_cov_3.899604	312	392	3	28	80	0.3500000
NODE_10176_length_855_cov_28.312169	541	621	1	16	80	0.2000000
NODE_10176_length_855_cov_28.312169	541	621	2	64	80	0.8000000
NODE_10176_length_855_cov_28.312169	594	674	1	12	80	0.1500000
NODE_10176_length_855_cov_28.312169	594	674	2	68	80	0.8500000
NODE_10177_length_855_cov_19.392857	692	772	6	16	80	0.2000000
NODE_10177_length_855_cov_19.392857	692	772	7	5	80	0.0625000
NODE_10177_length_855_cov_19.392857	692	772	8	8	80	0.1000000
NODE_10177_length_855_cov_19.392857	692	772	9	30	80	0.3750000
NODE_10177_length_855_cov_19.392857	692	772	10	21	80	0.2625000
NODE_10177_length_855_cov_19.392857	745	825	0	11	80	0.1375000
NODE_10177_length_855_cov_19.392857	745	825	2	12	80	0.1500000
NODE_10177_length_855_cov_19.392857	745	825	4	21	80	0.2625000
NODE_10177_length_855_cov_19.392857	745	825	6	21	80	0.2625000
NODE_10177_length_855_cov_19.392857	745	825	7	5	80	0.0625000
NODE_10177_length_855_cov_19.392857	745	825	9	10	80	0.1250000
NODE_10178_length_855_cov_13.402116	343	423	2	32	80	0.4000000
NODE_10178_length_855_cov_13.402116	343	423	4	39	80	0.4875000
NODE_10178_length_855_cov_13.402116	343	423	6	9	80	0.1125000
NODE_10178_length_855_cov_13.402116	396	476	3	4	80	0.0500000
NODE_10178_length_855_cov_13.402116	396	476	4	18	80	0.2250000
NODE_10178_length_855_cov_13.402116	396	476	5	1	80	0.0125000
NODE_10178_length_855_cov_13.402116	396	476	6	57	80	0.7125000
NODE_10179_length_855_cov_13.116402	295	375	2	32	80	0.4000000
NODE_10179_length_855_cov_13.116402	295	375	3	6	80	0.0750000
NODE_10179_length_855_cov_13.116402	295	375	4	24	80	0.3000000
NODE_10179_length_855_cov_13.116402	295	375	5	18	80	0.2250000
NODE_10179_length_855_cov_13.116402	348	428	2	7	80	0.0875000
NODE_10179_length_855_cov_13.116402	348	428	4	2	80	0.0250000
NODE_10179_length_855_cov_13.116402	348	428	5	40	80	0.5000000
NODE_10179_length_855_cov_13.116402	348	428	6	31	80	0.3875000
NODE_10180_length_855_cov_11.179894	360	436	0	19	76	0.2500000
NODE_10180_length_855_cov_11.179894	360	436	2	57	76	0.7500000
NODE_10180_length_855_cov_11.179894	409	489	2	80	80	1.0000000
NODE_10183_length_855_cov_8.593915	339	419	0	80	80	1.0000000
NODE_10183_length_855_cov_8.593915	392	472	0	80	80	1.0000000
NODE_10206_length_854_cov_64.200000	586	666	26	14	80	0.1750000
NODE_10206_length_854_cov_64.200000	586	666	27	15	80	0.1875000
NODE_10206_length_854_cov_64.200000	586	666	28	10	80	0.1250000
NODE_10206_length_854_cov_64.200000	586	666	30	1	80	0.0125000
NODE_10206_length_854_cov_64.200000	586	666	32	5	80	0.0625000
NODE_10206_length_854_cov_64.200000	586	666	34	4	80	0.0500000
NODE_10206_length_854_cov_64.200000	586	666	35	3	80	0.0375000
NODE_10206_length_854_cov_64.200000	586	666	36	3	80	0.0375000
NODE_10206_length_854_cov_64.200000	586	666	37	5	80	0.0625000
NODE_10206_length_854_cov_64.200000	586	666	38	10	80	0.1250000
NODE_10206_length_854_cov_64.200000	586	666	39	4	80	0.0500000
NODE_10206_length_854_cov_64.200000	586	666	40	6	80	0.0750000
NODE_10206_length_854_cov_64.200000	639	719	23	7	80	0.0875000
NODE_10206_length_854_cov_64.200000	639	719	24	1	80	0.0125000
NODE_10206_length_854_cov_64.200000	639	719	25	2	80	0.0250000
NODE_10206_length_854_cov_64.200000	639	719	26	1	80	0.0125000
NODE_10206_length_854_cov_64.200000	639	719	28	4	80	0.0500000
NODE_10206_length_854_cov_64.200000	639	719	29	7	80	0.0875000
NODE_10206_length_854_cov_64.200000	639	719	30	6	80	0.0750000
NODE_10206_length_854_cov_64.200000	639	719	31	10	80	0.1250000
NODE_10206_length_854_cov_64.200000	639	719	32	2	80	0.0250000
NODE_10206_length_854_cov_64.200000	639	719	33	1	80	0.0125000
NODE_10206_length_854_cov_64.200000	639	719	34	3	80	0.0375000
NODE_10206_length_854_cov_64.200000	639	719	36	3	80	0.0375000
NODE_10206_length_854_cov_64.200000	639	719	37	5	80	0.0625000
NODE_10206_length_854_cov_64.200000	639	719	38	18	80	0.2250000
NODE_10206_length_854_cov_64.200000	639	719	39	4	80	0.0500000
NODE_10206_length_854_cov_64.200000	639	719	40	6	80	0.0750000
NODE_10207_length_854_cov_46.037086	348	428	3	20	80	0.2500000
NODE_10207_length_854_cov_46.037086	348	428	4	14	80	0.1750000
NODE_10207_length_854_cov_46.037086	348	428	6	10	80	0.1250000
NODE_10207_length_854_cov_46.037086	348	428	8	29	80	0.3625000
NODE_10207_length_854_cov_46.037086	348	428	10	7	80	0.0875000
NODE_10207_length_854_cov_46.037086	401	481	6	14	80	0.1750000
NODE_10207_length_854_cov_46.037086	401	481	8	31	80	0.3875000
NODE_10207_length_854_cov_46.037086	401	481	10	35	80	0.4375000
NODE_10207_length_854_cov_46.037086	458	481	6	14	23	0.6086956
NODE_10207_length_854_cov_46.037086	458	481	8	9	23	0.3913043
NODE_10208_length_854_cov_45.633113	393	473	12	26	80	0.3250000
NODE_10208_length_854_cov_45.633113	393	473	14	22	80	0.2750000
NODE_10208_length_854_cov_45.633113	393	473	15	16	80	0.2000000
NODE_10208_length_854_cov_45.633113	393	473	16	12	80	0.1500000
NODE_10208_length_854_cov_45.633113	393	473	17	4	80	0.0500000
NODE_10208_length_854_cov_45.633113	446	526	6	4	80	0.0500000
NODE_10208_length_854_cov_45.633113	446	526	8	22	80	0.2750000
NODE_10208_length_854_cov_45.633113	446	526	9	4	80	0.0500000
NODE_10208_length_854_cov_45.633113	446	526	10	2	80	0.0250000
NODE_10208_length_854_cov_45.633113	446	526	12	4	80	0.0500000
NODE_10208_length_854_cov_45.633113	446	526	14	34	80	0.4250000
NODE_10208_length_854_cov_45.633113	446	526	15	4	80	0.0500000
NODE_10208_length_854_cov_45.633113	446	526	16	2	80	0.0250000
NODE_10208_length_854_cov_45.633113	446	526	17	4	80	0.0500000
NODE_10209_length_854_cov_40.407947	489	569	1	32	80	0.4000000
NODE_10209_length_854_cov_40.407947	489	569	2	17	80	0.2125000
NODE_10209_length_854_cov_40.407947	489	569	3	6	80	0.0750000
NODE_10209_length_854_cov_40.407947	489	569	4	25	80	0.3125000
NODE_10209_length_854_cov_40.407947	542	622	3	2	80	0.0250000
NODE_10209_length_854_cov_40.407947	542	622	4	27	80	0.3375000
NODE_10209_length_854_cov_40.407947	542	622	5	4	80	0.0500000
NODE_10209_length_854_cov_40.407947	542	622	6	20	80	0.2500000
NODE_10209_length_854_cov_40.407947	542	622	7	17	80	0.2125000
NODE_10209_length_854_cov_40.407947	542	622	8	10	80	0.1250000
NODE_10210_length_854_cov_29.773510	450	530	4	35	80	0.4375000
NODE_10210_length_854_cov_29.773510	450	530	5	3	80	0.0375000
NODE_10210_length_854_cov_29.773510	450	530	6	42	80	0.5250000
NODE_10210_length_854_cov_29.773510	503	583	4	7	80	0.0875000
NODE_10210_length_854_cov_29.773510	503	583	5	17	80	0.2125000
NODE_10210_length_854_cov_29.773510	503	583	6	56	80	0.7000000
NODE_10211_length_854_cov_22.968212	318	398	2	11	80	0.1375000
NODE_10211_length_854_cov_22.968212	318	398	3	9	80	0.1125000
NODE_10211_length_854_cov_22.968212	318	398	4	1	80	0.0125000
NODE_10211_length_854_cov_22.968212	318	398	5	11	80	0.1375000
NODE_10211_length_854_cov_22.968212	318	398	6	24	80	0.3000000
NODE_10211_length_854_cov_22.968212	318	398	7	24	80	0.3000000
NODE_10211_length_854_cov_22.968212	371	451	6	3	80	0.0375000
NODE_10211_length_854_cov_22.968212	371	451	7	24	80	0.3000000
NODE_10211_length_854_cov_22.968212	371	451	8	6	80	0.0750000
NODE_10211_length_854_cov_22.968212	371	451	10	7	80	0.0875000
NODE_10211_length_854_cov_22.968212	371	451	11	6	80	0.0750000
NODE_10211_length_854_cov_22.968212	371	451	12	34	80	0.4250000
NODE_10212_length_854_cov_18.038411	387	467	5	6	80	0.0750000
NODE_10212_length_854_cov_18.038411	387	467	6	45	80	0.5625000
NODE_10212_length_854_cov_18.038411	387	467	7	16	80	0.2000000
NODE_10212_length_854_cov_18.038411	387	467	8	13	80	0.1625000
NODE_10212_length_854_cov_18.038411	440	520	1	4	80	0.0500000
NODE_10212_length_854_cov_18.038411	440	520	2	2	80	0.0250000
NODE_10212_length_854_cov_18.038411	440	520	3	19	80	0.2375000
NODE_10212_length_854_cov_18.038411	440	520	5	34	80	0.4250000
NODE_10212_length_854_cov_18.038411	440	520	6	21	80	0.2625000
NODE_10213_length_854_cov_13.774834	330	410	0	80	80	1.0000000
NODE_10213_length_854_cov_13.774834	383	463	0	80	80	1.0000000
NODE_10214_length_854_cov_11.998675	366	446	3	17	80	0.2125000
NODE_10214_length_854_cov_11.998675	366	446	4	14	80	0.1750000
NODE_10214_length_854_cov_11.998675	366	446	5	27	80	0.3375000
NODE_10214_length_854_cov_11.998675	366	446	6	9	80	0.1125000
NODE_10214_length_854_cov_11.998675	366	446	7	13	80	0.1625000
NODE_10214_length_854_cov_11.998675	419	499	5	5	80	0.0625000
NODE_10214_length_854_cov_11.998675	419	499	6	62	80	0.7750000
NODE_10214_length_854_cov_11.998675	419	499	7	13	80	0.1625000
NODE_10215_length_854_cov_7.600000	298	378	4	9	80	0.1125000
NODE_10215_length_854_cov_7.600000	298	378	5	18	80	0.2250000
NODE_10215_length_854_cov_7.600000	298	378	6	24	80	0.3000000
NODE_10215_length_854_cov_7.600000	298	378	7	29	80	0.3625000
NODE_10215_length_854_cov_7.600000	351	431	4	38	80	0.4750000
NODE_10215_length_854_cov_7.600000	351	431	5	16	80	0.2000000
NODE_10215_length_854_cov_7.600000	351	431	6	17	80	0.2125000
NODE_10215_length_854_cov_7.600000	351	431	7	9	80	0.1125000
NODE_10218_length_854_cov_4.939073	603	633	2	30	30	1.0000000
NODE_10226_length_854_cov_2.354967	613	633	0	20	20	1.0000000
NODE_10239_length_853_cov_61.988064	380	460	2	7	80	0.0875000
NODE_10239_length_853_cov_61.988064	380	460	3	51	80	0.6375000
NODE_10239_length_853_cov_61.988064	380	460	5	22	80	0.2750000
NODE_10239_length_853_cov_61.988064	433	513	3	5	80	0.0625000
NODE_10239_length_853_cov_61.988064	433	513	4	3	80	0.0375000
NODE_10239_length_853_cov_61.988064	433	513	5	72	80	0.9000000
NODE_10240_length_853_cov_33.683024	384	464	4	43	80	0.5375000
NODE_10240_length_853_cov_33.683024	384	464	5	1	80	0.0125000
NODE_10240_length_853_cov_33.683024	384	464	7	11	80	0.1375000
NODE_10240_length_853_cov_33.683024	384	464	8	13	80	0.1625000
NODE_10240_length_853_cov_33.683024	384	464	9	12	80	0.1500000
NODE_10240_length_853_cov_33.683024	437	517	7	6	80	0.0750000
NODE_10240_length_853_cov_33.683024	437	517	8	9	80	0.1125000
NODE_10240_length_853_cov_33.683024	437	517	9	32	80	0.4000000
NODE_10240_length_853_cov_33.683024	437	517	10	33	80	0.4125000
NODE_10241_length_853_cov_31.965517	224	305	5	24	81	0.2962963
NODE_10241_length_853_cov_31.965517	224	305	6	57	81	0.7037037
NODE_10241_length_853_cov_31.965517	278	358	2	12	80	0.1500000
NODE_10241_length_853_cov_31.965517	278	358	3	28	80	0.3500000
NODE_10241_length_853_cov_31.965517	278	358	4	9	80	0.1125000
NODE_10241_length_853_cov_31.965517	278	358	5	5	80	0.0625000
NODE_10241_length_853_cov_31.965517	278	358	6	26	80	0.3250000
NODE_10241_length_853_cov_31.965517	354	434	1	58	80	0.7250000
NODE_10241_length_853_cov_31.965517	354	434	2	22	80	0.2750000
NODE_10241_length_853_cov_31.965517	407	466	1	22	59	0.3728814
NODE_10241_length_853_cov_31.965517	407	466	2	31	59	0.5254237
NODE_10241_length_853_cov_31.965517	407	466	3	6	59	0.1016949
NODE_10242_length_853_cov_16.551724	247	327	1	14	80	0.1750000
NODE_10242_length_853_cov_16.551724	247	327	2	40	80	0.5000000
NODE_10242_length_853_cov_16.551724	247	327	3	3	80	0.0375000
NODE_10242_length_853_cov_16.551724	247	327	4	23	80	0.2875000
NODE_10242_length_853_cov_16.551724	300	380	2	1	80	0.0125000
NODE_10242_length_853_cov_16.551724	300	380	3	3	80	0.0375000
NODE_10242_length_853_cov_16.551724	300	380	4	58	80	0.7250000
NODE_10242_length_853_cov_16.551724	300	380	5	4	80	0.0500000
NODE_10242_length_853_cov_16.551724	300	380	6	14	80	0.1750000
NODE_10242_length_853_cov_16.551724	376	456	3	2	80	0.0250000
NODE_10242_length_853_cov_16.551724	376	456	4	3	80	0.0375000
NODE_10242_length_853_cov_16.551724	376	456	5	40	80	0.5000000
NODE_10242_length_853_cov_16.551724	376	456	6	35	80	0.4375000
NODE_10242_length_853_cov_16.551724	429	509	2	17	80	0.2125000
NODE_10242_length_853_cov_16.551724	429	509	3	38	80	0.4750000
NODE_10242_length_853_cov_16.551724	429	509	4	3	80	0.0375000
NODE_10242_length_853_cov_16.551724	429	509	5	22	80	0.2750000
NODE_10243_length_853_cov_15.395225	395	475	2	66	80	0.8250000
NODE_10243_length_853_cov_15.395225	395	475	4	9	80	0.1125000
NODE_10243_length_853_cov_15.395225	395	475	6	5	80	0.0625000
NODE_10243_length_853_cov_15.395225	448	528	2	13	80	0.1625000
NODE_10243_length_853_cov_15.395225	448	528	4	9	80	0.1125000
NODE_10243_length_853_cov_15.395225	448	528	6	43	80	0.5375000
NODE_10243_length_853_cov_15.395225	448	528	8	15	80	0.1875000
NODE_10244_length_853_cov_15.086207	355	434	2	26	79	0.3291139
NODE_10244_length_853_cov_15.086207	355	434	3	10	79	0.1265823
NODE_10244_length_853_cov_15.086207	355	434	4	26	79	0.3291139
NODE_10244_length_853_cov_15.086207	355	434	5	17	79	0.2151899
NODE_10244_length_853_cov_15.086207	408	488	1	10	80	0.1250000
NODE_10244_length_853_cov_15.086207	408	488	3	54	80	0.6750000
NODE_10244_length_853_cov_15.086207	408	488	5	16	80	0.2000000
NODE_10245_length_853_cov_14.929708	160	240	0	32	80	0.4000000
NODE_10245_length_853_cov_14.929708	160	240	1	48	80	0.6000000
NODE_10245_length_853_cov_14.929708	213	293	1	80	80	1.0000000
NODE_10246_length_853_cov_11.299735	395	475	1	80	80	1.0000000
NODE_10246_length_853_cov_11.299735	448	528	1	31	80	0.3875000
NODE_10246_length_853_cov_11.299735	448	528	2	19	80	0.2375000
NODE_10246_length_853_cov_11.299735	448	528	3	30	80	0.3750000
NODE_10247_length_853_cov_9.571618	479	559	4	32	80	0.4000000
NODE_10247_length_853_cov_9.571618	479	559	5	14	80	0.1750000
NODE_10247_length_853_cov_9.571618	479	559	7	4	80	0.0500000
NODE_10247_length_853_cov_9.571618	479	559	8	3	80	0.0375000
NODE_10247_length_853_cov_9.571618	479	559	9	16	80	0.2000000
NODE_10247_length_853_cov_9.571618	479	559	10	11	80	0.1375000
NODE_10247_length_853_cov_9.571618	532	612	7	1	80	0.0125000
NODE_10247_length_853_cov_9.571618	532	612	8	3	80	0.0375000
NODE_10247_length_853_cov_9.571618	532	612	9	44	80	0.5500000
NODE_10247_length_853_cov_9.571618	532	612	10	32	80	0.4000000
NODE_10248_length_853_cov_7.828912	265	345	1	37	80	0.4625000
NODE_10248_length_853_cov_7.828912	265	345	3	43	80	0.5375000
NODE_10248_length_853_cov_7.828912	318	398	1	2	80	0.0250000
NODE_10248_length_853_cov_7.828912	318	398	2	22	80	0.2750000
NODE_10248_length_853_cov_7.828912	318	398	3	56	80	0.7000000
NODE_10249_length_853_cov_7.623342	255	335	4	53	80	0.6625000
NODE_10249_length_853_cov_7.623342	255	335	6	27	80	0.3375000
NODE_10249_length_853_cov_7.623342	308	388	2	18	80	0.2250000
NODE_10249_length_853_cov_7.623342	308	388	4	1	80	0.0125000
NODE_10249_length_853_cov_7.623342	308	388	6	61	80	0.7625000
NODE_10253_length_853_cov_3.173740	212	292	0	40	80	0.5000000
NODE_10253_length_853_cov_3.173740	212	292	1	40	80	0.5000000
NODE_10253_length_853_cov_3.173740	265	343	1	78	78	1.0000000
NODE_10258_length_853_cov_1.823607	710	773	0	63	63	1.0000000
NODE_10258_length_853_cov_1.823607	711	773	0	62	62	1.0000000
NODE_10258_length_853_cov_1.823607	711	773	0	62	62	1.0000000
NODE_10258_length_853_cov_1.823607	746	826	0	80	80	1.0000000
NODE_10267_length_852_cov_30.022576	279	359	2	16	80	0.2000000
NODE_10267_length_852_cov_30.022576	279	359	3	25	80	0.3125000
NODE_10267_length_852_cov_30.022576	279	359	4	16	80	0.2000000
NODE_10267_length_852_cov_30.022576	279	359	6	23	80	0.2875000
NODE_10267_length_852_cov_30.022576	332	412	4	25	80	0.3125000
NODE_10267_length_852_cov_30.022576	332	412	6	55	80	0.6875000
NODE_10268_length_852_cov_19.373174	353	433	3	4	80	0.0500000
NODE_10268_length_852_cov_19.373174	353	433	4	12	80	0.1500000
NODE_10268_length_852_cov_19.373174	353	433	5	28	80	0.3500000
NODE_10268_length_852_cov_19.373174	353	433	6	16	80	0.2000000
NODE_10268_length_852_cov_19.373174	353	433	7	20	80	0.2500000
NODE_10268_length_852_cov_19.373174	406	486	2	13	80	0.1625000
NODE_10268_length_852_cov_19.373174	406	486	3	9	80	0.1125000
NODE_10268_length_852_cov_19.373174	406	486	4	47	80	0.5875000
NODE_10268_length_852_cov_19.373174	406	486	5	11	80	0.1375000
NODE_10269_length_852_cov_18.853918	297	377	3	3	80	0.0375000
NODE_10269_length_852_cov_18.853918	297	377	4	42	80	0.5250000
NODE_10269_length_852_cov_18.853918	297	377	5	3	80	0.0375000
NODE_10269_length_852_cov_18.853918	297	377	6	32	80	0.4000000
NODE_10269_length_852_cov_18.853918	350	430	3	12	80	0.1500000
NODE_10269_length_852_cov_18.853918	350	430	4	68	80	0.8500000
NODE_10269_length_852_cov_18.853918	426	506	0	51	80	0.6375000
NODE_10269_length_852_cov_18.853918	426	506	1	3	80	0.0375000
NODE_10269_length_852_cov_18.853918	426	506	2	2	80	0.0250000
NODE_10269_length_852_cov_18.853918	426	506	3	24	80	0.3000000
NODE_10269_length_852_cov_18.853918	489	559	0	70	70	1.0000000
NODE_10270_length_852_cov_17.391766	472	552	2	4	80	0.0500000
NODE_10270_length_852_cov_17.391766	472	552	3	3	80	0.0375000
NODE_10270_length_852_cov_17.391766	472	552	5	2	80	0.0250000
NODE_10270_length_852_cov_17.391766	472	552	7	38	80	0.4750000
NODE_10270_length_852_cov_17.391766	472	552	9	33	80	0.4125000
NODE_10270_length_852_cov_17.391766	525	605	5	4	80	0.0500000
NODE_10270_length_852_cov_17.391766	525	605	7	65	80	0.8125000
NODE_10270_length_852_cov_17.391766	525	605	9	11	80	0.1375000
NODE_10271_length_852_cov_8.818061	513	593	0	80	80	1.0000000
NODE_10271_length_852_cov_8.818061	566	646	0	80	80	1.0000000
NODE_10274_length_852_cov_4.403718	493	573	2	6	80	0.0750000
NODE_10274_length_852_cov_4.403718	493	573	3	32	80	0.4000000
NODE_10274_length_852_cov_4.403718	493	573	4	42	80	0.5250000
NODE_10274_length_852_cov_4.403718	546	626	1	33	80	0.4125000
NODE_10274_length_852_cov_4.403718	546	626	2	26	80	0.3250000
NODE_10274_length_852_cov_4.403718	546	626	4	21	80	0.2625000
NODE_10285_length_851_cov_33.953457	329	409	6	9	80	0.1125000
NODE_10285_length_851_cov_33.953457	329	409	7	49	80	0.6125000
NODE_10285_length_851_cov_33.953457	329	409	8	16	80	0.2000000
NODE_10285_length_851_cov_33.953457	329	409	9	1	80	0.0125000
NODE_10285_length_851_cov_33.953457	329	409	10	5	80	0.0625000
NODE_10285_length_851_cov_33.953457	382	462	5	7	80	0.0875000
NODE_10285_length_851_cov_33.953457	382	462	6	15	80	0.1875000
NODE_10285_length_851_cov_33.953457	382	462	7	17	80	0.2125000
NODE_10285_length_851_cov_33.953457	382	462	8	11	80	0.1375000
NODE_10285_length_851_cov_33.953457	382	462	9	3	80	0.0375000
NODE_10285_length_851_cov_33.953457	382	462	10	27	80	0.3375000
NODE_10286_length_851_cov_30.488032	395	475	2	20	80	0.2500000
NODE_10286_length_851_cov_30.488032	395	475	3	16	80	0.2000000
NODE_10286_length_851_cov_30.488032	395	475	4	44	80	0.5500000
NODE_10286_length_851_cov_30.488032	448	528	2	16	80	0.2000000
NODE_10286_length_851_cov_30.488032	448	528	3	14	80	0.1750000
NODE_10286_length_851_cov_30.488032	448	528	4	50	80	0.6250000
NODE_10287_length_851_cov_27.481383	353	433	10	11	80	0.1375000
NODE_10287_length_851_cov_27.481383	353	433	11	19	80	0.2375000
NODE_10287_length_851_cov_27.481383	353	433	12	36	80	0.4500000
NODE_10287_length_851_cov_27.481383	353	433	13	4	80	0.0500000
NODE_10287_length_851_cov_27.481383	353	433	14	10	80	0.1250000
NODE_10287_length_851_cov_27.481383	406	486	9	29	80	0.3625000
NODE_10287_length_851_cov_27.481383	406	486	10	2	80	0.0250000
NODE_10287_length_851_cov_27.481383	406	486	11	3	80	0.0375000
NODE_10287_length_851_cov_27.481383	406	486	12	14	80	0.1750000
NODE_10287_length_851_cov_27.481383	406	486	13	10	80	0.1250000
NODE_10287_length_851_cov_27.481383	406	486	14	22	80	0.2750000
NODE_10288_length_851_cov_23.656915	345	425	3	3	80	0.0375000
NODE_10288_length_851_cov_23.656915	345	425	4	39	80	0.4875000
NODE_10288_length_851_cov_23.656915	345	425	5	38	80	0.4750000
NODE_10288_length_851_cov_23.656915	398	478	4	16	80	0.2000000
NODE_10288_length_851_cov_23.656915	398	478	5	64	80	0.8000000
NODE_10289_length_851_cov_19.769947	298	378	5	6	80	0.0750000
NODE_10289_length_851_cov_19.769947	298	378	6	4	80	0.0500000
NODE_10289_length_851_cov_19.769947	298	378	7	33	80	0.4125000
NODE_10289_length_851_cov_19.769947	298	378	8	37	80	0.4625000
NODE_10289_length_851_cov_19.769947	351	431	4	9	80	0.1125000
NODE_10289_length_851_cov_19.769947	351	431	5	8	80	0.1000000
NODE_10289_length_851_cov_19.769947	351	431	6	7	80	0.0875000
NODE_10289_length_851_cov_19.769947	351	431	7	5	80	0.0625000
NODE_10289_length_851_cov_19.769947	351	431	8	51	80	0.6375000
NODE_10290_length_851_cov_17.386968	459	539	4	64	80	0.8000000
NODE_10290_length_851_cov_17.386968	459	539	5	16	80	0.2000000
NODE_10290_length_851_cov_17.386968	512	592	2	10	80	0.1250000
NODE_10290_length_851_cov_17.386968	512	592	3	1	80	0.0125000
NODE_10290_length_851_cov_17.386968	512	592	4	62	80	0.7750000
NODE_10290_length_851_cov_17.386968	512	592	5	7	80	0.0875000
NODE_10291_length_851_cov_13.519947	323	403	1	11	80	0.1375000
NODE_10291_length_851_cov_13.519947	323	403	3	6	80	0.0750000
NODE_10291_length_851_cov_13.519947	323	403	5	2	80	0.0250000
NODE_10291_length_851_cov_13.519947	323	403	6	48	80	0.6000000
NODE_10291_length_851_cov_13.519947	323	403	8	13	80	0.1625000
NODE_10291_length_851_cov_13.519947	376	456	6	14	80	0.1750000
NODE_10291_length_851_cov_13.519947	376	456	8	19	80	0.2375000
NODE_10291_length_851_cov_13.519947	376	456	9	18	80	0.2250000
NODE_10291_length_851_cov_13.519947	376	456	10	7	80	0.0875000
NODE_10291_length_851_cov_13.519947	376	456	11	7	80	0.0875000
NODE_10291_length_851_cov_13.519947	376	456	12	15	80	0.1875000
NODE_10292_length_851_cov_11.771277	403	483	8	26	80	0.3250000
NODE_10292_length_851_cov_11.771277	403	483	9	29	80	0.3625000
NODE_10292_length_851_cov_11.771277	403	483	10	25	80	0.3125000
NODE_10292_length_851_cov_11.771277	456	536	5	21	80	0.2625000
NODE_10292_length_851_cov_11.771277	456	536	6	19	80	0.2375000
NODE_10292_length_851_cov_11.771277	456	536	7	1	80	0.0125000
NODE_10292_length_851_cov_11.771277	456	536	8	15	80	0.1875000
NODE_10292_length_851_cov_11.771277	456	536	9	5	80	0.0625000
NODE_10292_length_851_cov_11.771277	456	536	10	19	80	0.2375000
NODE_10293_length_851_cov_11.698138	227	307	0	80	80	1.0000000
NODE_10293_length_851_cov_11.698138	280	360	0	65	80	0.8125000
NODE_10293_length_851_cov_11.698138	280	360	1	1	80	0.0125000
NODE_10293_length_851_cov_11.698138	280	360	2	1	80	0.0125000
NODE_10293_length_851_cov_11.698138	280	360	3	4	80	0.0500000
NODE_10293_length_851_cov_11.698138	280	360	4	9	80	0.1125000
NODE_10293_length_851_cov_11.698138	356	436	2	8	80	0.1000000
NODE_10293_length_851_cov_11.698138	356	436	4	72	80	0.9000000
NODE_10293_length_851_cov_11.698138	409	489	2	61	80	0.7625000
NODE_10293_length_851_cov_11.698138	409	489	4	19	80	0.2375000
NODE_10294_length_851_cov_11.672872	372	452	0	7	80	0.0875000
NODE_10294_length_851_cov_11.672872	372	452	1	19	80	0.2375000
NODE_10294_length_851_cov_11.672872	372	452	3	3	80	0.0375000
NODE_10294_length_851_cov_11.672872	372	452	5	51	80	0.6375000
NODE_10294_length_851_cov_11.672872	425	505	5	80	80	1.0000000
NODE_10295_length_851_cov_10.938830	418	499	1	13	81	0.1604938
NODE_10295_length_851_cov_10.938830	418	499	3	38	81	0.4691358
NODE_10295_length_851_cov_10.938830	418	499	4	30	81	0.3703704
NODE_10296_length_851_cov_10.074468	454	534	3	80	80	1.0000000
NODE_10296_length_851_cov_10.074468	507	587	1	22	80	0.2750000
NODE_10296_length_851_cov_10.074468	507	587	2	8	80	0.1000000
NODE_10296_length_851_cov_10.074468	507	587	3	50	80	0.6250000
NODE_10297_length_851_cov_7.599734	330	410	1	15	80	0.1875000
NODE_10297_length_851_cov_7.599734	330	410	2	65	80	0.8125000
NODE_10297_length_851_cov_7.599734	383	463	1	43	80	0.5375000
NODE_10297_length_851_cov_7.599734	383	463	2	37	80	0.4625000
NODE_10298_length_851_cov_5.639628	379	459	0	80	80	1.0000000
NODE_10298_length_851_cov_5.639628	432	512	0	80	80	1.0000000
NODE_10300_length_851_cov_3.880319	729	765	0	36	36	1.0000000
NODE_10300_length_851_cov_3.880319	743	824	0	81	81	1.0000000
NODE_10301_length_851_cov_3.823138	380	460	1	80	80	1.0000000
NODE_10301_length_851_cov_3.823138	433	513	0	24	80	0.3000000
NODE_10301_length_851_cov_3.823138	433	513	1	56	80	0.7000000
NODE_10318_length_851_cov_1.130319	33	103	1	70	70	1.0000000
NODE_10326_length_850_cov_36.527297	360	440	6	1	80	0.0125000
NODE_10326_length_850_cov_36.527297	360	440	7	7	80	0.0875000
NODE_10326_length_850_cov_36.527297	360	440	8	71	80	0.8875000
NODE_10326_length_850_cov_36.527297	360	440	9	1	80	0.0125000
NODE_10326_length_850_cov_36.527297	413	493	5	23	80	0.2875000
NODE_10326_length_850_cov_36.527297	413	493	7	37	80	0.4625000
NODE_10326_length_850_cov_36.527297	413	493	8	19	80	0.2375000
NODE_10326_length_850_cov_36.527297	413	493	9	1	80	0.0125000
NODE_10327_length_850_cov_31.006658	330	410	1	14	80	0.1750000
NODE_10327_length_850_cov_31.006658	330	410	2	1	80	0.0125000
NODE_10327_length_850_cov_31.006658	330	410	3	44	80	0.5500000
NODE_10327_length_850_cov_31.006658	330	410	4	21	80	0.2625000
NODE_10327_length_850_cov_31.006658	383	463	1	40	80	0.5000000
NODE_10327_length_850_cov_31.006658	383	463	2	5	80	0.0625000
NODE_10327_length_850_cov_31.006658	383	463	3	35	80	0.4375000
NODE_10328_length_850_cov_30.460719	251	331	5	10	80	0.1250000
NODE_10328_length_850_cov_30.460719	251	331	6	15	80	0.1875000
NODE_10328_length_850_cov_30.460719	251	331	7	5	80	0.0625000
NODE_10328_length_850_cov_30.460719	251	331	8	2	80	0.0250000
NODE_10328_length_850_cov_30.460719	251	331	10	19	80	0.2375000
NODE_10328_length_850_cov_30.460719	251	331	11	29	80	0.3625000
NODE_10328_length_850_cov_30.460719	304	384	7	12	80	0.1500000
NODE_10328_length_850_cov_30.460719	304	384	9	14	80	0.1750000
NODE_10328_length_850_cov_30.460719	304	384	10	28	80	0.3500000
NODE_10328_length_850_cov_30.460719	304	384	11	26	80	0.3250000
NODE_10329_length_850_cov_25.263648	355	435	3	51	80	0.6375000
NODE_10329_length_850_cov_25.263648	355	435	4	29	80	0.3625000
NODE_10329_length_850_cov_25.263648	408	488	2	7	80	0.0875000
NODE_10329_length_850_cov_25.263648	408	488	3	66	80	0.8250000
NODE_10329_length_850_cov_25.263648	408	488	4	7	80	0.0875000
NODE_10330_length_850_cov_21.368842	290	370	6	5	80	0.0625000
NODE_10330_length_850_cov_21.368842	290	370	7	33	80	0.4125000
NODE_10330_length_850_cov_21.368842	290	370	8	41	80	0.5125000
NODE_10330_length_850_cov_21.368842	290	370	9	1	80	0.0125000
NODE_10330_length_850_cov_21.368842	343	423	7	18	80	0.2250000
NODE_10330_length_850_cov_21.368842	343	423	8	11	80	0.1375000
NODE_10330_length_850_cov_21.368842	343	423	9	13	80	0.1625000
NODE_10330_length_850_cov_21.368842	343	423	10	30	80	0.3750000
NODE_10330_length_850_cov_21.368842	343	423	11	8	80	0.1000000
NODE_10331_length_850_cov_20.500666	318	398	3	11	80	0.1375000
NODE_10331_length_850_cov_20.500666	318	398	5	20	80	0.2500000
NODE_10331_length_850_cov_20.500666	318	398	7	16	80	0.2000000
NODE_10331_length_850_cov_20.500666	318	398	9	2	80	0.0250000
NODE_10331_length_850_cov_20.500666	318	398	10	31	80	0.3875000
NODE_10331_length_850_cov_20.500666	371	451	6	9	80	0.1125000
NODE_10331_length_850_cov_20.500666	371	451	8	18	80	0.2250000
NODE_10331_length_850_cov_20.500666	371	451	10	53	80	0.6625000
NODE_10332_length_850_cov_17.268975	398	478	0	1	80	0.0125000
NODE_10332_length_850_cov_17.268975	398	478	1	52	80	0.6500000
NODE_10332_length_850_cov_17.268975	398	478	2	27	80	0.3375000
NODE_10332_length_850_cov_17.268975	451	531	0	54	80	0.6750000
NODE_10332_length_850_cov_17.268975	451	531	1	26	80	0.3250000
NODE_10333_length_850_cov_14.728362	379	459	1	1	80	0.0125000
NODE_10333_length_850_cov_14.728362	379	459	2	11	80	0.1375000
NODE_10333_length_850_cov_14.728362	379	459	4	9	80	0.1125000
NODE_10333_length_850_cov_14.728362	379	459	5	35	80	0.4375000
NODE_10333_length_850_cov_14.728362	379	459	6	24	80	0.3000000
NODE_10333_length_850_cov_14.728362	432	512	4	35	80	0.4375000
NODE_10333_length_850_cov_14.728362	432	512	6	45	80	0.5625000
NODE_10334_length_850_cov_14.230360	313	393	0	80	80	1.0000000
NODE_10334_length_850_cov_14.230360	366	446	0	80	80	1.0000000
NODE_10335_length_850_cov_12.387483	337	417	2	18	80	0.2250000
NODE_10335_length_850_cov_12.387483	337	417	3	3	80	0.0375000
NODE_10335_length_850_cov_12.387483	337	417	4	59	80	0.7375000
NODE_10335_length_850_cov_12.387483	390	470	0	30	80	0.3750000
NODE_10335_length_850_cov_12.387483	390	470	2	21	80	0.2625000
NODE_10335_length_850_cov_12.387483	390	470	3	5	80	0.0625000
NODE_10335_length_850_cov_12.387483	390	470	4	24	80	0.3000000
NODE_10335_length_850_cov_12.387483	466	545	0	79	79	1.0000000
NODE_10335_length_850_cov_12.387483	518	598	0	80	80	1.0000000
NODE_10336_length_850_cov_11.402130	329	409	4	55	80	0.6875000
NODE_10336_length_850_cov_11.402130	329	409	5	25	80	0.3125000
NODE_10336_length_850_cov_11.402130	382	462	1	30	80	0.3750000
NODE_10336_length_850_cov_11.402130	382	462	3	2	80	0.0250000
NODE_10336_length_850_cov_11.402130	382	462	4	2	80	0.0250000
NODE_10336_length_850_cov_11.402130	382	462	5	46	80	0.5750000
NODE_10337_length_850_cov_10.326232	330	410	0	80	80	1.0000000
NODE_10337_length_850_cov_10.326232	383	463	0	80	80	1.0000000
NODE_10338_length_850_cov_9.675100	464	544	0	80	80	1.0000000
NODE_10338_length_850_cov_9.675100	517	597	0	80	80	1.0000000
NODE_10367_length_849_cov_43.137333	336	416	3	29	80	0.3625000
NODE_10367_length_849_cov_43.137333	336	416	4	34	80	0.4250000
NODE_10367_length_849_cov_43.137333	336	416	5	17	80	0.2125000
NODE_10367_length_849_cov_43.137333	389	469	3	10	80	0.1250000
NODE_10367_length_849_cov_43.137333	389	469	5	46	80	0.5750000
NODE_10367_length_849_cov_43.137333	389	469	6	24	80	0.3000000
NODE_10368_length_849_cov_36.562667	326	406	4	11	80	0.1375000
NODE_10368_length_849_cov_36.562667	326	406	5	11	80	0.1375000
NODE_10368_length_849_cov_36.562667	326	406	7	58	80	0.7250000
NODE_10368_length_849_cov_36.562667	379	459	3	1	80	0.0125000
NODE_10368_length_849_cov_36.562667	379	459	5	12	80	0.1500000
NODE_10368_length_849_cov_36.562667	379	459	6	15	80	0.1875000
NODE_10368_length_849_cov_36.562667	379	459	7	52	80	0.6500000
NODE_10369_length_849_cov_35.449333	408	488	12	16	80	0.2000000
NODE_10369_length_849_cov_35.449333	408	488	14	6	80	0.0750000
NODE_10369_length_849_cov_35.449333	408	488	15	10	80	0.1250000
NODE_10369_length_849_cov_35.449333	408	488	17	41	80	0.5125000
NODE_10369_length_849_cov_35.449333	408	488	19	4	80	0.0500000
NODE_10369_length_849_cov_35.449333	408	488	21	3	80	0.0375000
NODE_10369_length_849_cov_35.449333	461	541	12	2	80	0.0250000
NODE_10369_length_849_cov_35.449333	461	541	14	7	80	0.0875000
NODE_10369_length_849_cov_35.449333	461	541	16	6	80	0.0750000
NODE_10369_length_849_cov_35.449333	461	541	17	34	80	0.4250000
NODE_10369_length_849_cov_35.449333	461	541	18	6	80	0.0750000
NODE_10369_length_849_cov_35.449333	461	541	19	5	80	0.0625000
NODE_10369_length_849_cov_35.449333	461	541	20	9	80	0.1125000
NODE_10369_length_849_cov_35.449333	461	541	21	11	80	0.1375000
NODE_10370_length_849_cov_29.989333	332	412	9	12	80	0.1500000
NODE_10370_length_849_cov_29.989333	332	412	10	17	80	0.2125000
NODE_10370_length_849_cov_29.989333	332	412	11	13	80	0.1625000
NODE_10370_length_849_cov_29.989333	332	412	12	31	80	0.3875000
NODE_10370_length_849_cov_29.989333	332	412	13	7	80	0.0875000
NODE_10370_length_849_cov_29.989333	385	465	2	14	80	0.1750000
NODE_10370_length_849_cov_29.989333	385	465	3	10	80	0.1250000
NODE_10370_length_849_cov_29.989333	385	465	5	1	80	0.0125000
NODE_10370_length_849_cov_29.989333	385	465	8	21	80	0.2625000
NODE_10370_length_849_cov_29.989333	385	465	9	19	80	0.2375000
NODE_10370_length_849_cov_29.989333	385	465	10	15	80	0.1875000
NODE_10371_length_849_cov_17.974667	343	423	8	8	80	0.1000000
NODE_10371_length_849_cov_17.974667	343	423	9	8	80	0.1000000
NODE_10371_length_849_cov_17.974667	343	423	10	64	80	0.8000000
NODE_10371_length_849_cov_17.974667	396	476	7	33	80	0.4125000
NODE_10371_length_849_cov_17.974667	396	476	8	28	80	0.3500000
NODE_10371_length_849_cov_17.974667	396	476	9	8	80	0.1000000
NODE_10371_length_849_cov_17.974667	396	476	10	11	80	0.1375000
NODE_10372_length_849_cov_17.018667	360	440	5	25	80	0.3125000
NODE_10372_length_849_cov_17.018667	360	440	6	55	80	0.6875000
NODE_10372_length_849_cov_17.018667	416	493	2	10	77	0.1298701
NODE_10372_length_849_cov_17.018667	416	493	3	28	77	0.3636364
NODE_10372_length_849_cov_17.018667	416	493	4	7	77	0.0909091
NODE_10372_length_849_cov_17.018667	416	493	5	9	77	0.1168831
NODE_10372_length_849_cov_17.018667	416	493	6	23	77	0.2987013
NODE_10373_length_849_cov_15.581333	287	367	0	80	80	1.0000000
NODE_10373_length_849_cov_15.581333	340	420	0	80	80	1.0000000
NODE_10373_length_849_cov_15.581333	416	496	0	19	80	0.2375000
NODE_10373_length_849_cov_15.581333	416	496	2	61	80	0.7625000
NODE_10373_length_849_cov_15.581333	469	549	2	80	80	1.0000000
NODE_10374_length_849_cov_9.460000	370	450	1	15	80	0.1875000
NODE_10374_length_849_cov_9.460000	370	450	2	65	80	0.8125000
NODE_10374_length_849_cov_9.460000	423	503	2	80	80	1.0000000
NODE_10375_length_849_cov_4.893333	427	507	0	4	80	0.0500000
NODE_10375_length_849_cov_4.893333	427	507	1	76	80	0.9500000
NODE_10375_length_849_cov_4.893333	480	560	1	64	80	0.8000000
NODE_10375_length_849_cov_4.893333	480	560	2	16	80	0.2000000
NODE_10376_length_849_cov_4.860000	380	460	2	80	80	1.0000000
NODE_10376_length_849_cov_4.860000	433	513	0	51	80	0.6375000
NODE_10376_length_849_cov_4.860000	433	513	2	29	80	0.3625000
NODE_10379_length_849_cov_2.761333	254	334	0	80	80	1.0000000
NODE_10396_length_848_cov_27.287049	253	333	3	1	80	0.0125000
NODE_10396_length_848_cov_27.287049	253	333	4	25	80	0.3125000
NODE_10396_length_848_cov_27.287049	253	333	5	27	80	0.3375000
NODE_10396_length_848_cov_27.287049	253	333	6	27	80	0.3375000
NODE_10396_length_848_cov_27.287049	306	386	5	33	80	0.4125000
NODE_10396_length_848_cov_27.287049	306	386	6	25	80	0.3125000
NODE_10396_length_848_cov_27.287049	306	386	7	22	80	0.2750000
NODE_10396_length_848_cov_27.287049	382	458	4	18	76	0.2368421
NODE_10396_length_848_cov_27.287049	382	458	5	27	76	0.3552631
NODE_10396_length_848_cov_27.287049	382	458	6	31	76	0.4078947
NODE_10396_length_848_cov_27.287049	435	513	4	45	78	0.5769231
NODE_10396_length_848_cov_27.287049	435	513	5	31	78	0.3974359
NODE_10396_length_848_cov_27.287049	435	513	6	2	78	0.0256410
NODE_10397_length_848_cov_23.511348	248	328	0	80	80	1.0000000
NODE_10397_length_848_cov_23.511348	301	381	0	61	80	0.7625000
NODE_10397_length_848_cov_23.511348	301	381	2	1	80	0.0125000
NODE_10397_length_848_cov_23.511348	301	381	4	6	80	0.0750000
NODE_10397_length_848_cov_23.511348	301	381	5	12	80	0.1500000
NODE_10397_length_848_cov_23.511348	377	457	5	26	80	0.3250000
NODE_10397_length_848_cov_23.511348	377	457	6	17	80	0.2125000
NODE_10397_length_848_cov_23.511348	377	457	7	37	80	0.4625000
NODE_10397_length_848_cov_23.511348	430	508	3	23	78	0.2948718
NODE_10397_length_848_cov_23.511348	430	508	5	3	78	0.0384615
NODE_10397_length_848_cov_23.511348	430	508	7	52	78	0.6666667
NODE_10398_length_848_cov_21.939920	295	375	7	33	80	0.4125000
NODE_10398_length_848_cov_21.939920	295	375	8	3	80	0.0375000
NODE_10398_length_848_cov_21.939920	295	375	9	38	80	0.4750000
NODE_10398_length_848_cov_21.939920	295	375	10	6	80	0.0750000
NODE_10398_length_848_cov_21.939920	348	428	7	18	80	0.2250000
NODE_10398_length_848_cov_21.939920	348	428	8	9	80	0.1125000
NODE_10398_length_848_cov_21.939920	348	428	9	47	80	0.5875000
NODE_10398_length_848_cov_21.939920	348	428	10	6	80	0.0750000
NODE_10399_length_848_cov_21.937250	434	514	2	47	80	0.5875000
NODE_10399_length_848_cov_21.937250	434	514	3	4	80	0.0500000
NODE_10399_length_848_cov_21.937250	434	514	4	29	80	0.3625000
NODE_10399_length_848_cov_21.937250	487	567	3	19	80	0.2375000
NODE_10399_length_848_cov_21.937250	487	567	4	29	80	0.3625000
NODE_10399_length_848_cov_21.937250	487	567	5	32	80	0.4000000
NODE_10400_length_848_cov_19.500668	367	392	4	25	25	1.0000000
NODE_10400_length_848_cov_19.500668	388	468	4	13	80	0.1625000
NODE_10400_length_848_cov_19.500668	388	468	5	8	80	0.1000000
NODE_10400_length_848_cov_19.500668	388	468	6	59	80	0.7375000
NODE_10400_length_848_cov_19.500668	441	521	2	27	80	0.3375000
NODE_10400_length_848_cov_19.500668	441	521	3	12	80	0.1500000
NODE_10400_length_848_cov_19.500668	441	521	5	22	80	0.2750000
NODE_10400_length_848_cov_19.500668	441	521	6	19	80	0.2375000
NODE_10400_length_848_cov_19.500668	443	512	2	18	69	0.2608696
NODE_10400_length_848_cov_19.500668	443	512	3	12	69	0.1739130
NODE_10400_length_848_cov_19.500668	443	512	5	22	69	0.3188406
NODE_10400_length_848_cov_19.500668	443	512	6	17	69	0.2463768
NODE_10400_length_848_cov_19.500668	443	472	5	12	29	0.4137931
NODE_10400_length_848_cov_19.500668	443	472	6	17	29	0.5862069
NODE_10401_length_848_cov_16.566088	323	403	2	50	80	0.6250000
NODE_10401_length_848_cov_16.566088	323	403	3	24	80	0.3000000
NODE_10401_length_848_cov_16.566088	323	403	4	6	80	0.0750000
NODE_10401_length_848_cov_16.566088	376	456	2	1	80	0.0125000
NODE_10401_length_848_cov_16.566088	376	456	3	70	80	0.8750000
NODE_10401_length_848_cov_16.566088	376	456	4	9	80	0.1125000
NODE_10402_length_848_cov_16.109479	256	336	0	54	80	0.6750000
NODE_10402_length_848_cov_16.109479	256	336	1	26	80	0.3250000
NODE_10402_length_848_cov_16.109479	309	389	0	1	80	0.0125000
NODE_10402_length_848_cov_16.109479	309	389	1	42	80	0.5250000
NODE_10402_length_848_cov_16.109479	309	389	2	29	80	0.3625000
NODE_10402_length_848_cov_16.109479	309	389	3	8	80	0.1000000
NODE_10402_length_848_cov_16.109479	385	465	3	73	80	0.9125000
NODE_10402_length_848_cov_16.109479	385	465	4	7	80	0.0875000
NODE_10402_length_848_cov_16.109479	438	518	2	16	80	0.2000000
NODE_10402_length_848_cov_16.109479	438	518	3	64	80	0.8000000
NODE_10403_length_848_cov_15.919893	492	568	6	14	76	0.1842105
NODE_10403_length_848_cov_15.919893	492	568	7	35	76	0.4605263
NODE_10403_length_848_cov_15.919893	492	568	8	21	76	0.2763158
NODE_10403_length_848_cov_15.919893	492	568	9	6	76	0.0789474
NODE_10403_length_848_cov_15.919893	541	621	4	20	80	0.2500000
NODE_10403_length_848_cov_15.919893	541	621	6	28	80	0.3500000
NODE_10403_length_848_cov_15.919893	541	621	7	32	80	0.4000000
NODE_10404_length_848_cov_13.979973	269	349	2	40	80	0.5000000
NODE_10404_length_848_cov_13.979973	269	349	3	40	80	0.5000000
NODE_10404_length_848_cov_13.979973	322	402	2	71	80	0.8875000
NODE_10404_length_848_cov_13.979973	322	402	3	9	80	0.1125000
NODE_10405_length_848_cov_13.073431	343	423	1	17	80	0.2125000
NODE_10405_length_848_cov_13.073431	343	423	2	44	80	0.5500000
NODE_10405_length_848_cov_13.073431	343	423	3	19	80	0.2375000
NODE_10405_length_848_cov_13.073431	396	476	0	24	80	0.3000000
NODE_10405_length_848_cov_13.073431	396	476	2	56	80	0.7000000
NODE_10406_length_848_cov_8.523364	232	312	0	80	80	1.0000000
NODE_10406_length_848_cov_8.523364	285	365	0	80	80	1.0000000
NODE_10406_length_848_cov_8.523364	361	441	0	80	80	1.0000000
NODE_10406_length_848_cov_8.523364	414	494	0	80	80	1.0000000
NODE_10408_length_848_cov_5.903872	251	331	0	34	80	0.4250000
NODE_10408_length_848_cov_5.903872	251	331	2	46	80	0.5750000
NODE_10408_length_848_cov_5.903872	304	383	2	79	79	1.0000000
NODE_10409_length_848_cov_5.236315	378	458	2	80	80	1.0000000
NODE_10409_length_848_cov_5.236315	431	507	0	38	76	0.5000000
NODE_10409_length_848_cov_5.236315	431	507	2	38	76	0.5000000
NODE_10424_length_847_cov_56.417112	576	656	23	13	80	0.1625000
NODE_10424_length_847_cov_56.417112	576	656	24	3	80	0.0375000
NODE_10424_length_847_cov_56.417112	576	656	25	8	80	0.1000000
NODE_10424_length_847_cov_56.417112	576	656	26	11	80	0.1375000
NODE_10424_length_847_cov_56.417112	576	656	27	2	80	0.0250000
NODE_10424_length_847_cov_56.417112	576	656	28	8	80	0.1000000
NODE_10424_length_847_cov_56.417112	576	656	29	7	80	0.0875000
NODE_10424_length_847_cov_56.417112	576	656	30	14	80	0.1750000
NODE_10424_length_847_cov_56.417112	576	656	31	14	80	0.1750000
NODE_10424_length_847_cov_56.417112	629	709	20	5	80	0.0625000
NODE_10424_length_847_cov_56.417112	629	709	21	18	80	0.2250000
NODE_10424_length_847_cov_56.417112	629	709	22	7	80	0.0875000
NODE_10424_length_847_cov_56.417112	629	709	23	1	80	0.0125000
NODE_10424_length_847_cov_56.417112	629	709	24	13	80	0.1625000
NODE_10424_length_847_cov_56.417112	629	709	25	11	80	0.1375000
NODE_10424_length_847_cov_56.417112	629	709	27	1	80	0.0125000
NODE_10424_length_847_cov_56.417112	629	709	28	1	80	0.0125000
NODE_10424_length_847_cov_56.417112	629	709	29	7	80	0.0875000
NODE_10424_length_847_cov_56.417112	629	709	30	10	80	0.1250000
NODE_10424_length_847_cov_56.417112	629	709	31	6	80	0.0750000
NODE_10425_length_847_cov_27.292781	390	470	5	26	80	0.3250000
NODE_10425_length_847_cov_27.292781	390	470	6	21	80	0.2625000
NODE_10425_length_847_cov_27.292781	390	470	7	10	80	0.1250000
NODE_10425_length_847_cov_27.292781	390	470	8	23	80	0.2875000
NODE_10425_length_847_cov_27.292781	443	523	5	5	80	0.0625000
NODE_10425_length_847_cov_27.292781	443	523	6	41	80	0.5125000
NODE_10425_length_847_cov_27.292781	443	523	7	28	80	0.3500000
NODE_10425_length_847_cov_27.292781	443	523	8	6	80	0.0750000
NODE_10426_length_847_cov_24.954545	342	422	2	28	80	0.3500000
NODE_10426_length_847_cov_24.954545	342	422	3	28	80	0.3500000
NODE_10426_length_847_cov_24.954545	342	422	4	24	80	0.3000000
NODE_10426_length_847_cov_24.954545	395	475	2	24	80	0.3000000
NODE_10426_length_847_cov_24.954545	395	475	3	56	80	0.7000000
NODE_10427_length_847_cov_20.310160	341	421	0	8	80	0.1000000
NODE_10427_length_847_cov_20.310160	341	421	2	39	80	0.4875000
NODE_10427_length_847_cov_20.310160	341	421	3	28	80	0.3500000
NODE_10427_length_847_cov_20.310160	341	421	4	5	80	0.0625000
NODE_10427_length_847_cov_20.310160	394	474	2	25	80	0.3125000
NODE_10427_length_847_cov_20.310160	394	474	3	22	80	0.2750000
NODE_10427_length_847_cov_20.310160	394	474	4	33	80	0.4125000
NODE_10428_length_847_cov_19.002674	368	448	2	24	80	0.3000000
NODE_10428_length_847_cov_19.002674	368	448	4	50	80	0.6250000
NODE_10428_length_847_cov_19.002674	368	448	6	6	80	0.0750000
NODE_10428_length_847_cov_19.002674	421	501	1	9	80	0.1125000
NODE_10428_length_847_cov_19.002674	421	501	2	67	80	0.8375000
NODE_10428_length_847_cov_19.002674	421	501	4	4	80	0.0500000
NODE_10429_length_847_cov_16.879679	218	298	0	9	80	0.1125000
NODE_10429_length_847_cov_16.879679	218	298	1	35	80	0.4375000
NODE_10429_length_847_cov_16.879679	218	298	3	25	80	0.3125000
NODE_10429_length_847_cov_16.879679	218	298	4	11	80	0.1375000
NODE_10429_length_847_cov_16.879679	271	351	3	16	80	0.2000000
NODE_10429_length_847_cov_16.879679	271	351	4	64	80	0.8000000
NODE_10431_length_847_cov_11.784759	298	378	1	3	80	0.0375000
NODE_10431_length_847_cov_11.784759	298	378	2	77	80	0.9625000
NODE_10431_length_847_cov_11.784759	351	431	2	42	80	0.5250000
NODE_10431_length_847_cov_11.784759	351	431	3	1	80	0.0125000
NODE_10431_length_847_cov_11.784759	351	431	4	4	80	0.0500000
NODE_10431_length_847_cov_11.784759	351	431	6	33	80	0.4125000
NODE_10431_length_847_cov_11.784759	427	507	4	19	80	0.2375000
NODE_10431_length_847_cov_11.784759	427	507	5	30	80	0.3750000
NODE_10431_length_847_cov_11.784759	427	507	6	31	80	0.3875000
NODE_10431_length_847_cov_11.784759	480	560	3	16	80	0.2000000
NODE_10431_length_847_cov_11.784759	480	560	4	14	80	0.1750000
NODE_10431_length_847_cov_11.784759	480	560	5	24	80	0.3000000
NODE_10431_length_847_cov_11.784759	480	560	6	26	80	0.3250000
NODE_10432_length_847_cov_11.604278	407	487	3	31	80	0.3875000
NODE_10432_length_847_cov_11.604278	407	487	4	25	80	0.3125000
NODE_10432_length_847_cov_11.604278	407	487	6	24	80	0.3000000
NODE_10432_length_847_cov_11.604278	460	540	3	80	80	1.0000000
NODE_10433_length_847_cov_10.221925	395	475	0	80	80	1.0000000
NODE_10433_length_847_cov_10.221925	448	528	0	80	80	1.0000000
NODE_10434_length_847_cov_4.602941	97	154	4	9	57	0.1578947
NODE_10434_length_847_cov_4.602941	97	154	6	8	57	0.1403509
NODE_10434_length_847_cov_4.602941	97	154	8	11	57	0.1929825
NODE_10434_length_847_cov_4.602941	97	154	10	29	57	0.5087720
NODE_10434_length_847_cov_4.602941	127	207	0	47	80	0.5875000
NODE_10434_length_847_cov_4.602941	127	207	2	4	80	0.0500000
NODE_10434_length_847_cov_4.602941	127	207	3	1	80	0.0125000
NODE_10434_length_847_cov_4.602941	127	207	4	10	80	0.1250000
NODE_10434_length_847_cov_4.602941	127	207	6	8	80	0.1000000
NODE_10434_length_847_cov_4.602941	127	207	8	10	80	0.1250000
NODE_10456_length_846_cov_39.476573	336	416	1	7	80	0.0875000
NODE_10456_length_846_cov_39.476573	336	416	2	8	80	0.1000000
NODE_10456_length_846_cov_39.476573	336	416	3	48	80	0.6000000
NODE_10456_length_846_cov_39.476573	336	416	4	10	80	0.1250000
NODE_10456_length_846_cov_39.476573	336	416	5	7	80	0.0875000
NODE_10456_length_846_cov_39.476573	389	469	3	17	80	0.2125000
NODE_10456_length_846_cov_39.476573	389	469	4	18	80	0.2250000
NODE_10456_length_846_cov_39.476573	389	469	5	8	80	0.1000000
NODE_10456_length_846_cov_39.476573	389	469	6	14	80	0.1750000
NODE_10456_length_846_cov_39.476573	389	469	7	8	80	0.1000000
NODE_10456_length_846_cov_39.476573	389	469	8	6	80	0.0750000
NODE_10456_length_846_cov_39.476573	389	469	9	9	80	0.1125000
NODE_10456_length_846_cov_39.476573	465	545	7	3	80	0.0375000
NODE_10456_length_846_cov_39.476573	465	545	8	34	80	0.4250000
NODE_10456_length_846_cov_39.476573	465	545	10	12	80	0.1500000
NODE_10456_length_846_cov_39.476573	465	545	11	10	80	0.1250000
NODE_10456_length_846_cov_39.476573	465	545	12	14	80	0.1750000
NODE_10456_length_846_cov_39.476573	465	545	13	7	80	0.0875000
NODE_10456_length_846_cov_39.476573	518	598	5	2	80	0.0250000
NODE_10456_length_846_cov_39.476573	518	598	7	5	80	0.0625000
NODE_10456_length_846_cov_39.476573	518	598	9	3	80	0.0375000
NODE_10456_length_846_cov_39.476573	518	598	10	9	80	0.1125000
NODE_10456_length_846_cov_39.476573	518	598	11	24	80	0.3000000
NODE_10456_length_846_cov_39.476573	518	598	12	22	80	0.2750000
NODE_10456_length_846_cov_39.476573	518	598	13	15	80	0.1875000
NODE_10457_length_846_cov_37.297189	312	392	7	15	80	0.1875000
NODE_10457_length_846_cov_37.297189	312	392	9	13	80	0.1625000
NODE_10457_length_846_cov_37.297189	312	392	10	52	80	0.6500000
NODE_10457_length_846_cov_37.297189	365	445	3	24	80	0.3000000
NODE_10457_length_846_cov_37.297189	365	445	5	1	80	0.0125000
NODE_10457_length_846_cov_37.297189	365	445	9	13	80	0.1625000
NODE_10457_length_846_cov_37.297189	365	445	10	42	80	0.5250000
NODE_10458_length_846_cov_32.852744	279	359	2	4	80	0.0500000
NODE_10458_length_846_cov_32.852744	279	359	3	29	80	0.3625000
NODE_10458_length_846_cov_32.852744	279	359	4	33	80	0.4125000
NODE_10458_length_846_cov_32.852744	279	359	5	14	80	0.1750000
NODE_10458_length_846_cov_32.852744	332	412	2	16	80	0.2000000
NODE_10458_length_846_cov_32.852744	332	412	3	54	80	0.6750000
NODE_10458_length_846_cov_32.852744	332	412	4	10	80	0.1250000
NODE_10459_length_846_cov_31.717537	290	370	8	22	80	0.2750000
NODE_10459_length_846_cov_31.717537	290	370	9	8	80	0.1000000
NODE_10459_length_846_cov_31.717537	290	370	10	9	80	0.1125000
NODE_10459_length_846_cov_31.717537	290	370	11	2	80	0.0250000
NODE_10459_length_846_cov_31.717537	290	370	12	39	80	0.4875000
NODE_10459_length_846_cov_31.717537	343	423	9	9	80	0.1125000
NODE_10459_length_846_cov_31.717537	343	423	10	4	80	0.0500000
NODE_10459_length_846_cov_31.717537	343	423	11	22	80	0.2750000
NODE_10459_length_846_cov_31.717537	343	423	12	33	80	0.4125000
NODE_10459_length_846_cov_31.717537	343	423	14	12	80	0.1500000
NODE_10460_length_846_cov_24.380187	350	430	1	15	80	0.1875000
NODE_10460_length_846_cov_24.380187	350	430	2	65	80	0.8125000
NODE_10460_length_846_cov_24.380187	403	483	1	68	80	0.8500000
NODE_10460_length_846_cov_24.380187	403	483	2	12	80	0.1500000
NODE_10461_length_846_cov_16.155288	364	444	0	31	80	0.3875000
NODE_10461_length_846_cov_16.155288	364	444	2	49	80	0.6125000
NODE_10461_length_846_cov_16.155288	417	497	2	80	80	1.0000000
NODE_10462_length_846_cov_15.917001	398	478	0	46	80	0.5750000
NODE_10462_length_846_cov_15.917001	398	478	1	34	80	0.4250000
NODE_10462_length_846_cov_15.917001	451	531	1	80	80	1.0000000
NODE_10463_length_846_cov_15.275770	355	435	0	80	80	1.0000000
NODE_10463_length_846_cov_15.275770	408	488	0	80	80	1.0000000
NODE_10464_length_846_cov_13.618474	216	296	3	4	80	0.0500000
NODE_10464_length_846_cov_13.618474	216	296	4	3	80	0.0375000
NODE_10464_length_846_cov_13.618474	216	296	6	73	80	0.9125000
NODE_10464_length_846_cov_13.618474	269	349	6	39	80	0.4875000
NODE_10464_length_846_cov_13.618474	269	349	8	12	80	0.1500000
NODE_10464_length_846_cov_13.618474	269	349	9	11	80	0.1375000
NODE_10464_length_846_cov_13.618474	269	349	10	2	80	0.0250000
NODE_10464_length_846_cov_13.618474	269	349	11	4	80	0.0500000
NODE_10464_length_846_cov_13.618474	269	349	12	7	80	0.0875000
NODE_10464_length_846_cov_13.618474	269	349	13	5	80	0.0625000
NODE_10464_length_846_cov_13.618474	345	425	8	1	80	0.0125000
NODE_10464_length_846_cov_13.618474	345	425	9	58	80	0.7250000
NODE_10464_length_846_cov_13.618474	345	425	10	12	80	0.1500000
NODE_10464_length_846_cov_13.618474	345	425	11	9	80	0.1125000
NODE_10464_length_846_cov_13.618474	398	478	4	8	80	0.1000000
NODE_10464_length_846_cov_13.618474	398	478	5	1	80	0.0125000
NODE_10464_length_846_cov_13.618474	398	478	7	11	80	0.1375000
NODE_10464_length_846_cov_13.618474	398	478	9	60	80	0.7500000
NODE_10465_length_846_cov_12.878179	425	505	2	10	80	0.1250000
NODE_10465_length_846_cov_12.878179	425	505	3	26	80	0.3250000
NODE_10465_length_846_cov_12.878179	425	505	4	16	80	0.2000000
NODE_10465_length_846_cov_12.878179	425	505	5	7	80	0.0875000
NODE_10465_length_846_cov_12.878179	425	505	6	21	80	0.2625000
NODE_10465_length_846_cov_12.878179	478	558	4	14	80	0.1750000
NODE_10465_length_846_cov_12.878179	478	558	5	7	80	0.0875000
NODE_10465_length_846_cov_12.878179	478	558	6	59	80	0.7375000
NODE_10467_length_846_cov_7.232932	407	487	8	41	80	0.5125000
NODE_10467_length_846_cov_7.232932	407	487	9	4	80	0.0500000
NODE_10467_length_846_cov_7.232932	407	487	10	35	80	0.4375000
NODE_10467_length_846_cov_7.232932	460	540	4	2	80	0.0250000
NODE_10467_length_846_cov_7.232932	460	540	5	18	80	0.2250000
NODE_10467_length_846_cov_7.232932	460	540	7	23	80	0.2875000
NODE_10467_length_846_cov_7.232932	460	540	8	17	80	0.2125000
NODE_10467_length_846_cov_7.232932	460	540	10	20	80	0.2500000
NODE_10468_length_846_cov_6.776439	320	400	0	42	80	0.5250000
NODE_10468_length_846_cov_6.776439	320	400	2	38	80	0.4750000
NODE_10468_length_846_cov_6.776439	373	453	2	80	80	1.0000000
NODE_10472_length_846_cov_3.025435	190	270	0	80	80	1.0000000
NODE_10472_length_846_cov_3.025435	243	323	0	80	80	1.0000000
NODE_10488_length_845_cov_34.458445	213	293	7	19	80	0.2375000
NODE_10488_length_845_cov_34.458445	213	293	8	11	80	0.1375000
NODE_10488_length_845_cov_34.458445	213	293	10	5	80	0.0625000
NODE_10488_length_845_cov_34.458445	213	293	11	3	80	0.0375000
NODE_10488_length_845_cov_34.458445	213	293	13	10	80	0.1250000
NODE_10488_length_845_cov_34.458445	213	293	14	5	80	0.0625000
NODE_10488_length_845_cov_34.458445	213	293	16	2	80	0.0250000
NODE_10488_length_845_cov_34.458445	213	293	17	19	80	0.2375000
NODE_10488_length_845_cov_34.458445	213	293	18	6	80	0.0750000
NODE_10488_length_845_cov_34.458445	266	346	10	6	80	0.0750000
NODE_10488_length_845_cov_34.458445	266	346	11	11	80	0.1375000
NODE_10488_length_845_cov_34.458445	266	346	12	2	80	0.0250000
NODE_10488_length_845_cov_34.458445	266	346	13	5	80	0.0625000
NODE_10488_length_845_cov_34.458445	266	346	15	23	80	0.2875000
NODE_10488_length_845_cov_34.458445	266	346	16	2	80	0.0250000
NODE_10488_length_845_cov_34.458445	266	346	17	24	80	0.3000000
NODE_10488_length_845_cov_34.458445	266	346	18	7	80	0.0875000
NODE_10489_length_845_cov_33.025469	309	389	6	9	80	0.1125000
NODE_10489_length_845_cov_33.025469	309	389	7	1	80	0.0125000
NODE_10489_length_845_cov_33.025469	309	389	8	2	80	0.0250000
NODE_10489_length_845_cov_33.025469	309	389	9	10	80	0.1250000
NODE_10489_length_845_cov_33.025469	309	389	10	58	80	0.7250000
NODE_10489_length_845_cov_33.025469	362	442	0	10	80	0.1250000
NODE_10489_length_845_cov_33.025469	362	442	1	7	80	0.0875000
NODE_10489_length_845_cov_33.025469	362	442	3	9	80	0.1125000
NODE_10489_length_845_cov_33.025469	362	442	7	28	80	0.3500000
NODE_10489_length_845_cov_33.025469	362	442	10	26	80	0.3250000
NODE_10490_length_845_cov_30.331099	288	368	11	7	80	0.0875000
NODE_10490_length_845_cov_30.331099	288	368	12	46	80	0.5750000
NODE_10490_length_845_cov_30.331099	288	368	13	27	80	0.3375000
NODE_10490_length_845_cov_30.331099	341	421	5	1	80	0.0125000
NODE_10490_length_845_cov_30.331099	341	421	7	12	80	0.1500000
NODE_10490_length_845_cov_30.331099	341	421	8	24	80	0.3000000
NODE_10490_length_845_cov_30.331099	341	421	10	6	80	0.0750000
NODE_10490_length_845_cov_30.331099	341	421	11	12	80	0.1500000
NODE_10490_length_845_cov_30.331099	341	421	12	25	80	0.3125000
NODE_10491_length_845_cov_22.042895	455	535	4	16	80	0.2000000
NODE_10491_length_845_cov_22.042895	455	535	6	8	80	0.1000000
NODE_10491_length_845_cov_22.042895	455	535	7	12	80	0.1500000
NODE_10491_length_845_cov_22.042895	455	535	8	44	80	0.5500000
NODE_10491_length_845_cov_22.042895	508	588	2	34	80	0.4250000
NODE_10491_length_845_cov_22.042895	508	588	3	2	80	0.0250000
NODE_10491_length_845_cov_22.042895	508	588	4	33	80	0.4125000
NODE_10491_length_845_cov_22.042895	508	588	6	8	80	0.1000000
NODE_10491_length_845_cov_22.042895	508	588	7	3	80	0.0375000
NODE_10492_length_845_cov_20.662198	325	406	2	15	81	0.1851852
NODE_10492_length_845_cov_20.662198	325	406	3	9	81	0.1111111
NODE_10492_length_845_cov_20.662198	325	406	4	54	81	0.6666667
NODE_10492_length_845_cov_20.662198	325	406	5	3	81	0.0370370
NODE_10492_length_845_cov_20.662198	379	459	3	9	80	0.1125000
NODE_10492_length_845_cov_20.662198	379	459	4	15	80	0.1875000
NODE_10492_length_845_cov_20.662198	379	459	5	56	80	0.7000000
NODE_10493_length_845_cov_17.214477	352	432	5	24	80	0.3000000
NODE_10493_length_845_cov_17.214477	352	432	6	56	80	0.7000000
NODE_10493_length_845_cov_17.214477	405	485	1	1	80	0.0125000
NODE_10493_length_845_cov_17.214477	405	485	2	10	80	0.1250000
NODE_10493_length_845_cov_17.214477	405	485	3	1	80	0.0125000
NODE_10493_length_845_cov_17.214477	405	485	4	22	80	0.2750000
NODE_10493_length_845_cov_17.214477	405	485	5	23	80	0.2875000
NODE_10493_length_845_cov_17.214477	405	485	6	23	80	0.2875000
NODE_10494_length_845_cov_15.805630	409	489	4	6	80	0.0750000
NODE_10494_length_845_cov_15.805630	409	489	5	20	80	0.2500000
NODE_10494_length_845_cov_15.805630	409	489	6	54	80	0.6750000
NODE_10494_length_845_cov_15.805630	462	542	3	9	80	0.1125000
NODE_10494_length_845_cov_15.805630	462	542	4	21	80	0.2625000
NODE_10494_length_845_cov_15.805630	462	542	5	29	80	0.3625000
NODE_10494_length_845_cov_15.805630	462	542	6	21	80	0.2625000
NODE_10495_length_845_cov_13.443700	329	409	0	25	80	0.3125000
NODE_10495_length_845_cov_13.443700	329	409	2	55	80	0.6875000
NODE_10495_length_845_cov_13.443700	382	462	0	78	80	0.9750000
NODE_10495_length_845_cov_13.443700	382	462	2	2	80	0.0250000
NODE_10496_length_845_cov_12.301609	334	414	2	14	80	0.1750000
NODE_10496_length_845_cov_12.301609	334	414	4	66	80	0.8250000
NODE_10496_length_845_cov_12.301609	387	467	2	13	80	0.1625000
NODE_10496_length_845_cov_12.301609	387	467	4	67	80	0.8375000
NODE_10497_length_845_cov_11.836461	389	469	4	24	80	0.3000000
NODE_10497_length_845_cov_11.836461	389	469	5	2	80	0.0250000
NODE_10497_length_845_cov_11.836461	389	469	6	24	80	0.3000000
NODE_10497_length_845_cov_11.836461	389	469	7	30	80	0.3750000
NODE_10497_length_845_cov_11.836461	442	522	4	76	80	0.9500000
NODE_10497_length_845_cov_11.836461	442	522	5	2	80	0.0250000
NODE_10497_length_845_cov_11.836461	442	522	6	2	80	0.0250000
NODE_10499_length_845_cov_8.140751	439	519	1	80	80	1.0000000
NODE_10499_length_845_cov_8.140751	492	572	0	14	80	0.1750000
NODE_10499_length_845_cov_8.140751	492	572	1	66	80	0.8250000
NODE_10516_length_845_cov_1.680965	447	491	0	44	44	1.0000000
NODE_10528_length_844_cov_43.778523	313	393	4	13	80	0.1625000
NODE_10528_length_844_cov_43.778523	313	393	5	52	80	0.6500000
NODE_10528_length_844_cov_43.778523	313	393	7	15	80	0.1875000
NODE_10528_length_844_cov_43.778523	366	446	4	7	80	0.0875000
NODE_10528_length_844_cov_43.778523	366	446	5	5	80	0.0625000
NODE_10528_length_844_cov_43.778523	366	446	7	19	80	0.2375000
NODE_10528_length_844_cov_43.778523	366	446	8	8	80	0.1000000
NODE_10528_length_844_cov_43.778523	366	446	9	1	80	0.0125000
NODE_10528_length_844_cov_43.778523	366	446	10	4	80	0.0500000
NODE_10528_length_844_cov_43.778523	366	446	11	22	80	0.2750000
NODE_10528_length_844_cov_43.778523	366	446	12	5	80	0.0625000
NODE_10528_length_844_cov_43.778523	366	446	13	9	80	0.1125000
NODE_10528_length_844_cov_43.778523	442	522	12	8	80	0.1000000
NODE_10528_length_844_cov_43.778523	442	522	13	13	80	0.1625000
NODE_10528_length_844_cov_43.778523	442	522	15	4	80	0.0500000
NODE_10528_length_844_cov_43.778523	442	522	16	2	80	0.0250000
NODE_10528_length_844_cov_43.778523	442	522	18	30	80	0.3750000
NODE_10528_length_844_cov_43.778523	442	522	19	23	80	0.2875000
NODE_10528_length_844_cov_43.778523	495	575	13	4	80	0.0500000
NODE_10528_length_844_cov_43.778523	495	575	15	11	80	0.1375000
NODE_10528_length_844_cov_43.778523	495	575	16	13	80	0.1625000
NODE_10528_length_844_cov_43.778523	495	575	17	1	80	0.0125000
NODE_10528_length_844_cov_43.778523	495	575	18	38	80	0.4750000
NODE_10528_length_844_cov_43.778523	495	575	19	13	80	0.1625000
NODE_10529_length_844_cov_36.762416	381	461	2	67	80	0.8375000
NODE_10529_length_844_cov_36.762416	381	461	3	13	80	0.1625000
NODE_10529_length_844_cov_36.762416	434	514	1	8	80	0.1000000
NODE_10529_length_844_cov_36.762416	434	514	2	49	80	0.6125000
NODE_10529_length_844_cov_36.762416	434	514	3	23	80	0.2875000
NODE_10529_length_844_cov_36.762416	510	590	3	42	80	0.5250000
NODE_10529_length_844_cov_36.762416	510	590	4	5	80	0.0625000
NODE_10529_length_844_cov_36.762416	510	590	5	33	80	0.4125000
NODE_10529_length_844_cov_36.762416	563	644	2	12	81	0.1481481
NODE_10529_length_844_cov_36.762416	563	644	4	45	81	0.5555556
NODE_10529_length_844_cov_36.762416	563	644	5	24	81	0.2962963
NODE_10530_length_844_cov_35.765101	424	504	6	30	80	0.3750000
NODE_10530_length_844_cov_35.765101	424	504	7	3	80	0.0375000
NODE_10530_length_844_cov_35.765101	424	504	8	24	80	0.3000000
NODE_10530_length_844_cov_35.765101	424	504	9	7	80	0.0875000
NODE_10530_length_844_cov_35.765101	424	504	10	16	80	0.2000000
NODE_10530_length_844_cov_35.765101	477	557	3	9	80	0.1125000
NODE_10530_length_844_cov_35.765101	477	557	6	59	80	0.7375000
NODE_10530_length_844_cov_35.765101	477	557	7	1	80	0.0125000
NODE_10530_length_844_cov_35.765101	477	557	8	11	80	0.1375000
NODE_10531_length_844_cov_18.445638	353	420	0	29	67	0.4328358
NODE_10531_length_844_cov_18.445638	353	420	1	8	67	0.1194030
NODE_10531_length_844_cov_18.445638	353	420	2	30	67	0.4477612
NODE_10531_length_844_cov_18.445638	393	473	2	80	80	1.0000000
NODE_10532_length_844_cov_12.616107	363	443	4	1	80	0.0125000
NODE_10532_length_844_cov_12.616107	363	443	5	12	80	0.1500000
NODE_10532_length_844_cov_12.616107	363	443	6	2	80	0.0250000
NODE_10532_length_844_cov_12.616107	363	443	7	18	80	0.2250000
NODE_10532_length_844_cov_12.616107	363	443	8	11	80	0.1375000
NODE_10532_length_844_cov_12.616107	363	443	9	1	80	0.0125000
NODE_10532_length_844_cov_12.616107	363	443	10	24	80	0.3000000
NODE_10532_length_844_cov_12.616107	363	443	11	11	80	0.1375000
NODE_10532_length_844_cov_12.616107	416	496	10	16	80	0.2000000
NODE_10532_length_844_cov_12.616107	416	496	11	24	80	0.3000000
NODE_10532_length_844_cov_12.616107	416	496	12	18	80	0.2250000
NODE_10532_length_844_cov_12.616107	416	496	13	22	80	0.2750000
NODE_10533_length_844_cov_12.092617	171	251	1	80	80	1.0000000
NODE_10533_length_844_cov_12.092617	224	304	0	14	80	0.1750000
NODE_10533_length_844_cov_12.092617	224	304	1	66	80	0.8250000
NODE_10534_length_844_cov_11.883221	341	421	2	34	80	0.4250000
NODE_10534_length_844_cov_11.883221	341	421	3	46	80	0.5750000
NODE_10534_length_844_cov_11.883221	394	474	2	38	80	0.4750000
NODE_10534_length_844_cov_11.883221	394	474	3	42	80	0.5250000
NODE_10535_length_844_cov_10.571812	390	448	2	1	58	0.0172414
NODE_10535_length_844_cov_10.571812	390	448	3	57	58	0.9827586
NODE_10537_length_844_cov_9.357047	370	450	2	24	80	0.3000000
NODE_10537_length_844_cov_9.357047	370	450	3	17	80	0.2125000
NODE_10537_length_844_cov_9.357047	370	450	4	39	80	0.4875000
NODE_10537_length_844_cov_9.357047	423	503	4	80	80	1.0000000
NODE_10538_length_844_cov_8.975839	355	435	0	80	80	1.0000000
NODE_10538_length_844_cov_8.975839	408	488	0	80	80	1.0000000
NODE_10539_length_844_cov_7.347651	357	438	0	81	81	1.0000000
NODE_10539_length_844_cov_7.347651	410	491	0	81	81	1.0000000
NODE_10540_length_844_cov_6.975839	444	524	0	80	80	1.0000000
NODE_10540_length_844_cov_6.975839	497	577	0	80	80	1.0000000
NODE_10567_length_843_cov_48.258065	203	262	36	1	59	0.0169492
NODE_10567_length_843_cov_48.258065	203	262	37	1	59	0.0169492
NODE_10567_length_843_cov_48.258065	203	262	38	6	59	0.1016949
NODE_10567_length_843_cov_48.258065	203	262	39	9	59	0.1525424
NODE_10567_length_843_cov_48.258065	203	262	40	2	59	0.0338983
NODE_10567_length_843_cov_48.258065	203	262	41	11	59	0.1864407
NODE_10567_length_843_cov_48.258065	203	262	42	8	59	0.1355932
NODE_10567_length_843_cov_48.258065	203	262	43	9	59	0.1525424
NODE_10567_length_843_cov_48.258065	203	262	44	7	59	0.1186441
NODE_10567_length_843_cov_48.258065	203	262	45	5	59	0.0847458
NODE_10568_length_843_cov_31.279570	351	431	5	25	80	0.3125000
NODE_10568_length_843_cov_31.279570	351	431	6	15	80	0.1875000
NODE_10568_length_843_cov_31.279570	351	431	7	35	80	0.4375000
NODE_10568_length_843_cov_31.279570	351	431	8	5	80	0.0625000
NODE_10568_length_843_cov_31.279570	404	484	4	41	80	0.5125000
NODE_10568_length_843_cov_31.279570	404	484	5	22	80	0.2750000
NODE_10568_length_843_cov_31.279570	404	484	7	17	80	0.2125000
NODE_10569_length_843_cov_27.060484	423	503	3	1	80	0.0125000
NODE_10569_length_843_cov_27.060484	423	503	4	10	80	0.1250000
NODE_10569_length_843_cov_27.060484	423	503	5	9	80	0.1125000
NODE_10569_length_843_cov_27.060484	423	503	6	21	80	0.2625000
NODE_10569_length_843_cov_27.060484	423	503	7	31	80	0.3875000
NODE_10569_length_843_cov_27.060484	423	503	8	8	80	0.1000000
NODE_10569_length_843_cov_27.060484	476	556	5	10	80	0.1250000
NODE_10569_length_843_cov_27.060484	476	556	6	18	80	0.2250000
NODE_10569_length_843_cov_27.060484	476	556	7	52	80	0.6500000
NODE_10570_length_843_cov_22.725806	334	414	0	80	80	1.0000000
NODE_10570_length_843_cov_22.725806	339	396	0	57	57	1.0000000
NODE_10570_length_843_cov_22.725806	356	427	0	71	71	1.0000000
NODE_10570_length_843_cov_22.725806	387	455	0	62	68	0.9117647
NODE_10570_length_843_cov_22.725806	387	455	2	6	68	0.0882353
NODE_10570_length_843_cov_22.725806	401	476	0	48	75	0.6400000
NODE_10570_length_843_cov_22.725806	401	476	2	27	75	0.3600000
NODE_10570_length_843_cov_22.725806	418	486	0	31	68	0.4558823
NODE_10570_length_843_cov_22.725806	418	486	2	37	68	0.5441176
NODE_10570_length_843_cov_22.725806	449	529	2	65	80	0.8125000
NODE_10570_length_843_cov_22.725806	449	529	3	11	80	0.1375000
NODE_10570_length_843_cov_22.725806	449	529	6	4	80	0.0500000
NODE_10571_length_843_cov_22.387097	412	492	8	18	80	0.2250000
NODE_10571_length_843_cov_22.387097	412	492	10	28	80	0.3500000
NODE_10571_length_843_cov_22.387097	412	492	11	27	80	0.3375000
NODE_10571_length_843_cov_22.387097	412	492	12	7	80	0.0875000
NODE_10571_length_843_cov_22.387097	465	545	5	8	80	0.1000000
NODE_10571_length_843_cov_22.387097	465	545	6	18	80	0.2250000
NODE_10571_length_843_cov_22.387097	465	545	7	2	80	0.0250000
NODE_10571_length_843_cov_22.387097	465	545	9	6	80	0.0750000
NODE_10571_length_843_cov_22.387097	465	545	10	20	80	0.2500000
NODE_10571_length_843_cov_22.387097	465	545	11	17	80	0.2125000
NODE_10571_length_843_cov_22.387097	465	545	12	9	80	0.1125000
NODE_10572_length_843_cov_16.326613	551	631	7	1	80	0.0125000
NODE_10572_length_843_cov_16.326613	551	631	8	17	80	0.2125000
NODE_10572_length_843_cov_16.326613	551	631	10	6	80	0.0750000
NODE_10572_length_843_cov_16.326613	551	631	11	8	80	0.1000000
NODE_10572_length_843_cov_16.326613	551	631	12	3	80	0.0375000
NODE_10572_length_843_cov_16.326613	551	631	13	9	80	0.1125000
NODE_10572_length_843_cov_16.326613	551	631	14	36	80	0.4500000
NODE_10572_length_843_cov_16.326613	604	684	8	10	80	0.1250000
NODE_10572_length_843_cov_16.326613	604	684	11	11	80	0.1375000
NODE_10572_length_843_cov_16.326613	604	684	12	29	80	0.3625000
NODE_10572_length_843_cov_16.326613	604	684	14	30	80	0.3750000
NODE_10573_length_843_cov_13.478495	381	461	3	14	80	0.1750000
NODE_10573_length_843_cov_13.478495	381	461	4	12	80	0.1500000
NODE_10573_length_843_cov_13.478495	381	461	5	54	80	0.6750000
NODE_10573_length_843_cov_13.478495	434	514	2	31	80	0.3875000
NODE_10573_length_843_cov_13.478495	434	514	3	10	80	0.1250000
NODE_10573_length_843_cov_13.478495	434	514	4	28	80	0.3500000
NODE_10573_length_843_cov_13.478495	434	514	5	11	80	0.1375000
NODE_10574_length_843_cov_13.150538	448	528	0	44	80	0.5500000
NODE_10574_length_843_cov_13.150538	448	528	1	1	80	0.0125000
NODE_10574_length_843_cov_13.150538	448	528	3	35	80	0.4375000
NODE_10574_length_843_cov_13.150538	501	581	3	80	80	1.0000000
NODE_10575_length_843_cov_12.510753	360	440	0	30	80	0.3750000
NODE_10575_length_843_cov_12.510753	360	440	1	11	80	0.1375000
NODE_10575_length_843_cov_12.510753	360	440	2	5	80	0.0625000
NODE_10575_length_843_cov_12.510753	360	440	4	34	80	0.4250000
NODE_10575_length_843_cov_12.510753	413	493	4	80	80	1.0000000
NODE_10576_length_843_cov_11.090054	457	537	4	40	80	0.5000000
NODE_10576_length_843_cov_11.090054	457	537	6	40	80	0.5000000
NODE_10576_length_843_cov_11.090054	510	590	3	4	80	0.0500000
NODE_10576_length_843_cov_11.090054	510	590	4	26	80	0.3250000
NODE_10576_length_843_cov_11.090054	510	590	5	2	80	0.0250000
NODE_10576_length_843_cov_11.090054	510	590	6	48	80	0.6000000
NODE_10577_length_843_cov_7.672043	472	552	5	13	80	0.1625000
NODE_10577_length_843_cov_7.672043	472	552	6	7	80	0.0875000
NODE_10577_length_843_cov_7.672043	472	552	10	10	80	0.1250000
NODE_10577_length_843_cov_7.672043	472	552	11	11	80	0.1375000
NODE_10577_length_843_cov_7.672043	472	552	12	33	80	0.4125000
NODE_10577_length_843_cov_7.672043	472	552	13	6	80	0.0750000
NODE_10577_length_843_cov_7.672043	525	605	5	11	80	0.1375000
NODE_10577_length_843_cov_7.672043	525	605	6	25	80	0.3125000
NODE_10577_length_843_cov_7.672043	525	605	8	3	80	0.0375000
NODE_10577_length_843_cov_7.672043	525	605	10	13	80	0.1625000
NODE_10577_length_843_cov_7.672043	525	605	11	1	80	0.0125000
NODE_10577_length_843_cov_7.672043	525	605	12	21	80	0.2625000
NODE_10577_length_843_cov_7.672043	525	605	13	6	80	0.0750000
NODE_10601_length_842_cov_39.518170	390	470	5	39	80	0.4875000
NODE_10601_length_842_cov_39.518170	390	470	6	21	80	0.2625000
NODE_10601_length_842_cov_39.518170	390	470	7	11	80	0.1375000
NODE_10601_length_842_cov_39.518170	390	470	8	9	80	0.1125000
NODE_10601_length_842_cov_39.518170	443	523	3	14	80	0.1750000
NODE_10601_length_842_cov_39.518170	443	523	5	1	80	0.0125000
NODE_10601_length_842_cov_39.518170	443	523	6	10	80	0.1250000
NODE_10601_length_842_cov_39.518170	443	523	7	21	80	0.2625000
NODE_10601_length_842_cov_39.518170	443	523	8	34	80	0.4250000
NODE_10602_length_842_cov_21.567968	331	411	0	80	80	1.0000000
NODE_10602_length_842_cov_21.567968	384	464	0	80	80	1.0000000
NODE_10603_length_842_cov_19.761777	228	308	1	49	80	0.6125000
NODE_10603_length_842_cov_19.761777	228	308	3	31	80	0.3875000
NODE_10603_length_842_cov_19.761777	281	361	2	13	80	0.1625000
NODE_10603_length_842_cov_19.761777	281	361	3	67	80	0.8375000
NODE_10605_length_842_cov_8.703903	641	722	0	81	81	1.0000000
NODE_10608_length_842_cov_5.305518	287	367	1	35	80	0.4375000
NODE_10608_length_842_cov_5.305518	287	367	2	16	80	0.2000000
NODE_10608_length_842_cov_5.305518	287	367	3	29	80	0.3625000
NODE_10608_length_842_cov_5.305518	340	420	2	8	80	0.1000000
NODE_10608_length_842_cov_5.305518	340	420	3	72	80	0.9000000
NODE_10617_length_842_cov_1.751009	35	66	1	31	31	1.0000000
NODE_10622_length_841_cov_23.815364	292	372	9	1	80	0.0125000
NODE_10622_length_841_cov_23.815364	292	372	10	22	80	0.2750000
NODE_10622_length_841_cov_23.815364	292	372	11	7	80	0.0875000
NODE_10622_length_841_cov_23.815364	292	372	12	15	80	0.1875000
NODE_10622_length_841_cov_23.815364	292	372	15	10	80	0.1250000
NODE_10622_length_841_cov_23.815364	292	372	18	3	80	0.0375000
NODE_10622_length_841_cov_23.815364	292	372	19	19	80	0.2375000
NODE_10622_length_841_cov_23.815364	292	372	20	3	80	0.0375000
NODE_10622_length_841_cov_23.815364	345	425	15	2	80	0.0250000
NODE_10622_length_841_cov_23.815364	345	425	17	4	80	0.0500000
NODE_10622_length_841_cov_23.815364	345	425	18	24	80	0.3000000
NODE_10622_length_841_cov_23.815364	345	425	19	27	80	0.3375000
NODE_10622_length_841_cov_23.815364	345	425	20	21	80	0.2625000
NODE_10622_length_841_cov_23.815364	345	425	21	2	80	0.0250000
NODE_10623_length_841_cov_18.871968	338	418	0	80	80	1.0000000
NODE_10623_length_841_cov_18.871968	391	471	0	80	80	1.0000000
NODE_10624_length_841_cov_14.663073	345	425	4	1	80	0.0125000
NODE_10624_length_841_cov_14.663073	345	425	5	3	80	0.0375000
NODE_10624_length_841_cov_14.663073	345	425	6	31	80	0.3875000
NODE_10624_length_841_cov_14.663073	345	425	7	16	80	0.2000000
NODE_10624_length_841_cov_14.663073	345	425	8	29	80	0.3625000
NODE_10624_length_841_cov_14.663073	398	478	3	17	80	0.2125000
NODE_10624_length_841_cov_14.663073	398	478	4	13	80	0.1625000
NODE_10624_length_841_cov_14.663073	398	478	5	27	80	0.3375000
NODE_10624_length_841_cov_14.663073	398	478	6	4	80	0.0500000
NODE_10624_length_841_cov_14.663073	398	478	7	4	80	0.0500000
NODE_10624_length_841_cov_14.663073	398	478	8	15	80	0.1875000
NODE_10625_length_841_cov_14.149596	341	421	7	1	80	0.0125000
NODE_10625_length_841_cov_14.149596	341	421	9	57	80	0.7125000
NODE_10625_length_841_cov_14.149596	341	421	10	1	80	0.0125000
NODE_10625_length_841_cov_14.149596	341	421	13	21	80	0.2625000
NODE_10625_length_841_cov_14.149596	394	474	5	6	80	0.0750000
NODE_10625_length_841_cov_14.149596	394	474	7	2	80	0.0250000
NODE_10625_length_841_cov_14.149596	394	474	9	6	80	0.0750000
NODE_10625_length_841_cov_14.149596	394	474	10	1	80	0.0125000
NODE_10625_length_841_cov_14.149596	394	474	11	17	80	0.2125000
NODE_10625_length_841_cov_14.149596	394	474	13	48	80	0.6000000
NODE_10626_length_841_cov_12.452830	240	320	0	39	80	0.4875000
NODE_10626_length_841_cov_12.452830	240	320	2	41	80	0.5125000
NODE_10626_length_841_cov_12.452830	293	373	0	41	80	0.5125000
NODE_10626_length_841_cov_12.452830	293	373	2	39	80	0.4875000
NODE_10628_length_841_cov_9.925876	394	474	1	19	80	0.2375000
NODE_10628_length_841_cov_9.925876	394	474	2	61	80	0.7625000
NODE_10628_length_841_cov_9.925876	447	527	1	38	80	0.4750000
NODE_10628_length_841_cov_9.925876	447	527	2	42	80	0.5250000
NODE_10629_length_841_cov_7.407008	317	397	1	33	80	0.4125000
NODE_10629_length_841_cov_7.407008	317	397	2	28	80	0.3500000
NODE_10629_length_841_cov_7.407008	317	397	3	19	80	0.2375000
NODE_10629_length_841_cov_7.407008	370	450	0	43	80	0.5375000
NODE_10629_length_841_cov_7.407008	370	450	1	37	80	0.4625000
NODE_10632_length_841_cov_3.865229	305	356	0	51	51	1.0000000
NODE_10651_length_840_cov_63.726046	461	541	11	11	80	0.1375000
NODE_10651_length_840_cov_63.726046	461	541	12	25	80	0.3125000
NODE_10651_length_840_cov_63.726046	461	541	13	43	80	0.5375000
NODE_10651_length_840_cov_63.726046	461	541	14	1	80	0.0125000
NODE_10651_length_840_cov_63.726046	514	594	6	1	80	0.0125000
NODE_10651_length_840_cov_63.726046	514	594	7	6	80	0.0750000
NODE_10651_length_840_cov_63.726046	514	594	8	18	80	0.2250000
NODE_10651_length_840_cov_63.726046	514	594	10	8	80	0.1000000
NODE_10651_length_840_cov_63.726046	514	594	12	27	80	0.3375000
NODE_10651_length_840_cov_63.726046	514	594	13	19	80	0.2375000
NODE_10651_length_840_cov_63.726046	514	594	14	1	80	0.0125000
NODE_10652_length_840_cov_35.874494	486	566	3	19	80	0.2375000
NODE_10652_length_840_cov_35.874494	486	566	4	61	80	0.7625000
NODE_10652_length_840_cov_35.874494	539	619	1	14	80	0.1750000
NODE_10652_length_840_cov_35.874494	539	619	2	25	80	0.3125000
NODE_10652_length_840_cov_35.874494	539	619	3	33	80	0.4125000
NODE_10652_length_840_cov_35.874494	539	619	4	8	80	0.1000000
NODE_10653_length_840_cov_24.499325	224	304	4	38	80	0.4750000
NODE_10653_length_840_cov_24.499325	224	304	5	14	80	0.1750000
NODE_10653_length_840_cov_24.499325	224	304	6	28	80	0.3500000
NODE_10653_length_840_cov_24.499325	277	357	1	13	80	0.1625000
NODE_10653_length_840_cov_24.499325	277	357	3	6	80	0.0750000
NODE_10653_length_840_cov_24.499325	277	357	4	30	80	0.3750000
NODE_10653_length_840_cov_24.499325	277	357	5	12	80	0.1500000
NODE_10653_length_840_cov_24.499325	277	357	6	19	80	0.2375000
NODE_10653_length_840_cov_24.499325	353	433	0	32	80	0.4000000
NODE_10653_length_840_cov_24.499325	353	433	1	48	80	0.6000000
NODE_10653_length_840_cov_24.499325	406	486	0	74	80	0.9250000
NODE_10653_length_840_cov_24.499325	406	486	1	6	80	0.0750000
NODE_10654_length_840_cov_23.272605	309	389	7	7	80	0.0875000
NODE_10654_length_840_cov_23.272605	309	389	8	21	80	0.2625000
NODE_10654_length_840_cov_23.272605	309	389	9	19	80	0.2375000
NODE_10654_length_840_cov_23.272605	309	389	10	11	80	0.1375000
NODE_10654_length_840_cov_23.272605	309	389	11	9	80	0.1125000
NODE_10654_length_840_cov_23.272605	309	389	12	13	80	0.1625000
NODE_10654_length_840_cov_23.272605	362	442	7	7	80	0.0875000
NODE_10654_length_840_cov_23.272605	362	442	8	39	80	0.4875000
NODE_10654_length_840_cov_23.272605	362	442	10	18	80	0.2250000
NODE_10654_length_840_cov_23.272605	362	442	11	3	80	0.0375000
NODE_10654_length_840_cov_23.272605	362	442	12	13	80	0.1625000
NODE_10655_length_840_cov_22.221323	293	373	1	10	80	0.1250000
NODE_10655_length_840_cov_22.221323	293	373	2	13	80	0.1625000
NODE_10655_length_840_cov_22.221323	293	373	3	57	80	0.7125000
NODE_10655_length_840_cov_22.221323	346	426	3	80	80	1.0000000
NODE_10656_length_840_cov_17.026991	348	432	0	56	84	0.6666667
NODE_10656_length_840_cov_17.026991	348	432	2	12	84	0.1428571
NODE_10656_length_840_cov_17.026991	348	432	4	16	84	0.1904762
NODE_10656_length_840_cov_17.026991	405	485	2	11	80	0.1375000
NODE_10656_length_840_cov_17.026991	405	485	4	34	80	0.4250000
NODE_10656_length_840_cov_17.026991	405	485	6	10	80	0.1250000
NODE_10656_length_840_cov_17.026991	405	485	8	25	80	0.3125000
NODE_10657_length_840_cov_16.635628	347	427	7	1	80	0.0125000
NODE_10657_length_840_cov_16.635628	347	427	8	71	80	0.8875000
NODE_10657_length_840_cov_16.635628	347	427	9	6	80	0.0750000
NODE_10657_length_840_cov_16.635628	347	427	10	2	80	0.0250000
NODE_10657_length_840_cov_16.635628	400	480	1	31	80	0.3875000
NODE_10657_length_840_cov_16.635628	400	480	3	5	80	0.0625000
NODE_10657_length_840_cov_16.635628	400	480	5	5	80	0.0625000
NODE_10657_length_840_cov_16.635628	400	480	7	13	80	0.1625000
NODE_10657_length_840_cov_16.635628	400	480	8	26	80	0.3250000
NODE_10658_length_840_cov_12.133603	336	416	3	4	80	0.0500000
NODE_10658_length_840_cov_12.133603	336	416	4	5	80	0.0625000
NODE_10658_length_840_cov_12.133603	336	416	5	14	80	0.1750000
NODE_10658_length_840_cov_12.133603	336	416	6	27	80	0.3375000
NODE_10658_length_840_cov_12.133603	336	416	8	12	80	0.1500000
NODE_10658_length_840_cov_12.133603	336	416	9	12	80	0.1500000
NODE_10658_length_840_cov_12.133603	336	416	10	6	80	0.0750000
NODE_10658_length_840_cov_12.133603	389	469	8	9	80	0.1125000
NODE_10658_length_840_cov_12.133603	389	469	9	19	80	0.2375000
NODE_10658_length_840_cov_12.133603	389	469	10	52	80	0.6500000
NODE_10659_length_840_cov_12.041835	332	412	0	17	80	0.2125000
NODE_10659_length_840_cov_12.041835	332	412	1	5	80	0.0625000
NODE_10659_length_840_cov_12.041835	332	412	2	2	80	0.0250000
NODE_10659_length_840_cov_12.041835	332	412	3	56	80	0.7000000
NODE_10659_length_840_cov_12.041835	385	465	0	32	80	0.4000000
NODE_10659_length_840_cov_12.041835	385	465	2	23	80	0.2875000
NODE_10659_length_840_cov_12.041835	385	465	3	25	80	0.3125000
NODE_10660_length_840_cov_10.719298	275	354	1	76	79	0.9620253
NODE_10660_length_840_cov_10.719298	275	354	2	3	79	0.0379747
NODE_10660_length_840_cov_10.719298	327	407	1	24	80	0.3000000
NODE_10660_length_840_cov_10.719298	327	407	2	56	80	0.7000000
NODE_10663_length_840_cov_5.207827	427	507	0	2	80	0.0250000
NODE_10663_length_840_cov_5.207827	427	507	2	38	80	0.4750000
NODE_10663_length_840_cov_5.207827	427	507	4	40	80	0.5000000
NODE_10663_length_840_cov_5.207827	480	560	2	18	80	0.2250000
NODE_10663_length_840_cov_5.207827	480	560	4	62	80	0.7750000
NODE_10683_length_839_cov_274.987838	450	530	33	5	80	0.0625000
NODE_10683_length_839_cov_274.987838	450	530	34	2	80	0.0250000
NODE_10683_length_839_cov_274.987838	450	530	36	9	80	0.1125000
NODE_10683_length_839_cov_274.987838	450	530	37	8	80	0.1000000
NODE_10683_length_839_cov_274.987838	450	530	38	3	80	0.0375000
NODE_10683_length_839_cov_274.987838	450	530	41	3	80	0.0375000
NODE_10683_length_839_cov_274.987838	450	530	42	4	80	0.0500000
NODE_10683_length_839_cov_274.987838	450	530	43	5	80	0.0625000
NODE_10683_length_839_cov_274.987838	450	530	44	14	80	0.1750000
NODE_10683_length_839_cov_274.987838	450	530	45	10	80	0.1250000
NODE_10683_length_839_cov_274.987838	450	530	46	9	80	0.1125000
NODE_10683_length_839_cov_274.987838	450	530	47	7	80	0.0875000
NODE_10683_length_839_cov_274.987838	450	530	48	1	80	0.0125000
NODE_10683_length_839_cov_274.987838	503	583	43	2	80	0.0250000
NODE_10683_length_839_cov_274.987838	503	583	45	8	80	0.1000000
NODE_10683_length_839_cov_274.987838	503	583	46	9	80	0.1125000
NODE_10683_length_839_cov_274.987838	503	583	47	7	80	0.0875000
NODE_10683_length_839_cov_274.987838	503	583	48	7	80	0.0875000
NODE_10683_length_839_cov_274.987838	503	583	52	1	80	0.0125000
NODE_10683_length_839_cov_274.987838	503	583	54	1	80	0.0125000
NODE_10683_length_839_cov_274.987838	503	583	56	2	80	0.0250000
NODE_10683_length_839_cov_274.987838	503	583	57	8	80	0.1000000
NODE_10683_length_839_cov_274.987838	503	583	58	10	80	0.1250000
NODE_10683_length_839_cov_274.987838	503	583	59	10	80	0.1250000
NODE_10683_length_839_cov_274.987838	503	583	60	15	80	0.1875000
NODE_10684_length_839_cov_24.500000	303	383	0	8	80	0.1000000
NODE_10684_length_839_cov_24.500000	303	383	2	18	80	0.2250000
NODE_10684_length_839_cov_24.500000	303	383	3	54	80	0.6750000
NODE_10684_length_839_cov_24.500000	356	436	2	9	80	0.1125000
NODE_10684_length_839_cov_24.500000	356	436	3	61	80	0.7625000
NODE_10684_length_839_cov_24.500000	356	436	4	10	80	0.1250000
NODE_10685_length_839_cov_16.390541	477	557	0	80	80	1.0000000
NODE_10685_length_839_cov_16.390541	530	610	0	80	80	1.0000000
NODE_10686_length_839_cov_10.006757	383	463	1	11	80	0.1375000
NODE_10686_length_839_cov_10.006757	383	463	2	17	80	0.2125000
NODE_10686_length_839_cov_10.006757	383	463	3	52	80	0.6500000
NODE_10686_length_839_cov_10.006757	436	516	3	45	80	0.5625000
NODE_10686_length_839_cov_10.006757	436	516	4	2	80	0.0250000
NODE_10686_length_839_cov_10.006757	436	516	5	33	80	0.4125000
NODE_10688_length_839_cov_7.612162	308	388	0	32	80	0.4000000
NODE_10688_length_839_cov_7.612162	308	388	1	45	80	0.5625000
NODE_10688_length_839_cov_7.612162	308	388	2	3	80	0.0375000
NODE_10688_length_839_cov_7.612162	361	441	1	24	80	0.3000000
NODE_10688_length_839_cov_7.612162	361	441	2	56	80	0.7000000
NODE_10689_length_839_cov_6.693243	343	423	0	80	80	1.0000000
NODE_10706_length_838_cov_39.263870	383	463	11	3	80	0.0375000
NODE_10706_length_838_cov_39.263870	383	463	12	7	80	0.0875000
NODE_10706_length_838_cov_39.263870	383	463	13	23	80	0.2875000
NODE_10706_length_838_cov_39.263870	383	463	14	47	80	0.5875000
NODE_10706_length_838_cov_39.263870	436	516	5	5	80	0.0625000
NODE_10706_length_838_cov_39.263870	436	516	6	4	80	0.0500000
NODE_10706_length_838_cov_39.263870	436	516	7	5	80	0.0625000
NODE_10706_length_838_cov_39.263870	436	516	8	24	80	0.3000000
NODE_10706_length_838_cov_39.263870	436	516	10	4	80	0.0500000
NODE_10706_length_838_cov_39.263870	436	516	11	14	80	0.1750000
NODE_10706_length_838_cov_39.263870	436	516	12	3	80	0.0375000
NODE_10706_length_838_cov_39.263870	436	516	13	5	80	0.0625000
NODE_10706_length_838_cov_39.263870	436	516	14	16	80	0.2000000
NODE_10707_length_838_cov_27.843031	473	553	10	24	80	0.3000000
NODE_10707_length_838_cov_27.843031	473	553	11	7	80	0.0875000
NODE_10707_length_838_cov_27.843031	473	553	13	2	80	0.0250000
NODE_10707_length_838_cov_27.843031	473	553	14	21	80	0.2625000
NODE_10707_length_838_cov_27.843031	473	553	15	26	80	0.3250000
NODE_10707_length_838_cov_27.843031	526	606	12	10	80	0.1250000
NODE_10707_length_838_cov_27.843031	526	606	13	2	80	0.0250000
NODE_10707_length_838_cov_27.843031	526	606	14	29	80	0.3625000
NODE_10707_length_838_cov_27.843031	526	606	15	29	80	0.3625000
NODE_10707_length_838_cov_27.843031	526	606	16	10	80	0.1250000
NODE_10708_length_838_cov_27.238160	432	512	10	1	80	0.0125000
NODE_10708_length_838_cov_27.238160	432	512	11	18	80	0.2250000
NODE_10708_length_838_cov_27.238160	432	512	12	61	80	0.7625000
NODE_10708_length_838_cov_27.238160	485	565	4	5	80	0.0625000
NODE_10708_length_838_cov_27.238160	485	565	5	6	80	0.0750000
NODE_10708_length_838_cov_27.238160	485	565	7	7	80	0.0875000
NODE_10708_length_838_cov_27.238160	485	565	9	12	80	0.1500000
NODE_10708_length_838_cov_27.238160	485	565	10	9	80	0.1125000
NODE_10708_length_838_cov_27.238160	485	565	11	5	80	0.0625000
NODE_10708_length_838_cov_27.238160	485	565	12	28	80	0.3500000
NODE_10708_length_838_cov_27.238160	485	565	13	8	80	0.1000000
NODE_10709_length_838_cov_22.691475	380	460	6	4	80	0.0500000
NODE_10709_length_838_cov_22.691475	380	460	7	40	80	0.5000000
NODE_10709_length_838_cov_22.691475	380	460	8	12	80	0.1500000
NODE_10709_length_838_cov_22.691475	380	460	9	24	80	0.3000000
NODE_10709_length_838_cov_22.691475	433	513	4	22	80	0.2750000
NODE_10709_length_838_cov_22.691475	433	513	5	25	80	0.3125000
NODE_10709_length_838_cov_22.691475	433	513	7	28	80	0.3500000
NODE_10709_length_838_cov_22.691475	433	513	9	5	80	0.0625000
NODE_10710_length_838_cov_16.169147	312	392	0	44	80	0.5500000
NODE_10710_length_838_cov_16.169147	312	392	2	7	80	0.0875000
NODE_10710_length_838_cov_16.169147	312	392	3	12	80	0.1500000
NODE_10710_length_838_cov_16.169147	312	392	4	17	80	0.2125000
NODE_10710_length_838_cov_16.169147	365	445	3	10	80	0.1250000
NODE_10710_length_838_cov_16.169147	365	445	4	70	80	0.8750000
NODE_10711_length_838_cov_15.753721	328	408	0	53	80	0.6625000
NODE_10711_length_838_cov_15.753721	328	408	2	27	80	0.3375000
NODE_10711_length_838_cov_15.753721	381	461	2	45	80	0.5625000
NODE_10711_length_838_cov_15.753721	381	461	6	35	80	0.4375000
NODE_10712_length_838_cov_15.514208	294	374	4	80	80	1.0000000
NODE_10712_length_838_cov_15.514208	347	427	4	80	80	1.0000000
NODE_10713_length_838_cov_7.733424	350	430	2	31	80	0.3875000
NODE_10713_length_838_cov_7.733424	350	430	3	49	80	0.6125000
NODE_10713_length_838_cov_7.733424	403	483	1	3	80	0.0375000
NODE_10713_length_838_cov_7.733424	403	483	2	54	80	0.6750000
NODE_10713_length_838_cov_7.733424	403	483	3	23	80	0.2875000
NODE_10716_length_838_cov_4.511502	131	213	0	82	82	1.0000000
NODE_10716_length_838_cov_4.511502	184	252	0	68	68	1.0000000
NODE_10722_length_838_cov_2.247632	359	405	0	46	46	1.0000000
NODE_10727_length_838_cov_1.843031	732	752	1	20	20	1.0000000
NODE_10740_length_837_cov_32.691057	401	481	4	2	80	0.0250000
NODE_10740_length_837_cov_32.691057	401	481	5	33	80	0.4125000
NODE_10740_length_837_cov_32.691057	401	481	6	45	80	0.5625000
NODE_10740_length_837_cov_32.691057	454	534	3	18	80	0.2250000
NODE_10740_length_837_cov_32.691057	454	534	4	2	80	0.0250000
NODE_10740_length_837_cov_32.691057	454	534	5	52	80	0.6500000
NODE_10740_length_837_cov_32.691057	454	534	6	8	80	0.1000000
NODE_10741_length_837_cov_30.995935	399	479	1	7	80	0.0875000
NODE_10741_length_837_cov_30.995935	399	479	3	47	80	0.5875000
NODE_10741_length_837_cov_30.995935	399	479	4	5	80	0.0625000
NODE_10741_length_837_cov_30.995935	399	479	5	15	80	0.1875000
NODE_10741_length_837_cov_30.995935	399	479	7	6	80	0.0750000
NODE_10741_length_837_cov_30.995935	452	532	3	6	80	0.0750000
NODE_10741_length_837_cov_30.995935	452	532	5	15	80	0.1875000
NODE_10741_length_837_cov_30.995935	452	532	6	12	80	0.1500000
NODE_10741_length_837_cov_30.995935	452	532	7	40	80	0.5000000
NODE_10741_length_837_cov_30.995935	452	532	9	7	80	0.0875000
NODE_10742_length_837_cov_30.883469	278	358	0	80	80	1.0000000
NODE_10742_length_837_cov_30.883469	331	411	0	77	80	0.9625000
NODE_10742_length_837_cov_30.883469	331	411	1	3	80	0.0375000
NODE_10742_length_837_cov_30.883469	407	487	0	1	80	0.0125000
NODE_10742_length_837_cov_30.883469	407	487	1	11	80	0.1375000
NODE_10742_length_837_cov_30.883469	407	487	2	40	80	0.5000000
NODE_10742_length_837_cov_30.883469	407	487	3	19	80	0.2375000
NODE_10742_length_837_cov_30.883469	407	487	4	9	80	0.1125000
NODE_10742_length_837_cov_30.883469	460	540	3	18	80	0.2250000
NODE_10742_length_837_cov_30.883469	460	540	4	62	80	0.7750000
NODE_10743_length_837_cov_14.573171	205	280	2	75	75	1.0000000
NODE_10743_length_837_cov_14.573171	258	337	0	53	79	0.6708861
NODE_10743_length_837_cov_14.573171	258	337	2	26	79	0.3291139
NODE_10743_length_837_cov_14.573171	333	413	0	80	80	1.0000000
NODE_10743_length_837_cov_14.573171	386	466	0	80	80	1.0000000
NODE_10744_length_837_cov_12.582656	226	306	0	4	80	0.0500000
NODE_10744_length_837_cov_12.582656	226	306	2	41	80	0.5125000
NODE_10744_length_837_cov_12.582656	226	306	3	7	80	0.0875000
NODE_10744_length_837_cov_12.582656	226	306	5	28	80	0.3500000
NODE_10744_length_837_cov_12.582656	279	359	5	80	80	1.0000000
NODE_10745_length_837_cov_6.998645	389	474	0	85	85	1.0000000
NODE_10745_length_837_cov_6.998645	447	527	0	80	80	1.0000000
NODE_10750_length_837_cov_3.119241	373	453	0	80	80	1.0000000
NODE_10750_length_837_cov_3.119241	426	506	0	80	80	1.0000000
NODE_10769_length_836_cov_40.141113	224	304	3	1	80	0.0125000
NODE_10769_length_836_cov_40.141113	224	304	4	27	80	0.3375000
NODE_10769_length_836_cov_40.141113	224	304	5	12	80	0.1500000
NODE_10769_length_836_cov_40.141113	224	304	6	19	80	0.2375000
NODE_10769_length_836_cov_40.141113	224	304	7	19	80	0.2375000
NODE_10769_length_836_cov_40.141113	224	304	8	2	80	0.0250000
NODE_10769_length_836_cov_40.141113	277	357	6	6	80	0.0750000
NODE_10769_length_836_cov_40.141113	277	357	7	29	80	0.3625000
NODE_10769_length_836_cov_40.141113	277	357	8	20	80	0.2500000
NODE_10769_length_836_cov_40.141113	277	357	9	25	80	0.3125000
NODE_10769_length_836_cov_40.141113	353	433	9	20	80	0.2500000
NODE_10769_length_836_cov_40.141113	353	433	10	5	80	0.0625000
NODE_10769_length_836_cov_40.141113	353	433	11	7	80	0.0875000
NODE_10769_length_836_cov_40.141113	353	433	13	23	80	0.2875000
NODE_10769_length_836_cov_40.141113	353	433	14	20	80	0.2500000
NODE_10769_length_836_cov_40.141113	353	433	15	5	80	0.0625000
NODE_10769_length_836_cov_40.141113	406	486	8	2	80	0.0250000
NODE_10769_length_836_cov_40.141113	406	486	9	32	80	0.4000000
NODE_10769_length_836_cov_40.141113	406	486	10	18	80	0.2250000
NODE_10769_length_836_cov_40.141113	406	486	12	1	80	0.0125000
NODE_10769_length_836_cov_40.141113	406	486	13	19	80	0.2375000
NODE_10769_length_836_cov_40.141113	406	486	14	8	80	0.1000000
NODE_10770_length_836_cov_27.610583	344	424	5	7	80	0.0875000
NODE_10770_length_836_cov_27.610583	344	424	7	18	80	0.2250000
NODE_10770_length_836_cov_27.610583	344	424	9	36	80	0.4500000
NODE_10770_length_836_cov_27.610583	344	424	10	19	80	0.2375000
NODE_10770_length_836_cov_27.610583	397	477	3	9	80	0.1125000
NODE_10770_length_836_cov_27.610583	397	477	7	62	80	0.7750000
NODE_10770_length_836_cov_27.610583	397	477	10	9	80	0.1125000
NODE_10771_length_836_cov_15.719132	295	375	0	10	80	0.1250000
NODE_10771_length_836_cov_15.719132	295	375	1	70	80	0.8750000
NODE_10771_length_836_cov_15.719132	348	428	1	40	80	0.5000000
NODE_10771_length_836_cov_15.719132	348	428	2	40	80	0.5000000
NODE_10772_length_836_cov_9.309362	295	375	1	20	80	0.2500000
NODE_10772_length_836_cov_9.309362	295	375	3	27	80	0.3375000
NODE_10772_length_836_cov_9.309362	295	375	5	2	80	0.0250000
NODE_10772_length_836_cov_9.309362	295	375	7	31	80	0.3875000
NODE_10772_length_836_cov_9.309362	348	428	7	34	80	0.4250000
NODE_10772_length_836_cov_9.309362	348	428	8	23	80	0.2875000
NODE_10772_length_836_cov_9.309362	348	428	9	23	80	0.2875000
NODE_10773_length_836_cov_6.283582	336	416	4	15	80	0.1875000
NODE_10773_length_836_cov_6.283582	336	416	5	24	80	0.3000000
NODE_10773_length_836_cov_6.283582	336	416	6	41	80	0.5125000
NODE_10773_length_836_cov_6.283582	389	469	1	22	80	0.2750000
NODE_10773_length_836_cov_6.283582	389	469	3	2	80	0.0250000
NODE_10773_length_836_cov_6.283582	389	469	4	44	80	0.5500000
NODE_10773_length_836_cov_6.283582	389	469	5	12	80	0.1500000
NODE_10774_length_836_cov_4.979647	371	451	2	12	80	0.1500000
NODE_10774_length_836_cov_4.979647	371	451	3	18	80	0.2250000
NODE_10774_length_836_cov_4.979647	371	451	4	50	80	0.6250000
NODE_10774_length_836_cov_4.979647	424	504	2	28	80	0.3500000
NODE_10774_length_836_cov_4.979647	424	504	3	43	80	0.5375000
NODE_10774_length_836_cov_4.979647	424	504	4	9	80	0.1125000
NODE_10787_length_835_cov_61.033967	253	333	10	4	80	0.0500000
NODE_10787_length_835_cov_61.033967	253	333	12	6	80	0.0750000
NODE_10787_length_835_cov_61.033967	253	333	13	7	80	0.0875000
NODE_10787_length_835_cov_61.033967	253	333	14	21	80	0.2625000
NODE_10787_length_835_cov_61.033967	253	333	16	8	80	0.1000000
NODE_10787_length_835_cov_61.033967	253	333	17	13	80	0.1625000
NODE_10787_length_835_cov_61.033967	253	333	18	2	80	0.0250000
NODE_10787_length_835_cov_61.033967	253	333	19	3	80	0.0375000
NODE_10787_length_835_cov_61.033967	253	333	20	2	80	0.0250000
NODE_10787_length_835_cov_61.033967	253	333	22	4	80	0.0500000
NODE_10787_length_835_cov_61.033967	253	333	23	2	80	0.0250000
NODE_10787_length_835_cov_61.033967	253	333	24	7	80	0.0875000
NODE_10787_length_835_cov_61.033967	253	333	25	1	80	0.0125000
NODE_10787_length_835_cov_61.033967	306	386	17	6	80	0.0750000
NODE_10787_length_835_cov_61.033967	306	386	18	2	80	0.0250000
NODE_10787_length_835_cov_61.033967	306	386	19	3	80	0.0375000
NODE_10787_length_835_cov_61.033967	306	386	20	2	80	0.0250000
NODE_10787_length_835_cov_61.033967	306	386	22	10	80	0.1250000
NODE_10787_length_835_cov_61.033967	306	386	23	10	80	0.1250000
NODE_10787_length_835_cov_61.033967	306	386	24	7	80	0.0875000
NODE_10787_length_835_cov_61.033967	306	386	25	12	80	0.1500000
NODE_10787_length_835_cov_61.033967	306	386	26	28	80	0.3500000
NODE_10788_length_835_cov_32.380435	390	470	6	5	80	0.0625000
NODE_10788_length_835_cov_32.380435	390	470	7	30	80	0.3750000
NODE_10788_length_835_cov_32.380435	390	470	8	17	80	0.2125000
NODE_10788_length_835_cov_32.380435	390	470	9	28	80	0.3500000
NODE_10788_length_835_cov_32.380435	443	523	3	14	80	0.1750000
NODE_10788_length_835_cov_32.380435	443	523	4	7	80	0.0875000
NODE_10788_length_835_cov_32.380435	443	523	5	8	80	0.1000000
NODE_10788_length_835_cov_32.380435	443	523	6	29	80	0.3625000
NODE_10788_length_835_cov_32.380435	443	523	8	11	80	0.1375000
NODE_10788_length_835_cov_32.380435	443	523	9	11	80	0.1375000
NODE_10789_length_835_cov_20.779891	415	495	2	11	80	0.1375000
NODE_10789_length_835_cov_20.779891	415	495	4	10	80	0.1250000
NODE_10789_length_835_cov_20.779891	415	495	5	1	80	0.0125000
NODE_10789_length_835_cov_20.779891	415	495	6	23	80	0.2875000
NODE_10789_length_835_cov_20.779891	415	495	7	8	80	0.1000000
NODE_10789_length_835_cov_20.779891	415	495	8	27	80	0.3375000
NODE_10789_length_835_cov_20.779891	468	548	6	6	80	0.0750000
NODE_10789_length_835_cov_20.779891	468	548	7	31	80	0.3875000
NODE_10789_length_835_cov_20.779891	468	548	8	43	80	0.5375000
NODE_10808_length_835_cov_1.694293	18	80	0	62	62	1.0000000
NODE_10820_length_834_cov_13.689796	213	293	1	39	80	0.4875000
NODE_10820_length_834_cov_13.689796	213	293	2	41	80	0.5125000
NODE_10820_length_834_cov_13.689796	266	346	1	43	80	0.5375000
NODE_10820_length_834_cov_13.689796	266	346	2	37	80	0.4625000
NODE_10822_length_834_cov_12.609524	406	486	5	14	80	0.1750000
NODE_10822_length_834_cov_12.609524	406	486	6	15	80	0.1875000
NODE_10822_length_834_cov_12.609524	406	486	7	20	80	0.2500000
NODE_10822_length_834_cov_12.609524	406	486	8	31	80	0.3875000
NODE_10822_length_834_cov_12.609524	459	539	3	15	80	0.1875000
NODE_10822_length_834_cov_12.609524	459	539	5	4	80	0.0500000
NODE_10822_length_834_cov_12.609524	459	539	6	24	80	0.3000000
NODE_10822_length_834_cov_12.609524	459	539	8	37	80	0.4625000
NODE_10823_length_834_cov_11.492517	248	328	2	27	80	0.3375000
NODE_10823_length_834_cov_11.492517	248	328	4	6	80	0.0750000
NODE_10823_length_834_cov_11.492517	248	328	5	18	80	0.2250000
NODE_10823_length_834_cov_11.492517	248	328	6	29	80	0.3625000
NODE_10823_length_834_cov_11.492517	301	381	5	9	80	0.1125000
NODE_10823_length_834_cov_11.492517	301	381	6	35	80	0.4375000
NODE_10823_length_834_cov_11.492517	301	381	7	36	80	0.4500000
NODE_10824_length_834_cov_9.957823	212	292	0	80	80	1.0000000
NODE_10824_length_834_cov_9.957823	265	345	0	80	80	1.0000000
NODE_10825_length_834_cov_6.448980	482	546	3	8	64	0.1250000
NODE_10825_length_834_cov_6.448980	482	546	4	12	64	0.1875000
NODE_10825_length_834_cov_6.448980	482	546	5	44	64	0.6875000
NODE_10833_length_834_cov_2.658503	589	641	2	52	52	1.0000000
NODE_10846_length_833_cov_57.702997	338	418	7	17	80	0.2125000
NODE_10846_length_833_cov_57.702997	338	418	8	54	80	0.6750000
NODE_10846_length_833_cov_57.702997	338	418	9	9	80	0.1125000
NODE_10846_length_833_cov_57.702997	391	471	4	17	80	0.2125000
NODE_10846_length_833_cov_57.702997	391	471	6	3	80	0.0375000
NODE_10846_length_833_cov_57.702997	391	471	7	37	80	0.4625000
NODE_10846_length_833_cov_57.702997	391	471	8	14	80	0.1750000
NODE_10846_length_833_cov_57.702997	391	471	9	9	80	0.1125000
NODE_10847_length_833_cov_38.153951	364	444	10	8	80	0.1000000
NODE_10847_length_833_cov_38.153951	364	444	11	52	80	0.6500000
NODE_10847_length_833_cov_38.153951	364	444	12	6	80	0.0750000
NODE_10847_length_833_cov_38.153951	364	444	13	14	80	0.1750000
NODE_10847_length_833_cov_38.153951	417	497	5	3	80	0.0375000
NODE_10847_length_833_cov_38.153951	417	497	7	11	80	0.1375000
NODE_10847_length_833_cov_38.153951	417	497	8	23	80	0.2875000
NODE_10847_length_833_cov_38.153951	417	497	10	5	80	0.0625000
NODE_10847_length_833_cov_38.153951	417	497	11	11	80	0.1375000
NODE_10847_length_833_cov_38.153951	417	497	12	13	80	0.1625000
NODE_10847_length_833_cov_38.153951	417	497	13	14	80	0.1750000
NODE_10848_length_833_cov_34.302452	368	448	6	10	80	0.1250000
NODE_10848_length_833_cov_34.302452	368	448	7	19	80	0.2375000
NODE_10848_length_833_cov_34.302452	368	448	8	34	80	0.4250000
NODE_10848_length_833_cov_34.302452	368	448	9	17	80	0.2125000
NODE_10848_length_833_cov_34.302452	421	501	6	4	80	0.0500000
NODE_10848_length_833_cov_34.302452	421	501	7	31	80	0.3875000
NODE_10848_length_833_cov_34.302452	421	501	8	45	80	0.5625000
NODE_10849_length_833_cov_20.452316	311	392	2	4	81	0.0493827
NODE_10849_length_833_cov_20.452316	311	392	4	77	81	0.9506173
NODE_10849_length_833_cov_20.452316	365	445	2	26	80	0.3250000
NODE_10849_length_833_cov_20.452316	365	445	4	54	80	0.6750000
NODE_10850_length_833_cov_16.643052	238	318	0	80	80	1.0000000
NODE_10851_length_833_cov_16.536785	84	164	4	13	80	0.1625000
NODE_10851_length_833_cov_16.536785	84	164	5	9	80	0.1125000
NODE_10851_length_833_cov_16.536785	84	164	6	58	80	0.7250000
NODE_10851_length_833_cov_16.536785	137	217	3	34	80	0.4250000
NODE_10851_length_833_cov_16.536785	137	217	4	7	80	0.0875000
NODE_10851_length_833_cov_16.536785	137	217	5	21	80	0.2625000
NODE_10851_length_833_cov_16.536785	137	217	6	18	80	0.2250000
NODE_10865_length_833_cov_3.089918	467	547	3	1	80	0.0125000
NODE_10865_length_833_cov_3.089918	467	547	4	37	80	0.4625000
NODE_10865_length_833_cov_3.089918	467	547	5	21	80	0.2625000
NODE_10865_length_833_cov_3.089918	467	547	6	21	80	0.2625000
NODE_10865_length_833_cov_3.089918	520	600	0	29	80	0.3625000
NODE_10865_length_833_cov_3.089918	520	600	2	24	80	0.3000000
NODE_10865_length_833_cov_3.089918	520	600	3	1	80	0.0125000
NODE_10865_length_833_cov_3.089918	520	600	4	26	80	0.3250000
NODE_10891_length_832_cov_35.728513	460	540	8	12	80	0.1500000
NODE_10891_length_832_cov_35.728513	460	540	9	18	80	0.2250000
NODE_10891_length_832_cov_35.728513	460	540	10	34	80	0.4250000
NODE_10891_length_832_cov_35.728513	460	540	11	9	80	0.1125000
NODE_10891_length_832_cov_35.728513	460	540	12	7	80	0.0875000
NODE_10891_length_832_cov_35.728513	513	593	6	2	80	0.0250000
NODE_10891_length_832_cov_35.728513	513	593	8	24	80	0.3000000
NODE_10891_length_832_cov_35.728513	513	593	10	12	80	0.1500000
NODE_10891_length_832_cov_35.728513	513	593	11	10	80	0.1250000
NODE_10891_length_832_cov_35.728513	513	593	12	11	80	0.1375000
NODE_10891_length_832_cov_35.728513	513	593	13	21	80	0.2625000
NODE_10892_length_832_cov_25.450205	292	372	3	7	80	0.0875000
NODE_10892_length_832_cov_25.450205	292	372	4	3	80	0.0375000
NODE_10892_length_832_cov_25.450205	292	372	5	23	80	0.2875000
NODE_10892_length_832_cov_25.450205	292	372	7	18	80	0.2250000
NODE_10892_length_832_cov_25.450205	292	372	8	29	80	0.3625000
NODE_10892_length_832_cov_25.450205	345	425	8	45	80	0.5625000
NODE_10892_length_832_cov_25.450205	345	425	9	10	80	0.1250000
NODE_10892_length_832_cov_25.450205	345	425	10	25	80	0.3125000
NODE_10893_length_832_cov_18.858117	428	508	1	47	80	0.5875000
NODE_10893_length_832_cov_18.858117	428	508	2	33	80	0.4125000
NODE_10893_length_832_cov_18.858117	481	561	1	13	80	0.1625000
NODE_10893_length_832_cov_18.858117	481	561	2	67	80	0.8375000
NODE_10894_length_832_cov_17.799454	314	394	2	80	80	1.0000000
NODE_10894_length_832_cov_17.799454	367	447	2	46	80	0.5750000
NODE_10894_length_832_cov_17.799454	367	447	4	34	80	0.4250000
NODE_10895_length_832_cov_14.811733	353	433	11	2	80	0.0250000
NODE_10895_length_832_cov_14.811733	353	433	14	11	80	0.1375000
NODE_10895_length_832_cov_14.811733	353	433	15	23	80	0.2875000
NODE_10895_length_832_cov_14.811733	353	433	16	39	80	0.4875000
NODE_10895_length_832_cov_14.811733	353	433	17	5	80	0.0625000
NODE_10896_length_832_cov_14.770805	259	339	8	3	80	0.0375000
NODE_10896_length_832_cov_14.770805	259	339	9	11	80	0.1375000
NODE_10896_length_832_cov_14.770805	259	339	10	12	80	0.1500000
NODE_10896_length_832_cov_14.770805	259	339	11	20	80	0.2500000
NODE_10896_length_832_cov_14.770805	259	339	12	14	80	0.1750000
NODE_10896_length_832_cov_14.770805	259	339	13	20	80	0.2500000
NODE_10896_length_832_cov_14.770805	312	392	0	15	80	0.1875000
NODE_10896_length_832_cov_14.770805	312	392	1	1	80	0.0125000
NODE_10896_length_832_cov_14.770805	312	392	2	8	80	0.1000000
NODE_10896_length_832_cov_14.770805	312	392	3	4	80	0.0500000
NODE_10896_length_832_cov_14.770805	312	392	5	5	80	0.0625000
NODE_10896_length_832_cov_14.770805	312	392	6	5	80	0.0625000
NODE_10896_length_832_cov_14.770805	312	392	8	18	80	0.2250000
NODE_10896_length_832_cov_14.770805	312	392	9	11	80	0.1375000
NODE_10896_length_832_cov_14.770805	312	392	10	12	80	0.1500000
NODE_10896_length_832_cov_14.770805	312	392	11	1	80	0.0125000
NODE_10897_length_832_cov_8.305593	266	346	5	17	80	0.2125000
NODE_10897_length_832_cov_8.305593	266	346	7	15	80	0.1875000
NODE_10897_length_832_cov_8.305593	266	346	9	48	80	0.6000000
NODE_10897_length_832_cov_8.305593	319	399	5	70	80	0.8750000
NODE_10897_length_832_cov_8.305593	319	399	7	10	80	0.1250000
NODE_10918_length_831_cov_18.403005	371	451	5	23	80	0.2875000
NODE_10918_length_831_cov_18.403005	371	451	6	6	80	0.0750000
NODE_10918_length_831_cov_18.403005	371	451	8	15	80	0.1875000
NODE_10918_length_831_cov_18.403005	371	451	9	12	80	0.1500000
NODE_10918_length_831_cov_18.403005	371	451	10	14	80	0.1750000
NODE_10918_length_831_cov_18.403005	371	451	11	10	80	0.1250000
NODE_10918_length_831_cov_18.403005	424	504	7	16	80	0.2000000
NODE_10918_length_831_cov_18.403005	424	504	8	45	80	0.5625000
NODE_10918_length_831_cov_18.403005	424	504	9	19	80	0.2375000
NODE_10919_length_831_cov_16.017760	357	437	2	8	80	0.1000000
NODE_10919_length_831_cov_16.017760	357	437	3	72	80	0.9000000
NODE_10919_length_831_cov_16.017760	410	490	2	28	80	0.3500000
NODE_10919_length_831_cov_16.017760	410	490	3	52	80	0.6500000
NODE_10920_length_831_cov_13.740437	405	485	0	3	80	0.0375000
NODE_10920_length_831_cov_13.740437	405	485	1	32	80	0.4000000
NODE_10920_length_831_cov_13.740437	405	485	3	45	80	0.5625000
NODE_10920_length_831_cov_13.740437	458	538	3	80	80	1.0000000
NODE_10921_length_831_cov_9.595628	281	361	3	10	80	0.1250000
NODE_10921_length_831_cov_9.595628	281	361	4	70	80	0.8750000
NODE_10921_length_831_cov_9.595628	334	414	2	37	80	0.4625000
NODE_10921_length_831_cov_9.595628	334	414	3	5	80	0.0625000
NODE_10921_length_831_cov_9.595628	334	414	4	38	80	0.4750000
NODE_10922_length_831_cov_8.199454	433	482	2	19	49	0.3877551
NODE_10922_length_831_cov_8.199454	433	482	3	27	49	0.5510204
NODE_10922_length_831_cov_8.199454	433	482	4	3	49	0.0612245
NODE_10923_length_831_cov_7.607923	216	296	0	80	80	1.0000000
NODE_10923_length_831_cov_7.607923	269	349	0	80	80	1.0000000
NODE_10924_length_831_cov_6.454918	334	409	0	38	75	0.5066667
NODE_10924_length_831_cov_6.454918	334	409	2	14	75	0.1866667
NODE_10924_length_831_cov_6.454918	334	409	3	23	75	0.3066667
NODE_10924_length_831_cov_6.454918	382	462	2	4	80	0.0500000
NODE_10924_length_831_cov_6.454918	382	462	3	76	80	0.9500000
NODE_10960_length_830_cov_40.856361	238	318	8	10	80	0.1250000
NODE_10960_length_830_cov_40.856361	238	318	9	1	80	0.0125000
NODE_10960_length_830_cov_40.856361	238	318	10	24	80	0.3000000
NODE_10960_length_830_cov_40.856361	238	318	11	20	80	0.2500000
NODE_10960_length_830_cov_40.856361	238	318	12	20	80	0.2500000
NODE_10960_length_830_cov_40.856361	238	318	13	2	80	0.0250000
NODE_10960_length_830_cov_40.856361	238	318	14	3	80	0.0375000
NODE_10960_length_830_cov_40.856361	291	371	10	6	80	0.0750000
NODE_10960_length_830_cov_40.856361	291	371	11	12	80	0.1500000
NODE_10960_length_830_cov_40.856361	291	371	12	43	80	0.5375000
NODE_10960_length_830_cov_40.856361	291	371	13	2	80	0.0250000
NODE_10960_length_830_cov_40.856361	291	371	14	17	80	0.2125000
NODE_10961_length_830_cov_32.170999	302	378	0	34	76	0.4473684
NODE_10961_length_830_cov_32.170999	302	378	2	14	76	0.1842105
NODE_10961_length_830_cov_32.170999	302	378	4	26	76	0.3421053
NODE_10961_length_830_cov_32.170999	302	378	6	2	76	0.0263158
NODE_10961_length_830_cov_32.170999	303	383	0	33	80	0.4125000
NODE_10961_length_830_cov_32.170999	303	383	2	14	80	0.1750000
NODE_10961_length_830_cov_32.170999	303	383	4	26	80	0.3250000
NODE_10961_length_830_cov_32.170999	303	383	6	7	80	0.0875000
NODE_10961_length_830_cov_32.170999	356	436	4	20	80	0.2500000
NODE_10961_length_830_cov_32.170999	356	436	6	60	80	0.7500000
NODE_10962_length_830_cov_28.041040	393	473	5	3	80	0.0375000
NODE_10962_length_830_cov_28.041040	393	473	6	30	80	0.3750000
NODE_10962_length_830_cov_28.041040	393	473	7	47	80	0.5875000
NODE_10962_length_830_cov_28.041040	446	526	1	27	80	0.3375000
NODE_10962_length_830_cov_28.041040	446	526	2	2	80	0.0250000
NODE_10962_length_830_cov_28.041040	446	526	3	3	80	0.0375000
NODE_10962_length_830_cov_28.041040	446	526	5	24	80	0.3000000
NODE_10962_length_830_cov_28.041040	446	526	6	16	80	0.2000000
NODE_10962_length_830_cov_28.041040	446	526	7	8	80	0.1000000
NODE_10963_length_830_cov_20.280438	360	440	0	80	80	1.0000000
NODE_10963_length_830_cov_20.280438	413	492	0	59	79	0.7468355
NODE_10963_length_830_cov_20.280438	413	492	1	1	79	0.0126582
NODE_10963_length_830_cov_20.280438	413	492	2	19	79	0.2405063
NODE_10964_length_830_cov_19.495212	274	354	3	5	80	0.0625000
NODE_10964_length_830_cov_19.495212	274	354	4	1	80	0.0125000
NODE_10964_length_830_cov_19.495212	274	354	5	24	80	0.3000000
NODE_10964_length_830_cov_19.495212	274	354	6	50	80	0.6250000
NODE_10964_length_830_cov_19.495212	327	407	1	23	80	0.2875000
NODE_10964_length_830_cov_19.495212	327	407	2	25	80	0.3125000
NODE_10964_length_830_cov_19.495212	327	407	3	10	80	0.1250000
NODE_10964_length_830_cov_19.495212	327	407	4	1	80	0.0125000
NODE_10964_length_830_cov_19.495212	327	407	6	21	80	0.2625000
NODE_10965_length_830_cov_18.522572	368	448	5	30	80	0.3750000
NODE_10965_length_830_cov_18.522572	368	448	7	44	80	0.5500000
NODE_10965_length_830_cov_18.522572	368	448	8	6	80	0.0750000
NODE_10965_length_830_cov_18.522572	421	501	3	43	80	0.5375000
NODE_10965_length_830_cov_18.522572	421	501	5	16	80	0.2000000
NODE_10965_length_830_cov_18.522572	421	501	7	15	80	0.1875000
NODE_10965_length_830_cov_18.522572	421	501	8	6	80	0.0750000
NODE_10966_length_830_cov_13.830369	278	358	1	31	80	0.3875000
NODE_10966_length_830_cov_13.830369	278	358	3	49	80	0.6125000
NODE_10966_length_830_cov_13.830369	331	411	2	9	80	0.1125000
NODE_10966_length_830_cov_13.830369	331	411	3	71	80	0.8875000
NODE_10967_length_830_cov_12.459644	201	281	1	47	80	0.5875000
NODE_10967_length_830_cov_12.459644	201	281	2	7	80	0.0875000
NODE_10967_length_830_cov_12.459644	201	281	3	26	80	0.3250000
NODE_10967_length_830_cov_12.459644	254	334	1	1	80	0.0125000
NODE_10967_length_830_cov_12.459644	254	334	3	26	80	0.3250000
NODE_10967_length_830_cov_12.459644	254	334	5	53	80	0.6625000
NODE_10968_length_830_cov_8.344733	450	530	0	19	80	0.2375000
NODE_10968_length_830_cov_8.344733	450	530	1	50	80	0.6250000
NODE_10968_length_830_cov_8.344733	450	530	2	5	80	0.0625000
NODE_10968_length_830_cov_8.344733	450	530	3	6	80	0.0750000
NODE_10968_length_830_cov_8.344733	503	583	0	72	80	0.9000000
NODE_10968_length_830_cov_8.344733	503	583	1	8	80	0.1000000
NODE_10969_length_830_cov_8.227086	634	714	1	13	80	0.1625000
NODE_10969_length_830_cov_8.227086	634	714	2	67	80	0.8375000
NODE_10969_length_830_cov_8.227086	687	767	2	80	80	1.0000000
NODE_10995_length_829_cov_74.910959	271	351	5	6	80	0.0750000
NODE_10995_length_829_cov_74.910959	271	351	6	3	80	0.0375000
NODE_10995_length_829_cov_74.910959	271	351	7	51	80	0.6375000
NODE_10995_length_829_cov_74.910959	271	351	9	12	80	0.1500000
NODE_10995_length_829_cov_74.910959	271	351	11	8	80	0.1000000
NODE_10995_length_829_cov_74.910959	324	404	7	7	80	0.0875000
NODE_10995_length_829_cov_74.910959	324	404	8	31	80	0.3875000
NODE_10995_length_829_cov_74.910959	324	404	9	12	80	0.1500000
NODE_10995_length_829_cov_74.910959	324	404	10	20	80	0.2500000
NODE_10995_length_829_cov_74.910959	324	404	11	10	80	0.1250000
NODE_10996_length_829_cov_34.068493	302	382	2	27	80	0.3375000
NODE_10996_length_829_cov_34.068493	302	382	5	17	80	0.2125000
NODE_10996_length_829_cov_34.068493	302	382	6	12	80	0.1500000
NODE_10996_length_829_cov_34.068493	302	382	8	24	80	0.3000000
NODE_10996_length_829_cov_34.068493	355	435	6	31	80	0.3875000
NODE_10996_length_829_cov_34.068493	355	435	7	21	80	0.2625000
NODE_10996_length_829_cov_34.068493	355	435	8	28	80	0.3500000
NODE_10997_length_829_cov_24.027397	441	521	1	80	80	1.0000000
NODE_10997_length_829_cov_24.027397	494	574	1	80	80	1.0000000
NODE_10998_length_829_cov_21.735616	420	500	3	2	80	0.0250000
NODE_10998_length_829_cov_21.735616	420	500	4	56	80	0.7000000
NODE_10998_length_829_cov_21.735616	420	500	5	22	80	0.2750000
NODE_10998_length_829_cov_21.735616	473	553	2	25	80	0.3125000
NODE_10998_length_829_cov_21.735616	473	553	3	12	80	0.1500000
NODE_10998_length_829_cov_21.735616	473	553	4	5	80	0.0625000
NODE_10998_length_829_cov_21.735616	473	553	5	38	80	0.4750000
NODE_10999_length_829_cov_18.446575	407	487	3	12	80	0.1500000
NODE_10999_length_829_cov_18.446575	407	487	4	7	80	0.0875000
NODE_10999_length_829_cov_18.446575	407	487	5	11	80	0.1375000
NODE_10999_length_829_cov_18.446575	407	487	6	50	80	0.6250000
NODE_10999_length_829_cov_18.446575	460	540	3	12	80	0.1500000
NODE_10999_length_829_cov_18.446575	460	540	4	60	80	0.7500000
NODE_10999_length_829_cov_18.446575	460	540	6	8	80	0.1000000
NODE_11000_length_829_cov_10.971233	368	448	1	50	80	0.6250000
NODE_11000_length_829_cov_10.971233	368	448	2	30	80	0.3750000
NODE_11000_length_829_cov_10.971233	421	501	2	80	80	1.0000000
NODE_11001_length_829_cov_10.035616	387	467	4	13	80	0.1625000
NODE_11001_length_829_cov_10.035616	387	467	5	10	80	0.1250000
NODE_11001_length_829_cov_10.035616	387	467	9	20	80	0.2500000
NODE_11001_length_829_cov_10.035616	387	467	10	33	80	0.4125000
NODE_11001_length_829_cov_10.035616	387	467	11	4	80	0.0500000
NODE_11001_length_829_cov_10.035616	440	520	10	24	80	0.3000000
NODE_11001_length_829_cov_10.035616	440	520	11	8	80	0.1000000
NODE_11001_length_829_cov_10.035616	440	520	12	1	80	0.0125000
NODE_11001_length_829_cov_10.035616	440	520	13	28	80	0.3500000
NODE_11001_length_829_cov_10.035616	440	520	14	19	80	0.2375000
NODE_11002_length_829_cov_9.906849	326	406	0	80	80	1.0000000
NODE_11002_length_829_cov_9.906849	379	459	0	80	80	1.0000000
NODE_11003_length_829_cov_8.809589	450	530	1	71	80	0.8875000
NODE_11003_length_829_cov_8.809589	450	530	2	9	80	0.1125000
NODE_11003_length_829_cov_8.809589	503	583	1	35	80	0.4375000
NODE_11003_length_829_cov_8.809589	503	583	2	45	80	0.5625000
NODE_11006_length_829_cov_4.310959	473	553	0	80	80	1.0000000
NODE_11006_length_829_cov_4.310959	526	606	0	80	80	1.0000000
NODE_11008_length_829_cov_3.079452	507	587	0	80	80	1.0000000
NODE_11008_length_829_cov_3.079452	507	587	0	80	80	1.0000000
NODE_11008_length_829_cov_3.079452	560	640	0	80	80	1.0000000
NODE_11025_length_828_cov_41.116598	436	516	6	28	80	0.3500000
NODE_11025_length_828_cov_41.116598	436	516	8	2	80	0.0250000
NODE_11025_length_828_cov_41.116598	436	516	9	4	80	0.0500000
NODE_11025_length_828_cov_41.116598	436	516	10	1	80	0.0125000
NODE_11025_length_828_cov_41.116598	436	516	11	12	80	0.1500000
NODE_11025_length_828_cov_41.116598	436	516	12	1	80	0.0125000
NODE_11025_length_828_cov_41.116598	436	516	13	20	80	0.2500000
NODE_11025_length_828_cov_41.116598	436	516	14	9	80	0.1125000
NODE_11025_length_828_cov_41.116598	436	516	15	3	80	0.0375000
NODE_11025_length_828_cov_41.116598	489	569	12	15	80	0.1875000
NODE_11025_length_828_cov_41.116598	489	569	13	26	80	0.3250000
NODE_11025_length_828_cov_41.116598	489	569	14	34	80	0.4250000
NODE_11025_length_828_cov_41.116598	489	569	15	5	80	0.0625000
NODE_11026_length_828_cov_36.459534	372	452	9	2	80	0.0250000
NODE_11026_length_828_cov_36.459534	372	452	10	13	80	0.1625000
NODE_11026_length_828_cov_36.459534	372	452	11	30	80	0.3750000
NODE_11026_length_828_cov_36.459534	372	452	12	22	80	0.2750000
NODE_11026_length_828_cov_36.459534	372	452	13	13	80	0.1625000
NODE_11026_length_828_cov_36.459534	425	505	7	9	80	0.1125000
NODE_11026_length_828_cov_36.459534	425	505	8	16	80	0.2000000
NODE_11026_length_828_cov_36.459534	425	505	9	2	80	0.0250000
NODE_11026_length_828_cov_36.459534	425	505	11	24	80	0.3000000
NODE_11026_length_828_cov_36.459534	425	505	12	21	80	0.2625000
NODE_11026_length_828_cov_36.459534	425	505	13	8	80	0.1000000
NODE_11027_length_828_cov_33.515775	443	523	1	1	80	0.0125000
NODE_11027_length_828_cov_33.515775	443	523	3	2	80	0.0250000
NODE_11027_length_828_cov_33.515775	443	523	5	17	80	0.2125000
NODE_11027_length_828_cov_33.515775	443	523	6	60	80	0.7500000
NODE_11027_length_828_cov_33.515775	496	576	1	54	80	0.6750000
NODE_11027_length_828_cov_33.515775	496	576	3	2	80	0.0250000
NODE_11027_length_828_cov_33.515775	496	576	5	11	80	0.1375000
NODE_11027_length_828_cov_33.515775	496	576	6	13	80	0.1625000
NODE_11028_length_828_cov_21.123457	380	460	4	34	80	0.4250000
NODE_11028_length_828_cov_21.123457	380	460	5	30	80	0.3750000
NODE_11028_length_828_cov_21.123457	380	460	6	16	80	0.2000000
NODE_11028_length_828_cov_21.123457	433	513	3	24	80	0.3000000
NODE_11028_length_828_cov_21.123457	433	513	4	16	80	0.2000000
NODE_11028_length_828_cov_21.123457	433	513	5	32	80	0.4000000
NODE_11028_length_828_cov_21.123457	433	513	6	8	80	0.1000000
NODE_11029_length_828_cov_17.406036	304	392	5	12	88	0.1363636
NODE_11029_length_828_cov_17.406036	304	392	6	20	88	0.2272727
NODE_11029_length_828_cov_17.406036	304	392	7	38	88	0.4318182
NODE_11029_length_828_cov_17.406036	304	392	8	18	88	0.2045455
NODE_11029_length_828_cov_17.406036	369	445	5	3	76	0.0394737
NODE_11029_length_828_cov_17.406036	369	445	6	45	76	0.5921053
NODE_11029_length_828_cov_17.406036	369	445	7	28	76	0.3684210
NODE_11030_length_828_cov_14.606310	287	367	3	74	80	0.9250000
NODE_11030_length_828_cov_14.606310	287	367	4	6	80	0.0750000
NODE_11030_length_828_cov_14.606310	340	420	2	52	80	0.6500000
NODE_11030_length_828_cov_14.606310	340	420	3	24	80	0.3000000
NODE_11030_length_828_cov_14.606310	340	420	4	4	80	0.0500000
NODE_11031_length_828_cov_14.493827	326	406	1	29	80	0.3625000
NODE_11031_length_828_cov_14.493827	326	406	2	4	80	0.0500000
NODE_11031_length_828_cov_14.493827	326	406	3	47	80	0.5875000
NODE_11031_length_828_cov_14.493827	379	459	2	57	80	0.7125000
NODE_11031_length_828_cov_14.493827	379	459	3	23	80	0.2875000
NODE_11031_length_828_cov_14.493827	455	535	0	29	80	0.3625000
NODE_11031_length_828_cov_14.493827	455	535	2	51	80	0.6375000
NODE_11031_length_828_cov_14.493827	508	588	0	55	80	0.6875000
NODE_11031_length_828_cov_14.493827	508	588	1	25	80	0.3125000
NODE_11032_length_828_cov_10.550069	280	360	1	5	80	0.0625000
NODE_11032_length_828_cov_10.550069	280	360	2	75	80	0.9375000
NODE_11032_length_828_cov_10.550069	333	413	1	29	80	0.3625000
NODE_11032_length_828_cov_10.550069	333	413	2	51	80	0.6375000
NODE_11033_length_828_cov_9.292181	594	674	3	75	80	0.9375000
NODE_11033_length_828_cov_9.292181	594	674	4	5	80	0.0625000
NODE_11033_length_828_cov_9.292181	647	727	1	36	80	0.4500000
NODE_11033_length_828_cov_9.292181	647	727	3	42	80	0.5250000
NODE_11033_length_828_cov_9.292181	647	727	4	2	80	0.0250000
NODE_11034_length_828_cov_8.747599	298	378	4	80	80	1.0000000
NODE_11034_length_828_cov_8.747599	351	431	0	4	80	0.0500000
NODE_11034_length_828_cov_8.747599	351	431	2	13	80	0.1625000
NODE_11034_length_828_cov_8.747599	351	431	3	24	80	0.3000000
NODE_11034_length_828_cov_8.747599	351	431	4	39	80	0.4875000
NODE_11035_length_828_cov_8.098765	199	279	1	1	80	0.0125000
NODE_11035_length_828_cov_8.098765	199	279	2	79	80	0.9875000
NODE_11035_length_828_cov_8.098765	252	332	2	28	80	0.3500000
NODE_11035_length_828_cov_8.098765	252	332	3	3	80	0.0375000
NODE_11035_length_828_cov_8.098765	252	332	4	49	80	0.6125000
NODE_11037_length_828_cov_7.473251	300	380	0	27	80	0.3375000
NODE_11037_length_828_cov_7.473251	300	380	2	15	80	0.1875000
NODE_11037_length_828_cov_7.473251	300	380	3	38	80	0.4750000
NODE_11037_length_828_cov_7.473251	353	433	3	80	80	1.0000000
NODE_11039_length_828_cov_5.481481	543	623	3	1	80	0.0125000
NODE_11039_length_828_cov_5.481481	543	623	4	79	80	0.9875000
NODE_11039_length_828_cov_5.481481	596	676	1	22	80	0.2750000
NODE_11039_length_828_cov_5.481481	596	676	2	5	80	0.0625000
NODE_11039_length_828_cov_5.481481	596	676	4	53	80	0.6625000
NODE_11041_length_828_cov_5.069959	259	339	0	80	80	1.0000000
NODE_11066_length_827_cov_34.567308	269	349	8	2	80	0.0250000
NODE_11066_length_827_cov_34.567308	269	349	9	41	80	0.5125000
NODE_11066_length_827_cov_34.567308	269	349	10	7	80	0.0875000
NODE_11066_length_827_cov_34.567308	269	349	11	30	80	0.3750000
NODE_11066_length_827_cov_34.567308	322	402	5	24	80	0.3000000
NODE_11066_length_827_cov_34.567308	322	402	6	5	80	0.0625000
NODE_11066_length_827_cov_34.567308	322	402	9	37	80	0.4625000
NODE_11066_length_827_cov_34.567308	322	402	10	6	80	0.0750000
NODE_11066_length_827_cov_34.567308	322	402	11	8	80	0.1000000
NODE_11066_length_827_cov_34.567308	398	478	2	10	80	0.1250000
NODE_11066_length_827_cov_34.567308	398	478	4	53	80	0.6625000
NODE_11066_length_827_cov_34.567308	398	478	5	17	80	0.2125000
NODE_11066_length_827_cov_34.567308	451	531	0	32	80	0.4000000
NODE_11066_length_827_cov_34.567308	451	531	2	31	80	0.3875000
NODE_11066_length_827_cov_34.567308	451	531	4	17	80	0.2125000
NODE_11067_length_827_cov_31.538462	320	400	3	22	80	0.2750000
NODE_11067_length_827_cov_31.538462	320	400	4	58	80	0.7250000
NODE_11067_length_827_cov_31.538462	373	453	1	39	80	0.4875000
NODE_11067_length_827_cov_31.538462	373	453	3	36	80	0.4500000
NODE_11067_length_827_cov_31.538462	373	453	4	5	80	0.0625000
NODE_11068_length_827_cov_19.548077	464	544	5	1	80	0.0125000
NODE_11068_length_827_cov_19.548077	464	544	6	10	80	0.1250000
NODE_11068_length_827_cov_19.548077	464	544	8	4	80	0.0500000
NODE_11068_length_827_cov_19.548077	464	544	10	65	80	0.8125000
NODE_11068_length_827_cov_19.548077	517	597	1	22	80	0.2750000
NODE_11068_length_827_cov_19.548077	517	597	3	12	80	0.1500000
NODE_11068_length_827_cov_19.548077	517	597	5	13	80	0.1625000
NODE_11068_length_827_cov_19.548077	517	597	6	2	80	0.0250000
NODE_11068_length_827_cov_19.548077	517	597	8	8	80	0.1000000
NODE_11068_length_827_cov_19.548077	517	597	10	23	80	0.2875000
NODE_11069_length_827_cov_17.490385	320	400	9	4	80	0.0500000
NODE_11069_length_827_cov_17.490385	320	400	10	22	80	0.2750000
NODE_11069_length_827_cov_17.490385	320	400	11	1	80	0.0125000
NODE_11069_length_827_cov_17.490385	320	400	12	11	80	0.1375000
NODE_11069_length_827_cov_17.490385	320	400	14	1	80	0.0125000
NODE_11069_length_827_cov_17.490385	320	400	15	41	80	0.5125000
NODE_11069_length_827_cov_17.490385	373	453	7	7	80	0.0875000
NODE_11069_length_827_cov_17.490385	373	453	8	14	80	0.1750000
NODE_11069_length_827_cov_17.490385	373	453	11	1	80	0.0125000
NODE_11069_length_827_cov_17.490385	373	453	13	18	80	0.2250000
NODE_11069_length_827_cov_17.490385	373	453	14	7	80	0.0875000
NODE_11069_length_827_cov_17.490385	373	453	15	33	80	0.4125000
NODE_11070_length_827_cov_15.247253	205	285	1	47	80	0.5875000
NODE_11070_length_827_cov_15.247253	205	285	2	33	80	0.4125000
NODE_11070_length_827_cov_15.247253	258	338	1	80	80	1.0000000
NODE_11071_length_827_cov_14.151099	372	452	6	12	80	0.1500000
NODE_11071_length_827_cov_14.151099	372	452	7	8	80	0.1000000
NODE_11071_length_827_cov_14.151099	372	452	8	3	80	0.0375000
NODE_11071_length_827_cov_14.151099	372	452	9	7	80	0.0875000
NODE_11071_length_827_cov_14.151099	372	452	10	31	80	0.3875000
NODE_11071_length_827_cov_14.151099	372	452	11	18	80	0.2250000
NODE_11071_length_827_cov_14.151099	372	452	13	1	80	0.0125000
NODE_11071_length_827_cov_14.151099	425	505	2	7	80	0.0875000
NODE_11071_length_827_cov_14.151099	425	505	3	42	80	0.5250000
NODE_11071_length_827_cov_14.151099	425	505	4	2	80	0.0250000
NODE_11071_length_827_cov_14.151099	425	505	6	14	80	0.1750000
NODE_11071_length_827_cov_14.151099	425	505	7	8	80	0.1000000
NODE_11071_length_827_cov_14.151099	425	505	8	3	80	0.0375000
NODE_11071_length_827_cov_14.151099	425	505	9	4	80	0.0500000
NODE_11072_length_827_cov_12.157967	262	342	1	32	80	0.4000000
NODE_11072_length_827_cov_12.157967	262	342	2	48	80	0.6000000
NODE_11072_length_827_cov_12.157967	315	395	1	23	80	0.2875000
NODE_11072_length_827_cov_12.157967	315	395	2	57	80	0.7125000
NODE_11073_length_827_cov_11.777473	316	396	0	80	80	1.0000000
NODE_11073_length_827_cov_11.777473	369	449	0	80	80	1.0000000
NODE_11074_length_827_cov_11.651099	393	473	5	4	80	0.0500000
NODE_11074_length_827_cov_11.651099	393	473	6	32	80	0.4000000
NODE_11074_length_827_cov_11.651099	393	473	7	44	80	0.5500000
NODE_11074_length_827_cov_11.651099	446	526	2	21	80	0.2625000
NODE_11074_length_827_cov_11.651099	446	526	4	1	80	0.0125000
NODE_11074_length_827_cov_11.651099	446	526	5	22	80	0.2750000
NODE_11074_length_827_cov_11.651099	446	526	6	36	80	0.4500000
NODE_11075_length_827_cov_10.711538	286	366	0	9	80	0.1125000
NODE_11075_length_827_cov_10.711538	286	366	1	38	80	0.4750000
NODE_11075_length_827_cov_10.711538	286	366	3	8	80	0.1000000
NODE_11075_length_827_cov_10.711538	286	366	4	25	80	0.3125000
NODE_11075_length_827_cov_10.711538	339	419	3	2	80	0.0250000
NODE_11075_length_827_cov_10.711538	339	419	4	78	80	0.9750000
NODE_11076_length_827_cov_10.262363	273	353	1	26	80	0.3250000
NODE_11076_length_827_cov_10.262363	273	353	2	9	80	0.1125000
NODE_11076_length_827_cov_10.262363	273	353	3	16	80	0.2000000
NODE_11076_length_827_cov_10.262363	273	353	4	29	80	0.3625000
NODE_11076_length_827_cov_10.262363	326	406	3	3	80	0.0375000
NODE_11076_length_827_cov_10.262363	326	406	4	25	80	0.3125000
NODE_11076_length_827_cov_10.262363	326	406	5	52	80	0.6500000
NODE_11077_length_827_cov_10.221154	256	336	2	25	80	0.3125000
NODE_11077_length_827_cov_10.221154	256	336	4	55	80	0.6875000
NODE_11078_length_827_cov_9.576923	359	439	1	80	80	1.0000000
NODE_11078_length_827_cov_9.576923	412	492	1	80	80	1.0000000
NODE_11079_length_827_cov_8.780220	361	441	0	40	80	0.5000000
NODE_11079_length_827_cov_8.780220	361	441	2	40	80	0.5000000
NODE_11079_length_827_cov_8.780220	414	494	0	80	80	1.0000000
NODE_11093_length_827_cov_1.412088	736	784	6	13	48	0.2708333
NODE_11093_length_827_cov_1.412088	736	784	8	35	48	0.7291667
NODE_11106_length_826_cov_34.026135	211	291	4	6	80	0.0750000
NODE_11106_length_826_cov_34.026135	211	291	5	24	80	0.3000000
NODE_11106_length_826_cov_34.026135	211	291	7	42	80	0.5250000
NODE_11106_length_826_cov_34.026135	211	291	8	8	80	0.1000000
NODE_11106_length_826_cov_34.026135	264	344	6	13	80	0.1625000
NODE_11106_length_826_cov_34.026135	264	344	7	27	80	0.3375000
NODE_11106_length_826_cov_34.026135	264	344	8	40	80	0.5000000
NODE_11107_length_826_cov_24.093535	282	362	5	9	80	0.1125000
NODE_11107_length_826_cov_24.093535	282	362	6	5	80	0.0625000
NODE_11107_length_826_cov_24.093535	282	362	7	66	80	0.8250000
NODE_11107_length_826_cov_24.093535	335	415	3	5	80	0.0625000
NODE_11107_length_826_cov_24.093535	335	415	4	1	80	0.0125000
NODE_11107_length_826_cov_24.093535	335	415	5	10	80	0.1250000
NODE_11107_length_826_cov_24.093535	335	415	6	38	80	0.4750000
NODE_11107_length_826_cov_24.093535	335	415	7	26	80	0.3250000
NODE_11108_length_826_cov_20.943604	207	287	7	21	80	0.2625000
NODE_11108_length_826_cov_20.943604	207	287	8	59	80	0.7375000
NODE_11108_length_826_cov_20.943604	260	340	3	8	80	0.1000000
NODE_11108_length_826_cov_20.943604	260	340	4	5	80	0.0625000
NODE_11108_length_826_cov_20.943604	260	340	6	6	80	0.0750000
NODE_11108_length_826_cov_20.943604	260	340	7	8	80	0.1000000
NODE_11108_length_826_cov_20.943604	260	340	8	46	80	0.5750000
NODE_11108_length_826_cov_20.943604	260	340	9	7	80	0.0875000
NODE_11109_length_826_cov_20.437414	413	493	8	8	80	0.1000000
NODE_11109_length_826_cov_20.437414	413	493	9	45	80	0.5625000
NODE_11109_length_826_cov_20.437414	413	493	10	27	80	0.3375000
NODE_11109_length_826_cov_20.437414	466	546	2	4	80	0.0500000
NODE_11109_length_826_cov_20.437414	466	546	3	18	80	0.2250000
NODE_11109_length_826_cov_20.437414	466	546	4	24	80	0.3000000
NODE_11109_length_826_cov_20.437414	466	546	6	7	80	0.0875000
NODE_11109_length_826_cov_20.437414	466	546	8	8	80	0.1000000
NODE_11109_length_826_cov_20.437414	466	546	10	19	80	0.2375000
NODE_11110_length_826_cov_20.200825	432	512	2	80	80	1.0000000
NODE_11110_length_826_cov_20.200825	485	565	0	40	80	0.5000000
NODE_11110_length_826_cov_20.200825	485	565	2	40	80	0.5000000
NODE_11111_length_826_cov_18.489684	345	425	0	36	80	0.4500000
NODE_11111_length_826_cov_18.489684	345	425	1	31	80	0.3875000
NODE_11111_length_826_cov_18.489684	345	425	2	13	80	0.1625000
NODE_11111_length_826_cov_18.489684	398	478	1	14	80	0.1750000
NODE_11111_length_826_cov_18.489684	398	478	2	66	80	0.8250000
NODE_11112_length_826_cov_17.998624	336	416	6	1	80	0.0125000
NODE_11112_length_826_cov_17.998624	336	416	7	9	80	0.1125000
NODE_11112_length_826_cov_17.998624	336	416	8	22	80	0.2750000
NODE_11112_length_826_cov_17.998624	336	416	9	11	80	0.1375000
NODE_11112_length_826_cov_17.998624	336	416	10	7	80	0.0875000
NODE_11112_length_826_cov_17.998624	336	416	11	18	80	0.2250000
NODE_11112_length_826_cov_17.998624	336	416	12	12	80	0.1500000
NODE_11112_length_826_cov_17.998624	389	469	7	8	80	0.1000000
NODE_11112_length_826_cov_17.998624	389	469	10	34	80	0.4250000
NODE_11112_length_826_cov_17.998624	389	469	11	15	80	0.1875000
NODE_11112_length_826_cov_17.998624	389	469	12	23	80	0.2875000
NODE_11113_length_826_cov_17.038514	358	438	1	1	80	0.0125000
NODE_11113_length_826_cov_17.038514	358	438	3	4	80	0.0500000
NODE_11113_length_826_cov_17.038514	358	438	5	75	80	0.9375000
NODE_11113_length_826_cov_17.038514	411	491	4	29	80	0.3625000
NODE_11113_length_826_cov_17.038514	411	491	5	51	80	0.6375000
NODE_11114_length_826_cov_16.777166	514	603	0	89	89	1.0000000
NODE_11115_length_826_cov_16.177442	361	441	0	9	80	0.1125000
NODE_11115_length_826_cov_16.177442	361	441	2	41	80	0.5125000
NODE_11115_length_826_cov_16.177442	361	441	6	30	80	0.3750000
NODE_11115_length_826_cov_16.177442	414	494	6	39	80	0.4875000
NODE_11115_length_826_cov_16.177442	414	494	7	24	80	0.3000000
NODE_11115_length_826_cov_16.177442	414	494	8	17	80	0.2125000
NODE_11116_length_826_cov_15.134801	346	426	3	6	80	0.0750000
NODE_11116_length_826_cov_15.134801	346	426	4	6	80	0.0750000
NODE_11116_length_826_cov_15.134801	346	426	5	22	80	0.2750000
NODE_11116_length_826_cov_15.134801	346	426	6	31	80	0.3875000
NODE_11116_length_826_cov_15.134801	346	426	7	2	80	0.0250000
NODE_11116_length_826_cov_15.134801	346	426	8	13	80	0.1625000
NODE_11116_length_826_cov_15.134801	399	479	6	12	80	0.1500000
NODE_11116_length_826_cov_15.134801	399	479	7	18	80	0.2250000
NODE_11116_length_826_cov_15.134801	399	479	8	50	80	0.6250000
NODE_11117_length_826_cov_9.943604	320	400	4	30	80	0.3750000
NODE_11117_length_826_cov_9.943604	320	400	6	50	80	0.6250000
NODE_11117_length_826_cov_9.943604	373	453	3	29	80	0.3625000
NODE_11117_length_826_cov_9.943604	373	453	4	6	80	0.0750000
NODE_11117_length_826_cov_9.943604	373	453	5	10	80	0.1250000
NODE_11117_length_826_cov_9.943604	373	453	6	35	80	0.4375000
NODE_11120_length_826_cov_4.852820	501	579	2	29	78	0.3717949
NODE_11120_length_826_cov_4.852820	501	579	3	5	78	0.0641026
NODE_11120_length_826_cov_4.852820	501	579	4	44	78	0.5641026
NODE_11120_length_826_cov_4.852820	552	632	2	49	80	0.6125000
NODE_11120_length_826_cov_4.852820	552	632	4	31	80	0.3875000
NODE_11161_length_825_cov_61.804408	382	462	7	55	80	0.6875000
NODE_11161_length_825_cov_61.804408	382	462	8	24	80	0.3000000
NODE_11161_length_825_cov_61.804408	382	462	9	1	80	0.0125000
NODE_11161_length_825_cov_61.804408	435	514	4	5	79	0.0632911
NODE_11161_length_825_cov_61.804408	435	514	5	12	79	0.1518987
NODE_11161_length_825_cov_61.804408	435	514	7	29	79	0.3670886
NODE_11161_length_825_cov_61.804408	435	514	8	7	79	0.0886076
NODE_11161_length_825_cov_61.804408	435	514	9	26	79	0.3291139
NODE_11162_length_825_cov_43.825069	488	568	6	23	80	0.2875000
NODE_11162_length_825_cov_43.825069	488	568	7	11	80	0.1375000
NODE_11162_length_825_cov_43.825069	488	568	9	10	80	0.1250000
NODE_11162_length_825_cov_43.825069	488	568	10	12	80	0.1500000
NODE_11162_length_825_cov_43.825069	488	568	11	24	80	0.3000000
NODE_11162_length_825_cov_43.825069	541	621	6	8	80	0.1000000
NODE_11162_length_825_cov_43.825069	541	621	7	11	80	0.1375000
NODE_11162_length_825_cov_43.825069	541	621	8	2	80	0.0250000
NODE_11162_length_825_cov_43.825069	541	621	9	14	80	0.1750000
NODE_11162_length_825_cov_43.825069	541	621	10	34	80	0.4250000
NODE_11162_length_825_cov_43.825069	541	621	12	9	80	0.1125000
NODE_11162_length_825_cov_43.825069	541	621	13	2	80	0.0250000
NODE_11162_length_825_cov_43.825069	617	697	12	2	80	0.0250000
NODE_11162_length_825_cov_43.825069	617	697	13	11	80	0.1375000
NODE_11162_length_825_cov_43.825069	617	697	14	18	80	0.2250000
NODE_11162_length_825_cov_43.825069	617	697	15	5	80	0.0625000
NODE_11162_length_825_cov_43.825069	617	697	16	31	80	0.3875000
NODE_11162_length_825_cov_43.825069	617	697	17	10	80	0.1250000
NODE_11162_length_825_cov_43.825069	617	697	18	3	80	0.0375000
NODE_11162_length_825_cov_43.825069	670	750	10	13	80	0.1625000
NODE_11162_length_825_cov_43.825069	670	750	11	12	80	0.1500000
NODE_11162_length_825_cov_43.825069	670	750	12	10	80	0.1250000
NODE_11162_length_825_cov_43.825069	670	750	14	5	80	0.0625000
NODE_11162_length_825_cov_43.825069	670	750	16	23	80	0.2875000
NODE_11162_length_825_cov_43.825069	670	750	17	12	80	0.1500000
NODE_11162_length_825_cov_43.825069	670	750	18	5	80	0.0625000
NODE_11163_length_825_cov_43.389807	496	576	4	6	80	0.0750000
NODE_11163_length_825_cov_43.389807	496	576	5	24	80	0.3000000
NODE_11163_length_825_cov_43.389807	496	576	6	35	80	0.4375000
NODE_11163_length_825_cov_43.389807	496	576	7	15	80	0.1875000
NODE_11163_length_825_cov_43.389807	549	629	3	10	80	0.1250000
NODE_11163_length_825_cov_43.389807	549	629	4	9	80	0.1125000
NODE_11163_length_825_cov_43.389807	549	629	5	58	80	0.7250000
NODE_11163_length_825_cov_43.389807	549	629	7	3	80	0.0375000
NODE_11164_length_825_cov_39.603306	386	466	10	2	80	0.0250000
NODE_11164_length_825_cov_39.603306	386	466	11	18	80	0.2250000
NODE_11164_length_825_cov_39.603306	386	466	12	4	80	0.0500000
NODE_11164_length_825_cov_39.603306	386	466	13	46	80	0.5750000
NODE_11164_length_825_cov_39.603306	386	466	14	10	80	0.1250000
NODE_11164_length_825_cov_39.603306	439	519	2	5	80	0.0625000
NODE_11164_length_825_cov_39.603306	439	519	8	7	80	0.0875000
NODE_11164_length_825_cov_39.603306	439	519	9	4	80	0.0500000
NODE_11164_length_825_cov_39.603306	439	519	10	39	80	0.4875000
NODE_11164_length_825_cov_39.603306	439	519	11	18	80	0.2250000
NODE_11164_length_825_cov_39.603306	439	519	12	4	80	0.0500000
NODE_11164_length_825_cov_39.603306	439	519	14	3	80	0.0375000
NODE_11165_length_825_cov_32.205234	354	434	4	46	80	0.5750000
NODE_11165_length_825_cov_32.205234	354	434	5	34	80	0.4250000
NODE_11165_length_825_cov_32.205234	407	487	0	16	80	0.2000000
NODE_11165_length_825_cov_32.205234	407	487	4	42	80	0.5250000
NODE_11165_length_825_cov_32.205234	407	487	5	22	80	0.2750000
NODE_11166_length_825_cov_29.411846	503	583	4	26	80	0.3250000
NODE_11166_length_825_cov_29.411846	503	583	5	12	80	0.1500000
NODE_11166_length_825_cov_29.411846	503	583	7	5	80	0.0625000
NODE_11166_length_825_cov_29.411846	503	583	8	11	80	0.1375000
NODE_11166_length_825_cov_29.411846	503	583	9	22	80	0.2750000
NODE_11166_length_825_cov_29.411846	503	583	10	4	80	0.0500000
NODE_11166_length_825_cov_29.411846	556	636	7	1	80	0.0125000
NODE_11166_length_825_cov_29.411846	556	636	8	2	80	0.0250000
NODE_11166_length_825_cov_29.411846	556	636	9	22	80	0.2750000
NODE_11166_length_825_cov_29.411846	556	636	10	36	80	0.4500000
NODE_11166_length_825_cov_29.411846	556	636	11	19	80	0.2375000
NODE_11167_length_825_cov_22.428375	312	392	0	7	80	0.0875000
NODE_11167_length_825_cov_22.428375	312	392	1	49	80	0.6125000
NODE_11167_length_825_cov_22.428375	312	392	2	24	80	0.3000000
NODE_11167_length_825_cov_22.428375	365	445	1	3	80	0.0375000
NODE_11167_length_825_cov_22.428375	365	445	2	69	80	0.8625000
NODE_11167_length_825_cov_22.428375	365	445	4	8	80	0.1000000
NODE_11167_length_825_cov_22.428375	441	521	2	3	80	0.0375000
NODE_11167_length_825_cov_22.428375	441	521	3	49	80	0.6125000
NODE_11167_length_825_cov_22.428375	441	521	4	28	80	0.3500000
NODE_11167_length_825_cov_22.428375	494	574	0	30	80	0.3750000
NODE_11167_length_825_cov_22.428375	494	574	2	26	80	0.3250000
NODE_11167_length_825_cov_22.428375	494	574	3	24	80	0.3000000
NODE_11168_length_825_cov_19.964187	249	329	8	22	80	0.2750000
NODE_11168_length_825_cov_19.964187	249	329	9	15	80	0.1875000
NODE_11168_length_825_cov_19.964187	249	329	10	36	80	0.4500000
NODE_11168_length_825_cov_19.964187	249	329	11	7	80	0.0875000
NODE_11168_length_825_cov_19.964187	302	382	3	5	80	0.0625000
NODE_11168_length_825_cov_19.964187	302	382	5	2	80	0.0250000
NODE_11168_length_825_cov_19.964187	302	382	7	21	80	0.2625000
NODE_11168_length_825_cov_19.964187	302	382	8	44	80	0.5500000
NODE_11168_length_825_cov_19.964187	302	382	10	8	80	0.1000000
NODE_11169_length_825_cov_13.790634	273	353	4	40	80	0.5000000
NODE_11169_length_825_cov_13.790634	273	353	6	17	80	0.2125000
NODE_11169_length_825_cov_13.790634	273	353	7	4	80	0.0500000
NODE_11169_length_825_cov_13.790634	273	353	8	19	80	0.2375000
NODE_11169_length_825_cov_13.790634	326	406	3	5	80	0.0625000
NODE_11169_length_825_cov_13.790634	326	406	4	24	80	0.3000000
NODE_11169_length_825_cov_13.790634	326	406	6	18	80	0.2250000
NODE_11169_length_825_cov_13.790634	326	406	8	18	80	0.2250000
NODE_11169_length_825_cov_13.790634	326	406	9	15	80	0.1875000
NODE_11170_length_825_cov_11.834711	331	411	1	80	80	1.0000000
NODE_11170_length_825_cov_11.834711	384	464	1	57	80	0.7125000
NODE_11170_length_825_cov_11.834711	384	464	2	23	80	0.2875000
NODE_11171_length_825_cov_11.477961	392	472	0	80	80	1.0000000
NODE_11172_length_825_cov_8.947658	259	339	1	46	80	0.5750000
NODE_11172_length_825_cov_8.947658	259	339	2	16	80	0.2000000
NODE_11172_length_825_cov_8.947658	259	339	3	18	80	0.2250000
NODE_11172_length_825_cov_8.947658	312	392	2	41	80	0.5125000
NODE_11172_length_825_cov_8.947658	312	392	3	39	80	0.4875000
NODE_11173_length_825_cov_7.811295	379	459	1	21	80	0.2625000
NODE_11173_length_825_cov_7.811295	379	459	2	10	80	0.1250000
NODE_11173_length_825_cov_7.811295	379	459	4	49	80	0.6125000
NODE_11173_length_825_cov_7.811295	432	512	1	74	80	0.9250000
NODE_11173_length_825_cov_7.811295	432	512	2	6	80	0.0750000
NODE_11174_length_825_cov_7.104683	464	544	3	15	80	0.1875000
NODE_11174_length_825_cov_7.104683	464	544	5	38	80	0.4750000
NODE_11174_length_825_cov_7.104683	464	544	6	27	80	0.3375000
NODE_11174_length_825_cov_7.104683	517	597	4	18	80	0.2250000
NODE_11174_length_825_cov_7.104683	517	597	5	48	80	0.6000000
NODE_11174_length_825_cov_7.104683	517	597	6	14	80	0.1750000
NODE_11176_length_825_cov_6.252066	542	622	0	80	80	1.0000000
NODE_11176_length_825_cov_6.252066	595	675	0	80	80	1.0000000
NODE_11178_length_825_cov_5.230028	264	344	4	22	80	0.2750000
NODE_11178_length_825_cov_5.230028	264	344	6	58	80	0.7250000
NODE_11178_length_825_cov_5.230028	317	372	4	22	55	0.4000000
NODE_11178_length_825_cov_5.230028	317	372	6	33	55	0.6000000
NODE_11178_length_825_cov_5.230028	383	463	0	63	80	0.7875000
NODE_11178_length_825_cov_5.230028	383	463	1	8	80	0.1000000
NODE_11178_length_825_cov_5.230028	383	463	3	9	80	0.1125000
NODE_11178_length_825_cov_5.230028	436	516	0	80	80	1.0000000
NODE_11205_length_825_cov_0.765840	0	50	0	50	50	1.0000000
NODE_11207_length_824_cov_27.074483	337	412	1	42	75	0.5600000
NODE_11207_length_824_cov_27.074483	337	412	2	33	75	0.4400000
NODE_11207_length_824_cov_27.074483	390	470	1	58	80	0.7250000
NODE_11207_length_824_cov_27.074483	390	470	2	22	80	0.2750000
NODE_11208_length_824_cov_23.936552	365	445	2	4	80	0.0500000
NODE_11208_length_824_cov_23.936552	365	445	3	7	80	0.0875000
NODE_11208_length_824_cov_23.936552	365	445	4	64	80	0.8000000
NODE_11208_length_824_cov_23.936552	365	445	5	5	80	0.0625000
NODE_11208_length_824_cov_23.936552	418	493	1	38	75	0.5066667
NODE_11208_length_824_cov_23.936552	418	493	3	17	75	0.2266667
NODE_11208_length_824_cov_23.936552	418	493	4	20	75	0.2666667
NODE_11209_length_824_cov_22.129655	377	457	0	15	80	0.1875000
NODE_11209_length_824_cov_22.129655	377	457	1	41	80	0.5125000
NODE_11209_length_824_cov_22.129655	377	457	2	24	80	0.3000000
NODE_11209_length_824_cov_22.129655	430	510	1	3	80	0.0375000
NODE_11209_length_824_cov_22.129655	430	510	2	77	80	0.9625000
NODE_11210_length_824_cov_17.914483	387	467	5	53	80	0.6625000
NODE_11210_length_824_cov_17.914483	387	467	6	27	80	0.3375000
NODE_11210_length_824_cov_17.914483	440	520	2	35	80	0.4375000
NODE_11210_length_824_cov_17.914483	440	520	3	17	80	0.2125000
NODE_11210_length_824_cov_17.914483	440	520	5	6	80	0.0750000
NODE_11210_length_824_cov_17.914483	440	520	6	22	80	0.2750000
NODE_11211_length_824_cov_16.662069	362	442	2	63	80	0.7875000
NODE_11211_length_824_cov_16.662069	362	442	4	17	80	0.2125000
NODE_11211_length_824_cov_16.662069	415	495	0	39	80	0.4875000
NODE_11211_length_824_cov_16.662069	415	495	2	41	80	0.5125000
NODE_11212_length_824_cov_16.306207	352	432	6	5	80	0.0625000
NODE_11212_length_824_cov_16.306207	352	432	7	37	80	0.4625000
NODE_11212_length_824_cov_16.306207	352	432	8	38	80	0.4750000
NODE_11212_length_824_cov_16.306207	405	485	4	26	80	0.3250000
NODE_11212_length_824_cov_16.306207	405	485	5	1	80	0.0125000
NODE_11212_length_824_cov_16.306207	405	485	6	7	80	0.0875000
NODE_11212_length_824_cov_16.306207	405	485	7	26	80	0.3250000
NODE_11212_length_824_cov_16.306207	405	485	8	20	80	0.2500000
NODE_11213_length_824_cov_15.891034	342	422	5	10	80	0.1250000
NODE_11213_length_824_cov_15.891034	342	422	8	29	80	0.3625000
NODE_11213_length_824_cov_15.891034	342	422	9	34	80	0.4250000
NODE_11213_length_824_cov_15.891034	342	422	10	7	80	0.0875000
NODE_11213_length_824_cov_15.891034	395	475	8	14	80	0.1750000
NODE_11213_length_824_cov_15.891034	395	475	9	45	80	0.5625000
NODE_11213_length_824_cov_15.891034	395	475	10	21	80	0.2625000
NODE_11214_length_824_cov_12.485517	280	360	0	19	80	0.2375000
NODE_11214_length_824_cov_12.485517	280	360	2	2	80	0.0250000
NODE_11214_length_824_cov_12.485517	280	360	4	11	80	0.1375000
NODE_11214_length_824_cov_12.485517	280	360	6	48	80	0.6000000
NODE_11214_length_824_cov_12.485517	333	413	4	1	80	0.0125000
NODE_11214_length_824_cov_12.485517	333	413	6	79	80	0.9875000
NODE_11216_length_824_cov_5.924138	269	349	0	80	80	1.0000000
NODE_11216_length_824_cov_5.924138	322	402	0	80	80	1.0000000
NODE_11222_length_824_cov_3.849655	191	271	2	35	80	0.4375000
NODE_11222_length_824_cov_3.849655	191	271	3	40	80	0.5000000
NODE_11222_length_824_cov_3.849655	191	271	4	5	80	0.0625000
NODE_11251_length_823_cov_75.169890	207	287	12	5	80	0.0625000
NODE_11251_length_823_cov_75.169890	207	287	15	3	80	0.0375000
NODE_11251_length_823_cov_75.169890	207	287	17	5	80	0.0625000
NODE_11251_length_823_cov_75.169890	207	287	18	1	80	0.0125000
NODE_11251_length_823_cov_75.169890	207	287	19	5	80	0.0625000
NODE_11251_length_823_cov_75.169890	207	287	20	1	80	0.0125000
NODE_11251_length_823_cov_75.169890	207	287	21	10	80	0.1250000
NODE_11251_length_823_cov_75.169890	207	287	22	4	80	0.0500000
NODE_11251_length_823_cov_75.169890	207	287	23	1	80	0.0125000
NODE_11251_length_823_cov_75.169890	207	287	24	23	80	0.2875000
NODE_11251_length_823_cov_75.169890	207	287	25	3	80	0.0375000
NODE_11251_length_823_cov_75.169890	207	287	26	14	80	0.1750000
NODE_11251_length_823_cov_75.169890	207	287	27	5	80	0.0625000
NODE_11251_length_823_cov_75.169890	260	340	23	4	80	0.0500000
NODE_11251_length_823_cov_75.169890	260	340	24	15	80	0.1875000
NODE_11251_length_823_cov_75.169890	260	340	25	22	80	0.2750000
NODE_11251_length_823_cov_75.169890	260	340	26	27	80	0.3375000
NODE_11251_length_823_cov_75.169890	260	340	27	10	80	0.1250000
NODE_11251_length_823_cov_75.169890	260	340	28	1	80	0.0125000
NODE_11251_length_823_cov_75.169890	260	340	29	1	80	0.0125000
NODE_11251_length_823_cov_75.169890	336	416	16	2	80	0.0250000
NODE_11251_length_823_cov_75.169890	336	416	17	5	80	0.0625000
NODE_11251_length_823_cov_75.169890	336	416	18	30	80	0.3750000
NODE_11251_length_823_cov_75.169890	336	416	19	3	80	0.0375000
NODE_11251_length_823_cov_75.169890	336	416	20	5	80	0.0625000
NODE_11251_length_823_cov_75.169890	336	416	21	1	80	0.0125000
NODE_11251_length_823_cov_75.169890	336	416	22	8	80	0.1000000
NODE_11251_length_823_cov_75.169890	336	416	23	25	80	0.3125000
NODE_11251_length_823_cov_75.169890	336	416	24	1	80	0.0125000
NODE_11251_length_823_cov_75.169890	389	469	7	10	80	0.1250000
NODE_11251_length_823_cov_75.169890	389	469	8	1	80	0.0125000
NODE_11251_length_823_cov_75.169890	389	469	10	1	80	0.0125000
NODE_11251_length_823_cov_75.169890	389	469	11	13	80	0.1625000
NODE_11251_length_823_cov_75.169890	389	469	13	13	80	0.1625000
NODE_11251_length_823_cov_75.169890	389	469	15	4	80	0.0500000
NODE_11251_length_823_cov_75.169890	389	469	16	12	80	0.1500000
NODE_11251_length_823_cov_75.169890	389	469	18	24	80	0.3000000
NODE_11251_length_823_cov_75.169890	389	469	19	2	80	0.0250000
NODE_11253_length_823_cov_37.738950	332	412	9	13	80	0.1625000
NODE_11253_length_823_cov_37.738950	332	412	13	11	80	0.1375000
NODE_11253_length_823_cov_37.738950	332	412	14	20	80	0.2500000
NODE_11253_length_823_cov_37.738950	332	412	15	36	80	0.4500000
NODE_11253_length_823_cov_37.738950	385	466	7	4	81	0.0493827
NODE_11253_length_823_cov_37.738950	385	466	11	10	81	0.1234568
NODE_11253_length_823_cov_37.738950	385	466	13	28	81	0.3456790
NODE_11253_length_823_cov_37.738950	385	466	14	18	81	0.2222222
NODE_11253_length_823_cov_37.738950	385	466	15	21	81	0.2592593
NODE_11254_length_823_cov_29.349448	400	480	5	43	80	0.5375000
NODE_11254_length_823_cov_29.349448	400	480	6	6	80	0.0750000
NODE_11254_length_823_cov_29.349448	400	480	7	31	80	0.3875000
NODE_11254_length_823_cov_29.349448	453	533	3	5	80	0.0625000
NODE_11254_length_823_cov_29.349448	453	533	4	16	80	0.2000000
NODE_11254_length_823_cov_29.349448	453	533	5	46	80	0.5750000
NODE_11254_length_823_cov_29.349448	453	533	6	5	80	0.0625000
NODE_11254_length_823_cov_29.349448	453	533	7	8	80	0.1000000
NODE_11255_length_823_cov_25.730663	338	418	2	22	80	0.2750000
NODE_11255_length_823_cov_25.730663	338	418	3	7	80	0.0875000
NODE_11255_length_823_cov_25.730663	338	418	4	51	80	0.6375000
NODE_11255_length_823_cov_25.730663	391	471	4	80	80	1.0000000
NODE_11256_length_823_cov_24.599448	349	429	2	54	80	0.6750000
NODE_11256_length_823_cov_24.599448	349	429	3	26	80	0.3250000
NODE_11256_length_823_cov_24.599448	402	482	1	23	80	0.2875000
NODE_11256_length_823_cov_24.599448	402	482	2	57	80	0.7125000
NODE_11257_length_823_cov_22.149171	356	436	2	18	80	0.2250000
NODE_11257_length_823_cov_22.149171	356	436	3	35	80	0.4375000
NODE_11257_length_823_cov_22.149171	356	436	4	2	80	0.0250000
NODE_11257_length_823_cov_22.149171	356	436	5	25	80	0.3125000
NODE_11257_length_823_cov_22.149171	409	489	1	7	80	0.0875000
NODE_11257_length_823_cov_22.149171	409	489	2	64	80	0.8000000
NODE_11257_length_823_cov_22.149171	409	489	3	9	80	0.1125000
NODE_11257_length_823_cov_22.149171	485	565	0	44	80	0.5500000
NODE_11257_length_823_cov_22.149171	485	565	1	36	80	0.4500000
NODE_11257_length_823_cov_22.149171	538	618	0	80	80	1.0000000
NODE_11258_length_823_cov_20.892265	329	409	0	42	80	0.5250000
NODE_11258_length_823_cov_20.892265	329	409	1	38	80	0.4750000
NODE_11258_length_823_cov_20.892265	382	462	0	11	80	0.1375000
NODE_11258_length_823_cov_20.892265	382	462	1	69	80	0.8625000
NODE_11259_length_823_cov_19.281768	305	385	1	9	80	0.1125000
NODE_11259_length_823_cov_19.281768	305	385	2	19	80	0.2375000
NODE_11259_length_823_cov_19.281768	305	385	4	1	80	0.0125000
NODE_11259_length_823_cov_19.281768	305	385	5	6	80	0.0750000
NODE_11259_length_823_cov_19.281768	305	385	6	24	80	0.3000000
NODE_11259_length_823_cov_19.281768	305	385	7	11	80	0.1375000
NODE_11259_length_823_cov_19.281768	305	385	10	10	80	0.1250000
NODE_11259_length_823_cov_19.281768	358	438	6	6	80	0.0750000
NODE_11259_length_823_cov_19.281768	358	438	7	11	80	0.1375000
NODE_11259_length_823_cov_19.281768	358	438	10	14	80	0.1750000
NODE_11259_length_823_cov_19.281768	358	438	11	49	80	0.6125000
NODE_11260_length_823_cov_15.738950	409	489	2	54	80	0.6750000
NODE_11260_length_823_cov_15.738950	409	489	3	26	80	0.3250000
NODE_11260_length_823_cov_15.738950	462	542	2	3	80	0.0375000
NODE_11260_length_823_cov_15.738950	462	542	3	77	80	0.9625000
NODE_11261_length_823_cov_10.729282	362	437	0	75	75	1.0000000
NODE_11261_length_823_cov_10.729282	410	484	0	74	74	1.0000000
NODE_11262_length_823_cov_9.110497	394	474	1	21	80	0.2625000
NODE_11262_length_823_cov_9.110497	394	474	2	59	80	0.7375000
NODE_11262_length_823_cov_9.110497	447	527	1	45	80	0.5625000
NODE_11262_length_823_cov_9.110497	447	527	2	35	80	0.4375000
NODE_11265_length_823_cov_5.511050	168	248	0	80	80	1.0000000
NODE_11265_length_823_cov_5.511050	434	485	1	3	51	0.0588235
NODE_11265_length_823_cov_5.511050	434	485	2	48	51	0.9411765
NODE_11292_length_823_cov_0.968232	86	154	0	29	68	0.4264706
NODE_11292_length_823_cov_0.968232	86	154	2	39	68	0.5735294
NODE_11298_length_822_cov_25.423237	377	459	2	36	82	0.4390244
NODE_11298_length_822_cov_25.423237	377	459	4	46	82	0.5609756
NODE_11298_length_822_cov_25.423237	432	512	0	1	80	0.0125000
NODE_11298_length_822_cov_25.423237	432	512	2	10	80	0.1250000
NODE_11298_length_822_cov_25.423237	432	512	4	69	80	0.8625000
NODE_11299_length_822_cov_16.381743	394	474	3	4	80	0.0500000
NODE_11299_length_822_cov_16.381743	394	474	5	15	80	0.1875000
NODE_11299_length_822_cov_16.381743	394	474	6	61	80	0.7625000
NODE_11299_length_822_cov_16.381743	447	527	0	10	80	0.1250000
NODE_11299_length_822_cov_16.381743	447	527	2	19	80	0.2375000
NODE_11299_length_822_cov_16.381743	447	527	3	28	80	0.3500000
NODE_11299_length_822_cov_16.381743	447	527	5	15	80	0.1875000
NODE_11299_length_822_cov_16.381743	447	527	6	8	80	0.1000000
NODE_11300_length_822_cov_12.426003	223	296	0	73	73	1.0000000
NODE_11300_length_822_cov_12.426003	278	349	0	71	71	1.0000000
NODE_11301_length_822_cov_10.608575	464	544	6	48	80	0.6000000
NODE_11301_length_822_cov_10.608575	464	544	7	30	80	0.3750000
NODE_11301_length_822_cov_10.608575	464	544	8	2	80	0.0250000
NODE_11301_length_822_cov_10.608575	517	597	3	10	80	0.1250000
NODE_11301_length_822_cov_10.608575	517	597	4	12	80	0.1500000
NODE_11301_length_822_cov_10.608575	517	597	5	11	80	0.1375000
NODE_11301_length_822_cov_10.608575	517	597	6	47	80	0.5875000
NODE_11302_length_822_cov_9.496542	363	443	4	8	80	0.1000000
NODE_11302_length_822_cov_9.496542	363	443	5	72	80	0.9000000
NODE_11302_length_822_cov_9.496542	416	496	2	27	80	0.3375000
NODE_11302_length_822_cov_9.496542	416	496	3	16	80	0.2000000
NODE_11302_length_822_cov_9.496542	416	496	4	15	80	0.1875000
NODE_11302_length_822_cov_9.496542	416	496	5	22	80	0.2750000
NODE_11333_length_821_cov_39.818560	341	420	4	14	79	0.1772152
NODE_11333_length_821_cov_39.818560	341	420	5	11	79	0.1392405
NODE_11333_length_821_cov_39.818560	341	420	6	54	79	0.6835443
NODE_11333_length_821_cov_39.818560	393	473	2	2	80	0.0250000
NODE_11333_length_821_cov_39.818560	393	473	4	28	80	0.3500000
NODE_11333_length_821_cov_39.818560	393	473	6	50	80	0.6250000
NODE_11334_length_821_cov_27.721607	299	379	0	5	80	0.0625000
NODE_11334_length_821_cov_27.721607	299	379	1	21	80	0.2625000
NODE_11334_length_821_cov_27.721607	299	379	2	32	80	0.4000000
NODE_11334_length_821_cov_27.721607	299	379	3	22	80	0.2750000
NODE_11334_length_821_cov_27.721607	352	432	2	5	80	0.0625000
NODE_11334_length_821_cov_27.721607	352	432	3	51	80	0.6375000
NODE_11334_length_821_cov_27.721607	352	432	4	24	80	0.3000000
NODE_11335_length_821_cov_26.252078	386	466	9	8	80	0.1000000
NODE_11335_length_821_cov_26.252078	386	466	10	6	80	0.0750000
NODE_11335_length_821_cov_26.252078	386	466	11	26	80	0.3250000
NODE_11335_length_821_cov_26.252078	386	466	12	6	80	0.0750000
NODE_11335_length_821_cov_26.252078	386	466	13	34	80	0.4250000
NODE_11335_length_821_cov_26.252078	439	519	5	9	80	0.1125000
NODE_11335_length_821_cov_26.252078	439	519	6	22	80	0.2750000
NODE_11335_length_821_cov_26.252078	439	519	7	15	80	0.1875000
NODE_11335_length_821_cov_26.252078	439	519	9	15	80	0.1875000
NODE_11335_length_821_cov_26.252078	439	519	11	19	80	0.2375000
NODE_11336_length_821_cov_19.603878	353	433	2	13	80	0.1625000
NODE_11336_length_821_cov_19.603878	353	433	4	16	80	0.2000000
NODE_11336_length_821_cov_19.603878	353	433	5	47	80	0.5875000
NODE_11336_length_821_cov_19.603878	353	433	6	4	80	0.0500000
NODE_11336_length_821_cov_19.603878	406	486	2	66	80	0.8250000
NODE_11336_length_821_cov_19.603878	406	486	4	9	80	0.1125000
NODE_11336_length_821_cov_19.603878	406	486	5	1	80	0.0125000
NODE_11336_length_821_cov_19.603878	406	486	6	4	80	0.0500000
NODE_11337_length_821_cov_15.945983	310	390	1	5	80	0.0625000
NODE_11337_length_821_cov_15.945983	310	390	3	2	80	0.0250000
NODE_11337_length_821_cov_15.945983	310	390	6	44	80	0.5500000
NODE_11337_length_821_cov_15.945983	310	390	7	29	80	0.3625000
NODE_11337_length_821_cov_15.945983	363	443	0	44	80	0.5500000
NODE_11337_length_821_cov_15.945983	363	443	1	14	80	0.1750000
NODE_11337_length_821_cov_15.945983	363	443	3	2	80	0.0250000
NODE_11337_length_821_cov_15.945983	363	443	6	20	80	0.2500000
NODE_11339_length_821_cov_8.711911	288	368	0	80	80	1.0000000
NODE_11339_length_821_cov_8.711911	341	421	0	80	80	1.0000000
NODE_11349_length_821_cov_3.026316	310	390	0	80	80	1.0000000
NODE_11349_length_821_cov_3.026316	363	443	0	80	80	1.0000000
NODE_11361_length_820_cov_67.292649	328	408	4	11	80	0.1375000
NODE_11361_length_820_cov_67.292649	328	408	6	20	80	0.2500000
NODE_11361_length_820_cov_67.292649	328	408	7	27	80	0.3375000
NODE_11361_length_820_cov_67.292649	328	408	8	10	80	0.1250000
NODE_11361_length_820_cov_67.292649	328	408	10	12	80	0.1500000
NODE_11361_length_820_cov_67.292649	381	461	7	5	80	0.0625000
NODE_11361_length_820_cov_67.292649	381	461	8	10	80	0.1250000
NODE_11361_length_820_cov_67.292649	381	461	9	42	80	0.5250000
NODE_11361_length_820_cov_67.292649	381	461	10	23	80	0.2875000
NODE_11362_length_820_cov_26.915395	308	388	0	63	80	0.7875000
NODE_11362_length_820_cov_26.915395	308	388	2	17	80	0.2125000
NODE_11363_length_820_cov_25.253814	301	381	0	21	80	0.2625000
NODE_11363_length_820_cov_25.253814	301	381	1	28	80	0.3500000
NODE_11363_length_820_cov_25.253814	301	381	2	31	80	0.3875000
NODE_11363_length_820_cov_25.253814	354	434	0	10	80	0.1250000
NODE_11363_length_820_cov_25.253814	354	434	1	19	80	0.2375000
NODE_11363_length_820_cov_25.253814	354	434	2	10	80	0.1250000
NODE_11363_length_820_cov_25.253814	354	434	3	41	80	0.5125000
NODE_11363_length_820_cov_25.253814	430	510	3	80	80	1.0000000
NODE_11363_length_820_cov_25.253814	483	563	0	20	80	0.2500000
NODE_11363_length_820_cov_25.253814	483	563	1	11	80	0.1375000
NODE_11363_length_820_cov_25.253814	483	563	2	18	80	0.2250000
NODE_11363_length_820_cov_25.253814	483	563	3	31	80	0.3875000
NODE_11364_length_820_cov_16.015257	325	405	0	80	80	1.0000000
NODE_11364_length_820_cov_16.015257	378	458	0	80	80	1.0000000
NODE_11365_length_820_cov_14.703190	371	451	1	13	80	0.1625000
NODE_11365_length_820_cov_14.703190	371	451	2	67	80	0.8375000
NODE_11365_length_820_cov_14.703190	424	504	0	38	80	0.4750000
NODE_11365_length_820_cov_14.703190	424	504	1	28	80	0.3500000
NODE_11365_length_820_cov_14.703190	424	504	2	14	80	0.1750000
NODE_11366_length_820_cov_14.527046	249	329	5	7	80	0.0875000
NODE_11366_length_820_cov_14.527046	249	329	6	16	80	0.2000000
NODE_11366_length_820_cov_14.527046	249	329	7	4	80	0.0500000
NODE_11366_length_820_cov_14.527046	249	329	8	39	80	0.4875000
NODE_11366_length_820_cov_14.527046	249	329	9	8	80	0.1000000
NODE_11366_length_820_cov_14.527046	249	329	10	6	80	0.0750000
NODE_11366_length_820_cov_14.527046	302	382	7	32	80	0.4000000
NODE_11366_length_820_cov_14.527046	302	382	8	34	80	0.4250000
NODE_11366_length_820_cov_14.527046	302	382	9	8	80	0.1000000
NODE_11366_length_820_cov_14.527046	302	382	10	6	80	0.0750000
NODE_11367_length_820_cov_14.284327	286	366	1	1	80	0.0125000
NODE_11367_length_820_cov_14.284327	286	366	2	27	80	0.3375000
NODE_11367_length_820_cov_14.284327	286	366	3	52	80	0.6500000
NODE_11367_length_820_cov_14.284327	339	419	2	80	80	1.0000000
NODE_11367_length_820_cov_14.284327	619	699	0	48	80	0.6000000
NODE_11367_length_820_cov_14.284327	619	699	2	1	80	0.0125000
NODE_11367_length_820_cov_14.284327	619	699	4	31	80	0.3875000
NODE_11368_length_820_cov_13.036061	364	444	7	26	80	0.3250000
NODE_11368_length_820_cov_13.036061	364	444	9	54	80	0.6750000
NODE_11368_length_820_cov_13.036061	417	497	1	9	80	0.1125000
NODE_11368_length_820_cov_13.036061	417	497	2	8	80	0.1000000
NODE_11368_length_820_cov_13.036061	417	497	3	29	80	0.3625000
NODE_11368_length_820_cov_13.036061	417	497	5	6	80	0.0750000
NODE_11368_length_820_cov_13.036061	417	497	7	27	80	0.3375000
NODE_11368_length_820_cov_13.036061	417	497	9	1	80	0.0125000
NODE_11369_length_820_cov_12.830791	313	393	1	9	80	0.1125000
NODE_11369_length_820_cov_12.830791	313	393	2	71	80	0.8875000
NODE_11369_length_820_cov_12.830791	366	446	2	80	80	1.0000000
NODE_11370_length_820_cov_12.768377	366	443	2	11	77	0.1428571
NODE_11370_length_820_cov_12.768377	366	443	3	8	77	0.1038961
NODE_11370_length_820_cov_12.768377	366	443	4	27	77	0.3506494
NODE_11370_length_820_cov_12.768377	366	443	5	31	77	0.4025974
NODE_11370_length_820_cov_12.768377	496	525	2	29	29	1.0000000
NODE_11371_length_820_cov_12.223301	452	519	5	38	67	0.5671642
NODE_11371_length_820_cov_12.223301	452	519	6	29	67	0.4328358
NODE_11371_length_820_cov_12.223301	492	572	0	6	80	0.0750000
NODE_11371_length_820_cov_12.223301	492	572	2	24	80	0.3000000
NODE_11371_length_820_cov_12.223301	492	572	3	15	80	0.1875000
NODE_11371_length_820_cov_12.223301	492	572	5	35	80	0.4375000
NODE_11396_length_819_cov_43.027778	403	483	8	80	80	1.0000000
NODE_11396_length_819_cov_43.027778	456	536	0	37	80	0.4625000
NODE_11396_length_819_cov_43.027778	456	536	4	3	80	0.0375000
NODE_11396_length_819_cov_43.027778	456	536	8	40	80	0.5000000
NODE_11396_length_819_cov_43.027778	532	612	0	77	80	0.9625000
NODE_11396_length_819_cov_43.027778	532	612	2	3	80	0.0375000
NODE_11396_length_819_cov_43.027778	585	665	0	24	80	0.3000000
NODE_11396_length_819_cov_43.027778	585	665	2	56	80	0.7000000
NODE_11397_length_819_cov_42.758333	391	471	2	9	80	0.1125000
NODE_11397_length_819_cov_42.758333	391	471	3	38	80	0.4750000
NODE_11397_length_819_cov_42.758333	391	471	4	17	80	0.2125000
NODE_11397_length_819_cov_42.758333	391	471	6	16	80	0.2000000
NODE_11397_length_819_cov_42.758333	444	524	4	11	80	0.1375000
NODE_11397_length_819_cov_42.758333	444	524	6	69	80	0.8625000
NODE_11398_length_819_cov_41.341667	86	166	6	1	80	0.0125000
NODE_11398_length_819_cov_41.341667	86	166	9	31	80	0.3875000
NODE_11398_length_819_cov_41.341667	86	166	10	19	80	0.2375000
NODE_11398_length_819_cov_41.341667	86	166	13	5	80	0.0625000
NODE_11398_length_819_cov_41.341667	86	166	14	17	80	0.2125000
NODE_11398_length_819_cov_41.341667	86	166	15	1	80	0.0125000
NODE_11398_length_819_cov_41.341667	86	166	16	6	80	0.0750000
NODE_11398_length_819_cov_41.341667	139	219	11	12	80	0.1500000
NODE_11398_length_819_cov_41.341667	139	219	12	22	80	0.2750000
NODE_11398_length_819_cov_41.341667	139	219	13	16	80	0.2000000
NODE_11398_length_819_cov_41.341667	139	219	14	23	80	0.2875000
NODE_11398_length_819_cov_41.341667	139	219	15	1	80	0.0125000
NODE_11398_length_819_cov_41.341667	139	219	16	6	80	0.0750000
NODE_11398_length_819_cov_41.341667	215	295	8	1	80	0.0125000
NODE_11398_length_819_cov_41.341667	215	295	10	5	80	0.0625000
NODE_11398_length_819_cov_41.341667	215	295	11	2	80	0.0250000
NODE_11398_length_819_cov_41.341667	215	295	12	3	80	0.0375000
NODE_11398_length_819_cov_41.341667	215	295	13	21	80	0.2625000
NODE_11398_length_819_cov_41.341667	215	295	14	31	80	0.3875000
NODE_11398_length_819_cov_41.341667	215	295	15	8	80	0.1000000
NODE_11398_length_819_cov_41.341667	215	295	16	6	80	0.0750000
NODE_11398_length_819_cov_41.341667	215	295	17	3	80	0.0375000
NODE_11398_length_819_cov_41.341667	268	348	8	3	80	0.0375000
NODE_11398_length_819_cov_41.341667	268	348	9	8	80	0.1000000
NODE_11398_length_819_cov_41.341667	268	348	10	48	80	0.6000000
NODE_11398_length_819_cov_41.341667	268	348	11	2	80	0.0250000
NODE_11398_length_819_cov_41.341667	268	348	13	19	80	0.2375000
NODE_11399_length_819_cov_23.656944	335	415	4	56	80	0.7000000
NODE_11399_length_819_cov_23.656944	335	415	6	24	80	0.3000000
NODE_11399_length_819_cov_23.656944	388	468	2	17	80	0.2125000
NODE_11399_length_819_cov_23.656944	388	468	3	11	80	0.1375000
NODE_11399_length_819_cov_23.656944	388	468	4	5	80	0.0625000
NODE_11399_length_819_cov_23.656944	388	468	6	47	80	0.5875000
NODE_11400_length_819_cov_20.633333	475	555	7	32	80	0.4000000
NODE_11400_length_819_cov_20.633333	475	555	8	48	80	0.6000000
NODE_11400_length_819_cov_20.633333	528	608	1	11	80	0.1375000
NODE_11400_length_819_cov_20.633333	528	608	2	1	80	0.0125000
NODE_11400_length_819_cov_20.633333	528	608	3	16	80	0.2000000
NODE_11400_length_819_cov_20.633333	528	608	5	6	80	0.0750000
NODE_11400_length_819_cov_20.633333	528	608	7	21	80	0.2625000
NODE_11400_length_819_cov_20.633333	528	608	8	25	80	0.3125000
NODE_11401_length_819_cov_18.941667	307	387	1	34	80	0.4250000
NODE_11401_length_819_cov_18.941667	307	387	2	15	80	0.1875000
NODE_11401_length_819_cov_18.941667	307	387	3	31	80	0.3875000
NODE_11401_length_819_cov_18.941667	360	440	3	48	80	0.6000000
NODE_11401_length_819_cov_18.941667	360	440	4	13	80	0.1625000
NODE_11401_length_819_cov_18.941667	360	440	5	19	80	0.2375000
NODE_11401_length_819_cov_18.941667	436	516	3	12	80	0.1500000
NODE_11401_length_819_cov_18.941667	436	516	4	28	80	0.3500000
NODE_11401_length_819_cov_18.941667	436	516	5	40	80	0.5000000
NODE_11401_length_819_cov_18.941667	489	569	1	43	80	0.5375000
NODE_11401_length_819_cov_18.941667	489	569	3	22	80	0.2750000
NODE_11401_length_819_cov_18.941667	489	569	4	15	80	0.1875000
NODE_11402_length_819_cov_12.225000	431	511	4	12	80	0.1500000
NODE_11402_length_819_cov_12.225000	431	511	6	68	80	0.8500000
NODE_11402_length_819_cov_12.225000	484	564	4	35	80	0.4375000
NODE_11402_length_819_cov_12.225000	484	564	5	30	80	0.3750000
NODE_11402_length_819_cov_12.225000	484	564	6	15	80	0.1875000
NODE_11403_length_819_cov_11.562500	273	353	0	80	80	1.0000000
NODE_11403_length_819_cov_11.562500	326	406	0	80	80	1.0000000
NODE_11404_length_819_cov_8.905556	477	557	1	45	80	0.5625000
NODE_11404_length_819_cov_8.905556	477	557	2	35	80	0.4375000
NODE_11404_length_819_cov_8.905556	530	610	2	80	80	1.0000000
NODE_11405_length_819_cov_5.675000	232	312	0	80	80	1.0000000
NODE_11405_length_819_cov_5.675000	285	365	0	80	80	1.0000000
NODE_11431_length_818_cov_21.979138	342	422	5	4	80	0.0500000
NODE_11431_length_818_cov_21.979138	342	422	6	12	80	0.1500000
NODE_11431_length_818_cov_21.979138	342	422	7	20	80	0.2500000
NODE_11431_length_818_cov_21.979138	342	422	8	31	80	0.3875000
NODE_11431_length_818_cov_21.979138	342	422	9	13	80	0.1625000
NODE_11431_length_818_cov_21.979138	395	475	3	2	80	0.0250000
NODE_11431_length_818_cov_21.979138	395	475	4	11	80	0.1375000
NODE_11431_length_818_cov_21.979138	395	475	5	19	80	0.2375000
NODE_11431_length_818_cov_21.979138	395	475	6	17	80	0.2125000
NODE_11431_length_818_cov_21.979138	395	475	7	16	80	0.2000000
NODE_11431_length_818_cov_21.979138	395	475	8	15	80	0.1875000
NODE_11432_length_818_cov_15.326843	334	414	1	1	80	0.0125000
NODE_11432_length_818_cov_15.326843	334	414	2	9	80	0.1125000
NODE_11432_length_818_cov_15.326843	334	414	3	70	80	0.8750000
NODE_11432_length_818_cov_15.326843	387	467	2	1	80	0.0125000
NODE_11432_length_818_cov_15.326843	387	467	3	79	80	0.9875000
NODE_11433_length_818_cov_14.880389	392	472	3	3	80	0.0375000
NODE_11433_length_818_cov_14.880389	392	472	4	77	80	0.9625000
NODE_11433_length_818_cov_14.880389	445	525	3	7	80	0.0875000
NODE_11433_length_818_cov_14.880389	445	525	4	73	80	0.9125000
NODE_11434_length_818_cov_12.369958	390	470	6	70	80	0.8750000
NODE_11434_length_818_cov_12.369958	390	470	8	10	80	0.1250000
NODE_11434_length_818_cov_12.369958	443	523	4	24	80	0.3000000
NODE_11434_length_818_cov_12.369958	443	523	5	10	80	0.1250000
NODE_11434_length_818_cov_12.369958	443	523	6	46	80	0.5750000
NODE_11436_length_818_cov_8.421419	370	450	0	51	80	0.6375000
NODE_11436_length_818_cov_8.421419	370	450	2	29	80	0.3625000
NODE_11436_length_818_cov_8.421419	423	503	2	80	80	1.0000000
NODE_11437_length_818_cov_6.439499	706	741	2	35	35	1.0000000
NODE_11439_length_818_cov_4.098748	320	390	0	70	70	1.0000000
NODE_11439_length_818_cov_4.098748	416	472	0	56	56	1.0000000
NODE_11457_length_817_cov_7.238162	494	574	5	5	80	0.0625000
NODE_11457_length_817_cov_7.238162	494	574	6	58	80	0.7250000
NODE_11457_length_817_cov_7.238162	494	574	7	17	80	0.2125000
NODE_11457_length_817_cov_7.238162	547	627	5	15	80	0.1875000
NODE_11457_length_817_cov_7.238162	547	627	6	63	80	0.7875000
NODE_11457_length_817_cov_7.238162	547	627	7	2	80	0.0250000
NODE_11458_length_817_cov_5.789694	400	480	0	4	80	0.0500000
NODE_11458_length_817_cov_5.789694	400	480	1	76	80	0.9500000
NODE_11458_length_817_cov_5.789694	476	555	0	5	79	0.0632911
NODE_11458_length_817_cov_5.789694	476	555	1	74	79	0.9367089
NODE_11458_length_817_cov_5.789694	528	608	0	58	80	0.7250000
NODE_11458_length_817_cov_5.789694	528	608	1	22	80	0.2750000
NODE_11462_length_817_cov_4.357939	433	513	3	28	80	0.3500000
NODE_11462_length_817_cov_4.357939	433	513	4	52	80	0.6500000
NODE_11462_length_817_cov_4.357939	486	566	1	26	80	0.3250000
NODE_11462_length_817_cov_4.357939	486	566	2	17	80	0.2125000
NODE_11462_length_817_cov_4.357939	486	566	3	20	80	0.2500000
NODE_11462_length_817_cov_4.357939	486	566	4	17	80	0.2125000
NODE_11486_length_817_cov_0.692201	626	696	0	10	70	0.1428571
NODE_11486_length_817_cov_0.692201	626	696	2	60	70	0.8571429
NODE_11488_length_816_cov_69.800558	395	475	5	51	80	0.6375000
NODE_11488_length_816_cov_69.800558	395	475	6	1	80	0.0125000
NODE_11488_length_816_cov_69.800558	395	475	7	28	80	0.3500000
NODE_11488_length_816_cov_69.800558	448	520	2	20	72	0.2777778
NODE_11488_length_816_cov_69.800558	448	520	5	51	72	0.7083333
NODE_11488_length_816_cov_69.800558	448	520	6	1	72	0.0138889
NODE_11489_length_816_cov_19.044630	77	154	2	77	77	1.0000000
NODE_11489_length_816_cov_19.044630	130	212	2	67	82	0.8170732
NODE_11489_length_816_cov_19.044630	130	212	4	15	82	0.1829268
NODE_11490_length_816_cov_16.418410	381	461	2	52	80	0.6500000
NODE_11490_length_816_cov_16.418410	381	461	3	28	80	0.3500000
NODE_11490_length_816_cov_16.418410	434	514	1	51	80	0.6375000
NODE_11490_length_816_cov_16.418410	434	514	3	29	80	0.3625000
NODE_11491_length_816_cov_15.945607	319	399	0	69	80	0.8625000
NODE_11491_length_816_cov_15.945607	319	399	1	11	80	0.1375000
NODE_11491_length_816_cov_15.945607	372	452	0	16	80	0.2000000
NODE_11491_length_816_cov_15.945607	372	452	1	13	80	0.1625000
NODE_11491_length_816_cov_15.945607	372	452	2	40	80	0.5000000
NODE_11491_length_816_cov_15.945607	372	452	3	11	80	0.1375000
NODE_11492_length_816_cov_12.797768	358	438	2	33	80	0.4125000
NODE_11492_length_816_cov_12.797768	358	438	3	7	80	0.0875000
NODE_11492_length_816_cov_12.797768	358	438	4	40	80	0.5000000
NODE_11492_length_816_cov_12.797768	411	491	3	40	80	0.5000000
NODE_11492_length_816_cov_12.797768	411	491	4	40	80	0.5000000
NODE_11493_length_816_cov_12.086471	242	322	0	48	80	0.6000000
NODE_11493_length_816_cov_12.086471	242	322	1	32	80	0.4000000
NODE_11493_length_816_cov_12.086471	295	375	1	65	80	0.8125000
NODE_11493_length_816_cov_12.086471	295	375	2	15	80	0.1875000
NODE_11495_length_816_cov_3.873082	412	492	0	80	80	1.0000000
NODE_11495_length_816_cov_3.873082	465	545	0	80	80	1.0000000
NODE_11516_length_815_cov_48.090782	334	414	1	4	80	0.0500000
NODE_11516_length_815_cov_48.090782	334	414	2	21	80	0.2625000
NODE_11516_length_815_cov_48.090782	334	414	4	8	80	0.1000000
NODE_11516_length_815_cov_48.090782	334	414	5	47	80	0.5875000
NODE_11516_length_815_cov_48.090782	387	467	5	57	80	0.7125000
NODE_11516_length_815_cov_48.090782	387	467	6	23	80	0.2875000
NODE_11517_length_815_cov_27.748603	290	370	4	5	80	0.0625000
NODE_11517_length_815_cov_27.748603	290	370	5	12	80	0.1500000
NODE_11517_length_815_cov_27.748603	290	370	6	18	80	0.2250000
NODE_11517_length_815_cov_27.748603	290	370	8	11	80	0.1375000
NODE_11517_length_815_cov_27.748603	290	370	9	34	80	0.4250000
NODE_11517_length_815_cov_27.748603	343	423	8	7	80	0.0875000
NODE_11517_length_815_cov_27.748603	343	423	9	42	80	0.5250000
NODE_11517_length_815_cov_27.748603	343	423	10	31	80	0.3875000
NODE_11518_length_815_cov_23.748603	429	509	9	42	80	0.5250000
NODE_11518_length_815_cov_23.748603	429	509	11	38	80	0.4750000
NODE_11518_length_815_cov_23.748603	482	562	2	10	80	0.1250000
NODE_11518_length_815_cov_23.748603	482	562	4	1	80	0.0125000
NODE_11518_length_815_cov_23.748603	482	562	5	4	80	0.0500000
NODE_11518_length_815_cov_23.748603	482	562	6	9	80	0.1125000
NODE_11518_length_815_cov_23.748603	482	562	7	14	80	0.1750000
NODE_11518_length_815_cov_23.748603	482	562	8	7	80	0.0875000
NODE_11518_length_815_cov_23.748603	482	562	9	1	80	0.0125000
NODE_11518_length_815_cov_23.748603	482	562	11	34	80	0.4250000
NODE_11519_length_815_cov_14.870112	318	398	1	3	80	0.0375000
NODE_11519_length_815_cov_14.870112	318	398	2	77	80	0.9625000
NODE_11519_length_815_cov_14.870112	371	451	0	7	80	0.0875000
NODE_11519_length_815_cov_14.870112	371	451	1	49	80	0.6125000
NODE_11519_length_815_cov_14.870112	371	451	2	24	80	0.3000000
NODE_11520_length_815_cov_13.317039	338	418	3	49	80	0.6125000
NODE_11520_length_815_cov_13.317039	338	418	4	31	80	0.3875000
NODE_11520_length_815_cov_13.317039	391	471	4	80	80	1.0000000
NODE_11521_length_815_cov_12.270950	315	395	3	74	80	0.9250000
NODE_11521_length_815_cov_12.270950	315	395	4	1	80	0.0125000
NODE_11521_length_815_cov_12.270950	315	395	6	5	80	0.0625000
NODE_11521_length_815_cov_12.270950	368	448	0	12	80	0.1500000
NODE_11521_length_815_cov_12.270950	368	448	2	8	80	0.1000000
NODE_11521_length_815_cov_12.270950	368	448	3	60	80	0.7500000
NODE_11522_length_815_cov_9.304469	150	230	4	31	80	0.3875000
NODE_11522_length_815_cov_9.304469	150	230	5	22	80	0.2750000
NODE_11522_length_815_cov_9.304469	150	230	6	8	80	0.1000000
NODE_11522_length_815_cov_9.304469	150	230	8	19	80	0.2375000
NODE_11522_length_815_cov_9.304469	203	283	0	3	80	0.0375000
NODE_11522_length_815_cov_9.304469	203	283	1	2	80	0.0250000
NODE_11522_length_815_cov_9.304469	203	283	2	27	80	0.3375000
NODE_11522_length_815_cov_9.304469	203	283	3	11	80	0.1375000
NODE_11522_length_815_cov_9.304469	203	283	4	37	80	0.4625000
NODE_11524_length_815_cov_8.117318	437	517	1	29	80	0.3625000
NODE_11524_length_815_cov_8.117318	437	517	2	44	80	0.5500000
NODE_11524_length_815_cov_8.117318	437	517	3	7	80	0.0875000
NODE_11524_length_815_cov_8.117318	490	570	2	49	80	0.6125000
NODE_11524_length_815_cov_8.117318	490	570	4	31	80	0.3875000
NODE_11530_length_815_cov_3.963687	275	355	0	80	80	1.0000000
NODE_11530_length_815_cov_3.963687	328	408	0	80	80	1.0000000
NODE_11532_length_815_cov_2.976257	441	508	0	67	67	1.0000000
NODE_11554_length_814_cov_55.545455	304	384	8	3	80	0.0375000
NODE_11554_length_814_cov_55.545455	304	384	9	10	80	0.1250000
NODE_11554_length_814_cov_55.545455	304	384	11	11	80	0.1375000
NODE_11554_length_814_cov_55.545455	304	384	12	43	80	0.5375000
NODE_11554_length_814_cov_55.545455	304	384	13	13	80	0.1625000
NODE_11554_length_814_cov_55.545455	357	437	7	17	80	0.2125000
NODE_11554_length_814_cov_55.545455	357	437	8	13	80	0.1625000
NODE_11554_length_814_cov_55.545455	357	437	9	22	80	0.2750000
NODE_11554_length_814_cov_55.545455	357	437	10	1	80	0.0125000
NODE_11554_length_814_cov_55.545455	357	437	12	17	80	0.2125000
NODE_11554_length_814_cov_55.545455	357	437	13	10	80	0.1250000
NODE_11554_length_814_cov_55.545455	517	559	0	36	42	0.8571429
NODE_11554_length_814_cov_55.545455	517	559	1	6	42	0.1428571
NODE_11554_length_814_cov_55.545455	724	804	4	23	80	0.2875000
NODE_11554_length_814_cov_55.545455	724	804	6	4	80	0.0500000
NODE_11554_length_814_cov_55.545455	724	804	8	3	80	0.0375000
NODE_11554_length_814_cov_55.545455	724	804	9	50	80	0.6250000
NODE_11555_length_814_cov_32.216783	317	397	1	8	80	0.1000000
NODE_11555_length_814_cov_32.216783	317	397	2	18	80	0.2250000
NODE_11555_length_814_cov_32.216783	317	397	3	3	80	0.0375000
NODE_11555_length_814_cov_32.216783	317	397	5	13	80	0.1625000
NODE_11555_length_814_cov_32.216783	317	397	6	34	80	0.4250000
NODE_11555_length_814_cov_32.216783	317	397	7	4	80	0.0500000
NODE_11555_length_814_cov_32.216783	370	450	6	23	80	0.2875000
NODE_11555_length_814_cov_32.216783	370	450	7	18	80	0.2250000
NODE_11555_length_814_cov_32.216783	370	450	9	39	80	0.4875000
NODE_11556_length_814_cov_19.507692	174	254	10	13	80	0.1625000
NODE_11556_length_814_cov_19.507692	174	254	11	6	80	0.0750000
NODE_11556_length_814_cov_19.507692	174	254	13	4	80	0.0500000
NODE_11556_length_814_cov_19.507692	174	254	14	22	80	0.2750000
NODE_11556_length_814_cov_19.507692	174	254	15	24	80	0.3000000
NODE_11556_length_814_cov_19.507692	174	254	16	11	80	0.1375000
NODE_11556_length_814_cov_19.507692	227	307	4	1	80	0.0125000
NODE_11556_length_814_cov_19.507692	227	307	5	8	80	0.1000000
NODE_11556_length_814_cov_19.507692	227	307	6	1	80	0.0125000
NODE_11556_length_814_cov_19.507692	227	307	8	20	80	0.2500000
NODE_11556_length_814_cov_19.507692	227	307	9	6	80	0.0750000
NODE_11556_length_814_cov_19.507692	227	307	10	30	80	0.3750000
NODE_11556_length_814_cov_19.507692	227	307	11	6	80	0.0750000
NODE_11556_length_814_cov_19.507692	227	307	15	4	80	0.0500000
NODE_11556_length_814_cov_19.507692	227	307	16	4	80	0.0500000
NODE_11556_length_814_cov_19.507692	303	383	4	25	80	0.3125000
NODE_11556_length_814_cov_19.507692	303	383	5	15	80	0.1875000
NODE_11556_length_814_cov_19.507692	303	383	6	14	80	0.1750000
NODE_11556_length_814_cov_19.507692	303	383	7	13	80	0.1625000
NODE_11556_length_814_cov_19.507692	303	383	8	13	80	0.1625000
NODE_11556_length_814_cov_19.507692	356	436	6	9	80	0.1125000
NODE_11556_length_814_cov_19.507692	356	436	7	58	80	0.7250000
NODE_11556_length_814_cov_19.507692	356	436	8	13	80	0.1625000
NODE_11557_length_814_cov_18.579021	433	513	3	37	80	0.4625000
NODE_11557_length_814_cov_18.579021	433	513	4	27	80	0.3375000
NODE_11557_length_814_cov_18.579021	433	513	5	16	80	0.2000000
NODE_11557_length_814_cov_18.579021	486	566	1	7	80	0.0875000
NODE_11557_length_814_cov_18.579021	486	566	3	73	80	0.9125000
NODE_11558_length_814_cov_17.183217	339	419	2	5	80	0.0625000
NODE_11558_length_814_cov_17.183217	339	419	3	23	80	0.2875000
NODE_11558_length_814_cov_17.183217	339	419	4	29	80	0.3625000
NODE_11558_length_814_cov_17.183217	339	419	5	23	80	0.2875000
NODE_11558_length_814_cov_17.183217	392	472	4	68	80	0.8500000
NODE_11558_length_814_cov_17.183217	392	472	5	12	80	0.1500000
NODE_11559_length_814_cov_15.306294	238	318	4	12	80	0.1500000
NODE_11559_length_814_cov_15.306294	238	318	5	4	80	0.0500000
NODE_11559_length_814_cov_15.306294	238	318	6	36	80	0.4500000
NODE_11559_length_814_cov_15.306294	238	318	9	28	80	0.3500000
NODE_11559_length_814_cov_15.306294	291	371	1	11	80	0.1375000
NODE_11559_length_814_cov_15.306294	291	371	2	1	80	0.0125000
NODE_11559_length_814_cov_15.306294	291	371	3	2	80	0.0250000
NODE_11559_length_814_cov_15.306294	291	371	4	51	80	0.6375000
NODE_11559_length_814_cov_15.306294	291	371	5	4	80	0.0500000
NODE_11559_length_814_cov_15.306294	291	371	6	11	80	0.1375000
NODE_11560_length_814_cov_11.511888	397	477	3	8	80	0.1000000
NODE_11560_length_814_cov_11.511888	397	477	4	44	80	0.5500000
NODE_11560_length_814_cov_11.511888	397	477	5	28	80	0.3500000
NODE_11560_length_814_cov_11.511888	459	530	0	6	71	0.0845070
NODE_11560_length_814_cov_11.511888	459	530	2	5	71	0.0704225
NODE_11560_length_814_cov_11.511888	459	530	3	50	71	0.7042254
NODE_11560_length_814_cov_11.511888	459	530	4	10	71	0.1408451
NODE_11561_length_814_cov_10.395804	305	385	3	2	80	0.0250000
NODE_11561_length_814_cov_10.395804	305	385	4	59	80	0.7375000
NODE_11561_length_814_cov_10.395804	305	385	5	19	80	0.2375000
NODE_11561_length_814_cov_10.395804	358	438	3	11	80	0.1375000
NODE_11561_length_814_cov_10.395804	358	438	4	8	80	0.1000000
NODE_11561_length_814_cov_10.395804	358	438	5	61	80	0.7625000
NODE_11562_length_814_cov_9.692308	347	427	1	45	80	0.5625000
NODE_11562_length_814_cov_9.692308	347	427	2	35	80	0.4375000
NODE_11562_length_814_cov_9.692308	400	480	1	3	80	0.0375000
NODE_11562_length_814_cov_9.692308	400	480	2	77	80	0.9625000
NODE_11564_length_814_cov_9.274126	245	325	2	62	80	0.7750000
NODE_11564_length_814_cov_9.274126	245	325	4	18	80	0.2250000
NODE_11564_length_814_cov_9.274126	298	378	2	9	80	0.1125000
NODE_11564_length_814_cov_9.274126	298	378	4	71	80	0.8875000
NODE_11565_length_814_cov_8.973427	271	351	1	80	80	1.0000000
NODE_11565_length_814_cov_8.973427	324	404	0	18	80	0.2250000
NODE_11565_length_814_cov_8.973427	324	404	1	62	80	0.7750000
NODE_11573_length_814_cov_2.145455	273	327	0	54	54	1.0000000
NODE_11573_length_814_cov_2.145455	307	371	0	64	64	1.0000000
NODE_11587_length_813_cov_39.228291	225	305	7	1	80	0.0125000
NODE_11587_length_813_cov_39.228291	225	305	9	5	80	0.0625000
NODE_11587_length_813_cov_39.228291	225	305	10	5	80	0.0625000
NODE_11587_length_813_cov_39.228291	225	305	11	35	80	0.4375000
NODE_11587_length_813_cov_39.228291	225	305	12	1	80	0.0125000
NODE_11587_length_813_cov_39.228291	225	305	13	15	80	0.1875000
NODE_11587_length_813_cov_39.228291	225	305	14	18	80	0.2250000
NODE_11587_length_813_cov_39.228291	278	358	3	23	80	0.2875000
NODE_11587_length_813_cov_39.228291	278	358	7	5	80	0.0625000
NODE_11587_length_813_cov_39.228291	278	358	9	27	80	0.3375000
NODE_11587_length_813_cov_39.228291	278	358	10	5	80	0.0625000
NODE_11587_length_813_cov_39.228291	278	358	12	1	80	0.0125000
NODE_11587_length_813_cov_39.228291	278	358	13	1	80	0.0125000
NODE_11587_length_813_cov_39.228291	278	358	14	18	80	0.2250000
NODE_11588_length_813_cov_36.570028	406	486	6	5	80	0.0625000
NODE_11588_length_813_cov_36.570028	406	486	8	34	80	0.4250000
NODE_11588_length_813_cov_36.570028	406	486	9	9	80	0.1125000
NODE_11588_length_813_cov_36.570028	406	486	10	32	80	0.4000000
NODE_11588_length_813_cov_36.570028	459	539	6	12	80	0.1500000
NODE_11588_length_813_cov_36.570028	459	539	7	21	80	0.2625000
NODE_11588_length_813_cov_36.570028	459	539	8	40	80	0.5000000
NODE_11588_length_813_cov_36.570028	459	539	9	2	80	0.0250000
NODE_11588_length_813_cov_36.570028	459	539	10	5	80	0.0625000
NODE_11589_length_813_cov_26.718487	209	289	6	11	80	0.1375000
NODE_11589_length_813_cov_26.718487	209	289	8	13	80	0.1625000
NODE_11589_length_813_cov_26.718487	209	289	9	23	80	0.2875000
NODE_11589_length_813_cov_26.718487	209	289	10	28	80	0.3500000
NODE_11589_length_813_cov_26.718487	209	289	11	5	80	0.0625000
NODE_11589_length_813_cov_26.718487	262	342	3	9	80	0.1125000
NODE_11589_length_813_cov_26.718487	262	342	4	3	80	0.0375000
NODE_11589_length_813_cov_26.718487	262	342	6	9	80	0.1125000
NODE_11589_length_813_cov_26.718487	262	342	7	5	80	0.0625000
NODE_11589_length_813_cov_26.718487	262	342	8	40	80	0.5000000
NODE_11589_length_813_cov_26.718487	262	342	10	14	80	0.1750000
NODE_11590_length_813_cov_17.537815	335	415	3	21	80	0.2625000
NODE_11590_length_813_cov_17.537815	335	415	4	11	80	0.1375000
NODE_11590_length_813_cov_17.537815	335	415	5	48	80	0.6000000
NODE_11590_length_813_cov_17.537815	388	468	0	4	80	0.0500000
NODE_11590_length_813_cov_17.537815	388	468	1	2	80	0.0250000
NODE_11590_length_813_cov_17.537815	388	468	3	23	80	0.2875000
NODE_11590_length_813_cov_17.537815	388	468	5	51	80	0.6375000
NODE_11591_length_813_cov_14.243697	279	359	2	68	80	0.8500000
NODE_11591_length_813_cov_14.243697	279	359	3	12	80	0.1500000
NODE_11591_length_813_cov_14.243697	332	412	2	58	80	0.7250000
NODE_11591_length_813_cov_14.243697	332	412	3	12	80	0.1500000
NODE_11591_length_813_cov_14.243697	332	412	4	10	80	0.1250000
NODE_11592_length_813_cov_13.984594	307	387	2	27	80	0.3375000
NODE_11592_length_813_cov_13.984594	307	387	3	13	80	0.1625000
NODE_11592_length_813_cov_13.984594	307	387	5	17	80	0.2125000
NODE_11592_length_813_cov_13.984594	307	387	6	23	80	0.2875000
NODE_11592_length_813_cov_13.984594	360	440	5	55	80	0.6875000
NODE_11592_length_813_cov_13.984594	360	440	6	25	80	0.3125000
NODE_11593_length_813_cov_13.242297	336	416	0	70	80	0.8750000
NODE_11593_length_813_cov_13.242297	336	416	1	10	80	0.1250000
NODE_11593_length_813_cov_13.242297	389	469	0	17	80	0.2125000
NODE_11593_length_813_cov_13.242297	389	469	1	18	80	0.2250000
NODE_11593_length_813_cov_13.242297	389	469	2	45	80	0.5625000
NODE_11594_length_813_cov_11.985994	374	454	2	58	80	0.7250000
NODE_11594_length_813_cov_11.985994	374	454	3	22	80	0.2750000
NODE_11594_length_813_cov_11.985994	427	507	0	3	80	0.0375000
NODE_11594_length_813_cov_11.985994	427	507	1	13	80	0.1625000
NODE_11594_length_813_cov_11.985994	427	507	2	5	80	0.0625000
NODE_11594_length_813_cov_11.985994	427	507	3	59	80	0.7375000
NODE_11595_length_813_cov_11.668067	279	359	0	80	80	1.0000000
NODE_11595_length_813_cov_11.668067	332	412	0	32	80	0.4000000
NODE_11595_length_813_cov_11.668067	332	412	2	48	80	0.6000000
NODE_11596_length_813_cov_8.149860	538	618	2	8	80	0.1000000
NODE_11596_length_813_cov_8.149860	538	618	3	72	80	0.9000000
NODE_11596_length_813_cov_8.149860	591	671	1	18	80	0.2250000
NODE_11596_length_813_cov_8.149860	591	671	2	13	80	0.1625000
NODE_11596_length_813_cov_8.149860	591	671	3	49	80	0.6125000
NODE_11597_length_813_cov_7.098039	234	314	0	80	80	1.0000000
NODE_11597_length_813_cov_7.098039	287	367	0	80	80	1.0000000
NODE_11613_length_812_cov_45.183731	435	515	12	10	80	0.1250000
NODE_11613_length_812_cov_45.183731	435	515	13	4	80	0.0500000
NODE_11613_length_812_cov_45.183731	435	515	14	16	80	0.2000000
NODE_11613_length_812_cov_45.183731	435	515	15	31	80	0.3875000
NODE_11613_length_812_cov_45.183731	435	515	16	13	80	0.1625000
NODE_11613_length_812_cov_45.183731	435	515	17	6	80	0.0750000
NODE_11613_length_812_cov_45.183731	488	568	5	3	80	0.0375000
NODE_11613_length_812_cov_45.183731	488	568	7	8	80	0.1000000
NODE_11613_length_812_cov_45.183731	488	568	8	10	80	0.1250000
NODE_11613_length_812_cov_45.183731	488	568	9	2	80	0.0250000
NODE_11613_length_812_cov_45.183731	488	568	11	12	80	0.1500000
NODE_11613_length_812_cov_45.183731	488	568	13	3	80	0.0375000
NODE_11613_length_812_cov_45.183731	488	568	14	11	80	0.1375000
NODE_11613_length_812_cov_45.183731	488	568	15	16	80	0.2000000
NODE_11613_length_812_cov_45.183731	488	568	16	13	80	0.1625000
NODE_11613_length_812_cov_45.183731	488	568	17	2	80	0.0250000
NODE_11614_length_812_cov_23.862553	386	466	3	7	80	0.0875000
NODE_11614_length_812_cov_23.862553	386	466	4	7	80	0.0875000
NODE_11614_length_812_cov_23.862553	386	466	6	21	80	0.2625000
NODE_11614_length_812_cov_23.862553	386	466	7	16	80	0.2000000
NODE_11614_length_812_cov_23.862553	386	466	8	27	80	0.3375000
NODE_11614_length_812_cov_23.862553	386	466	9	2	80	0.0250000
NODE_11614_length_812_cov_23.862553	439	519	4	1	80	0.0125000
NODE_11614_length_812_cov_23.862553	439	519	5	7	80	0.0875000
NODE_11614_length_812_cov_23.862553	439	519	6	17	80	0.2125000
NODE_11614_length_812_cov_23.862553	439	519	7	37	80	0.4625000
NODE_11614_length_812_cov_23.862553	439	519	8	18	80	0.2250000
NODE_11615_length_812_cov_23.516129	295	375	1	4	80	0.0500000
NODE_11615_length_812_cov_23.516129	295	375	2	10	80	0.1250000
NODE_11615_length_812_cov_23.516129	295	375	3	21	80	0.2625000
NODE_11615_length_812_cov_23.516129	295	375	6	3	80	0.0375000
NODE_11615_length_812_cov_23.516129	295	375	8	19	80	0.2375000
NODE_11615_length_812_cov_23.516129	295	375	9	23	80	0.2875000
NODE_11615_length_812_cov_23.516129	348	428	8	13	80	0.1625000
NODE_11615_length_812_cov_23.516129	348	428	9	67	80	0.8375000
NODE_11616_length_812_cov_15.577840	509	589	1	19	80	0.2375000
NODE_11616_length_812_cov_15.577840	509	589	2	46	80	0.5750000
NODE_11616_length_812_cov_15.577840	509	589	3	7	80	0.0875000
NODE_11616_length_812_cov_15.577840	509	589	4	8	80	0.1000000
NODE_11616_length_812_cov_15.577840	562	644	1	74	82	0.9024390
NODE_11616_length_812_cov_15.577840	562	644	2	8	82	0.0975610
NODE_11617_length_812_cov_13.277700	257	331	0	74	74	1.0000000
NODE_11617_length_812_cov_13.277700	304	384	0	80	80	1.0000000
NODE_11619_length_812_cov_6.697055	309	389	2	37	80	0.4625000
NODE_11619_length_812_cov_6.697055	309	389	3	43	80	0.5375000
NODE_11619_length_812_cov_6.697055	362	442	1	18	80	0.2250000
NODE_11619_length_812_cov_6.697055	362	442	2	36	80	0.4500000
NODE_11619_length_812_cov_6.697055	362	442	3	26	80	0.3250000
NODE_11642_length_811_cov_65.762640	418	492	6	19	74	0.2567568
NODE_11642_length_811_cov_65.762640	418	492	7	29	74	0.3918919
NODE_11642_length_811_cov_65.762640	418	492	8	3	74	0.0405405
NODE_11642_length_811_cov_65.762640	418	492	9	23	74	0.3108108
NODE_11642_length_811_cov_65.762640	471	545	3	10	74	0.1351351
NODE_11642_length_811_cov_65.762640	471	545	4	4	74	0.0540541
NODE_11642_length_811_cov_65.762640	471	545	5	9	74	0.1216216
NODE_11642_length_811_cov_65.762640	471	545	6	1	74	0.0135135
NODE_11642_length_811_cov_65.762640	471	545	7	15	74	0.2027027
NODE_11642_length_811_cov_65.762640	471	545	8	17	74	0.2297297
NODE_11642_length_811_cov_65.762640	471	545	9	18	74	0.2432432
NODE_11643_length_811_cov_62.933989	457	537	0	20	80	0.2500000
NODE_11643_length_811_cov_62.933989	457	537	1	24	80	0.3000000
NODE_11643_length_811_cov_62.933989	457	537	2	35	80	0.4375000
NODE_11643_length_811_cov_62.933989	457	537	3	1	80	0.0125000
NODE_11643_length_811_cov_62.933989	510	590	1	20	80	0.2500000
NODE_11643_length_811_cov_62.933989	510	590	2	6	80	0.0750000
NODE_11643_length_811_cov_62.933989	510	590	3	7	80	0.0875000
NODE_11643_length_811_cov_62.933989	510	590	4	47	80	0.5875000
NODE_11644_length_811_cov_26.401685	397	477	5	11	80	0.1375000
NODE_11644_length_811_cov_26.401685	397	477	6	7	80	0.0875000
NODE_11644_length_811_cov_26.401685	397	477	7	14	80	0.1750000
NODE_11644_length_811_cov_26.401685	397	477	8	1	80	0.0125000
NODE_11644_length_811_cov_26.401685	397	477	10	6	80	0.0750000
NODE_11644_length_811_cov_26.401685	397	477	11	13	80	0.1625000
NODE_11644_length_811_cov_26.401685	397	477	12	1	80	0.0125000
NODE_11644_length_811_cov_26.401685	397	477	13	9	80	0.1125000
NODE_11644_length_811_cov_26.401685	397	477	14	18	80	0.2250000
NODE_11644_length_811_cov_26.401685	450	530	13	21	80	0.2625000
NODE_11644_length_811_cov_26.401685	450	530	14	27	80	0.3375000
NODE_11644_length_811_cov_26.401685	450	530	15	2	80	0.0250000
NODE_11644_length_811_cov_26.401685	450	530	16	30	80	0.3750000
NODE_11645_length_811_cov_23.009831	189	269	3	49	80	0.6125000
NODE_11645_length_811_cov_23.009831	189	269	5	31	80	0.3875000
NODE_11645_length_811_cov_23.009831	242	322	2	2	80	0.0250000
NODE_11645_length_811_cov_23.009831	242	322	4	28	80	0.3500000
NODE_11645_length_811_cov_23.009831	242	322	5	50	80	0.6250000
NODE_11646_length_811_cov_20.523876	375	455	3	80	80	1.0000000
NODE_11646_length_811_cov_20.523876	428	508	1	12	80	0.1500000
NODE_11646_length_811_cov_20.523876	428	508	2	2	80	0.0250000
NODE_11646_length_811_cov_20.523876	428	508	3	58	80	0.7250000
NODE_11646_length_811_cov_20.523876	428	508	4	8	80	0.1000000
NODE_11647_length_811_cov_17.386236	421	501	10	8	80	0.1000000
NODE_11647_length_811_cov_17.386236	421	501	11	5	80	0.0625000
NODE_11647_length_811_cov_17.386236	421	501	12	31	80	0.3875000
NODE_11647_length_811_cov_17.386236	421	501	13	36	80	0.4500000
NODE_11647_length_811_cov_17.386236	474	554	5	1	80	0.0125000
NODE_11647_length_811_cov_17.386236	474	554	6	6	80	0.0750000
NODE_11647_length_811_cov_17.386236	474	554	7	20	80	0.2500000
NODE_11647_length_811_cov_17.386236	474	554	8	17	80	0.2125000
NODE_11647_length_811_cov_17.386236	474	554	9	4	80	0.0500000
NODE_11647_length_811_cov_17.386236	474	554	12	25	80	0.3125000
NODE_11647_length_811_cov_17.386236	474	554	13	7	80	0.0875000
NODE_11648_length_811_cov_15.279494	368	448	4	11	80	0.1375000
NODE_11648_length_811_cov_15.279494	368	448	5	14	80	0.1750000
NODE_11648_length_811_cov_15.279494	368	448	7	22	80	0.2750000
NODE_11648_length_811_cov_15.279494	368	448	9	17	80	0.2125000
NODE_11648_length_811_cov_15.279494	368	448	10	16	80	0.2000000
NODE_11648_length_811_cov_15.279494	421	502	9	29	81	0.3580247
NODE_11648_length_811_cov_15.279494	421	502	10	40	81	0.4938272
NODE_11648_length_811_cov_15.279494	421	502	11	7	81	0.0864198
NODE_11648_length_811_cov_15.279494	421	502	12	5	81	0.0617284
NODE_11649_length_811_cov_14.543539	222	302	8	25	80	0.3125000
NODE_11649_length_811_cov_14.543539	222	302	9	35	80	0.4375000
NODE_11649_length_811_cov_14.543539	222	302	10	20	80	0.2500000
NODE_11649_length_811_cov_14.543539	275	355	1	2	80	0.0250000
NODE_11649_length_811_cov_14.543539	275	355	3	5	80	0.0625000
NODE_11649_length_811_cov_14.543539	275	355	5	25	80	0.3125000
NODE_11649_length_811_cov_14.543539	275	355	7	1	80	0.0125000
NODE_11649_length_811_cov_14.543539	275	355	9	31	80	0.3875000
NODE_11649_length_811_cov_14.543539	275	355	10	16	80	0.2000000
NODE_11650_length_811_cov_12.196629	402	482	1	3	80	0.0375000
NODE_11650_length_811_cov_12.196629	402	482	2	12	80	0.1500000
NODE_11650_length_811_cov_12.196629	402	482	3	65	80	0.8125000
NODE_11650_length_811_cov_12.196629	455	535	0	52	80	0.6500000
NODE_11650_length_811_cov_12.196629	455	535	1	4	80	0.0500000
NODE_11650_length_811_cov_12.196629	455	535	2	12	80	0.1500000
NODE_11650_length_811_cov_12.196629	455	535	3	12	80	0.1500000
NODE_11651_length_811_cov_12.117978	289	369	5	1	80	0.0125000
NODE_11651_length_811_cov_12.117978	289	369	6	11	80	0.1375000
NODE_11651_length_811_cov_12.117978	289	369	7	2	80	0.0250000
NODE_11651_length_811_cov_12.117978	289	369	8	9	80	0.1125000
NODE_11651_length_811_cov_12.117978	289	369	9	53	80	0.6625000
NODE_11651_length_811_cov_12.117978	289	369	10	4	80	0.0500000
NODE_11651_length_811_cov_12.117978	342	422	4	19	80	0.2375000
NODE_11651_length_811_cov_12.117978	342	422	5	5	80	0.0625000
NODE_11651_length_811_cov_12.117978	342	422	7	31	80	0.3875000
NODE_11651_length_811_cov_12.117978	342	422	8	9	80	0.1125000
NODE_11651_length_811_cov_12.117978	342	422	9	16	80	0.2000000
NODE_11652_length_811_cov_11.886236	330	410	1	1	80	0.0125000
NODE_11652_length_811_cov_11.886236	330	410	3	58	80	0.7250000
NODE_11652_length_811_cov_11.886236	330	410	4	21	80	0.2625000
NODE_11652_length_811_cov_11.886236	383	463	1	16	80	0.2000000
NODE_11652_length_811_cov_11.886236	383	463	3	43	80	0.5375000
NODE_11652_length_811_cov_11.886236	383	463	4	21	80	0.2625000
NODE_11653_length_811_cov_10.602528	342	422	9	8	80	0.1000000
NODE_11653_length_811_cov_10.602528	342	422	12	11	80	0.1375000
NODE_11653_length_811_cov_10.602528	342	422	13	61	80	0.7625000
NODE_11653_length_811_cov_10.602528	395	461	10	4	66	0.0606061
NODE_11653_length_811_cov_10.602528	395	461	12	14	66	0.2121212
NODE_11653_length_811_cov_10.602528	395	461	13	23	66	0.3484848
NODE_11653_length_811_cov_10.602528	395	461	14	25	66	0.3787879
NODE_11653_length_811_cov_10.602528	452	519	2	12	67	0.1791045
NODE_11653_length_811_cov_10.602528	452	519	3	7	67	0.1044776
NODE_11653_length_811_cov_10.602528	452	519	6	25	67	0.3731343
NODE_11653_length_811_cov_10.602528	452	519	10	18	67	0.2686567
NODE_11653_length_811_cov_10.602528	452	519	12	5	67	0.0746269
NODE_11653_length_811_cov_10.602528	492	572	2	35	80	0.4375000
NODE_11653_length_811_cov_10.602528	492	572	3	16	80	0.2000000
NODE_11653_length_811_cov_10.602528	492	572	5	21	80	0.2625000
NODE_11653_length_811_cov_10.602528	492	572	6	8	80	0.1000000
NODE_11654_length_811_cov_7.539326	324	404	0	80	80	1.0000000
NODE_11654_length_811_cov_7.539326	377	457	0	80	80	1.0000000
NODE_11655_length_811_cov_6.398876	419	499	0	79	80	0.9875000
NODE_11655_length_811_cov_6.398876	419	499	2	1	80	0.0125000
NODE_11655_length_811_cov_6.398876	472	552	0	26	80	0.3250000
NODE_11655_length_811_cov_6.398876	472	552	2	54	80	0.6750000
NODE_11657_length_811_cov_5.939607	496	527	0	31	31	1.0000000
NODE_11657_length_811_cov_5.939607	528	603	0	24	75	0.3200000
NODE_11657_length_811_cov_5.939607	528	603	1	51	75	0.6800000
NODE_11669_length_811_cov_1.501404	645	676	0	31	31	1.0000000
NODE_11684_length_810_cov_42.358650	484	564	2	4	80	0.0500000
NODE_11684_length_810_cov_42.358650	484	564	3	76	80	0.9500000
NODE_11684_length_810_cov_42.358650	537	617	0	12	80	0.1500000
NODE_11684_length_810_cov_42.358650	537	617	1	4	80	0.0500000
NODE_11684_length_810_cov_42.358650	537	617	2	41	80	0.5125000
NODE_11684_length_810_cov_42.358650	537	617	3	23	80	0.2875000
NODE_11685_length_810_cov_38.604782	370	450	6	31	80	0.3875000
NODE_11685_length_810_cov_38.604782	370	450	8	19	80	0.2375000
NODE_11685_length_810_cov_38.604782	370	450	10	17	80	0.2125000
NODE_11685_length_810_cov_38.604782	370	450	12	13	80	0.1625000
NODE_11685_length_810_cov_38.604782	423	499	9	9	76	0.1184211
NODE_11685_length_810_cov_38.604782	423	499	10	21	76	0.2763158
NODE_11685_length_810_cov_38.604782	423	499	11	9	76	0.1184211
NODE_11685_length_810_cov_38.604782	423	499	12	21	76	0.2763158
NODE_11685_length_810_cov_38.604782	423	499	13	16	76	0.2105263
NODE_11686_length_810_cov_20.354430	338	418	3	27	80	0.3375000
NODE_11686_length_810_cov_20.354430	338	418	4	53	80	0.6625000
NODE_11686_length_810_cov_20.354430	391	471	1	22	80	0.2750000
NODE_11686_length_810_cov_20.354430	391	471	2	6	80	0.0750000
NODE_11686_length_810_cov_20.354430	391	471	3	52	80	0.6500000
NODE_11688_length_810_cov_12.367089	144	224	6	5	80	0.0625000
NODE_11688_length_810_cov_12.367089	144	224	7	11	80	0.1375000
NODE_11688_length_810_cov_12.367089	144	224	8	10	80	0.1250000
NODE_11688_length_810_cov_12.367089	144	224	9	5	80	0.0625000
NODE_11688_length_810_cov_12.367089	144	224	10	19	80	0.2375000
NODE_11688_length_810_cov_12.367089	144	224	11	17	80	0.2125000
NODE_11688_length_810_cov_12.367089	144	224	12	9	80	0.1125000
NODE_11688_length_810_cov_12.367089	144	224	13	4	80	0.0500000
NODE_11688_length_810_cov_12.367089	197	277	9	9	80	0.1125000
NODE_11688_length_810_cov_12.367089	197	277	10	62	80	0.7750000
NODE_11688_length_810_cov_12.367089	197	277	12	9	80	0.1125000
NODE_11689_length_810_cov_8.886076	333	399	0	3	66	0.0454545
NODE_11689_length_810_cov_8.886076	333	399	2	63	66	0.9545454
NODE_11690_length_810_cov_8.291139	446	526	0	11	80	0.1375000
NODE_11690_length_810_cov_8.291139	446	526	1	12	80	0.1500000
NODE_11690_length_810_cov_8.291139	446	526	2	5	80	0.0625000
NODE_11690_length_810_cov_8.291139	446	526	3	12	80	0.1500000
NODE_11690_length_810_cov_8.291139	446	526	4	40	80	0.5000000
NODE_11690_length_810_cov_8.291139	499	579	4	40	80	0.5000000
NODE_11690_length_810_cov_8.291139	499	579	5	2	80	0.0250000
NODE_11690_length_810_cov_8.291139	499	579	6	38	80	0.4750000
NODE_11692_length_810_cov_7.213783	335	406	2	71	71	1.0000000
NODE_11692_length_810_cov_7.213783	335	416	2	81	81	1.0000000
NODE_11692_length_810_cov_7.213783	379	459	1	4	80	0.0500000
NODE_11692_length_810_cov_7.213783	379	459	2	76	80	0.9500000
NODE_11714_length_809_cov_40.536620	428	500	0	68	72	0.9444444
NODE_11714_length_809_cov_40.536620	428	500	1	4	72	0.0555556
NODE_11714_length_809_cov_40.536620	473	553	0	23	80	0.2875000
NODE_11714_length_809_cov_40.536620	473	553	1	33	80	0.4125000
NODE_11714_length_809_cov_40.536620	473	553	2	24	80	0.3000000
NODE_11715_length_809_cov_15.871831	385	465	5	3	80	0.0375000
NODE_11715_length_809_cov_15.871831	385	465	6	4	80	0.0500000
NODE_11715_length_809_cov_15.871831	385	465	7	5	80	0.0625000
NODE_11715_length_809_cov_15.871831	385	465	8	2	80	0.0250000
NODE_11715_length_809_cov_15.871831	385	465	9	24	80	0.3000000
NODE_11715_length_809_cov_15.871831	385	465	10	17	80	0.2125000
NODE_11715_length_809_cov_15.871831	385	465	11	25	80	0.3125000
NODE_11715_length_809_cov_15.871831	402	465	9	21	63	0.3333333
NODE_11715_length_809_cov_15.871831	402	465	10	17	63	0.2698413
NODE_11715_length_809_cov_15.871831	402	465	11	25	63	0.3968254
NODE_11715_length_809_cov_15.871831	438	518	7	2	80	0.0250000
NODE_11715_length_809_cov_15.871831	438	518	8	35	80	0.4375000
NODE_11715_length_809_cov_15.871831	438	518	9	6	80	0.0750000
NODE_11715_length_809_cov_15.871831	438	518	10	12	80	0.1500000
NODE_11715_length_809_cov_15.871831	438	518	11	25	80	0.3125000
NODE_11715_length_809_cov_15.871831	438	518	7	2	80	0.0250000
NODE_11715_length_809_cov_15.871831	438	518	8	35	80	0.4375000
NODE_11715_length_809_cov_15.871831	438	518	9	6	80	0.0750000
NODE_11715_length_809_cov_15.871831	438	518	10	12	80	0.1500000
NODE_11715_length_809_cov_15.871831	438	518	11	25	80	0.3125000
NODE_11716_length_809_cov_15.019718	286	366	1	5	80	0.0625000
NODE_11716_length_809_cov_15.019718	286	366	2	37	80	0.4625000
NODE_11716_length_809_cov_15.019718	286	366	3	29	80	0.3625000
NODE_11716_length_809_cov_15.019718	286	366	5	9	80	0.1125000
NODE_11716_length_809_cov_15.019718	339	419	3	18	80	0.2250000
NODE_11716_length_809_cov_15.019718	339	419	5	61	80	0.7625000
NODE_11716_length_809_cov_15.019718	339	419	6	1	80	0.0125000
NODE_11718_length_809_cov_4.483099	244	324	0	80	80	1.0000000
NODE_11718_length_809_cov_4.483099	278	324	0	46	46	1.0000000
NODE_11718_length_809_cov_4.483099	298	377	0	79	79	1.0000000
NODE_11718_length_809_cov_4.483099	308	377	0	69	69	1.0000000
NODE_11738_length_808_cov_45.023977	325	405	3	13	80	0.1625000
NODE_11738_length_808_cov_45.023977	325	405	4	9	80	0.1125000
NODE_11738_length_808_cov_45.023977	325	405	6	11	80	0.1375000
NODE_11738_length_808_cov_45.023977	325	405	7	29	80	0.3625000
NODE_11738_length_808_cov_45.023977	325	405	8	11	80	0.1375000
NODE_11738_length_808_cov_45.023977	325	405	9	7	80	0.0875000
NODE_11738_length_808_cov_45.023977	378	458	6	25	80	0.3125000
NODE_11738_length_808_cov_45.023977	378	458	7	53	80	0.6625000
NODE_11738_length_808_cov_45.023977	378	458	8	2	80	0.0250000
NODE_11739_length_808_cov_24.087447	287	367	0	80	80	1.0000000
NODE_11739_length_808_cov_24.087447	340	420	0	80	80	1.0000000
NODE_11740_length_808_cov_21.867419	324	404	0	15	80	0.1875000
NODE_11740_length_808_cov_21.867419	324	404	1	29	80	0.3625000
NODE_11740_length_808_cov_21.867419	324	404	2	16	80	0.2000000
NODE_11740_length_808_cov_21.867419	324	404	4	20	80	0.2500000
NODE_11740_length_808_cov_21.867419	377	457	2	7	80	0.0875000
NODE_11740_length_808_cov_21.867419	377	457	4	36	80	0.4500000
NODE_11740_length_808_cov_21.867419	377	457	6	37	80	0.4625000
NODE_11741_length_808_cov_16.289140	333	413	4	3	80	0.0375000
NODE_11741_length_808_cov_16.289140	333	413	5	3	80	0.0375000
NODE_11741_length_808_cov_16.289140	333	413	6	31	80	0.3875000
NODE_11741_length_808_cov_16.289140	333	413	7	43	80	0.5375000
NODE_11741_length_808_cov_16.289140	386	466	1	17	80	0.2125000
NODE_11741_length_808_cov_16.289140	386	466	2	29	80	0.3625000
NODE_11741_length_808_cov_16.289140	386	466	4	10	80	0.1250000
NODE_11741_length_808_cov_16.289140	386	466	5	3	80	0.0375000
NODE_11741_length_808_cov_16.289140	386	466	6	21	80	0.2625000
NODE_11742_length_808_cov_14.489422	307	387	1	12	80	0.1500000
NODE_11742_length_808_cov_14.489422	307	387	2	31	80	0.3875000
NODE_11742_length_808_cov_14.489422	307	387	3	37	80	0.4625000
NODE_11742_length_808_cov_14.489422	360	440	3	80	80	1.0000000
NODE_11744_length_808_cov_10.507757	317	397	0	67	80	0.8375000
NODE_11744_length_808_cov_10.507757	317	397	2	13	80	0.1625000
NODE_11744_length_808_cov_10.507757	370	450	0	14	80	0.1750000
NODE_11744_length_808_cov_10.507757	370	450	2	66	80	0.8250000
NODE_11745_length_808_cov_10.066291	483	563	2	80	80	1.0000000
NODE_11745_length_808_cov_10.066291	536	616	1	51	80	0.6375000
NODE_11745_length_808_cov_10.066291	536	616	2	29	80	0.3625000
NODE_11746_length_808_cov_7.581100	358	438	0	80	80	1.0000000
NODE_11746_length_808_cov_7.581100	411	491	0	80	80	1.0000000
NODE_11756_length_808_cov_3.283498	471	551	0	80	80	1.0000000
NODE_11756_length_808_cov_3.283498	524	604	0	80	80	1.0000000
NODE_11783_length_807_cov_67.341808	2	25	5	3	23	0.1304348
NODE_11783_length_807_cov_67.341808	2	25	8	4	23	0.1739130
NODE_11783_length_807_cov_67.341808	2	25	10	2	23	0.0869565
NODE_11783_length_807_cov_67.341808	2	25	13	1	23	0.0434783
NODE_11783_length_807_cov_67.341808	2	25	14	4	23	0.1739130
NODE_11783_length_807_cov_67.341808	2	25	15	3	23	0.1304348
NODE_11783_length_807_cov_67.341808	2	25	16	2	23	0.0869565
NODE_11783_length_807_cov_67.341808	2	25	19	1	23	0.0434783
NODE_11783_length_807_cov_67.341808	2	25	22	1	23	0.0434783
NODE_11783_length_807_cov_67.341808	2	25	23	2	23	0.0869565
NODE_11783_length_807_cov_67.341808	339	370	40	1	31	0.0322581
NODE_11783_length_807_cov_67.341808	339	370	41	5	31	0.1612903
NODE_11783_length_807_cov_67.341808	339	370	42	3	31	0.0967742
NODE_11783_length_807_cov_67.341808	339	370	44	1	31	0.0322581
NODE_11783_length_807_cov_67.341808	339	370	46	3	31	0.0967742
NODE_11783_length_807_cov_67.341808	339	370	47	3	31	0.0967742
NODE_11783_length_807_cov_67.341808	339	370	50	1	31	0.0322581
NODE_11783_length_807_cov_67.341808	339	370	52	2	31	0.0645161
NODE_11783_length_807_cov_67.341808	339	370	53	1	31	0.0322581
NODE_11783_length_807_cov_67.341808	339	370	55	1	31	0.0322581
NODE_11783_length_807_cov_67.341808	339	370	56	5	31	0.1612903
NODE_11783_length_807_cov_67.341808	339	370	58	3	31	0.0967742
NODE_11783_length_807_cov_67.341808	339	370	59	2	31	0.0645161
NODE_11783_length_807_cov_67.341808	343	423	40	1	80	0.0125000
NODE_11783_length_807_cov_67.341808	343	423	41	1	80	0.0125000
NODE_11783_length_807_cov_67.341808	343	423	42	3	80	0.0375000
NODE_11783_length_807_cov_67.341808	343	423	44	1	80	0.0125000
NODE_11783_length_807_cov_67.341808	343	423	46	3	80	0.0375000
NODE_11783_length_807_cov_67.341808	343	423	47	3	80	0.0375000
NODE_11783_length_807_cov_67.341808	343	423	50	1	80	0.0125000
NODE_11783_length_807_cov_67.341808	343	423	52	2	80	0.0250000
NODE_11783_length_807_cov_67.341808	343	423	53	1	80	0.0125000
NODE_11783_length_807_cov_67.341808	343	423	55	5	80	0.0625000
NODE_11783_length_807_cov_67.341808	343	423	56	6	80	0.0750000
NODE_11783_length_807_cov_67.341808	343	423	57	2	80	0.0250000
NODE_11783_length_807_cov_67.341808	343	423	58	5	80	0.0625000
NODE_11783_length_807_cov_67.341808	343	423	59	9	80	0.1125000
NODE_11783_length_807_cov_67.341808	343	423	60	1	80	0.0125000
NODE_11783_length_807_cov_67.341808	343	423	62	1	80	0.0125000
NODE_11783_length_807_cov_67.341808	343	423	64	4	80	0.0500000
NODE_11783_length_807_cov_67.341808	343	423	67	1	80	0.0125000
NODE_11783_length_807_cov_67.341808	343	423	69	7	80	0.0875000
NODE_11783_length_807_cov_67.341808	343	423	70	7	80	0.0875000
NODE_11783_length_807_cov_67.341808	343	423	71	3	80	0.0375000
NODE_11783_length_807_cov_67.341808	343	423	73	2	80	0.0250000
NODE_11783_length_807_cov_67.341808	343	423	74	4	80	0.0500000
NODE_11783_length_807_cov_67.341808	343	423	75	3	80	0.0375000
NODE_11783_length_807_cov_67.341808	343	423	76	1	80	0.0125000
NODE_11783_length_807_cov_67.341808	343	423	77	3	80	0.0375000
NODE_11784_length_807_cov_54.980226	683	749	31	5	66	0.0757576
NODE_11784_length_807_cov_54.980226	683	749	32	17	66	0.2575758
NODE_11784_length_807_cov_54.980226	683	749	33	1	66	0.0151515
NODE_11784_length_807_cov_54.980226	683	749	34	3	66	0.0454545
NODE_11784_length_807_cov_54.980226	683	749	36	7	66	0.1060606
NODE_11784_length_807_cov_54.980226	683	749	37	14	66	0.2121212
NODE_11784_length_807_cov_54.980226	683	749	38	4	66	0.0606061
NODE_11784_length_807_cov_54.980226	683	749	39	11	66	0.1666667
NODE_11784_length_807_cov_54.980226	683	749	40	3	66	0.0454545
NODE_11784_length_807_cov_54.980226	683	749	41	1	66	0.0151515
NODE_11784_length_807_cov_54.980226	727	802	10	1	75	0.0133333
NODE_11784_length_807_cov_54.980226	727	802	12	2	75	0.0266667
NODE_11784_length_807_cov_54.980226	727	802	13	1	75	0.0133333
NODE_11784_length_807_cov_54.980226	727	802	14	2	75	0.0266667
NODE_11784_length_807_cov_54.980226	727	802	17	1	75	0.0133333
NODE_11784_length_807_cov_54.980226	727	802	18	4	75	0.0533333
NODE_11784_length_807_cov_54.980226	727	802	20	4	75	0.0533333
NODE_11784_length_807_cov_54.980226	727	802	22	8	75	0.1066667
NODE_11784_length_807_cov_54.980226	727	802	24	11	75	0.1466667
NODE_11784_length_807_cov_54.980226	727	802	25	2	75	0.0266667
NODE_11784_length_807_cov_54.980226	727	802	26	8	75	0.1066667
NODE_11784_length_807_cov_54.980226	727	802	27	5	75	0.0666667
NODE_11784_length_807_cov_54.980226	727	802	28	1	75	0.0133333
NODE_11784_length_807_cov_54.980226	727	802	29	1	75	0.0133333
NODE_11784_length_807_cov_54.980226	727	802	30	2	75	0.0266667
NODE_11784_length_807_cov_54.980226	727	802	31	5	75	0.0666667
NODE_11784_length_807_cov_54.980226	727	802	32	17	75	0.2266667
NODE_11785_length_807_cov_37.306497	435	515	7	9	80	0.1125000
NODE_11785_length_807_cov_37.306497	435	515	8	15	80	0.1875000
NODE_11785_length_807_cov_37.306497	435	515	9	5	80	0.0625000
NODE_11785_length_807_cov_37.306497	435	515	10	16	80	0.2000000
NODE_11785_length_807_cov_37.306497	435	515	11	1	80	0.0125000
NODE_11785_length_807_cov_37.306497	435	515	12	34	80	0.4250000
NODE_11785_length_807_cov_37.306497	488	568	5	7	80	0.0875000
NODE_11785_length_807_cov_37.306497	488	568	6	43	80	0.5375000
NODE_11785_length_807_cov_37.306497	488	568	8	3	80	0.0375000
NODE_11785_length_807_cov_37.306497	488	568	10	4	80	0.0500000
NODE_11785_length_807_cov_37.306497	488	568	12	23	80	0.2875000
NODE_11786_length_807_cov_31.177966	287	367	3	16	80	0.2000000
NODE_11786_length_807_cov_31.177966	287	367	4	41	80	0.5125000
NODE_11786_length_807_cov_31.177966	287	367	5	23	80	0.2875000
NODE_11786_length_807_cov_31.177966	340	420	3	19	80	0.2375000
NODE_11786_length_807_cov_31.177966	340	420	4	26	80	0.3250000
NODE_11786_length_807_cov_31.177966	340	420	5	35	80	0.4375000
NODE_11787_length_807_cov_30.638418	250	329	1	30	79	0.3797468
NODE_11787_length_807_cov_30.638418	250	329	2	49	79	0.6202531
NODE_11787_length_807_cov_30.638418	302	382	1	17	80	0.2125000
NODE_11787_length_807_cov_30.638418	302	382	2	63	80	0.7875000
NODE_11787_length_807_cov_30.638418	378	458	0	4	80	0.0500000
NODE_11787_length_807_cov_30.638418	378	458	1	76	80	0.9500000
NODE_11787_length_807_cov_30.638418	431	511	0	4	80	0.0500000
NODE_11787_length_807_cov_30.638418	431	511	1	76	80	0.9500000
NODE_11788_length_807_cov_29.725989	362	442	2	2	80	0.0250000
NODE_11788_length_807_cov_29.725989	362	442	3	23	80	0.2875000
NODE_11788_length_807_cov_29.725989	362	442	4	7	80	0.0875000
NODE_11788_length_807_cov_29.725989	362	442	5	13	80	0.1625000
NODE_11788_length_807_cov_29.725989	362	442	6	16	80	0.2000000
NODE_11788_length_807_cov_29.725989	362	442	7	19	80	0.2375000
NODE_11788_length_807_cov_29.725989	415	495	5	61	80	0.7625000
NODE_11788_length_807_cov_29.725989	415	495	6	3	80	0.0375000
NODE_11788_length_807_cov_29.725989	415	495	7	16	80	0.2000000
NODE_11789_length_807_cov_23.200565	441	521	3	3	80	0.0375000
NODE_11789_length_807_cov_23.200565	441	521	5	14	80	0.1750000
NODE_11789_length_807_cov_23.200565	441	521	6	30	80	0.3750000
NODE_11789_length_807_cov_23.200565	441	521	8	33	80	0.4125000
NODE_11789_length_807_cov_23.200565	494	574	5	14	80	0.1750000
NODE_11789_length_807_cov_23.200565	494	574	7	27	80	0.3375000
NODE_11789_length_807_cov_23.200565	494	574	8	39	80	0.4875000
NODE_11790_length_807_cov_21.888418	319	386	0	41	67	0.6119403
NODE_11790_length_807_cov_21.888418	319	386	1	26	67	0.3880597
NODE_11790_length_807_cov_21.888418	390	440	0	50	50	1.0000000
NODE_11791_length_807_cov_17.480226	339	419	3	4	80	0.0500000
NODE_11791_length_807_cov_17.480226	339	419	4	6	80	0.0750000
NODE_11791_length_807_cov_17.480226	339	419	5	16	80	0.2000000
NODE_11791_length_807_cov_17.480226	339	419	7	27	80	0.3375000
NODE_11791_length_807_cov_17.480226	339	419	8	12	80	0.1500000
NODE_11791_length_807_cov_17.480226	339	419	9	15	80	0.1875000
NODE_11791_length_807_cov_17.480226	392	472	0	16	80	0.2000000
NODE_11791_length_807_cov_17.480226	392	472	1	24	80	0.3000000
NODE_11791_length_807_cov_17.480226	392	472	2	9	80	0.1125000
NODE_11791_length_807_cov_17.480226	392	472	3	8	80	0.1000000
NODE_11791_length_807_cov_17.480226	392	472	4	6	80	0.0750000
NODE_11791_length_807_cov_17.480226	392	472	5	16	80	0.2000000
NODE_11791_length_807_cov_17.480226	392	472	7	1	80	0.0125000
NODE_11792_length_807_cov_14.895480	350	430	2	80	80	1.0000000
NODE_11792_length_807_cov_14.895480	403	483	2	80	80	1.0000000
NODE_11794_length_807_cov_12.255650	440	520	3	4	80	0.0500000
NODE_11794_length_807_cov_12.255650	440	520	4	45	80	0.5625000
NODE_11794_length_807_cov_12.255650	440	520	5	31	80	0.3875000
NODE_11794_length_807_cov_12.255650	493	573	1	20	80	0.2500000
NODE_11794_length_807_cov_12.255650	493	573	2	21	80	0.2625000
NODE_11794_length_807_cov_12.255650	493	573	3	8	80	0.1000000
NODE_11794_length_807_cov_12.255650	493	573	4	31	80	0.3875000
NODE_11795_length_807_cov_11.129944	359	439	0	80	80	1.0000000
NODE_11795_length_807_cov_11.129944	412	492	0	80	80	1.0000000
NODE_11801_length_807_cov_3.847458	322	385	2	41	63	0.6507937
NODE_11801_length_807_cov_3.847458	322	385	3	1	63	0.0158730
NODE_11801_length_807_cov_3.847458	322	385	4	21	63	0.3333333
NODE_11822_length_806_cov_35.650636	397	477	5	2	80	0.0250000
NODE_11822_length_806_cov_35.650636	397	477	6	62	80	0.7750000
NODE_11822_length_806_cov_35.650636	397	477	7	16	80	0.2000000
NODE_11822_length_806_cov_35.650636	450	530	3	12	80	0.1500000
NODE_11822_length_806_cov_35.650636	450	530	4	16	80	0.2000000
NODE_11822_length_806_cov_35.650636	450	530	5	3	80	0.0375000
NODE_11822_length_806_cov_35.650636	450	530	6	40	80	0.5000000
NODE_11822_length_806_cov_35.650636	450	530	7	9	80	0.1125000
NODE_11822_length_806_cov_35.650636	526	606	3	5	80	0.0625000
NODE_11822_length_806_cov_35.650636	526	606	4	1	80	0.0125000
NODE_11822_length_806_cov_35.650636	526	606	5	16	80	0.2000000
NODE_11822_length_806_cov_35.650636	526	606	6	4	80	0.0500000
NODE_11822_length_806_cov_35.650636	526	606	7	54	80	0.6750000
NODE_11822_length_806_cov_35.650636	579	667	5	23	88	0.2613636
NODE_11822_length_806_cov_35.650636	579	667	6	29	88	0.3295455
NODE_11822_length_806_cov_35.650636	579	667	7	36	88	0.4090909
NODE_11823_length_806_cov_29.615276	377	457	2	6	80	0.0750000
NODE_11823_length_806_cov_29.615276	377	457	3	23	80	0.2875000
NODE_11823_length_806_cov_29.615276	377	457	4	51	80	0.6375000
NODE_11823_length_806_cov_29.615276	430	510	2	59	80	0.7375000
NODE_11823_length_806_cov_29.615276	430	510	3	1	80	0.0125000
NODE_11823_length_806_cov_29.615276	430	510	4	20	80	0.2500000
NODE_11824_length_806_cov_23.680339	394	474	2	33	80	0.4125000
NODE_11824_length_806_cov_23.680339	394	474	4	27	80	0.3375000
NODE_11824_length_806_cov_23.680339	394	474	5	5	80	0.0625000
NODE_11824_length_806_cov_23.680339	394	474	6	7	80	0.0875000
NODE_11824_length_806_cov_23.680339	394	474	7	8	80	0.1000000
NODE_11824_length_806_cov_23.680339	447	527	4	7	80	0.0875000
NODE_11824_length_806_cov_23.680339	447	527	5	11	80	0.1375000
NODE_11824_length_806_cov_23.680339	447	527	6	54	80	0.6750000
NODE_11824_length_806_cov_23.680339	447	527	7	8	80	0.1000000
NODE_11825_length_806_cov_19.107496	239	293	0	54	54	1.0000000
NODE_11825_length_806_cov_19.107496	248	293	0	45	45	1.0000000
NODE_11825_length_806_cov_19.107496	266	345	0	43	79	0.5443038
NODE_11825_length_806_cov_19.107496	266	345	1	14	79	0.1772152
NODE_11825_length_806_cov_19.107496	266	345	2	6	79	0.0759494
NODE_11825_length_806_cov_19.107496	266	345	4	16	79	0.2025317
NODE_11825_length_806_cov_19.107496	266	345	0	43	79	0.5443038
NODE_11825_length_806_cov_19.107496	266	345	1	14	79	0.1772152
NODE_11825_length_806_cov_19.107496	266	345	2	6	79	0.0759494
NODE_11825_length_806_cov_19.107496	266	345	4	16	79	0.2025317
NODE_11825_length_806_cov_19.107496	421	501	6	23	80	0.2875000
NODE_11825_length_806_cov_19.107496	421	501	8	9	80	0.1125000
NODE_11825_length_806_cov_19.107496	421	501	9	25	80	0.3125000
NODE_11825_length_806_cov_19.107496	421	501	10	23	80	0.2875000
NODE_11826_length_806_cov_17.551627	308	388	1	2	80	0.0250000
NODE_11826_length_806_cov_17.551627	308	388	2	6	80	0.0750000
NODE_11826_length_806_cov_17.551627	308	388	3	19	80	0.2375000
NODE_11826_length_806_cov_17.551627	308	388	4	53	80	0.6625000
NODE_11826_length_806_cov_17.551627	361	441	2	20	80	0.2500000
NODE_11826_length_806_cov_17.551627	361	441	3	51	80	0.6375000
NODE_11826_length_806_cov_17.551627	361	441	4	9	80	0.1125000
NODE_11827_length_806_cov_15.608204	408	488	2	18	80	0.2250000
NODE_11827_length_806_cov_15.608204	408	488	3	16	80	0.2000000
NODE_11827_length_806_cov_15.608204	408	488	4	13	80	0.1625000
NODE_11827_length_806_cov_15.608204	408	488	5	1	80	0.0125000
NODE_11827_length_806_cov_15.608204	408	488	6	3	80	0.0375000
NODE_11827_length_806_cov_15.608204	408	488	7	29	80	0.3625000
NODE_11827_length_806_cov_15.608204	461	543	6	25	82	0.3048781
NODE_11827_length_806_cov_15.608204	461	543	7	33	82	0.4024390
NODE_11827_length_806_cov_15.608204	461	543	8	24	82	0.2926829
NODE_11864_length_805_cov_94.121813	398	478	15	2	80	0.0250000
NODE_11864_length_805_cov_94.121813	398	478	16	2	80	0.0250000
NODE_11864_length_805_cov_94.121813	398	478	17	2	80	0.0250000
NODE_11864_length_805_cov_94.121813	398	478	18	2	80	0.0250000
NODE_11864_length_805_cov_94.121813	398	478	19	7	80	0.0875000
NODE_11864_length_805_cov_94.121813	398	478	20	5	80	0.0625000
NODE_11864_length_805_cov_94.121813	398	478	21	4	80	0.0500000
NODE_11864_length_805_cov_94.121813	398	478	22	2	80	0.0250000
NODE_11864_length_805_cov_94.121813	398	478	23	20	80	0.2500000
NODE_11864_length_805_cov_94.121813	398	478	24	11	80	0.1375000
NODE_11864_length_805_cov_94.121813	398	478	25	2	80	0.0250000
NODE_11864_length_805_cov_94.121813	398	478	26	2	80	0.0250000
NODE_11864_length_805_cov_94.121813	398	478	28	15	80	0.1875000
NODE_11864_length_805_cov_94.121813	398	478	29	2	80	0.0250000
NODE_11864_length_805_cov_94.121813	398	478	30	2	80	0.0250000
NODE_11864_length_805_cov_94.121813	451	531	23	3	80	0.0375000
NODE_11864_length_805_cov_94.121813	451	531	24	1	80	0.0125000
NODE_11864_length_805_cov_94.121813	451	531	25	2	80	0.0250000
NODE_11864_length_805_cov_94.121813	451	531	26	8	80	0.1000000
NODE_11864_length_805_cov_94.121813	451	531	27	8	80	0.1000000
NODE_11864_length_805_cov_94.121813	451	531	28	25	80	0.3125000
NODE_11864_length_805_cov_94.121813	451	531	29	18	80	0.2250000
NODE_11864_length_805_cov_94.121813	451	531	30	15	80	0.1875000
NODE_11865_length_805_cov_54.001416	284	364	1	37	80	0.4625000
NODE_11865_length_805_cov_54.001416	284	364	2	25	80	0.3125000
NODE_11865_length_805_cov_54.001416	284	364	3	18	80	0.2250000
NODE_11865_length_805_cov_54.001416	337	417	2	27	80	0.3375000
NODE_11865_length_805_cov_54.001416	337	417	3	29	80	0.3625000
NODE_11865_length_805_cov_54.001416	337	417	4	24	80	0.3000000
NODE_11865_length_805_cov_54.001416	413	493	2	13	80	0.1625000
NODE_11865_length_805_cov_54.001416	413	493	3	9	80	0.1125000
NODE_11865_length_805_cov_54.001416	413	493	4	58	80	0.7250000
NODE_11865_length_805_cov_54.001416	466	546	0	3	80	0.0375000
NODE_11865_length_805_cov_54.001416	466	546	1	18	80	0.2250000
NODE_11865_length_805_cov_54.001416	466	546	2	45	80	0.5625000
NODE_11865_length_805_cov_54.001416	466	546	3	9	80	0.1125000
NODE_11865_length_805_cov_54.001416	466	546	4	5	80	0.0625000
NODE_11866_length_805_cov_42.325779	377	457	0	67	80	0.8375000
NODE_11866_length_805_cov_42.325779	377	457	1	13	80	0.1625000
NODE_11866_length_805_cov_42.325779	430	510	0	14	80	0.1750000
NODE_11866_length_805_cov_42.325779	430	510	1	17	80	0.2125000
NODE_11866_length_805_cov_42.325779	430	510	2	7	80	0.0875000
NODE_11866_length_805_cov_42.325779	430	510	4	42	80	0.5250000
NODE_11867_length_805_cov_36.742210	345	425	7	21	80	0.2625000
NODE_11867_length_805_cov_36.742210	345	425	8	21	80	0.2625000
NODE_11867_length_805_cov_36.742210	345	425	9	16	80	0.2000000
NODE_11867_length_805_cov_36.742210	345	425	10	22	80	0.2750000
NODE_11867_length_805_cov_36.742210	398	478	3	1	80	0.0125000
NODE_11867_length_805_cov_36.742210	398	478	4	15	80	0.1875000
NODE_11867_length_805_cov_36.742210	398	478	6	2	80	0.0250000
NODE_11867_length_805_cov_36.742210	398	478	7	21	80	0.2625000
NODE_11867_length_805_cov_36.742210	398	478	8	41	80	0.5125000
NODE_11868_length_805_cov_25.879603	361	441	9	13	80	0.1625000
NODE_11868_length_805_cov_25.879603	361	441	10	37	80	0.4625000
NODE_11868_length_805_cov_25.879603	361	441	11	13	80	0.1625000
NODE_11868_length_805_cov_25.879603	361	441	12	1	80	0.0125000
NODE_11868_length_805_cov_25.879603	361	441	13	15	80	0.1875000
NODE_11868_length_805_cov_25.879603	361	441	14	1	80	0.0125000
NODE_11868_length_805_cov_25.879603	414	494	5	16	80	0.2000000
NODE_11868_length_805_cov_25.879603	414	494	8	29	80	0.3625000
NODE_11868_length_805_cov_25.879603	414	494	9	21	80	0.2625000
NODE_11868_length_805_cov_25.879603	414	494	10	5	80	0.0625000
NODE_11868_length_805_cov_25.879603	414	494	11	9	80	0.1125000
NODE_11869_length_805_cov_25.048159	306	386	3	19	80	0.2375000
NODE_11869_length_805_cov_25.048159	306	386	4	29	80	0.3625000
NODE_11869_length_805_cov_25.048159	306	386	5	11	80	0.1375000
NODE_11869_length_805_cov_25.048159	306	386	7	21	80	0.2625000
NODE_11869_length_805_cov_25.048159	359	439	5	16	80	0.2000000
NODE_11869_length_805_cov_25.048159	359	439	6	2	80	0.0250000
NODE_11869_length_805_cov_25.048159	359	439	7	38	80	0.4750000
NODE_11869_length_805_cov_25.048159	359	439	8	24	80	0.3000000
NODE_11870_length_805_cov_15.453258	311	391	0	80	80	1.0000000
NODE_11870_length_805_cov_15.453258	364	444	0	80	80	1.0000000
NODE_11871_length_805_cov_14.930595	264	344	3	51	80	0.6375000
NODE_11871_length_805_cov_14.930595	264	344	4	29	80	0.3625000
NODE_11871_length_805_cov_14.930595	317	397	1	3	80	0.0375000
NODE_11871_length_805_cov_14.930595	317	397	2	22	80	0.2750000
NODE_11871_length_805_cov_14.930595	317	397	3	55	80	0.6875000
NODE_11872_length_805_cov_10.888102	259	339	2	19	80	0.2375000
NODE_11872_length_805_cov_10.888102	259	339	3	1	80	0.0125000
NODE_11872_length_805_cov_10.888102	259	339	4	60	80	0.7500000
NODE_11872_length_805_cov_10.888102	312	392	0	48	80	0.6000000
NODE_11872_length_805_cov_10.888102	312	392	2	24	80	0.3000000
NODE_11872_length_805_cov_10.888102	312	392	3	1	80	0.0125000
NODE_11872_length_805_cov_10.888102	312	392	4	7	80	0.0875000
NODE_11873_length_805_cov_10.716714	348	428	1	67	80	0.8375000
NODE_11873_length_805_cov_10.716714	348	428	3	3	80	0.0375000
NODE_11873_length_805_cov_10.716714	348	428	4	10	80	0.1250000
NODE_11873_length_805_cov_10.716714	401	481	1	14	80	0.1750000
NODE_11873_length_805_cov_10.716714	401	481	3	30	80	0.3750000
NODE_11873_length_805_cov_10.716714	401	481	4	36	80	0.4500000
NODE_11876_length_805_cov_7.212465	374	454	4	6	80	0.0750000
NODE_11876_length_805_cov_7.212465	374	454	5	11	80	0.1375000
NODE_11876_length_805_cov_7.212465	374	454	6	43	80	0.5375000
NODE_11876_length_805_cov_7.212465	374	454	7	20	80	0.2500000
NODE_11876_length_805_cov_7.212465	427	507	4	59	80	0.7375000
NODE_11876_length_805_cov_7.212465	427	507	5	10	80	0.1250000
NODE_11876_length_805_cov_7.212465	427	507	6	11	80	0.1375000
NODE_11877_length_805_cov_5.637394	323	403	1	20	80	0.2500000
NODE_11877_length_805_cov_5.637394	323	403	2	60	80	0.7500000
NODE_11877_length_805_cov_5.637394	376	456	0	31	80	0.3875000
NODE_11877_length_805_cov_5.637394	376	456	1	42	80	0.5250000
NODE_11877_length_805_cov_5.637394	376	456	2	7	80	0.0875000
NODE_11878_length_805_cov_4.001416	304	384	0	37	80	0.4625000
NODE_11878_length_805_cov_4.001416	304	384	2	43	80	0.5375000
NODE_11878_length_805_cov_4.001416	357	437	2	80	80	1.0000000
NODE_11903_length_804_cov_26.204255	319	399	1	3	80	0.0375000
NODE_11903_length_804_cov_26.204255	319	399	2	3	80	0.0375000
NODE_11903_length_804_cov_26.204255	319	399	3	46	80	0.5750000
NODE_11903_length_804_cov_26.204255	319	399	4	28	80	0.3500000
NODE_11903_length_804_cov_26.204255	372	452	1	3	80	0.0375000
NODE_11903_length_804_cov_26.204255	372	452	2	56	80	0.7000000
NODE_11903_length_804_cov_26.204255	372	452	3	21	80	0.2625000
NODE_11904_length_804_cov_25.978723	242	322	0	8	80	0.1000000
NODE_11904_length_804_cov_25.978723	242	322	1	54	80	0.6750000
NODE_11904_length_804_cov_25.978723	242	322	2	1	80	0.0125000
NODE_11904_length_804_cov_25.978723	242	322	3	17	80	0.2125000
NODE_11904_length_804_cov_25.978723	295	375	0	8	80	0.1000000
NODE_11904_length_804_cov_25.978723	295	375	1	1	80	0.0125000
NODE_11904_length_804_cov_25.978723	295	375	2	1	80	0.0125000
NODE_11904_length_804_cov_25.978723	295	375	3	45	80	0.5625000
NODE_11904_length_804_cov_25.978723	295	375	4	12	80	0.1500000
NODE_11904_length_804_cov_25.978723	295	375	5	13	80	0.1625000
NODE_11904_length_804_cov_25.978723	371	451	4	56	80	0.7000000
NODE_11904_length_804_cov_25.978723	371	451	5	10	80	0.1250000
NODE_11904_length_804_cov_25.978723	371	451	6	14	80	0.1750000
NODE_11904_length_804_cov_25.978723	424	504	3	3	80	0.0375000
NODE_11904_length_804_cov_25.978723	424	504	4	74	80	0.9250000
NODE_11904_length_804_cov_25.978723	424	504	5	3	80	0.0375000
NODE_11905_length_804_cov_25.628369	444	524	5	22	80	0.2750000
NODE_11905_length_804_cov_25.628369	444	524	6	58	80	0.7250000
NODE_11905_length_804_cov_25.628369	497	577	2	40	80	0.5000000
NODE_11905_length_804_cov_25.628369	497	577	3	6	80	0.0750000
NODE_11905_length_804_cov_25.628369	497	577	4	2	80	0.0250000
NODE_11905_length_804_cov_25.628369	497	577	5	13	80	0.1625000
NODE_11905_length_804_cov_25.628369	497	577	6	19	80	0.2375000
NODE_11906_length_804_cov_22.438298	269	349	8	38	80	0.4750000
NODE_11906_length_804_cov_22.438298	269	349	9	24	80	0.3000000
NODE_11906_length_804_cov_22.438298	269	349	10	2	80	0.0250000
NODE_11906_length_804_cov_22.438298	269	349	11	16	80	0.2000000
NODE_11906_length_804_cov_22.438298	322	402	1	10	80	0.1250000
NODE_11906_length_804_cov_22.438298	322	402	2	5	80	0.0625000
NODE_11906_length_804_cov_22.438298	322	402	3	1	80	0.0125000
NODE_11906_length_804_cov_22.438298	322	402	5	5	80	0.0625000
NODE_11906_length_804_cov_22.438298	322	402	6	4	80	0.0500000
NODE_11906_length_804_cov_22.438298	322	402	7	6	80	0.0750000
NODE_11906_length_804_cov_22.438298	322	402	8	11	80	0.1375000
NODE_11906_length_804_cov_22.438298	322	402	9	38	80	0.4750000
NODE_11907_length_804_cov_17.425532	273	353	5	34	80	0.4250000
NODE_11907_length_804_cov_17.425532	273	353	6	24	80	0.3000000
NODE_11907_length_804_cov_17.425532	273	353	7	22	80	0.2750000
NODE_11907_length_804_cov_17.425532	326	406	5	55	80	0.6875000
NODE_11907_length_804_cov_17.425532	326	406	6	3	80	0.0375000
NODE_11907_length_804_cov_17.425532	326	406	7	22	80	0.2750000
NODE_11908_length_804_cov_16.849645	229	309	3	18	80	0.2250000
NODE_11908_length_804_cov_16.849645	229	309	4	12	80	0.1500000
NODE_11908_length_804_cov_16.849645	229	309	5	37	80	0.4625000
NODE_11908_length_804_cov_16.849645	229	309	6	2	80	0.0250000
NODE_11908_length_804_cov_16.849645	229	309	7	11	80	0.1375000
NODE_11908_length_804_cov_16.849645	282	362	4	14	80	0.1750000
NODE_11908_length_804_cov_16.849645	282	362	5	14	80	0.1750000
NODE_11908_length_804_cov_16.849645	282	362	6	26	80	0.3250000
NODE_11908_length_804_cov_16.849645	282	362	7	26	80	0.3250000
NODE_11909_length_804_cov_16.024113	499	579	2	80	80	1.0000000
NODE_11909_length_804_cov_16.024113	552	632	1	26	80	0.3250000
NODE_11909_length_804_cov_16.024113	552	632	2	54	80	0.6750000
NODE_11910_length_804_cov_14.567376	375	455	0	1	80	0.0125000
NODE_11910_length_804_cov_14.567376	375	455	1	79	80	0.9875000
NODE_11910_length_804_cov_14.567376	428	508	1	29	80	0.3625000
NODE_11910_length_804_cov_14.567376	428	508	2	51	80	0.6375000
NODE_11911_length_804_cov_14.011348	262	342	7	1	80	0.0125000
NODE_11911_length_804_cov_14.011348	262	342	8	9	80	0.1125000
NODE_11911_length_804_cov_14.011348	262	342	10	18	80	0.2250000
NODE_11911_length_804_cov_14.011348	262	342	11	1	80	0.0125000
NODE_11911_length_804_cov_14.011348	262	342	12	2	80	0.0250000
NODE_11911_length_804_cov_14.011348	262	342	13	16	80	0.2000000
NODE_11911_length_804_cov_14.011348	262	342	14	18	80	0.2250000
NODE_11911_length_804_cov_14.011348	262	342	15	13	80	0.1625000
NODE_11911_length_804_cov_14.011348	262	342	16	2	80	0.0250000
NODE_11911_length_804_cov_14.011348	315	395	11	23	80	0.2875000
NODE_11911_length_804_cov_14.011348	315	395	12	10	80	0.1250000
NODE_11911_length_804_cov_14.011348	315	395	13	31	80	0.3875000
NODE_11911_length_804_cov_14.011348	315	395	14	4	80	0.0500000
NODE_11911_length_804_cov_14.011348	315	395	15	10	80	0.1250000
NODE_11911_length_804_cov_14.011348	315	395	16	2	80	0.0250000
NODE_11912_length_804_cov_13.800000	289	318	0	29	29	1.0000000
NODE_11913_length_804_cov_12.585816	396	476	4	1	80	0.0125000
NODE_11913_length_804_cov_12.585816	396	476	5	52	80	0.6500000
NODE_11913_length_804_cov_12.585816	396	476	6	27	80	0.3375000
NODE_11913_length_804_cov_12.585816	449	529	1	14	80	0.1750000
NODE_11913_length_804_cov_12.585816	449	529	2	5	80	0.0625000
NODE_11913_length_804_cov_12.585816	449	529	3	11	80	0.1375000
NODE_11913_length_804_cov_12.585816	449	529	4	24	80	0.3000000
NODE_11913_length_804_cov_12.585816	449	529	5	25	80	0.3125000
NODE_11913_length_804_cov_12.585816	449	529	6	1	80	0.0125000
NODE_11914_length_804_cov_12.375887	190	270	1	17	80	0.2125000
NODE_11914_length_804_cov_12.375887	190	270	2	5	80	0.0625000
NODE_11914_length_804_cov_12.375887	190	270	3	15	80	0.1875000
NODE_11914_length_804_cov_12.375887	190	270	4	43	80	0.5375000
NODE_11914_length_804_cov_12.375887	243	323	3	43	80	0.5375000
NODE_11914_length_804_cov_12.375887	243	323	4	37	80	0.4625000
NODE_11915_length_804_cov_10.947518	363	443	4	80	80	1.0000000
NODE_11915_length_804_cov_10.947518	416	496	0	7	80	0.0875000
NODE_11915_length_804_cov_10.947518	416	496	2	26	80	0.3250000
NODE_11915_length_804_cov_10.947518	416	496	3	12	80	0.1500000
NODE_11915_length_804_cov_10.947518	416	496	4	35	80	0.4375000
NODE_11916_length_804_cov_8.164539	427	507	1	24	80	0.3000000
NODE_11916_length_804_cov_8.164539	427	507	3	56	80	0.7000000
NODE_11916_length_804_cov_8.164539	480	560	2	7	80	0.0875000
NODE_11916_length_804_cov_8.164539	480	560	3	39	80	0.4875000
NODE_11916_length_804_cov_8.164539	480	560	4	34	80	0.4250000
NODE_11917_length_804_cov_7.462411	345	425	0	80	80	1.0000000
NODE_11917_length_804_cov_7.462411	398	478	0	80	80	1.0000000
NODE_11919_length_804_cov_3.663830	736	799	0	63	63	1.0000000
NODE_11933_length_804_cov_1.303546	480	560	0	80	80	1.0000000
NODE_11933_length_804_cov_1.303546	533	613	0	80	80	1.0000000
NODE_11942_length_803_cov_40.930398	374	454	6	16	80	0.2000000
NODE_11942_length_803_cov_40.930398	374	454	7	5	80	0.0625000
NODE_11942_length_803_cov_40.930398	374	454	9	5	80	0.0625000
NODE_11942_length_803_cov_40.930398	374	454	10	5	80	0.0625000
NODE_11942_length_803_cov_40.930398	374	454	11	28	80	0.3500000
NODE_11942_length_803_cov_40.930398	374	454	12	16	80	0.2000000
NODE_11942_length_803_cov_40.930398	374	454	13	5	80	0.0625000
NODE_11942_length_803_cov_40.930398	427	507	9	5	80	0.0625000
NODE_11942_length_803_cov_40.930398	427	507	10	5	80	0.0625000
NODE_11942_length_803_cov_40.930398	427	507	11	12	80	0.1500000
NODE_11942_length_803_cov_40.930398	427	507	12	34	80	0.4250000
NODE_11942_length_803_cov_40.930398	427	507	13	24	80	0.3000000
NODE_11944_length_803_cov_28.346591	242	322	10	13	80	0.1625000
NODE_11944_length_803_cov_28.346591	242	322	11	10	80	0.1250000
NODE_11944_length_803_cov_28.346591	242	322	13	6	80	0.0750000
NODE_11944_length_803_cov_28.346591	242	322	14	47	80	0.5875000
NODE_11944_length_803_cov_28.346591	242	322	15	4	80	0.0500000
NODE_11944_length_803_cov_28.346591	295	375	10	25	80	0.3125000
NODE_11944_length_803_cov_28.346591	295	375	14	34	80	0.4250000
NODE_11944_length_803_cov_28.346591	295	375	15	4	80	0.0500000
NODE_11944_length_803_cov_28.346591	295	375	16	13	80	0.1625000
NODE_11944_length_803_cov_28.346591	295	375	17	4	80	0.0500000
NODE_11945_length_803_cov_23.420455	288	368	2	67	80	0.8375000
NODE_11945_length_803_cov_23.420455	288	368	4	13	80	0.1625000
NODE_11945_length_803_cov_23.420455	341	421	2	14	80	0.1750000
NODE_11945_length_803_cov_23.420455	341	421	3	15	80	0.1875000
NODE_11945_length_803_cov_23.420455	341	421	4	51	80	0.6375000
NODE_11946_length_803_cov_20.977273	316	396	2	16	80	0.2000000
NODE_11946_length_803_cov_20.977273	316	396	3	11	80	0.1375000
NODE_11946_length_803_cov_20.977273	316	396	4	4	80	0.0500000
NODE_11946_length_803_cov_20.977273	316	396	5	29	80	0.3625000
NODE_11946_length_803_cov_20.977273	316	396	6	20	80	0.2500000
NODE_11946_length_803_cov_20.977273	369	449	4	31	80	0.3875000
NODE_11946_length_803_cov_20.977273	369	449	5	49	80	0.6125000
NODE_11947_length_803_cov_18.458807	307	387	3	48	80	0.6000000
NODE_11947_length_803_cov_18.458807	307	387	5	32	80	0.4000000
NODE_11947_length_803_cov_18.458807	360	440	2	20	80	0.2500000
NODE_11947_length_803_cov_18.458807	360	440	4	33	80	0.4125000
NODE_11947_length_803_cov_18.458807	360	440	5	27	80	0.3375000
NODE_11948_length_803_cov_14.411932	386	466	0	60	80	0.7500000
NODE_11948_length_803_cov_14.411932	386	466	2	5	80	0.0625000
NODE_11948_length_803_cov_14.411932	386	466	3	15	80	0.1875000
NODE_11948_length_803_cov_14.411932	439	519	0	7	80	0.0875000
NODE_11948_length_803_cov_14.411932	439	519	2	5	80	0.0625000
NODE_11948_length_803_cov_14.411932	439	519	3	68	80	0.8500000
NODE_11949_length_803_cov_10.157670	319	399	3	26	80	0.3250000
NODE_11949_length_803_cov_10.157670	319	399	4	54	80	0.6750000
NODE_11949_length_803_cov_10.157670	372	452	2	24	80	0.3000000
NODE_11949_length_803_cov_10.157670	372	452	3	55	80	0.6875000
NODE_11949_length_803_cov_10.157670	372	452	4	1	80	0.0125000
NODE_11950_length_803_cov_8.977273	362	442	5	1	80	0.0125000
NODE_11950_length_803_cov_8.977273	362	442	6	2	80	0.0250000
NODE_11950_length_803_cov_8.977273	362	442	7	27	80	0.3375000
NODE_11950_length_803_cov_8.977273	362	442	8	50	80	0.6250000
NODE_11950_length_803_cov_8.977273	415	485	5	8	70	0.1142857
NODE_11950_length_803_cov_8.977273	415	485	7	23	70	0.3285714
NODE_11950_length_803_cov_8.977273	415	485	8	39	70	0.5571429
NODE_11951_length_803_cov_7.735795	195	275	0	80	80	1.0000000
NODE_11951_length_803_cov_7.735795	248	328	0	80	80	1.0000000
NODE_11955_length_803_cov_4.613636	266	346	1	29	80	0.3625000
NODE_11955_length_803_cov_4.613636	266	346	2	16	80	0.2000000
NODE_11955_length_803_cov_4.613636	266	346	3	35	80	0.4375000
NODE_11955_length_803_cov_4.613636	319	399	0	21	80	0.2625000
NODE_11955_length_803_cov_4.613636	319	399	1	59	80	0.7375000
NODE_11957_length_803_cov_4.220170	72	152	0	80	80	1.0000000
NODE_11957_length_803_cov_4.220170	130	207	0	77	77	1.0000000
NODE_11985_length_802_cov_42.294452	289	369	8	4	80	0.0500000
NODE_11985_length_802_cov_42.294452	289	369	9	13	80	0.1625000
NODE_11985_length_802_cov_42.294452	289	369	11	11	80	0.1375000
NODE_11985_length_802_cov_42.294452	289	369	12	41	80	0.5125000
NODE_11985_length_802_cov_42.294452	289	369	13	11	80	0.1375000
NODE_11985_length_802_cov_42.294452	342	422	7	6	80	0.0750000
NODE_11985_length_802_cov_42.294452	342	422	8	15	80	0.1875000
NODE_11985_length_802_cov_42.294452	342	422	10	27	80	0.3375000
NODE_11985_length_802_cov_42.294452	342	422	11	11	80	0.1375000
NODE_11985_length_802_cov_42.294452	342	422	12	18	80	0.2250000
NODE_11985_length_802_cov_42.294452	342	422	13	3	80	0.0375000
NODE_11986_length_802_cov_31.896159	246	326	3	10	80	0.1250000
NODE_11986_length_802_cov_31.896159	246	326	4	43	80	0.5375000
NODE_11986_length_802_cov_31.896159	246	326	5	3	80	0.0375000
NODE_11986_length_802_cov_31.896159	246	326	6	24	80	0.3000000
NODE_11986_length_802_cov_31.896159	299	379	4	29	80	0.3625000
NODE_11986_length_802_cov_31.896159	299	379	6	51	80	0.6375000
NODE_11987_length_802_cov_30.786629	419	499	5	14	80	0.1750000
NODE_11987_length_802_cov_30.786629	419	499	7	66	80	0.8250000
NODE_11987_length_802_cov_30.786629	472	552	2	11	80	0.1375000
NODE_11987_length_802_cov_30.786629	472	552	4	26	80	0.3250000
NODE_11987_length_802_cov_30.786629	472	552	5	6	80	0.0750000
NODE_11987_length_802_cov_30.786629	472	552	7	37	80	0.4625000
NODE_11988_length_802_cov_19.540541	368	448	7	8	80	0.1000000
NODE_11988_length_802_cov_19.540541	368	448	8	26	80	0.3250000
NODE_11988_length_802_cov_19.540541	368	448	9	11	80	0.1375000
NODE_11988_length_802_cov_19.540541	368	448	10	33	80	0.4125000
NODE_11988_length_802_cov_19.540541	368	448	12	2	80	0.0250000
NODE_11988_length_802_cov_19.540541	421	501	5	1	80	0.0125000
NODE_11988_length_802_cov_19.540541	421	501	7	43	80	0.5375000
NODE_11988_length_802_cov_19.540541	421	501	9	5	80	0.0625000
NODE_11988_length_802_cov_19.540541	421	501	10	28	80	0.3500000
NODE_11988_length_802_cov_19.540541	421	501	11	1	80	0.0125000
NODE_11988_length_802_cov_19.540541	421	501	12	2	80	0.0250000
NODE_11989_length_802_cov_17.689900	268	348	2	5	80	0.0625000
NODE_11989_length_802_cov_17.689900	268	348	3	17	80	0.2125000
NODE_11989_length_802_cov_17.689900	268	348	5	57	80	0.7125000
NODE_11989_length_802_cov_17.689900	268	348	7	1	80	0.0125000
NODE_11989_length_802_cov_17.689900	321	401	5	26	80	0.3250000
NODE_11989_length_802_cov_17.689900	321	401	7	18	80	0.2250000
NODE_11989_length_802_cov_17.689900	321	401	8	3	80	0.0375000
NODE_11989_length_802_cov_17.689900	321	401	9	33	80	0.4125000
NODE_11990_length_802_cov_16.432432	364	444	2	80	80	1.0000000
NODE_11990_length_802_cov_16.432432	417	497	2	80	80	1.0000000
NODE_11991_length_802_cov_15.409673	317	397	0	67	80	0.8375000
NODE_11991_length_802_cov_15.409673	317	397	1	13	80	0.1625000
NODE_11991_length_802_cov_15.409673	370	450	0	14	80	0.1750000
NODE_11991_length_802_cov_15.409673	370	450	1	21	80	0.2625000
NODE_11991_length_802_cov_15.409673	370	450	2	45	80	0.5625000
NODE_11992_length_802_cov_12.507824	340	420	2	6	80	0.0750000
NODE_11992_length_802_cov_12.507824	340	420	4	67	80	0.8375000
NODE_11992_length_802_cov_12.507824	340	420	6	7	80	0.0875000
NODE_11992_length_802_cov_12.507824	393	473	4	45	80	0.5625000
NODE_11992_length_802_cov_12.507824	393	473	6	35	80	0.4375000
NODE_11993_length_802_cov_9.310100	374	454	0	80	80	1.0000000
NODE_11993_length_802_cov_9.310100	427	507	0	80	80	1.0000000
NODE_11994_length_802_cov_8.421053	272	351	0	15	79	0.1898734
NODE_11994_length_802_cov_8.421053	272	351	4	8	79	0.1012658
NODE_11994_length_802_cov_8.421053	272	351	5	16	79	0.2025317
NODE_11994_length_802_cov_8.421053	272	351	6	40	79	0.5063291
NODE_11994_length_802_cov_8.421053	324	404	0	68	80	0.8500000
NODE_11994_length_802_cov_8.421053	324	404	4	8	80	0.1000000
NODE_11994_length_802_cov_8.421053	324	404	5	4	80	0.0500000
NODE_11997_length_802_cov_5.576102	294	374	3	78	80	0.9750000
NODE_11997_length_802_cov_5.576102	294	374	4	2	80	0.0250000
NODE_11997_length_802_cov_5.576102	347	427	1	35	80	0.4375000
NODE_11997_length_802_cov_5.576102	347	427	3	45	80	0.5625000
NODE_12025_length_801_cov_35.199430	334	414	1	19	80	0.2375000
NODE_12025_length_801_cov_35.199430	334	414	3	2	80	0.0250000
NODE_12025_length_801_cov_35.199430	334	414	4	27	80	0.3375000
NODE_12025_length_801_cov_35.199430	334	414	5	4	80	0.0500000
NODE_12025_length_801_cov_35.199430	334	414	7	28	80	0.3500000
NODE_12025_length_801_cov_35.199430	387	467	4	33	80	0.4125000
NODE_12025_length_801_cov_35.199430	387	467	5	1	80	0.0125000
NODE_12025_length_801_cov_35.199430	387	467	6	14	80	0.1750000
NODE_12025_length_801_cov_35.199430	387	467	7	32	80	0.4000000
NODE_12026_length_801_cov_20.096866	347	427	3	17	80	0.2125000
NODE_12026_length_801_cov_20.096866	347	427	4	11	80	0.1375000
NODE_12026_length_801_cov_20.096866	347	427	5	14	80	0.1750000
NODE_12026_length_801_cov_20.096866	347	427	6	38	80	0.4750000
NODE_12026_length_801_cov_20.096866	400	480	5	67	80	0.8375000
NODE_12026_length_801_cov_20.096866	400	480	6	13	80	0.1625000
NODE_12027_length_801_cov_18.643875	355	435	2	18	80	0.2250000
NODE_12027_length_801_cov_18.643875	355	435	3	9	80	0.1125000
NODE_12027_length_801_cov_18.643875	355	435	5	53	80	0.6625000
NODE_12027_length_801_cov_18.643875	408	488	5	66	80	0.8250000
NODE_12027_length_801_cov_18.643875	408	488	6	14	80	0.1750000
NODE_12028_length_801_cov_16.099715	427	507	2	73	80	0.9125000
NODE_12028_length_801_cov_16.099715	427	507	3	7	80	0.0875000
NODE_12028_length_801_cov_16.099715	480	560	0	40	80	0.5000000
NODE_12028_length_801_cov_16.099715	480	560	2	40	80	0.5000000
NODE_12029_length_801_cov_12.307692	332	412	8	3	80	0.0375000
NODE_12029_length_801_cov_12.307692	332	412	9	14	80	0.1750000
NODE_12029_length_801_cov_12.307692	332	412	10	6	80	0.0750000
NODE_12029_length_801_cov_12.307692	332	412	11	17	80	0.2125000
NODE_12029_length_801_cov_12.307692	332	412	12	13	80	0.1625000
NODE_12029_length_801_cov_12.307692	332	412	13	27	80	0.3375000
NODE_12029_length_801_cov_12.307692	385	465	6	17	80	0.2125000
NODE_12029_length_801_cov_12.307692	385	465	7	25	80	0.3125000
NODE_12029_length_801_cov_12.307692	385	465	8	9	80	0.1125000
NODE_12029_length_801_cov_12.307692	385	465	9	14	80	0.1750000
NODE_12029_length_801_cov_12.307692	385	465	11	2	80	0.0250000
NODE_12029_length_801_cov_12.307692	385	465	12	13	80	0.1625000
NODE_12030_length_801_cov_11.464387	293	373	3	3	80	0.0375000
NODE_12030_length_801_cov_11.464387	293	373	4	17	80	0.2125000
NODE_12030_length_801_cov_11.464387	293	373	6	60	80	0.7500000
NODE_12030_length_801_cov_11.464387	346	426	5	2	80	0.0250000
NODE_12030_length_801_cov_11.464387	346	426	6	32	80	0.4000000
NODE_12030_length_801_cov_11.464387	346	426	7	19	80	0.2375000
NODE_12030_length_801_cov_11.464387	346	426	8	27	80	0.3375000
NODE_12031_length_801_cov_8.562678	309	389	1	24	80	0.3000000
NODE_12031_length_801_cov_8.562678	309	389	2	56	80	0.7000000
NODE_12031_length_801_cov_8.562678	362	442	0	39	80	0.4875000
NODE_12031_length_801_cov_8.562678	362	442	1	38	80	0.4750000
NODE_12031_length_801_cov_8.562678	362	442	2	3	80	0.0375000
NODE_12032_length_801_cov_3.927350	339	419	4	14	80	0.1750000
NODE_12032_length_801_cov_3.927350	339	419	5	66	80	0.8250000
NODE_12032_length_801_cov_3.927350	392	472	3	25	80	0.3125000
NODE_12032_length_801_cov_3.927350	392	472	4	14	80	0.1750000
NODE_12032_length_801_cov_3.927350	392	472	5	41	80	0.5125000
NODE_12053_length_800_cov_72.029957	245	325	9	6	80	0.0750000
NODE_12053_length_800_cov_72.029957	245	325	10	7	80	0.0875000
NODE_12053_length_800_cov_72.029957	245	325	11	37	80	0.4625000
NODE_12053_length_800_cov_72.029957	245	325	12	27	80	0.3375000
NODE_12053_length_800_cov_72.029957	245	325	13	3	80	0.0375000
NODE_12053_length_800_cov_72.029957	298	378	7	21	80	0.2625000
NODE_12053_length_800_cov_72.029957	298	378	8	15	80	0.1875000
NODE_12053_length_800_cov_72.029957	298	378	9	3	80	0.0375000
NODE_12053_length_800_cov_72.029957	298	378	10	7	80	0.0875000
NODE_12053_length_800_cov_72.029957	298	378	11	29	80	0.3625000
NODE_12053_length_800_cov_72.029957	298	378	12	5	80	0.0625000
NODE_12054_length_800_cov_22.631954	297	377	7	5	80	0.0625000
NODE_12054_length_800_cov_22.631954	297	377	8	16	80	0.2000000
NODE_12054_length_800_cov_22.631954	297	377	9	44	80	0.5500000
NODE_12054_length_800_cov_22.631954	297	377	10	15	80	0.1875000
NODE_12054_length_800_cov_22.631954	350	430	4	20	80	0.2500000
NODE_12054_length_800_cov_22.631954	350	430	6	20	80	0.2500000
NODE_12054_length_800_cov_22.631954	350	430	8	18	80	0.2250000
NODE_12054_length_800_cov_22.631954	350	430	9	22	80	0.2750000
NODE_12055_length_800_cov_9.457917	409	489	5	5	80	0.0625000
NODE_12055_length_800_cov_9.457917	409	489	6	20	80	0.2500000
NODE_12055_length_800_cov_9.457917	409	489	7	19	80	0.2375000
NODE_12055_length_800_cov_9.457917	409	489	8	36	80	0.4500000
NODE_12055_length_800_cov_9.457917	462	542	2	11	80	0.1375000
NODE_12055_length_800_cov_9.457917	462	542	3	25	80	0.3125000
NODE_12055_length_800_cov_9.457917	462	542	4	16	80	0.2000000
NODE_12055_length_800_cov_9.457917	462	542	6	21	80	0.2625000
NODE_12055_length_800_cov_9.457917	462	542	8	7	80	0.0875000
NODE_12084_length_799_cov_101.640000	101	132	25	1	31	0.0322581
NODE_12084_length_799_cov_101.640000	101	132	28	1	31	0.0322581
NODE_12084_length_799_cov_101.640000	101	132	29	7	31	0.2258064
NODE_12084_length_799_cov_101.640000	101	132	32	4	31	0.1290323
NODE_12084_length_799_cov_101.640000	101	132	33	3	31	0.0967742
NODE_12084_length_799_cov_101.640000	101	132	37	1	31	0.0322581
NODE_12084_length_799_cov_101.640000	101	132	42	1	31	0.0322581
NODE_12084_length_799_cov_101.640000	101	132	43	2	31	0.0645161
NODE_12084_length_799_cov_101.640000	101	132	45	1	31	0.0322581
NODE_12084_length_799_cov_101.640000	101	132	47	1	31	0.0322581
NODE_12084_length_799_cov_101.640000	101	132	51	1	31	0.0322581
NODE_12084_length_799_cov_101.640000	101	132	53	1	31	0.0322581
NODE_12084_length_799_cov_101.640000	101	132	56	1	31	0.0322581
NODE_12084_length_799_cov_101.640000	101	132	58	6	31	0.1935484
NODE_12085_length_799_cov_33.630000	367	447	6	4	80	0.0500000
NODE_12085_length_799_cov_33.630000	367	447	7	4	80	0.0500000
NODE_12085_length_799_cov_33.630000	367	447	8	30	80	0.3750000
NODE_12085_length_799_cov_33.630000	367	447	9	42	80	0.5250000
NODE_12085_length_799_cov_33.630000	420	500	2	21	80	0.2625000
NODE_12085_length_799_cov_33.630000	420	500	3	2	80	0.0250000
NODE_12085_length_799_cov_33.630000	420	500	5	13	80	0.1625000
NODE_12085_length_799_cov_33.630000	420	500	6	12	80	0.1500000
NODE_12085_length_799_cov_33.630000	420	500	7	13	80	0.1625000
NODE_12085_length_799_cov_33.630000	420	500	9	19	80	0.2375000
NODE_12086_length_799_cov_15.717143	408	488	2	8	80	0.1000000
NODE_12086_length_799_cov_15.717143	408	488	3	27	80	0.3375000
NODE_12086_length_799_cov_15.717143	408	488	5	45	80	0.5625000
NODE_12086_length_799_cov_15.717143	461	541	5	80	80	1.0000000
NODE_12087_length_799_cov_15.175714	293	373	5	9	80	0.1125000
NODE_12087_length_799_cov_15.175714	293	373	6	35	80	0.4375000
NODE_12087_length_799_cov_15.175714	293	373	8	8	80	0.1000000
NODE_12087_length_799_cov_15.175714	293	373	9	28	80	0.3500000
NODE_12087_length_799_cov_15.175714	346	426	2	18	80	0.2250000
NODE_12087_length_799_cov_15.175714	346	426	3	1	80	0.0125000
NODE_12087_length_799_cov_15.175714	346	426	4	33	80	0.4125000
NODE_12087_length_799_cov_15.175714	346	426	6	28	80	0.3500000
NODE_12088_length_799_cov_8.444286	408	488	4	8	80	0.1000000
NODE_12088_length_799_cov_8.444286	408	488	6	33	80	0.4125000
NODE_12088_length_799_cov_8.444286	408	488	7	19	80	0.2375000
NODE_12088_length_799_cov_8.444286	408	488	8	20	80	0.2500000
NODE_12088_length_799_cov_8.444286	461	541	1	27	80	0.3375000
NODE_12088_length_799_cov_8.444286	461	541	3	8	80	0.1000000
NODE_12088_length_799_cov_8.444286	461	541	4	26	80	0.3250000
NODE_12088_length_799_cov_8.444286	461	541	6	5	80	0.0625000
NODE_12088_length_799_cov_8.444286	461	541	8	14	80	0.1750000
NODE_12120_length_798_cov_42.629471	148	228	6	3	80	0.0375000
NODE_12120_length_798_cov_42.629471	148	228	7	10	80	0.1250000
NODE_12120_length_798_cov_42.629471	148	228	8	11	80	0.1375000
NODE_12120_length_798_cov_42.629471	148	228	9	4	80	0.0500000
NODE_12120_length_798_cov_42.629471	148	228	10	51	80	0.6375000
NODE_12120_length_798_cov_42.629471	148	228	11	1	80	0.0125000
NODE_12120_length_798_cov_42.629471	201	281	7	31	80	0.3875000
NODE_12120_length_798_cov_42.629471	201	281	9	25	80	0.3125000
NODE_12120_length_798_cov_42.629471	201	281	10	23	80	0.2875000
NODE_12120_length_798_cov_42.629471	201	281	11	1	80	0.0125000
NODE_12121_length_798_cov_23.658083	368	448	3	2	80	0.0250000
NODE_12121_length_798_cov_23.658083	368	448	5	18	80	0.2250000
NODE_12121_length_798_cov_23.658083	368	448	7	18	80	0.2250000
NODE_12121_length_798_cov_23.658083	368	448	9	35	80	0.4375000
NODE_12121_length_798_cov_23.658083	368	448	10	7	80	0.0875000
NODE_12121_length_798_cov_23.658083	421	501	8	4	80	0.0500000
NODE_12121_length_798_cov_23.658083	421	501	9	48	80	0.6000000
NODE_12121_length_798_cov_23.658083	421	501	10	28	80	0.3500000
NODE_12122_length_798_cov_15.037196	341	421	3	1	80	0.0125000
NODE_12122_length_798_cov_15.037196	341	421	4	79	80	0.9875000
NODE_12122_length_798_cov_15.037196	394	474	2	26	80	0.3250000
NODE_12122_length_798_cov_15.037196	394	474	3	1	80	0.0125000
NODE_12122_length_798_cov_15.037196	394	474	4	53	80	0.6625000
NODE_12123_length_798_cov_6.816881	404	483	1	79	79	1.0000000
NODE_12123_length_798_cov_6.816881	457	536	0	19	79	0.2405063
NODE_12123_length_798_cov_6.816881	457	536	1	60	79	0.7594936
NODE_12129_length_798_cov_2.796853	246	326	0	80	80	1.0000000
NODE_12129_length_798_cov_2.796853	299	379	0	38	80	0.4750000
NODE_12129_length_798_cov_2.796853	299	379	2	42	80	0.5250000
NODE_12151_length_797_cov_24.340974	207	287	2	18	80	0.2250000
NODE_12151_length_797_cov_24.340974	207	287	4	62	80	0.7750000
NODE_12151_length_797_cov_24.340974	260	340	2	47	80	0.5875000
NODE_12151_length_797_cov_24.340974	260	340	4	33	80	0.4125000
NODE_12152_length_797_cov_21.071633	372	452	0	5	80	0.0625000
NODE_12152_length_797_cov_21.071633	372	452	1	41	80	0.5125000
NODE_12152_length_797_cov_21.071633	372	452	2	34	80	0.4250000
NODE_12152_length_797_cov_21.071633	425	505	0	58	80	0.7250000
NODE_12152_length_797_cov_21.071633	425	505	1	22	80	0.2750000
NODE_12153_length_797_cov_18.286533	346	426	6	2	80	0.0250000
NODE_12153_length_797_cov_18.286533	346	426	7	33	80	0.4125000
NODE_12153_length_797_cov_18.286533	346	426	8	23	80	0.2875000
NODE_12153_length_797_cov_18.286533	346	426	9	20	80	0.2500000
NODE_12153_length_797_cov_18.286533	346	426	10	2	80	0.0250000
NODE_12153_length_797_cov_18.286533	399	479	2	5	80	0.0625000
NODE_12153_length_797_cov_18.286533	399	479	4	2	80	0.0250000
NODE_12153_length_797_cov_18.286533	399	479	5	10	80	0.1250000
NODE_12153_length_797_cov_18.286533	399	479	6	26	80	0.3250000
NODE_12153_length_797_cov_18.286533	399	479	7	37	80	0.4625000
NODE_12154_length_797_cov_16.628940	322	402	2	60	80	0.7500000
NODE_12154_length_797_cov_16.628940	322	402	4	20	80	0.2500000
NODE_12154_length_797_cov_16.628940	375	455	0	2	80	0.0250000
NODE_12154_length_797_cov_16.628940	375	455	2	41	80	0.5125000
NODE_12154_length_797_cov_16.628940	375	455	4	37	80	0.4625000
NODE_12155_length_797_cov_15.266476	299	379	2	4	80	0.0500000
NODE_12155_length_797_cov_15.266476	299	379	4	5	80	0.0625000
NODE_12155_length_797_cov_15.266476	299	379	5	8	80	0.1000000
NODE_12155_length_797_cov_15.266476	299	379	6	29	80	0.3625000
NODE_12155_length_797_cov_15.266476	299	379	7	34	80	0.4250000
NODE_12155_length_797_cov_15.266476	352	432	4	10	80	0.1250000
NODE_12155_length_797_cov_15.266476	352	432	6	19	80	0.2375000
NODE_12155_length_797_cov_15.266476	352	432	7	36	80	0.4500000
NODE_12155_length_797_cov_15.266476	352	432	8	15	80	0.1875000
NODE_12156_length_797_cov_15.035817	263	343	0	38	80	0.4750000
NODE_12156_length_797_cov_15.035817	263	343	2	30	80	0.3750000
NODE_12156_length_797_cov_15.035817	263	343	3	12	80	0.1500000
NODE_12156_length_797_cov_15.035817	316	396	2	15	80	0.1875000
NODE_12156_length_797_cov_15.035817	316	396	3	61	80	0.7625000
NODE_12156_length_797_cov_15.035817	316	396	4	1	80	0.0125000
NODE_12156_length_797_cov_15.035817	316	396	5	3	80	0.0375000
NODE_12157_length_797_cov_12.934097	403	484	1	43	81	0.5308642
NODE_12157_length_797_cov_12.934097	403	484	2	38	81	0.4691358
NODE_12157_length_797_cov_12.934097	457	537	1	71	80	0.8875000
NODE_12157_length_797_cov_12.934097	457	537	2	9	80	0.1125000
NODE_12158_length_797_cov_11.140401	201	281	6	10	80	0.1250000
NODE_12158_length_797_cov_11.140401	201	281	7	9	80	0.1125000
NODE_12158_length_797_cov_11.140401	201	281	8	13	80	0.1625000
NODE_12158_length_797_cov_11.140401	201	281	9	37	80	0.4625000
NODE_12158_length_797_cov_11.140401	201	281	10	11	80	0.1375000
NODE_12158_length_797_cov_11.140401	254	334	4	6	80	0.0750000
NODE_12158_length_797_cov_11.140401	254	334	5	16	80	0.2000000
NODE_12158_length_797_cov_11.140401	254	334	7	27	80	0.3375000
NODE_12158_length_797_cov_11.140401	254	334	8	12	80	0.1500000
NODE_12158_length_797_cov_11.140401	254	334	9	8	80	0.1000000
NODE_12158_length_797_cov_11.140401	254	334	10	11	80	0.1375000
NODE_12159_length_797_cov_8.681948	284	364	1	35	80	0.4375000
NODE_12159_length_797_cov_8.681948	284	364	2	45	80	0.5625000
NODE_12159_length_797_cov_8.681948	337	417	2	80	80	1.0000000
NODE_12160_length_797_cov_7.616046	314	397	1	9	83	0.1084337
NODE_12160_length_797_cov_7.616046	314	397	2	74	83	0.8915663
NODE_12160_length_797_cov_7.616046	370	450	1	23	80	0.2875000
NODE_12160_length_797_cov_7.616046	370	450	2	57	80	0.7125000
NODE_12161_length_797_cov_7.487106	275	347	5	70	72	0.9722222
NODE_12161_length_797_cov_7.487106	275	347	6	2	72	0.0277778
NODE_12161_length_797_cov_7.487106	320	400	4	28	80	0.3500000
NODE_12161_length_797_cov_7.487106	320	400	5	31	80	0.3875000
NODE_12161_length_797_cov_7.487106	320	400	6	21	80	0.2625000
NODE_12163_length_797_cov_6.068768	357	437	1	80	80	1.0000000
NODE_12163_length_797_cov_6.068768	410	490	0	5	80	0.0625000
NODE_12163_length_797_cov_6.068768	410	490	1	27	80	0.3375000
NODE_12163_length_797_cov_6.068768	410	490	2	13	80	0.1625000
NODE_12163_length_797_cov_6.068768	410	490	3	35	80	0.4375000
NODE_12186_length_796_cov_20.862267	262	342	1	57	80	0.7125000
NODE_12186_length_796_cov_20.862267	262	342	2	23	80	0.2875000
NODE_12186_length_796_cov_20.862267	315	395	1	55	80	0.6875000
NODE_12186_length_796_cov_20.862267	315	395	2	25	80	0.3125000
NODE_12187_length_796_cov_18.291248	283	363	11	4	80	0.0500000
NODE_12187_length_796_cov_18.291248	283	363	12	12	80	0.1500000
NODE_12187_length_796_cov_18.291248	283	363	13	6	80	0.0750000
NODE_12187_length_796_cov_18.291248	283	363	14	3	80	0.0375000
NODE_12187_length_796_cov_18.291248	283	363	15	55	80	0.6875000
NODE_12187_length_796_cov_18.291248	336	416	8	1	80	0.0125000
NODE_12187_length_796_cov_18.291248	336	416	9	6	80	0.0750000
NODE_12187_length_796_cov_18.291248	336	416	10	19	80	0.2375000
NODE_12187_length_796_cov_18.291248	336	416	11	11	80	0.1375000
NODE_12187_length_796_cov_18.291248	336	416	12	2	80	0.0250000
NODE_12187_length_796_cov_18.291248	336	416	13	4	80	0.0500000
NODE_12187_length_796_cov_18.291248	336	416	14	11	80	0.1375000
NODE_12187_length_796_cov_18.291248	336	416	15	26	80	0.3250000
NODE_12189_length_796_cov_7.880918	388	460	1	16	72	0.2222222
NODE_12189_length_796_cov_7.880918	388	460	3	4	72	0.0555556
NODE_12189_length_796_cov_7.880918	388	460	5	20	72	0.2777778
NODE_12189_length_796_cov_7.880918	388	460	6	32	72	0.4444444
NODE_12189_length_796_cov_7.880918	442	513	3	27	71	0.3802817
NODE_12189_length_796_cov_7.880918	442	513	4	6	71	0.0845070
NODE_12189_length_796_cov_7.880918	442	513	6	38	71	0.5352113
NODE_12216_length_795_cov_31.729885	298	378	5	3	80	0.0375000
NODE_12216_length_795_cov_31.729885	298	378	6	3	80	0.0375000
NODE_12216_length_795_cov_31.729885	298	378	8	10	80	0.1250000
NODE_12216_length_795_cov_31.729885	298	378	9	64	80	0.8000000
NODE_12216_length_795_cov_31.729885	351	431	2	11	80	0.1375000
NODE_12216_length_795_cov_31.729885	351	431	3	17	80	0.2125000
NODE_12216_length_795_cov_31.729885	351	431	4	20	80	0.2500000
NODE_12216_length_795_cov_31.729885	351	431	5	8	80	0.1000000
NODE_12216_length_795_cov_31.729885	351	431	6	3	80	0.0375000
NODE_12216_length_795_cov_31.729885	351	431	8	8	80	0.1000000
NODE_12216_length_795_cov_31.729885	351	431	9	13	80	0.1625000
NODE_12217_length_795_cov_26.760057	367	447	5	28	80	0.3500000
NODE_12217_length_795_cov_26.760057	367	447	6	11	80	0.1375000
NODE_12217_length_795_cov_26.760057	367	447	7	41	80	0.5125000
NODE_12217_length_795_cov_26.760057	420	500	3	23	80	0.2875000
NODE_12217_length_795_cov_26.760057	420	500	4	22	80	0.2750000
NODE_12217_length_795_cov_26.760057	420	500	5	11	80	0.1375000
NODE_12217_length_795_cov_26.760057	420	500	7	24	80	0.3000000
NODE_12218_length_795_cov_24.522989	352	432	8	17	80	0.2125000
NODE_12218_length_795_cov_24.522989	352	432	9	4	80	0.0500000
NODE_12218_length_795_cov_24.522989	352	432	10	10	80	0.1250000
NODE_12218_length_795_cov_24.522989	352	432	11	49	80	0.6125000
NODE_12218_length_795_cov_24.522989	405	485	9	24	80	0.3000000
NODE_12218_length_795_cov_24.522989	405	485	11	48	80	0.6000000
NODE_12218_length_795_cov_24.522989	405	485	12	8	80	0.1000000
NODE_12219_length_795_cov_22.747126	363	443	3	49	80	0.6125000
NODE_12219_length_795_cov_22.747126	363	443	4	20	80	0.2500000
NODE_12219_length_795_cov_22.747126	363	443	5	2	80	0.0250000
NODE_12219_length_795_cov_22.747126	363	443	6	9	80	0.1125000
NODE_12219_length_795_cov_22.747126	416	496	4	20	80	0.2500000
NODE_12219_length_795_cov_22.747126	416	496	5	3	80	0.0375000
NODE_12219_length_795_cov_22.747126	416	496	6	9	80	0.1125000
NODE_12219_length_795_cov_22.747126	416	496	7	17	80	0.2125000
NODE_12219_length_795_cov_22.747126	416	496	8	31	80	0.3875000
NODE_12220_length_795_cov_9.439655	425	505	5	43	80	0.5375000
NODE_12220_length_795_cov_9.439655	425	505	6	1	80	0.0125000
NODE_12220_length_795_cov_9.439655	425	505	7	11	80	0.1375000
NODE_12220_length_795_cov_9.439655	425	505	8	2	80	0.0250000
NODE_12220_length_795_cov_9.439655	425	505	9	19	80	0.2375000
NODE_12220_length_795_cov_9.439655	425	505	10	4	80	0.0500000
NODE_12220_length_795_cov_9.439655	478	558	3	29	80	0.3625000
NODE_12220_length_795_cov_9.439655	478	558	4	18	80	0.2250000
NODE_12220_length_795_cov_9.439655	478	558	5	33	80	0.4125000
NODE_12232_length_795_cov_3.359195	349	429	0	80	80	1.0000000
NODE_12232_length_795_cov_3.359195	402	482	0	80	80	1.0000000
NODE_12256_length_794_cov_24.680576	326	406	2	80	80	1.0000000
NODE_12256_length_794_cov_24.680576	379	459	1	24	80	0.3000000
NODE_12256_length_794_cov_24.680576	379	459	2	56	80	0.7000000
NODE_12257_length_794_cov_20.057554	153	233	0	30	80	0.3750000
NODE_12257_length_794_cov_20.057554	153	233	2	27	80	0.3375000
NODE_12257_length_794_cov_20.057554	153	233	3	16	80	0.2000000
NODE_12257_length_794_cov_20.057554	153	233	4	7	80	0.0875000
NODE_12257_length_794_cov_20.057554	206	286	2	4	80	0.0500000
NODE_12257_length_794_cov_20.057554	206	286	3	16	80	0.2000000
NODE_12257_length_794_cov_20.057554	206	286	4	44	80	0.5500000
NODE_12257_length_794_cov_20.057554	206	286	5	16	80	0.2000000
NODE_12257_length_794_cov_20.057554	282	362	3	7	80	0.0875000
NODE_12257_length_794_cov_20.057554	282	362	4	33	80	0.4125000
NODE_12257_length_794_cov_20.057554	282	362	5	7	80	0.0875000
NODE_12257_length_794_cov_20.057554	282	362	6	33	80	0.4125000
NODE_12257_length_794_cov_20.057554	335	415	2	44	80	0.5500000
NODE_12257_length_794_cov_20.057554	335	415	3	16	80	0.2000000
NODE_12257_length_794_cov_20.057554	335	415	4	20	80	0.2500000
NODE_12258_length_794_cov_16.602878	361	441	2	1	80	0.0125000
NODE_12258_length_794_cov_16.602878	361	441	3	11	80	0.1375000
NODE_12258_length_794_cov_16.602878	361	441	4	27	80	0.3375000
NODE_12258_length_794_cov_16.602878	361	441	5	17	80	0.2125000
NODE_12258_length_794_cov_16.602878	361	441	6	24	80	0.3000000
NODE_12258_length_794_cov_16.602878	414	494	5	3	80	0.0375000
NODE_12258_length_794_cov_16.602878	414	494	6	40	80	0.5000000
NODE_12258_length_794_cov_16.602878	414	494	7	37	80	0.4625000
NODE_12259_length_794_cov_16.362590	337	417	0	7	80	0.0875000
NODE_12259_length_794_cov_16.362590	337	417	1	53	80	0.6625000
NODE_12259_length_794_cov_16.362590	337	417	2	20	80	0.2500000
NODE_12259_length_794_cov_16.362590	390	470	0	60	80	0.7500000
NODE_12259_length_794_cov_16.362590	390	470	1	20	80	0.2500000
NODE_12260_length_794_cov_14.444604	101	160	0	59	59	1.0000000
NODE_12260_length_794_cov_14.444604	409	489	0	69	80	0.8625000
NODE_12260_length_794_cov_14.444604	409	489	1	11	80	0.1375000
NODE_12260_length_794_cov_14.444604	462	542	0	16	80	0.2000000
NODE_12260_length_794_cov_14.444604	462	542	1	22	80	0.2750000
NODE_12260_length_794_cov_14.444604	462	542	2	42	80	0.5250000
NODE_12261_length_794_cov_12.866187	442	522	2	21	80	0.2625000
NODE_12261_length_794_cov_12.866187	442	522	4	22	80	0.2750000
NODE_12261_length_794_cov_12.866187	442	522	5	37	80	0.4625000
NODE_12261_length_794_cov_12.866187	495	575	4	35	80	0.4375000
NODE_12261_length_794_cov_12.866187	495	575	5	27	80	0.3375000
NODE_12261_length_794_cov_12.866187	495	575	6	18	80	0.2250000
NODE_12262_length_794_cov_12.287770	235	315	0	23	80	0.2875000
NODE_12262_length_794_cov_12.287770	235	315	1	35	80	0.4375000
NODE_12262_length_794_cov_12.287770	235	315	2	22	80	0.2750000
NODE_12262_length_794_cov_12.287770	288	368	0	76	80	0.9500000
NODE_12262_length_794_cov_12.287770	288	368	1	4	80	0.0500000
NODE_12263_length_794_cov_11.210072	315	395	0	80	80	1.0000000
NODE_12263_length_794_cov_11.210072	368	448	0	80	80	1.0000000
NODE_12264_length_794_cov_10.638849	325	406	4	27	81	0.3333333
NODE_12264_length_794_cov_10.638849	325	406	5	23	81	0.2839506
NODE_12264_length_794_cov_10.638849	325	406	6	17	81	0.2098765
NODE_12264_length_794_cov_10.638849	325	406	7	14	81	0.1728395
NODE_12264_length_794_cov_10.638849	379	459	5	33	80	0.4125000
NODE_12264_length_794_cov_10.638849	379	459	6	1	80	0.0125000
NODE_12264_length_794_cov_10.638849	379	459	7	46	80	0.5750000
NODE_12266_length_794_cov_6.274820	412	492	0	80	80	1.0000000
NODE_12266_length_794_cov_6.274820	465	545	0	80	80	1.0000000
NODE_12271_length_794_cov_3.197122	273	338	2	65	65	1.0000000
NODE_12282_length_794_cov_1.848921	246	326	2	80	80	1.0000000
NODE_12282_length_794_cov_1.848921	299	379	0	36	80	0.4500000
NODE_12282_length_794_cov_1.848921	299	379	1	5	80	0.0625000
NODE_12282_length_794_cov_1.848921	299	379	2	39	80	0.4875000
NODE_12295_length_793_cov_29.878963	326	406	3	16	80	0.2000000
NODE_12295_length_793_cov_29.878963	326	406	4	24	80	0.3000000
NODE_12295_length_793_cov_29.878963	326	406	5	40	80	0.5000000
NODE_12295_length_793_cov_29.878963	379	459	2	35	80	0.4375000
NODE_12295_length_793_cov_29.878963	379	459	3	17	80	0.2125000
NODE_12295_length_793_cov_29.878963	379	459	5	28	80	0.3500000
NODE_12296_length_793_cov_25.981268	310	390	0	1	80	0.0125000
NODE_12296_length_793_cov_25.981268	310	390	1	7	80	0.0875000
NODE_12296_length_793_cov_25.981268	310	390	2	6	80	0.0750000
NODE_12296_length_793_cov_25.981268	310	390	3	24	80	0.3000000
NODE_12296_length_793_cov_25.981268	310	390	7	42	80	0.5250000
NODE_12296_length_793_cov_25.981268	363	445	7	82	82	1.0000000
NODE_12297_length_793_cov_24.840058	331	411	6	16	80	0.2000000
NODE_12297_length_793_cov_24.840058	331	411	8	11	80	0.1375000
NODE_12297_length_793_cov_24.840058	331	411	9	25	80	0.3125000
NODE_12297_length_793_cov_24.840058	331	411	10	10	80	0.1250000
NODE_12297_length_793_cov_24.840058	331	411	11	3	80	0.0375000
NODE_12297_length_793_cov_24.840058	331	411	12	15	80	0.1875000
NODE_12297_length_793_cov_24.840058	384	464	6	8	80	0.1000000
NODE_12297_length_793_cov_24.840058	384	464	7	6	80	0.0750000
NODE_12297_length_793_cov_24.840058	384	464	9	5	80	0.0625000
NODE_12297_length_793_cov_24.840058	384	464	10	4	80	0.0500000
NODE_12297_length_793_cov_24.840058	384	464	11	4	80	0.0500000
NODE_12297_length_793_cov_24.840058	384	464	12	17	80	0.2125000
NODE_12297_length_793_cov_24.840058	384	464	13	36	80	0.4500000
NODE_12298_length_793_cov_21.707493	398	478	8	24	80	0.3000000
NODE_12298_length_793_cov_21.707493	398	478	10	21	80	0.2625000
NODE_12298_length_793_cov_21.707493	398	478	11	35	80	0.4375000
NODE_12298_length_793_cov_21.707493	451	531	4	15	80	0.1875000
NODE_12298_length_793_cov_21.707493	451	531	6	9	80	0.1125000
NODE_12298_length_793_cov_21.707493	451	531	8	14	80	0.1750000
NODE_12298_length_793_cov_21.707493	451	531	9	2	80	0.0250000
NODE_12298_length_793_cov_21.707493	451	531	10	26	80	0.3250000
NODE_12298_length_793_cov_21.707493	451	531	11	14	80	0.1750000
NODE_12299_length_793_cov_8.358790	257	337	0	6	80	0.0750000
NODE_12299_length_793_cov_8.358790	257	337	1	69	80	0.8625000
NODE_12299_length_793_cov_8.358790	257	337	3	5	80	0.0625000
NODE_12299_length_793_cov_8.358790	310	390	1	22	80	0.2750000
NODE_12299_length_793_cov_8.358790	310	390	3	11	80	0.1375000
NODE_12299_length_793_cov_8.358790	310	390	4	47	80	0.5875000
NODE_12300_length_793_cov_8.236311	477	557	0	80	80	1.0000000
NODE_12300_length_793_cov_8.236311	530	610	0	80	80	1.0000000
NODE_12302_length_793_cov_6.763689	461	541	0	80	80	1.0000000
NODE_12302_length_793_cov_6.763689	514	594	0	80	80	1.0000000
NODE_12307_length_793_cov_4.465418	501	549	0	48	48	1.0000000
NODE_12311_length_793_cov_4.138329	174	254	0	80	80	1.0000000
NODE_12311_length_793_cov_4.138329	227	307	0	80	80	1.0000000
NODE_12338_length_792_cov_40.025974	198	278	0	28	80	0.3500000
NODE_12338_length_792_cov_40.025974	198	278	1	52	80	0.6500000
NODE_12338_length_792_cov_40.025974	251	331	1	80	80	1.0000000
NODE_12338_length_792_cov_40.025974	327	408	1	53	81	0.6543210
NODE_12338_length_792_cov_40.025974	327	408	2	28	81	0.3456790
NODE_12338_length_792_cov_40.025974	381	461	1	80	80	1.0000000
NODE_12339_length_792_cov_31.176046	331	411	1	3	80	0.0375000
NODE_12339_length_792_cov_31.176046	331	411	2	32	80	0.4000000
NODE_12339_length_792_cov_31.176046	331	411	3	45	80	0.5625000
NODE_12339_length_792_cov_31.176046	384	463	2	49	79	0.6202531
NODE_12339_length_792_cov_31.176046	384	463	3	30	79	0.3797468
NODE_12339_length_792_cov_31.176046	459	539	1	3	80	0.0375000
NODE_12339_length_792_cov_31.176046	459	539	2	26	80	0.3250000
NODE_12339_length_792_cov_31.176046	459	539	3	37	80	0.4625000
NODE_12339_length_792_cov_31.176046	459	539	4	14	80	0.1750000
NODE_12339_length_792_cov_31.176046	512	546	3	30	34	0.8823529
NODE_12339_length_792_cov_31.176046	512	546	4	4	34	0.1176471
NODE_12340_length_792_cov_21.347763	303	383	1	75	80	0.9375000
NODE_12340_length_792_cov_21.347763	303	383	2	5	80	0.0625000
NODE_12340_length_792_cov_21.347763	356	436	1	80	80	1.0000000
NODE_12341_length_792_cov_20.142857	361	441	5	6	80	0.0750000
NODE_12341_length_792_cov_20.142857	361	441	6	15	80	0.1875000
NODE_12341_length_792_cov_20.142857	361	441	7	14	80	0.1750000
NODE_12341_length_792_cov_20.142857	361	441	8	45	80	0.5625000
NODE_12341_length_792_cov_20.142857	414	494	4	43	80	0.5375000
NODE_12341_length_792_cov_20.142857	414	494	6	1	80	0.0125000
NODE_12341_length_792_cov_20.142857	414	494	7	15	80	0.1875000
NODE_12341_length_792_cov_20.142857	414	494	8	21	80	0.2625000
NODE_12342_length_792_cov_18.733045	320	400	1	3	80	0.0375000
NODE_12342_length_792_cov_18.733045	320	400	2	11	80	0.1375000
NODE_12342_length_792_cov_18.733045	320	400	3	66	80	0.8250000
NODE_12342_length_792_cov_18.733045	373	453	1	4	80	0.0500000
NODE_12342_length_792_cov_18.733045	373	453	2	11	80	0.1375000
NODE_12342_length_792_cov_18.733045	373	453	3	65	80	0.8125000
NODE_12343_length_792_cov_12.024531	369	449	5	12	80	0.1500000
NODE_12343_length_792_cov_12.024531	369	449	6	24	80	0.3000000
NODE_12343_length_792_cov_12.024531	369	449	7	15	80	0.1875000
NODE_12343_length_792_cov_12.024531	369	449	8	29	80	0.3625000
NODE_12343_length_792_cov_12.024531	422	502	2	9	80	0.1125000
NODE_12343_length_792_cov_12.024531	422	502	4	30	80	0.3750000
NODE_12343_length_792_cov_12.024531	422	502	5	26	80	0.3250000
NODE_12343_length_792_cov_12.024531	422	502	6	15	80	0.1875000
NODE_12372_length_791_cov_53.573699	287	359	7	5	72	0.0694444
NODE_12372_length_791_cov_53.573699	287	359	8	2	72	0.0277778
NODE_12372_length_791_cov_53.573699	287	359	9	1	72	0.0138889
NODE_12372_length_791_cov_53.573699	287	359	10	21	72	0.2916667
NODE_12372_length_791_cov_53.573699	287	359	11	3	72	0.0416667
NODE_12372_length_791_cov_53.573699	287	359	14	3	72	0.0416667
NODE_12372_length_791_cov_53.573699	287	359	15	2	72	0.0277778
NODE_12372_length_791_cov_53.573699	287	359	16	2	72	0.0277778
NODE_12372_length_791_cov_53.573699	287	359	17	5	72	0.0694444
NODE_12372_length_791_cov_53.573699	287	359	18	8	72	0.1111111
NODE_12372_length_791_cov_53.573699	287	359	19	8	72	0.1111111
NODE_12372_length_791_cov_53.573699	287	359	20	2	72	0.0277778
NODE_12372_length_791_cov_53.573699	287	359	21	8	72	0.1111111
NODE_12372_length_791_cov_53.573699	287	359	22	2	72	0.0277778
NODE_12372_length_791_cov_53.573699	332	412	16	4	80	0.0500000
NODE_12372_length_791_cov_53.573699	332	412	17	17	80	0.2125000
NODE_12372_length_791_cov_53.573699	332	412	18	14	80	0.1750000
NODE_12372_length_791_cov_53.573699	332	412	19	12	80	0.1500000
NODE_12372_length_791_cov_53.573699	332	412	20	6	80	0.0750000
NODE_12372_length_791_cov_53.573699	332	412	21	14	80	0.1750000
NODE_12372_length_791_cov_53.573699	332	412	22	13	80	0.1625000
NODE_12373_length_791_cov_40.416185	238	318	6	4	80	0.0500000
NODE_12373_length_791_cov_40.416185	238	318	7	3	80	0.0375000
NODE_12373_length_791_cov_40.416185	238	318	8	73	80	0.9125000
NODE_12373_length_791_cov_40.416185	291	371	3	9	80	0.1125000
NODE_12373_length_791_cov_40.416185	291	371	4	8	80	0.1000000
NODE_12373_length_791_cov_40.416185	291	371	5	10	80	0.1250000
NODE_12373_length_791_cov_40.416185	291	371	6	30	80	0.3750000
NODE_12373_length_791_cov_40.416185	291	371	8	23	80	0.2875000
NODE_12374_length_791_cov_38.791908	309	389	3	18	80	0.2250000
NODE_12374_length_791_cov_38.791908	309	389	4	14	80	0.1750000
NODE_12374_length_791_cov_38.791908	309	389	6	21	80	0.2625000
NODE_12374_length_791_cov_38.791908	309	389	7	27	80	0.3375000
NODE_12374_length_791_cov_38.791908	362	442	6	74	80	0.9250000
NODE_12374_length_791_cov_38.791908	362	442	7	6	80	0.0750000
NODE_12375_length_791_cov_23.468208	328	408	4	22	80	0.2750000
NODE_12375_length_791_cov_23.468208	328	408	5	58	80	0.7250000
NODE_12375_length_791_cov_23.468208	381	461	1	15	80	0.1875000
NODE_12375_length_791_cov_23.468208	381	461	2	11	80	0.1375000
NODE_12375_length_791_cov_23.468208	381	461	3	14	80	0.1750000
NODE_12375_length_791_cov_23.468208	381	461	4	35	80	0.4375000
NODE_12375_length_791_cov_23.468208	381	461	5	5	80	0.0625000
NODE_12376_length_791_cov_20.897399	299	379	3	42	80	0.5250000
NODE_12376_length_791_cov_20.897399	299	379	5	38	80	0.4750000
NODE_12376_length_791_cov_20.897399	352	432	4	43	80	0.5375000
NODE_12376_length_791_cov_20.897399	352	432	5	34	80	0.4250000
NODE_12376_length_791_cov_20.897399	352	432	6	3	80	0.0375000
NODE_12377_length_791_cov_13.504335	339	419	2	7	80	0.0875000
NODE_12377_length_791_cov_13.504335	339	419	4	73	80	0.9125000
NODE_12377_length_791_cov_13.504335	392	472	0	13	80	0.1625000
NODE_12377_length_791_cov_13.504335	392	472	2	38	80	0.4750000
NODE_12377_length_791_cov_13.504335	392	472	4	29	80	0.3625000
NODE_12379_length_791_cov_12.547688	338	418	0	80	80	1.0000000
NODE_12379_length_791_cov_12.547688	391	471	0	80	80	1.0000000
NODE_12380_length_791_cov_11.791908	440	520	4	7	80	0.0875000
NODE_12380_length_791_cov_11.791908	440	520	5	18	80	0.2250000
NODE_12380_length_791_cov_11.791908	440	520	6	6	80	0.0750000
NODE_12380_length_791_cov_11.791908	440	520	7	2	80	0.0250000
NODE_12380_length_791_cov_11.791908	440	520	8	2	80	0.0250000
NODE_12380_length_791_cov_11.791908	440	520	9	7	80	0.0875000
NODE_12380_length_791_cov_11.791908	440	520	10	38	80	0.4750000
NODE_12380_length_791_cov_11.791908	493	573	6	12	80	0.1500000
NODE_12380_length_791_cov_11.791908	493	573	8	11	80	0.1375000
NODE_12380_length_791_cov_11.791908	493	573	9	9	80	0.1125000
NODE_12380_length_791_cov_11.791908	493	573	10	39	80	0.4875000
NODE_12380_length_791_cov_11.791908	493	573	11	9	80	0.1125000
NODE_12381_length_791_cov_11.011561	337	417	2	33	80	0.4125000
NODE_12381_length_791_cov_11.011561	337	417	4	47	80	0.5875000
NODE_12381_length_791_cov_11.011561	390	470	2	12	80	0.1500000
NODE_12381_length_791_cov_11.011561	390	470	3	4	80	0.0500000
NODE_12381_length_791_cov_11.011561	390	470	4	64	80	0.8000000
NODE_12382_length_791_cov_8.757225	325	405	1	15	80	0.1875000
NODE_12382_length_791_cov_8.757225	325	405	2	21	80	0.2625000
NODE_12382_length_791_cov_8.757225	325	405	3	18	80	0.2250000
NODE_12382_length_791_cov_8.757225	325	405	4	26	80	0.3250000
NODE_12382_length_791_cov_8.757225	378	458	1	68	80	0.8500000
NODE_12382_length_791_cov_8.757225	378	458	2	12	80	0.1500000
NODE_12384_length_791_cov_8.125723	416	496	2	3	80	0.0375000
NODE_12384_length_791_cov_8.125723	416	496	3	55	80	0.6875000
NODE_12384_length_791_cov_8.125723	416	496	4	22	80	0.2750000
NODE_12384_length_791_cov_8.125723	469	549	2	24	80	0.3000000
NODE_12384_length_791_cov_8.125723	469	549	3	56	80	0.7000000
NODE_12409_length_790_cov_48.021708	526	606	5	26	80	0.3250000
NODE_12409_length_790_cov_48.021708	526	606	6	32	80	0.4000000
NODE_12409_length_790_cov_48.021708	526	606	7	22	80	0.2750000
NODE_12409_length_790_cov_48.021708	579	659	4	16	80	0.2000000
NODE_12409_length_790_cov_48.021708	579	659	5	5	80	0.0625000
NODE_12409_length_790_cov_48.021708	579	659	6	22	80	0.2750000
NODE_12409_length_790_cov_48.021708	579	659	7	37	80	0.4625000
NODE_12410_length_790_cov_44.151954	343	423	1	80	80	1.0000000
NODE_12410_length_790_cov_44.151954	396	438	1	42	42	1.0000000
NODE_12410_length_790_cov_44.151954	696	776	3	40	80	0.5000000
NODE_12410_length_790_cov_44.151954	696	776	5	40	80	0.5000000
NODE_12411_length_790_cov_27.144718	291	371	0	11	80	0.1375000
NODE_12411_length_790_cov_27.144718	291	371	1	42	80	0.5250000
NODE_12411_length_790_cov_27.144718	291	371	2	27	80	0.3375000
NODE_12411_length_790_cov_27.144718	344	424	0	11	80	0.1375000
NODE_12411_length_790_cov_27.144718	344	424	1	69	80	0.8625000
NODE_12412_length_790_cov_16.973951	232	312	3	24	80	0.3000000
NODE_12412_length_790_cov_16.973951	232	312	4	55	80	0.6875000
NODE_12412_length_790_cov_16.973951	232	312	5	1	80	0.0125000
NODE_12412_length_790_cov_16.973951	285	365	3	18	80	0.2250000
NODE_12412_length_790_cov_16.973951	285	365	4	14	80	0.1750000
NODE_12412_length_790_cov_16.973951	285	365	5	37	80	0.4625000
NODE_12412_length_790_cov_16.973951	285	365	6	11	80	0.1375000
NODE_12413_length_790_cov_13.374819	204	284	4	36	80	0.4500000
NODE_12413_length_790_cov_13.374819	204	284	5	40	80	0.5000000
NODE_12413_length_790_cov_13.374819	204	284	6	4	80	0.0500000
NODE_12413_length_790_cov_13.374819	257	337	4	53	80	0.6625000
NODE_12413_length_790_cov_13.374819	257	337	5	27	80	0.3375000
NODE_12415_length_790_cov_10.613603	302	382	2	54	80	0.6750000
NODE_12415_length_790_cov_10.613603	302	382	4	26	80	0.3250000
NODE_12415_length_790_cov_10.613603	355	435	2	24	80	0.3000000
NODE_12415_length_790_cov_10.613603	355	435	4	56	80	0.7000000
NODE_12418_length_790_cov_5.493488	271	351	0	6	80	0.0750000
NODE_12418_length_790_cov_5.493488	271	351	2	74	80	0.9250000
NODE_12418_length_790_cov_5.493488	324	404	0	59	80	0.7375000
NODE_12418_length_790_cov_5.493488	324	404	2	21	80	0.2625000
NODE_12434_length_790_cov_1.463097	313	376	0	63	63	1.0000000
NODE_12452_length_789_cov_39.123188	226	306	2	70	80	0.8750000
NODE_12452_length_789_cov_39.123188	226	306	3	10	80	0.1250000
NODE_12452_length_789_cov_39.123188	279	359	2	48	80	0.6000000
NODE_12452_length_789_cov_39.123188	279	359	3	32	80	0.4000000
NODE_12453_length_789_cov_37.205797	423	503	0	80	80	1.0000000
NODE_12453_length_789_cov_37.205797	476	556	0	80	80	1.0000000
NODE_12454_length_789_cov_31.311594	223	303	7	2	80	0.0250000
NODE_12454_length_789_cov_31.311594	223	303	8	16	80	0.2000000
NODE_12454_length_789_cov_31.311594	223	303	9	8	80	0.1000000
NODE_12454_length_789_cov_31.311594	223	303	10	16	80	0.2000000
NODE_12454_length_789_cov_31.311594	223	303	11	16	80	0.2000000
NODE_12454_length_789_cov_31.311594	223	303	13	3	80	0.0375000
NODE_12454_length_789_cov_31.311594	223	303	14	10	80	0.1250000
NODE_12454_length_789_cov_31.311594	223	303	15	9	80	0.1125000
NODE_12454_length_789_cov_31.311594	276	356	9	5	80	0.0625000
NODE_12454_length_789_cov_31.311594	276	356	10	1	80	0.0125000
NODE_12454_length_789_cov_31.311594	276	356	11	20	80	0.2500000
NODE_12454_length_789_cov_31.311594	276	356	13	35	80	0.4375000
NODE_12454_length_789_cov_31.311594	276	356	14	10	80	0.1250000
NODE_12454_length_789_cov_31.311594	276	356	15	9	80	0.1125000
NODE_12455_length_789_cov_30.536232	306	386	6	3	80	0.0375000
NODE_12455_length_789_cov_30.536232	306	386	7	32	80	0.4000000
NODE_12455_length_789_cov_30.536232	306	386	8	11	80	0.1375000
NODE_12455_length_789_cov_30.536232	306	386	9	34	80	0.4250000
NODE_12455_length_789_cov_30.536232	359	439	4	14	80	0.1750000
NODE_12455_length_789_cov_30.536232	359	439	5	37	80	0.4625000
NODE_12455_length_789_cov_30.536232	359	439	7	5	80	0.0625000
NODE_12455_length_789_cov_30.536232	359	439	9	24	80	0.3000000
NODE_12456_length_789_cov_24.886957	343	423	4	11	80	0.1375000
NODE_12456_length_789_cov_24.886957	343	423	5	20	80	0.2500000
NODE_12456_length_789_cov_24.886957	343	423	6	49	80	0.6125000
NODE_12456_length_789_cov_24.886957	396	476	2	14	80	0.1750000
NODE_12456_length_789_cov_24.886957	396	476	4	27	80	0.3375000
NODE_12456_length_789_cov_24.886957	396	476	5	23	80	0.2875000
NODE_12456_length_789_cov_24.886957	396	476	6	16	80	0.2000000
NODE_12457_length_789_cov_23.539130	357	437	4	13	80	0.1625000
NODE_12457_length_789_cov_23.539130	357	437	5	7	80	0.0875000
NODE_12457_length_789_cov_23.539130	357	437	6	6	80	0.0750000
NODE_12457_length_789_cov_23.539130	357	437	7	16	80	0.2000000
NODE_12457_length_789_cov_23.539130	357	437	9	18	80	0.2250000
NODE_12457_length_789_cov_23.539130	357	437	10	20	80	0.2500000
NODE_12457_length_789_cov_23.539130	410	490	9	7	80	0.0875000
NODE_12457_length_789_cov_23.539130	410	490	10	73	80	0.9125000
NODE_12458_length_789_cov_16.169565	392	472	5	9	80	0.1125000
NODE_12458_length_789_cov_16.169565	392	472	6	71	80	0.8875000
NODE_12458_length_789_cov_16.169565	445	525	0	18	80	0.2250000
NODE_12458_length_789_cov_16.169565	445	525	5	44	80	0.5500000
NODE_12458_length_789_cov_16.169565	445	525	6	18	80	0.2250000
NODE_12459_length_789_cov_15.175362	242	322	1	80	80	1.0000000
NODE_12459_length_789_cov_15.175362	295	375	0	26	80	0.3250000
NODE_12459_length_789_cov_15.175362	295	375	1	54	80	0.6750000
NODE_12459_length_789_cov_15.175362	371	451	1	80	80	1.0000000
NODE_12459_length_789_cov_15.175362	424	504	1	36	80	0.4500000
NODE_12459_length_789_cov_15.175362	424	504	3	44	80	0.5500000
NODE_12460_length_789_cov_7.276812	306	386	2	80	80	1.0000000
NODE_12460_length_789_cov_7.276812	359	439	0	48	80	0.6000000
NODE_12460_length_789_cov_7.276812	359	439	2	32	80	0.4000000
NODE_12482_length_788_cov_43.091437	335	415	3	8	80	0.1000000
NODE_12482_length_788_cov_43.091437	335	415	4	19	80	0.2375000
NODE_12482_length_788_cov_43.091437	335	415	6	9	80	0.1125000
NODE_12482_length_788_cov_43.091437	335	415	7	3	80	0.0375000
NODE_12482_length_788_cov_43.091437	335	415	8	5	80	0.0625000
NODE_12482_length_788_cov_43.091437	335	415	9	36	80	0.4500000
NODE_12482_length_788_cov_43.091437	388	460	8	10	72	0.1388889
NODE_12482_length_788_cov_43.091437	388	460	9	62	72	0.8611111
NODE_12483_length_788_cov_38.914369	345	425	12	29	80	0.3625000
NODE_12483_length_788_cov_38.914369	345	425	13	1	80	0.0125000
NODE_12483_length_788_cov_38.914369	345	425	14	17	80	0.2125000
NODE_12483_length_788_cov_38.914369	345	425	15	9	80	0.1125000
NODE_12483_length_788_cov_38.914369	345	425	16	24	80	0.3000000
NODE_12483_length_788_cov_38.914369	398	478	7	9	80	0.1125000
NODE_12483_length_788_cov_38.914369	398	478	8	21	80	0.2625000
NODE_12483_length_788_cov_38.914369	398	478	10	8	80	0.1000000
NODE_12483_length_788_cov_38.914369	398	478	13	12	80	0.1500000
NODE_12483_length_788_cov_38.914369	398	478	14	18	80	0.2250000
NODE_12483_length_788_cov_38.914369	398	478	16	12	80	0.1500000
NODE_12484_length_788_cov_36.148041	320	400	2	14	80	0.1750000
NODE_12484_length_788_cov_36.148041	320	400	3	45	80	0.5625000
NODE_12484_length_788_cov_36.148041	320	400	5	9	80	0.1125000
NODE_12484_length_788_cov_36.148041	320	400	6	1	80	0.0125000
NODE_12484_length_788_cov_36.148041	320	400	7	11	80	0.1375000
NODE_12484_length_788_cov_36.148041	373	453	3	6	80	0.0750000
NODE_12484_length_788_cov_36.148041	373	453	4	2	80	0.0250000
NODE_12484_length_788_cov_36.148041	373	453	5	10	80	0.1250000
NODE_12484_length_788_cov_36.148041	373	453	6	1	80	0.0125000
NODE_12484_length_788_cov_36.148041	373	453	7	61	80	0.7625000
NODE_12485_length_788_cov_35.460087	346	426	8	27	80	0.3375000
NODE_12485_length_788_cov_35.460087	346	426	9	10	80	0.1250000
NODE_12485_length_788_cov_35.460087	346	426	10	43	80	0.5375000
NODE_12485_length_788_cov_35.460087	399	479	7	9	80	0.1125000
NODE_12485_length_788_cov_35.460087	399	479	8	18	80	0.2250000
NODE_12485_length_788_cov_35.460087	399	479	9	18	80	0.2250000
NODE_12485_length_788_cov_35.460087	399	479	10	22	80	0.2750000
NODE_12485_length_788_cov_35.460087	399	479	11	13	80	0.1625000
NODE_12486_length_788_cov_30.785196	278	358	2	24	80	0.3000000
NODE_12486_length_788_cov_30.785196	278	358	4	50	80	0.6250000
NODE_12486_length_788_cov_30.785196	278	358	6	6	80	0.0750000
NODE_12486_length_788_cov_30.785196	331	411	4	21	80	0.2625000
NODE_12486_length_788_cov_30.785196	331	411	5	23	80	0.2875000
NODE_12486_length_788_cov_30.785196	331	411	6	36	80	0.4500000
NODE_12488_length_788_cov_20.867925	300	380	2	80	80	1.0000000
NODE_12488_length_788_cov_20.867925	353	430	1	50	77	0.6493506
NODE_12488_length_788_cov_20.867925	353	430	2	27	77	0.3506494
NODE_12489_length_788_cov_20.821480	322	402	2	9	80	0.1125000
NODE_12489_length_788_cov_20.821480	322	402	3	6	80	0.0750000
NODE_12489_length_788_cov_20.821480	322	402	4	11	80	0.1375000
NODE_12489_length_788_cov_20.821480	322	402	5	2	80	0.0250000
NODE_12489_length_788_cov_20.821480	322	402	6	52	80	0.6500000
NODE_12489_length_788_cov_20.821480	375	455	2	62	80	0.7750000
NODE_12489_length_788_cov_20.821480	375	455	3	6	80	0.0750000
NODE_12489_length_788_cov_20.821480	375	455	4	8	80	0.1000000
NODE_12489_length_788_cov_20.821480	375	455	6	4	80	0.0500000
NODE_12490_length_788_cov_15.570392	342	422	0	24	80	0.3000000
NODE_12490_length_788_cov_15.570392	342	422	1	34	80	0.4250000
NODE_12490_length_788_cov_15.570392	342	422	3	2	80	0.0250000
NODE_12490_length_788_cov_15.570392	342	422	4	15	80	0.1875000
NODE_12490_length_788_cov_15.570392	342	422	5	5	80	0.0625000
NODE_12490_length_788_cov_15.570392	395	475	0	3	80	0.0375000
NODE_12490_length_788_cov_15.570392	395	475	1	2	80	0.0250000
NODE_12490_length_788_cov_15.570392	395	475	3	2	80	0.0250000
NODE_12490_length_788_cov_15.570392	395	475	4	15	80	0.1875000
NODE_12490_length_788_cov_15.570392	395	475	5	58	80	0.7250000
NODE_12491_length_788_cov_12.235123	241	321	2	15	80	0.1875000
NODE_12491_length_788_cov_12.235123	241	321	3	65	80	0.8125000
NODE_12491_length_788_cov_12.235123	294	374	1	48	80	0.6000000
NODE_12491_length_788_cov_12.235123	294	374	2	20	80	0.2500000
NODE_12491_length_788_cov_12.235123	294	374	3	12	80	0.1500000
NODE_12492_length_788_cov_10.509434	405	480	3	57	75	0.7600000
NODE_12492_length_788_cov_10.509434	405	480	4	18	75	0.2400000
NODE_12493_length_788_cov_9.737300	310	390	3	48	80	0.6000000
NODE_12493_length_788_cov_9.737300	310	390	4	21	80	0.2625000
NODE_12493_length_788_cov_9.737300	310	390	5	11	80	0.1375000
NODE_12493_length_788_cov_9.737300	363	443	2	4	80	0.0500000
NODE_12493_length_788_cov_9.737300	363	443	3	76	80	0.9500000
NODE_12494_length_788_cov_8.872279	280	360	4	16	80	0.2000000
NODE_12494_length_788_cov_8.872279	280	360	5	33	80	0.4125000
NODE_12494_length_788_cov_8.872279	280	360	7	31	80	0.3875000
NODE_12494_length_788_cov_8.872279	333	413	4	11	80	0.1375000
NODE_12494_length_788_cov_8.872279	333	413	5	57	80	0.7125000
NODE_12494_length_788_cov_8.872279	333	413	7	12	80	0.1500000
NODE_12516_length_787_cov_34.683140	274	335	0	61	61	1.0000000
NODE_12516_length_787_cov_34.683140	319	380	0	61	61	1.0000000
NODE_12517_length_787_cov_28.039244	252	329	4	22	77	0.2857143
NODE_12517_length_787_cov_28.039244	252	329	6	34	77	0.4415585
NODE_12517_length_787_cov_28.039244	252	329	7	19	77	0.2467532
NODE_12517_length_787_cov_28.039244	252	329	8	2	77	0.0259740
NODE_12517_length_787_cov_28.039244	302	370	6	6	68	0.0882353
NODE_12517_length_787_cov_28.039244	302	370	7	60	68	0.8823529
NODE_12517_length_787_cov_28.039244	302	370	8	2	68	0.0294118
NODE_12518_length_787_cov_25.422965	351	431	1	1	80	0.0125000
NODE_12518_length_787_cov_25.422965	351	431	3	30	80	0.3750000
NODE_12518_length_787_cov_25.422965	351	431	4	2	80	0.0250000
NODE_12518_length_787_cov_25.422965	351	431	6	47	80	0.5875000
NODE_12518_length_787_cov_25.422965	404	484	4	18	80	0.2250000
NODE_12518_length_787_cov_25.422965	404	484	6	46	80	0.5750000
NODE_12518_length_787_cov_25.422965	404	484	7	4	80	0.0500000
NODE_12518_length_787_cov_25.422965	404	484	8	12	80	0.1500000
NODE_12519_length_787_cov_24.857558	319	399	15	11	80	0.1375000
NODE_12519_length_787_cov_24.857558	319	399	16	13	80	0.1625000
NODE_12519_length_787_cov_24.857558	319	399	17	18	80	0.2250000
NODE_12519_length_787_cov_24.857558	319	399	18	37	80	0.4625000
NODE_12519_length_787_cov_24.857558	319	399	19	1	80	0.0125000
NODE_12519_length_787_cov_24.857558	372	452	10	18	80	0.2250000
NODE_12519_length_787_cov_24.857558	372	452	11	14	80	0.1750000
NODE_12519_length_787_cov_24.857558	372	452	13	1	80	0.0125000
NODE_12519_length_787_cov_24.857558	372	452	15	18	80	0.2250000
NODE_12519_length_787_cov_24.857558	372	452	16	15	80	0.1875000
NODE_12519_length_787_cov_24.857558	372	452	18	14	80	0.1750000
NODE_12520_length_787_cov_21.357558	291	371	4	52	80	0.6500000
NODE_12520_length_787_cov_21.357558	291	371	5	28	80	0.3500000
NODE_12520_length_787_cov_21.357558	344	424	1	6	80	0.0750000
NODE_12520_length_787_cov_21.357558	344	424	2	11	80	0.1375000
NODE_12520_length_787_cov_21.357558	344	424	4	63	80	0.7875000
NODE_12521_length_787_cov_17.360465	396	476	1	34	80	0.4250000
NODE_12521_length_787_cov_17.360465	396	476	2	18	80	0.2250000
NODE_12521_length_787_cov_17.360465	396	476	3	28	80	0.3500000
NODE_12521_length_787_cov_17.360465	449	529	1	42	80	0.5250000
NODE_12521_length_787_cov_17.360465	449	529	2	38	80	0.4750000
NODE_12522_length_787_cov_14.677326	178	258	2	34	80	0.4250000
NODE_12522_length_787_cov_14.677326	178	258	3	1	80	0.0125000
NODE_12522_length_787_cov_14.677326	178	258	5	45	80	0.5625000
NODE_12522_length_787_cov_14.677326	231	311	4	22	80	0.2750000
NODE_12522_length_787_cov_14.677326	231	311	5	58	80	0.7250000
NODE_12523_length_787_cov_12.959302	331	411	4	6	80	0.0750000
NODE_12523_length_787_cov_12.959302	331	411	5	74	80	0.9250000
NODE_12523_length_787_cov_12.959302	384	464	3	24	80	0.3000000
NODE_12523_length_787_cov_12.959302	384	464	4	18	80	0.2250000
NODE_12523_length_787_cov_12.959302	384	464	5	38	80	0.4750000
NODE_12524_length_787_cov_12.748547	426	506	4	21	80	0.2625000
NODE_12524_length_787_cov_12.748547	426	506	5	16	80	0.2000000
NODE_12524_length_787_cov_12.748547	426	506	6	20	80	0.2500000
NODE_12524_length_787_cov_12.748547	426	506	7	23	80	0.2875000
NODE_12524_length_787_cov_12.748547	479	559	2	4	80	0.0500000
NODE_12524_length_787_cov_12.748547	479	559	4	8	80	0.1000000
NODE_12524_length_787_cov_12.748547	479	559	5	65	80	0.8125000
NODE_12524_length_787_cov_12.748547	479	559	6	3	80	0.0375000
NODE_12525_length_787_cov_12.369186	338	418	2	80	80	1.0000000
NODE_12525_length_787_cov_12.369186	391	471	0	4	80	0.0500000
NODE_12525_length_787_cov_12.369186	391	471	1	7	80	0.0875000
NODE_12525_length_787_cov_12.369186	391	471	2	69	80	0.8625000
NODE_12526_length_787_cov_9.213663	376	456	0	57	80	0.7125000
NODE_12526_length_787_cov_9.213663	376	456	2	23	80	0.2875000
NODE_12527_length_787_cov_8.857558	344	424	5	41	80	0.5125000
NODE_12527_length_787_cov_8.857558	344	424	6	39	80	0.4875000
NODE_12527_length_787_cov_8.857558	397	477	4	1	80	0.0125000
NODE_12527_length_787_cov_8.857558	397	477	5	38	80	0.4750000
NODE_12527_length_787_cov_8.857558	397	477	6	41	80	0.5125000
NODE_12529_length_787_cov_8.186047	508	552	0	44	44	1.0000000
NODE_12541_length_787_cov_2.188953	505	552	0	47	47	1.0000000
NODE_12562_length_786_cov_36.441048	431	511	6	2	80	0.0250000
NODE_12562_length_786_cov_36.441048	431	511	7	7	80	0.0875000
NODE_12562_length_786_cov_36.441048	431	511	8	1	80	0.0125000
NODE_12562_length_786_cov_36.441048	431	511	9	1	80	0.0125000
NODE_12562_length_786_cov_36.441048	431	511	10	16	80	0.2000000
NODE_12562_length_786_cov_36.441048	431	511	11	6	80	0.0750000
NODE_12562_length_786_cov_36.441048	431	511	12	25	80	0.3125000
NODE_12562_length_786_cov_36.441048	431	511	13	7	80	0.0875000
NODE_12562_length_786_cov_36.441048	431	511	14	15	80	0.1875000
NODE_12562_length_786_cov_36.441048	484	564	6	9	80	0.1125000
NODE_12562_length_786_cov_36.441048	484	564	8	4	80	0.0500000
NODE_12562_length_786_cov_36.441048	484	564	10	27	80	0.3375000
NODE_12562_length_786_cov_36.441048	484	564	12	20	80	0.2500000
NODE_12562_length_786_cov_36.441048	484	564	13	7	80	0.0875000
NODE_12562_length_786_cov_36.441048	484	564	14	13	80	0.1625000
NODE_12563_length_786_cov_23.771470	235	315	4	5	80	0.0625000
NODE_12563_length_786_cov_23.771470	235	315	5	1	80	0.0125000
NODE_12563_length_786_cov_23.771470	235	315	6	15	80	0.1875000
NODE_12563_length_786_cov_23.771470	235	315	7	27	80	0.3375000
NODE_12563_length_786_cov_23.771470	235	315	8	15	80	0.1875000
NODE_12563_length_786_cov_23.771470	235	315	9	5	80	0.0625000
NODE_12563_length_786_cov_23.771470	235	315	11	12	80	0.1500000
NODE_12563_length_786_cov_23.771470	288	368	7	27	80	0.3375000
NODE_12563_length_786_cov_23.771470	288	368	8	22	80	0.2750000
NODE_12563_length_786_cov_23.771470	288	368	9	5	80	0.0625000
NODE_12563_length_786_cov_23.771470	288	368	10	1	80	0.0125000
NODE_12563_length_786_cov_23.771470	288	368	11	25	80	0.3125000
NODE_12564_length_786_cov_23.333333	361	436	0	12	75	0.1600000
NODE_12564_length_786_cov_23.333333	361	436	1	7	75	0.0933333
NODE_12564_length_786_cov_23.333333	361	436	3	19	75	0.2533333
NODE_12564_length_786_cov_23.333333	361	436	5	23	75	0.3066667
NODE_12564_length_786_cov_23.333333	361	436	6	1	75	0.0133333
NODE_12564_length_786_cov_23.333333	361	436	7	13	75	0.1733333
NODE_12564_length_786_cov_23.333333	362	436	0	11	74	0.1486486
NODE_12564_length_786_cov_23.333333	362	436	1	7	74	0.0945946
NODE_12564_length_786_cov_23.333333	362	436	3	19	74	0.2567568
NODE_12564_length_786_cov_23.333333	362	436	5	23	74	0.3108108
NODE_12564_length_786_cov_23.333333	362	436	6	1	74	0.0135135
NODE_12564_length_786_cov_23.333333	362	436	7	13	74	0.1756757
NODE_12564_length_786_cov_23.333333	375	436	1	5	61	0.0819672
NODE_12564_length_786_cov_23.333333	375	436	3	19	61	0.3114754
NODE_12564_length_786_cov_23.333333	375	436	5	23	61	0.3770492
NODE_12564_length_786_cov_23.333333	375	436	6	1	61	0.0163934
NODE_12564_length_786_cov_23.333333	375	436	7	13	61	0.2131148
NODE_12564_length_786_cov_23.333333	414	489	5	8	75	0.1066667
NODE_12564_length_786_cov_23.333333	414	489	6	1	75	0.0133333
NODE_12564_length_786_cov_23.333333	414	489	7	15	75	0.2000000
NODE_12564_length_786_cov_23.333333	414	489	8	17	75	0.2266667
NODE_12564_length_786_cov_23.333333	414	489	9	34	75	0.4533333
NODE_12564_length_786_cov_23.333333	414	489	5	8	75	0.1066667
NODE_12564_length_786_cov_23.333333	414	489	6	1	75	0.0133333
NODE_12564_length_786_cov_23.333333	414	489	7	15	75	0.2000000
NODE_12564_length_786_cov_23.333333	414	489	8	17	75	0.2266667
NODE_12564_length_786_cov_23.333333	414	489	9	34	75	0.4533333
NODE_12564_length_786_cov_23.333333	414	489	5	8	75	0.1066667
NODE_12564_length_786_cov_23.333333	414	489	6	1	75	0.0133333
NODE_12564_length_786_cov_23.333333	414	489	7	15	75	0.2000000
NODE_12564_length_786_cov_23.333333	414	489	8	17	75	0.2266667
NODE_12564_length_786_cov_23.333333	414	489	9	34	75	0.4533333
NODE_12564_length_786_cov_23.333333	490	564	5	17	74	0.2297297
NODE_12564_length_786_cov_23.333333	490	564	7	24	74	0.3243243
NODE_12564_length_786_cov_23.333333	490	564	8	29	74	0.3918919
NODE_12564_length_786_cov_23.333333	490	564	10	4	74	0.0540541
NODE_12565_length_786_cov_19.279476	310	375	0	30	65	0.4615385
NODE_12565_length_786_cov_19.279476	310	375	2	35	65	0.5384616
NODE_12565_length_786_cov_19.279476	371	441	2	18	70	0.2571429
NODE_12565_length_786_cov_19.279476	371	441	4	52	70	0.7428572
NODE_12565_length_786_cov_19.279476	371	451	2	18	80	0.2250000
NODE_12565_length_786_cov_19.279476	371	451	4	62	80	0.7750000
NODE_12565_length_786_cov_19.279476	424	491	2	29	67	0.4328358
NODE_12565_length_786_cov_19.279476	424	491	4	38	67	0.5671642
NODE_12566_length_786_cov_18.652111	251	331	2	80	80	1.0000000
NODE_12566_length_786_cov_18.652111	304	384	0	43	80	0.5375000
NODE_12566_length_786_cov_18.652111	304	384	2	37	80	0.4625000
NODE_12567_length_786_cov_16.704512	319	399	4	65	80	0.8125000
NODE_12567_length_786_cov_16.704512	319	399	5	7	80	0.0875000
NODE_12567_length_786_cov_16.704512	319	399	6	8	80	0.1000000
NODE_12567_length_786_cov_16.704512	372	452	2	29	80	0.3625000
NODE_12567_length_786_cov_16.704512	372	452	4	42	80	0.5250000
NODE_12567_length_786_cov_16.704512	372	452	5	1	80	0.0125000
NODE_12567_length_786_cov_16.704512	372	452	6	8	80	0.1000000
NODE_12568_length_786_cov_16.254731	378	458	5	2	80	0.0250000
NODE_12568_length_786_cov_16.254731	378	458	6	19	80	0.2375000
NODE_12568_length_786_cov_16.254731	378	458	7	24	80	0.3000000
NODE_12568_length_786_cov_16.254731	378	458	8	25	80	0.3125000
NODE_12568_length_786_cov_16.254731	378	458	9	10	80	0.1250000
NODE_12568_length_786_cov_16.254731	431	511	6	15	80	0.1875000
NODE_12568_length_786_cov_16.254731	431	511	7	19	80	0.2375000
NODE_12568_length_786_cov_16.254731	431	511	8	36	80	0.4500000
NODE_12568_length_786_cov_16.254731	431	511	9	10	80	0.1250000
NODE_12571_length_786_cov_10.053857	381	461	1	18	80	0.2250000
NODE_12571_length_786_cov_10.053857	381	461	2	16	80	0.2000000
NODE_12571_length_786_cov_10.053857	381	461	4	41	80	0.5125000
NODE_12571_length_786_cov_10.053857	381	461	5	5	80	0.0625000
NODE_12571_length_786_cov_10.053857	434	514	1	5	80	0.0625000
NODE_12571_length_786_cov_10.053857	434	514	3	7	80	0.0875000
NODE_12571_length_786_cov_10.053857	434	514	4	22	80	0.2750000
NODE_12571_length_786_cov_10.053857	434	514	5	46	80	0.5750000
NODE_12572_length_786_cov_7.455604	400	473	2	73	73	1.0000000
NODE_12572_length_786_cov_7.455604	453	533	0	58	80	0.7250000
NODE_12572_length_786_cov_7.455604	453	533	2	22	80	0.2750000
NODE_12573_length_786_cov_7.119360	276	356	1	8	80	0.1000000
NODE_12573_length_786_cov_7.119360	276	356	2	11	80	0.1375000
NODE_12573_length_786_cov_7.119360	276	356	3	7	80	0.0875000
NODE_12573_length_786_cov_7.119360	276	356	5	54	80	0.6750000
NODE_12573_length_786_cov_7.119360	329	409	5	54	80	0.6750000
NODE_12573_length_786_cov_7.119360	329	409	6	3	80	0.0375000
NODE_12573_length_786_cov_7.119360	329	409	7	23	80	0.2875000
NODE_12575_length_786_cov_6.771470	382	462	0	80	80	1.0000000
NODE_12575_length_786_cov_6.771470	435	515	0	80	80	1.0000000
NODE_12603_length_785_cov_83.972303	315	395	11	2	80	0.0250000
NODE_12603_length_785_cov_83.972303	315	395	12	13	80	0.1625000
NODE_12603_length_785_cov_83.972303	315	395	13	2	80	0.0250000
NODE_12603_length_785_cov_83.972303	315	395	14	21	80	0.2625000
NODE_12603_length_785_cov_83.972303	315	395	15	8	80	0.1000000
NODE_12603_length_785_cov_83.972303	315	395	16	6	80	0.0750000
NODE_12603_length_785_cov_83.972303	315	395	17	8	80	0.1000000
NODE_12603_length_785_cov_83.972303	315	395	18	20	80	0.2500000
NODE_12603_length_785_cov_83.972303	368	448	7	5	80	0.0625000
NODE_12603_length_785_cov_83.972303	368	448	8	29	80	0.3625000
NODE_12603_length_785_cov_83.972303	368	448	9	3	80	0.0375000
NODE_12603_length_785_cov_83.972303	368	448	10	1	80	0.0125000
NODE_12603_length_785_cov_83.972303	368	448	12	7	80	0.0875000
NODE_12603_length_785_cov_83.972303	368	448	13	3	80	0.0375000
NODE_12603_length_785_cov_83.972303	368	448	15	13	80	0.1625000
NODE_12603_length_785_cov_83.972303	368	448	17	8	80	0.1000000
NODE_12603_length_785_cov_83.972303	368	448	18	11	80	0.1375000
NODE_12604_length_785_cov_33.911079	477	557	3	21	80	0.2625000
NODE_12604_length_785_cov_33.911079	477	557	5	9	80	0.1125000
NODE_12604_length_785_cov_33.911079	477	557	7	50	80	0.6250000
NODE_12604_length_785_cov_33.911079	530	610	4	36	80	0.4500000
NODE_12604_length_785_cov_33.911079	530	610	5	25	80	0.3125000
NODE_12604_length_785_cov_33.911079	530	610	7	19	80	0.2375000
NODE_12605_length_785_cov_21.174927	265	299	13	5	34	0.1470588
NODE_12605_length_785_cov_21.174927	265	299	14	20	34	0.5882353
NODE_12605_length_785_cov_21.174927	265	299	15	9	34	0.2647059
NODE_12605_length_785_cov_21.174927	295	375	15	13	80	0.1625000
NODE_12605_length_785_cov_21.174927	295	375	17	4	80	0.0500000
NODE_12605_length_785_cov_21.174927	295	375	18	42	80	0.5250000
NODE_12605_length_785_cov_21.174927	295	375	19	19	80	0.2375000
NODE_12605_length_785_cov_21.174927	295	375	20	2	80	0.0250000
NODE_12605_length_785_cov_21.174927	348	428	6	18	80	0.2250000
NODE_12605_length_785_cov_21.174927	348	428	7	13	80	0.1625000
NODE_12605_length_785_cov_21.174927	348	428	9	7	80	0.0875000
NODE_12605_length_785_cov_21.174927	348	428	12	1	80	0.0125000
NODE_12605_length_785_cov_21.174927	348	428	13	1	80	0.0125000
NODE_12605_length_785_cov_21.174927	348	428	14	2	80	0.0250000
NODE_12605_length_785_cov_21.174927	348	428	16	4	80	0.0500000
NODE_12605_length_785_cov_21.174927	348	428	17	1	80	0.0125000
NODE_12605_length_785_cov_21.174927	348	428	18	10	80	0.1250000
NODE_12605_length_785_cov_21.174927	348	428	19	21	80	0.2625000
NODE_12605_length_785_cov_21.174927	348	428	20	2	80	0.0250000
NODE_12606_length_785_cov_18.612245	291	371	0	10	80	0.1250000
NODE_12606_length_785_cov_18.612245	291	371	1	3	80	0.0375000
NODE_12606_length_785_cov_18.612245	291	371	2	67	80	0.8375000
NODE_12606_length_785_cov_18.612245	344	424	2	80	80	1.0000000
NODE_12606_length_785_cov_18.612245	684	705	0	21	21	1.0000000
NODE_12607_length_785_cov_9.893586	153	233	0	5	80	0.0625000
NODE_12607_length_785_cov_9.893586	153	233	1	75	80	0.9375000
NODE_12607_length_785_cov_9.893586	206	286	1	30	80	0.3750000
NODE_12607_length_785_cov_9.893586	206	286	2	50	80	0.6250000
NODE_12645_length_784_cov_203.604380	5	85	13	5	80	0.0625000
NODE_12645_length_784_cov_203.604380	5	85	14	1	80	0.0125000
NODE_12645_length_784_cov_203.604380	5	85	15	1	80	0.0125000
NODE_12645_length_784_cov_203.604380	5	85	17	6	80	0.0750000
NODE_12645_length_784_cov_203.604380	5	85	19	10	80	0.1250000
NODE_12645_length_784_cov_203.604380	5	85	20	1	80	0.0125000
NODE_12645_length_784_cov_203.604380	5	85	22	6	80	0.0750000
NODE_12645_length_784_cov_203.604380	5	85	23	8	80	0.1000000
NODE_12645_length_784_cov_203.604380	5	85	25	6	80	0.0750000
NODE_12645_length_784_cov_203.604380	5	85	27	5	80	0.0625000
NODE_12645_length_784_cov_203.604380	5	85	29	1	80	0.0125000
NODE_12645_length_784_cov_203.604380	5	85	31	1	80	0.0125000
NODE_12645_length_784_cov_203.604380	5	85	32	19	80	0.2375000
NODE_12645_length_784_cov_203.604380	5	85	33	9	80	0.1125000
NODE_12645_length_784_cov_203.604380	5	85	34	1	80	0.0125000
NODE_12645_length_784_cov_203.604380	58	138	32	17	80	0.2125000
NODE_12645_length_784_cov_203.604380	58	138	33	9	80	0.1125000
NODE_12645_length_784_cov_203.604380	58	138	34	10	80	0.1250000
NODE_12645_length_784_cov_203.604380	58	138	36	4	80	0.0500000
NODE_12645_length_784_cov_203.604380	58	138	37	2	80	0.0250000
NODE_12645_length_784_cov_203.604380	58	138	39	1	80	0.0125000
NODE_12645_length_784_cov_203.604380	58	138	42	2	80	0.0250000
NODE_12645_length_784_cov_203.604380	58	138	43	2	80	0.0250000
NODE_12645_length_784_cov_203.604380	58	138	44	6	80	0.0750000
NODE_12645_length_784_cov_203.604380	58	138	46	3	80	0.0375000
NODE_12645_length_784_cov_203.604380	58	138	47	7	80	0.0875000
NODE_12645_length_784_cov_203.604380	58	138	49	6	80	0.0750000
NODE_12645_length_784_cov_203.604380	58	138	50	3	80	0.0375000
NODE_12645_length_784_cov_203.604380	58	138	51	3	80	0.0375000
NODE_12645_length_784_cov_203.604380	58	138	53	5	80	0.0625000
NODE_12646_length_784_cov_45.210219	49	129	0	80	80	1.0000000
NODE_12646_length_784_cov_45.210219	102	182	0	80	80	1.0000000
NODE_12646_length_784_cov_45.210219	218	298	0	80	80	1.0000000
NODE_12646_length_784_cov_45.210219	271	351	0	34	80	0.4250000
NODE_12646_length_784_cov_45.210219	271	351	1	31	80	0.3875000
NODE_12646_length_784_cov_45.210219	271	351	2	15	80	0.1875000
NODE_12646_length_784_cov_45.210219	347	427	2	80	80	1.0000000
NODE_12646_length_784_cov_45.210219	347	427	2	80	80	1.0000000
NODE_12646_length_784_cov_45.210219	347	427	2	80	80	1.0000000
NODE_12646_length_784_cov_45.210219	400	447	1	8	47	0.1702128
NODE_12646_length_784_cov_45.210219	400	447	2	39	47	0.8297873
NODE_12646_length_784_cov_45.210219	400	480	1	41	80	0.5125000
NODE_12646_length_784_cov_45.210219	400	480	2	39	80	0.4875000
NODE_12646_length_784_cov_45.210219	400	455	1	16	55	0.2909091
NODE_12646_length_784_cov_45.210219	400	455	2	39	55	0.7090909
NODE_12647_length_784_cov_33.543066	405	485	4	3	80	0.0375000
NODE_12647_length_784_cov_33.543066	405	485	6	19	80	0.2375000
NODE_12647_length_784_cov_33.543066	405	485	7	1	80	0.0125000
NODE_12647_length_784_cov_33.543066	405	485	8	29	80	0.3625000
NODE_12647_length_784_cov_33.543066	405	485	9	26	80	0.3250000
NODE_12647_length_784_cov_33.543066	405	485	11	2	80	0.0250000
NODE_12647_length_784_cov_33.543066	458	538	4	56	80	0.7000000
NODE_12647_length_784_cov_33.543066	458	538	6	16	80	0.2000000
NODE_12647_length_784_cov_33.543066	458	538	7	1	80	0.0125000
NODE_12647_length_784_cov_33.543066	458	538	8	7	80	0.0875000
NODE_12648_length_784_cov_21.762044	318	398	1	80	80	1.0000000
NODE_12648_length_784_cov_21.762044	371	451	0	1	80	0.0125000
NODE_12648_length_784_cov_21.762044	371	451	1	38	80	0.4750000
NODE_12648_length_784_cov_21.762044	371	451	2	41	80	0.5125000
NODE_12649_length_784_cov_20.583942	286	366	5	63	80	0.7875000
NODE_12649_length_784_cov_20.583942	286	366	6	14	80	0.1750000
NODE_12649_length_784_cov_20.583942	286	366	7	3	80	0.0375000
NODE_12649_length_784_cov_20.583942	339	419	4	1	80	0.0125000
NODE_12649_length_784_cov_20.583942	339	419	5	45	80	0.5625000
NODE_12649_length_784_cov_20.583942	339	419	6	9	80	0.1125000
NODE_12649_length_784_cov_20.583942	339	419	7	25	80	0.3125000
NODE_12649_length_784_cov_20.583942	415	495	2	13	80	0.1625000
NODE_12649_length_784_cov_20.583942	415	495	3	56	80	0.7000000
NODE_12649_length_784_cov_20.583942	415	495	4	8	80	0.1000000
NODE_12649_length_784_cov_20.583942	415	495	6	2	80	0.0250000
NODE_12649_length_784_cov_20.583942	415	495	7	1	80	0.0125000
NODE_12649_length_784_cov_20.583942	468	548	1	21	80	0.2625000
NODE_12649_length_784_cov_20.583942	468	548	2	28	80	0.3500000
NODE_12649_length_784_cov_20.583942	468	548	3	31	80	0.3875000
NODE_12650_length_784_cov_19.448175	217	297	6	15	80	0.1875000
NODE_12650_length_784_cov_19.448175	217	297	7	65	80	0.8125000
NODE_12650_length_784_cov_19.448175	270	350	3	35	80	0.4375000
NODE_12650_length_784_cov_19.448175	270	350	5	8	80	0.1000000
NODE_12650_length_784_cov_19.448175	270	350	6	19	80	0.2375000
NODE_12650_length_784_cov_19.448175	270	350	7	18	80	0.2250000
NODE_12652_length_784_cov_12.480292	297	377	3	5	80	0.0625000
NODE_12652_length_784_cov_12.480292	297	377	4	28	80	0.3500000
NODE_12652_length_784_cov_12.480292	297	377	5	47	80	0.5875000
NODE_12652_length_784_cov_12.480292	350	430	2	33	80	0.4125000
NODE_12652_length_784_cov_12.480292	350	430	3	25	80	0.3125000
NODE_12652_length_784_cov_12.480292	350	430	4	10	80	0.1250000
NODE_12652_length_784_cov_12.480292	350	430	5	12	80	0.1500000
NODE_12653_length_784_cov_9.296350	250	330	0	49	80	0.6125000
NODE_12653_length_784_cov_9.296350	250	330	2	31	80	0.3875000
NODE_12653_length_784_cov_9.296350	303	383	2	80	80	1.0000000
NODE_12653_length_784_cov_9.296350	379	459	1	21	80	0.2625000
NODE_12653_length_784_cov_9.296350	379	459	2	32	80	0.4000000
NODE_12653_length_784_cov_9.296350	379	459	3	27	80	0.3375000
NODE_12653_length_784_cov_9.296350	432	512	1	74	80	0.9250000
NODE_12653_length_784_cov_9.296350	432	512	3	6	80	0.0750000
NODE_12654_length_784_cov_6.316788	274	354	3	16	80	0.2000000
NODE_12654_length_784_cov_6.316788	274	354	4	61	80	0.7625000
NODE_12654_length_784_cov_6.316788	274	354	5	3	80	0.0375000
NODE_12654_length_784_cov_6.316788	327	407	4	35	80	0.4375000
NODE_12654_length_784_cov_6.316788	327	407	5	45	80	0.5625000
NODE_12688_length_783_cov_41.849415	459	539	4	9	80	0.1125000
NODE_12688_length_783_cov_41.849415	459	539	8	4	80	0.0500000
NODE_12688_length_783_cov_41.849415	459	539	9	4	80	0.0500000
NODE_12688_length_783_cov_41.849415	459	539	10	2	80	0.0250000
NODE_12688_length_783_cov_41.849415	459	539	11	13	80	0.1625000
NODE_12688_length_783_cov_41.849415	459	539	12	17	80	0.2125000
NODE_12688_length_783_cov_41.849415	459	539	13	26	80	0.3250000
NODE_12688_length_783_cov_41.849415	459	539	14	5	80	0.0625000
NODE_12688_length_783_cov_41.849415	512	592	8	4	80	0.0500000
NODE_12688_length_783_cov_41.849415	512	592	12	20	80	0.2500000
NODE_12688_length_783_cov_41.849415	512	592	13	50	80	0.6250000
NODE_12688_length_783_cov_41.849415	512	592	14	6	80	0.0750000
NODE_12689_length_783_cov_39.881579	230	310	1	53	80	0.6625000
NODE_12689_length_783_cov_39.881579	230	310	2	19	80	0.2375000
NODE_12689_length_783_cov_39.881579	230	310	4	8	80	0.1000000
NODE_12689_length_783_cov_39.881579	283	363	2	19	80	0.2375000
NODE_12689_length_783_cov_39.881579	283	363	4	31	80	0.3875000
NODE_12689_length_783_cov_39.881579	283	363	6	18	80	0.2250000
NODE_12689_length_783_cov_39.881579	283	363	7	12	80	0.1500000
NODE_12689_length_783_cov_39.881579	359	439	6	18	80	0.2250000
NODE_12689_length_783_cov_39.881579	359	439	7	37	80	0.4625000
NODE_12689_length_783_cov_39.881579	359	439	8	19	80	0.2375000
NODE_12689_length_783_cov_39.881579	359	439	9	6	80	0.0750000
NODE_12689_length_783_cov_39.881579	412	492	7	27	80	0.3375000
NODE_12689_length_783_cov_39.881579	412	492	8	32	80	0.4000000
NODE_12689_length_783_cov_39.881579	412	492	9	21	80	0.2625000
NODE_12690_length_783_cov_35.967836	229	309	3	9	80	0.1125000
NODE_12690_length_783_cov_35.967836	229	309	5	13	80	0.1625000
NODE_12690_length_783_cov_35.967836	229	309	6	58	80	0.7250000
NODE_12690_length_783_cov_35.967836	282	362	0	30	80	0.3750000
NODE_12690_length_783_cov_35.967836	282	362	1	7	80	0.0875000
NODE_12690_length_783_cov_35.967836	282	362	3	25	80	0.3125000
NODE_12690_length_783_cov_35.967836	282	362	5	13	80	0.1625000
NODE_12690_length_783_cov_35.967836	282	362	6	5	80	0.0625000
NODE_12691_length_783_cov_28.203216	292	372	1	25	80	0.3125000
NODE_12691_length_783_cov_28.203216	292	372	2	10	80	0.1250000
NODE_12691_length_783_cov_28.203216	292	372	3	45	80	0.5625000
NODE_12691_length_783_cov_28.203216	345	425	3	74	80	0.9250000
NODE_12691_length_783_cov_28.203216	345	425	4	6	80	0.0750000
NODE_12692_length_783_cov_16.695906	393	473	5	27	80	0.3375000
NODE_12692_length_783_cov_16.695906	393	473	6	53	80	0.6625000
NODE_12692_length_783_cov_16.695906	446	526	1	13	80	0.1625000
NODE_12692_length_783_cov_16.695906	446	526	2	6	80	0.0750000
NODE_12692_length_783_cov_16.695906	446	526	3	10	80	0.1250000
NODE_12692_length_783_cov_16.695906	446	526	4	4	80	0.0500000
NODE_12692_length_783_cov_16.695906	446	526	5	40	80	0.5000000
NODE_12692_length_783_cov_16.695906	446	526	6	7	80	0.0875000
NODE_12693_length_783_cov_15.656433	418	498	1	80	80	1.0000000
NODE_12693_length_783_cov_15.656433	471	551	1	30	80	0.3750000
NODE_12693_length_783_cov_15.656433	471	551	2	21	80	0.2625000
NODE_12693_length_783_cov_15.656433	471	551	3	29	80	0.3625000
NODE_12694_length_783_cov_14.904971	321	401	2	5	80	0.0625000
NODE_12694_length_783_cov_14.904971	321	401	3	57	80	0.7125000
NODE_12694_length_783_cov_14.904971	321	401	4	18	80	0.2250000
NODE_12694_length_783_cov_14.904971	374	454	2	5	80	0.0625000
NODE_12694_length_783_cov_14.904971	374	454	3	4	80	0.0500000
NODE_12694_length_783_cov_14.904971	374	454	4	68	80	0.8500000
NODE_12694_length_783_cov_14.904971	374	454	5	3	80	0.0375000
NODE_12728_length_782_cov_22.461201	347	427	3	20	80	0.2500000
NODE_12728_length_782_cov_22.461201	347	427	4	16	80	0.2000000
NODE_12728_length_782_cov_22.461201	347	427	5	27	80	0.3375000
NODE_12728_length_782_cov_22.461201	347	427	6	7	80	0.0875000
NODE_12728_length_782_cov_22.461201	347	427	7	10	80	0.1250000
NODE_12728_length_782_cov_22.461201	400	480	5	45	80	0.5625000
NODE_12728_length_782_cov_22.461201	400	480	6	25	80	0.3125000
NODE_12728_length_782_cov_22.461201	400	480	7	10	80	0.1250000
NODE_12729_length_782_cov_19.163982	306	386	0	80	80	1.0000000
NODE_12729_length_782_cov_19.163982	382	462	0	80	80	1.0000000
NODE_12729_length_782_cov_19.163982	435	515	0	80	80	1.0000000
NODE_12730_length_782_cov_19.090776	295	375	14	18	80	0.2250000
NODE_12730_length_782_cov_19.090776	295	375	15	9	80	0.1125000
NODE_12730_length_782_cov_19.090776	295	375	17	6	80	0.0750000
NODE_12730_length_782_cov_19.090776	295	375	18	26	80	0.3250000
NODE_12730_length_782_cov_19.090776	295	375	19	21	80	0.2625000
NODE_12730_length_782_cov_19.090776	348	428	9	1	80	0.0125000
NODE_12730_length_782_cov_19.090776	348	428	10	11	80	0.1375000
NODE_12730_length_782_cov_19.090776	348	428	11	2	80	0.0250000
NODE_12730_length_782_cov_19.090776	348	428	12	7	80	0.0875000
NODE_12730_length_782_cov_19.090776	348	428	13	2	80	0.0250000
NODE_12730_length_782_cov_19.090776	348	428	14	10	80	0.1250000
NODE_12730_length_782_cov_19.090776	348	428	15	15	80	0.1875000
NODE_12730_length_782_cov_19.090776	348	428	18	21	80	0.2625000
NODE_12730_length_782_cov_19.090776	348	428	19	11	80	0.1375000
NODE_12731_length_782_cov_13.509517	323	403	0	32	80	0.4000000
NODE_12731_length_782_cov_13.509517	323	403	2	4	80	0.0500000
NODE_12731_length_782_cov_13.509517	323	403	4	44	80	0.5500000
NODE_12731_length_782_cov_13.509517	376	456	0	17	80	0.2125000
NODE_12731_length_782_cov_13.509517	376	456	2	7	80	0.0875000
NODE_12731_length_782_cov_13.509517	376	456	4	56	80	0.7000000
NODE_12732_length_782_cov_11.364568	367	447	7	33	80	0.4125000
NODE_12732_length_782_cov_11.364568	367	447	8	47	80	0.5875000
NODE_12732_length_782_cov_11.364568	420	500	4	19	80	0.2375000
NODE_12732_length_782_cov_11.364568	420	500	6	10	80	0.1250000
NODE_12732_length_782_cov_11.364568	420	500	7	51	80	0.6375000
NODE_12735_length_782_cov_7.976574	245	325	1	8	80	0.1000000
NODE_12735_length_782_cov_7.976574	245	325	2	72	80	0.9000000
NODE_12735_length_782_cov_7.976574	298	378	1	8	80	0.1000000
NODE_12735_length_782_cov_7.976574	298	378	2	41	80	0.5125000
NODE_12735_length_782_cov_7.976574	298	378	3	31	80	0.3875000
NODE_12737_length_782_cov_5.500732	384	464	0	54	80	0.6750000
NODE_12737_length_782_cov_5.500732	384	464	2	26	80	0.3250000
NODE_12737_length_782_cov_5.500732	437	517	0	1	80	0.0125000
NODE_12737_length_782_cov_5.500732	437	517	2	79	80	0.9875000
NODE_12739_length_782_cov_4.434846	309	389	0	80	80	1.0000000
NODE_12739_length_782_cov_4.434846	362	442	0	68	80	0.8500000
NODE_12739_length_782_cov_4.434846	362	442	1	12	80	0.1500000
NODE_12740_length_782_cov_3.352855	177	196	0	19	19	1.0000000
NODE_12741_length_782_cov_3.231332	160	240	1	80	80	1.0000000
NODE_12741_length_782_cov_3.231332	213	298	0	7	85	0.0823529
NODE_12741_length_782_cov_3.231332	213	298	1	78	85	0.9176471
NODE_12765_length_781_cov_34.247801	174	254	11	32	80	0.4000000
NODE_12765_length_781_cov_34.247801	174	254	12	1	80	0.0125000
NODE_12765_length_781_cov_34.247801	174	254	13	21	80	0.2625000
NODE_12765_length_781_cov_34.247801	174	254	15	25	80	0.3125000
NODE_12765_length_781_cov_34.247801	174	254	16	1	80	0.0125000
NODE_12765_length_781_cov_34.247801	227	307	7	30	80	0.3750000
NODE_12765_length_781_cov_34.247801	227	307	8	2	80	0.0250000
NODE_12765_length_781_cov_34.247801	227	307	9	10	80	0.1250000
NODE_12765_length_781_cov_34.247801	227	307	11	2	80	0.0250000
NODE_12765_length_781_cov_34.247801	227	307	12	7	80	0.0875000
NODE_12765_length_781_cov_34.247801	227	307	13	7	80	0.0875000
NODE_12765_length_781_cov_34.247801	227	307	15	21	80	0.2625000
NODE_12765_length_781_cov_34.247801	227	307	16	1	80	0.0125000
NODE_12766_length_781_cov_27.530792	490	570	4	4	80	0.0500000
NODE_12766_length_781_cov_27.530792	490	570	5	6	80	0.0750000
NODE_12766_length_781_cov_27.530792	490	570	6	9	80	0.1125000
NODE_12766_length_781_cov_27.530792	490	570	8	22	80	0.2750000
NODE_12766_length_781_cov_27.530792	490	570	9	6	80	0.0750000
NODE_12766_length_781_cov_27.530792	490	570	10	9	80	0.1125000
NODE_12766_length_781_cov_27.530792	490	570	11	19	80	0.2375000
NODE_12766_length_781_cov_27.530792	490	570	12	5	80	0.0625000
NODE_12766_length_781_cov_27.530792	543	623	9	10	80	0.1250000
NODE_12766_length_781_cov_27.530792	543	623	10	10	80	0.1250000
NODE_12766_length_781_cov_27.530792	543	623	11	41	80	0.5125000
NODE_12766_length_781_cov_27.530792	543	623	12	19	80	0.2375000
NODE_12766_length_781_cov_27.530792	619	699	3	4	80	0.0500000
NODE_12766_length_781_cov_27.530792	619	699	4	9	80	0.1125000
NODE_12766_length_781_cov_27.530792	619	699	5	6	80	0.0750000
NODE_12766_length_781_cov_27.530792	619	699	6	29	80	0.3625000
NODE_12766_length_781_cov_27.530792	619	699	8	2	80	0.0250000
NODE_12766_length_781_cov_27.530792	619	699	9	6	80	0.0750000
NODE_12766_length_781_cov_27.530792	619	699	10	21	80	0.2625000
NODE_12766_length_781_cov_27.530792	619	699	11	3	80	0.0375000
NODE_12766_length_781_cov_27.530792	672	752	2	37	80	0.4625000
NODE_12766_length_781_cov_27.530792	672	752	3	20	80	0.2500000
NODE_12766_length_781_cov_27.530792	672	752	4	9	80	0.1125000
NODE_12766_length_781_cov_27.530792	672	752	5	6	80	0.0750000
NODE_12766_length_781_cov_27.530792	672	752	6	8	80	0.1000000
NODE_12767_length_781_cov_22.768328	427	507	1	4	80	0.0500000
NODE_12767_length_781_cov_22.768328	427	507	2	76	80	0.9500000
NODE_12767_length_781_cov_22.768328	480	560	1	19	80	0.2375000
NODE_12767_length_781_cov_22.768328	480	560	2	61	80	0.7625000
NODE_12768_length_781_cov_17.894428	411	491	7	8	80	0.1000000
NODE_12768_length_781_cov_17.894428	411	491	8	72	80	0.9000000
NODE_12768_length_781_cov_17.894428	464	544	0	11	80	0.1375000
NODE_12768_length_781_cov_17.894428	464	544	1	7	80	0.0875000
NODE_12768_length_781_cov_17.894428	464	544	3	19	80	0.2375000
NODE_12768_length_781_cov_17.894428	464	544	4	10	80	0.1250000
NODE_12768_length_781_cov_17.894428	464	544	5	3	80	0.0375000
NODE_12768_length_781_cov_17.894428	464	544	7	11	80	0.1375000
NODE_12768_length_781_cov_17.894428	464	544	8	19	80	0.2375000
NODE_12769_length_781_cov_14.922287	486	565	5	4	79	0.0506329
NODE_12769_length_781_cov_14.922287	486	565	6	20	79	0.2531646
NODE_12769_length_781_cov_14.922287	486	565	7	55	79	0.6962025
NODE_12769_length_781_cov_14.922287	538	618	5	35	80	0.4375000
NODE_12769_length_781_cov_14.922287	538	618	6	13	80	0.1625000
NODE_12769_length_781_cov_14.922287	538	618	7	32	80	0.4000000
NODE_12770_length_781_cov_12.529326	318	398	6	3	80	0.0375000
NODE_12770_length_781_cov_12.529326	318	398	7	69	80	0.8625000
NODE_12770_length_781_cov_12.529326	318	398	9	8	80	0.1000000
NODE_12770_length_781_cov_12.529326	371	451	2	3	80	0.0375000
NODE_12770_length_781_cov_12.529326	371	451	3	9	80	0.1125000
NODE_12770_length_781_cov_12.529326	371	451	4	18	80	0.2250000
NODE_12770_length_781_cov_12.529326	371	451	5	15	80	0.1875000
NODE_12770_length_781_cov_12.529326	371	451	6	11	80	0.1375000
NODE_12770_length_781_cov_12.529326	371	451	7	16	80	0.2000000
NODE_12770_length_781_cov_12.529326	371	451	9	8	80	0.1000000
NODE_12771_length_781_cov_10.303519	444	524	0	80	80	1.0000000
NODE_12772_length_781_cov_9.851906	374	454	4	7	80	0.0875000
NODE_12772_length_781_cov_9.851906	374	454	6	16	80	0.2000000
NODE_12772_length_781_cov_9.851906	374	454	7	57	80	0.7125000
NODE_12772_length_781_cov_9.851906	427	507	3	45	80	0.5625000
NODE_12772_length_781_cov_9.851906	427	507	7	35	80	0.4375000
NODE_12775_length_781_cov_8.557185	113	194	8	17	81	0.2098765
NODE_12775_length_781_cov_8.557185	113	194	9	24	81	0.2962963
NODE_12775_length_781_cov_8.557185	113	194	10	3	81	0.0370370
NODE_12775_length_781_cov_8.557185	113	194	12	7	81	0.0864198
NODE_12775_length_781_cov_8.557185	113	194	13	26	81	0.3209876
NODE_12775_length_781_cov_8.557185	113	194	14	4	81	0.0493827
NODE_12775_length_781_cov_8.557185	166	239	12	2	73	0.0273973
NODE_12775_length_781_cov_8.557185	166	239	13	23	73	0.3150685
NODE_12775_length_781_cov_8.557185	166	239	14	4	73	0.0547945
NODE_12775_length_781_cov_8.557185	166	239	15	4	73	0.0547945
NODE_12775_length_781_cov_8.557185	166	239	16	11	73	0.1506849
NODE_12775_length_781_cov_8.557185	166	239	18	15	73	0.2054795
NODE_12775_length_781_cov_8.557185	166	239	19	14	73	0.1917808
NODE_12778_length_781_cov_4.734604	30	110	0	80	80	1.0000000
NODE_12778_length_781_cov_4.734604	83	163	0	80	80	1.0000000
NODE_12780_length_781_cov_4.077713	269	349	0	3	80	0.0375000
NODE_12780_length_781_cov_4.077713	269	349	2	77	80	0.9625000
NODE_12780_length_781_cov_4.077713	322	402	2	80	80	1.0000000
NODE_12812_length_780_cov_37.693098	165	245	6	2	80	0.0250000
NODE_12812_length_780_cov_37.693098	165	245	7	30	80	0.3750000
NODE_12812_length_780_cov_37.693098	165	245	8	7	80	0.0875000
NODE_12812_length_780_cov_37.693098	165	245	9	3	80	0.0375000
NODE_12812_length_780_cov_37.693098	165	245	10	20	80	0.2500000
NODE_12812_length_780_cov_37.693098	165	245	11	8	80	0.1000000
NODE_12812_length_780_cov_37.693098	165	245	12	10	80	0.1250000
NODE_12812_length_780_cov_37.693098	218	298	9	3	80	0.0375000
NODE_12812_length_780_cov_37.693098	218	298	10	6	80	0.0750000
NODE_12812_length_780_cov_37.693098	218	298	11	8	80	0.1000000
NODE_12812_length_780_cov_37.693098	218	298	12	19	80	0.2375000
NODE_12812_length_780_cov_37.693098	218	298	13	29	80	0.3625000
NODE_12812_length_780_cov_37.693098	218	298	14	13	80	0.1625000
NODE_12812_length_780_cov_37.693098	218	298	15	2	80	0.0250000
NODE_12813_length_780_cov_22.132159	407	487	3	51	80	0.6375000
NODE_12813_length_780_cov_22.132159	407	487	4	1	80	0.0125000
NODE_12813_length_780_cov_22.132159	407	487	6	28	80	0.3500000
NODE_12813_length_780_cov_22.132159	460	540	5	34	80	0.4250000
NODE_12813_length_780_cov_22.132159	460	540	6	46	80	0.5750000
NODE_12814_length_780_cov_21.831131	299	379	4	12	80	0.1500000
NODE_12814_length_780_cov_21.831131	299	379	5	1	80	0.0125000
NODE_12814_length_780_cov_21.831131	299	379	6	2	80	0.0250000
NODE_12814_length_780_cov_21.831131	299	379	7	11	80	0.1375000
NODE_12814_length_780_cov_21.831131	299	379	9	20	80	0.2500000
NODE_12814_length_780_cov_21.831131	299	379	10	10	80	0.1250000
NODE_12814_length_780_cov_21.831131	299	379	11	24	80	0.3000000
NODE_12814_length_780_cov_21.831131	352	432	9	8	80	0.1000000
NODE_12814_length_780_cov_21.831131	352	432	10	42	80	0.5250000
NODE_12814_length_780_cov_21.831131	352	432	11	30	80	0.3750000
NODE_12815_length_780_cov_16.722467	165	245	0	80	80	1.0000000
NODE_12815_length_780_cov_16.722467	218	298	0	80	80	1.0000000
NODE_12816_length_780_cov_13.189427	150	254	0	104	104	1.0000000
NODE_12816_length_780_cov_13.189427	227	307	0	80	80	1.0000000
NODE_12817_length_780_cov_12.910426	276	356	0	80	80	1.0000000
NODE_12817_length_780_cov_12.910426	329	409	0	80	80	1.0000000
NODE_12818_length_780_cov_8.455213	141	221	1	58	80	0.7250000
NODE_12818_length_780_cov_8.455213	141	221	2	11	80	0.1375000
NODE_12818_length_780_cov_8.455213	141	221	3	11	80	0.1375000
NODE_12818_length_780_cov_8.455213	194	274	1	16	80	0.2000000
NODE_12818_length_780_cov_8.455213	194	274	3	64	80	0.8000000
NODE_12848_length_779_cov_51.022059	8	43	0	35	35	1.0000000
NODE_12848_length_779_cov_51.022059	53	96	0	15	43	0.3488372
NODE_12848_length_779_cov_51.022059	53	96	1	11	43	0.2558140
NODE_12848_length_779_cov_51.022059	53	96	3	15	43	0.3488372
NODE_12848_length_779_cov_51.022059	53	96	5	2	43	0.0465116
NODE_12848_length_779_cov_51.022059	97	177	5	8	80	0.1000000
NODE_12848_length_779_cov_51.022059	97	177	6	1	80	0.0125000
NODE_12848_length_779_cov_51.022059	97	177	8	71	80	0.8875000
NODE_12848_length_779_cov_51.022059	150	230	7	1	80	0.0125000
NODE_12848_length_779_cov_51.022059	150	230	8	27	80	0.3375000
NODE_12848_length_779_cov_51.022059	150	230	9	11	80	0.1375000
NODE_12848_length_779_cov_51.022059	150	230	10	41	80	0.5125000
NODE_12849_length_779_cov_23.682353	362	442	2	19	80	0.2375000
NODE_12849_length_779_cov_23.682353	362	442	3	31	80	0.3875000
NODE_12849_length_779_cov_23.682353	362	442	4	7	80	0.0875000
NODE_12849_length_779_cov_23.682353	362	442	6	23	80	0.2875000
NODE_12849_length_779_cov_23.682353	415	495	4	4	80	0.0500000
NODE_12849_length_779_cov_23.682353	415	495	6	62	80	0.7750000
NODE_12849_length_779_cov_23.682353	415	495	7	14	80	0.1750000
NODE_12850_length_779_cov_15.994118	320	400	0	9	80	0.1125000
NODE_12850_length_779_cov_15.994118	320	400	2	2	80	0.0250000
NODE_12850_length_779_cov_15.994118	320	400	4	20	80	0.2500000
NODE_12850_length_779_cov_15.994118	320	400	5	49	80	0.6125000
NODE_12850_length_779_cov_15.994118	373	453	1	28	80	0.3500000
NODE_12850_length_779_cov_15.994118	373	453	3	16	80	0.2000000
NODE_12850_length_779_cov_15.994118	373	453	5	36	80	0.4500000
NODE_12851_length_779_cov_14.386765	258	320	0	62	62	1.0000000
NODE_12851_length_779_cov_14.386765	293	368	0	75	75	1.0000000
NODE_12851_length_779_cov_14.386765	369	443	0	10	74	0.1351351
NODE_12851_length_779_cov_14.386765	369	443	1	29	74	0.3918919
NODE_12851_length_779_cov_14.386765	369	443	2	35	74	0.4729730
NODE_12852_length_779_cov_11.861765	180	263	0	46	83	0.5542169
NODE_12852_length_779_cov_11.861765	180	263	1	20	83	0.2409639
NODE_12852_length_779_cov_11.861765	180	263	2	17	83	0.2048193
NODE_12852_length_779_cov_11.861765	236	316	0	7	80	0.0875000
NODE_12852_length_779_cov_11.861765	236	316	1	73	80	0.9125000
NODE_12852_length_779_cov_11.861765	312	392	1	11	80	0.1375000
NODE_12852_length_779_cov_11.861765	312	392	3	36	80	0.4500000
NODE_12852_length_779_cov_11.861765	312	392	4	33	80	0.4125000
NODE_12852_length_779_cov_11.861765	365	445	2	9	80	0.1125000
NODE_12852_length_779_cov_11.861765	365	445	4	71	80	0.8875000
NODE_12853_length_779_cov_11.735294	285	365	1	60	80	0.7500000
NODE_12853_length_779_cov_11.735294	285	365	3	20	80	0.2500000
NODE_12853_length_779_cov_11.735294	338	418	1	7	80	0.0875000
NODE_12853_length_779_cov_11.735294	338	418	3	72	80	0.9000000
NODE_12853_length_779_cov_11.735294	338	418	4	1	80	0.0125000
NODE_12854_length_779_cov_7.211765	333	413	1	1	80	0.0125000
NODE_12854_length_779_cov_7.211765	333	413	2	13	80	0.1625000
NODE_12854_length_779_cov_7.211765	333	413	3	66	80	0.8250000
NODE_12854_length_779_cov_7.211765	386	466	0	39	80	0.4875000
NODE_12854_length_779_cov_7.211765	386	466	1	15	80	0.1875000
NODE_12854_length_779_cov_7.211765	386	466	2	13	80	0.1625000
NODE_12854_length_779_cov_7.211765	386	466	3	13	80	0.1625000
NODE_12857_length_779_cov_5.611765	271	351	1	54	80	0.6750000
NODE_12857_length_779_cov_5.611765	271	351	2	26	80	0.3250000
NODE_12857_length_779_cov_5.611765	324	404	1	77	80	0.9625000
NODE_12857_length_779_cov_5.611765	324	404	2	3	80	0.0375000
NODE_12859_length_779_cov_4.695588	216	296	0	80	80	1.0000000
NODE_12859_length_779_cov_4.695588	269	349	0	80	80	1.0000000
NODE_12863_length_779_cov_2.329412	615	672	6	11	57	0.1929825
NODE_12863_length_779_cov_2.329412	615	672	7	46	57	0.8070176
NODE_12883_length_778_cov_21.615611	325	405	3	29	80	0.3625000
NODE_12883_length_778_cov_21.615611	325	405	4	51	80	0.6375000
NODE_12883_length_778_cov_21.615611	378	458	4	80	80	1.0000000
NODE_12884_length_778_cov_19.549337	348	428	0	80	80	1.0000000
NODE_12884_length_778_cov_19.549337	401	481	0	80	80	1.0000000
NODE_12885_length_778_cov_15.403535	312	392	1	34	80	0.4250000
NODE_12885_length_778_cov_15.403535	312	392	2	46	80	0.5750000
NODE_12885_length_778_cov_15.403535	365	445	1	45	80	0.5625000
NODE_12885_length_778_cov_15.403535	365	445	2	35	80	0.4375000
NODE_12886_length_778_cov_14.614138	101	181	2	17	80	0.2125000
NODE_12886_length_778_cov_14.614138	101	181	3	10	80	0.1250000
NODE_12886_length_778_cov_14.614138	101	181	4	3	80	0.0375000
NODE_12886_length_778_cov_14.614138	101	181	6	4	80	0.0500000
NODE_12886_length_778_cov_14.614138	101	181	8	12	80	0.1500000
NODE_12886_length_778_cov_14.614138	101	181	9	34	80	0.4250000
NODE_12886_length_778_cov_14.614138	154	234	7	24	80	0.3000000
NODE_12886_length_778_cov_14.614138	154	234	8	6	80	0.0750000
NODE_12886_length_778_cov_14.614138	154	234	9	50	80	0.6250000
NODE_12887_length_778_cov_13.368189	256	336	0	26	80	0.3250000
NODE_12887_length_778_cov_13.368189	256	336	2	19	80	0.2375000
NODE_12887_length_778_cov_13.368189	256	336	4	35	80	0.4375000
NODE_12887_length_778_cov_13.368189	309	389	2	24	80	0.3000000
NODE_12887_length_778_cov_13.368189	309	389	4	56	80	0.7000000
NODE_12891_length_778_cov_6.307806	349	429	1	21	80	0.2625000
NODE_12891_length_778_cov_6.307806	349	429	3	59	80	0.7375000
NODE_12891_length_778_cov_6.307806	402	482	0	42	80	0.5250000
NODE_12891_length_778_cov_6.307806	402	482	1	32	80	0.4000000
NODE_12891_length_778_cov_6.307806	402	482	3	6	80	0.0750000
NODE_12893_length_778_cov_5.985272	385	465	2	47	80	0.5875000
NODE_12893_length_778_cov_5.985272	385	465	3	12	80	0.1500000
NODE_12893_length_778_cov_5.985272	385	465	4	21	80	0.2625000
NODE_12893_length_778_cov_5.985272	438	518	2	6	80	0.0750000
NODE_12893_length_778_cov_5.985272	438	518	4	38	80	0.4750000
NODE_12893_length_778_cov_5.985272	438	518	5	36	80	0.4500000
NODE_12928_length_777_cov_25.504425	323	403	3	45	80	0.5625000
NODE_12928_length_777_cov_25.504425	323	403	4	35	80	0.4375000
NODE_12928_length_777_cov_25.504425	376	456	1	27	80	0.3375000
NODE_12928_length_777_cov_25.504425	376	456	3	8	80	0.1000000
NODE_12928_length_777_cov_25.504425	376	456	4	45	80	0.5625000
NODE_12929_length_777_cov_25.410029	346	426	7	17	80	0.2125000
NODE_12929_length_777_cov_25.410029	346	426	8	21	80	0.2625000
NODE_12929_length_777_cov_25.410029	346	426	9	18	80	0.2250000
NODE_12929_length_777_cov_25.410029	346	426	10	24	80	0.3000000
NODE_12929_length_777_cov_25.410029	399	479	5	26	80	0.3250000
NODE_12929_length_777_cov_25.410029	399	479	7	11	80	0.1375000
NODE_12929_length_777_cov_25.410029	399	479	8	7	80	0.0875000
NODE_12929_length_777_cov_25.410029	399	479	9	4	80	0.0500000
NODE_12929_length_777_cov_25.410029	399	479	10	32	80	0.4000000
NODE_12930_length_777_cov_25.333333	97	177	0	45	80	0.5625000
NODE_12930_length_777_cov_25.333333	97	177	3	14	80	0.1750000
NODE_12930_length_777_cov_25.333333	97	177	4	6	80	0.0750000
NODE_12930_length_777_cov_25.333333	97	177	5	15	80	0.1875000
NODE_12930_length_777_cov_25.333333	150	230	3	6	80	0.0750000
NODE_12930_length_777_cov_25.333333	150	230	4	6	80	0.0750000
NODE_12930_length_777_cov_25.333333	150	230	5	20	80	0.2500000
NODE_12930_length_777_cov_25.333333	150	230	6	4	80	0.0500000
NODE_12930_length_777_cov_25.333333	150	230	7	30	80	0.3750000
NODE_12930_length_777_cov_25.333333	150	230	8	14	80	0.1750000
NODE_12931_length_777_cov_21.600295	408	485	3	23	77	0.2987013
NODE_12931_length_777_cov_21.600295	408	485	4	54	77	0.7012987
NODE_12931_length_777_cov_21.600295	458	538	3	12	80	0.1500000
NODE_12931_length_777_cov_21.600295	458	538	4	68	80	0.8500000
NODE_12932_length_777_cov_19.561947	343	423	6	3	80	0.0375000
NODE_12932_length_777_cov_19.561947	343	423	7	59	80	0.7375000
NODE_12932_length_777_cov_19.561947	343	423	8	18	80	0.2250000
NODE_12932_length_777_cov_19.561947	396	476	4	27	80	0.3375000
NODE_12932_length_777_cov_19.561947	396	476	6	29	80	0.3625000
NODE_12932_length_777_cov_19.561947	396	476	7	21	80	0.2625000
NODE_12932_length_777_cov_19.561947	396	476	8	3	80	0.0375000
NODE_12933_length_777_cov_16.961652	264	344	0	18	80	0.2250000
NODE_12933_length_777_cov_16.961652	264	344	1	62	80	0.7750000
NODE_12933_length_777_cov_16.961652	317	397	1	33	80	0.4125000
NODE_12933_length_777_cov_16.961652	317	397	2	47	80	0.5875000
NODE_12934_length_777_cov_16.081121	299	379	0	4	80	0.0500000
NODE_12934_length_777_cov_16.081121	299	379	1	76	80	0.9500000
NODE_12934_length_777_cov_16.081121	352	432	1	80	80	1.0000000
NODE_12935_length_777_cov_13.827434	380	460	2	26	80	0.3250000
NODE_12935_length_777_cov_13.827434	380	460	3	19	80	0.2375000
NODE_12935_length_777_cov_13.827434	380	460	4	14	80	0.1750000
NODE_12935_length_777_cov_13.827434	380	460	5	21	80	0.2625000
NODE_12935_length_777_cov_13.827434	433	513	4	18	80	0.2250000
NODE_12935_length_777_cov_13.827434	433	513	5	52	80	0.6500000
NODE_12935_length_777_cov_13.827434	433	513	6	10	80	0.1250000
NODE_12936_length_777_cov_12.497050	413	493	2	40	80	0.5000000
NODE_12936_length_777_cov_12.497050	413	493	3	14	80	0.1750000
NODE_12936_length_777_cov_12.497050	413	493	4	26	80	0.3250000
NODE_12936_length_777_cov_12.497050	466	546	2	50	80	0.6250000
NODE_12936_length_777_cov_12.497050	466	546	3	30	80	0.3750000
NODE_12937_length_777_cov_10.787611	213	286	0	17	73	0.2328767
NODE_12937_length_777_cov_10.787611	213	286	1	33	73	0.4520548
NODE_12937_length_777_cov_10.787611	213	286	3	11	73	0.1506849
NODE_12937_length_777_cov_10.787611	213	286	4	4	73	0.0547945
NODE_12937_length_777_cov_10.787611	213	286	5	8	73	0.1095890
NODE_12938_length_777_cov_8.530973	362	422	6	34	60	0.5666667
NODE_12938_length_777_cov_8.530973	362	422	8	26	60	0.4333333
NODE_12939_length_777_cov_7.634218	79	159	7	34	80	0.4250000
NODE_12939_length_777_cov_7.634218	79	159	8	41	80	0.5125000
NODE_12939_length_777_cov_7.634218	79	159	9	5	80	0.0625000
NODE_12939_length_777_cov_7.634218	132	212	3	14	80	0.1750000
NODE_12939_length_777_cov_7.634218	132	212	4	2	80	0.0250000
NODE_12939_length_777_cov_7.634218	132	212	6	20	80	0.2500000
NODE_12939_length_777_cov_7.634218	132	212	7	16	80	0.2000000
NODE_12939_length_777_cov_7.634218	132	212	8	23	80	0.2875000
NODE_12939_length_777_cov_7.634218	132	212	9	5	80	0.0625000
NODE_12940_length_777_cov_6.963127	256	336	0	80	80	1.0000000
NODE_12940_length_777_cov_6.963127	309	389	0	80	80	1.0000000
NODE_12941_length_777_cov_6.417404	565	638	0	73	73	1.0000000
NODE_12942_length_777_cov_5.868732	443	523	0	80	80	1.0000000
NODE_12942_length_777_cov_5.868732	496	576	0	80	80	1.0000000
NODE_12971_length_776_cov_81.002954	237	317	0	67	80	0.8375000
NODE_12971_length_776_cov_81.002954	237	317	1	1	80	0.0125000
NODE_12971_length_776_cov_81.002954	237	317	3	2	80	0.0250000
NODE_12971_length_776_cov_81.002954	237	317	6	1	80	0.0125000
NODE_12971_length_776_cov_81.002954	237	317	8	2	80	0.0250000
NODE_12971_length_776_cov_81.002954	237	317	9	2	80	0.0250000
NODE_12971_length_776_cov_81.002954	237	317	10	5	80	0.0625000
NODE_12971_length_776_cov_81.002954	290	370	0	80	80	1.0000000
NODE_12972_length_776_cov_40.502216	345	425	12	7	80	0.0875000
NODE_12972_length_776_cov_40.502216	345	425	14	24	80	0.3000000
NODE_12972_length_776_cov_40.502216	345	425	15	30	80	0.3750000
NODE_12972_length_776_cov_40.502216	345	425	16	6	80	0.0750000
NODE_12972_length_776_cov_40.502216	345	425	17	13	80	0.1625000
NODE_12972_length_776_cov_40.502216	398	478	7	22	80	0.2750000
NODE_12972_length_776_cov_40.502216	398	478	9	4	80	0.0500000
NODE_12972_length_776_cov_40.502216	398	478	10	9	80	0.1125000
NODE_12972_length_776_cov_40.502216	398	478	11	1	80	0.0125000
NODE_12972_length_776_cov_40.502216	398	478	12	15	80	0.1875000
NODE_12972_length_776_cov_40.502216	398	478	14	12	80	0.1500000
NODE_12972_length_776_cov_40.502216	398	478	15	15	80	0.1875000
NODE_12972_length_776_cov_40.502216	398	478	17	2	80	0.0250000
NODE_12973_length_776_cov_34.921713	204	284	8	1	80	0.0125000
NODE_12973_length_776_cov_34.921713	204	284	9	16	80	0.2000000
NODE_12973_length_776_cov_34.921713	204	284	10	52	80	0.6500000
NODE_12973_length_776_cov_34.921713	204	284	11	11	80	0.1375000
NODE_12973_length_776_cov_34.921713	257	337	5	1	80	0.0125000
NODE_12973_length_776_cov_34.921713	257	337	7	35	80	0.4375000
NODE_12973_length_776_cov_34.921713	257	337	8	1	80	0.0125000
NODE_12973_length_776_cov_34.921713	257	337	9	29	80	0.3625000
NODE_12973_length_776_cov_34.921713	257	337	10	13	80	0.1625000
NODE_12973_length_776_cov_34.921713	257	337	11	1	80	0.0125000
NODE_12974_length_776_cov_29.998523	177	257	5	16	80	0.2000000
NODE_12974_length_776_cov_29.998523	177	257	6	3	80	0.0375000
NODE_12974_length_776_cov_29.998523	177	257	8	32	80	0.4000000
NODE_12974_length_776_cov_29.998523	177	257	9	4	80	0.0500000
NODE_12974_length_776_cov_29.998523	177	257	10	25	80	0.3125000
NODE_12974_length_776_cov_29.998523	230	310	4	17	80	0.2125000
NODE_12974_length_776_cov_29.998523	230	310	5	11	80	0.1375000
NODE_12974_length_776_cov_29.998523	230	310	6	2	80	0.0250000
NODE_12974_length_776_cov_29.998523	230	310	7	1	80	0.0125000
NODE_12974_length_776_cov_29.998523	230	310	8	15	80	0.1875000
NODE_12974_length_776_cov_29.998523	230	310	9	11	80	0.1375000
NODE_12974_length_776_cov_29.998523	230	310	10	23	80	0.2875000
NODE_12975_length_776_cov_25.683900	417	497	0	20	80	0.2500000
NODE_12975_length_776_cov_25.683900	417	497	2	60	80	0.7500000
NODE_12975_length_776_cov_25.683900	470	550	2	80	80	1.0000000
NODE_12976_length_776_cov_22.276219	367	447	5	36	80	0.4500000
NODE_12976_length_776_cov_22.276219	367	447	6	14	80	0.1750000
NODE_12976_length_776_cov_22.276219	367	447	7	30	80	0.3750000
NODE_12976_length_776_cov_22.276219	420	500	4	2	80	0.0250000
NODE_12976_length_776_cov_22.276219	420	500	5	27	80	0.3375000
NODE_12976_length_776_cov_22.276219	420	500	6	19	80	0.2375000
NODE_12976_length_776_cov_22.276219	420	500	7	15	80	0.1875000
NODE_12976_length_776_cov_22.276219	420	500	8	17	80	0.2125000
NODE_12977_length_776_cov_19.574594	242	322	2	2	80	0.0250000
NODE_12977_length_776_cov_19.574594	242	322	3	9	80	0.1125000
NODE_12977_length_776_cov_19.574594	242	322	5	10	80	0.1250000
NODE_12977_length_776_cov_19.574594	242	322	8	6	80	0.0750000
NODE_12977_length_776_cov_19.574594	242	322	9	30	80	0.3750000
NODE_12977_length_776_cov_19.574594	242	322	10	23	80	0.2875000
NODE_12977_length_776_cov_19.574594	295	375	9	28	80	0.3500000
NODE_12977_length_776_cov_19.574594	295	375	10	30	80	0.3750000
NODE_12977_length_776_cov_19.574594	295	375	11	22	80	0.2750000
NODE_12978_length_776_cov_18.262925	384	464	0	3	80	0.0375000
NODE_12978_length_776_cov_18.262925	384	464	1	4	80	0.0500000
NODE_12978_length_776_cov_18.262925	384	464	2	73	80	0.9125000
NODE_12978_length_776_cov_18.262925	437	517	2	80	80	1.0000000
NODE_12979_length_776_cov_16.023634	334	414	3	6	80	0.0750000
NODE_12979_length_776_cov_16.023634	334	414	5	37	80	0.4625000
NODE_12979_length_776_cov_16.023634	334	414	7	10	80	0.1250000
NODE_12979_length_776_cov_16.023634	334	414	8	27	80	0.3375000
NODE_12979_length_776_cov_16.023634	387	467	3	12	80	0.1500000
NODE_12979_length_776_cov_16.023634	387	467	4	31	80	0.3875000
NODE_12979_length_776_cov_16.023634	387	467	6	1	80	0.0125000
NODE_12979_length_776_cov_16.023634	387	467	8	36	80	0.4500000
NODE_12980_length_776_cov_15.841950	282	362	4	61	80	0.7625000
NODE_12980_length_776_cov_15.841950	282	362	5	10	80	0.1250000
NODE_12980_length_776_cov_15.841950	282	362	7	9	80	0.1125000
NODE_12980_length_776_cov_15.841950	335	415	4	8	80	0.1000000
NODE_12980_length_776_cov_15.841950	335	415	5	10	80	0.1250000
NODE_12980_length_776_cov_15.841950	335	415	6	36	80	0.4500000
NODE_12980_length_776_cov_15.841950	335	415	7	16	80	0.2000000
NODE_12980_length_776_cov_15.841950	335	415	8	10	80	0.1250000
NODE_12981_length_776_cov_14.131462	240	320	0	80	80	1.0000000
NODE_12981_length_776_cov_14.131462	293	373	0	52	80	0.6500000
NODE_12981_length_776_cov_14.131462	293	373	1	11	80	0.1375000
NODE_12981_length_776_cov_14.131462	293	373	2	17	80	0.2125000
NODE_12981_length_776_cov_14.131462	369	449	2	80	80	1.0000000
NODE_12981_length_776_cov_14.131462	422	502	1	7	80	0.0875000
NODE_12981_length_776_cov_14.131462	422	502	2	73	80	0.9125000
NODE_12983_length_776_cov_13.890694	302	382	4	80	80	1.0000000
NODE_12983_length_776_cov_13.890694	355	435	0	34	80	0.4250000
NODE_12983_length_776_cov_13.890694	355	435	2	19	80	0.2375000
NODE_12983_length_776_cov_13.890694	355	435	4	27	80	0.3375000
NODE_12984_length_776_cov_12.097489	488	568	2	80	80	1.0000000
NODE_12984_length_776_cov_12.097489	541	621	0	52	80	0.6500000
NODE_12984_length_776_cov_12.097489	541	621	2	28	80	0.3500000
NODE_12985_length_776_cov_11.923191	422	498	3	6	76	0.0789474
NODE_12985_length_776_cov_11.923191	422	498	4	31	76	0.4078947
NODE_12985_length_776_cov_11.923191	422	498	5	39	76	0.5131579
NODE_12985_length_776_cov_11.923191	475	551	3	6	76	0.0789474
NODE_12985_length_776_cov_11.923191	475	551	4	20	76	0.2631579
NODE_12985_length_776_cov_11.923191	475	551	5	50	76	0.6578947
NODE_12986_length_776_cov_11.163959	312	392	6	10	80	0.1250000
NODE_12986_length_776_cov_11.163959	312	392	8	5	80	0.0625000
NODE_12986_length_776_cov_11.163959	312	392	9	38	80	0.4750000
NODE_12986_length_776_cov_11.163959	312	392	11	22	80	0.2750000
NODE_12986_length_776_cov_11.163959	312	392	12	5	80	0.0625000
NODE_12986_length_776_cov_11.163959	365	445	10	37	80	0.4625000
NODE_12986_length_776_cov_11.163959	365	445	11	37	80	0.4625000
NODE_12986_length_776_cov_11.163959	365	445	12	6	80	0.0750000
NODE_12987_length_776_cov_9.754801	370	450	0	12	80	0.1500000
NODE_12987_length_776_cov_9.754801	370	450	2	68	80	0.8500000
NODE_12987_length_776_cov_9.754801	423	503	0	3	80	0.0375000
NODE_12987_length_776_cov_9.754801	423	503	2	77	80	0.9625000
NODE_12989_length_776_cov_8.271787	332	412	3	4	80	0.0500000
NODE_12989_length_776_cov_8.271787	332	412	4	9	80	0.1125000
NODE_12989_length_776_cov_8.271787	332	412	5	44	80	0.5500000
NODE_12989_length_776_cov_8.271787	332	412	6	23	80	0.2875000
NODE_12989_length_776_cov_8.271787	385	465	3	25	80	0.3125000
NODE_12989_length_776_cov_8.271787	385	465	4	37	80	0.4625000
NODE_12989_length_776_cov_8.271787	385	465	5	18	80	0.2250000
NODE_12990_length_776_cov_4.874446	330	410	0	54	80	0.6750000
NODE_12990_length_776_cov_4.874446	330	410	2	26	80	0.3250000
NODE_12990_length_776_cov_4.874446	383	463	0	1	80	0.0125000
NODE_12990_length_776_cov_4.874446	383	463	2	79	80	0.9875000
NODE_13022_length_775_cov_33.612426	372	452	2	1	80	0.0125000
NODE_13022_length_775_cov_33.612426	372	452	4	5	80	0.0625000
NODE_13022_length_775_cov_33.612426	372	452	6	37	80	0.4625000
NODE_13022_length_775_cov_33.612426	372	452	7	37	80	0.4625000
NODE_13022_length_775_cov_33.612426	425	505	5	39	80	0.4875000
NODE_13022_length_775_cov_33.612426	425	505	6	28	80	0.3500000
NODE_13022_length_775_cov_33.612426	425	505	7	13	80	0.1625000
NODE_13023_length_775_cov_25.500000	361	434	2	8	73	0.1095890
NODE_13023_length_775_cov_25.500000	361	434	4	39	73	0.5342466
NODE_13023_length_775_cov_25.500000	361	434	5	26	73	0.3561644
NODE_13023_length_775_cov_25.500000	413	487	2	10	74	0.1351351
NODE_13023_length_775_cov_25.500000	413	487	4	64	74	0.8648649
NODE_13024_length_775_cov_24.128698	220	300	4	9	80	0.1125000
NODE_13024_length_775_cov_24.128698	220	300	5	8	80	0.1000000
NODE_13024_length_775_cov_24.128698	220	300	6	30	80	0.3750000
NODE_13024_length_775_cov_24.128698	220	300	7	33	80	0.4125000
NODE_13024_length_775_cov_24.128698	273	353	2	4	80	0.0500000
NODE_13024_length_775_cov_24.128698	273	353	4	17	80	0.2125000
NODE_13024_length_775_cov_24.128698	273	353	5	31	80	0.3875000
NODE_13024_length_775_cov_24.128698	273	353	6	9	80	0.1125000
NODE_13024_length_775_cov_24.128698	273	353	7	19	80	0.2375000
NODE_13026_length_775_cov_16.165680	358	438	2	22	80	0.2750000
NODE_13026_length_775_cov_16.165680	358	438	3	58	80	0.7250000
NODE_13026_length_775_cov_16.165680	411	491	2	29	80	0.3625000
NODE_13026_length_775_cov_16.165680	411	491	3	44	80	0.5500000
NODE_13026_length_775_cov_16.165680	411	491	4	4	80	0.0500000
NODE_13026_length_775_cov_16.165680	411	491	5	3	80	0.0375000
NODE_13027_length_775_cov_8.522189	440	520	0	25	80	0.3125000
NODE_13027_length_775_cov_8.522189	440	520	1	55	80	0.6875000
NODE_13027_length_775_cov_8.522189	493	573	0	50	80	0.6250000
NODE_13027_length_775_cov_8.522189	493	573	1	8	80	0.1000000
NODE_13027_length_775_cov_8.522189	493	573	2	22	80	0.2750000
NODE_13028_length_775_cov_8.258876	247	327	0	30	80	0.3750000
NODE_13028_length_775_cov_8.258876	247	327	2	50	80	0.6250000
NODE_13028_length_775_cov_8.258876	300	380	2	80	80	1.0000000
NODE_13031_length_775_cov_3.786982	299	379	0	27	80	0.3375000
NODE_13031_length_775_cov_3.786982	299	379	1	19	80	0.2375000
NODE_13031_length_775_cov_3.786982	299	379	2	34	80	0.4250000
NODE_13031_length_775_cov_3.786982	352	432	2	80	80	1.0000000
NODE_13059_length_774_cov_27.386667	433	514	6	27	81	0.3333333
NODE_13059_length_774_cov_27.386667	433	514	7	4	81	0.0493827
NODE_13059_length_774_cov_27.386667	433	514	8	11	81	0.1358025
NODE_13059_length_774_cov_27.386667	433	514	9	39	81	0.4814815
NODE_13059_length_774_cov_27.386667	487	567	7	5	80	0.0625000
NODE_13059_length_774_cov_27.386667	487	567	8	2	80	0.0250000
NODE_13059_length_774_cov_27.386667	487	567	9	29	80	0.3625000
NODE_13059_length_774_cov_27.386667	487	567	10	44	80	0.5500000
NODE_13060_length_774_cov_19.721481	239	319	4	35	80	0.4375000
NODE_13060_length_774_cov_19.721481	239	319	5	23	80	0.2875000
NODE_13060_length_774_cov_19.721481	239	319	6	22	80	0.2750000
NODE_13060_length_774_cov_19.721481	292	372	5	5	80	0.0625000
NODE_13060_length_774_cov_19.721481	292	372	6	62	80	0.7750000
NODE_13060_length_774_cov_19.721481	292	372	7	13	80	0.1625000
NODE_13063_length_774_cov_4.594074	216	294	1	39	78	0.5000000
NODE_13063_length_774_cov_4.594074	216	294	2	8	78	0.1025641
NODE_13063_length_774_cov_4.594074	216	294	3	21	78	0.2692308
NODE_13063_length_774_cov_4.594074	216	294	4	10	78	0.1282051
NODE_13063_length_774_cov_4.594074	269	347	3	15	78	0.1923077
NODE_13063_length_774_cov_4.594074	269	347	4	63	78	0.8076923
NODE_13063_length_774_cov_4.594074	405	485	1	51	80	0.6375000
NODE_13063_length_774_cov_4.594074	405	485	2	21	80	0.2625000
NODE_13063_length_774_cov_4.594074	405	485	3	8	80	0.1000000
NODE_13103_length_773_cov_60.566766	249	328	2	8	79	0.1012658
NODE_13103_length_773_cov_60.566766	249	328	3	28	79	0.3544304
NODE_13103_length_773_cov_60.566766	249	328	5	3	79	0.0379747
NODE_13103_length_773_cov_60.566766	249	328	7	15	79	0.1898734
NODE_13103_length_773_cov_60.566766	249	328	9	17	79	0.2151899
NODE_13103_length_773_cov_60.566766	249	328	10	8	79	0.1012658
NODE_13103_length_773_cov_60.566766	304	381	9	29	77	0.3766234
NODE_13103_length_773_cov_60.566766	304	381	10	48	77	0.6233766
NODE_13104_length_773_cov_27.299703	230	310	1	34	80	0.4250000
NODE_13104_length_773_cov_27.299703	230	310	2	13	80	0.1625000
NODE_13104_length_773_cov_27.299703	230	310	3	22	80	0.2750000
NODE_13104_length_773_cov_27.299703	230	310	4	9	80	0.1125000
NODE_13104_length_773_cov_27.299703	230	310	5	2	80	0.0250000
NODE_13104_length_773_cov_27.299703	283	363	3	16	80	0.2000000
NODE_13104_length_773_cov_27.299703	283	363	4	9	80	0.1125000
NODE_13104_length_773_cov_27.299703	283	363	5	5	80	0.0625000
NODE_13104_length_773_cov_27.299703	283	363	6	48	80	0.6000000
NODE_13104_length_773_cov_27.299703	283	363	7	2	80	0.0250000
NODE_13105_length_773_cov_24.250742	392	470	3	23	78	0.2948718
NODE_13105_length_773_cov_24.250742	392	470	4	22	78	0.2820513
NODE_13105_length_773_cov_24.250742	392	470	5	6	78	0.0769231
NODE_13105_length_773_cov_24.250742	392	470	6	27	78	0.3461539
NODE_13105_length_773_cov_24.250742	443	523	2	7	80	0.0875000
NODE_13105_length_773_cov_24.250742	443	523	3	55	80	0.6875000
NODE_13105_length_773_cov_24.250742	443	523	4	18	80	0.2250000
NODE_13106_length_773_cov_20.683976	367	447	3	27	80	0.3375000
NODE_13106_length_773_cov_20.683976	367	447	4	53	80	0.6625000
NODE_13106_length_773_cov_20.683976	420	500	2	8	80	0.1000000
NODE_13106_length_773_cov_20.683976	420	500	3	25	80	0.3125000
NODE_13106_length_773_cov_20.683976	420	500	4	47	80	0.5875000
NODE_13107_length_773_cov_18.498516	248	328	3	7	80	0.0875000
NODE_13107_length_773_cov_18.498516	248	328	4	22	80	0.2750000
NODE_13107_length_773_cov_18.498516	248	328	5	19	80	0.2375000
NODE_13107_length_773_cov_18.498516	248	328	6	32	80	0.4000000
NODE_13107_length_773_cov_18.498516	301	381	2	9	80	0.1125000
NODE_13107_length_773_cov_18.498516	301	381	3	10	80	0.1250000
NODE_13107_length_773_cov_18.498516	301	381	4	46	80	0.5750000
NODE_13107_length_773_cov_18.498516	301	381	5	15	80	0.1875000
NODE_13108_length_773_cov_14.063798	405	485	3	5	80	0.0625000
NODE_13108_length_773_cov_14.063798	405	485	4	38	80	0.4750000
NODE_13108_length_773_cov_14.063798	405	485	5	37	80	0.4625000
NODE_13108_length_773_cov_14.063798	458	538	4	4	80	0.0500000
NODE_13108_length_773_cov_14.063798	458	538	5	76	80	0.9500000
NODE_13109_length_773_cov_12.482196	421	501	0	5	80	0.0625000
NODE_13109_length_773_cov_12.482196	421	501	1	35	80	0.4375000
NODE_13109_length_773_cov_12.482196	421	501	2	40	80	0.5000000
NODE_13109_length_773_cov_12.482196	474	554	2	80	80	1.0000000
NODE_13114_length_773_cov_9.136499	214	294	1	12	80	0.1500000
NODE_13114_length_773_cov_9.136499	214	294	2	65	80	0.8125000
NODE_13114_length_773_cov_9.136499	214	294	3	3	80	0.0375000
NODE_13114_length_773_cov_9.136499	267	347	0	14	80	0.1750000
NODE_13114_length_773_cov_9.136499	267	347	1	51	80	0.6375000
NODE_13114_length_773_cov_9.136499	267	347	2	15	80	0.1875000
NODE_13115_length_773_cov_8.609792	461	541	3	9	80	0.1125000
NODE_13115_length_773_cov_8.609792	461	541	4	49	80	0.6125000
NODE_13115_length_773_cov_8.609792	461	541	5	22	80	0.2750000
NODE_13115_length_773_cov_8.609792	514	594	3	17	80	0.2125000
NODE_13115_length_773_cov_8.609792	514	594	4	5	80	0.0625000
NODE_13115_length_773_cov_8.609792	514	594	5	58	80	0.7250000
NODE_13116_length_773_cov_7.224036	200	280	3	27	80	0.3375000
NODE_13116_length_773_cov_7.224036	200	280	5	10	80	0.1250000
NODE_13116_length_773_cov_7.224036	200	280	8	1	80	0.0125000
NODE_13116_length_773_cov_7.224036	200	280	9	37	80	0.4625000
NODE_13116_length_773_cov_7.224036	200	280	10	5	80	0.0625000
NODE_13116_length_773_cov_7.224036	253	333	7	6	80	0.0750000
NODE_13116_length_773_cov_7.224036	253	333	8	12	80	0.1500000
NODE_13116_length_773_cov_7.224036	253	333	9	57	80	0.7125000
NODE_13116_length_773_cov_7.224036	253	333	10	5	80	0.0625000
NODE_13117_length_773_cov_6.910979	522	615	0	60	93	0.6451613
NODE_13117_length_773_cov_6.910979	522	615	1	24	93	0.2580645
NODE_13117_length_773_cov_6.910979	522	615	2	9	93	0.0967742
NODE_13117_length_773_cov_6.910979	588	668	1	18	80	0.2250000
NODE_13117_length_773_cov_6.910979	588	668	2	62	80	0.7750000
NODE_13147_length_772_cov_28.044577	231	311	7	37	80	0.4625000
NODE_13147_length_772_cov_28.044577	231	311	8	12	80	0.1500000
NODE_13147_length_772_cov_28.044577	231	311	9	31	80	0.3875000
NODE_13147_length_772_cov_28.044577	284	364	2	4	80	0.0500000
NODE_13147_length_772_cov_28.044577	284	364	3	9	80	0.1125000
NODE_13147_length_772_cov_28.044577	284	364	4	11	80	0.1375000
NODE_13147_length_772_cov_28.044577	284	364	6	1	80	0.0125000
NODE_13147_length_772_cov_28.044577	284	364	7	5	80	0.0625000
NODE_13147_length_772_cov_28.044577	284	364	8	6	80	0.0750000
NODE_13147_length_772_cov_28.044577	284	364	9	44	80	0.5500000
NODE_13149_length_772_cov_9.523031	288	368	2	21	80	0.2625000
NODE_13149_length_772_cov_9.523031	288	368	3	31	80	0.3875000
NODE_13149_length_772_cov_9.523031	288	368	4	9	80	0.1125000
NODE_13149_length_772_cov_9.523031	288	368	5	19	80	0.2375000
NODE_13149_length_772_cov_9.523031	341	421	4	8	80	0.1000000
NODE_13149_length_772_cov_9.523031	341	421	5	62	80	0.7750000
NODE_13149_length_772_cov_9.523031	341	421	6	8	80	0.1000000
NODE_13149_length_772_cov_9.523031	341	421	7	2	80	0.0250000
NODE_13150_length_772_cov_8.778603	133	213	0	60	80	0.7500000
NODE_13150_length_772_cov_8.778603	133	213	1	20	80	0.2500000
NODE_13150_length_772_cov_8.778603	186	266	0	7	80	0.0875000
NODE_13150_length_772_cov_8.778603	186	266	1	51	80	0.6375000
NODE_13150_length_772_cov_8.778603	186	266	2	22	80	0.2750000
NODE_13151_length_772_cov_7.921248	351	431	0	54	80	0.6750000
NODE_13151_length_772_cov_7.921248	351	431	1	15	80	0.1875000
NODE_13151_length_772_cov_7.921248	351	431	2	11	80	0.1375000
NODE_13151_length_772_cov_7.921248	404	480	0	1	76	0.0131579
NODE_13151_length_772_cov_7.921248	404	480	1	15	76	0.1973684
NODE_13151_length_772_cov_7.921248	404	480	2	60	76	0.7894737
NODE_13152_length_772_cov_7.059435	276	356	4	20	80	0.2500000
NODE_13152_length_772_cov_7.059435	276	356	5	33	80	0.4125000
NODE_13152_length_772_cov_7.059435	276	356	6	4	80	0.0500000
NODE_13152_length_772_cov_7.059435	276	356	7	23	80	0.2875000
NODE_13152_length_772_cov_7.059435	329	409	2	10	80	0.1250000
NODE_13152_length_772_cov_7.059435	329	409	3	39	80	0.4875000
NODE_13152_length_772_cov_7.059435	329	409	4	24	80	0.3000000
NODE_13152_length_772_cov_7.059435	329	409	5	7	80	0.0875000
NODE_13153_length_772_cov_5.536404	269	299	0	30	30	1.0000000
NODE_13153_length_772_cov_5.536404	272	341	0	69	69	1.0000000
NODE_13156_length_772_cov_4.838039	430	510	0	80	80	1.0000000
NODE_13156_length_772_cov_4.838039	483	563	0	80	80	1.0000000
NODE_13162_length_772_cov_3.041605	339	419	1	80	80	1.0000000
NODE_13162_length_772_cov_3.041605	392	472	0	11	80	0.1375000
NODE_13162_length_772_cov_3.041605	392	472	1	69	80	0.8625000
NODE_13195_length_771_cov_36.729167	223	304	0	81	81	1.0000000
NODE_13195_length_771_cov_36.729167	277	357	0	80	80	1.0000000
NODE_13195_length_771_cov_36.729167	353	434	0	28	81	0.3456790
NODE_13195_length_771_cov_36.729167	353	434	2	17	81	0.2098765
NODE_13195_length_771_cov_36.729167	353	434	3	1	81	0.0123457
NODE_13195_length_771_cov_36.729167	353	434	4	35	81	0.4320988
NODE_13195_length_771_cov_36.729167	407	487	4	80	80	1.0000000
NODE_13196_length_771_cov_28.903274	337	417	2	10	80	0.1250000
NODE_13196_length_771_cov_28.903274	337	417	4	2	80	0.0250000
NODE_13196_length_771_cov_28.903274	337	417	5	26	80	0.3250000
NODE_13196_length_771_cov_28.903274	337	417	6	17	80	0.2125000
NODE_13196_length_771_cov_28.903274	337	417	7	25	80	0.3125000
NODE_13196_length_771_cov_28.903274	390	470	4	7	80	0.0875000
NODE_13196_length_771_cov_28.903274	390	470	6	63	80	0.7875000
NODE_13196_length_771_cov_28.903274	390	470	7	10	80	0.1250000
NODE_13197_length_771_cov_28.165179	453	533	9	7	80	0.0875000
NODE_13197_length_771_cov_28.165179	453	533	10	39	80	0.4875000
NODE_13197_length_771_cov_28.165179	453	533	11	28	80	0.3500000
NODE_13197_length_771_cov_28.165179	453	533	12	6	80	0.0750000
NODE_13197_length_771_cov_28.165179	506	586	5	15	80	0.1875000
NODE_13197_length_771_cov_28.165179	506	586	6	12	80	0.1500000
NODE_13197_length_771_cov_28.165179	506	586	7	1	80	0.0125000
NODE_13197_length_771_cov_28.165179	506	586	8	18	80	0.2250000
NODE_13197_length_771_cov_28.165179	506	586	9	5	80	0.0625000
NODE_13197_length_771_cov_28.165179	506	586	10	29	80	0.3625000
NODE_13198_length_771_cov_14.336310	259	339	0	44	80	0.5500000
NODE_13198_length_771_cov_14.336310	259	339	2	36	80	0.4500000
NODE_13198_length_771_cov_14.336310	312	392	0	80	80	1.0000000
NODE_13199_length_771_cov_13.592262	428	508	1	22	80	0.2750000
NODE_13199_length_771_cov_13.592262	428	508	2	58	80	0.7250000
NODE_13199_length_771_cov_13.592262	481	561	1	50	80	0.6250000
NODE_13199_length_771_cov_13.592262	481	561	2	30	80	0.3750000
NODE_13200_length_771_cov_12.226190	407	487	1	25	80	0.3125000
NODE_13200_length_771_cov_12.226190	407	487	2	55	80	0.6875000
NODE_13200_length_771_cov_12.226190	460	540	1	60	80	0.7500000
NODE_13200_length_771_cov_12.226190	460	540	2	20	80	0.2500000
NODE_13201_length_771_cov_11.188988	348	428	2	33	80	0.4125000
NODE_13201_length_771_cov_11.188988	348	428	4	1	80	0.0125000
NODE_13201_length_771_cov_11.188988	348	428	6	46	80	0.5750000
NODE_13201_length_771_cov_11.188988	401	481	0	11	80	0.1375000
NODE_13201_length_771_cov_11.188988	401	481	1	6	80	0.0750000
NODE_13201_length_771_cov_11.188988	401	481	2	63	80	0.7875000
NODE_13202_length_771_cov_10.525298	171	251	0	19	80	0.2375000
NODE_13202_length_771_cov_10.525298	171	251	4	61	80	0.7625000
NODE_13202_length_771_cov_10.525298	224	304	4	80	80	1.0000000
NODE_13207_length_771_cov_3.357143	238	318	2	80	80	1.0000000
NODE_13207_length_771_cov_3.357143	291	371	2	74	80	0.9250000
NODE_13207_length_771_cov_3.357143	291	371	3	2	80	0.0250000
NODE_13207_length_771_cov_3.357143	291	371	4	4	80	0.0500000
NODE_13209_length_771_cov_3.129464	476	518	0	42	42	1.0000000
NODE_13238_length_770_cov_45.312966	212	292	7	22	80	0.2750000
NODE_13238_length_770_cov_45.312966	212	292	8	34	80	0.4250000
NODE_13238_length_770_cov_45.312966	212	292	9	7	80	0.0875000
NODE_13238_length_770_cov_45.312966	212	292	10	17	80	0.2125000
NODE_13238_length_770_cov_45.312966	265	345	6	12	80	0.1500000
NODE_13238_length_770_cov_45.312966	265	345	7	1	80	0.0125000
NODE_13238_length_770_cov_45.312966	265	345	8	25	80	0.3125000
NODE_13238_length_770_cov_45.312966	265	345	9	25	80	0.3125000
NODE_13238_length_770_cov_45.312966	265	345	10	17	80	0.2125000
NODE_13239_length_770_cov_23.153502	348	428	1	2	80	0.0250000
NODE_13239_length_770_cov_23.153502	348	428	2	78	80	0.9750000
NODE_13239_length_770_cov_23.153502	401	481	1	18	80	0.2250000
NODE_13239_length_770_cov_23.153502	401	481	2	62	80	0.7750000
NODE_13240_length_770_cov_22.463487	340	420	3	18	80	0.2250000
NODE_13240_length_770_cov_22.463487	340	420	4	34	80	0.4250000
NODE_13240_length_770_cov_22.463487	340	420	5	23	80	0.2875000
NODE_13240_length_770_cov_22.463487	340	420	6	5	80	0.0625000
NODE_13240_length_770_cov_22.463487	393	473	2	22	80	0.2750000
NODE_13240_length_770_cov_22.463487	393	473	3	49	80	0.6125000
NODE_13240_length_770_cov_22.463487	393	473	5	9	80	0.1125000
NODE_13241_length_770_cov_18.594635	335	416	4	47	81	0.5802469
NODE_13241_length_770_cov_18.594635	335	416	5	19	81	0.2345679
NODE_13241_length_770_cov_18.594635	335	416	6	4	81	0.0493827
NODE_13241_length_770_cov_18.594635	335	416	7	11	81	0.1358025
NODE_13241_length_770_cov_18.594635	389	469	0	6	80	0.0750000
NODE_13241_length_770_cov_18.594635	389	469	1	12	80	0.1500000
NODE_13241_length_770_cov_18.594635	389	469	2	34	80	0.4250000
NODE_13241_length_770_cov_18.594635	389	469	4	28	80	0.3500000
NODE_13242_length_770_cov_18.092399	292	372	2	43	80	0.5375000
NODE_13242_length_770_cov_18.092399	292	372	4	37	80	0.4625000
NODE_13242_length_770_cov_18.092399	345	425	2	28	80	0.3500000
NODE_13242_length_770_cov_18.092399	345	425	3	6	80	0.0750000
NODE_13242_length_770_cov_18.092399	345	425	4	46	80	0.5750000
NODE_13243_length_770_cov_7.064083	294	374	2	6	80	0.0750000
NODE_13243_length_770_cov_7.064083	294	374	3	6	80	0.0750000
NODE_13243_length_770_cov_7.064083	294	374	4	43	80	0.5375000
NODE_13243_length_770_cov_7.064083	294	374	7	25	80	0.3125000
NODE_13243_length_770_cov_7.064083	347	426	4	2	79	0.0253165
NODE_13243_length_770_cov_7.064083	347	426	6	10	79	0.1265823
NODE_13243_length_770_cov_7.064083	347	426	7	45	79	0.5696203
NODE_13243_length_770_cov_7.064083	347	426	8	22	79	0.2784810
NODE_13246_length_770_cov_5.184799	341	421	2	72	80	0.9000000
NODE_13246_length_770_cov_5.184799	341	421	4	8	80	0.1000000
NODE_13246_length_770_cov_5.184799	394	474	0	28	80	0.3500000
NODE_13246_length_770_cov_5.184799	394	474	2	52	80	0.6500000
NODE_13250_length_770_cov_4.120715	325	405	1	24	80	0.3000000
NODE_13250_length_770_cov_4.120715	325	405	3	56	80	0.7000000
NODE_13250_length_770_cov_4.120715	378	458	1	49	80	0.6125000
NODE_13250_length_770_cov_4.120715	378	458	2	28	80	0.3500000
NODE_13250_length_770_cov_4.120715	378	458	3	3	80	0.0375000
NODE_13272_length_769_cov_11.008955	355	435	2	80	80	1.0000000
NODE_13272_length_769_cov_11.008955	408	488	0	35	80	0.4375000
NODE_13272_length_769_cov_11.008955	408	488	1	9	80	0.1125000
NODE_13272_length_769_cov_11.008955	408	488	2	36	80	0.4500000
NODE_13274_length_769_cov_9.077612	263	343	0	80	80	1.0000000
NODE_13274_length_769_cov_9.077612	316	396	0	28	80	0.3500000
NODE_13274_length_769_cov_9.077612	316	396	1	14	80	0.1750000
NODE_13274_length_769_cov_9.077612	316	396	2	1	80	0.0125000
NODE_13274_length_769_cov_9.077612	316	396	4	36	80	0.4500000
NODE_13274_length_769_cov_9.077612	316	396	6	1	80	0.0125000
NODE_13275_length_769_cov_7.034328	289	367	0	54	78	0.6923077
NODE_13275_length_769_cov_7.034328	289	367	2	24	78	0.3076923
NODE_13275_length_769_cov_7.034328	340	420	0	3	80	0.0375000
NODE_13275_length_769_cov_7.034328	340	420	2	77	80	0.9625000
NODE_13307_length_769_cov_1.262687	620	668	0	48	48	1.0000000
NODE_13316_length_768_cov_19.195815	266	346	1	36	80	0.4500000
NODE_13316_length_768_cov_19.195815	266	346	2	44	80	0.5500000
NODE_13316_length_768_cov_19.195815	319	399	1	23	80	0.2875000
NODE_13316_length_768_cov_19.195815	319	399	2	45	80	0.5625000
NODE_13316_length_768_cov_19.195815	319	399	3	4	80	0.0500000
NODE_13316_length_768_cov_19.195815	319	399	5	8	80	0.1000000
NODE_13316_length_768_cov_19.195815	395	475	5	10	80	0.1250000
NODE_13316_length_768_cov_19.195815	395	475	6	27	80	0.3375000
NODE_13316_length_768_cov_19.195815	395	475	7	43	80	0.5375000
NODE_13316_length_768_cov_19.195815	448	528	3	9	80	0.1125000
NODE_13316_length_768_cov_19.195815	448	528	4	4	80	0.0500000
NODE_13316_length_768_cov_19.195815	448	528	6	63	80	0.7875000
NODE_13316_length_768_cov_19.195815	448	528	7	4	80	0.0500000
NODE_13317_length_768_cov_16.420030	246	326	1	38	80	0.4750000
NODE_13317_length_768_cov_16.420030	246	326	2	30	80	0.3750000
NODE_13317_length_768_cov_16.420030	246	326	3	12	80	0.1500000
NODE_13317_length_768_cov_16.420030	299	379	2	80	80	1.0000000
NODE_13318_length_768_cov_14.508221	309	389	1	1	80	0.0125000
NODE_13318_length_768_cov_14.508221	309	389	2	79	80	0.9875000
NODE_13318_length_768_cov_14.508221	362	442	0	5	80	0.0625000
NODE_13318_length_768_cov_14.508221	362	442	1	1	80	0.0125000
NODE_13318_length_768_cov_14.508221	362	442	2	74	80	0.9250000
NODE_13319_length_768_cov_11.635277	309	389	1	35	80	0.4375000
NODE_13319_length_768_cov_11.635277	309	389	2	7	80	0.0875000
NODE_13319_length_768_cov_11.635277	309	389	3	17	80	0.2125000
NODE_13319_length_768_cov_11.635277	309	389	4	21	80	0.2625000
NODE_13319_length_768_cov_11.635277	362	442	3	38	80	0.4750000
NODE_13319_length_768_cov_11.635277	362	442	4	42	80	0.5250000
NODE_13321_length_768_cov_9.064275	392	472	0	29	80	0.3625000
NODE_13321_length_768_cov_9.064275	392	472	1	51	80	0.6375000
NODE_13321_length_768_cov_9.064275	445	525	0	80	80	1.0000000
NODE_13324_length_768_cov_3.605381	512	592	0	52	80	0.6500000
NODE_13324_length_768_cov_3.605381	512	592	1	22	80	0.2750000
NODE_13324_length_768_cov_3.605381	512	592	2	6	80	0.0750000
NODE_13324_length_768_cov_3.605381	565	645	0	80	80	1.0000000
NODE_13354_length_767_cov_38.161677	28	108	0	80	80	1.0000000
NODE_13354_length_767_cov_38.161677	254	334	2	47	80	0.5875000
NODE_13354_length_767_cov_38.161677	254	334	4	8	80	0.1000000
NODE_13354_length_767_cov_38.161677	254	334	5	25	80	0.3125000
NODE_13354_length_767_cov_38.161677	307	387	3	4	80	0.0500000
NODE_13354_length_767_cov_38.161677	307	387	4	54	80	0.6750000
NODE_13354_length_767_cov_38.161677	307	387	5	22	80	0.2750000
NODE_13355_length_767_cov_24.107784	279	359	7	35	80	0.4375000
NODE_13355_length_767_cov_24.107784	279	359	8	28	80	0.3500000
NODE_13355_length_767_cov_24.107784	279	359	9	17	80	0.2125000
NODE_13355_length_767_cov_24.107784	332	412	6	18	80	0.2250000
NODE_13355_length_767_cov_24.107784	332	412	8	16	80	0.2000000
NODE_13355_length_767_cov_24.107784	332	412	9	33	80	0.4125000
NODE_13355_length_767_cov_24.107784	332	412	10	13	80	0.1625000
NODE_13356_length_767_cov_22.823353	286	366	1	5	80	0.0625000
NODE_13356_length_767_cov_22.823353	286	366	2	14	80	0.1750000
NODE_13356_length_767_cov_22.823353	286	366	3	4	80	0.0500000
NODE_13356_length_767_cov_22.823353	286	366	4	1	80	0.0125000
NODE_13356_length_767_cov_22.823353	286	366	5	10	80	0.1250000
NODE_13356_length_767_cov_22.823353	286	366	6	6	80	0.0750000
NODE_13356_length_767_cov_22.823353	286	366	7	18	80	0.2250000
NODE_13356_length_767_cov_22.823353	286	366	8	10	80	0.1250000
NODE_13356_length_767_cov_22.823353	286	366	10	12	80	0.1500000
NODE_13356_length_767_cov_22.823353	339	419	7	5	80	0.0625000
NODE_13356_length_767_cov_22.823353	339	419	8	10	80	0.1250000
NODE_13356_length_767_cov_22.823353	339	419	9	31	80	0.3875000
NODE_13356_length_767_cov_22.823353	339	419	10	34	80	0.4250000
NODE_13357_length_767_cov_20.898204	312	392	2	46	80	0.5750000
NODE_13357_length_767_cov_20.898204	312	392	3	34	80	0.4250000
NODE_13357_length_767_cov_20.898204	365	445	2	17	80	0.2125000
NODE_13357_length_767_cov_20.898204	365	445	3	42	80	0.5250000
NODE_13357_length_767_cov_20.898204	365	445	4	21	80	0.2625000
NODE_13358_length_767_cov_20.058383	357	439	0	36	82	0.4390244
NODE_13358_length_767_cov_20.058383	357	439	1	46	82	0.5609756
NODE_13358_length_767_cov_20.058383	410	490	0	80	80	1.0000000
NODE_13359_length_767_cov_20.020958	191	271	1	8	80	0.1000000
NODE_13359_length_767_cov_20.020958	191	271	2	72	80	0.9000000
NODE_13359_length_767_cov_20.020958	244	324	1	2	80	0.0250000
NODE_13359_length_767_cov_20.020958	244	324	2	78	80	0.9750000
NODE_13360_length_767_cov_18.687126	270	350	2	20	80	0.2500000
NODE_13360_length_767_cov_18.687126	270	350	4	8	80	0.1000000
NODE_13360_length_767_cov_18.687126	270	350	5	52	80	0.6500000
NODE_13360_length_767_cov_18.687126	323	403	1	20	80	0.2500000
NODE_13360_length_767_cov_18.687126	323	403	3	19	80	0.2375000
NODE_13360_length_767_cov_18.687126	323	403	5	41	80	0.5125000
NODE_13362_length_767_cov_13.323353	45	125	0	11	80	0.1375000
NODE_13362_length_767_cov_13.323353	45	125	1	7	80	0.0875000
NODE_13362_length_767_cov_13.323353	45	125	2	4	80	0.0500000
NODE_13362_length_767_cov_13.323353	45	125	3	22	80	0.2750000
NODE_13362_length_767_cov_13.323353	45	125	5	36	80	0.4500000
NODE_13362_length_767_cov_13.323353	98	178	5	37	80	0.4625000
NODE_13362_length_767_cov_13.323353	98	178	6	24	80	0.3000000
NODE_13362_length_767_cov_13.323353	98	178	7	19	80	0.2375000
NODE_13366_length_767_cov_8.787425	377	447	0	70	70	1.0000000
NODE_13366_length_767_cov_8.787425	420	500	0	80	80	1.0000000
NODE_13367_length_767_cov_7.206587	306	386	0	44	80	0.5500000
NODE_13367_length_767_cov_7.206587	306	386	1	36	80	0.4500000
NODE_13367_length_767_cov_7.206587	359	440	1	81	81	1.0000000
NODE_13403_length_766_cov_59.388306	322	402	6	1	80	0.0125000
NODE_13403_length_766_cov_59.388306	322	402	7	10	80	0.1250000
NODE_13403_length_766_cov_59.388306	322	402	8	15	80	0.1875000
NODE_13403_length_766_cov_59.388306	322	402	10	41	80	0.5125000
NODE_13403_length_766_cov_59.388306	322	402	11	13	80	0.1625000
NODE_13403_length_766_cov_59.388306	375	455	7	24	80	0.3000000
NODE_13403_length_766_cov_59.388306	375	455	8	11	80	0.1375000
NODE_13403_length_766_cov_59.388306	375	455	9	27	80	0.3375000
NODE_13403_length_766_cov_59.388306	375	455	10	17	80	0.2125000
NODE_13403_length_766_cov_59.388306	375	455	11	1	80	0.0125000
NODE_13403_length_766_cov_59.388306	451	531	1	20	80	0.2500000
NODE_13403_length_766_cov_59.388306	451	531	2	27	80	0.3375000
NODE_13403_length_766_cov_59.388306	451	531	3	11	80	0.1375000
NODE_13403_length_766_cov_59.388306	451	531	5	15	80	0.1875000
NODE_13403_length_766_cov_59.388306	451	531	7	7	80	0.0875000
NODE_13403_length_766_cov_59.388306	504	584	0	30	80	0.3750000
NODE_13403_length_766_cov_59.388306	504	584	1	43	80	0.5375000
NODE_13403_length_766_cov_59.388306	504	584	2	7	80	0.0875000
NODE_13404_length_766_cov_23.361319	308	388	3	12	80	0.1500000
NODE_13404_length_766_cov_23.361319	308	388	4	68	80	0.8500000
NODE_13404_length_766_cov_23.361319	361	441	1	10	80	0.1250000
NODE_13404_length_766_cov_23.361319	361	441	2	32	80	0.4000000
NODE_13404_length_766_cov_23.361319	361	441	3	23	80	0.2875000
NODE_13404_length_766_cov_23.361319	361	441	4	15	80	0.1875000
NODE_13405_length_766_cov_22.751124	229	309	2	1	80	0.0125000
NODE_13405_length_766_cov_22.751124	229	309	4	6	80	0.0750000
NODE_13405_length_766_cov_22.751124	229	309	6	56	80	0.7000000
NODE_13405_length_766_cov_22.751124	229	309	7	16	80	0.2000000
NODE_13405_length_766_cov_22.751124	229	309	8	1	80	0.0125000
NODE_13405_length_766_cov_22.751124	282	362	6	18	80	0.2250000
NODE_13405_length_766_cov_22.751124	282	362	7	24	80	0.3000000
NODE_13405_length_766_cov_22.751124	282	362	8	16	80	0.2000000
NODE_13405_length_766_cov_22.751124	282	362	9	22	80	0.2750000
NODE_13406_length_766_cov_20.011994	285	363	3	29	78	0.3717949
NODE_13406_length_766_cov_20.011994	285	363	4	11	78	0.1410256
NODE_13406_length_766_cov_20.011994	285	363	5	3	78	0.0384615
NODE_13406_length_766_cov_20.011994	285	363	6	27	78	0.3461539
NODE_13406_length_766_cov_20.011994	285	363	7	8	78	0.1025641
NODE_13406_length_766_cov_20.011994	336	416	6	72	80	0.9000000
NODE_13406_length_766_cov_20.011994	336	416	7	8	80	0.1000000
NODE_13407_length_766_cov_18.685157	288	368	4	3	80	0.0375000
NODE_13407_length_766_cov_18.685157	288	368	5	1	80	0.0125000
NODE_13407_length_766_cov_18.685157	288	368	6	9	80	0.1125000
NODE_13407_length_766_cov_18.685157	288	368	7	26	80	0.3250000
NODE_13407_length_766_cov_18.685157	288	368	8	6	80	0.0750000
NODE_13407_length_766_cov_18.685157	288	368	9	15	80	0.1875000
NODE_13407_length_766_cov_18.685157	288	368	10	4	80	0.0500000
NODE_13407_length_766_cov_18.685157	288	368	11	9	80	0.1125000
NODE_13407_length_766_cov_18.685157	288	368	12	7	80	0.0875000
NODE_13407_length_766_cov_18.685157	341	421	9	9	80	0.1125000
NODE_13407_length_766_cov_18.685157	341	421	10	6	80	0.0750000
NODE_13407_length_766_cov_18.685157	341	421	11	25	80	0.3125000
NODE_13407_length_766_cov_18.685157	341	421	12	40	80	0.5000000
NODE_13408_length_766_cov_13.131934	271	351	1	72	80	0.9000000
NODE_13408_length_766_cov_13.131934	271	351	2	8	80	0.1000000
NODE_13408_length_766_cov_13.131934	324	404	1	80	80	1.0000000
NODE_13410_length_766_cov_9.479760	274	354	0	25	80	0.3125000
NODE_13410_length_766_cov_9.479760	274	354	2	55	80	0.6875000
NODE_13410_length_766_cov_9.479760	327	407	0	78	80	0.9750000
NODE_13410_length_766_cov_9.479760	327	407	2	2	80	0.0250000
NODE_13415_length_766_cov_4.500750	333	413	0	80	80	1.0000000
NODE_13415_length_766_cov_4.500750	369	404	0	35	35	1.0000000
NODE_13415_length_766_cov_4.500750	371	413	0	42	42	1.0000000
NODE_13415_length_766_cov_4.500750	397	466	0	69	69	1.0000000
NODE_13447_length_765_cov_92.851351	16	96	6	7	80	0.0875000
NODE_13447_length_765_cov_92.851351	16	96	7	8	80	0.1000000
NODE_13447_length_765_cov_92.851351	16	96	8	3	80	0.0375000
NODE_13447_length_765_cov_92.851351	16	96	9	2	80	0.0250000
NODE_13447_length_765_cov_92.851351	16	96	11	17	80	0.2125000
NODE_13447_length_765_cov_92.851351	16	96	13	19	80	0.2375000
NODE_13447_length_765_cov_92.851351	16	96	14	24	80	0.3000000
NODE_13448_length_765_cov_36.345345	504	584	4	7	80	0.0875000
NODE_13448_length_765_cov_36.345345	504	584	5	3	80	0.0375000
NODE_13448_length_765_cov_36.345345	504	584	6	1	80	0.0125000
NODE_13448_length_765_cov_36.345345	504	584	8	69	80	0.8625000
NODE_13448_length_765_cov_36.345345	557	637	4	48	80	0.6000000
NODE_13448_length_765_cov_36.345345	557	637	5	8	80	0.1000000
NODE_13448_length_765_cov_36.345345	557	637	6	1	80	0.0125000
NODE_13448_length_765_cov_36.345345	557	637	8	23	80	0.2875000
NODE_13449_length_765_cov_27.334835	370	450	0	5	80	0.0625000
NODE_13449_length_765_cov_27.334835	370	450	1	10	80	0.1250000
NODE_13449_length_765_cov_27.334835	370	450	2	62	80	0.7750000
NODE_13449_length_765_cov_27.334835	370	450	4	3	80	0.0375000
NODE_13449_length_765_cov_27.334835	423	503	2	24	80	0.3000000
NODE_13449_length_765_cov_27.334835	423	503	4	8	80	0.1000000
NODE_13449_length_765_cov_27.334835	423	503	5	20	80	0.2500000
NODE_13449_length_765_cov_27.334835	423	503	7	4	80	0.0500000
NODE_13449_length_765_cov_27.334835	423	503	8	7	80	0.0875000
NODE_13449_length_765_cov_27.334835	423	503	9	17	80	0.2125000
NODE_13450_length_765_cov_23.355856	251	331	1	57	80	0.7125000
NODE_13450_length_765_cov_23.355856	251	331	2	23	80	0.2875000
NODE_13450_length_765_cov_23.355856	304	384	1	33	80	0.4125000
NODE_13450_length_765_cov_23.355856	304	384	2	47	80	0.5875000
NODE_13450_length_765_cov_23.355856	380	460	1	13	80	0.1625000
NODE_13450_length_765_cov_23.355856	380	460	2	2	80	0.0250000
NODE_13450_length_765_cov_23.355856	380	460	3	65	80	0.8125000
NODE_13450_length_765_cov_23.355856	433	506	0	15	73	0.2054795
NODE_13450_length_765_cov_23.355856	433	506	2	33	73	0.4520548
NODE_13450_length_765_cov_23.355856	433	506	3	25	73	0.3424658
NODE_13451_length_765_cov_23.322823	256	336	1	25	80	0.3125000
NODE_13451_length_765_cov_23.322823	256	336	2	8	80	0.1000000
NODE_13451_length_765_cov_23.322823	256	336	3	1	80	0.0125000
NODE_13451_length_765_cov_23.322823	256	336	4	7	80	0.0875000
NODE_13451_length_765_cov_23.322823	256	336	5	2	80	0.0250000
NODE_13451_length_765_cov_23.322823	256	336	6	8	80	0.1000000
NODE_13451_length_765_cov_23.322823	256	336	8	10	80	0.1250000
NODE_13451_length_765_cov_23.322823	256	336	10	19	80	0.2375000
NODE_13451_length_765_cov_23.322823	309	389	8	8	80	0.1000000
NODE_13451_length_765_cov_23.322823	309	389	10	31	80	0.3875000
NODE_13451_length_765_cov_23.322823	309	389	11	1	80	0.0125000
NODE_13451_length_765_cov_23.322823	309	389	12	40	80	0.5000000
NODE_13452_length_765_cov_21.741742	379	452	0	22	73	0.3013699
NODE_13452_length_765_cov_21.741742	379	452	1	51	73	0.6986302
NODE_13452_length_765_cov_21.741742	425	505	0	75	80	0.9375000
NODE_13452_length_765_cov_21.741742	425	505	1	5	80	0.0625000
NODE_13453_length_765_cov_14.253754	450	530	2	75	80	0.9375000
NODE_13453_length_765_cov_14.253754	450	530	3	5	80	0.0625000
NODE_13453_length_765_cov_14.253754	503	583	1	1	80	0.0125000
NODE_13453_length_765_cov_14.253754	503	583	2	74	80	0.9250000
NODE_13453_length_765_cov_14.253754	503	583	3	5	80	0.0625000
NODE_13454_length_765_cov_13.627628	313	393	1	12	80	0.1500000
NODE_13454_length_765_cov_13.627628	313	393	2	53	80	0.6625000
NODE_13454_length_765_cov_13.627628	313	393	4	15	80	0.1875000
NODE_13454_length_765_cov_13.627628	366	446	2	12	80	0.1500000
NODE_13454_length_765_cov_13.627628	366	446	4	60	80	0.7500000
NODE_13454_length_765_cov_13.627628	366	446	5	8	80	0.1000000
NODE_13455_length_765_cov_5.561562	319	349	0	30	30	1.0000000
NODE_13458_length_765_cov_4.367868	433	513	1	8	80	0.1000000
NODE_13458_length_765_cov_4.367868	433	513	2	72	80	0.9000000
NODE_13458_length_765_cov_4.367868	486	566	0	32	80	0.4000000
NODE_13458_length_765_cov_4.367868	486	566	1	29	80	0.3625000
NODE_13458_length_765_cov_4.367868	486	566	2	19	80	0.2375000
NODE_13483_length_764_cov_30.096241	436	516	0	80	80	1.0000000
NODE_13483_length_764_cov_30.096241	489	569	0	80	80	1.0000000
NODE_13484_length_764_cov_29.218045	304	384	8	61	80	0.7625000
NODE_13484_length_764_cov_29.218045	304	384	9	19	80	0.2375000
NODE_13484_length_764_cov_29.218045	357	437	3	7	80	0.0875000
NODE_13484_length_764_cov_29.218045	357	437	5	15	80	0.1875000
NODE_13484_length_764_cov_29.218045	357	437	7	14	80	0.1750000
NODE_13484_length_764_cov_29.218045	357	437	8	11	80	0.1375000
NODE_13484_length_764_cov_29.218045	357	437	9	33	80	0.4125000
NODE_13485_length_764_cov_25.951880	421	501	0	78	80	0.9750000
NODE_13485_length_764_cov_25.951880	421	501	1	2	80	0.0250000
NODE_13485_length_764_cov_25.951880	474	554	0	80	80	1.0000000
NODE_13486_length_764_cov_23.590977	204	284	5	2	80	0.0250000
NODE_13486_length_764_cov_23.590977	204	284	7	10	80	0.1250000
NODE_13486_length_764_cov_23.590977	204	284	8	10	80	0.1250000
NODE_13486_length_764_cov_23.590977	204	284	9	53	80	0.6625000
NODE_13486_length_764_cov_23.590977	204	284	10	5	80	0.0625000
NODE_13486_length_764_cov_23.590977	257	337	6	1	80	0.0125000
NODE_13486_length_764_cov_23.590977	257	337	7	32	80	0.4000000
NODE_13486_length_764_cov_23.590977	257	337	8	25	80	0.3125000
NODE_13486_length_764_cov_23.590977	257	337	9	17	80	0.2125000
NODE_13486_length_764_cov_23.590977	257	337	10	5	80	0.0625000
NODE_13488_length_764_cov_6.804511	281	361	2	9	80	0.1125000
NODE_13488_length_764_cov_6.804511	281	361	3	31	80	0.3875000
NODE_13488_length_764_cov_6.804511	281	361	4	40	80	0.5000000
NODE_13488_length_764_cov_6.804511	334	414	2	17	80	0.2125000
NODE_13488_length_764_cov_6.804511	334	414	4	63	80	0.7875000
NODE_13489_length_764_cov_6.700752	392	458	0	66	66	1.0000000
NODE_13508_length_764_cov_1.171429	475	537	0	62	62	1.0000000
NODE_13520_length_763_cov_28.807229	311	391	0	35	80	0.4375000
NODE_13520_length_763_cov_28.807229	311	391	2	45	80	0.5625000
NODE_13520_length_763_cov_28.807229	364	444	2	44	80	0.5500000
NODE_13520_length_763_cov_28.807229	364	444	3	12	80	0.1500000
NODE_13520_length_763_cov_28.807229	364	444	4	24	80	0.3000000
NODE_13521_length_763_cov_25.299699	598	673	0	75	75	1.0000000
NODE_13521_length_763_cov_25.299699	598	678	0	80	80	1.0000000
NODE_13521_length_763_cov_25.299699	605	675	0	70	70	1.0000000
NODE_13521_length_763_cov_25.299699	607	678	0	71	71	1.0000000
NODE_13521_length_763_cov_25.299699	651	731	0	80	80	1.0000000
NODE_13521_length_763_cov_25.299699	651	731	0	80	80	1.0000000
NODE_13521_length_763_cov_25.299699	651	731	0	80	80	1.0000000
NODE_13521_length_763_cov_25.299699	651	731	0	80	80	1.0000000
NODE_13522_length_763_cov_12.887048	336	416	3	3	80	0.0375000
NODE_13522_length_763_cov_12.887048	336	416	4	15	80	0.1875000
NODE_13522_length_763_cov_12.887048	336	416	5	62	80	0.7750000
NODE_13522_length_763_cov_12.887048	389	469	4	36	80	0.4500000
NODE_13522_length_763_cov_12.887048	389	469	5	34	80	0.4250000
NODE_13522_length_763_cov_12.887048	389	469	6	10	80	0.1250000
NODE_13523_length_763_cov_11.599398	547	627	0	13	80	0.1625000
NODE_13523_length_763_cov_11.599398	547	627	3	15	80	0.1875000
NODE_13523_length_763_cov_11.599398	547	627	4	52	80	0.6500000
NODE_13523_length_763_cov_11.599398	600	680	2	3	80	0.0375000
NODE_13523_length_763_cov_11.599398	600	680	4	77	80	0.9625000
NODE_13524_length_763_cov_9.378012	297	377	0	1	80	0.0125000
NODE_13524_length_763_cov_9.378012	297	377	2	79	80	0.9875000
NODE_13524_length_763_cov_9.378012	350	430	0	53	80	0.6625000
NODE_13524_length_763_cov_9.378012	350	430	2	27	80	0.3375000
NODE_13526_length_763_cov_7.246988	368	448	1	80	80	1.0000000
NODE_13526_length_763_cov_7.246988	421	501	0	32	80	0.4000000
NODE_13526_length_763_cov_7.246988	421	501	1	48	80	0.6000000
NODE_13527_length_763_cov_6.414157	371	451	0	2	80	0.0250000
NODE_13527_length_763_cov_6.414157	371	451	1	24	80	0.3000000
NODE_13527_length_763_cov_6.414157	371	451	3	54	80	0.6750000
NODE_13527_length_763_cov_6.414157	424	504	1	9	80	0.1125000
NODE_13527_length_763_cov_6.414157	424	504	3	71	80	0.8875000
NODE_13558_length_762_cov_21.236802	368	448	5	16	80	0.2000000
NODE_13558_length_762_cov_21.236802	368	448	7	64	80	0.8000000
NODE_13558_length_762_cov_21.236802	421	501	3	28	80	0.3500000
NODE_13558_length_762_cov_21.236802	421	501	5	20	80	0.2500000
NODE_13558_length_762_cov_21.236802	421	501	7	32	80	0.4000000
NODE_13559_length_762_cov_19.984917	327	407	2	8	80	0.1000000
NODE_13559_length_762_cov_19.984917	327	407	3	8	80	0.1000000
NODE_13559_length_762_cov_19.984917	327	407	5	54	80	0.6750000
NODE_13559_length_762_cov_19.984917	327	407	6	10	80	0.1250000
NODE_13559_length_762_cov_19.984917	380	460	1	38	80	0.4750000
NODE_13559_length_762_cov_19.984917	380	460	2	23	80	0.2875000
NODE_13559_length_762_cov_19.984917	380	460	3	8	80	0.1000000
NODE_13559_length_762_cov_19.984917	380	460	5	11	80	0.1375000
NODE_13560_length_762_cov_15.975867	318	398	0	55	80	0.6875000
NODE_13560_length_762_cov_15.975867	318	398	2	25	80	0.3125000
NODE_13560_length_762_cov_15.975867	371	439	0	2	68	0.0294118
NODE_13560_length_762_cov_15.975867	371	439	2	36	68	0.5294118
NODE_13560_length_762_cov_15.975867	371	439	4	30	68	0.4411765
NODE_13561_length_762_cov_12.728507	381	461	0	80	80	1.0000000
NODE_13561_length_762_cov_12.728507	434	514	0	80	80	1.0000000
NODE_13562_length_762_cov_10.078431	277	357	0	80	80	1.0000000
NODE_13562_length_762_cov_10.078431	330	410	0	80	80	1.0000000
NODE_13563_length_762_cov_9.705882	339	419	0	21	80	0.2625000
NODE_13563_length_762_cov_9.705882	339	419	2	59	80	0.7375000
NODE_13563_length_762_cov_9.705882	392	472	2	80	80	1.0000000
NODE_13564_length_762_cov_7.276018	316	395	0	36	79	0.4556962
NODE_13564_length_762_cov_7.276018	316	395	1	43	79	0.5443038
NODE_13564_length_762_cov_7.276018	368	448	1	80	80	1.0000000
NODE_13565_length_762_cov_6.168929	222	302	5	15	80	0.1875000
NODE_13565_length_762_cov_6.168929	222	302	7	10	80	0.1250000
NODE_13565_length_762_cov_6.168929	222	302	8	55	80	0.6875000
NODE_13565_length_762_cov_6.168929	275	355	3	9	80	0.1125000
NODE_13565_length_762_cov_6.168929	275	355	4	4	80	0.0500000
NODE_13565_length_762_cov_6.168929	275	355	5	24	80	0.3000000
NODE_13565_length_762_cov_6.168929	275	355	7	10	80	0.1250000
NODE_13565_length_762_cov_6.168929	275	355	8	33	80	0.4125000
NODE_13613_length_761_cov_44.243202	531	582	1	12	51	0.2352941
NODE_13613_length_761_cov_44.243202	531	582	2	32	51	0.6274510
NODE_13613_length_761_cov_44.243202	531	582	3	7	51	0.1372549
NODE_13614_length_761_cov_38.809668	342	422	0	37	80	0.4625000
NODE_13614_length_761_cov_38.809668	342	422	2	43	80	0.5375000
NODE_13614_length_761_cov_38.809668	395	475	2	80	80	1.0000000
NODE_13615_length_761_cov_38.694864	314	394	6	14	80	0.1750000
NODE_13615_length_761_cov_38.694864	314	394	8	15	80	0.1875000
NODE_13615_length_761_cov_38.694864	314	394	9	25	80	0.3125000
NODE_13615_length_761_cov_38.694864	314	394	10	26	80	0.3250000
NODE_13615_length_761_cov_38.694864	367	447	6	4	80	0.0500000
NODE_13615_length_761_cov_38.694864	367	447	7	7	80	0.0875000
NODE_13615_length_761_cov_38.694864	367	447	8	5	80	0.0625000
NODE_13615_length_761_cov_38.694864	367	447	9	39	80	0.4875000
NODE_13615_length_761_cov_38.694864	367	447	10	25	80	0.3125000
NODE_13616_length_761_cov_32.382175	432	512	9	5	80	0.0625000
NODE_13616_length_761_cov_32.382175	432	512	11	1	80	0.0125000
NODE_13616_length_761_cov_32.382175	432	512	12	15	80	0.1875000
NODE_13616_length_761_cov_32.382175	432	512	14	2	80	0.0250000
NODE_13616_length_761_cov_32.382175	432	512	16	55	80	0.6875000
NODE_13616_length_761_cov_32.382175	432	512	17	2	80	0.0250000
NODE_13616_length_761_cov_32.382175	485	565	4	32	80	0.4000000
NODE_13616_length_761_cov_32.382175	485	565	6	1	80	0.0125000
NODE_13616_length_761_cov_32.382175	485	565	7	7	80	0.0875000
NODE_13616_length_761_cov_32.382175	485	565	9	18	80	0.2250000
NODE_13616_length_761_cov_32.382175	485	565	11	1	80	0.0125000
NODE_13616_length_761_cov_32.382175	485	565	12	15	80	0.1875000
NODE_13616_length_761_cov_32.382175	485	565	14	2	80	0.0250000
NODE_13616_length_761_cov_32.382175	485	565	16	4	80	0.0500000
NODE_13617_length_761_cov_31.444109	323	403	2	19	80	0.2375000
NODE_13617_length_761_cov_31.444109	323	403	3	61	80	0.7625000
NODE_13617_length_761_cov_31.444109	376	467	1	33	91	0.3626374
NODE_13617_length_761_cov_31.444109	376	467	2	29	91	0.3186813
NODE_13617_length_761_cov_31.444109	376	467	3	29	91	0.3186813
NODE_13618_length_761_cov_14.004532	366	446	7	31	80	0.3875000
NODE_13618_length_761_cov_14.004532	366	446	9	1	80	0.0125000
NODE_13618_length_761_cov_14.004532	366	446	10	40	80	0.5000000
NODE_13618_length_761_cov_14.004532	366	446	11	8	80	0.1000000
NODE_13618_length_761_cov_14.004532	419	499	3	15	80	0.1875000
NODE_13618_length_761_cov_14.004532	419	499	4	13	80	0.1625000
NODE_13618_length_761_cov_14.004532	419	499	6	10	80	0.1250000
NODE_13618_length_761_cov_14.004532	419	499	7	42	80	0.5250000
NODE_13619_length_761_cov_13.287009	336	415	0	72	79	0.9113924
NODE_13619_length_761_cov_13.287009	336	415	2	7	79	0.0886076
NODE_13619_length_761_cov_13.287009	388	468	0	20	80	0.2500000
NODE_13619_length_761_cov_13.287009	388	468	2	60	80	0.7500000
NODE_13621_length_761_cov_9.654079	274	354	3	31	80	0.3875000
NODE_13621_length_761_cov_9.654079	274	354	4	11	80	0.1375000
NODE_13621_length_761_cov_9.654079	274	354	5	35	80	0.4375000
NODE_13621_length_761_cov_9.654079	274	354	6	3	80	0.0375000
NODE_13621_length_761_cov_9.654079	327	407	3	32	80	0.4000000
NODE_13621_length_761_cov_9.654079	327	407	4	5	80	0.0625000
NODE_13621_length_761_cov_9.654079	327	407	5	24	80	0.3000000
NODE_13621_length_761_cov_9.654079	327	407	6	19	80	0.2375000
NODE_13622_length_761_cov_7.306647	308	388	1	48	80	0.6000000
NODE_13622_length_761_cov_7.306647	308	388	2	32	80	0.4000000
NODE_13622_length_761_cov_7.306647	361	441	1	25	80	0.3125000
NODE_13622_length_761_cov_7.306647	361	441	2	55	80	0.6875000
NODE_13625_length_761_cov_4.314199	354	434	0	80	80	1.0000000
NODE_13625_length_761_cov_4.314199	407	487	0	80	80	1.0000000
NODE_13658_length_760_cov_48.290469	215	295	4	18	80	0.2250000
NODE_13658_length_760_cov_48.290469	215	295	5	9	80	0.1125000
NODE_13658_length_760_cov_48.290469	215	295	6	40	80	0.5000000
NODE_13658_length_760_cov_48.290469	215	295	7	13	80	0.1625000
NODE_13658_length_760_cov_48.290469	268	348	0	29	80	0.3625000
NODE_13658_length_760_cov_48.290469	268	348	1	6	80	0.0750000
NODE_13658_length_760_cov_48.290469	268	348	2	9	80	0.1125000
NODE_13658_length_760_cov_48.290469	268	348	4	27	80	0.3375000
NODE_13658_length_760_cov_48.290469	268	348	5	6	80	0.0750000
NODE_13658_length_760_cov_48.290469	268	348	6	3	80	0.0375000
NODE_13658_length_760_cov_48.290469	344	424	0	65	80	0.8125000
NODE_13658_length_760_cov_48.290469	344	424	1	15	80	0.1875000
NODE_13658_length_760_cov_48.290469	397	477	0	12	80	0.1500000
NODE_13658_length_760_cov_48.290469	397	477	1	68	80	0.8500000
NODE_13659_length_760_cov_28.314675	384	464	2	17	80	0.2125000
NODE_13659_length_760_cov_28.314675	384	464	4	10	80	0.1250000
NODE_13659_length_760_cov_28.314675	384	464	5	25	80	0.3125000
NODE_13659_length_760_cov_28.314675	384	464	7	19	80	0.2375000
NODE_13659_length_760_cov_28.314675	384	464	8	9	80	0.1125000
NODE_13659_length_760_cov_28.314675	437	517	7	59	80	0.7375000
NODE_13659_length_760_cov_28.314675	437	517	8	10	80	0.1250000
NODE_13659_length_760_cov_28.314675	437	517	9	11	80	0.1375000
NODE_13660_length_760_cov_27.981846	432	512	2	56	80	0.7000000
NODE_13660_length_760_cov_27.981846	432	512	4	24	80	0.3000000
NODE_13660_length_760_cov_27.981846	485	565	2	26	80	0.3250000
NODE_13660_length_760_cov_27.981846	485	565	3	30	80	0.3750000
NODE_13660_length_760_cov_27.981846	485	565	4	24	80	0.3000000
NODE_13661_length_760_cov_17.500756	372	452	0	9	80	0.1125000
NODE_13661_length_760_cov_17.500756	372	452	1	43	80	0.5375000
NODE_13661_length_760_cov_17.500756	372	452	2	1	80	0.0125000
NODE_13661_length_760_cov_17.500756	372	452	3	27	80	0.3375000
NODE_13661_length_760_cov_17.500756	425	505	3	80	80	1.0000000
NODE_13662_length_760_cov_17.420575	183	263	1	33	80	0.4125000
NODE_13662_length_760_cov_17.420575	183	263	2	5	80	0.0625000
NODE_13662_length_760_cov_17.420575	183	263	4	7	80	0.0875000
NODE_13662_length_760_cov_17.420575	183	263	5	35	80	0.4375000
NODE_13662_length_760_cov_17.420575	236	316	5	58	80	0.7250000
NODE_13662_length_760_cov_17.420575	236	316	6	22	80	0.2750000
NODE_13663_length_760_cov_13.444781	357	437	6	8	80	0.1000000
NODE_13663_length_760_cov_13.444781	357	437	7	11	80	0.1375000
NODE_13663_length_760_cov_13.444781	357	437	8	29	80	0.3625000
NODE_13663_length_760_cov_13.444781	357	437	9	5	80	0.0625000
NODE_13663_length_760_cov_13.444781	357	437	10	27	80	0.3375000
NODE_13663_length_760_cov_13.444781	410	490	9	1	80	0.0125000
NODE_13663_length_760_cov_13.444781	410	490	10	44	80	0.5500000
NODE_13663_length_760_cov_13.444781	410	490	11	16	80	0.2000000
NODE_13663_length_760_cov_13.444781	410	490	12	19	80	0.2375000
NODE_13664_length_760_cov_13.196672	282	362	0	80	80	1.0000000
NODE_13664_length_760_cov_13.196672	335	415	0	80	80	1.0000000
NODE_13665_length_760_cov_12.692890	295	375	0	5	80	0.0625000
NODE_13665_length_760_cov_12.692890	295	375	1	12	80	0.1500000
NODE_13665_length_760_cov_12.692890	295	375	3	63	80	0.7875000
NODE_13665_length_760_cov_12.692890	348	428	3	80	80	1.0000000
NODE_13671_length_760_cov_4.282905	388	468	0	80	80	1.0000000
NODE_13671_length_760_cov_4.282905	441	521	0	72	80	0.9000000
NODE_13671_length_760_cov_4.282905	441	521	1	8	80	0.1000000
NODE_13671_length_760_cov_4.282905	517	597	1	80	80	1.0000000
NODE_13683_length_760_cov_1.990923	490	570	0	80	80	1.0000000
NODE_13683_length_760_cov_1.990923	543	623	0	46	80	0.5750000
NODE_13683_length_760_cov_1.990923	543	623	2	23	80	0.2875000
NODE_13683_length_760_cov_1.990923	543	623	4	11	80	0.1375000
NODE_13709_length_759_cov_24.757576	376	456	1	56	80	0.7000000
NODE_13709_length_759_cov_24.757576	376	456	3	5	80	0.0625000
NODE_13709_length_759_cov_24.757576	376	456	4	19	80	0.2375000
NODE_13709_length_759_cov_24.757576	429	509	1	54	80	0.6750000
NODE_13709_length_759_cov_24.757576	429	509	2	3	80	0.0375000
NODE_13709_length_759_cov_24.757576	429	509	3	23	80	0.2875000
NODE_13710_length_759_cov_14.356061	210	290	4	44	80	0.5500000
NODE_13710_length_759_cov_14.356061	210	290	5	23	80	0.2875000
NODE_13710_length_759_cov_14.356061	210	290	6	13	80	0.1625000
NODE_13710_length_759_cov_14.356061	263	343	2	16	80	0.2000000
NODE_13710_length_759_cov_14.356061	263	343	4	48	80	0.6000000
NODE_13710_length_759_cov_14.356061	263	343	5	16	80	0.2000000
NODE_13711_length_759_cov_10.956061	328	408	0	13	80	0.1625000
NODE_13711_length_759_cov_10.956061	328	408	2	67	80	0.8375000
NODE_13711_length_759_cov_10.956061	381	461	2	80	80	1.0000000
NODE_13712_length_759_cov_10.639394	330	410	0	19	80	0.2375000
NODE_13712_length_759_cov_10.639394	330	410	2	24	80	0.3000000
NODE_13712_length_759_cov_10.639394	330	410	3	37	80	0.4625000
NODE_13712_length_759_cov_10.639394	383	463	1	40	80	0.5000000
NODE_13712_length_759_cov_10.639394	383	463	3	40	80	0.5000000
NODE_13713_length_759_cov_9.192424	209	290	3	54	81	0.6666667
NODE_13713_length_759_cov_9.192424	209	290	7	5	81	0.0617284
NODE_13713_length_759_cov_9.192424	209	290	9	22	81	0.2716049
NODE_13713_length_759_cov_9.192424	262	310	0	6	48	0.1250000
NODE_13713_length_759_cov_9.192424	262	310	1	8	48	0.1666667
NODE_13713_length_759_cov_9.192424	262	310	3	30	48	0.6250000
NODE_13713_length_759_cov_9.192424	262	310	6	4	48	0.0833333
NODE_13714_length_759_cov_8.771212	292	372	2	48	80	0.6000000
NODE_13714_length_759_cov_8.771212	292	372	3	32	80	0.4000000
NODE_13714_length_759_cov_8.771212	345	425	2	73	80	0.9125000
NODE_13714_length_759_cov_8.771212	345	425	3	7	80	0.0875000
NODE_13715_length_759_cov_8.650000	324	404	2	4	80	0.0500000
NODE_13715_length_759_cov_8.650000	324	404	4	64	80	0.8000000
NODE_13715_length_759_cov_8.650000	324	404	6	12	80	0.1500000
NODE_13715_length_759_cov_8.650000	377	457	2	5	80	0.0625000
NODE_13715_length_759_cov_8.650000	377	457	3	6	80	0.0750000
NODE_13715_length_759_cov_8.650000	377	457	4	15	80	0.1875000
NODE_13715_length_759_cov_8.650000	377	457	5	37	80	0.4625000
NODE_13715_length_759_cov_8.650000	377	457	6	17	80	0.2125000
NODE_13716_length_759_cov_8.268182	604	684	4	80	80	1.0000000
NODE_13716_length_759_cov_8.268182	657	737	2	16	80	0.2000000
NODE_13716_length_759_cov_8.268182	657	737	3	6	80	0.0750000
NODE_13716_length_759_cov_8.268182	657	737	4	58	80	0.7250000
NODE_13717_length_759_cov_6.833333	381	461	0	30	80	0.3750000
NODE_13717_length_759_cov_6.833333	381	461	1	50	80	0.6250000
NODE_13717_length_759_cov_6.833333	434	515	0	81	81	1.0000000
NODE_13718_length_759_cov_6.407576	319	399	0	8	80	0.1000000
NODE_13718_length_759_cov_6.407576	319	399	1	32	80	0.4000000
NODE_13718_length_759_cov_6.407576	319	399	2	40	80	0.5000000
NODE_13718_length_759_cov_6.407576	372	452	0	61	80	0.7625000
NODE_13718_length_759_cov_6.407576	372	452	1	19	80	0.2375000
NODE_13725_length_759_cov_3.400000	355	435	0	24	80	0.3000000
NODE_13725_length_759_cov_3.400000	355	435	2	56	80	0.7000000
NODE_13725_length_759_cov_3.400000	408	488	0	15	80	0.1875000
NODE_13725_length_759_cov_3.400000	408	488	2	65	80	0.8125000
NODE_13726_length_759_cov_3.346970	240	322	0	45	82	0.5487805
NODE_13726_length_759_cov_3.346970	240	322	1	16	82	0.1951219
NODE_13726_length_759_cov_3.346970	240	322	2	21	82	0.2560976
NODE_13760_length_758_cov_38.414264	215	295	0	2	80	0.0250000
NODE_13760_length_758_cov_38.414264	215	295	2	54	80	0.6750000
NODE_13760_length_758_cov_38.414264	215	295	4	2	80	0.0250000
NODE_13760_length_758_cov_38.414264	215	295	5	22	80	0.2750000
NODE_13760_length_758_cov_38.414264	268	348	2	3	80	0.0375000
NODE_13760_length_758_cov_38.414264	268	348	4	20	80	0.2500000
NODE_13760_length_758_cov_38.414264	268	348	5	32	80	0.4000000
NODE_13760_length_758_cov_38.414264	268	348	6	25	80	0.3125000
NODE_13760_length_758_cov_38.414264	344	424	4	1	80	0.0125000
NODE_13760_length_758_cov_38.414264	344	424	5	27	80	0.3375000
NODE_13760_length_758_cov_38.414264	344	424	6	8	80	0.1000000
NODE_13760_length_758_cov_38.414264	344	424	7	44	80	0.5500000
NODE_13760_length_758_cov_38.414264	397	477	2	32	80	0.4000000
NODE_13760_length_758_cov_38.414264	397	477	3	5	80	0.0625000
NODE_13760_length_758_cov_38.414264	397	477	4	17	80	0.2125000
NODE_13760_length_758_cov_38.414264	397	477	5	26	80	0.3250000
NODE_13761_length_758_cov_36.722307	331	411	4	19	80	0.2375000
NODE_13761_length_758_cov_36.722307	331	411	5	2	80	0.0250000
NODE_13761_length_758_cov_36.722307	331	411	6	4	80	0.0500000
NODE_13761_length_758_cov_36.722307	331	411	8	55	80	0.6875000
NODE_13761_length_758_cov_36.722307	384	464	1	7	80	0.0875000
NODE_13761_length_758_cov_36.722307	384	464	2	14	80	0.1750000
NODE_13761_length_758_cov_36.722307	384	464	3	9	80	0.1125000
NODE_13761_length_758_cov_36.722307	384	464	5	25	80	0.3125000
NODE_13761_length_758_cov_36.722307	384	464	8	25	80	0.3125000
NODE_13762_length_758_cov_29.910470	235	315	5	16	80	0.2000000
NODE_13762_length_758_cov_29.910470	235	315	6	33	80	0.4125000
NODE_13762_length_758_cov_29.910470	235	315	7	31	80	0.3875000
NODE_13762_length_758_cov_29.910470	288	368	5	18	80	0.2250000
NODE_13762_length_758_cov_29.910470	288	368	6	5	80	0.0625000
NODE_13762_length_758_cov_29.910470	288	368	7	30	80	0.3750000
NODE_13762_length_758_cov_29.910470	288	368	8	27	80	0.3375000
NODE_13763_length_758_cov_16.226100	386	466	1	26	80	0.3250000
NODE_13763_length_758_cov_16.226100	386	466	2	54	80	0.6750000
NODE_13763_length_758_cov_16.226100	439	519	2	53	80	0.6625000
NODE_13763_length_758_cov_16.226100	439	519	3	27	80	0.3375000
NODE_13764_length_758_cov_16.097117	311	391	2	66	80	0.8250000
NODE_13764_length_758_cov_16.097117	311	391	3	14	80	0.1750000
NODE_13764_length_758_cov_16.097117	364	444	0	49	80	0.6125000
NODE_13764_length_758_cov_16.097117	364	444	2	31	80	0.3875000
NODE_13765_length_758_cov_15.525038	260	340	3	8	80	0.1000000
NODE_13765_length_758_cov_15.525038	260	340	4	45	80	0.5625000
NODE_13765_length_758_cov_15.525038	260	340	5	27	80	0.3375000
NODE_13765_length_758_cov_15.525038	313	393	0	3	80	0.0375000
NODE_13765_length_758_cov_15.525038	313	393	2	7	80	0.0875000
NODE_13765_length_758_cov_15.525038	313	393	4	27	80	0.3375000
NODE_13765_length_758_cov_15.525038	313	393	5	43	80	0.5375000
NODE_13768_length_758_cov_9.153263	224	299	0	12	75	0.1600000
NODE_13768_length_758_cov_9.153263	224	299	1	18	75	0.2400000
NODE_13768_length_758_cov_9.153263	224	299	3	2	75	0.0266667
NODE_13768_length_758_cov_9.153263	224	299	4	43	75	0.5733333
NODE_13771_length_758_cov_4.241275	508	588	0	80	80	1.0000000
NODE_13772_length_758_cov_3.902883	346	426	1	35	80	0.4375000
NODE_13772_length_758_cov_3.902883	346	426	2	4	80	0.0500000
NODE_13772_length_758_cov_3.902883	346	426	3	41	80	0.5125000
NODE_13772_length_758_cov_3.902883	399	479	2	17	80	0.2125000
NODE_13772_length_758_cov_3.902883	399	479	3	63	80	0.7875000
NODE_13794_length_757_cov_49.057751	155	235	4	15	80	0.1875000
NODE_13794_length_757_cov_49.057751	155	235	5	6	80	0.0750000
NODE_13794_length_757_cov_49.057751	155	235	6	2	80	0.0250000
NODE_13794_length_757_cov_49.057751	155	235	8	24	80	0.3000000
NODE_13794_length_757_cov_49.057751	155	235	9	5	80	0.0625000
NODE_13794_length_757_cov_49.057751	155	235	10	2	80	0.0250000
NODE_13794_length_757_cov_49.057751	155	235	11	12	80	0.1500000
NODE_13794_length_757_cov_49.057751	155	235	12	1	80	0.0125000
NODE_13794_length_757_cov_49.057751	155	235	14	3	80	0.0375000
NODE_13794_length_757_cov_49.057751	155	235	17	10	80	0.1250000
NODE_13794_length_757_cov_49.057751	208	288	10	1	80	0.0125000
NODE_13794_length_757_cov_49.057751	208	288	11	12	80	0.1500000
NODE_13794_length_757_cov_49.057751	208	288	12	1	80	0.0125000
NODE_13794_length_757_cov_49.057751	208	288	14	15	80	0.1875000
NODE_13794_length_757_cov_49.057751	208	288	15	5	80	0.0625000
NODE_13794_length_757_cov_49.057751	208	288	16	13	80	0.1625000
NODE_13794_length_757_cov_49.057751	208	288	17	33	80	0.4125000
NODE_13795_length_757_cov_29.954407	181	262	1	64	81	0.7901235
NODE_13795_length_757_cov_29.954407	181	262	2	17	81	0.2098765
NODE_13795_length_757_cov_29.954407	235	315	1	15	80	0.1875000
NODE_13795_length_757_cov_29.954407	235	315	2	65	80	0.8125000
NODE_13795_length_757_cov_29.954407	311	391	1	80	80	1.0000000
NODE_13795_length_757_cov_29.954407	364	444	0	49	80	0.6125000
NODE_13795_length_757_cov_29.954407	364	444	1	31	80	0.3875000
NODE_13796_length_757_cov_25.565350	352	432	0	80	80	1.0000000
NODE_13796_length_757_cov_25.565350	405	483	0	55	78	0.7051282
NODE_13796_length_757_cov_25.565350	405	483	1	23	78	0.2948718
NODE_13797_length_757_cov_18.338906	264	344	3	47	80	0.5875000
NODE_13797_length_757_cov_18.338906	264	344	5	22	80	0.2750000
NODE_13797_length_757_cov_18.338906	264	344	7	11	80	0.1375000
NODE_13797_length_757_cov_18.338906	317	397	4	1	80	0.0125000
NODE_13797_length_757_cov_18.338906	317	397	5	68	80	0.8500000
NODE_13797_length_757_cov_18.338906	317	397	7	11	80	0.1375000
NODE_13798_length_757_cov_15.879939	58	138	1	1	80	0.0125000
NODE_13798_length_757_cov_15.879939	58	138	2	10	80	0.1250000
NODE_13798_length_757_cov_15.879939	58	138	4	69	80	0.8625000
NODE_13798_length_757_cov_15.879939	111	191	3	23	80	0.2875000
NODE_13798_length_757_cov_15.879939	111	191	4	57	80	0.7125000
NODE_13800_length_757_cov_15.291793	314	394	4	7	80	0.0875000
NODE_13800_length_757_cov_15.291793	314	394	5	26	80	0.3250000
NODE_13800_length_757_cov_15.291793	314	394	6	47	80	0.5875000
NODE_13800_length_757_cov_15.291793	367	447	2	10	80	0.1250000
NODE_13800_length_757_cov_15.291793	367	447	3	5	80	0.0625000
NODE_13800_length_757_cov_15.291793	367	447	4	31	80	0.3875000
NODE_13800_length_757_cov_15.291793	367	447	6	34	80	0.4250000
NODE_13807_length_757_cov_3.182371	423	503	1	48	80	0.6000000
NODE_13807_length_757_cov_3.182371	423	503	3	32	80	0.4000000
NODE_13807_length_757_cov_3.182371	476	556	2	3	80	0.0375000
NODE_13807_length_757_cov_3.182371	476	556	3	77	80	0.9625000
NODE_13832_length_756_cov_26.441400	287	367	5	51	80	0.6375000
NODE_13832_length_756_cov_26.441400	287	367	6	29	80	0.3625000
NODE_13832_length_756_cov_26.441400	340	420	2	29	80	0.3625000
NODE_13832_length_756_cov_26.441400	340	420	3	11	80	0.1375000
NODE_13832_length_756_cov_26.441400	340	420	4	9	80	0.1125000
NODE_13832_length_756_cov_26.441400	340	420	5	31	80	0.3875000
NODE_13834_length_756_cov_13.097412	154	234	0	80	80	1.0000000
NODE_13834_length_756_cov_13.097412	207	287	0	80	80	1.0000000
NODE_13835_length_756_cov_12.732116	377	457	3	20	80	0.2500000
NODE_13835_length_756_cov_12.732116	377	457	4	9	80	0.1125000
NODE_13835_length_756_cov_12.732116	377	457	5	33	80	0.4125000
NODE_13835_length_756_cov_12.732116	377	457	6	18	80	0.2250000
NODE_13836_length_756_cov_9.254186	241	321	0	80	80	1.0000000
NODE_13836_length_756_cov_9.254186	294	374	0	30	80	0.3750000
NODE_13836_length_756_cov_9.254186	294	374	1	21	80	0.2625000
NODE_13836_length_756_cov_9.254186	294	374	2	29	80	0.3625000
NODE_13837_length_756_cov_8.304414	363	409	0	46	46	1.0000000
NODE_13838_length_756_cov_8.105023	271	351	2	21	80	0.2625000
NODE_13838_length_756_cov_8.105023	271	351	3	35	80	0.4375000
NODE_13838_length_756_cov_8.105023	271	351	4	24	80	0.3000000
NODE_13838_length_756_cov_8.105023	324	404	2	74	80	0.9250000
NODE_13838_length_756_cov_8.105023	324	404	3	6	80	0.0750000
NODE_13840_length_756_cov_6.622527	431	511	2	22	80	0.2750000
NODE_13840_length_756_cov_6.622527	431	511	3	4	80	0.0500000
NODE_13840_length_756_cov_6.622527	431	511	4	54	80	0.6750000
NODE_13840_length_756_cov_6.622527	484	565	2	28	81	0.3456790
NODE_13840_length_756_cov_6.622527	484	565	4	53	81	0.6543210
NODE_13888_length_755_cov_64.705793	303	383	4	11	80	0.1375000
NODE_13888_length_755_cov_64.705793	303	383	6	7	80	0.0875000
NODE_13888_length_755_cov_64.705793	303	383	8	3	80	0.0375000
NODE_13888_length_755_cov_64.705793	303	383	9	11	80	0.1375000
NODE_13888_length_755_cov_64.705793	303	383	10	26	80	0.3250000
NODE_13888_length_755_cov_64.705793	303	383	12	4	80	0.0500000
NODE_13888_length_755_cov_64.705793	303	383	13	18	80	0.2250000
NODE_13888_length_755_cov_64.705793	356	436	10	5	80	0.0625000
NODE_13888_length_755_cov_64.705793	356	436	12	4	80	0.0500000
NODE_13888_length_755_cov_64.705793	356	436	13	56	80	0.7000000
NODE_13888_length_755_cov_64.705793	356	436	15	15	80	0.1875000
NODE_13889_length_755_cov_58.214939	425	505	0	26	80	0.3250000
NODE_13889_length_755_cov_58.214939	425	505	2	54	80	0.6750000
NODE_13889_length_755_cov_58.214939	425	505	0	26	80	0.3250000
NODE_13889_length_755_cov_58.214939	425	505	2	54	80	0.6750000
NODE_13889_length_755_cov_58.214939	478	556	0	77	78	0.9871795
NODE_13889_length_755_cov_58.214939	478	556	2	1	78	0.0128205
NODE_13889_length_755_cov_58.214939	478	556	0	77	78	0.9871795
NODE_13889_length_755_cov_58.214939	478	556	2	1	78	0.0128205
NODE_13890_length_755_cov_25.945122	237	317	2	3	80	0.0375000
NODE_13890_length_755_cov_25.945122	237	317	3	12	80	0.1500000
NODE_13890_length_755_cov_25.945122	237	317	6	22	80	0.2750000
NODE_13890_length_755_cov_25.945122	237	317	7	30	80	0.3750000
NODE_13890_length_755_cov_25.945122	237	317	8	13	80	0.1625000
NODE_13890_length_755_cov_25.945122	290	370	6	27	80	0.3375000
NODE_13890_length_755_cov_25.945122	290	370	7	31	80	0.3875000
NODE_13890_length_755_cov_25.945122	290	370	8	22	80	0.2750000
NODE_13891_length_755_cov_24.263720	334	414	6	12	80	0.1500000
NODE_13891_length_755_cov_24.263720	334	414	7	2	80	0.0250000
NODE_13891_length_755_cov_24.263720	334	414	8	17	80	0.2125000
NODE_13891_length_755_cov_24.263720	334	414	9	49	80	0.6125000
NODE_13891_length_755_cov_24.263720	387	467	5	6	80	0.0750000
NODE_13891_length_755_cov_24.263720	387	467	6	59	80	0.7375000
NODE_13891_length_755_cov_24.263720	387	467	7	2	80	0.0250000
NODE_13891_length_755_cov_24.263720	387	467	8	3	80	0.0375000
NODE_13891_length_755_cov_24.263720	387	467	9	10	80	0.1250000
NODE_13892_length_755_cov_15.559451	306	386	0	80	80	1.0000000
NODE_13892_length_755_cov_15.559451	359	439	0	80	80	1.0000000
NODE_13894_length_755_cov_10.196646	332	412	1	80	80	1.0000000
NODE_13894_length_755_cov_10.196646	385	465	1	80	80	1.0000000
NODE_13895_length_755_cov_9.772866	210	290	0	3	80	0.0375000
NODE_13895_length_755_cov_9.772866	210	290	2	77	80	0.9625000
NODE_13895_length_755_cov_9.772866	263	343	0	56	80	0.7000000
NODE_13895_length_755_cov_9.772866	263	343	2	24	80	0.3000000
NODE_13936_length_754_cov_87.432061	208	288	5	8	80	0.1000000
NODE_13936_length_754_cov_87.432061	208	288	6	6	80	0.0750000
NODE_13936_length_754_cov_87.432061	208	288	7	3	80	0.0375000
NODE_13936_length_754_cov_87.432061	208	288	9	1	80	0.0125000
NODE_13936_length_754_cov_87.432061	208	288	10	6	80	0.0750000
NODE_13936_length_754_cov_87.432061	208	288	11	17	80	0.2125000
NODE_13936_length_754_cov_87.432061	208	288	12	15	80	0.1875000
NODE_13936_length_754_cov_87.432061	208	288	13	21	80	0.2625000
NODE_13936_length_754_cov_87.432061	208	288	14	3	80	0.0375000
NODE_13936_length_754_cov_87.432061	261	341	11	27	80	0.3375000
NODE_13936_length_754_cov_87.432061	261	341	12	2	80	0.0250000
NODE_13936_length_754_cov_87.432061	261	341	13	33	80	0.4125000
NODE_13936_length_754_cov_87.432061	261	341	14	18	80	0.2250000
NODE_13937_length_754_cov_16.549618	156	236	7	5	80	0.0625000
NODE_13937_length_754_cov_16.549618	156	236	8	26	80	0.3250000
NODE_13937_length_754_cov_16.549618	156	236	9	33	80	0.4125000
NODE_13937_length_754_cov_16.549618	156	236	10	16	80	0.2000000
NODE_13937_length_754_cov_16.549618	209	289	5	5	80	0.0625000
NODE_13937_length_754_cov_16.549618	209	289	6	5	80	0.0625000
NODE_13937_length_754_cov_16.549618	209	289	7	23	80	0.2875000
NODE_13937_length_754_cov_16.549618	209	289	8	46	80	0.5750000
NODE_13937_length_754_cov_16.549618	209	289	10	1	80	0.0125000
NODE_13939_length_754_cov_9.068702	316	396	2	20	80	0.2500000
NODE_13939_length_754_cov_9.068702	316	396	3	60	80	0.7500000
NODE_13939_length_754_cov_9.068702	369	449	2	7	80	0.0875000
NODE_13939_length_754_cov_9.068702	369	449	3	65	80	0.8125000
NODE_13939_length_754_cov_9.068702	369	449	4	8	80	0.1000000
NODE_13940_length_754_cov_5.925191	287	367	0	2	80	0.0250000
NODE_13940_length_754_cov_5.925191	287	367	3	3	80	0.0375000
NODE_13940_length_754_cov_5.925191	287	367	4	4	80	0.0500000
NODE_13940_length_754_cov_5.925191	287	367	5	40	80	0.5000000
NODE_13940_length_754_cov_5.925191	287	367	6	31	80	0.3875000
NODE_13940_length_754_cov_5.925191	340	420	0	55	80	0.6875000
NODE_13940_length_754_cov_5.925191	340	420	3	3	80	0.0375000
NODE_13940_length_754_cov_5.925191	340	420	4	4	80	0.0500000
NODE_13940_length_754_cov_5.925191	340	420	5	18	80	0.2250000
NODE_13974_length_753_cov_10.434251	386	466	4	60	80	0.7500000
NODE_13974_length_753_cov_10.434251	386	466	5	18	80	0.2250000
NODE_13974_length_753_cov_10.434251	386	466	6	2	80	0.0250000
NODE_13974_length_753_cov_10.434251	439	519	2	30	80	0.3750000
NODE_13974_length_753_cov_10.434251	439	519	3	12	80	0.1500000
NODE_13974_length_753_cov_10.434251	439	519	4	18	80	0.2250000
NODE_13974_length_753_cov_10.434251	439	519	5	18	80	0.2250000
NODE_13974_length_753_cov_10.434251	439	519	6	2	80	0.0250000
NODE_13976_length_753_cov_7.056575	344	424	0	80	80	1.0000000
NODE_13976_length_753_cov_7.056575	397	477	0	80	80	1.0000000
NODE_13977_length_753_cov_4.597859	321	401	2	34	80	0.4250000
NODE_13977_length_753_cov_4.597859	321	401	3	2	80	0.0250000
NODE_13977_length_753_cov_4.597859	321	401	4	44	80	0.5500000
NODE_13977_length_753_cov_4.597859	374	454	0	12	80	0.1500000
NODE_13977_length_753_cov_4.597859	374	454	1	40	80	0.5000000
NODE_13977_length_753_cov_4.597859	374	454	2	28	80	0.3500000
NODE_14003_length_752_cov_66.281776	617	697	17	10	80	0.1250000
NODE_14003_length_752_cov_66.281776	617	697	19	2	80	0.0250000
NODE_14003_length_752_cov_66.281776	617	697	20	3	80	0.0375000
NODE_14003_length_752_cov_66.281776	617	697	21	2	80	0.0250000
NODE_14003_length_752_cov_66.281776	617	697	22	2	80	0.0250000
NODE_14003_length_752_cov_66.281776	617	697	23	17	80	0.2125000
NODE_14003_length_752_cov_66.281776	617	697	24	20	80	0.2500000
NODE_14003_length_752_cov_66.281776	617	697	25	12	80	0.1500000
NODE_14003_length_752_cov_66.281776	617	697	27	12	80	0.1500000
NODE_14003_length_752_cov_66.281776	670	751	7	4	81	0.0493827
NODE_14003_length_752_cov_66.281776	670	751	8	11	81	0.1358025
NODE_14003_length_752_cov_66.281776	670	751	9	17	81	0.2098765
NODE_14003_length_752_cov_66.281776	670	751	10	4	81	0.0493827
NODE_14003_length_752_cov_66.281776	670	751	12	2	81	0.0246914
NODE_14003_length_752_cov_66.281776	670	751	14	2	81	0.0246914
NODE_14003_length_752_cov_66.281776	670	751	16	14	81	0.1728395
NODE_14003_length_752_cov_66.281776	670	751	17	10	81	0.1234568
NODE_14003_length_752_cov_66.281776	670	751	19	2	81	0.0246914
NODE_14003_length_752_cov_66.281776	670	751	20	3	81	0.0370370
NODE_14003_length_752_cov_66.281776	670	751	21	2	81	0.0246914
NODE_14003_length_752_cov_66.281776	670	751	22	2	81	0.0246914
NODE_14003_length_752_cov_66.281776	670	751	23	8	81	0.0987654
NODE_14004_length_752_cov_60.274119	193	273	5	41	80	0.5125000
NODE_14004_length_752_cov_60.274119	193	273	6	29	80	0.3625000
NODE_14004_length_752_cov_60.274119	193	273	7	10	80	0.1250000
NODE_14004_length_752_cov_60.274119	246	326	3	28	80	0.3500000
NODE_14004_length_752_cov_60.274119	246	326	4	11	80	0.1375000
NODE_14004_length_752_cov_60.274119	246	326	5	41	80	0.5125000
NODE_14005_length_752_cov_19.811639	299	379	2	7	80	0.0875000
NODE_14005_length_752_cov_19.811639	299	379	3	73	80	0.9125000
NODE_14005_length_752_cov_19.811639	352	432	2	60	80	0.7500000
NODE_14005_length_752_cov_19.811639	352	432	3	20	80	0.2500000
NODE_14006_length_752_cov_17.661562	118	198	5	11	80	0.1375000
NODE_14006_length_752_cov_17.661562	118	198	7	25	80	0.3125000
NODE_14006_length_752_cov_17.661562	118	198	9	17	80	0.2125000
NODE_14006_length_752_cov_17.661562	118	198	10	13	80	0.1625000
NODE_14006_length_752_cov_17.661562	118	198	12	14	80	0.1750000
NODE_14006_length_752_cov_17.661562	171	251	7	10	80	0.1250000
NODE_14006_length_752_cov_17.661562	171	251	8	11	80	0.1375000
NODE_14006_length_752_cov_17.661562	171	251	9	15	80	0.1875000
NODE_14006_length_752_cov_17.661562	171	251	10	30	80	0.3750000
NODE_14006_length_752_cov_17.661562	171	251	12	14	80	0.1750000
NODE_14007_length_752_cov_13.275651	241	321	1	80	80	1.0000000
NODE_14007_length_752_cov_13.275651	294	374	1	80	80	1.0000000
NODE_14008_length_752_cov_10.928025	313	393	7	24	80	0.3000000
NODE_14008_length_752_cov_10.928025	313	393	8	56	80	0.7000000
NODE_14011_length_752_cov_9.558959	249	329	1	16	80	0.2000000
NODE_14011_length_752_cov_9.558959	249	329	2	64	80	0.8000000
NODE_14011_length_752_cov_9.558959	302	382	1	63	80	0.7875000
NODE_14011_length_752_cov_9.558959	302	382	2	17	80	0.2125000
NODE_14014_length_752_cov_8.281776	237	317	0	15	80	0.1875000
NODE_14014_length_752_cov_8.281776	237	317	2	65	80	0.8125000
NODE_14014_length_752_cov_8.281776	290	370	0	17	80	0.2125000
NODE_14014_length_752_cov_8.281776	290	370	2	63	80	0.7875000
NODE_14015_length_752_cov_8.082695	352	432	0	80	80	1.0000000
NODE_14015_length_752_cov_8.082695	405	485	0	80	80	1.0000000
NODE_14044_length_751_cov_20.730061	238	318	3	18	80	0.2250000
NODE_14044_length_751_cov_20.730061	238	318	4	26	80	0.3250000
NODE_14044_length_751_cov_20.730061	238	318	5	36	80	0.4500000
NODE_14044_length_751_cov_20.730061	291	371	1	49	80	0.6125000
NODE_14044_length_751_cov_20.730061	291	371	3	22	80	0.2750000
NODE_14044_length_751_cov_20.730061	291	371	5	9	80	0.1125000
NODE_14045_length_751_cov_18.478528	328	409	1	34	81	0.4197531
NODE_14045_length_751_cov_18.478528	328	409	2	47	81	0.5802469
NODE_14045_length_751_cov_18.478528	382	462	0	16	80	0.2000000
NODE_14045_length_751_cov_18.478528	382	462	1	64	80	0.8000000
NODE_14046_length_751_cov_13.016871	172	252	2	21	80	0.2625000
NODE_14046_length_751_cov_13.016871	172	252	4	2	80	0.0250000
NODE_14046_length_751_cov_13.016871	172	252	5	4	80	0.0500000
NODE_14046_length_751_cov_13.016871	172	252	6	19	80	0.2375000
NODE_14046_length_751_cov_13.016871	172	252	8	10	80	0.1250000
NODE_14046_length_751_cov_13.016871	172	252	9	7	80	0.0875000
NODE_14046_length_751_cov_13.016871	172	252	10	17	80	0.2125000
NODE_14046_length_751_cov_13.016871	225	305	5	2	80	0.0250000
NODE_14046_length_751_cov_13.016871	225	305	7	5	80	0.0625000
NODE_14046_length_751_cov_13.016871	225	305	8	3	80	0.0375000
NODE_14046_length_751_cov_13.016871	225	305	9	20	80	0.2500000
NODE_14046_length_751_cov_13.016871	225	305	10	50	80	0.6250000
NODE_14047_length_751_cov_12.363497	397	477	0	80	80	1.0000000
NODE_14047_length_751_cov_12.363497	450	530	0	80	80	1.0000000
NODE_14085_length_750_cov_46.371736	396	476	1	6	80	0.0750000
NODE_14085_length_750_cov_46.371736	396	476	2	52	80	0.6500000
NODE_14085_length_750_cov_46.371736	396	476	3	4	80	0.0500000
NODE_14085_length_750_cov_46.371736	396	476	4	1	80	0.0125000
NODE_14085_length_750_cov_46.371736	396	476	5	17	80	0.2125000
NODE_14085_length_750_cov_46.371736	449	529	2	5	80	0.0625000
NODE_14085_length_750_cov_46.371736	449	529	3	4	80	0.0500000
NODE_14085_length_750_cov_46.371736	449	529	4	1	80	0.0125000
NODE_14085_length_750_cov_46.371736	449	529	5	22	80	0.2750000
NODE_14085_length_750_cov_46.371736	449	529	6	42	80	0.5250000
NODE_14085_length_750_cov_46.371736	449	529	7	6	80	0.0750000
NODE_14086_length_750_cov_24.428571	524	604	0	4	80	0.0500000
NODE_14086_length_750_cov_24.428571	524	604	2	30	80	0.3750000
NODE_14086_length_750_cov_24.428571	524	604	4	15	80	0.1875000
NODE_14086_length_750_cov_24.428571	524	604	6	31	80	0.3875000
NODE_14086_length_750_cov_24.428571	683	746	0	63	63	1.0000000
NODE_14087_length_750_cov_24.311828	325	405	5	4	80	0.0500000
NODE_14087_length_750_cov_24.311828	325	405	6	27	80	0.3375000
NODE_14087_length_750_cov_24.311828	325	405	7	35	80	0.4375000
NODE_14087_length_750_cov_24.311828	325	405	8	14	80	0.1750000
NODE_14087_length_750_cov_24.311828	378	458	4	14	80	0.1750000
NODE_14087_length_750_cov_24.311828	378	458	5	17	80	0.2125000
NODE_14087_length_750_cov_24.311828	378	458	6	48	80	0.6000000
NODE_14087_length_750_cov_24.311828	378	458	7	1	80	0.0125000
NODE_14089_length_750_cov_8.529954	336	416	1	1	80	0.0125000
NODE_14089_length_750_cov_8.529954	336	416	2	79	80	0.9875000
NODE_14089_length_750_cov_8.529954	395	469	0	15	74	0.2027027
NODE_14089_length_750_cov_8.529954	395	469	1	39	74	0.5270270
NODE_14089_length_750_cov_8.529954	395	469	2	20	74	0.2702703
NODE_14137_length_749_cov_18.986154	221	301	0	12	80	0.1500000
NODE_14137_length_749_cov_18.986154	221	301	2	35	80	0.4375000
NODE_14137_length_749_cov_18.986154	221	301	4	33	80	0.4125000
NODE_14137_length_749_cov_18.986154	274	354	0	15	80	0.1875000
NODE_14137_length_749_cov_18.986154	274	354	1	7	80	0.0875000
NODE_14137_length_749_cov_18.986154	274	354	2	2	80	0.0250000
NODE_14137_length_749_cov_18.986154	274	354	4	56	80	0.7000000
NODE_14138_length_749_cov_18.836923	273	355	0	77	82	0.9390244
NODE_14138_length_749_cov_18.836923	273	355	1	5	82	0.0609756
NODE_14138_length_749_cov_18.836923	328	408	0	22	80	0.2750000
NODE_14138_length_749_cov_18.836923	328	408	1	52	80	0.6500000
NODE_14138_length_749_cov_18.836923	328	408	2	6	80	0.0750000
NODE_14138_length_749_cov_18.836923	404	484	2	35	80	0.4375000
NODE_14138_length_749_cov_18.836923	404	484	3	4	80	0.0500000
NODE_14138_length_749_cov_18.836923	404	484	5	19	80	0.2375000
NODE_14138_length_749_cov_18.836923	404	484	6	22	80	0.2750000
NODE_14138_length_749_cov_18.836923	457	535	5	20	78	0.2564103
NODE_14138_length_749_cov_18.836923	457	535	6	58	78	0.7435898
NODE_14139_length_749_cov_16.160000	232	253	13	4	21	0.1904762
NODE_14139_length_749_cov_16.160000	232	253	14	4	21	0.1904762
NODE_14139_length_749_cov_16.160000	232	253	15	13	21	0.6190476
NODE_14139_length_749_cov_16.160000	232	306	7	4	74	0.0540541
NODE_14139_length_749_cov_16.160000	232	306	9	1	74	0.0135135
NODE_14139_length_749_cov_16.160000	232	306	10	1	74	0.0135135
NODE_14139_length_749_cov_16.160000	232	306	11	2	74	0.0270270
NODE_14139_length_749_cov_16.160000	232	306	12	2	74	0.0270270
NODE_14139_length_749_cov_16.160000	232	306	13	4	74	0.0540541
NODE_14139_length_749_cov_16.160000	232	306	14	8	74	0.1081081
NODE_14139_length_749_cov_16.160000	232	306	15	20	74	0.2702703
NODE_14139_length_749_cov_16.160000	232	306	16	28	74	0.3783784
NODE_14139_length_749_cov_16.160000	232	306	17	4	74	0.0540541
NODE_14140_length_749_cov_16.115385	307	387	3	20	80	0.2500000
NODE_14140_length_749_cov_16.115385	307	387	5	60	80	0.7500000
NODE_14140_length_749_cov_16.115385	360	440	3	20	80	0.2500000
NODE_14140_length_749_cov_16.115385	360	440	4	2	80	0.0250000
NODE_14140_length_749_cov_16.115385	360	440	5	58	80	0.7250000
NODE_14141_length_749_cov_11.210769	340	420	0	80	80	1.0000000
NODE_14141_length_749_cov_11.210769	393	473	0	80	80	1.0000000
NODE_14142_length_749_cov_8.424615	372	452	0	80	80	1.0000000
NODE_14142_length_749_cov_8.424615	425	505	0	80	80	1.0000000
NODE_14145_length_749_cov_4.521538	550	630	0	6	80	0.0750000
NODE_14145_length_749_cov_4.521538	550	630	1	30	80	0.3750000
NODE_14145_length_749_cov_4.521538	550	630	2	44	80	0.5500000
NODE_14145_length_749_cov_4.521538	603	683	2	80	80	1.0000000
NODE_14185_length_748_cov_55.348228	393	473	15	4	80	0.0500000
NODE_14185_length_748_cov_55.348228	393	473	16	43	80	0.5375000
NODE_14185_length_748_cov_55.348228	393	473	17	3	80	0.0375000
NODE_14185_length_748_cov_55.348228	393	473	18	2	80	0.0250000
NODE_14185_length_748_cov_55.348228	393	473	19	2	80	0.0250000
NODE_14185_length_748_cov_55.348228	393	473	20	3	80	0.0375000
NODE_14185_length_748_cov_55.348228	393	473	21	3	80	0.0375000
NODE_14185_length_748_cov_55.348228	393	473	22	20	80	0.2500000
NODE_14185_length_748_cov_55.348228	446	526	10	16	80	0.2000000
NODE_14185_length_748_cov_55.348228	446	526	12	14	80	0.1750000
NODE_14185_length_748_cov_55.348228	446	526	14	22	80	0.2750000
NODE_14185_length_748_cov_55.348228	446	526	16	28	80	0.3500000
NODE_14186_length_748_cov_51.838213	369	449	7	14	80	0.1750000
NODE_14186_length_748_cov_51.838213	369	449	8	4	80	0.0500000
NODE_14186_length_748_cov_51.838213	369	449	9	21	80	0.2625000
NODE_14186_length_748_cov_51.838213	369	449	12	4	80	0.0500000
NODE_14186_length_748_cov_51.838213	369	449	13	8	80	0.1000000
NODE_14186_length_748_cov_51.838213	369	449	15	15	80	0.1875000
NODE_14186_length_748_cov_51.838213	369	449	16	14	80	0.1750000
NODE_14186_length_748_cov_51.838213	422	502	9	19	80	0.2375000
NODE_14186_length_748_cov_51.838213	422	502	10	1	80	0.0125000
NODE_14186_length_748_cov_51.838213	422	502	12	17	80	0.2125000
NODE_14186_length_748_cov_51.838213	422	502	14	2	80	0.0250000
NODE_14186_length_748_cov_51.838213	422	502	15	27	80	0.3375000
NODE_14186_length_748_cov_51.838213	422	502	16	14	80	0.1750000
NODE_14187_length_748_cov_46.952234	293	373	13	17	80	0.2125000
NODE_14187_length_748_cov_46.952234	293	373	14	1	80	0.0125000
NODE_14187_length_748_cov_46.952234	293	373	15	1	80	0.0125000
NODE_14187_length_748_cov_46.952234	293	373	16	16	80	0.2000000
NODE_14187_length_748_cov_46.952234	293	373	17	20	80	0.2500000
NODE_14187_length_748_cov_46.952234	293	373	19	21	80	0.2625000
NODE_14187_length_748_cov_46.952234	293	373	20	4	80	0.0500000
NODE_14187_length_748_cov_46.952234	346	426	11	10	80	0.1250000
NODE_14187_length_748_cov_46.952234	346	426	13	16	80	0.2000000
NODE_14187_length_748_cov_46.952234	346	426	14	6	80	0.0750000
NODE_14187_length_748_cov_46.952234	346	426	16	7	80	0.0875000
NODE_14187_length_748_cov_46.952234	346	426	17	11	80	0.1375000
NODE_14187_length_748_cov_46.952234	346	426	18	2	80	0.0250000
NODE_14187_length_748_cov_46.952234	346	426	19	21	80	0.2625000
NODE_14187_length_748_cov_46.952234	346	426	20	7	80	0.0875000
NODE_14188_length_748_cov_45.001541	272	352	8	3	80	0.0375000
NODE_14188_length_748_cov_45.001541	272	352	10	13	80	0.1625000
NODE_14188_length_748_cov_45.001541	272	352	11	12	80	0.1500000
NODE_14188_length_748_cov_45.001541	272	352	13	5	80	0.0625000
NODE_14188_length_748_cov_45.001541	272	352	14	44	80	0.5500000
NODE_14188_length_748_cov_45.001541	272	352	15	3	80	0.0375000
NODE_14188_length_748_cov_45.001541	325	405	8	9	80	0.1125000
NODE_14188_length_748_cov_45.001541	325	405	9	1	80	0.0125000
NODE_14188_length_748_cov_45.001541	325	405	10	4	80	0.0500000
NODE_14188_length_748_cov_45.001541	325	405	12	27	80	0.3375000
NODE_14188_length_748_cov_45.001541	325	405	14	39	80	0.4875000
NODE_14189_length_748_cov_34.355932	488	568	9	20	80	0.2500000
NODE_14189_length_748_cov_34.355932	488	568	10	23	80	0.2875000
NODE_14189_length_748_cov_34.355932	488	568	11	27	80	0.3375000
NODE_14189_length_748_cov_34.355932	488	568	12	3	80	0.0375000
NODE_14189_length_748_cov_34.355932	488	568	13	7	80	0.0875000
NODE_14189_length_748_cov_34.355932	541	621	7	3	80	0.0375000
NODE_14189_length_748_cov_34.355932	541	621	8	10	80	0.1250000
NODE_14189_length_748_cov_34.355932	541	621	9	3	80	0.0375000
NODE_14189_length_748_cov_34.355932	541	621	11	22	80	0.2750000
NODE_14189_length_748_cov_34.355932	541	621	12	24	80	0.3000000
NODE_14189_length_748_cov_34.355932	541	621	13	11	80	0.1375000
NODE_14189_length_748_cov_34.355932	541	621	14	7	80	0.0875000
NODE_14190_length_748_cov_25.972265	297	377	6	9	80	0.1125000
NODE_14190_length_748_cov_25.972265	297	377	7	43	80	0.5375000
NODE_14190_length_748_cov_25.972265	297	377	8	18	80	0.2250000
NODE_14190_length_748_cov_25.972265	297	377	9	2	80	0.0250000
NODE_14190_length_748_cov_25.972265	297	377	10	8	80	0.1000000
NODE_14190_length_748_cov_25.972265	350	430	5	20	80	0.2500000
NODE_14190_length_748_cov_25.972265	350	430	7	11	80	0.1375000
NODE_14190_length_748_cov_25.972265	350	430	8	27	80	0.3375000
NODE_14190_length_748_cov_25.972265	350	430	9	7	80	0.0875000
NODE_14190_length_748_cov_25.972265	350	430	10	15	80	0.1875000
NODE_14191_length_748_cov_21.050847	362	442	1	15	80	0.1875000
NODE_14191_length_748_cov_21.050847	362	442	2	65	80	0.8125000
NODE_14191_length_748_cov_21.050847	415	495	1	35	80	0.4375000
NODE_14191_length_748_cov_21.050847	415	495	2	45	80	0.5625000
NODE_14192_length_748_cov_20.682589	353	433	6	3	80	0.0375000
NODE_14192_length_748_cov_20.682589	353	433	7	9	80	0.1125000
NODE_14192_length_748_cov_20.682589	353	433	8	50	80	0.6250000
NODE_14192_length_748_cov_20.682589	353	433	9	18	80	0.2250000
NODE_14192_length_748_cov_20.682589	406	486	5	34	80	0.4250000
NODE_14192_length_748_cov_20.682589	406	486	6	22	80	0.2750000
NODE_14192_length_748_cov_20.682589	406	486	7	5	80	0.0625000
NODE_14192_length_748_cov_20.682589	406	486	8	7	80	0.0875000
NODE_14192_length_748_cov_20.682589	406	486	9	12	80	0.1500000
NODE_14193_length_748_cov_19.081664	261	341	0	80	80	1.0000000
NODE_14193_length_748_cov_19.081664	314	394	0	80	80	1.0000000
NODE_14193_length_748_cov_19.081664	390	470	0	11	80	0.1375000
NODE_14193_length_748_cov_19.081664	390	470	2	69	80	0.8625000
NODE_14193_length_748_cov_19.081664	443	522	2	29	79	0.3670886
NODE_14193_length_748_cov_19.081664	443	522	3	50	79	0.6329114
NODE_14194_length_748_cov_16.579353	81	161	0	80	80	1.0000000
NODE_14194_length_748_cov_16.579353	134	214	0	80	80	1.0000000
NODE_14194_length_748_cov_16.579353	210	290	0	80	80	1.0000000
NODE_14194_length_748_cov_16.579353	263	343	0	80	80	1.0000000
NODE_14196_length_748_cov_11.983051	375	455	0	80	80	1.0000000
NODE_14196_length_748_cov_11.983051	428	508	0	47	80	0.5875000
NODE_14196_length_748_cov_11.983051	428	508	2	33	80	0.4125000
NODE_14197_length_748_cov_11.474576	257	337	1	16	80	0.2000000
NODE_14197_length_748_cov_11.474576	257	337	2	21	80	0.2625000
NODE_14197_length_748_cov_11.474576	257	337	3	43	80	0.5375000
NODE_14197_length_748_cov_11.474576	310	390	1	13	80	0.1625000
NODE_14197_length_748_cov_11.474576	310	390	2	8	80	0.1000000
NODE_14197_length_748_cov_11.474576	310	390	3	59	80	0.7375000
NODE_14200_length_748_cov_7.979969	223	303	3	80	80	1.0000000
NODE_14200_length_748_cov_7.979969	276	356	1	16	80	0.2000000
NODE_14200_length_748_cov_7.979969	276	356	3	64	80	0.8000000
NODE_14240_length_747_cov_24.279321	205	285	11	1	80	0.0125000
NODE_14240_length_747_cov_24.279321	205	285	12	10	80	0.1250000
NODE_14240_length_747_cov_24.279321	205	285	13	7	80	0.0875000
NODE_14240_length_747_cov_24.279321	205	285	14	4	80	0.0500000
NODE_14240_length_747_cov_24.279321	205	285	15	8	80	0.1000000
NODE_14240_length_747_cov_24.279321	205	285	16	15	80	0.1875000
NODE_14240_length_747_cov_24.279321	205	285	17	4	80	0.0500000
NODE_14240_length_747_cov_24.279321	205	285	18	24	80	0.3000000
NODE_14240_length_747_cov_24.279321	205	285	19	7	80	0.0875000
NODE_14240_length_747_cov_24.279321	258	338	10	7	80	0.0875000
NODE_14240_length_747_cov_24.279321	258	338	11	2	80	0.0250000
NODE_14240_length_747_cov_24.279321	258	338	12	6	80	0.0750000
NODE_14240_length_747_cov_24.279321	258	338	13	1	80	0.0125000
NODE_14240_length_747_cov_24.279321	258	338	14	2	80	0.0250000
NODE_14240_length_747_cov_24.279321	258	338	16	31	80	0.3875000
NODE_14240_length_747_cov_24.279321	258	338	17	3	80	0.0375000
NODE_14240_length_747_cov_24.279321	258	338	18	21	80	0.2625000
NODE_14240_length_747_cov_24.279321	258	338	19	7	80	0.0875000
NODE_14241_length_747_cov_15.438272	352	432	4	78	80	0.9750000
NODE_14241_length_747_cov_15.438272	352	432	5	2	80	0.0250000
NODE_14241_length_747_cov_15.438272	405	485	2	12	80	0.1500000
NODE_14241_length_747_cov_15.438272	405	485	3	30	80	0.3750000
NODE_14241_length_747_cov_15.438272	405	485	4	36	80	0.4500000
NODE_14241_length_747_cov_15.438272	405	485	5	2	80	0.0250000
NODE_14244_length_747_cov_7.979938	237	317	2	31	80	0.3875000
NODE_14244_length_747_cov_7.979938	237	317	3	49	80	0.6125000
NODE_14244_length_747_cov_7.979938	290	370	1	44	80	0.5500000
NODE_14244_length_747_cov_7.979938	290	370	2	24	80	0.3000000
NODE_14244_length_747_cov_7.979938	290	370	3	12	80	0.1500000
NODE_14248_length_747_cov_4.918210	157	237	1	10	80	0.1250000
NODE_14248_length_747_cov_4.918210	157	237	2	1	80	0.0125000
NODE_14248_length_747_cov_4.918210	157	237	3	6	80	0.0750000
NODE_14248_length_747_cov_4.918210	157	237	4	16	80	0.2000000
NODE_14248_length_747_cov_4.918210	157	237	5	47	80	0.5875000
NODE_14248_length_747_cov_4.918210	210	290	4	26	80	0.3250000
NODE_14248_length_747_cov_4.918210	210	290	5	52	80	0.6500000
NODE_14248_length_747_cov_4.918210	210	290	6	2	80	0.0250000
NODE_14277_length_746_cov_44.041731	153	233	10	1	80	0.0125000
NODE_14277_length_746_cov_44.041731	153	233	11	25	80	0.3125000
NODE_14277_length_746_cov_44.041731	153	233	12	17	80	0.2125000
NODE_14277_length_746_cov_44.041731	153	233	16	2	80	0.0250000
NODE_14277_length_746_cov_44.041731	153	233	18	13	80	0.1625000
NODE_14277_length_746_cov_44.041731	153	233	19	5	80	0.0625000
NODE_14277_length_746_cov_44.041731	153	233	20	17	80	0.2125000
NODE_14277_length_746_cov_44.041731	206	286	13	15	80	0.1875000
NODE_14277_length_746_cov_44.041731	206	286	14	4	80	0.0500000
NODE_14277_length_746_cov_44.041731	206	286	15	8	80	0.1000000
NODE_14277_length_746_cov_44.041731	206	286	17	4	80	0.0500000
NODE_14277_length_746_cov_44.041731	206	286	18	12	80	0.1500000
NODE_14277_length_746_cov_44.041731	206	286	19	16	80	0.2000000
NODE_14277_length_746_cov_44.041731	206	286	20	21	80	0.2625000
NODE_14278_length_746_cov_24.435858	334	414	2	56	80	0.7000000
NODE_14278_length_746_cov_24.435858	334	414	3	15	80	0.1875000
NODE_14278_length_746_cov_24.435858	334	414	4	9	80	0.1125000
NODE_14278_length_746_cov_24.435858	387	467	2	18	80	0.2250000
NODE_14278_length_746_cov_24.435858	387	467	3	53	80	0.6625000
NODE_14278_length_746_cov_24.435858	387	467	4	9	80	0.1125000
NODE_14279_length_746_cov_20.225657	114	194	2	29	80	0.3625000
NODE_14279_length_746_cov_20.225657	114	194	3	8	80	0.1000000
NODE_14279_length_746_cov_20.225657	114	194	4	4	80	0.0500000
NODE_14279_length_746_cov_20.225657	114	194	5	39	80	0.4875000
NODE_14279_length_746_cov_20.225657	167	247	1	51	80	0.6375000
NODE_14279_length_746_cov_20.225657	167	247	2	29	80	0.3625000
NODE_14280_length_746_cov_17.919629	330	410	0	80	80	1.0000000
NODE_14280_length_746_cov_17.919629	383	463	0	80	80	1.0000000
NODE_14281_length_746_cov_17.523957	292	372	2	44	80	0.5500000
NODE_14281_length_746_cov_17.523957	292	372	3	1	80	0.0125000
NODE_14281_length_746_cov_17.523957	292	372	4	18	80	0.2250000
NODE_14281_length_746_cov_17.523957	292	372	6	10	80	0.1250000
NODE_14281_length_746_cov_17.523957	292	372	7	7	80	0.0875000
NODE_14281_length_746_cov_17.523957	345	425	2	10	80	0.1250000
NODE_14281_length_746_cov_17.523957	345	425	6	10	80	0.1250000
NODE_14281_length_746_cov_17.523957	345	425	7	18	80	0.2250000
NODE_14281_length_746_cov_17.523957	345	425	8	42	80	0.5250000
NODE_14282_length_746_cov_17.214838	306	386	0	31	80	0.3875000
NODE_14282_length_746_cov_17.214838	306	386	2	8	80	0.1000000
NODE_14282_length_746_cov_17.214838	306	386	4	41	80	0.5125000
NODE_14282_length_746_cov_17.214838	359	439	4	80	80	1.0000000
NODE_14283_length_746_cov_16.765070	344	424	0	53	80	0.6625000
NODE_14283_length_746_cov_16.765070	344	424	1	8	80	0.1000000
NODE_14283_length_746_cov_16.765070	344	424	3	19	80	0.2375000
NODE_14283_length_746_cov_16.765070	397	477	1	8	80	0.1000000
NODE_14283_length_746_cov_16.765070	397	477	3	60	80	0.7500000
NODE_14283_length_746_cov_16.765070	397	477	4	12	80	0.1500000
NODE_14284_length_746_cov_13.153014	126	206	4	16	80	0.2000000
NODE_14284_length_746_cov_13.153014	126	206	5	25	80	0.3125000
NODE_14284_length_746_cov_13.153014	126	206	6	32	80	0.4000000
NODE_14284_length_746_cov_13.153014	126	206	7	7	80	0.0875000
NODE_14284_length_746_cov_13.153014	179	259	5	2	80	0.0250000
NODE_14284_length_746_cov_13.153014	179	259	6	78	80	0.9750000
NODE_14284_length_746_cov_13.153014	244	263	3	1	19	0.0526316
NODE_14284_length_746_cov_13.153014	244	263	5	4	19	0.2105263
NODE_14284_length_746_cov_13.153014	244	263	6	14	19	0.7368421
NODE_14285_length_746_cov_12.316847	364	442	1	78	78	1.0000000
NODE_14286_length_746_cov_11.301391	349	429	3	11	80	0.1375000
NODE_14286_length_746_cov_11.301391	349	429	5	69	80	0.8625000
NODE_14286_length_746_cov_11.301391	402	482	2	30	80	0.3750000
NODE_14286_length_746_cov_11.301391	402	482	3	28	80	0.3500000
NODE_14286_length_746_cov_11.301391	402	482	5	22	80	0.2750000
NODE_14302_length_746_cov_2.639876	331	411	0	80	80	1.0000000
NODE_14307_length_746_cov_1.879444	435	502	0	67	67	1.0000000
NODE_14310_length_746_cov_1.727975	65	121	0	56	56	1.0000000
NODE_14310_length_746_cov_1.727975	494	540	2	20	46	0.4347826
NODE_14310_length_746_cov_1.727975	494	540	4	26	46	0.5652174
NODE_14329_length_745_cov_40.360681	257	337	7	13	80	0.1625000
NODE_14329_length_745_cov_40.360681	257	337	8	23	80	0.2875000
NODE_14329_length_745_cov_40.360681	257	337	9	5	80	0.0625000
NODE_14329_length_745_cov_40.360681	257	337	10	39	80	0.4875000
NODE_14329_length_745_cov_40.360681	310	390	6	52	80	0.6500000
NODE_14329_length_745_cov_40.360681	310	390	7	14	80	0.1750000
NODE_14329_length_745_cov_40.360681	310	390	8	14	80	0.1750000
NODE_14330_length_745_cov_30.817337	339	419	3	2	80	0.0250000
NODE_14330_length_745_cov_30.817337	339	419	4	78	80	0.9750000
NODE_14330_length_745_cov_30.817337	392	459	1	12	67	0.1791045
NODE_14330_length_745_cov_30.817337	392	459	2	11	67	0.1641791
NODE_14330_length_745_cov_30.817337	392	459	3	19	67	0.2835821
NODE_14330_length_745_cov_30.817337	392	459	4	25	67	0.3731343
NODE_14335_length_745_cov_8.620743	225	275	3	30	50	0.6000000
NODE_14335_length_745_cov_8.620743	225	275	4	18	50	0.3600000
NODE_14335_length_745_cov_8.620743	225	275	5	2	50	0.0400000
NODE_14335_length_745_cov_8.620743	248	328	3	7	80	0.0875000
NODE_14335_length_745_cov_8.620743	248	328	4	22	80	0.2750000
NODE_14335_length_745_cov_8.620743	248	328	5	24	80	0.3000000
NODE_14335_length_745_cov_8.620743	248	328	6	27	80	0.3375000
NODE_14343_length_745_cov_3.922601	249	280	6	20	31	0.6451613
NODE_14343_length_745_cov_3.922601	249	280	7	11	31	0.3548387
NODE_14343_length_745_cov_3.922601	253	333	5	6	80	0.0750000
NODE_14343_length_745_cov_3.922601	253	333	6	16	80	0.2000000
NODE_14343_length_745_cov_3.922601	253	333	7	58	80	0.7250000
NODE_14381_length_744_cov_44.953488	553	633	3	20	80	0.2500000
NODE_14381_length_744_cov_44.953488	553	633	4	21	80	0.2625000
NODE_14381_length_744_cov_44.953488	553	633	5	39	80	0.4875000
NODE_14381_length_744_cov_44.953488	553	633	3	20	80	0.2500000
NODE_14381_length_744_cov_44.953488	553	633	4	21	80	0.2625000
NODE_14381_length_744_cov_44.953488	553	633	5	39	80	0.4875000
NODE_14381_length_744_cov_44.953488	553	633	3	20	80	0.2500000
NODE_14381_length_744_cov_44.953488	553	633	4	21	80	0.2625000
NODE_14381_length_744_cov_44.953488	553	633	5	39	80	0.4875000
NODE_14381_length_744_cov_44.953488	553	633	3	20	80	0.2500000
NODE_14381_length_744_cov_44.953488	553	633	4	21	80	0.2625000
NODE_14381_length_744_cov_44.953488	553	633	5	39	80	0.4875000
NODE_14382_length_744_cov_35.333333	163	243	4	2	80	0.0250000
NODE_14382_length_744_cov_35.333333	163	243	6	2	80	0.0250000
NODE_14382_length_744_cov_35.333333	163	243	7	21	80	0.2625000
NODE_14382_length_744_cov_35.333333	163	243	8	3	80	0.0375000
NODE_14382_length_744_cov_35.333333	163	243	9	44	80	0.5500000
NODE_14382_length_744_cov_35.333333	163	243	10	8	80	0.1000000
NODE_14382_length_744_cov_35.333333	216	296	8	7	80	0.0875000
NODE_14382_length_744_cov_35.333333	216	296	9	21	80	0.2625000
NODE_14382_length_744_cov_35.333333	216	296	10	45	80	0.5625000
NODE_14382_length_744_cov_35.333333	216	296	11	7	80	0.0875000
NODE_14382_length_744_cov_35.333333	292	372	7	19	80	0.2375000
NODE_14382_length_744_cov_35.333333	292	372	8	37	80	0.4625000
NODE_14382_length_744_cov_35.333333	292	372	9	2	80	0.0250000
NODE_14382_length_744_cov_35.333333	292	372	10	12	80	0.1500000
NODE_14382_length_744_cov_35.333333	292	372	11	10	80	0.1250000
NODE_14382_length_744_cov_35.333333	345	425	5	30	80	0.3750000
NODE_14382_length_744_cov_35.333333	345	425	7	10	80	0.1250000
NODE_14382_length_744_cov_35.333333	345	425	8	40	80	0.5000000
NODE_14383_length_744_cov_34.503876	294	374	1	7	80	0.0875000
NODE_14383_length_744_cov_34.503876	294	374	2	23	80	0.2875000
NODE_14383_length_744_cov_34.503876	294	374	5	5	80	0.0625000
NODE_14383_length_744_cov_34.503876	294	374	6	5	80	0.0625000
NODE_14383_length_744_cov_34.503876	294	374	10	1	80	0.0125000
NODE_14383_length_744_cov_34.503876	294	374	11	16	80	0.2000000
NODE_14383_length_744_cov_34.503876	294	374	12	11	80	0.1375000
NODE_14383_length_744_cov_34.503876	294	374	13	12	80	0.1500000
NODE_14383_length_744_cov_34.503876	347	427	11	4	80	0.0500000
NODE_14383_length_744_cov_34.503876	347	427	12	11	80	0.1375000
NODE_14383_length_744_cov_34.503876	347	427	13	35	80	0.4375000
NODE_14383_length_744_cov_34.503876	347	427	14	17	80	0.2125000
NODE_14383_length_744_cov_34.503876	347	427	15	13	80	0.1625000
NODE_14384_length_744_cov_32.282171	333	403	0	64	70	0.9142857
NODE_14384_length_744_cov_32.282171	333	403	1	6	70	0.0857143
NODE_14384_length_744_cov_32.282171	440	520	0	80	80	1.0000000
NODE_14384_length_744_cov_32.282171	493	573	0	80	80	1.0000000
NODE_14390_length_744_cov_4.537984	260	340	0	80	80	1.0000000
NODE_14390_length_744_cov_4.537984	313	393	0	55	80	0.6875000
NODE_14390_length_744_cov_4.537984	313	393	1	25	80	0.3125000
NODE_14396_length_744_cov_2.784496	335	387	0	8	52	0.1538462
NODE_14396_length_744_cov_2.784496	335	387	1	44	52	0.8461539
NODE_14396_length_744_cov_2.784496	360	437	1	39	77	0.5064935
NODE_14396_length_744_cov_2.784496	360	437	2	38	77	0.4935065
NODE_14427_length_743_cov_26.369565	354	434	3	24	80	0.3000000
NODE_14427_length_743_cov_26.369565	354	434	4	56	80	0.7000000
NODE_14427_length_743_cov_26.369565	407	487	3	25	80	0.3125000
NODE_14427_length_743_cov_26.369565	407	487	4	54	80	0.6750000
NODE_14427_length_743_cov_26.369565	407	487	5	1	80	0.0125000
NODE_14428_length_743_cov_21.759317	138	218	3	4	80	0.0500000
NODE_14428_length_743_cov_21.759317	138	218	5	2	80	0.0250000
NODE_14428_length_743_cov_21.759317	138	218	6	8	80	0.1000000
NODE_14428_length_743_cov_21.759317	138	218	7	38	80	0.4750000
NODE_14428_length_743_cov_21.759317	138	218	9	28	80	0.3500000
NODE_14428_length_743_cov_21.759317	191	271	8	31	80	0.3875000
NODE_14428_length_743_cov_21.759317	191	271	9	49	80	0.6125000
NODE_14429_length_743_cov_18.173913	213	293	4	15	80	0.1875000
NODE_14429_length_743_cov_18.173913	213	293	5	65	80	0.8125000
NODE_14429_length_743_cov_18.173913	266	346	2	6	80	0.0750000
NODE_14429_length_743_cov_18.173913	266	346	3	10	80	0.1250000
NODE_14429_length_743_cov_18.173913	266	346	4	36	80	0.4500000
NODE_14429_length_743_cov_18.173913	266	346	5	28	80	0.3500000
NODE_14431_length_743_cov_17.066770	400	480	0	5	80	0.0625000
NODE_14431_length_743_cov_17.066770	400	480	2	75	80	0.9375000
NODE_14431_length_743_cov_17.066770	453	532	0	57	79	0.7215190
NODE_14431_length_743_cov_17.066770	453	532	2	22	79	0.2784810
NODE_14432_length_743_cov_16.354037	350	430	1	2	80	0.0250000
NODE_14432_length_743_cov_16.354037	350	430	3	26	80	0.3250000
NODE_14432_length_743_cov_16.354037	350	430	4	19	80	0.2375000
NODE_14432_length_743_cov_16.354037	350	430	5	33	80	0.4125000
NODE_14432_length_743_cov_16.354037	403	483	2	34	80	0.4250000
NODE_14432_length_743_cov_16.354037	403	483	4	2	80	0.0250000
NODE_14432_length_743_cov_16.354037	403	483	5	44	80	0.5500000
NODE_14433_length_743_cov_15.667702	220	300	0	80	80	1.0000000
NODE_14433_length_743_cov_15.667702	273	353	0	33	80	0.4125000
NODE_14433_length_743_cov_15.667702	273	353	2	47	80	0.5875000
NODE_14433_length_743_cov_15.667702	349	429	0	42	80	0.5250000
NODE_14433_length_743_cov_15.667702	349	429	2	38	80	0.4750000
NODE_14433_length_743_cov_15.667702	402	482	0	80	80	1.0000000
NODE_14434_length_743_cov_14.975155	289	362	0	73	73	1.0000000
NODE_14435_length_743_cov_14.100932	232	312	0	26	80	0.3250000
NODE_14435_length_743_cov_14.100932	232	312	1	54	80	0.6750000
NODE_14435_length_743_cov_14.100932	285	365	1	80	80	1.0000000
NODE_14435_length_743_cov_14.100932	361	441	1	10	80	0.1250000
NODE_14435_length_743_cov_14.100932	361	441	2	36	80	0.4500000
NODE_14435_length_743_cov_14.100932	361	441	3	2	80	0.0250000
NODE_14435_length_743_cov_14.100932	361	441	4	3	80	0.0375000
NODE_14435_length_743_cov_14.100932	361	441	5	6	80	0.0750000
NODE_14435_length_743_cov_14.100932	361	441	6	23	80	0.2875000
NODE_14435_length_743_cov_14.100932	414	494	5	4	80	0.0500000
NODE_14435_length_743_cov_14.100932	414	494	6	76	80	0.9500000
NODE_14436_length_743_cov_12.968944	268	348	0	80	80	1.0000000
NODE_14436_length_743_cov_12.968944	321	401	0	80	80	1.0000000
NODE_14437_length_743_cov_12.847826	485	565	12	7	80	0.0875000
NODE_14437_length_743_cov_12.847826	485	565	13	3	80	0.0375000
NODE_14437_length_743_cov_12.847826	485	565	14	6	80	0.0750000
NODE_14437_length_743_cov_12.847826	485	565	15	7	80	0.0875000
NODE_14437_length_743_cov_12.847826	485	565	16	31	80	0.3875000
NODE_14437_length_743_cov_12.847826	485	565	17	26	80	0.3250000
NODE_14437_length_743_cov_12.847826	538	618	4	7	80	0.0875000
NODE_14437_length_743_cov_12.847826	538	618	5	6	80	0.0750000
NODE_14437_length_743_cov_12.847826	538	618	7	8	80	0.1000000
NODE_14437_length_743_cov_12.847826	538	618	8	6	80	0.0750000
NODE_14437_length_743_cov_12.847826	538	618	10	13	80	0.1625000
NODE_14437_length_743_cov_12.847826	538	618	12	20	80	0.2500000
NODE_14437_length_743_cov_12.847826	538	618	13	3	80	0.0375000
NODE_14437_length_743_cov_12.847826	538	618	15	3	80	0.0375000
NODE_14437_length_743_cov_12.847826	538	618	16	14	80	0.1750000
NODE_14438_length_743_cov_11.871118	403	483	0	80	80	1.0000000
NODE_14438_length_743_cov_11.871118	456	536	0	80	80	1.0000000
NODE_14439_length_743_cov_11.760870	337	417	6	7	80	0.0875000
NODE_14439_length_743_cov_11.760870	337	417	8	2	80	0.0250000
NODE_14439_length_743_cov_11.760870	337	417	10	33	80	0.4125000
NODE_14439_length_743_cov_11.760870	337	417	11	34	80	0.4250000
NODE_14439_length_743_cov_11.760870	337	417	12	4	80	0.0500000
NODE_14439_length_743_cov_11.760870	390	470	7	21	80	0.2625000
NODE_14439_length_743_cov_11.760870	390	470	8	5	80	0.0625000
NODE_14439_length_743_cov_11.760870	390	470	10	10	80	0.1250000
NODE_14439_length_743_cov_11.760870	390	470	11	23	80	0.2875000
NODE_14439_length_743_cov_11.760870	390	470	12	21	80	0.2625000
NODE_14440_length_743_cov_9.006211	351	431	0	15	80	0.1875000
NODE_14440_length_743_cov_9.006211	351	431	2	65	80	0.8125000
NODE_14440_length_743_cov_9.006211	404	484	2	80	80	1.0000000
NODE_14441_length_743_cov_8.063665	290	370	2	62	80	0.7750000
NODE_14441_length_743_cov_8.063665	290	370	3	18	80	0.2250000
NODE_14441_length_743_cov_8.063665	343	423	1	3	80	0.0375000
NODE_14441_length_743_cov_8.063665	343	423	2	67	80	0.8375000
NODE_14441_length_743_cov_8.063665	343	423	3	10	80	0.1250000
NODE_14456_length_743_cov_2.029503	260	284	0	24	24	1.0000000
NODE_14456_length_743_cov_2.029503	301	363	0	62	62	1.0000000
NODE_14473_length_743_cov_0.989130	592	670	0	17	78	0.2179487
NODE_14473_length_743_cov_0.989130	592	670	2	61	78	0.7820513
NODE_14477_length_742_cov_23.664075	271	351	0	80	80	1.0000000
NODE_14477_length_742_cov_23.664075	324	404	0	80	80	1.0000000
NODE_14478_length_742_cov_19.488336	288	368	1	4	80	0.0500000
NODE_14478_length_742_cov_19.488336	288	368	3	23	80	0.2875000
NODE_14478_length_742_cov_19.488336	288	368	5	53	80	0.6625000
NODE_14478_length_742_cov_19.488336	341	421	0	8	80	0.1000000
NODE_14478_length_742_cov_19.488336	341	421	2	3	80	0.0375000
NODE_14478_length_742_cov_19.488336	341	421	3	22	80	0.2750000
NODE_14478_length_742_cov_19.488336	341	421	5	47	80	0.5875000
NODE_14479_length_742_cov_18.528771	319	399	4	49	80	0.6125000
NODE_14479_length_742_cov_18.528771	319	399	5	6	80	0.0750000
NODE_14479_length_742_cov_18.528771	319	399	6	4	80	0.0500000
NODE_14479_length_742_cov_18.528771	319	399	7	21	80	0.2625000
NODE_14479_length_742_cov_18.528771	372	452	5	2	80	0.0250000
NODE_14479_length_742_cov_18.528771	372	452	6	4	80	0.0500000
NODE_14479_length_742_cov_18.528771	372	452	7	25	80	0.3125000
NODE_14479_length_742_cov_18.528771	372	452	8	17	80	0.2125000
NODE_14479_length_742_cov_18.528771	372	452	9	32	80	0.4000000
NODE_14480_length_742_cov_17.401244	126	206	4	80	80	1.0000000
NODE_14480_length_742_cov_17.401244	179	259	2	20	80	0.2500000
NODE_14480_length_742_cov_17.401244	179	259	4	60	80	0.7500000
NODE_14482_length_742_cov_7.679627	274	354	1	80	80	1.0000000
NODE_14482_length_742_cov_7.679627	327	407	1	80	80	1.0000000
NODE_14521_length_741_cov_12.168224	316	392	1	9	76	0.1184211
NODE_14521_length_741_cov_12.168224	316	392	3	67	76	0.8815789
NODE_14521_length_741_cov_12.168224	598	663	0	20	65	0.3076923
NODE_14521_length_741_cov_12.168224	598	663	1	45	65	0.6923077
NODE_14522_length_741_cov_8.542056	198	278	2	27	80	0.3375000
NODE_14522_length_741_cov_8.542056	198	278	3	17	80	0.2125000
NODE_14522_length_741_cov_8.542056	198	278	4	36	80	0.4500000
NODE_14522_length_741_cov_8.542056	251	331	1	51	80	0.6375000
NODE_14522_length_741_cov_8.542056	251	331	2	10	80	0.1250000
NODE_14522_length_741_cov_8.542056	251	331	3	19	80	0.2375000
NODE_14525_length_741_cov_5.989097	457	538	0	49	81	0.6049383
NODE_14525_length_741_cov_5.989097	457	538	2	32	81	0.3950617
NODE_14536_length_741_cov_2.556075	212	289	0	15	77	0.1948052
NODE_14536_length_741_cov_2.556075	212	289	2	10	77	0.1298701
NODE_14536_length_741_cov_2.556075	212	289	4	51	77	0.6623377
NODE_14536_length_741_cov_2.556075	212	289	6	1	77	0.0129870
NODE_14571_length_740_cov_54.372855	192	272	11	16	80	0.2000000
NODE_14571_length_740_cov_54.372855	192	272	12	7	80	0.0875000
NODE_14571_length_740_cov_54.372855	192	272	14	1	80	0.0125000
NODE_14571_length_740_cov_54.372855	192	272	15	29	80	0.3625000
NODE_14571_length_740_cov_54.372855	192	272	17	23	80	0.2875000
NODE_14571_length_740_cov_54.372855	192	272	18	4	80	0.0500000
NODE_14571_length_740_cov_54.372855	245	325	11	6	80	0.0750000
NODE_14571_length_740_cov_54.372855	245	325	12	11	80	0.1375000
NODE_14571_length_740_cov_54.372855	245	325	13	13	80	0.1625000
NODE_14571_length_740_cov_54.372855	245	325	15	4	80	0.0500000
NODE_14571_length_740_cov_54.372855	245	325	16	12	80	0.1500000
NODE_14571_length_740_cov_54.372855	245	325	17	30	80	0.3750000
NODE_14571_length_740_cov_54.372855	245	325	18	4	80	0.0500000
NODE_14571_length_740_cov_54.372855	321	401	3	2	80	0.0250000
NODE_14571_length_740_cov_54.372855	321	401	4	33	80	0.4125000
NODE_14571_length_740_cov_54.372855	321	401	5	7	80	0.0875000
NODE_14571_length_740_cov_54.372855	321	401	6	15	80	0.1875000
NODE_14571_length_740_cov_54.372855	321	401	7	4	80	0.0500000
NODE_14571_length_740_cov_54.372855	321	401	8	2	80	0.0250000
NODE_14571_length_740_cov_54.372855	321	401	9	2	80	0.0250000
NODE_14571_length_740_cov_54.372855	321	401	10	6	80	0.0750000
NODE_14571_length_740_cov_54.372855	321	401	11	8	80	0.1000000
NODE_14571_length_740_cov_54.372855	321	401	12	1	80	0.0125000
NODE_14571_length_740_cov_54.372855	374	454	3	2	80	0.0250000
NODE_14571_length_740_cov_54.372855	374	454	4	78	80	0.9750000
NODE_14572_length_740_cov_51.758190	194	274	7	6	80	0.0750000
NODE_14572_length_740_cov_51.758190	194	274	8	10	80	0.1250000
NODE_14572_length_740_cov_51.758190	194	274	9	3	80	0.0375000
NODE_14572_length_740_cov_51.758190	194	274	10	3	80	0.0375000
NODE_14572_length_740_cov_51.758190	194	274	11	21	80	0.2625000
NODE_14572_length_740_cov_51.758190	194	274	12	5	80	0.0625000
NODE_14572_length_740_cov_51.758190	194	274	13	32	80	0.4000000
NODE_14572_length_740_cov_51.758190	247	327	9	3	80	0.0375000
NODE_14572_length_740_cov_51.758190	247	327	11	12	80	0.1500000
NODE_14572_length_740_cov_51.758190	247	327	12	16	80	0.2000000
NODE_14572_length_740_cov_51.758190	247	327	13	38	80	0.4750000
NODE_14572_length_740_cov_51.758190	247	327	14	11	80	0.1375000
NODE_14573_length_740_cov_34.185647	359	439	10	4	80	0.0500000
NODE_14573_length_740_cov_34.185647	359	439	11	15	80	0.1875000
NODE_14573_length_740_cov_34.185647	359	439	12	47	80	0.5875000
NODE_14573_length_740_cov_34.185647	359	439	13	13	80	0.1625000
NODE_14573_length_740_cov_34.185647	359	439	14	1	80	0.0125000
NODE_14573_length_740_cov_34.185647	412	492	6	18	80	0.2250000
NODE_14573_length_740_cov_34.185647	412	492	8	11	80	0.1375000
NODE_14573_length_740_cov_34.185647	412	492	10	20	80	0.2500000
NODE_14573_length_740_cov_34.185647	412	492	11	6	80	0.0750000
NODE_14573_length_740_cov_34.185647	412	492	12	25	80	0.3125000
NODE_14574_length_740_cov_24.794072	286	366	0	80	80	1.0000000
NODE_14574_length_740_cov_24.794072	339	419	0	80	80	1.0000000
NODE_14575_length_740_cov_20.361934	316	396	2	52	80	0.6500000
NODE_14575_length_740_cov_20.361934	316	396	3	28	80	0.3500000
NODE_14575_length_740_cov_20.361934	369	449	1	35	80	0.4375000
NODE_14575_length_740_cov_20.361934	369	449	2	18	80	0.2250000
NODE_14575_length_740_cov_20.361934	369	449	3	27	80	0.3375000
NODE_14576_length_740_cov_18.982839	266	348	5	48	82	0.5853658
NODE_14576_length_740_cov_18.982839	266	348	7	34	82	0.4146341
NODE_14576_length_740_cov_18.982839	321	401	2	7	80	0.0875000
NODE_14576_length_740_cov_18.982839	321	401	3	18	80	0.2250000
NODE_14576_length_740_cov_18.982839	321	401	4	2	80	0.0250000
NODE_14576_length_740_cov_18.982839	321	401	5	24	80	0.3000000
NODE_14576_length_740_cov_18.982839	321	401	7	29	80	0.3625000
NODE_14577_length_740_cov_16.755070	354	434	0	55	80	0.6875000
NODE_14577_length_740_cov_16.755070	354	434	2	9	80	0.1125000
NODE_14577_length_740_cov_16.755070	354	434	4	16	80	0.2000000
NODE_14577_length_740_cov_16.755070	407	487	0	80	80	1.0000000
NODE_14579_length_740_cov_7.585023	206	286	0	80	80	1.0000000
NODE_14579_length_740_cov_7.585023	259	339	0	80	80	1.0000000
NODE_14580_length_740_cov_7.174727	165	245	0	13	80	0.1625000
NODE_14580_length_740_cov_7.174727	165	245	1	8	80	0.1000000
NODE_14580_length_740_cov_7.174727	165	245	2	59	80	0.7375000
NODE_14580_length_740_cov_7.174727	218	298	0	4	80	0.0500000
NODE_14580_length_740_cov_7.174727	218	298	2	76	80	0.9500000
NODE_14614_length_739_cov_52.970312	346	426	3	12	80	0.1500000
NODE_14614_length_739_cov_52.970312	346	426	5	9	80	0.1125000
NODE_14614_length_739_cov_52.970312	346	426	7	15	80	0.1875000
NODE_14614_length_739_cov_52.970312	346	426	8	44	80	0.5500000
NODE_14614_length_739_cov_52.970312	399	479	6	31	80	0.3875000
NODE_14614_length_739_cov_52.970312	399	479	7	10	80	0.1250000
NODE_14614_length_739_cov_52.970312	399	479	8	39	80	0.4875000
NODE_14615_length_739_cov_31.175000	204	284	0	10	80	0.1250000
NODE_14615_length_739_cov_31.175000	204	284	4	5	80	0.0625000
NODE_14615_length_739_cov_31.175000	204	284	5	13	80	0.1625000
NODE_14615_length_739_cov_31.175000	204	284	6	11	80	0.1375000
NODE_14615_length_739_cov_31.175000	204	284	8	2	80	0.0250000
NODE_14615_length_739_cov_31.175000	204	284	12	39	80	0.4875000
NODE_14615_length_739_cov_31.175000	257	337	7	6	80	0.0750000
NODE_14615_length_739_cov_31.175000	257	337	8	3	80	0.0375000
NODE_14615_length_739_cov_31.175000	257	337	9	3	80	0.0375000
NODE_14615_length_739_cov_31.175000	257	337	10	2	80	0.0250000
NODE_14615_length_739_cov_31.175000	257	337	12	66	80	0.8250000
NODE_14616_length_739_cov_25.482813	487	567	12	16	80	0.2000000
NODE_14616_length_739_cov_25.482813	487	567	13	9	80	0.1125000
NODE_14616_length_739_cov_25.482813	487	567	14	31	80	0.3875000
NODE_14616_length_739_cov_25.482813	487	567	15	6	80	0.0750000
NODE_14616_length_739_cov_25.482813	487	567	16	18	80	0.2250000
NODE_14616_length_739_cov_25.482813	540	620	6	3	80	0.0375000
NODE_14616_length_739_cov_25.482813	540	620	8	1	80	0.0125000
NODE_14616_length_739_cov_25.482813	540	620	10	3	80	0.0375000
NODE_14616_length_739_cov_25.482813	540	620	11	1	80	0.0125000
NODE_14616_length_739_cov_25.482813	540	620	12	36	80	0.4500000
NODE_14616_length_739_cov_25.482813	540	620	13	8	80	0.1000000
NODE_14616_length_739_cov_25.482813	540	620	14	9	80	0.1125000
NODE_14616_length_739_cov_25.482813	540	620	15	5	80	0.0625000
NODE_14616_length_739_cov_25.482813	540	620	16	14	80	0.1750000
NODE_14617_length_739_cov_24.871875	191	271	3	16	80	0.2000000
NODE_14617_length_739_cov_24.871875	191	271	4	12	80	0.1500000
NODE_14617_length_739_cov_24.871875	191	271	6	1	80	0.0125000
NODE_14617_length_739_cov_24.871875	191	271	7	15	80	0.1875000
NODE_14617_length_739_cov_24.871875	191	271	8	3	80	0.0375000
NODE_14617_length_739_cov_24.871875	191	271	9	9	80	0.1125000
NODE_14617_length_739_cov_24.871875	191	271	11	13	80	0.1625000
NODE_14617_length_739_cov_24.871875	191	271	12	11	80	0.1375000
NODE_14617_length_739_cov_24.871875	244	324	8	15	80	0.1875000
NODE_14617_length_739_cov_24.871875	244	324	9	37	80	0.4625000
NODE_14617_length_739_cov_24.871875	244	324	10	3	80	0.0375000
NODE_14617_length_739_cov_24.871875	244	324	11	13	80	0.1625000
NODE_14617_length_739_cov_24.871875	244	324	12	12	80	0.1500000
NODE_14618_length_739_cov_18.360937	146	226	0	33	80	0.4125000
NODE_14618_length_739_cov_18.360937	146	226	2	47	80	0.5875000
NODE_14618_length_739_cov_18.360937	199	279	2	80	80	1.0000000
NODE_14619_length_739_cov_13.195312	273	353	5	9	80	0.1125000
NODE_14619_length_739_cov_13.195312	273	353	6	38	80	0.4750000
NODE_14619_length_739_cov_13.195312	273	353	7	33	80	0.4125000
NODE_14619_length_739_cov_13.195312	326	406	4	13	80	0.1625000
NODE_14619_length_739_cov_13.195312	326	406	5	23	80	0.2875000
NODE_14619_length_739_cov_13.195312	326	406	6	26	80	0.3250000
NODE_14619_length_739_cov_13.195312	326	406	7	18	80	0.2250000
NODE_14620_length_739_cov_10.314063	231	311	2	8	80	0.1000000
NODE_14620_length_739_cov_10.314063	231	311	4	6	80	0.0750000
NODE_14620_length_739_cov_10.314063	231	311	6	66	80	0.8250000
NODE_14620_length_739_cov_10.314063	284	364	0	47	80	0.5875000
NODE_14620_length_739_cov_10.314063	284	364	2	6	80	0.0750000
NODE_14620_length_739_cov_10.314063	284	364	4	5	80	0.0625000
NODE_14620_length_739_cov_10.314063	284	364	6	22	80	0.2750000
NODE_14622_length_739_cov_8.523438	468	548	1	4	80	0.0500000
NODE_14622_length_739_cov_8.523438	468	548	2	76	80	0.9500000
NODE_14622_length_739_cov_8.523438	521	600	1	30	79	0.3797468
NODE_14622_length_739_cov_8.523438	521	600	2	49	79	0.6202531
NODE_14623_length_739_cov_7.398438	342	422	0	18	80	0.2250000
NODE_14623_length_739_cov_7.398438	342	422	2	62	80	0.7750000
NODE_14623_length_739_cov_7.398438	395	475	2	80	80	1.0000000
NODE_14625_length_739_cov_5.826562	252	332	0	12	80	0.1500000
NODE_14625_length_739_cov_5.826562	252	332	2	68	80	0.8500000
NODE_14625_length_739_cov_5.826562	305	385	2	80	80	1.0000000
NODE_14634_length_739_cov_3.232813	355	435	0	23	80	0.2875000
NODE_14634_length_739_cov_3.232813	355	435	1	57	80	0.7125000
NODE_14634_length_739_cov_3.232813	408	488	1	80	80	1.0000000
NODE_14679_length_738_cov_35.278560	274	318	12	4	44	0.0909091
NODE_14679_length_738_cov_35.278560	274	318	13	5	44	0.1136364
NODE_14679_length_738_cov_35.278560	274	318	14	10	44	0.2272727
NODE_14679_length_738_cov_35.278560	274	318	15	5	44	0.1136364
NODE_14679_length_738_cov_35.278560	274	318	16	19	44	0.4318182
NODE_14679_length_738_cov_35.278560	274	318	18	1	44	0.0227273
NODE_14680_length_738_cov_21.672926	208	288	5	3	80	0.0375000
NODE_14680_length_738_cov_21.672926	208	288	7	33	80	0.4125000
NODE_14680_length_738_cov_21.672926	208	288	9	9	80	0.1125000
NODE_14680_length_738_cov_21.672926	208	288	10	21	80	0.2625000
NODE_14680_length_738_cov_21.672926	208	288	11	14	80	0.1750000
NODE_14680_length_738_cov_21.672926	261	341	7	17	80	0.2125000
NODE_14680_length_738_cov_21.672926	261	341	8	33	80	0.4125000
NODE_14680_length_738_cov_21.672926	261	341	10	16	80	0.2000000
NODE_14680_length_738_cov_21.672926	261	341	11	14	80	0.1750000
NODE_14681_length_738_cov_15.665102	302	382	2	80	80	1.0000000
NODE_14681_length_738_cov_15.665102	355	435	2	80	80	1.0000000
NODE_14682_length_738_cov_15.661972	338	418	2	1	80	0.0125000
NODE_14682_length_738_cov_15.661972	338	418	3	79	80	0.9875000
NODE_14682_length_738_cov_15.661972	391	471	1	17	80	0.2125000
NODE_14682_length_738_cov_15.661972	391	471	2	10	80	0.1250000
NODE_14682_length_738_cov_15.661972	391	471	3	53	80	0.6625000
NODE_14683_length_738_cov_12.594679	49	129	3	4	80	0.0500000
NODE_14683_length_738_cov_12.594679	49	129	4	14	80	0.1750000
NODE_14683_length_738_cov_12.594679	49	129	7	3	80	0.0375000
NODE_14683_length_738_cov_12.594679	49	129	8	35	80	0.4375000
NODE_14683_length_738_cov_12.594679	49	129	9	22	80	0.2750000
NODE_14683_length_738_cov_12.594679	49	129	10	2	80	0.0250000
NODE_14683_length_738_cov_12.594679	102	182	8	3	80	0.0375000
NODE_14683_length_738_cov_12.594679	102	182	9	22	80	0.2750000
NODE_14683_length_738_cov_12.594679	102	182	10	25	80	0.3125000
NODE_14683_length_738_cov_12.594679	102	182	11	7	80	0.0875000
NODE_14683_length_738_cov_12.594679	102	182	12	23	80	0.2875000
NODE_14683_length_738_cov_12.594679	178	258	7	17	80	0.2125000
NODE_14683_length_738_cov_12.594679	178	258	8	8	80	0.1000000
NODE_14683_length_738_cov_12.594679	178	258	9	13	80	0.1625000
NODE_14683_length_738_cov_12.594679	178	258	10	23	80	0.2875000
NODE_14683_length_738_cov_12.594679	178	258	11	8	80	0.1000000
NODE_14683_length_738_cov_12.594679	178	258	12	11	80	0.1375000
NODE_14683_length_738_cov_12.594679	231	311	6	8	80	0.1000000
NODE_14683_length_738_cov_12.594679	231	311	7	26	80	0.3250000
NODE_14683_length_738_cov_12.594679	231	311	8	22	80	0.2750000
NODE_14683_length_738_cov_12.594679	231	311	10	16	80	0.2000000
NODE_14683_length_738_cov_12.594679	231	311	11	8	80	0.1000000
NODE_14691_length_738_cov_4.056338	254	326	0	72	72	1.0000000
NODE_14691_length_738_cov_4.056338	437	528	0	70	91	0.7692308
NODE_14691_length_738_cov_4.056338	437	528	1	15	91	0.1648352
NODE_14691_length_738_cov_4.056338	437	528	2	6	91	0.0659341
NODE_14724_length_737_cov_22.363636	303	383	2	80	80	1.0000000
NODE_14724_length_737_cov_22.363636	356	436	2	80	80	1.0000000
NODE_14725_length_737_cov_21.318182	208	288	2	9	80	0.1125000
NODE_14725_length_737_cov_21.318182	208	288	3	54	80	0.6750000
NODE_14725_length_737_cov_21.318182	208	288	4	17	80	0.2125000
NODE_14725_length_737_cov_21.318182	261	341	1	37	80	0.4625000
NODE_14725_length_737_cov_21.318182	261	341	2	25	80	0.3125000
NODE_14725_length_737_cov_21.318182	261	341	3	18	80	0.2250000
NODE_14726_length_737_cov_17.161442	346	426	2	80	80	1.0000000
NODE_14726_length_737_cov_17.161442	399	479	0	43	80	0.5375000
NODE_14726_length_737_cov_17.161442	399	479	2	37	80	0.4625000
NODE_14727_length_737_cov_11.835423	211	291	3	49	80	0.6125000
NODE_14727_length_737_cov_11.835423	211	291	4	31	80	0.3875000
NODE_14727_length_737_cov_11.835423	264	344	1	7	80	0.0875000
NODE_14727_length_737_cov_11.835423	264	344	2	13	80	0.1625000
NODE_14727_length_737_cov_11.835423	264	344	3	30	80	0.3750000
NODE_14727_length_737_cov_11.835423	264	344	4	30	80	0.3750000
NODE_14729_length_737_cov_6.782132	488	548	0	60	60	1.0000000
NODE_14732_length_737_cov_6.089342	241	321	0	80	80	1.0000000
NODE_14732_length_737_cov_6.089342	294	374	0	80	80	1.0000000
NODE_14747_length_737_cov_2.548589	386	416	0	30	30	1.0000000
NODE_14781_length_736_cov_46.601256	226	306	4	27	80	0.3375000
NODE_14781_length_736_cov_46.601256	226	306	5	9	80	0.1125000
NODE_14781_length_736_cov_46.601256	226	306	6	44	80	0.5500000
NODE_14781_length_736_cov_46.601256	279	359	4	13	80	0.1625000
NODE_14781_length_736_cov_46.601256	279	359	5	48	80	0.6000000
NODE_14781_length_736_cov_46.601256	279	359	6	13	80	0.1625000
NODE_14781_length_736_cov_46.601256	279	359	7	6	80	0.0750000
NODE_14782_length_736_cov_32.442700	215	295	0	10	80	0.1250000
NODE_14782_length_736_cov_32.442700	215	295	2	70	80	0.8750000
NODE_14782_length_736_cov_32.442700	268	350	0	30	82	0.3658537
NODE_14782_length_736_cov_32.442700	268	350	2	52	82	0.6341463
NODE_14783_length_736_cov_26.364207	220	300	0	42	80	0.5250000
NODE_14783_length_736_cov_26.364207	220	300	2	38	80	0.4750000
NODE_14783_length_736_cov_26.364207	273	353	2	30	80	0.3750000
NODE_14783_length_736_cov_26.364207	273	353	4	50	80	0.6250000
NODE_14785_length_736_cov_10.317111	313	393	2	49	80	0.6125000
NODE_14785_length_736_cov_10.317111	313	393	4	31	80	0.3875000
NODE_14785_length_736_cov_10.317111	366	446	2	18	80	0.2250000
NODE_14785_length_736_cov_10.317111	366	446	3	1	80	0.0125000
NODE_14785_length_736_cov_10.317111	366	446	4	61	80	0.7625000
NODE_14786_length_736_cov_9.188383	292	372	0	80	80	1.0000000
NODE_14786_length_736_cov_9.188383	345	425	0	80	80	1.0000000
NODE_14787_length_736_cov_8.149137	315	391	3	1	76	0.0131579
NODE_14787_length_736_cov_8.149137	315	391	4	41	76	0.5394737
NODE_14787_length_736_cov_8.149137	315	391	6	9	76	0.1184211
NODE_14787_length_736_cov_8.149137	315	391	7	7	76	0.0921053
NODE_14787_length_736_cov_8.149137	315	391	8	18	76	0.2368421
NODE_14787_length_736_cov_8.149137	365	445	5	17	80	0.2125000
NODE_14787_length_736_cov_8.149137	365	445	6	31	80	0.3875000
NODE_14787_length_736_cov_8.149137	365	445	7	14	80	0.1750000
NODE_14787_length_736_cov_8.149137	365	445	8	18	80	0.2250000
NODE_14788_length_736_cov_8.103611	295	375	0	80	80	1.0000000
NODE_14788_length_736_cov_8.103611	348	428	0	80	80	1.0000000
NODE_14789_length_736_cov_7.513344	239	319	0	1	80	0.0125000
NODE_14789_length_736_cov_7.513344	239	319	2	79	80	0.9875000
NODE_14789_length_736_cov_7.513344	292	372	0	22	80	0.2750000
NODE_14789_length_736_cov_7.513344	292	372	2	58	80	0.7250000
NODE_14792_length_736_cov_5.967033	253	333	0	42	80	0.5250000
NODE_14792_length_736_cov_5.967033	253	333	2	38	80	0.4750000
NODE_14792_length_736_cov_5.967033	306	386	2	80	80	1.0000000
NODE_14795_length_736_cov_4.908948	258	338	3	29	80	0.3625000
NODE_14795_length_736_cov_4.908948	258	338	4	51	80	0.6375000
NODE_14795_length_736_cov_4.908948	311	391	1	16	80	0.2000000
NODE_14795_length_736_cov_4.908948	311	391	2	6	80	0.0750000
NODE_14795_length_736_cov_4.908948	311	391	3	28	80	0.3500000
NODE_14795_length_736_cov_4.908948	311	391	4	30	80	0.3750000
NODE_14825_length_735_cov_21.099057	265	345	0	80	80	1.0000000
NODE_14825_length_735_cov_21.099057	318	398	0	80	80	1.0000000
NODE_14826_length_735_cov_16.696541	190	270	2	23	80	0.2875000
NODE_14826_length_735_cov_16.696541	190	270	3	57	80	0.7125000
NODE_14826_length_735_cov_16.696541	243	323	1	14	80	0.1750000
NODE_14826_length_735_cov_16.696541	243	323	3	66	80	0.8250000
NODE_14826_length_735_cov_16.696541	479	538	2	59	59	1.0000000
NODE_14827_length_735_cov_13.143082	231	311	0	10	80	0.1250000
NODE_14827_length_735_cov_13.143082	231	311	1	25	80	0.3125000
NODE_14827_length_735_cov_13.143082	231	311	2	20	80	0.2500000
NODE_14827_length_735_cov_13.143082	231	311	4	5	80	0.0625000
NODE_14827_length_735_cov_13.143082	231	311	5	20	80	0.2500000
NODE_14827_length_735_cov_13.143082	284	364	2	2	80	0.0250000
NODE_14827_length_735_cov_13.143082	284	364	4	5	80	0.0625000
NODE_14827_length_735_cov_13.143082	284	364	5	73	80	0.9125000
NODE_14828_length_735_cov_12.415094	434	514	2	45	80	0.5625000
NODE_14828_length_735_cov_12.415094	434	514	3	7	80	0.0875000
NODE_14828_length_735_cov_12.415094	434	514	4	28	80	0.3500000
NODE_14828_length_735_cov_12.415094	487	567	0	14	80	0.1750000
NODE_14828_length_735_cov_12.415094	487	567	2	11	80	0.1375000
NODE_14828_length_735_cov_12.415094	487	567	3	35	80	0.4375000
NODE_14828_length_735_cov_12.415094	487	567	4	20	80	0.2500000
NODE_14836_length_735_cov_5.603774	326	394	0	68	68	1.0000000
NODE_14836_length_735_cov_5.603774	367	409	0	42	42	1.0000000
NODE_14880_length_734_cov_26.787402	209	289	3	13	80	0.1625000
NODE_14880_length_734_cov_26.787402	209	289	4	45	80	0.5625000
NODE_14880_length_734_cov_26.787402	209	289	5	22	80	0.2750000
NODE_14880_length_734_cov_26.787402	262	342	2	22	80	0.2750000
NODE_14880_length_734_cov_26.787402	262	342	3	9	80	0.1125000
NODE_14880_length_734_cov_26.787402	262	342	4	49	80	0.6125000
NODE_14881_length_734_cov_23.214173	200	280	1	40	80	0.5000000
NODE_14881_length_734_cov_23.214173	200	280	2	40	80	0.5000000
NODE_14881_length_734_cov_23.214173	253	333	2	80	80	1.0000000
NODE_14883_length_734_cov_21.645669	245	325	3	80	80	1.0000000
NODE_14883_length_734_cov_21.645669	298	378	0	44	80	0.5500000
NODE_14883_length_734_cov_21.645669	298	378	1	4	80	0.0500000
NODE_14883_length_734_cov_21.645669	298	378	3	32	80	0.4000000
NODE_14884_length_734_cov_14.393701	249	329	0	80	80	1.0000000
NODE_14884_length_734_cov_14.393701	302	382	0	80	80	1.0000000
NODE_14885_length_734_cov_11.324409	133	196	5	11	63	0.1746032
NODE_14885_length_734_cov_11.324409	133	196	7	19	63	0.3015873
NODE_14885_length_734_cov_11.324409	133	196	8	33	63	0.5238096
NODE_14885_length_734_cov_11.324409	169	229	8	60	60	1.0000000
NODE_14886_length_734_cov_10.872441	302	331	0	2	29	0.0689655
NODE_14886_length_734_cov_10.872441	302	331	2	27	29	0.9310345
NODE_14890_length_734_cov_6.352756	371	451	5	30	80	0.3750000
NODE_14890_length_734_cov_6.352756	371	451	6	4	80	0.0500000
NODE_14890_length_734_cov_6.352756	371	451	7	46	80	0.5750000
NODE_14890_length_734_cov_6.352756	424	504	4	2	80	0.0250000
NODE_14890_length_734_cov_6.352756	424	504	5	17	80	0.2125000
NODE_14890_length_734_cov_6.352756	424	504	7	61	80	0.7625000
NODE_14896_length_734_cov_2.705512	231	302	0	71	71	1.0000000
NODE_14934_length_733_cov_35.041009	268	348	1	24	80	0.3000000
NODE_14934_length_733_cov_35.041009	268	348	2	15	80	0.1875000
NODE_14934_length_733_cov_35.041009	268	348	3	41	80	0.5125000
NODE_14934_length_733_cov_35.041009	321	402	2	69	81	0.8518519
NODE_14934_length_733_cov_35.041009	321	402	3	12	81	0.1481481
NODE_14935_length_733_cov_29.810726	28	108	1	1	80	0.0125000
NODE_14935_length_733_cov_29.810726	28	108	3	13	80	0.1625000
NODE_14935_length_733_cov_29.810726	28	108	5	1	80	0.0125000
NODE_14935_length_733_cov_29.810726	28	108	6	56	80	0.7000000
NODE_14935_length_733_cov_29.810726	28	108	7	9	80	0.1125000
NODE_14935_length_733_cov_29.810726	81	161	5	11	80	0.1375000
NODE_14935_length_733_cov_29.810726	81	161	6	30	80	0.3750000
NODE_14935_length_733_cov_29.810726	81	161	7	39	80	0.4875000
NODE_14935_length_733_cov_29.810726	157	237	6	4	80	0.0500000
NODE_14935_length_733_cov_29.810726	157	237	7	11	80	0.1375000
NODE_14935_length_733_cov_29.810726	157	237	8	10	80	0.1250000
NODE_14935_length_733_cov_29.810726	157	237	9	1	80	0.0125000
NODE_14935_length_733_cov_29.810726	157	237	11	6	80	0.0750000
NODE_14935_length_733_cov_29.810726	157	237	12	44	80	0.5500000
NODE_14935_length_733_cov_29.810726	157	237	13	4	80	0.0500000
NODE_14935_length_733_cov_29.810726	210	290	8	10	80	0.1250000
NODE_14935_length_733_cov_29.810726	210	290	9	17	80	0.2125000
NODE_14935_length_733_cov_29.810726	210	290	11	14	80	0.1750000
NODE_14935_length_733_cov_29.810726	210	290	12	39	80	0.4875000
NODE_14936_length_733_cov_13.738170	333	413	8	78	80	0.9750000
NODE_14936_length_733_cov_13.738170	333	413	9	2	80	0.0250000
NODE_14936_length_733_cov_13.738170	386	466	2	3	80	0.0375000
NODE_14936_length_733_cov_13.738170	386	466	3	3	80	0.0375000
NODE_14936_length_733_cov_13.738170	386	466	4	3	80	0.0375000
NODE_14936_length_733_cov_13.738170	386	466	5	7	80	0.0875000
NODE_14936_length_733_cov_13.738170	386	466	6	30	80	0.3750000
NODE_14936_length_733_cov_13.738170	386	466	8	32	80	0.4000000
NODE_14936_length_733_cov_13.738170	386	466	9	2	80	0.0250000
NODE_14937_length_733_cov_11.471609	314	389	0	75	75	1.0000000
NODE_14938_length_733_cov_11.321767	245	325	2	22	80	0.2750000
NODE_14938_length_733_cov_11.321767	245	325	3	1	80	0.0125000
NODE_14938_length_733_cov_11.321767	245	325	4	57	80	0.7125000
NODE_14938_length_733_cov_11.321767	298	378	4	80	80	1.0000000
NODE_14940_length_733_cov_8.481073	318	395	0	77	77	1.0000000
NODE_14940_length_733_cov_8.481073	371	451	0	80	80	1.0000000
NODE_14944_length_733_cov_5.485804	659	715	20	7	56	0.1250000
NODE_14944_length_733_cov_5.485804	659	715	21	9	56	0.1607143
NODE_14944_length_733_cov_5.485804	659	715	22	16	56	0.2857143
NODE_14944_length_733_cov_5.485804	659	715	24	6	56	0.1071429
NODE_14944_length_733_cov_5.485804	659	715	25	1	56	0.0178571
NODE_14944_length_733_cov_5.485804	659	715	26	7	56	0.1250000
NODE_14944_length_733_cov_5.485804	659	715	27	10	56	0.1785714
NODE_14944_length_733_cov_5.485804	696	733	13	4	37	0.1081081
NODE_14944_length_733_cov_5.485804	696	733	14	2	37	0.0540541
NODE_14944_length_733_cov_5.485804	696	733	15	6	37	0.1621622
NODE_14944_length_733_cov_5.485804	696	733	16	5	37	0.1351351
NODE_14944_length_733_cov_5.485804	696	733	18	1	37	0.0270270
NODE_14944_length_733_cov_5.485804	696	733	20	7	37	0.1891892
NODE_14944_length_733_cov_5.485804	696	733	21	9	37	0.2432432
NODE_14944_length_733_cov_5.485804	696	733	22	3	37	0.0810811
NODE_14957_length_733_cov_2.272871	312	392	0	35	80	0.4375000
NODE_14957_length_733_cov_2.272871	312	392	2	45	80	0.5625000
NODE_14957_length_733_cov_2.272871	365	445	2	80	80	1.0000000
NODE_14975_length_732_cov_19.519747	229	309	3	2	80	0.0250000
NODE_14975_length_732_cov_19.519747	229	309	4	78	80	0.9750000
NODE_14975_length_732_cov_19.519747	282	362	1	11	80	0.1375000
NODE_14975_length_732_cov_19.519747	282	362	3	2	80	0.0250000
NODE_14975_length_732_cov_19.519747	282	362	4	67	80	0.8375000
NODE_14976_length_732_cov_10.846761	247	327	0	24	80	0.3000000
NODE_14976_length_732_cov_10.846761	247	327	1	13	80	0.1625000
NODE_14976_length_732_cov_10.846761	247	327	2	43	80	0.5375000
NODE_14976_length_732_cov_10.846761	300	380	0	77	80	0.9625000
NODE_14976_length_732_cov_10.846761	300	380	1	3	80	0.0375000
NODE_14977_length_732_cov_9.807267	276	356	0	43	80	0.5375000
NODE_14977_length_732_cov_9.807267	276	356	1	37	80	0.4625000
NODE_14977_length_732_cov_9.807267	329	409	0	80	80	1.0000000
NODE_14978_length_732_cov_8.053712	415	495	3	19	80	0.2375000
NODE_14978_length_732_cov_8.053712	415	495	4	61	80	0.7625000
NODE_14978_length_732_cov_8.053712	468	548	3	64	80	0.8000000
NODE_14978_length_732_cov_8.053712	468	548	4	16	80	0.2000000
NODE_14980_length_732_cov_5.194313	319	399	0	80	80	1.0000000
NODE_14980_length_732_cov_5.194313	372	452	0	80	80	1.0000000
NODE_14981_length_732_cov_4.998420	293	373	0	16	80	0.2000000
NODE_14981_length_732_cov_4.998420	293	373	1	53	80	0.6625000
NODE_14981_length_732_cov_4.998420	293	373	2	11	80	0.1375000
NODE_14981_length_732_cov_4.998420	346	426	0	16	80	0.2000000
NODE_14981_length_732_cov_4.998420	346	426	2	31	80	0.3875000
NODE_14981_length_732_cov_4.998420	346	426	4	33	80	0.4125000
NODE_14983_length_732_cov_4.758294	483	524	0	41	41	1.0000000
NODE_15021_length_731_cov_36.123418	464	544	3	62	80	0.7750000
NODE_15021_length_731_cov_36.123418	464	544	4	2	80	0.0250000
NODE_15021_length_731_cov_36.123418	464	544	5	13	80	0.1625000
NODE_15021_length_731_cov_36.123418	464	544	6	3	80	0.0375000
NODE_15021_length_731_cov_36.123418	517	597	3	9	80	0.1125000
NODE_15021_length_731_cov_36.123418	517	597	4	29	80	0.3625000
NODE_15021_length_731_cov_36.123418	517	597	5	29	80	0.3625000
NODE_15021_length_731_cov_36.123418	517	597	6	13	80	0.1625000
NODE_15022_length_731_cov_27.721519	294	374	2	3	80	0.0375000
NODE_15022_length_731_cov_27.721519	294	374	3	27	80	0.3375000
NODE_15022_length_731_cov_27.721519	294	374	4	11	80	0.1375000
NODE_15022_length_731_cov_27.721519	294	374	5	39	80	0.4875000
NODE_15022_length_731_cov_27.721519	347	427	4	55	80	0.6875000
NODE_15022_length_731_cov_27.721519	347	427	5	25	80	0.3125000
NODE_15023_length_731_cov_19.655063	394	474	6	39	80	0.4875000
NODE_15023_length_731_cov_19.655063	394	474	8	41	80	0.5125000
NODE_15023_length_731_cov_19.655063	447	527	0	9	80	0.1125000
NODE_15023_length_731_cov_19.655063	447	527	1	4	80	0.0500000
NODE_15023_length_731_cov_19.655063	447	527	3	4	80	0.0500000
NODE_15023_length_731_cov_19.655063	447	527	6	63	80	0.7875000
NODE_15024_length_731_cov_16.346519	429	509	0	40	80	0.5000000
NODE_15024_length_731_cov_16.346519	429	509	2	40	80	0.5000000
NODE_15024_length_731_cov_16.346519	482	562	0	4	80	0.0500000
NODE_15024_length_731_cov_16.346519	482	562	2	76	80	0.9500000
NODE_15025_length_731_cov_13.892405	321	401	0	80	80	1.0000000
NODE_15025_length_731_cov_13.892405	374	454	0	80	80	1.0000000
NODE_15027_length_731_cov_8.800633	218	298	2	4	80	0.0500000
NODE_15027_length_731_cov_8.800633	218	298	4	25	80	0.3125000
NODE_15027_length_731_cov_8.800633	218	298	6	51	80	0.6375000
NODE_15027_length_731_cov_8.800633	271	352	2	2	81	0.0246914
NODE_15027_length_731_cov_8.800633	271	352	4	62	81	0.7654321
NODE_15027_length_731_cov_8.800633	271	352	6	17	81	0.2098765
NODE_15028_length_731_cov_7.658228	335	406	2	25	71	0.3521127
NODE_15028_length_731_cov_7.658228	335	406	4	46	71	0.6478873
NODE_15028_length_731_cov_7.658228	387	468	2	28	81	0.3456790
NODE_15028_length_731_cov_7.658228	387	468	3	12	81	0.1481481
NODE_15028_length_731_cov_7.658228	387	468	4	41	81	0.5061728
NODE_15031_length_731_cov_5.471519	261	341	0	80	80	1.0000000
NODE_15031_length_731_cov_5.471519	314	394	0	80	80	1.0000000
NODE_15034_length_731_cov_4.083861	361	441	0	80	80	1.0000000
NODE_15034_length_731_cov_4.083861	458	482	0	24	24	1.0000000
NODE_15050_length_731_cov_2.226266	466	548	0	82	82	1.0000000
NODE_15077_length_730_cov_51.556260	349	429	2	13	80	0.1625000
NODE_15077_length_730_cov_51.556260	349	429	4	41	80	0.5125000
NODE_15077_length_730_cov_51.556260	349	429	6	26	80	0.3250000
NODE_15077_length_730_cov_51.556260	402	482	2	25	80	0.3125000
NODE_15077_length_730_cov_51.556260	402	482	4	46	80	0.5750000
NODE_15077_length_730_cov_51.556260	402	482	6	9	80	0.1125000
NODE_15078_length_730_cov_39.862124	370	450	1	23	80	0.2875000
NODE_15078_length_730_cov_39.862124	370	450	2	9	80	0.1125000
NODE_15078_length_730_cov_39.862124	370	450	3	41	80	0.5125000
NODE_15078_length_730_cov_39.862124	370	450	4	7	80	0.0875000
NODE_15078_length_730_cov_39.862124	423	503	3	80	80	1.0000000
NODE_15079_length_730_cov_15.801902	261	341	4	31	80	0.3875000
NODE_15079_length_730_cov_15.801902	261	341	5	2	80	0.0250000
NODE_15079_length_730_cov_15.801902	261	341	6	47	80	0.5875000
NODE_15079_length_730_cov_15.801902	314	394	2	27	80	0.3375000
NODE_15079_length_730_cov_15.801902	314	394	5	28	80	0.3500000
NODE_15079_length_730_cov_15.801902	314	394	6	25	80	0.3125000
NODE_15080_length_730_cov_11.746434	242	322	0	48	80	0.6000000
NODE_15080_length_730_cov_11.746434	242	322	2	32	80	0.4000000
NODE_15080_length_730_cov_11.746434	295	375	0	24	80	0.3000000
NODE_15080_length_730_cov_11.746434	295	375	2	56	80	0.7000000
NODE_15081_length_730_cov_9.209192	358	438	0	31	80	0.3875000
NODE_15081_length_730_cov_9.209192	358	438	1	8	80	0.1000000
NODE_15081_length_730_cov_9.209192	358	438	3	41	80	0.5125000
NODE_15081_length_730_cov_9.209192	411	483	0	26	72	0.3611111
NODE_15081_length_730_cov_9.209192	411	483	1	46	72	0.6388889
NODE_15131_length_729_cov_44.188889	418	498	10	12	80	0.1500000
NODE_15131_length_729_cov_44.188889	418	498	11	14	80	0.1750000
NODE_15131_length_729_cov_44.188889	418	498	12	7	80	0.0875000
NODE_15131_length_729_cov_44.188889	418	498	13	13	80	0.1625000
NODE_15131_length_729_cov_44.188889	418	498	14	24	80	0.3000000
NODE_15131_length_729_cov_44.188889	418	498	15	10	80	0.1250000
NODE_15131_length_729_cov_44.188889	471	551	8	4	80	0.0500000
NODE_15131_length_729_cov_44.188889	471	551	9	7	80	0.0875000
NODE_15131_length_729_cov_44.188889	471	551	10	6	80	0.0750000
NODE_15131_length_729_cov_44.188889	471	551	12	15	80	0.1875000
NODE_15131_length_729_cov_44.188889	471	551	13	21	80	0.2625000
NODE_15131_length_729_cov_44.188889	471	551	14	19	80	0.2375000
NODE_15131_length_729_cov_44.188889	471	551	15	8	80	0.1000000
NODE_15132_length_729_cov_40.390476	330	410	2	7	80	0.0875000
NODE_15132_length_729_cov_40.390476	330	410	4	8	80	0.1000000
NODE_15132_length_729_cov_40.390476	330	410	5	6	80	0.0750000
NODE_15132_length_729_cov_40.390476	330	410	7	25	80	0.3125000
NODE_15132_length_729_cov_40.390476	330	410	8	5	80	0.0625000
NODE_15132_length_729_cov_40.390476	330	410	10	14	80	0.1750000
NODE_15132_length_729_cov_40.390476	330	410	12	15	80	0.1875000
NODE_15132_length_729_cov_40.390476	383	463	10	12	80	0.1500000
NODE_15132_length_729_cov_40.390476	383	463	11	39	80	0.4875000
NODE_15132_length_729_cov_40.390476	383	463	12	23	80	0.2875000
NODE_15132_length_729_cov_40.390476	383	463	13	6	80	0.0750000
NODE_15133_length_729_cov_35.973016	231	311	5	2	80	0.0250000
NODE_15133_length_729_cov_35.973016	231	311	6	1	80	0.0125000
NODE_15133_length_729_cov_35.973016	231	311	7	13	80	0.1625000
NODE_15133_length_729_cov_35.973016	231	311	8	50	80	0.6250000
NODE_15133_length_729_cov_35.973016	231	311	9	14	80	0.1750000
NODE_15133_length_729_cov_35.973016	284	363	6	23	79	0.2911392
NODE_15133_length_729_cov_35.973016	284	363	7	18	79	0.2278481
NODE_15133_length_729_cov_35.973016	284	363	8	24	79	0.3037975
NODE_15133_length_729_cov_35.973016	284	363	9	14	79	0.1772152
NODE_15134_length_729_cov_18.357143	170	250	2	4	80	0.0500000
NODE_15134_length_729_cov_18.357143	170	250	3	58	80	0.7250000
NODE_15134_length_729_cov_18.357143	170	250	5	18	80	0.2250000
NODE_15134_length_729_cov_18.357143	223	303	3	9	80	0.1125000
NODE_15134_length_729_cov_18.357143	223	303	4	3	80	0.0375000
NODE_15134_length_729_cov_18.357143	223	303	5	68	80	0.8500000
NODE_15135_length_729_cov_17.928571	194	274	3	9	80	0.1125000
NODE_15135_length_729_cov_17.928571	194	274	5	3	80	0.0375000
NODE_15135_length_729_cov_17.928571	194	274	7	48	80	0.6000000
NODE_15135_length_729_cov_17.928571	194	274	8	20	80	0.2500000
NODE_15135_length_729_cov_17.928571	247	327	4	20	80	0.2500000
NODE_15135_length_729_cov_17.928571	247	327	6	1	80	0.0125000
NODE_15135_length_729_cov_17.928571	247	327	7	7	80	0.0875000
NODE_15135_length_729_cov_17.928571	247	327	8	52	80	0.6500000
NODE_15136_length_729_cov_17.373016	369	449	1	41	80	0.5125000
NODE_15136_length_729_cov_17.373016	369	449	2	5	80	0.0625000
NODE_15136_length_729_cov_17.373016	369	449	3	4	80	0.0500000
NODE_15136_length_729_cov_17.373016	369	449	4	30	80	0.3750000
NODE_15136_length_729_cov_17.373016	422	502	4	80	80	1.0000000
NODE_15137_length_729_cov_12.452381	347	427	1	16	80	0.2000000
NODE_15137_length_729_cov_12.452381	347	427	3	4	80	0.0500000
NODE_15137_length_729_cov_12.452381	347	427	5	4	80	0.0500000
NODE_15137_length_729_cov_12.452381	347	427	6	56	80	0.7000000
NODE_15137_length_729_cov_12.452381	400	480	5	25	80	0.3125000
NODE_15137_length_729_cov_12.452381	400	480	6	55	80	0.6875000
NODE_15138_length_729_cov_10.388889	296	376	3	6	80	0.0750000
NODE_15138_length_729_cov_10.388889	296	376	4	9	80	0.1125000
NODE_15138_length_729_cov_10.388889	296	376	5	18	80	0.2250000
NODE_15138_length_729_cov_10.388889	296	376	6	26	80	0.3250000
NODE_15138_length_729_cov_10.388889	296	376	7	21	80	0.2625000
NODE_15138_length_729_cov_10.388889	349	429	4	33	80	0.4125000
NODE_15138_length_729_cov_10.388889	349	429	5	15	80	0.1875000
NODE_15138_length_729_cov_10.388889	349	429	6	17	80	0.2125000
NODE_15138_length_729_cov_10.388889	349	429	7	15	80	0.1875000
NODE_15185_length_728_cov_23.503975	338	418	3	38	80	0.4750000
NODE_15185_length_728_cov_23.503975	338	418	4	42	80	0.5250000
NODE_15185_length_728_cov_23.503975	391	471	0	33	80	0.4125000
NODE_15185_length_728_cov_23.503975	391	471	2	10	80	0.1250000
NODE_15185_length_728_cov_23.503975	391	471	3	37	80	0.4625000
NODE_15186_length_728_cov_22.496025	310	390	3	4	80	0.0500000
NODE_15186_length_728_cov_22.496025	310	390	4	76	80	0.9500000
NODE_15186_length_728_cov_22.496025	363	443	1	34	80	0.4250000
NODE_15186_length_728_cov_22.496025	363	443	2	5	80	0.0625000
NODE_15186_length_728_cov_22.496025	363	443	3	18	80	0.2250000
NODE_15186_length_728_cov_22.496025	363	443	4	23	80	0.2875000
NODE_15187_length_728_cov_16.596184	257	337	1	39	80	0.4875000
NODE_15187_length_728_cov_16.596184	257	337	2	41	80	0.5125000
NODE_15187_length_728_cov_16.596184	310	387	2	43	77	0.5584416
NODE_15187_length_728_cov_16.596184	310	387	4	34	77	0.4415585
NODE_15188_length_728_cov_16.114467	192	272	3	30	80	0.3750000
NODE_15188_length_728_cov_16.114467	192	272	4	30	80	0.3750000
NODE_15188_length_728_cov_16.114467	192	272	5	4	80	0.0500000
NODE_15188_length_728_cov_16.114467	192	272	7	16	80	0.2000000
NODE_15188_length_728_cov_16.114467	245	325	3	31	80	0.3875000
NODE_15188_length_728_cov_16.114467	245	325	4	49	80	0.6125000
NODE_15189_length_728_cov_15.128776	298	377	1	25	79	0.3164557
NODE_15189_length_728_cov_15.128776	298	377	2	54	79	0.6835443
NODE_15189_length_728_cov_15.128776	350	430	1	8	80	0.1000000
NODE_15189_length_728_cov_15.128776	350	430	2	72	80	0.9000000
NODE_15190_length_728_cov_10.613672	269	349	4	28	80	0.3500000
NODE_15190_length_728_cov_10.613672	269	349	5	20	80	0.2500000
NODE_15190_length_728_cov_10.613672	269	349	6	30	80	0.3750000
NODE_15190_length_728_cov_10.613672	269	349	7	2	80	0.0250000
NODE_15190_length_728_cov_10.613672	322	402	4	57	80	0.7125000
NODE_15190_length_728_cov_10.613672	322	402	5	7	80	0.0875000
NODE_15190_length_728_cov_10.613672	322	402	6	16	80	0.2000000
NODE_15191_length_728_cov_7.613672	408	488	0	80	80	1.0000000
NODE_15191_length_728_cov_7.613672	461	541	0	80	80	1.0000000
NODE_15196_length_728_cov_3.405405	335	415	0	80	80	1.0000000
NODE_15244_length_727_cov_34.883758	57	137	2	12	80	0.1500000
NODE_15244_length_727_cov_34.883758	57	137	3	55	80	0.6875000
NODE_15244_length_727_cov_34.883758	57	137	4	13	80	0.1625000
NODE_15244_length_727_cov_34.883758	57	137	2	12	80	0.1500000
NODE_15244_length_727_cov_34.883758	57	137	3	55	80	0.6875000
NODE_15244_length_727_cov_34.883758	57	137	4	13	80	0.1625000
NODE_15244_length_727_cov_34.883758	57	137	2	12	80	0.1500000
NODE_15244_length_727_cov_34.883758	57	137	3	55	80	0.6875000
NODE_15244_length_727_cov_34.883758	57	137	4	13	80	0.1625000
NODE_15244_length_727_cov_34.883758	110	190	3	34	80	0.4250000
NODE_15244_length_727_cov_34.883758	110	190	4	46	80	0.5750000
NODE_15244_length_727_cov_34.883758	110	190	3	34	80	0.4250000
NODE_15244_length_727_cov_34.883758	110	190	4	46	80	0.5750000
NODE_15245_length_727_cov_32.025478	275	355	4	1	80	0.0125000
NODE_15245_length_727_cov_32.025478	275	355	6	5	80	0.0625000
NODE_15245_length_727_cov_32.025478	275	355	8	4	80	0.0500000
NODE_15245_length_727_cov_32.025478	275	355	10	11	80	0.1375000
NODE_15245_length_727_cov_32.025478	275	355	11	13	80	0.1625000
NODE_15245_length_727_cov_32.025478	275	355	12	46	80	0.5750000
NODE_15245_length_727_cov_32.025478	328	408	5	1	80	0.0125000
NODE_15245_length_727_cov_32.025478	328	408	8	16	80	0.2000000
NODE_15245_length_727_cov_32.025478	328	408	9	2	80	0.0250000
NODE_15245_length_727_cov_32.025478	328	408	10	3	80	0.0375000
NODE_15245_length_727_cov_32.025478	328	408	11	42	80	0.5250000
NODE_15245_length_727_cov_32.025478	328	408	12	16	80	0.2000000
NODE_15246_length_727_cov_28.523885	307	381	0	19	74	0.2567568
NODE_15246_length_727_cov_28.523885	307	381	1	53	74	0.7162162
NODE_15246_length_727_cov_28.523885	307	381	2	2	74	0.0270270
NODE_15246_length_727_cov_28.523885	360	381	0	18	21	0.8571429
NODE_15246_length_727_cov_28.523885	360	381	1	1	21	0.0476190
NODE_15246_length_727_cov_28.523885	360	381	2	2	21	0.0952381
NODE_15246_length_727_cov_28.523885	378	415	1	1	37	0.0270270
NODE_15246_length_727_cov_28.523885	378	415	2	36	37	0.9729730
NODE_15247_length_727_cov_25.826433	325	405	6	39	80	0.4875000
NODE_15247_length_727_cov_25.826433	325	405	7	7	80	0.0875000
NODE_15247_length_727_cov_25.826433	325	405	8	34	80	0.4250000
NODE_15247_length_727_cov_25.826433	378	458	4	1	80	0.0125000
NODE_15247_length_727_cov_25.826433	378	458	6	22	80	0.2750000
NODE_15247_length_727_cov_25.826433	378	458	7	4	80	0.0500000
NODE_15247_length_727_cov_25.826433	378	458	8	53	80	0.6625000
NODE_15248_length_727_cov_22.253185	150	230	5	25	80	0.3125000
NODE_15248_length_727_cov_22.253185	150	230	6	40	80	0.5000000
NODE_15248_length_727_cov_22.253185	150	230	8	15	80	0.1875000
NODE_15248_length_727_cov_22.253185	203	283	3	1	80	0.0125000
NODE_15248_length_727_cov_22.253185	203	283	4	12	80	0.1500000
NODE_15248_length_727_cov_22.253185	203	283	5	39	80	0.4875000
NODE_15248_length_727_cov_22.253185	203	283	6	13	80	0.1625000
NODE_15248_length_727_cov_22.253185	203	283	8	15	80	0.1875000
NODE_15249_length_727_cov_18.972930	263	343	2	36	80	0.4500000
NODE_15249_length_727_cov_18.972930	263	343	3	23	80	0.2875000
NODE_15249_length_727_cov_18.972930	263	343	4	21	80	0.2625000
NODE_15249_length_727_cov_18.972930	316	396	2	10	80	0.1250000
NODE_15249_length_727_cov_18.972930	316	396	4	70	80	0.8750000
NODE_15250_length_727_cov_15.531847	269	349	5	23	80	0.2875000
NODE_15250_length_727_cov_15.531847	269	349	6	30	80	0.3750000
NODE_15250_length_727_cov_15.531847	269	349	7	27	80	0.3375000
NODE_15250_length_727_cov_15.531847	322	402	0	7	80	0.0875000
NODE_15250_length_727_cov_15.531847	322	402	2	4	80	0.0500000
NODE_15250_length_727_cov_15.531847	322	402	3	2	80	0.0250000
NODE_15250_length_727_cov_15.531847	322	402	5	63	80	0.7875000
NODE_15250_length_727_cov_15.531847	322	402	7	4	80	0.0500000
NODE_15252_length_727_cov_10.178344	280	360	0	17	80	0.2125000
NODE_15252_length_727_cov_10.178344	280	360	2	63	80	0.7875000
NODE_15252_length_727_cov_10.178344	333	413	0	7	80	0.0875000
NODE_15252_length_727_cov_10.178344	333	413	2	73	80	0.9125000
NODE_15258_length_727_cov_4.955414	360	440	1	28	80	0.3500000
NODE_15258_length_727_cov_4.955414	360	440	2	25	80	0.3125000
NODE_15258_length_727_cov_4.955414	360	440	3	27	80	0.3375000
NODE_15258_length_727_cov_4.955414	413	493	3	44	80	0.5500000
NODE_15258_length_727_cov_4.955414	413	493	4	36	80	0.4500000
NODE_15287_length_726_cov_52.923445	415	495	4	1	80	0.0125000
NODE_15287_length_726_cov_52.923445	415	495	6	11	80	0.1375000
NODE_15287_length_726_cov_52.923445	415	495	7	12	80	0.1500000
NODE_15287_length_726_cov_52.923445	415	495	8	25	80	0.3125000
NODE_15287_length_726_cov_52.923445	415	495	9	31	80	0.3875000
NODE_15287_length_726_cov_52.923445	468	548	6	33	80	0.4125000
NODE_15287_length_726_cov_52.923445	468	548	7	9	80	0.1125000
NODE_15287_length_726_cov_52.923445	468	548	8	21	80	0.2625000
NODE_15287_length_726_cov_52.923445	468	548	9	17	80	0.2125000
NODE_15288_length_726_cov_35.896332	108	188	3	6	80	0.0750000
NODE_15288_length_726_cov_35.896332	108	188	6	1	80	0.0125000
NODE_15288_length_726_cov_35.896332	108	188	7	21	80	0.2625000
NODE_15288_length_726_cov_35.896332	108	188	8	52	80	0.6500000
NODE_15288_length_726_cov_35.896332	161	241	2	21	80	0.2625000
NODE_15288_length_726_cov_35.896332	161	241	3	12	80	0.1500000
NODE_15288_length_726_cov_35.896332	161	241	6	15	80	0.1875000
NODE_15288_length_726_cov_35.896332	161	241	7	9	80	0.1125000
NODE_15288_length_726_cov_35.896332	161	241	8	23	80	0.2875000
NODE_15288_length_726_cov_35.896332	237	317	3	47	80	0.5875000
NODE_15288_length_726_cov_35.896332	237	317	4	33	80	0.4125000
NODE_15288_length_726_cov_35.896332	290	370	2	8	80	0.1000000
NODE_15288_length_726_cov_35.896332	290	370	3	72	80	0.9000000
NODE_15291_length_726_cov_8.534290	355	435	4	6	80	0.0750000
NODE_15291_length_726_cov_8.534290	355	435	5	74	80	0.9250000
NODE_15291_length_726_cov_8.534290	408	488	2	3	80	0.0375000
NODE_15291_length_726_cov_8.534290	408	488	3	24	80	0.3000000
NODE_15291_length_726_cov_8.534290	408	488	4	28	80	0.3500000
NODE_15291_length_726_cov_8.534290	408	488	5	25	80	0.3125000
NODE_15330_length_725_cov_40.856230	203	283	1	14	80	0.1750000
NODE_15330_length_725_cov_40.856230	203	283	2	66	80	0.8250000
NODE_15330_length_725_cov_40.856230	256	336	1	41	80	0.5125000
NODE_15330_length_725_cov_40.856230	256	336	2	39	80	0.4875000
NODE_15330_length_725_cov_40.856230	332	412	0	6	80	0.0750000
NODE_15330_length_725_cov_40.856230	332	412	1	74	80	0.9250000
NODE_15330_length_725_cov_40.856230	385	465	1	80	80	1.0000000
NODE_15331_length_725_cov_25.036741	366	446	2	78	80	0.9750000
NODE_15331_length_725_cov_25.036741	366	446	3	2	80	0.0250000
NODE_15331_length_725_cov_25.036741	419	499	1	23	80	0.2875000
NODE_15331_length_725_cov_25.036741	419	499	2	37	80	0.4625000
NODE_15331_length_725_cov_25.036741	419	499	3	20	80	0.2500000
NODE_15332_length_725_cov_23.009585	455	536	2	1	81	0.0123457
NODE_15332_length_725_cov_23.009585	455	536	4	80	81	0.9876543
NODE_15333_length_725_cov_20.474441	112	192	1	21	80	0.2625000
NODE_15333_length_725_cov_20.474441	112	192	2	59	80	0.7375000
NODE_15333_length_725_cov_20.474441	165	245	1	50	80	0.6250000
NODE_15333_length_725_cov_20.474441	165	245	2	30	80	0.3750000
NODE_15334_length_725_cov_15.455272	106	186	1	33	80	0.4125000
NODE_15334_length_725_cov_15.455272	106	186	2	47	80	0.5875000
NODE_15334_length_725_cov_15.455272	159	239	2	47	80	0.5875000
NODE_15334_length_725_cov_15.455272	159	239	3	33	80	0.4125000
NODE_15334_length_725_cov_15.455272	235	315	2	29	80	0.3625000
NODE_15334_length_725_cov_15.455272	235	315	3	51	80	0.6375000
NODE_15334_length_725_cov_15.455272	288	368	2	24	80	0.3000000
NODE_15334_length_725_cov_15.455272	288	368	3	25	80	0.3125000
NODE_15334_length_725_cov_15.455272	288	368	4	12	80	0.1500000
NODE_15334_length_725_cov_15.455272	288	368	5	19	80	0.2375000
NODE_15335_length_725_cov_10.426518	289	369	0	80	80	1.0000000
NODE_15335_length_725_cov_10.426518	342	422	0	80	80	1.0000000
NODE_15337_length_725_cov_7.781150	189	269	0	19	80	0.2375000
NODE_15337_length_725_cov_7.781150	189	269	1	41	80	0.5125000
NODE_15337_length_725_cov_7.781150	189	269	2	20	80	0.2500000
NODE_15337_length_725_cov_7.781150	242	322	1	7	80	0.0875000
NODE_15337_length_725_cov_7.781150	242	322	2	73	80	0.9125000
NODE_15388_length_724_cov_28.132800	354	434	4	28	80	0.3500000
NODE_15388_length_724_cov_28.132800	354	434	5	52	80	0.6500000
NODE_15388_length_724_cov_28.132800	407	473	3	14	66	0.2121212
NODE_15388_length_724_cov_28.132800	407	473	4	5	66	0.0757576
NODE_15388_length_724_cov_28.132800	407	473	5	44	66	0.6666667
NODE_15388_length_724_cov_28.132800	407	473	6	2	66	0.0303030
NODE_15388_length_724_cov_28.132800	407	473	7	1	66	0.0151515
NODE_15389_length_724_cov_24.710400	376	461	5	4	85	0.0470588
NODE_15389_length_724_cov_24.710400	376	461	6	81	85	0.9529412
NODE_15389_length_724_cov_24.710400	434	514	2	4	80	0.0500000
NODE_15389_length_724_cov_24.710400	434	514	4	14	80	0.1750000
NODE_15389_length_724_cov_24.710400	434	514	5	30	80	0.3750000
NODE_15389_length_724_cov_24.710400	434	514	6	32	80	0.4000000
NODE_15390_length_724_cov_13.960000	152	232	3	32	80	0.4000000
NODE_15390_length_724_cov_13.960000	152	232	5	48	80	0.6000000
NODE_15390_length_724_cov_13.960000	205	248	1	2	43	0.0465116
NODE_15390_length_724_cov_13.960000	205	248	3	40	43	0.9302326
NODE_15390_length_724_cov_13.960000	205	248	5	1	43	0.0232558
NODE_15390_length_724_cov_13.960000	237	286	0	23	49	0.4693878
NODE_15390_length_724_cov_13.960000	237	286	1	17	49	0.3469388
NODE_15390_length_724_cov_13.960000	237	286	3	9	49	0.1836735
NODE_15390_length_724_cov_13.960000	259	302	0	39	43	0.9069768
NODE_15390_length_724_cov_13.960000	259	302	1	4	43	0.0930233
NODE_15390_length_724_cov_13.960000	288	340	0	50	52	0.9615384
NODE_15390_length_724_cov_13.960000	288	340	1	2	52	0.0384615
NODE_15390_length_724_cov_13.960000	313	393	0	25	80	0.3125000
NODE_15390_length_724_cov_13.960000	313	393	1	55	80	0.6875000
NODE_15391_length_724_cov_13.065600	215	295	0	80	80	1.0000000
NODE_15391_length_724_cov_13.065600	268	347	0	79	79	1.0000000
NODE_15393_length_724_cov_10.358400	257	337	2	1	80	0.0125000
NODE_15393_length_724_cov_10.358400	257	337	3	1	80	0.0125000
NODE_15393_length_724_cov_10.358400	257	337	4	18	80	0.2250000
NODE_15393_length_724_cov_10.358400	257	337	5	16	80	0.2000000
NODE_15393_length_724_cov_10.358400	257	337	6	44	80	0.5500000
NODE_15393_length_724_cov_10.358400	310	385	4	2	75	0.0266667
NODE_15393_length_724_cov_10.358400	310	385	6	73	75	0.9733334
NODE_15396_length_724_cov_6.451200	151	231	0	8	80	0.1000000
NODE_15396_length_724_cov_6.451200	151	231	1	6	80	0.0750000
NODE_15396_length_724_cov_6.451200	151	231	3	8	80	0.1000000
NODE_15396_length_724_cov_6.451200	151	231	4	58	80	0.7250000
NODE_15396_length_724_cov_6.451200	202	282	0	59	80	0.7375000
NODE_15396_length_724_cov_6.451200	202	282	1	6	80	0.0750000
NODE_15396_length_724_cov_6.451200	202	282	3	8	80	0.1000000
NODE_15396_length_724_cov_6.451200	202	282	4	7	80	0.0875000
NODE_15397_length_724_cov_5.921600	165	213	0	48	48	1.0000000
NODE_15399_length_724_cov_5.028800	416	469	0	53	53	1.0000000
NODE_15399_length_724_cov_5.028800	488	526	0	38	38	1.0000000
NODE_15403_length_724_cov_3.315200	166	246	0	80	80	1.0000000
NODE_15403_length_724_cov_3.315200	219	299	0	80	80	1.0000000
NODE_15442_length_723_cov_81.453526	205	285	14	13	80	0.1625000
NODE_15442_length_723_cov_81.453526	205	285	15	11	80	0.1375000
NODE_15442_length_723_cov_81.453526	205	285	16	4	80	0.0500000
NODE_15442_length_723_cov_81.453526	205	285	17	17	80	0.2125000
NODE_15442_length_723_cov_81.453526	205	285	18	3	80	0.0375000
NODE_15442_length_723_cov_81.453526	205	285	19	11	80	0.1375000
NODE_15442_length_723_cov_81.453526	205	285	20	10	80	0.1250000
NODE_15442_length_723_cov_81.453526	205	285	21	8	80	0.1000000
NODE_15442_length_723_cov_81.453526	205	285	23	3	80	0.0375000
NODE_15442_length_723_cov_81.453526	258	338	14	16	80	0.2000000
NODE_15442_length_723_cov_81.453526	258	338	15	35	80	0.4375000
NODE_15442_length_723_cov_81.453526	258	338	16	2	80	0.0250000
NODE_15442_length_723_cov_81.453526	258	338	17	18	80	0.2250000
NODE_15442_length_723_cov_81.453526	258	338	18	3	80	0.0375000
NODE_15442_length_723_cov_81.453526	258	338	19	4	80	0.0500000
NODE_15442_length_723_cov_81.453526	258	338	20	2	80	0.0250000
NODE_15443_length_723_cov_33.075321	254	329	0	23	75	0.3066667
NODE_15443_length_723_cov_33.075321	254	329	1	37	75	0.4933333
NODE_15443_length_723_cov_33.075321	254	329	2	11	75	0.1466667
NODE_15443_length_723_cov_33.075321	254	329	3	4	75	0.0533333
NODE_15443_length_723_cov_33.075321	307	387	0	7	80	0.0875000
NODE_15443_length_723_cov_33.075321	307	387	2	11	80	0.1375000
NODE_15443_length_723_cov_33.075321	307	387	3	62	80	0.7750000
NODE_15444_length_723_cov_25.410256	291	371	3	1	80	0.0125000
NODE_15444_length_723_cov_25.410256	291	371	4	1	80	0.0125000
NODE_15444_length_723_cov_25.410256	291	371	5	1	80	0.0125000
NODE_15444_length_723_cov_25.410256	291	371	6	10	80	0.1250000
NODE_15444_length_723_cov_25.410256	291	371	7	9	80	0.1125000
NODE_15444_length_723_cov_25.410256	291	371	8	24	80	0.3000000
NODE_15444_length_723_cov_25.410256	291	371	9	28	80	0.3500000
NODE_15444_length_723_cov_25.410256	291	371	11	6	80	0.0750000
NODE_15444_length_723_cov_25.410256	344	424	9	45	80	0.5625000
NODE_15444_length_723_cov_25.410256	344	424	11	35	80	0.4375000
NODE_15445_length_723_cov_18.097756	233	313	5	5	80	0.0625000
NODE_15445_length_723_cov_18.097756	233	313	6	9	80	0.1125000
NODE_15445_length_723_cov_18.097756	233	313	7	66	80	0.8250000
NODE_15445_length_723_cov_18.097756	286	351	5	9	65	0.1384615
NODE_15445_length_723_cov_18.097756	286	351	7	56	65	0.8615385
NODE_15446_length_723_cov_14.113782	311	391	1	38	80	0.4750000
NODE_15446_length_723_cov_14.113782	311	391	2	2	80	0.0250000
NODE_15446_length_723_cov_14.113782	311	391	4	40	80	0.5000000
NODE_15446_length_723_cov_14.113782	364	444	4	80	80	1.0000000
NODE_15447_length_723_cov_11.634615	299	379	0	23	80	0.2875000
NODE_15447_length_723_cov_11.634615	299	379	1	57	80	0.7125000
NODE_15447_length_723_cov_11.634615	352	432	0	76	80	0.9500000
NODE_15447_length_723_cov_11.634615	352	432	1	4	80	0.0500000
NODE_15448_length_723_cov_8.342949	357	437	0	80	80	1.0000000
NODE_15448_length_723_cov_8.342949	410	490	0	80	80	1.0000000
NODE_15455_length_723_cov_2.711538	379	422	1	43	43	1.0000000
NODE_15459_length_723_cov_2.573718	383	413	0	30	30	1.0000000
NODE_15495_length_722_cov_19.182986	180	260	2	26	80	0.3250000
NODE_15495_length_722_cov_19.182986	180	260	3	9	80	0.1125000
NODE_15495_length_722_cov_19.182986	180	260	5	40	80	0.5000000
NODE_15495_length_722_cov_19.182986	180	260	6	5	80	0.0625000
NODE_15495_length_722_cov_19.182986	233	313	5	24	80	0.3000000
NODE_15495_length_722_cov_19.182986	233	313	6	24	80	0.3000000
NODE_15495_length_722_cov_19.182986	233	313	7	32	80	0.4000000
NODE_15496_length_722_cov_13.582665	192	272	1	39	80	0.4875000
NODE_15496_length_722_cov_13.582665	192	272	2	4	80	0.0500000
NODE_15496_length_722_cov_13.582665	192	272	4	13	80	0.1625000
NODE_15496_length_722_cov_13.582665	192	272	6	6	80	0.0750000
NODE_15496_length_722_cov_13.582665	192	272	7	15	80	0.1875000
NODE_15496_length_722_cov_13.582665	192	272	11	3	80	0.0375000
NODE_15496_length_722_cov_13.582665	245	326	4	3	81	0.0370370
NODE_15496_length_722_cov_13.582665	245	326	6	6	81	0.0740741
NODE_15496_length_722_cov_13.582665	245	326	7	15	81	0.1851852
NODE_15496_length_722_cov_13.582665	245	326	11	4	81	0.0493827
NODE_15496_length_722_cov_13.582665	245	326	12	14	81	0.1728395
NODE_15496_length_722_cov_13.582665	245	326	13	30	81	0.3703704
NODE_15496_length_722_cov_13.582665	245	326	14	9	81	0.1111111
NODE_15497_length_722_cov_9.202247	347	427	0	80	80	1.0000000
NODE_15497_length_722_cov_9.202247	400	480	0	80	80	1.0000000
NODE_15500_length_722_cov_6.707865	343	423	0	17	80	0.2125000
NODE_15500_length_722_cov_6.707865	343	423	2	63	80	0.7875000
NODE_15500_length_722_cov_6.707865	396	476	0	25	80	0.3125000
NODE_15500_length_722_cov_6.707865	396	476	2	55	80	0.6875000
NODE_15504_length_722_cov_4.985554	332	393	0	61	61	1.0000000
NODE_15508_length_722_cov_3.977528	217	297	0	15	80	0.1875000
NODE_15508_length_722_cov_3.977528	217	297	1	25	80	0.3125000
NODE_15508_length_722_cov_3.977528	217	297	2	23	80	0.2875000
NODE_15508_length_722_cov_3.977528	217	297	3	17	80	0.2125000
NODE_15508_length_722_cov_3.977528	270	350	2	10	80	0.1250000
NODE_15508_length_722_cov_3.977528	270	350	3	63	80	0.7875000
NODE_15508_length_722_cov_3.977528	270	350	4	7	80	0.0875000
NODE_15553_length_721_cov_105.927653	425	505	14	5	80	0.0625000
NODE_15553_length_721_cov_105.927653	425	505	15	33	80	0.4125000
NODE_15553_length_721_cov_105.927653	425	505	16	15	80	0.1875000
NODE_15553_length_721_cov_105.927653	425	505	17	17	80	0.2125000
NODE_15553_length_721_cov_105.927653	425	505	18	6	80	0.0750000
NODE_15553_length_721_cov_105.927653	425	505	19	4	80	0.0500000
NODE_15553_length_721_cov_105.927653	478	558	6	18	80	0.2250000
NODE_15553_length_721_cov_105.927653	478	558	7	7	80	0.0875000
NODE_15553_length_721_cov_105.927653	478	558	8	18	80	0.2250000
NODE_15553_length_721_cov_105.927653	478	558	9	6	80	0.0750000
NODE_15553_length_721_cov_105.927653	478	558	12	2	80	0.0250000
NODE_15553_length_721_cov_105.927653	478	558	15	2	80	0.0250000
NODE_15553_length_721_cov_105.927653	478	558	16	11	80	0.1375000
NODE_15553_length_721_cov_105.927653	478	558	17	16	80	0.2000000
NODE_15554_length_721_cov_49.660772	304	384	4	29	80	0.3625000
NODE_15554_length_721_cov_49.660772	304	384	5	25	80	0.3125000
NODE_15554_length_721_cov_49.660772	304	384	6	14	80	0.1750000
NODE_15554_length_721_cov_49.660772	304	384	7	11	80	0.1375000
NODE_15554_length_721_cov_49.660772	304	384	8	1	80	0.0125000
NODE_15554_length_721_cov_49.660772	357	437	5	1	80	0.0125000
NODE_15554_length_721_cov_49.660772	357	437	6	24	80	0.3000000
NODE_15554_length_721_cov_49.660772	357	437	7	47	80	0.5875000
NODE_15554_length_721_cov_49.660772	357	437	8	2	80	0.0250000
NODE_15554_length_721_cov_49.660772	357	437	9	6	80	0.0750000
NODE_15555_length_721_cov_46.991961	341	421	2	6	80	0.0750000
NODE_15555_length_721_cov_46.991961	341	421	3	1	80	0.0125000
NODE_15555_length_721_cov_46.991961	341	421	4	12	80	0.1500000
NODE_15555_length_721_cov_46.991961	341	421	6	6	80	0.0750000
NODE_15555_length_721_cov_46.991961	341	421	7	2	80	0.0250000
NODE_15555_length_721_cov_46.991961	341	421	9	8	80	0.1000000
NODE_15555_length_721_cov_46.991961	341	421	10	4	80	0.0500000
NODE_15555_length_721_cov_46.991961	341	421	13	15	80	0.1875000
NODE_15555_length_721_cov_46.991961	341	421	14	17	80	0.2125000
NODE_15555_length_721_cov_46.991961	341	421	15	5	80	0.0625000
NODE_15555_length_721_cov_46.991961	341	421	17	4	80	0.0500000
NODE_15555_length_721_cov_46.991961	394	474	13	1	80	0.0125000
NODE_15555_length_721_cov_46.991961	394	474	14	17	80	0.2125000
NODE_15555_length_721_cov_46.991961	394	474	15	10	80	0.1250000
NODE_15555_length_721_cov_46.991961	394	474	16	1	80	0.0125000
NODE_15555_length_721_cov_46.991961	394	474	17	51	80	0.6375000
NODE_15556_length_721_cov_38.864952	208	288	1	35	80	0.4375000
NODE_15556_length_721_cov_38.864952	208	288	2	45	80	0.5625000
NODE_15556_length_721_cov_38.864952	269	341	1	72	72	1.0000000
NODE_15556_length_721_cov_38.864952	337	417	0	47	80	0.5875000
NODE_15556_length_721_cov_38.864952	337	417	1	33	80	0.4125000
NODE_15556_length_721_cov_38.864952	390	467	0	77	77	1.0000000
NODE_15557_length_721_cov_29.016077	192	272	0	5	80	0.0625000
NODE_15557_length_721_cov_29.016077	192	272	1	3	80	0.0375000
NODE_15557_length_721_cov_29.016077	192	272	2	72	80	0.9000000
NODE_15557_length_721_cov_29.016077	251	325	1	3	74	0.0405405
NODE_15557_length_721_cov_29.016077	251	325	2	21	74	0.2837838
NODE_15557_length_721_cov_29.016077	251	325	3	3	74	0.0405405
NODE_15557_length_721_cov_29.016077	251	325	4	32	74	0.4324324
NODE_15557_length_721_cov_29.016077	251	325	5	15	74	0.2027027
NODE_15558_length_721_cov_26.196141	398	478	5	7	80	0.0875000
NODE_15558_length_721_cov_26.196141	398	478	6	11	80	0.1375000
NODE_15558_length_721_cov_26.196141	398	478	7	23	80	0.2875000
NODE_15558_length_721_cov_26.196141	398	478	8	34	80	0.4250000
NODE_15558_length_721_cov_26.196141	398	478	9	5	80	0.0625000
NODE_15558_length_721_cov_26.196141	451	531	8	51	80	0.6375000
NODE_15558_length_721_cov_26.196141	451	531	9	25	80	0.3125000
NODE_15558_length_721_cov_26.196141	451	531	11	4	80	0.0500000
NODE_15560_length_721_cov_20.054662	178	258	1	51	80	0.6375000
NODE_15560_length_721_cov_20.054662	178	258	2	19	80	0.2375000
NODE_15560_length_721_cov_20.054662	178	258	3	10	80	0.1250000
NODE_15560_length_721_cov_20.054662	231	311	2	17	80	0.2125000
NODE_15560_length_721_cov_20.054662	231	311	3	25	80	0.3125000
NODE_15560_length_721_cov_20.054662	231	311	4	38	80	0.4750000
NODE_15561_length_721_cov_13.670418	263	343	0	30	80	0.3750000
NODE_15561_length_721_cov_13.670418	263	343	2	50	80	0.6250000
NODE_15561_length_721_cov_13.670418	316	396	2	80	80	1.0000000
NODE_15562_length_721_cov_13.652733	268	350	0	39	82	0.4756097
NODE_15562_length_721_cov_13.652733	268	350	1	15	82	0.1829268
NODE_15562_length_721_cov_13.652733	268	350	2	28	82	0.3414634
NODE_15562_length_721_cov_13.652733	321	403	1	1	82	0.0121951
NODE_15562_length_721_cov_13.652733	321	403	2	81	82	0.9878049
NODE_15563_length_721_cov_13.120579	312	392	2	29	80	0.3625000
NODE_15563_length_721_cov_13.120579	312	392	3	7	80	0.0875000
NODE_15563_length_721_cov_13.120579	312	392	4	44	80	0.5500000
NODE_15563_length_721_cov_13.120579	365	445	2	44	80	0.5500000
NODE_15563_length_721_cov_13.120579	365	445	4	36	80	0.4500000
NODE_15572_length_721_cov_4.491961	210	280	4	13	70	0.1857143
NODE_15572_length_721_cov_4.491961	210	280	5	32	70	0.4571429
NODE_15572_length_721_cov_4.491961	210	280	6	25	70	0.3571429
NODE_15572_length_721_cov_4.491961	253	333	4	55	80	0.6875000
NODE_15572_length_721_cov_4.491961	253	333	6	25	80	0.3125000
NODE_15572_length_721_cov_4.491961	470	521	0	51	51	1.0000000
NODE_15608_length_720_cov_17.449275	267	347	1	80	80	1.0000000
NODE_15608_length_720_cov_17.449275	320	400	0	7	80	0.0875000
NODE_15608_length_720_cov_17.449275	320	400	1	73	80	0.9125000
NODE_15609_length_720_cov_14.814815	261	341	2	1	80	0.0125000
NODE_15609_length_720_cov_14.814815	261	341	4	10	80	0.1250000
NODE_15609_length_720_cov_14.814815	261	341	5	30	80	0.3750000
NODE_15609_length_720_cov_14.814815	261	341	6	31	80	0.3875000
NODE_15609_length_720_cov_14.814815	261	341	7	8	80	0.1000000
NODE_15609_length_720_cov_14.814815	314	394	1	2	80	0.0250000
NODE_15609_length_720_cov_14.814815	314	394	2	5	80	0.0625000
NODE_15609_length_720_cov_14.814815	314	394	4	26	80	0.3250000
NODE_15609_length_720_cov_14.814815	314	394	6	47	80	0.5875000
NODE_15610_length_720_cov_14.107890	290	370	3	29	80	0.3625000
NODE_15610_length_720_cov_14.107890	290	370	5	50	80	0.6250000
NODE_15610_length_720_cov_14.107890	290	370	6	1	80	0.0125000
NODE_15610_length_720_cov_14.107890	343	423	5	26	80	0.3250000
NODE_15610_length_720_cov_14.107890	343	423	6	51	80	0.6375000
NODE_15610_length_720_cov_14.107890	343	423	8	3	80	0.0375000
NODE_15612_length_720_cov_12.924316	314	394	2	25	80	0.3125000
NODE_15612_length_720_cov_12.924316	314	394	3	55	80	0.6875000
NODE_15612_length_720_cov_12.924316	367	447	3	27	80	0.3375000
NODE_15612_length_720_cov_12.924316	367	447	4	53	80	0.6625000
NODE_15614_length_720_cov_10.389694	435	515	3	52	80	0.6500000
NODE_15614_length_720_cov_10.389694	435	515	5	28	80	0.3500000
NODE_15614_length_720_cov_10.389694	488	568	0	17	80	0.2125000
NODE_15614_length_720_cov_10.389694	488	568	1	26	80	0.3250000
NODE_15614_length_720_cov_10.389694	488	568	3	37	80	0.4625000
NODE_15620_length_720_cov_5.278583	309	389	8	4	80	0.0500000
NODE_15620_length_720_cov_5.278583	309	389	9	12	80	0.1500000
NODE_15620_length_720_cov_5.278583	309	389	10	23	80	0.2875000
NODE_15620_length_720_cov_5.278583	309	389	11	8	80	0.1000000
NODE_15620_length_720_cov_5.278583	309	389	12	30	80	0.3750000
NODE_15620_length_720_cov_5.278583	309	389	13	3	80	0.0375000
NODE_15620_length_720_cov_5.278583	362	442	6	12	80	0.1500000
NODE_15620_length_720_cov_5.278583	362	442	7	7	80	0.0875000
NODE_15620_length_720_cov_5.278583	362	442	8	7	80	0.0875000
NODE_15620_length_720_cov_5.278583	362	442	10	23	80	0.2875000
NODE_15620_length_720_cov_5.278583	362	442	11	4	80	0.0500000
NODE_15620_length_720_cov_5.278583	362	442	12	24	80	0.3000000
NODE_15620_length_720_cov_5.278583	362	442	13	3	80	0.0375000
NODE_15624_length_720_cov_3.792271	157	235	1	7	78	0.0897436
NODE_15624_length_720_cov_3.792271	157	235	2	57	78	0.7307692
NODE_15624_length_720_cov_3.792271	157	235	3	14	78	0.1794872
NODE_15624_length_720_cov_3.792271	215	265	1	37	50	0.7400000
NODE_15624_length_720_cov_3.792271	215	265	3	13	50	0.2600000
NODE_15658_length_719_cov_30.256452	279	359	2	20	80	0.2500000
NODE_15658_length_719_cov_30.256452	279	359	5	26	80	0.3250000
NODE_15658_length_719_cov_30.256452	279	359	6	15	80	0.1875000
NODE_15658_length_719_cov_30.256452	279	359	7	3	80	0.0375000
NODE_15658_length_719_cov_30.256452	279	359	8	16	80	0.2000000
NODE_15658_length_719_cov_30.256452	332	412	6	38	80	0.4750000
NODE_15658_length_719_cov_30.256452	332	412	7	17	80	0.2125000
NODE_15658_length_719_cov_30.256452	332	412	8	25	80	0.3125000
NODE_15659_length_719_cov_29.093548	310	390	3	14	80	0.1750000
NODE_15659_length_719_cov_29.093548	310	390	5	19	80	0.2375000
NODE_15659_length_719_cov_29.093548	310	390	7	47	80	0.5875000
NODE_15659_length_719_cov_29.093548	363	443	5	15	80	0.1875000
NODE_15659_length_719_cov_29.093548	363	443	6	1	80	0.0125000
NODE_15659_length_719_cov_29.093548	363	443	7	64	80	0.8000000
NODE_15660_length_719_cov_10.988710	195	275	0	77	80	0.9625000
NODE_15660_length_719_cov_10.988710	195	275	2	3	80	0.0375000
NODE_15660_length_719_cov_10.988710	248	328	0	80	80	1.0000000
NODE_15661_length_719_cov_10.837097	259	339	0	80	80	1.0000000
NODE_15661_length_719_cov_10.837097	312	392	0	80	80	1.0000000
NODE_15662_length_719_cov_7.622581	288	368	0	76	80	0.9500000
NODE_15662_length_719_cov_7.622581	288	368	1	4	80	0.0500000
NODE_15662_length_719_cov_7.622581	341	421	0	25	80	0.3125000
NODE_15662_length_719_cov_7.622581	341	421	1	21	80	0.2625000
NODE_15662_length_719_cov_7.622581	341	421	2	34	80	0.4250000
NODE_15663_length_719_cov_7.570968	351	431	0	4	80	0.0500000
NODE_15663_length_719_cov_7.570968	351	431	2	10	80	0.1250000
NODE_15663_length_719_cov_7.570968	351	431	4	25	80	0.3125000
NODE_15663_length_719_cov_7.570968	351	431	6	41	80	0.5125000
NODE_15663_length_719_cov_7.570968	404	484	4	20	80	0.2500000
NODE_15663_length_719_cov_7.570968	404	484	6	60	80	0.7500000
NODE_15672_length_719_cov_4.264516	251	281	4	18	30	0.6000000
NODE_15672_length_719_cov_4.264516	251	281	6	12	30	0.4000000
NODE_15684_length_719_cov_1.629032	88	163	1	75	75	1.0000000
NODE_15706_length_718_cov_35.382876	296	376	7	4	80	0.0500000
NODE_15706_length_718_cov_35.382876	296	376	8	76	80	0.9500000
NODE_15706_length_718_cov_35.382876	296	376	7	4	80	0.0500000
NODE_15706_length_718_cov_35.382876	296	376	8	76	80	0.9500000
NODE_15706_length_718_cov_35.382876	349	429	2	19	80	0.2375000
NODE_15706_length_718_cov_35.382876	349	429	3	16	80	0.2000000
NODE_15706_length_718_cov_35.382876	349	429	5	2	80	0.0250000
NODE_15706_length_718_cov_35.382876	349	429	6	1	80	0.0125000
NODE_15706_length_718_cov_35.382876	349	429	7	6	80	0.0750000
NODE_15706_length_718_cov_35.382876	349	429	8	36	80	0.4500000
NODE_15706_length_718_cov_35.382876	349	429	2	19	80	0.2375000
NODE_15706_length_718_cov_35.382876	349	429	3	16	80	0.2000000
NODE_15706_length_718_cov_35.382876	349	429	5	2	80	0.0250000
NODE_15706_length_718_cov_35.382876	349	429	6	1	80	0.0125000
NODE_15706_length_718_cov_35.382876	349	429	7	6	80	0.0750000
NODE_15706_length_718_cov_35.382876	349	429	8	36	80	0.4500000
NODE_15707_length_718_cov_24.211632	313	393	0	80	80	1.0000000
NODE_15707_length_718_cov_24.211632	366	446	0	80	80	1.0000000
NODE_15708_length_718_cov_18.300485	217	297	0	80	80	1.0000000
NODE_15708_length_718_cov_18.300485	270	350	0	80	80	1.0000000
NODE_15709_length_718_cov_14.757674	383	463	3	14	80	0.1750000
NODE_15709_length_718_cov_14.757674	383	463	4	37	80	0.4625000
NODE_15709_length_718_cov_14.757674	383	463	5	29	80	0.3625000
NODE_15709_length_718_cov_14.757674	436	516	3	14	80	0.1750000
NODE_15709_length_718_cov_14.757674	436	516	4	65	80	0.8125000
NODE_15709_length_718_cov_14.757674	436	516	7	1	80	0.0125000
NODE_15710_length_718_cov_14.355412	254	334	0	3	80	0.0375000
NODE_15710_length_718_cov_14.355412	254	334	2	77	80	0.9625000
NODE_15710_length_718_cov_14.355412	307	387	2	80	80	1.0000000
NODE_15715_length_718_cov_4.804523	263	343	0	26	80	0.3250000
NODE_15715_length_718_cov_4.804523	263	343	1	9	80	0.1125000
NODE_15715_length_718_cov_4.804523	263	343	2	8	80	0.1000000
NODE_15715_length_718_cov_4.804523	263	343	3	37	80	0.4625000
NODE_15715_length_718_cov_4.804523	316	396	3	80	80	1.0000000
NODE_15750_length_717_cov_28.377023	335	415	2	80	80	1.0000000
NODE_15750_length_717_cov_28.377023	388	468	0	40	80	0.5000000
NODE_15750_length_717_cov_28.377023	388	468	2	40	80	0.5000000
NODE_15751_length_717_cov_23.275081	162	242	3	43	80	0.5375000
NODE_15751_length_717_cov_23.275081	162	242	4	37	80	0.4625000
NODE_15751_length_717_cov_23.275081	215	295	0	1	80	0.0125000
NODE_15751_length_717_cov_23.275081	215	295	2	39	80	0.4875000
NODE_15751_length_717_cov_23.275081	215	295	3	40	80	0.5000000
NODE_15752_length_717_cov_18.564725	319	399	3	1	80	0.0125000
NODE_15752_length_717_cov_18.564725	319	399	4	21	80	0.2625000
NODE_15752_length_717_cov_18.564725	319	399	6	1	80	0.0125000
NODE_15752_length_717_cov_18.564725	319	399	8	1	80	0.0125000
NODE_15752_length_717_cov_18.564725	319	399	10	56	80	0.7000000
NODE_15752_length_717_cov_18.564725	372	452	5	3	80	0.0375000
NODE_15752_length_717_cov_18.564725	372	452	7	3	80	0.0375000
NODE_15752_length_717_cov_18.564725	372	452	8	47	80	0.5875000
NODE_15752_length_717_cov_18.564725	372	452	10	27	80	0.3375000
NODE_15753_length_717_cov_18.389968	358	438	3	36	80	0.4500000
NODE_15753_length_717_cov_18.389968	358	438	6	26	80	0.3250000
NODE_15753_length_717_cov_18.389968	358	438	8	18	80	0.2250000
NODE_15753_length_717_cov_18.389968	411	491	5	15	80	0.1875000
NODE_15753_length_717_cov_18.389968	411	491	6	9	80	0.1125000
NODE_15753_length_717_cov_18.389968	411	491	7	16	80	0.2000000
NODE_15753_length_717_cov_18.389968	411	491	8	33	80	0.4125000
NODE_15753_length_717_cov_18.389968	411	491	9	7	80	0.0875000
NODE_15754_length_717_cov_17.932039	241	321	2	6	80	0.0750000
NODE_15754_length_717_cov_17.932039	241	321	3	74	80	0.9250000
NODE_15754_length_717_cov_17.932039	294	374	1	33	80	0.4125000
NODE_15754_length_717_cov_17.932039	294	374	2	5	80	0.0625000
NODE_15754_length_717_cov_17.932039	294	374	3	42	80	0.5250000
NODE_15755_length_717_cov_14.637540	298	378	4	11	80	0.1375000
NODE_15755_length_717_cov_14.637540	298	378	5	69	80	0.8625000
NODE_15755_length_717_cov_14.637540	351	431	2	31	80	0.3875000
NODE_15755_length_717_cov_14.637540	351	431	4	12	80	0.1500000
NODE_15755_length_717_cov_14.637540	351	431	5	37	80	0.4625000
NODE_15756_length_717_cov_12.279935	113	196	0	47	83	0.5662650
NODE_15756_length_717_cov_12.279935	113	196	1	36	83	0.4337350
NODE_15756_length_717_cov_12.279935	169	249	0	80	80	1.0000000
NODE_15757_length_717_cov_10.711974	353	431	0	78	78	1.0000000
NODE_15758_length_717_cov_9.399676	331	411	0	10	80	0.1250000
NODE_15758_length_717_cov_9.399676	331	411	1	16	80	0.2000000
NODE_15758_length_717_cov_9.399676	331	411	2	33	80	0.4125000
NODE_15758_length_717_cov_9.399676	331	411	3	21	80	0.2625000
NODE_15758_length_717_cov_9.399676	384	464	2	6	80	0.0750000
NODE_15758_length_717_cov_9.399676	384	464	3	24	80	0.3000000
NODE_15758_length_717_cov_9.399676	384	464	4	50	80	0.6250000
NODE_15762_length_717_cov_5.341424	475	555	0	80	80	1.0000000
NODE_15762_length_717_cov_5.341424	528	608	0	80	80	1.0000000
NODE_15770_length_717_cov_3.187702	285	322	0	37	37	1.0000000
NODE_15805_length_716_cov_16.800648	430	510	5	24	80	0.3000000
NODE_15805_length_716_cov_16.800648	430	510	6	39	80	0.4875000
NODE_15805_length_716_cov_16.800648	430	510	7	15	80	0.1875000
NODE_15805_length_716_cov_16.800648	430	510	8	2	80	0.0250000
NODE_15805_length_716_cov_16.800648	483	563	4	2	80	0.0250000
NODE_15805_length_716_cov_16.800648	483	563	5	75	80	0.9375000
NODE_15805_length_716_cov_16.800648	483	563	6	3	80	0.0375000
NODE_15806_length_716_cov_12.565640	356	436	1	72	80	0.9000000
NODE_15806_length_716_cov_12.565640	356	436	2	8	80	0.1000000
NODE_15806_length_716_cov_12.565640	409	489	1	50	80	0.6250000
NODE_15806_length_716_cov_12.565640	409	489	2	30	80	0.3750000
NODE_15807_length_716_cov_9.277147	385	465	0	33	80	0.4125000
NODE_15807_length_716_cov_9.277147	385	465	2	47	80	0.5875000
NODE_15807_length_716_cov_9.277147	438	518	2	80	80	1.0000000
NODE_15808_length_716_cov_9.257699	302	382	0	80	80	1.0000000
NODE_15808_length_716_cov_9.257699	355	435	0	80	80	1.0000000
NODE_15809_length_716_cov_6.761750	263	343	0	15	80	0.1875000
NODE_15809_length_716_cov_6.761750	263	343	1	65	80	0.8125000
NODE_15809_length_716_cov_6.761750	316	396	1	80	80	1.0000000
NODE_15812_length_716_cov_4.909238	236	316	0	37	80	0.4625000
NODE_15812_length_716_cov_4.909238	236	316	4	43	80	0.5375000
NODE_15812_length_716_cov_4.909238	289	369	4	80	80	1.0000000
NODE_15824_length_716_cov_2.068071	453	481	1	28	28	1.0000000
NODE_15853_length_715_cov_38.795455	260	340	9	57	80	0.7125000
NODE_15853_length_715_cov_38.795455	260	340	10	16	80	0.2000000
NODE_15853_length_715_cov_38.795455	260	340	11	7	80	0.0875000
NODE_15853_length_715_cov_38.795455	313	393	6	12	80	0.1500000
NODE_15853_length_715_cov_38.795455	313	393	7	2	80	0.0250000
NODE_15853_length_715_cov_38.795455	313	393	8	2	80	0.0250000
NODE_15853_length_715_cov_38.795455	313	393	9	33	80	0.4125000
NODE_15853_length_715_cov_38.795455	313	393	10	18	80	0.2250000
NODE_15853_length_715_cov_38.795455	313	393	11	11	80	0.1375000
NODE_15853_length_715_cov_38.795455	313	393	12	2	80	0.0250000
NODE_15854_length_715_cov_30.344156	316	396	5	1	80	0.0125000
NODE_15854_length_715_cov_30.344156	316	396	7	10	80	0.1250000
NODE_15854_length_715_cov_30.344156	316	396	8	35	80	0.4375000
NODE_15854_length_715_cov_30.344156	316	396	9	34	80	0.4250000
NODE_15854_length_715_cov_30.344156	369	449	3	30	80	0.3750000
NODE_15854_length_715_cov_30.344156	369	449	4	3	80	0.0375000
NODE_15854_length_715_cov_30.344156	369	449	5	21	80	0.2625000
NODE_15854_length_715_cov_30.344156	369	449	9	26	80	0.3250000
NODE_15857_length_715_cov_11.209416	484	564	4	34	80	0.4250000
NODE_15857_length_715_cov_11.209416	484	564	5	19	80	0.2375000
NODE_15857_length_715_cov_11.209416	484	564	6	27	80	0.3375000
NODE_15857_length_715_cov_11.209416	537	617	3	30	80	0.3750000
NODE_15857_length_715_cov_11.209416	537	617	4	29	80	0.3625000
NODE_15857_length_715_cov_11.209416	537	617	5	13	80	0.1625000
NODE_15857_length_715_cov_11.209416	537	617	6	8	80	0.1000000
NODE_15858_length_715_cov_10.894481	189	242	2	45	53	0.8490566
NODE_15858_length_715_cov_10.894481	189	242	4	8	53	0.1509434
NODE_15859_length_715_cov_10.628247	502	582	2	38	80	0.4750000
NODE_15859_length_715_cov_10.628247	502	582	3	42	80	0.5250000
NODE_15859_length_715_cov_10.628247	555	635	2	36	80	0.4500000
NODE_15859_length_715_cov_10.628247	555	635	4	12	80	0.1500000
NODE_15859_length_715_cov_10.628247	555	635	6	32	80	0.4000000
NODE_15860_length_715_cov_8.647727	138	218	3	34	80	0.4250000
NODE_15860_length_715_cov_8.647727	138	218	4	46	80	0.5750000
NODE_15860_length_715_cov_8.647727	191	271	1	23	80	0.2875000
NODE_15860_length_715_cov_8.647727	191	271	2	27	80	0.3375000
NODE_15860_length_715_cov_8.647727	191	271	3	4	80	0.0500000
NODE_15860_length_715_cov_8.647727	191	271	4	26	80	0.3250000
NODE_15861_length_715_cov_8.412338	364	444	0	22	80	0.2750000
NODE_15861_length_715_cov_8.412338	364	444	1	25	80	0.3125000
NODE_15861_length_715_cov_8.412338	364	444	2	22	80	0.2750000
NODE_15861_length_715_cov_8.412338	364	444	4	11	80	0.1375000
NODE_15861_length_715_cov_8.412338	417	497	2	16	80	0.2000000
NODE_15861_length_715_cov_8.412338	417	497	4	39	80	0.4875000
NODE_15861_length_715_cov_8.412338	417	497	6	25	80	0.3125000
NODE_15864_length_715_cov_5.373377	318	398	0	80	80	1.0000000
NODE_15864_length_715_cov_5.373377	371	451	0	80	80	1.0000000
NODE_15898_length_715_cov_1.271104	331	397	0	66	66	1.0000000
NODE_15910_length_714_cov_18.621138	297	377	2	56	80	0.7000000
NODE_15910_length_714_cov_18.621138	297	377	3	23	80	0.2875000
NODE_15910_length_714_cov_18.621138	297	377	4	1	80	0.0125000
NODE_15910_length_714_cov_18.621138	350	430	2	37	80	0.4625000
NODE_15910_length_714_cov_18.621138	350	430	3	23	80	0.2875000
NODE_15910_length_714_cov_18.621138	350	430	4	20	80	0.2500000
NODE_15911_length_714_cov_15.468293	268	348	0	9	80	0.1125000
NODE_15911_length_714_cov_15.468293	268	348	1	5	80	0.0625000
NODE_15911_length_714_cov_15.468293	268	348	2	66	80	0.8250000
NODE_15911_length_714_cov_15.468293	321	401	2	80	80	1.0000000
NODE_15913_length_714_cov_10.530081	218	298	3	19	80	0.2375000
NODE_15913_length_714_cov_10.530081	218	298	4	8	80	0.1000000
NODE_15913_length_714_cov_10.530081	218	298	5	37	80	0.4625000
NODE_15913_length_714_cov_10.530081	218	298	6	16	80	0.2000000
NODE_15913_length_714_cov_10.530081	271	351	5	52	80	0.6500000
NODE_15913_length_714_cov_10.530081	271	351	6	28	80	0.3500000
NODE_15913_length_714_cov_10.530081	354	434	2	14	80	0.1750000
NODE_15913_length_714_cov_10.530081	354	434	3	25	80	0.3125000
NODE_15913_length_714_cov_10.530081	354	434	4	8	80	0.1000000
NODE_15913_length_714_cov_10.530081	354	434	5	33	80	0.4125000
NODE_15913_length_714_cov_10.530081	407	487	0	23	80	0.2875000
NODE_15913_length_714_cov_10.530081	407	487	1	8	80	0.1000000
NODE_15913_length_714_cov_10.530081	407	487	2	36	80	0.4500000
NODE_15913_length_714_cov_10.530081	407	487	3	13	80	0.1625000
NODE_15914_length_714_cov_8.365854	285	365	0	46	80	0.5750000
NODE_15914_length_714_cov_8.365854	285	365	2	34	80	0.4250000
NODE_15914_length_714_cov_8.365854	338	418	2	40	80	0.5000000
NODE_15914_length_714_cov_8.365854	338	418	3	40	80	0.5000000
NODE_15919_length_714_cov_6.993496	263	343	0	64	80	0.8000000
NODE_15919_length_714_cov_6.993496	263	343	2	16	80	0.2000000
NODE_15919_length_714_cov_6.993496	316	384	0	68	68	1.0000000
NODE_15921_length_714_cov_4.224390	218	288	7	22	70	0.3142857
NODE_15921_length_714_cov_4.224390	218	288	8	47	70	0.6714286
NODE_15921_length_714_cov_4.224390	218	288	9	1	70	0.0142857
NODE_15921_length_714_cov_4.224390	271	351	1	1	80	0.0125000
NODE_15921_length_714_cov_4.224390	271	351	2	9	80	0.1125000
NODE_15921_length_714_cov_4.224390	271	351	4	12	80	0.1500000
NODE_15921_length_714_cov_4.224390	271	351	5	14	80	0.1750000
NODE_15921_length_714_cov_4.224390	271	351	6	1	80	0.0125000
NODE_15921_length_714_cov_4.224390	271	351	8	43	80	0.5375000
NODE_15969_length_713_cov_19.304560	271	351	5	30	80	0.3750000
NODE_15969_length_713_cov_19.304560	271	351	6	50	80	0.6250000
NODE_15969_length_713_cov_19.304560	324	404	1	28	80	0.3500000
NODE_15969_length_713_cov_19.304560	324	404	3	16	80	0.2000000
NODE_15969_length_713_cov_19.304560	324	404	5	11	80	0.1375000
NODE_15969_length_713_cov_19.304560	324	404	6	25	80	0.3125000
NODE_15970_length_713_cov_16.926710	262	342	0	80	80	1.0000000
NODE_15970_length_713_cov_16.926710	315	395	0	80	80	1.0000000
NODE_15973_length_713_cov_7.159609	351	431	2	65	80	0.8125000
NODE_15973_length_713_cov_7.159609	351	431	3	15	80	0.1875000
NODE_15973_length_713_cov_7.159609	404	484	0	4	80	0.0500000
NODE_15973_length_713_cov_7.159609	404	484	1	27	80	0.3375000
NODE_15973_length_713_cov_7.159609	404	484	2	49	80	0.6125000
NODE_15974_length_713_cov_6.723127	379	427	0	48	48	1.0000000
NODE_15975_length_713_cov_4.954397	90	171	0	81	81	1.0000000
NODE_15975_length_713_cov_4.954397	144	224	0	80	80	1.0000000
NODE_15980_length_713_cov_4.302932	402	482	0	80	80	1.0000000
NODE_15980_length_713_cov_4.302932	455	535	0	80	80	1.0000000
NODE_16004_length_713_cov_1.939739	15	75	0	60	60	1.0000000
NODE_16010_length_713_cov_1.605863	81	161	0	80	80	1.0000000
NODE_16010_length_713_cov_1.605863	134	214	0	72	80	0.9000000
NODE_16010_length_713_cov_1.605863	134	214	1	8	80	0.1000000
NODE_16052_length_712_cov_32.931485	289	369	2	5	80	0.0625000
NODE_16052_length_712_cov_32.931485	289	369	5	62	80	0.7750000
NODE_16052_length_712_cov_32.931485	289	369	6	13	80	0.1625000
NODE_16052_length_712_cov_32.931485	342	422	2	58	80	0.7250000
NODE_16052_length_712_cov_32.931485	342	422	5	9	80	0.1125000
NODE_16052_length_712_cov_32.931485	342	422	6	13	80	0.1625000
NODE_16053_length_712_cov_31.752039	185	251	0	22	66	0.3333333
NODE_16053_length_712_cov_31.752039	185	251	1	44	66	0.6666667
NODE_16053_length_712_cov_31.752039	228	307	1	79	79	1.0000000
NODE_16054_length_712_cov_22.567700	228	308	2	25	80	0.3125000
NODE_16054_length_712_cov_22.567700	228	308	3	9	80	0.1125000
NODE_16054_length_712_cov_22.567700	228	308	4	14	80	0.1750000
NODE_16054_length_712_cov_22.567700	228	308	5	26	80	0.3250000
NODE_16054_length_712_cov_22.567700	228	308	7	4	80	0.0500000
NODE_16054_length_712_cov_22.567700	228	308	8	2	80	0.0250000
NODE_16054_length_712_cov_22.567700	281	361	4	2	80	0.0250000
NODE_16054_length_712_cov_22.567700	281	361	5	19	80	0.2375000
NODE_16054_length_712_cov_22.567700	281	361	7	4	80	0.0500000
NODE_16054_length_712_cov_22.567700	281	361	8	34	80	0.4250000
NODE_16054_length_712_cov_22.567700	281	361	9	21	80	0.2625000
NODE_16055_length_712_cov_19.306688	238	318	0	28	80	0.3500000
NODE_16055_length_712_cov_19.306688	238	318	1	8	80	0.1000000
NODE_16055_length_712_cov_19.306688	238	318	2	18	80	0.2250000
NODE_16055_length_712_cov_19.306688	238	318	3	26	80	0.3250000
NODE_16055_length_712_cov_19.306688	291	371	2	1	80	0.0125000
NODE_16055_length_712_cov_19.306688	291	371	3	79	80	0.9875000
NODE_16056_length_712_cov_14.929853	332	412	0	13	80	0.1625000
NODE_16056_length_712_cov_14.929853	332	412	1	30	80	0.3750000
NODE_16056_length_712_cov_14.929853	332	412	2	37	80	0.4625000
NODE_16056_length_712_cov_14.929853	385	465	0	66	80	0.8250000
NODE_16056_length_712_cov_14.929853	385	465	1	14	80	0.1750000
NODE_16057_length_712_cov_14.228385	250	330	1	2	80	0.0250000
NODE_16057_length_712_cov_14.228385	250	330	2	24	80	0.3000000
NODE_16057_length_712_cov_14.228385	250	330	3	15	80	0.1875000
NODE_16057_length_712_cov_14.228385	250	330	5	1	80	0.0125000
NODE_16057_length_712_cov_14.228385	250	330	7	16	80	0.2000000
NODE_16057_length_712_cov_14.228385	250	330	8	4	80	0.0500000
NODE_16057_length_712_cov_14.228385	250	330	9	18	80	0.2250000
NODE_16057_length_712_cov_14.228385	303	383	6	2	80	0.0250000
NODE_16057_length_712_cov_14.228385	303	383	7	5	80	0.0625000
NODE_16057_length_712_cov_14.228385	303	383	8	55	80	0.6875000
NODE_16057_length_712_cov_14.228385	303	383	9	18	80	0.2250000
NODE_16059_length_712_cov_9.221860	326	406	0	80	80	1.0000000
NODE_16059_length_712_cov_9.221860	379	463	0	84	84	1.0000000
NODE_16060_length_712_cov_8.368679	331	411	0	80	80	1.0000000
NODE_16060_length_712_cov_8.368679	384	464	0	80	80	1.0000000
NODE_16079_length_712_cov_2.350734	466	510	0	44	44	1.0000000
NODE_16118_length_711_cov_36.459150	146	223	0	77	77	1.0000000
NODE_16118_length_711_cov_36.459150	199	280	0	39	81	0.4814815
NODE_16118_length_711_cov_36.459150	199	280	1	18	81	0.2222222
NODE_16118_length_711_cov_36.459150	199	280	2	3	81	0.0370370
NODE_16118_length_711_cov_36.459150	199	280	3	21	81	0.2592593
NODE_16119_length_711_cov_26.702614	460	540	6	41	80	0.5125000
NODE_16119_length_711_cov_26.702614	460	540	7	39	80	0.4875000
NODE_16119_length_711_cov_26.702614	513	593	4	3	80	0.0375000
NODE_16119_length_711_cov_26.702614	513	593	5	25	80	0.3125000
NODE_16119_length_711_cov_26.702614	513	593	6	52	80	0.6500000
NODE_16120_length_711_cov_19.632353	329	409	4	23	80	0.2875000
NODE_16120_length_711_cov_19.632353	329	409	5	32	80	0.4000000
NODE_16120_length_711_cov_19.632353	329	409	6	25	80	0.3125000
NODE_16120_length_711_cov_19.632353	382	462	3	2	80	0.0250000
NODE_16120_length_711_cov_19.632353	382	462	4	47	80	0.5875000
NODE_16120_length_711_cov_19.632353	382	462	5	16	80	0.2000000
NODE_16120_length_711_cov_19.632353	382	462	6	15	80	0.1875000
NODE_16121_length_711_cov_19.267974	283	363	0	9	80	0.1125000
NODE_16121_length_711_cov_19.267974	283	363	2	13	80	0.1625000
NODE_16121_length_711_cov_19.267974	283	363	4	24	80	0.3000000
NODE_16121_length_711_cov_19.267974	283	363	5	34	80	0.4250000
NODE_16121_length_711_cov_19.267974	336	416	3	17	80	0.2125000
NODE_16121_length_711_cov_19.267974	336	416	5	63	80	0.7875000
NODE_16122_length_711_cov_12.813725	255	334	0	79	79	1.0000000
NODE_16123_length_711_cov_12.147059	314	394	0	80	80	1.0000000
NODE_16123_length_711_cov_12.147059	367	447	0	80	80	1.0000000
NODE_16124_length_711_cov_10.009804	336	415	1	1	79	0.0126582
NODE_16124_length_711_cov_10.009804	336	415	2	72	79	0.9113924
NODE_16124_length_711_cov_10.009804	336	415	3	6	79	0.0759494
NODE_16127_length_711_cov_5.619281	276	356	0	36	80	0.4500000
NODE_16127_length_711_cov_5.619281	276	356	1	26	80	0.3250000
NODE_16127_length_711_cov_5.619281	276	356	2	18	80	0.2250000
NODE_16127_length_711_cov_5.619281	329	409	1	9	80	0.1125000
NODE_16127_length_711_cov_5.619281	329	409	2	32	80	0.4000000
NODE_16127_length_711_cov_5.619281	329	409	3	39	80	0.4875000
NODE_16130_length_711_cov_4.040850	165	245	0	15	80	0.1875000
NODE_16130_length_711_cov_4.040850	165	245	1	18	80	0.2250000
NODE_16130_length_711_cov_4.040850	165	245	2	47	80	0.5875000
NODE_16130_length_711_cov_4.040850	218	298	2	36	80	0.4500000
NODE_16130_length_711_cov_4.040850	218	298	3	44	80	0.5500000
NODE_16167_length_710_cov_73.721768	626	706	0	80	80	1.0000000
NODE_16168_length_710_cov_21.772504	292	372	1	80	80	1.0000000
NODE_16168_length_710_cov_21.772504	345	425	0	32	80	0.4000000
NODE_16168_length_710_cov_21.772504	345	425	1	48	80	0.6000000
NODE_16169_length_710_cov_21.597381	18	54	0	36	36	1.0000000
NODE_16170_length_710_cov_13.155483	306	386	0	30	80	0.3750000
NODE_16170_length_710_cov_13.155483	306	386	2	50	80	0.6250000
NODE_16170_length_710_cov_13.155483	359	439	0	80	80	1.0000000
NODE_16173_length_710_cov_8.031097	316	396	0	80	80	1.0000000
NODE_16173_length_710_cov_8.031097	369	449	0	80	80	1.0000000
NODE_16175_length_710_cov_6.664484	264	344	0	80	80	1.0000000
NODE_16178_length_710_cov_5.590835	352	421	5	28	69	0.4057971
NODE_16178_length_710_cov_5.590835	352	421	6	41	69	0.5942029
NODE_16178_length_710_cov_5.590835	394	474	1	2	80	0.0250000
NODE_16178_length_710_cov_5.590835	394	474	3	9	80	0.1125000
NODE_16178_length_710_cov_5.590835	394	474	4	7	80	0.0875000
NODE_16178_length_710_cov_5.590835	394	474	6	62	80	0.7750000
NODE_16180_length_710_cov_5.356792	248	328	3	4	80	0.0500000
NODE_16180_length_710_cov_5.356792	248	328	4	25	80	0.3125000
NODE_16180_length_710_cov_5.356792	248	328	5	19	80	0.2375000
NODE_16180_length_710_cov_5.356792	248	328	6	2	80	0.0250000
NODE_16180_length_710_cov_5.356792	248	328	7	6	80	0.0750000
NODE_16180_length_710_cov_5.356792	248	328	9	24	80	0.3000000
NODE_16180_length_710_cov_5.356792	301	381	7	3	80	0.0375000
NODE_16180_length_710_cov_5.356792	301	381	8	11	80	0.1375000
NODE_16180_length_710_cov_5.356792	301	381	9	66	80	0.8250000
NODE_16233_length_709_cov_12.227869	347	427	3	32	80	0.4000000
NODE_16233_length_709_cov_12.227869	347	427	4	30	80	0.3750000
NODE_16233_length_709_cov_12.227869	347	427	5	18	80	0.2250000
NODE_16233_length_709_cov_12.227869	400	480	2	36	80	0.4500000
NODE_16233_length_709_cov_12.227869	400	480	3	44	80	0.5500000
NODE_16234_length_709_cov_10.531148	279	359	4	1	80	0.0125000
NODE_16234_length_709_cov_10.531148	279	359	5	54	80	0.6750000
NODE_16234_length_709_cov_10.531148	279	359	6	25	80	0.3125000
NODE_16234_length_709_cov_10.531148	332	412	4	7	80	0.0875000
NODE_16234_length_709_cov_10.531148	332	412	5	41	80	0.5125000
NODE_16234_length_709_cov_10.531148	332	412	6	32	80	0.4000000
NODE_16238_length_709_cov_7.181967	225	305	0	80	80	1.0000000
NODE_16238_length_709_cov_7.181967	279	312	0	33	33	1.0000000
NODE_16241_length_709_cov_5.888525	239	319	0	5	80	0.0625000
NODE_16241_length_709_cov_5.888525	239	319	2	75	80	0.9375000
NODE_16241_length_709_cov_5.888525	292	372	2	80	80	1.0000000
NODE_16294_length_708_cov_42.435140	307	387	0	40	80	0.5000000
NODE_16294_length_708_cov_42.435140	307	387	1	40	80	0.5000000
NODE_16294_length_708_cov_42.435140	360	440	1	32	80	0.4000000
NODE_16294_length_708_cov_42.435140	360	440	2	48	80	0.6000000
NODE_16296_length_708_cov_33.412151	235	315	2	8	80	0.1000000
NODE_16296_length_708_cov_33.412151	235	315	4	47	80	0.5875000
NODE_16296_length_708_cov_33.412151	235	315	6	5	80	0.0625000
NODE_16296_length_708_cov_33.412151	235	315	7	9	80	0.1125000
NODE_16296_length_708_cov_33.412151	235	315	8	11	80	0.1375000
NODE_16296_length_708_cov_33.412151	288	368	4	10	80	0.1250000
NODE_16296_length_708_cov_33.412151	288	368	6	18	80	0.2250000
NODE_16296_length_708_cov_33.412151	288	368	7	9	80	0.1125000
NODE_16296_length_708_cov_33.412151	288	368	8	43	80	0.5375000
NODE_16297_length_708_cov_23.034483	316	396	1	5	80	0.0625000
NODE_16297_length_708_cov_23.034483	316	396	3	2	80	0.0250000
NODE_16297_length_708_cov_23.034483	316	396	4	12	80	0.1500000
NODE_16297_length_708_cov_23.034483	316	396	5	61	80	0.7625000
NODE_16297_length_708_cov_23.034483	369	449	0	25	80	0.3125000
NODE_16297_length_708_cov_23.034483	369	449	2	6	80	0.0750000
NODE_16297_length_708_cov_23.034483	369	449	4	34	80	0.4250000
NODE_16297_length_708_cov_23.034483	369	449	5	15	80	0.1875000
NODE_16298_length_708_cov_20.449918	254	334	1	8	80	0.1000000
NODE_16298_length_708_cov_20.449918	254	334	2	14	80	0.1750000
NODE_16298_length_708_cov_20.449918	254	334	3	10	80	0.1250000
NODE_16298_length_708_cov_20.449918	254	334	7	22	80	0.2750000
NODE_16298_length_708_cov_20.449918	254	334	9	10	80	0.1250000
NODE_16298_length_708_cov_20.449918	254	334	10	16	80	0.2000000
NODE_16298_length_708_cov_20.449918	307	387	7	7	80	0.0875000
NODE_16298_length_708_cov_20.449918	307	387	9	32	80	0.4000000
NODE_16298_length_708_cov_20.449918	307	387	10	41	80	0.5125000
NODE_16299_length_708_cov_19.998358	238	318	2	4	80	0.0500000
NODE_16299_length_708_cov_19.998358	238	318	3	76	80	0.9500000
NODE_16299_length_708_cov_19.998358	291	371	2	44	80	0.5500000
NODE_16299_length_708_cov_19.998358	291	371	3	36	80	0.4500000
NODE_16300_length_708_cov_19.021346	366	446	5	5	80	0.0625000
NODE_16300_length_708_cov_19.021346	366	446	6	14	80	0.1750000
NODE_16300_length_708_cov_19.021346	366	446	8	56	80	0.7000000
NODE_16300_length_708_cov_19.021346	366	446	10	5	80	0.0625000
NODE_16300_length_708_cov_19.021346	419	499	6	42	80	0.5250000
NODE_16300_length_708_cov_19.021346	419	499	8	38	80	0.4750000
NODE_16302_length_708_cov_12.228243	181	263	0	82	82	1.0000000
NODE_16302_length_708_cov_12.228243	188	268	0	80	80	1.0000000
NODE_16302_length_708_cov_12.228243	236	316	0	74	80	0.9250000
NODE_16302_length_708_cov_12.228243	236	316	2	6	80	0.0750000
NODE_16302_length_708_cov_12.228243	312	392	2	34	80	0.4250000
NODE_16302_length_708_cov_12.228243	312	392	4	46	80	0.5750000
NODE_16302_length_708_cov_12.228243	312	392	2	34	80	0.4250000
NODE_16302_length_708_cov_12.228243	312	392	4	46	80	0.5750000
NODE_16302_length_708_cov_12.228243	365	445	1	15	80	0.1875000
NODE_16302_length_708_cov_12.228243	365	445	2	29	80	0.3625000
NODE_16302_length_708_cov_12.228243	365	445	3	27	80	0.3375000
NODE_16302_length_708_cov_12.228243	365	445	4	9	80	0.1125000
NODE_16303_length_708_cov_11.338259	255	335	0	6	80	0.0750000
NODE_16303_length_708_cov_11.338259	255	335	1	11	80	0.1375000
NODE_16303_length_708_cov_11.338259	255	335	2	63	80	0.7875000
NODE_16303_length_708_cov_11.338259	308	388	0	59	80	0.7375000
NODE_16303_length_708_cov_11.338259	308	388	1	11	80	0.1375000
NODE_16303_length_708_cov_11.338259	308	388	2	10	80	0.1250000
NODE_16305_length_708_cov_9.676519	219	299	0	80	80	1.0000000
NODE_16305_length_708_cov_9.676519	272	352	0	80	80	1.0000000
NODE_16306_length_708_cov_8.638752	324	399	0	75	75	1.0000000
NODE_16330_length_708_cov_2.699507	358	398	0	40	40	1.0000000
NODE_16370_length_707_cov_30.067434	325	405	5	7	80	0.0875000
NODE_16370_length_707_cov_30.067434	325	405	6	14	80	0.1750000
NODE_16370_length_707_cov_30.067434	325	405	7	44	80	0.5500000
NODE_16370_length_707_cov_30.067434	325	405	8	15	80	0.1875000
NODE_16370_length_707_cov_30.067434	378	458	2	34	80	0.4250000
NODE_16370_length_707_cov_30.067434	378	458	3	3	80	0.0375000
NODE_16370_length_707_cov_30.067434	378	458	5	23	80	0.2875000
NODE_16370_length_707_cov_30.067434	378	458	6	11	80	0.1375000
NODE_16370_length_707_cov_30.067434	378	458	7	9	80	0.1125000
NODE_16371_length_707_cov_26.555921	241	321	0	36	80	0.4500000
NODE_16371_length_707_cov_26.555921	241	321	2	25	80	0.3125000
NODE_16371_length_707_cov_26.555921	241	321	4	7	80	0.0875000
NODE_16371_length_707_cov_26.555921	241	321	5	5	80	0.0625000
NODE_16371_length_707_cov_26.555921	241	321	6	7	80	0.0875000
NODE_16371_length_707_cov_26.555921	294	374	2	8	80	0.1000000
NODE_16371_length_707_cov_26.555921	294	374	4	7	80	0.0875000
NODE_16371_length_707_cov_26.555921	294	374	5	5	80	0.0625000
NODE_16371_length_707_cov_26.555921	294	374	6	11	80	0.1375000
NODE_16371_length_707_cov_26.555921	294	374	7	23	80	0.2875000
NODE_16371_length_707_cov_26.555921	294	374	8	26	80	0.3250000
NODE_16372_length_707_cov_23.972039	322	402	8	23	80	0.2875000
NODE_16372_length_707_cov_23.972039	322	402	10	55	80	0.6875000
NODE_16372_length_707_cov_23.972039	322	402	11	2	80	0.0250000
NODE_16372_length_707_cov_23.972039	375	455	4	18	80	0.2250000
NODE_16372_length_707_cov_23.972039	375	455	6	12	80	0.1500000
NODE_16372_length_707_cov_23.972039	375	455	7	8	80	0.1000000
NODE_16372_length_707_cov_23.972039	375	455	8	6	80	0.0750000
NODE_16372_length_707_cov_23.972039	375	455	10	36	80	0.4500000
NODE_16373_length_707_cov_20.348684	157	237	4	51	80	0.6375000
NODE_16373_length_707_cov_20.348684	157	237	6	2	80	0.0250000
NODE_16373_length_707_cov_20.348684	157	237	7	3	80	0.0375000
NODE_16373_length_707_cov_20.348684	157	237	8	23	80	0.2875000
NODE_16373_length_707_cov_20.348684	157	237	9	1	80	0.0125000
NODE_16373_length_707_cov_20.348684	210	281	7	3	71	0.0422535
NODE_16373_length_707_cov_20.348684	210	281	8	47	71	0.6619718
NODE_16373_length_707_cov_20.348684	210	281	9	20	71	0.2816902
NODE_16373_length_707_cov_20.348684	210	281	10	1	71	0.0140845
NODE_16374_length_707_cov_18.970395	253	333	7	4	80	0.0500000
NODE_16374_length_707_cov_18.970395	253	333	9	14	80	0.1750000
NODE_16374_length_707_cov_18.970395	253	333	10	17	80	0.2125000
NODE_16374_length_707_cov_18.970395	253	333	11	2	80	0.0250000
NODE_16374_length_707_cov_18.970395	253	333	12	28	80	0.3500000
NODE_16374_length_707_cov_18.970395	253	333	13	2	80	0.0250000
NODE_16374_length_707_cov_18.970395	253	333	14	13	80	0.1625000
NODE_16374_length_707_cov_18.970395	306	386	8	3	80	0.0375000
NODE_16374_length_707_cov_18.970395	306	386	9	1	80	0.0125000
NODE_16374_length_707_cov_18.970395	306	386	10	11	80	0.1375000
NODE_16374_length_707_cov_18.970395	306	386	11	28	80	0.3500000
NODE_16374_length_707_cov_18.970395	306	386	12	32	80	0.4000000
NODE_16374_length_707_cov_18.970395	306	386	14	5	80	0.0625000
NODE_16375_length_707_cov_14.324013	302	382	2	3	80	0.0375000
NODE_16375_length_707_cov_14.324013	302	382	3	21	80	0.2625000
NODE_16375_length_707_cov_14.324013	302	382	4	14	80	0.1750000
NODE_16375_length_707_cov_14.324013	302	382	5	42	80	0.5250000
NODE_16375_length_707_cov_14.324013	355	435	2	3	80	0.0375000
NODE_16375_length_707_cov_14.324013	355	435	3	66	80	0.8250000
NODE_16375_length_707_cov_14.324013	355	435	4	5	80	0.0625000
NODE_16375_length_707_cov_14.324013	355	435	5	6	80	0.0750000
NODE_16378_length_707_cov_5.062500	313	393	0	80	80	1.0000000
NODE_16441_length_706_cov_34.116969	272	352	5	16	80	0.2000000
NODE_16441_length_706_cov_34.116969	272	352	7	24	80	0.3000000
NODE_16441_length_706_cov_34.116969	272	352	8	40	80	0.5000000
NODE_16441_length_706_cov_34.116969	325	405	4	2	80	0.0250000
NODE_16441_length_706_cov_34.116969	325	405	6	15	80	0.1875000
NODE_16441_length_706_cov_34.116969	325	405	7	26	80	0.3250000
NODE_16441_length_706_cov_34.116969	325	405	8	37	80	0.4625000
NODE_16442_length_706_cov_27.220758	229	309	3	13	80	0.1625000
NODE_16442_length_706_cov_27.220758	229	309	4	16	80	0.2000000
NODE_16442_length_706_cov_27.220758	229	309	7	21	80	0.2625000
NODE_16442_length_706_cov_27.220758	229	309	8	12	80	0.1500000
NODE_16442_length_706_cov_27.220758	229	309	9	18	80	0.2250000
NODE_16442_length_706_cov_27.220758	282	362	8	12	80	0.1500000
NODE_16442_length_706_cov_27.220758	282	362	9	28	80	0.3500000
NODE_16442_length_706_cov_27.220758	282	362	10	1	80	0.0125000
NODE_16442_length_706_cov_27.220758	282	362	11	39	80	0.4875000
NODE_16443_length_706_cov_20.380560	264	344	4	35	80	0.4375000
NODE_16443_length_706_cov_20.380560	264	344	5	27	80	0.3375000
NODE_16443_length_706_cov_20.380560	264	344	6	18	80	0.2250000
NODE_16443_length_706_cov_20.380560	317	397	3	27	80	0.3375000
NODE_16443_length_706_cov_20.380560	317	397	4	53	80	0.6625000
NODE_16444_length_706_cov_19.525535	289	369	0	80	80	1.0000000
NODE_16444_length_706_cov_19.525535	342	422	0	80	80	1.0000000
NODE_16454_length_706_cov_3.344316	465	545	0	30	80	0.3750000
NODE_16454_length_706_cov_3.344316	465	545	1	44	80	0.5500000
NODE_16454_length_706_cov_3.344316	465	545	2	6	80	0.0750000
NODE_16454_length_706_cov_3.344316	518	598	1	21	80	0.2625000
NODE_16454_length_706_cov_3.344316	518	598	2	59	80	0.7375000
NODE_16494_length_705_cov_19.211221	118	198	3	80	80	1.0000000
NODE_16494_length_705_cov_19.211221	171	250	0	17	79	0.2151899
NODE_16494_length_705_cov_19.211221	171	250	1	4	79	0.0506329
NODE_16494_length_705_cov_19.211221	171	250	2	25	79	0.3164557
NODE_16494_length_705_cov_19.211221	171	250	3	33	79	0.4177215
NODE_16495_length_705_cov_16.338284	291	339	0	14	48	0.2916667
NODE_16495_length_705_cov_16.338284	291	339	2	34	48	0.7083333
NODE_16495_length_705_cov_16.338284	336	406	0	17	70	0.2428571
NODE_16495_length_705_cov_16.338284	336	406	2	53	70	0.7571428
NODE_16496_length_705_cov_14.354785	209	289	0	80	80	1.0000000
NODE_16496_length_705_cov_14.354785	262	342	0	80	80	1.0000000
NODE_16497_length_705_cov_12.231023	293	373	7	35	80	0.4375000
NODE_16497_length_705_cov_12.231023	293	373	8	45	80	0.5625000
NODE_16497_length_705_cov_12.231023	346	426	3	21	80	0.2625000
NODE_16497_length_705_cov_12.231023	346	426	5	16	80	0.2000000
NODE_16497_length_705_cov_12.231023	346	426	7	31	80	0.3875000
NODE_16497_length_705_cov_12.231023	346	426	8	12	80	0.1500000
NODE_16498_length_705_cov_11.836634	390	470	0	80	80	1.0000000
NODE_16498_length_705_cov_11.836634	443	523	0	80	80	1.0000000
NODE_16499_length_705_cov_10.049505	382	479	0	97	97	1.0000000
NODE_16499_length_705_cov_10.049505	452	532	0	80	80	1.0000000
NODE_16507_length_705_cov_4.275578	358	438	0	80	80	1.0000000
NODE_16507_length_705_cov_4.275578	411	491	0	80	80	1.0000000
NODE_16509_length_705_cov_4.018152	306	364	0	58	58	1.0000000
NODE_16509_length_705_cov_4.018152	337	410	0	73	73	1.0000000
NODE_16511_length_705_cov_3.620462	253	315	1	21	62	0.3387097
NODE_16511_length_705_cov_3.620462	253	315	2	33	62	0.5322581
NODE_16511_length_705_cov_3.620462	253	315	3	8	62	0.1290323
NODE_16511_length_705_cov_3.620462	308	368	1	50	60	0.8333333
NODE_16511_length_705_cov_3.620462	308	368	2	10	60	0.1666667
NODE_16527_length_705_cov_1.607261	462	531	0	69	69	1.0000000
NODE_16549_length_705_cov_0.529703	33	97	0	64	64	1.0000000
NODE_16549_length_705_cov_0.529703	86	150	0	64	64	1.0000000
NODE_16550_length_704_cov_18.256198	295	375	2	65	80	0.8125000
NODE_16550_length_704_cov_18.256198	295	375	3	15	80	0.1875000
NODE_16550_length_704_cov_18.256198	348	428	1	34	80	0.4250000
NODE_16550_length_704_cov_18.256198	348	428	2	46	80	0.5750000
NODE_16552_length_704_cov_16.662810	264	344	1	54	80	0.6750000
NODE_16552_length_704_cov_16.662810	264	344	2	26	80	0.3250000
NODE_16552_length_704_cov_16.662810	317	397	1	1	80	0.0125000
NODE_16552_length_704_cov_16.662810	317	397	2	79	80	0.9875000
NODE_16553_length_704_cov_12.641322	294	374	0	80	80	1.0000000
NODE_16553_length_704_cov_12.641322	347	427	0	37	80	0.4625000
NODE_16553_length_704_cov_12.641322	347	427	2	43	80	0.5375000
NODE_16557_length_704_cov_5.603306	440	498	0	53	58	0.9137931
NODE_16557_length_704_cov_5.603306	440	498	2	5	58	0.0862069
NODE_16564_length_704_cov_3.535537	303	383	0	80	80	1.0000000
NODE_16564_length_704_cov_3.535537	369	436	0	67	67	1.0000000
NODE_16578_length_704_cov_1.963636	345	425	0	80	80	1.0000000
NODE_16578_length_704_cov_1.963636	398	478	0	80	80	1.0000000
NODE_16598_length_703_cov_44.102649	514	594	2	80	80	1.0000000
NODE_16598_length_703_cov_44.102649	567	647	0	37	80	0.4625000
NODE_16598_length_703_cov_44.102649	567	647	2	43	80	0.5375000
NODE_16599_length_703_cov_33.067881	521	594	8	13	73	0.1780822
NODE_16599_length_703_cov_33.067881	521	594	9	17	73	0.2328767
NODE_16599_length_703_cov_33.067881	521	594	10	1	73	0.0136986
NODE_16599_length_703_cov_33.067881	521	594	11	15	73	0.2054795
NODE_16599_length_703_cov_33.067881	521	594	12	27	73	0.3698630
NODE_16599_length_703_cov_33.067881	561	602	7	1	41	0.0243902
NODE_16599_length_703_cov_33.067881	561	602	8	5	41	0.1219512
NODE_16599_length_703_cov_33.067881	561	602	9	6	41	0.1463415
NODE_16599_length_703_cov_33.067881	561	602	10	1	41	0.0243902
NODE_16599_length_703_cov_33.067881	561	602	11	1	41	0.0243902
NODE_16599_length_703_cov_33.067881	561	602	12	27	41	0.6585366
NODE_16600_length_703_cov_30.266556	312	392	7	2	80	0.0250000
NODE_16600_length_703_cov_30.266556	312	392	8	6	80	0.0750000
NODE_16600_length_703_cov_30.266556	312	392	9	2	80	0.0250000
NODE_16600_length_703_cov_30.266556	312	392	11	26	80	0.3250000
NODE_16600_length_703_cov_30.266556	312	392	12	44	80	0.5500000
NODE_16600_length_703_cov_30.266556	365	445	2	38	80	0.4750000
NODE_16600_length_703_cov_30.266556	365	445	4	15	80	0.1875000
NODE_16600_length_703_cov_30.266556	365	445	7	2	80	0.0250000
NODE_16600_length_703_cov_30.266556	365	445	8	6	80	0.0750000
NODE_16600_length_703_cov_30.266556	365	445	9	2	80	0.0250000
NODE_16600_length_703_cov_30.266556	365	445	11	13	80	0.1625000
NODE_16600_length_703_cov_30.266556	365	445	12	4	80	0.0500000
NODE_16601_length_703_cov_17.006623	449	529	2	12	80	0.1500000
NODE_16601_length_703_cov_17.006623	449	529	4	15	80	0.1875000
NODE_16601_length_703_cov_17.006623	449	529	6	53	80	0.6625000
NODE_16601_length_703_cov_17.006623	502	582	4	42	80	0.5250000
NODE_16601_length_703_cov_17.006623	502	582	6	38	80	0.4750000
NODE_16602_length_703_cov_14.801325	383	463	2	13	80	0.1625000
NODE_16602_length_703_cov_14.801325	383	463	3	67	80	0.8375000
NODE_16602_length_703_cov_14.801325	436	516	2	35	80	0.4375000
NODE_16602_length_703_cov_14.801325	436	516	3	45	80	0.5625000
NODE_16603_length_703_cov_11.766556	308	388	0	28	80	0.3500000
NODE_16603_length_703_cov_11.766556	308	388	1	1	80	0.0125000
NODE_16603_length_703_cov_11.766556	308	388	2	51	80	0.6375000
NODE_16603_length_703_cov_11.766556	361	441	0	17	80	0.2125000
NODE_16603_length_703_cov_11.766556	361	441	2	63	80	0.7875000
NODE_16604_length_703_cov_10.405629	213	293	5	1	80	0.0125000
NODE_16604_length_703_cov_10.405629	213	293	7	21	80	0.2625000
NODE_16604_length_703_cov_10.405629	213	293	8	58	80	0.7250000
NODE_16604_length_703_cov_10.405629	266	301	5	9	35	0.2571429
NODE_16604_length_703_cov_10.405629	266	301	7	21	35	0.6000000
NODE_16604_length_703_cov_10.405629	266	301	8	5	35	0.1428571
NODE_16605_length_703_cov_6.966887	381	440	2	59	59	1.0000000
NODE_16616_length_703_cov_3.491722	256	309	0	53	53	1.0000000
NODE_16616_length_703_cov_3.491722	257	337	0	80	80	1.0000000
NODE_16616_length_703_cov_3.491722	305	362	0	57	57	1.0000000
NODE_16624_length_703_cov_2.687086	216	296	0	80	80	1.0000000
NODE_16624_length_703_cov_2.687086	269	349	0	80	80	1.0000000
NODE_16663_length_702_cov_49.784411	221	299	4	7	78	0.0897436
NODE_16663_length_702_cov_49.784411	221	299	5	10	78	0.1282051
NODE_16663_length_702_cov_49.784411	221	299	6	1	78	0.0128205
NODE_16663_length_702_cov_49.784411	221	299	7	21	78	0.2692308
NODE_16663_length_702_cov_49.784411	221	299	9	16	78	0.2051282
NODE_16663_length_702_cov_49.784411	221	299	10	8	78	0.1025641
NODE_16663_length_702_cov_49.784411	221	299	11	15	78	0.1923077
NODE_16663_length_702_cov_49.784411	277	352	7	14	75	0.1866667
NODE_16663_length_702_cov_49.784411	277	352	8	14	75	0.1866667
NODE_16663_length_702_cov_49.784411	277	352	9	28	75	0.3733333
NODE_16663_length_702_cov_49.784411	277	352	10	4	75	0.0533333
NODE_16663_length_702_cov_49.784411	277	352	11	15	75	0.2000000
NODE_16664_length_702_cov_26.570481	201	281	0	80	80	1.0000000
NODE_16664_length_702_cov_26.570481	254	334	0	80	80	1.0000000
NODE_16665_length_702_cov_23.971808	139	219	0	41	80	0.5125000
NODE_16665_length_702_cov_23.971808	139	219	2	39	80	0.4875000
NODE_16665_length_702_cov_23.971808	192	272	0	1	80	0.0125000
NODE_16665_length_702_cov_23.971808	192	272	2	79	80	0.9875000
NODE_16665_length_702_cov_23.971808	268	348	0	77	80	0.9625000
NODE_16665_length_702_cov_23.971808	268	348	2	3	80	0.0375000
NODE_16665_length_702_cov_23.971808	321	401	0	80	80	1.0000000
NODE_16666_length_702_cov_23.827529	448	528	2	31	80	0.3875000
NODE_16666_length_702_cov_23.827529	448	528	3	1	80	0.0125000
NODE_16666_length_702_cov_23.827529	448	528	6	1	80	0.0125000
NODE_16666_length_702_cov_23.827529	448	528	8	23	80	0.2875000
NODE_16666_length_702_cov_23.827529	448	528	9	24	80	0.3000000
NODE_16666_length_702_cov_23.827529	501	581	8	6	80	0.0750000
NODE_16666_length_702_cov_23.827529	501	581	9	40	80	0.5000000
NODE_16666_length_702_cov_23.827529	501	581	11	34	80	0.4250000
NODE_16667_length_702_cov_14.661692	424	504	8	19	80	0.2375000
NODE_16667_length_702_cov_14.661692	424	504	9	5	80	0.0625000
NODE_16667_length_702_cov_14.661692	424	504	10	56	80	0.7000000
NODE_16667_length_702_cov_14.661692	477	557	1	2	80	0.0250000
NODE_16667_length_702_cov_14.661692	477	557	5	20	80	0.2500000
NODE_16667_length_702_cov_14.661692	477	557	6	24	80	0.3000000
NODE_16667_length_702_cov_14.661692	477	557	8	26	80	0.3250000
NODE_16667_length_702_cov_14.661692	477	557	10	8	80	0.1000000
NODE_16668_length_702_cov_13.908789	259	304	5	33	45	0.7333333
NODE_16668_length_702_cov_13.908789	259	304	6	12	45	0.2666667
NODE_16668_length_702_cov_13.908789	277	357	1	5	80	0.0625000
NODE_16668_length_702_cov_13.908789	277	357	2	5	80	0.0625000
NODE_16668_length_702_cov_13.908789	277	357	3	2	80	0.0250000
NODE_16668_length_702_cov_13.908789	277	357	5	48	80	0.6000000
NODE_16668_length_702_cov_13.908789	277	357	6	20	80	0.2500000
NODE_16668_length_702_cov_13.908789	289	357	1	5	68	0.0735294
NODE_16668_length_702_cov_13.908789	289	357	2	5	68	0.0735294
NODE_16668_length_702_cov_13.908789	289	357	3	2	68	0.0294118
NODE_16668_length_702_cov_13.908789	289	357	5	36	68	0.5294118
NODE_16668_length_702_cov_13.908789	289	357	6	20	68	0.2941177
NODE_16669_length_702_cov_8.502488	337	417	1	80	80	1.0000000
NODE_16669_length_702_cov_8.502488	390	470	0	31	80	0.3875000
NODE_16669_length_702_cov_8.502488	390	470	1	49	80	0.6125000
NODE_16671_length_702_cov_6.470978	209	289	4	21	80	0.2625000
NODE_16671_length_702_cov_6.470978	209	289	5	59	80	0.7375000
NODE_16671_length_702_cov_6.470978	262	342	1	6	80	0.0750000
NODE_16671_length_702_cov_6.470978	262	342	2	4	80	0.0500000
NODE_16671_length_702_cov_6.470978	262	342	3	9	80	0.1125000
NODE_16671_length_702_cov_6.470978	262	342	5	61	80	0.7625000
NODE_16729_length_701_cov_38.715947	178	258	6	10	80	0.1250000
NODE_16729_length_701_cov_38.715947	178	258	7	35	80	0.4375000
NODE_16729_length_701_cov_38.715947	178	258	8	11	80	0.1375000
NODE_16729_length_701_cov_38.715947	178	258	9	7	80	0.0875000
NODE_16729_length_701_cov_38.715947	178	258	10	17	80	0.2125000
NODE_16729_length_701_cov_38.715947	231	311	5	11	80	0.1375000
NODE_16729_length_701_cov_38.715947	231	311	6	32	80	0.4000000
NODE_16729_length_701_cov_38.715947	231	311	7	5	80	0.0625000
NODE_16729_length_701_cov_38.715947	231	311	8	11	80	0.1375000
NODE_16729_length_701_cov_38.715947	231	311	9	4	80	0.0500000
NODE_16729_length_701_cov_38.715947	231	311	10	17	80	0.2125000
NODE_16729_length_701_cov_38.715947	307	387	6	27	80	0.3375000
NODE_16729_length_701_cov_38.715947	307	387	8	6	80	0.0750000
NODE_16729_length_701_cov_38.715947	307	387	9	17	80	0.2125000
NODE_16729_length_701_cov_38.715947	307	387	10	11	80	0.1375000
NODE_16729_length_701_cov_38.715947	307	387	11	7	80	0.0875000
NODE_16729_length_701_cov_38.715947	307	387	12	12	80	0.1500000
NODE_16729_length_701_cov_38.715947	360	440	6	11	80	0.1375000
NODE_16729_length_701_cov_38.715947	360	440	7	5	80	0.0625000
NODE_16729_length_701_cov_38.715947	360	440	9	20	80	0.2500000
NODE_16729_length_701_cov_38.715947	360	440	10	8	80	0.1000000
NODE_16729_length_701_cov_38.715947	360	440	11	24	80	0.3000000
NODE_16729_length_701_cov_38.715947	360	440	12	12	80	0.1500000
NODE_16730_length_701_cov_28.059801	432	513	2	2	81	0.0246914
NODE_16730_length_701_cov_28.059801	432	513	4	13	81	0.1604938
NODE_16730_length_701_cov_28.059801	432	513	5	6	81	0.0740741
NODE_16730_length_701_cov_28.059801	432	513	6	56	81	0.6913580
NODE_16730_length_701_cov_28.059801	432	513	7	4	81	0.0493827
NODE_16730_length_701_cov_28.059801	486	566	4	53	80	0.6625000
NODE_16730_length_701_cov_28.059801	486	566	6	27	80	0.3375000
NODE_16731_length_701_cov_18.387043	258	338	4	30	80	0.3750000
NODE_16731_length_701_cov_18.387043	258	338	5	4	80	0.0500000
NODE_16731_length_701_cov_18.387043	258	338	6	5	80	0.0625000
NODE_16731_length_701_cov_18.387043	258	338	7	17	80	0.2125000
NODE_16731_length_701_cov_18.387043	258	338	8	24	80	0.3000000
NODE_16731_length_701_cov_18.387043	311	391	4	4	80	0.0500000
NODE_16731_length_701_cov_18.387043	311	391	5	17	80	0.2125000
NODE_16731_length_701_cov_18.387043	311	391	6	3	80	0.0375000
NODE_16731_length_701_cov_18.387043	311	391	7	3	80	0.0375000
NODE_16731_length_701_cov_18.387043	311	391	8	53	80	0.6625000
NODE_16732_length_701_cov_17.122924	295	367	3	1	72	0.0138889
NODE_16732_length_701_cov_17.122924	295	367	4	14	72	0.1944444
NODE_16732_length_701_cov_17.122924	295	367	5	20	72	0.2777778
NODE_16732_length_701_cov_17.122924	295	367	6	37	72	0.5138889
NODE_16733_length_701_cov_16.114618	242	322	5	59	80	0.7375000
NODE_16733_length_701_cov_16.114618	242	322	6	21	80	0.2625000
NODE_16733_length_701_cov_16.114618	295	375	0	5	80	0.0625000
NODE_16733_length_701_cov_16.114618	295	375	2	17	80	0.2125000
NODE_16733_length_701_cov_16.114618	295	375	3	5	80	0.0625000
NODE_16733_length_701_cov_16.114618	295	375	5	53	80	0.6625000
NODE_16734_length_701_cov_15.588040	399	479	2	80	80	1.0000000
NODE_16734_length_701_cov_15.588040	452	532	0	18	80	0.2250000
NODE_16734_length_701_cov_15.588040	452	532	2	62	80	0.7750000
NODE_16736_length_701_cov_11.420266	229	309	0	80	80	1.0000000
NODE_16736_length_701_cov_11.420266	282	362	0	80	80	1.0000000
NODE_16737_length_701_cov_10.411960	202	283	3	4	81	0.0493827
NODE_16737_length_701_cov_10.411960	202	283	4	77	81	0.9506173
NODE_16737_length_701_cov_10.411960	256	336	2	6	80	0.0750000
NODE_16737_length_701_cov_10.411960	256	336	3	40	80	0.5000000
NODE_16737_length_701_cov_10.411960	256	336	4	34	80	0.4250000
NODE_16738_length_701_cov_9.107973	400	480	2	80	80	1.0000000
NODE_16738_length_701_cov_9.107973	453	533	0	7	80	0.0875000
NODE_16738_length_701_cov_9.107973	453	533	1	2	80	0.0250000
NODE_16738_length_701_cov_9.107973	453	533	2	71	80	0.8875000
NODE_16739_length_701_cov_8.877076	283	363	0	45	80	0.5625000
NODE_16739_length_701_cov_8.877076	283	363	1	35	80	0.4375000
NODE_16739_length_701_cov_8.877076	336	416	0	80	80	1.0000000
NODE_16740_length_701_cov_8.543189	341	421	1	16	80	0.2000000
NODE_16740_length_701_cov_8.543189	341	421	2	8	80	0.1000000
NODE_16740_length_701_cov_8.543189	341	421	3	56	80	0.7000000
NODE_16740_length_701_cov_8.543189	394	474	3	80	80	1.0000000
NODE_16742_length_701_cov_6.317276	273	353	2	59	80	0.7375000
NODE_16742_length_701_cov_6.317276	273	353	3	21	80	0.2625000
NODE_16742_length_701_cov_6.317276	326	382	1	8	56	0.1428571
NODE_16742_length_701_cov_6.317276	326	382	2	48	56	0.8571429
NODE_16747_length_701_cov_5.081395	318	374	1	7	56	0.1250000
NODE_16747_length_701_cov_5.081395	318	374	3	45	56	0.8035714
NODE_16747_length_701_cov_5.081395	318	374	4	4	56	0.0714286
NODE_16752_length_701_cov_3.320598	207	287	0	80	80	1.0000000
NODE_16752_length_701_cov_3.320598	260	340	0	80	80	1.0000000
NODE_16794_length_700_cov_22.241265	326	406	17	7	80	0.0875000
NODE_16794_length_700_cov_22.241265	326	406	18	10	80	0.1250000
NODE_16794_length_700_cov_22.241265	326	406	19	36	80	0.4500000
NODE_16794_length_700_cov_22.241265	326	406	20	19	80	0.2375000
NODE_16794_length_700_cov_22.241265	326	406	21	1	80	0.0125000
NODE_16794_length_700_cov_22.241265	326	406	22	7	80	0.0875000
NODE_16796_length_700_cov_11.730449	294	374	3	11	80	0.1375000
NODE_16796_length_700_cov_11.730449	294	374	4	48	80	0.6000000
NODE_16796_length_700_cov_11.730449	294	374	5	21	80	0.2625000
NODE_16796_length_700_cov_11.730449	347	427	2	2	80	0.0250000
NODE_16796_length_700_cov_11.730449	347	427	3	25	80	0.3125000
NODE_16796_length_700_cov_11.730449	347	427	4	37	80	0.4625000
NODE_16796_length_700_cov_11.730449	347	427	5	16	80	0.2000000
NODE_16800_length_700_cov_7.291181	317	397	1	3	80	0.0375000
NODE_16800_length_700_cov_7.291181	317	397	4	12	80	0.1500000
NODE_16800_length_700_cov_7.291181	317	397	6	8	80	0.1000000
NODE_16800_length_700_cov_7.291181	317	397	7	45	80	0.5625000
NODE_16800_length_700_cov_7.291181	317	397	8	12	80	0.1500000
NODE_16800_length_700_cov_7.291181	370	450	1	56	80	0.7000000
NODE_16800_length_700_cov_7.291181	370	450	4	12	80	0.1500000
NODE_16800_length_700_cov_7.291181	370	450	6	8	80	0.1000000
NODE_16800_length_700_cov_7.291181	370	450	7	4	80	0.0500000
NODE_16801_length_700_cov_6.557404	353	404	2	22	51	0.4313726
NODE_16801_length_700_cov_6.557404	353	404	3	29	51	0.5686275
NODE_16802_length_700_cov_5.475874	301	381	2	80	80	1.0000000
NODE_16802_length_700_cov_5.475874	354	434	0	8	80	0.1000000
NODE_16802_length_700_cov_5.475874	354	434	2	72	80	0.9000000
NODE_16803_length_700_cov_3.960067	158	234	0	6	76	0.0789474
NODE_16803_length_700_cov_3.960067	158	234	1	70	76	0.9210526
NODE_16803_length_700_cov_3.960067	209	291	1	72	82	0.8780488
NODE_16803_length_700_cov_3.960067	209	291	2	10	82	0.1219512
NODE_16822_length_700_cov_1.517471	324	404	0	80	80	1.0000000
NODE_16822_length_700_cov_1.517471	377	457	0	80	80	1.0000000
NODE_16844_length_699_cov_18.446667	185	265	7	17	80	0.2125000
NODE_16844_length_699_cov_18.446667	185	265	8	2	80	0.0250000
NODE_16844_length_699_cov_18.446667	185	265	10	8	80	0.1000000
NODE_16844_length_699_cov_18.446667	185	265	11	1	80	0.0125000
NODE_16844_length_699_cov_18.446667	185	265	12	5	80	0.0625000
NODE_16844_length_699_cov_18.446667	185	265	13	6	80	0.0750000
NODE_16844_length_699_cov_18.446667	185	265	14	24	80	0.3000000
NODE_16844_length_699_cov_18.446667	185	265	15	14	80	0.1750000
NODE_16844_length_699_cov_18.446667	185	265	16	2	80	0.0250000
NODE_16844_length_699_cov_18.446667	185	265	17	1	80	0.0125000
NODE_16844_length_699_cov_18.446667	238	318	12	5	80	0.0625000
NODE_16844_length_699_cov_18.446667	238	318	14	58	80	0.7250000
NODE_16844_length_699_cov_18.446667	238	318	15	14	80	0.1750000
NODE_16844_length_699_cov_18.446667	238	318	16	2	80	0.0250000
NODE_16844_length_699_cov_18.446667	238	318	17	1	80	0.0125000
NODE_16845_length_699_cov_18.383333	258	338	0	80	80	1.0000000
NODE_16845_length_699_cov_18.383333	311	391	0	80	80	1.0000000
NODE_16846_length_699_cov_18.103333	218	298	6	21	80	0.2625000
NODE_16846_length_699_cov_18.103333	218	298	8	33	80	0.4125000
NODE_16846_length_699_cov_18.103333	218	298	9	7	80	0.0875000
NODE_16846_length_699_cov_18.103333	218	298	10	19	80	0.2375000
NODE_16846_length_699_cov_18.103333	271	351	4	4	80	0.0500000
NODE_16846_length_699_cov_18.103333	271	351	5	6	80	0.0750000
NODE_16846_length_699_cov_18.103333	271	351	6	40	80	0.5000000
NODE_16846_length_699_cov_18.103333	271	351	8	14	80	0.1750000
NODE_16846_length_699_cov_18.103333	271	351	10	16	80	0.2000000
NODE_16847_length_699_cov_15.636667	279	359	3	30	80	0.3750000
NODE_16847_length_699_cov_15.636667	279	359	4	1	80	0.0125000
NODE_16847_length_699_cov_15.636667	279	359	6	49	80	0.6125000
NODE_16847_length_699_cov_15.636667	332	412	4	16	80	0.2000000
NODE_16847_length_699_cov_15.636667	332	412	5	3	80	0.0375000
NODE_16847_length_699_cov_15.636667	332	412	6	61	80	0.7625000
NODE_16848_length_699_cov_15.113333	313	393	1	16	80	0.2000000
NODE_16848_length_699_cov_15.113333	313	393	2	33	80	0.4125000
NODE_16848_length_699_cov_15.113333	313	393	3	31	80	0.3875000
NODE_16848_length_699_cov_15.113333	366	446	1	14	80	0.1750000
NODE_16848_length_699_cov_15.113333	366	446	2	51	80	0.6375000
NODE_16848_length_699_cov_15.113333	366	446	3	15	80	0.1875000
NODE_16849_length_699_cov_10.070000	233	313	0	80	80	1.0000000
NODE_16849_length_699_cov_10.070000	286	366	0	80	80	1.0000000
NODE_16849_length_699_cov_10.070000	362	442	0	80	80	1.0000000
NODE_16849_length_699_cov_10.070000	415	495	0	80	80	1.0000000
NODE_16850_length_699_cov_8.083333	347	427	0	80	80	1.0000000
NODE_16850_length_699_cov_8.083333	400	480	0	80	80	1.0000000
NODE_16851_length_699_cov_7.758333	307	387	0	80	80	1.0000000
NODE_16851_length_699_cov_7.758333	360	440	0	79	80	0.9875000
NODE_16851_length_699_cov_7.758333	360	440	1	1	80	0.0125000
NODE_16852_length_699_cov_7.713333	252	332	4	80	80	1.0000000
NODE_16852_length_699_cov_7.713333	305	385	1	21	80	0.2625000
NODE_16852_length_699_cov_7.713333	305	385	3	6	80	0.0750000
NODE_16852_length_699_cov_7.713333	305	385	4	53	80	0.6625000
NODE_16853_length_699_cov_7.186667	271	332	4	3	61	0.0491803
NODE_16853_length_699_cov_7.186667	271	332	5	21	61	0.3442623
NODE_16853_length_699_cov_7.186667	271	332	6	20	61	0.3278688
NODE_16853_length_699_cov_7.186667	271	332	7	1	61	0.0163934
NODE_16853_length_699_cov_7.186667	271	332	9	5	61	0.0819672
NODE_16853_length_699_cov_7.186667	271	332	10	11	61	0.1803279
NODE_16853_length_699_cov_7.186667	348	428	7	2	80	0.0250000
NODE_16853_length_699_cov_7.186667	348	428	8	6	80	0.0750000
NODE_16853_length_699_cov_7.186667	348	428	9	33	80	0.4125000
NODE_16853_length_699_cov_7.186667	348	428	10	27	80	0.3375000
NODE_16853_length_699_cov_7.186667	348	428	11	12	80	0.1500000
NODE_16857_length_699_cov_5.815000	243	316	2	73	73	1.0000000
NODE_16857_length_699_cov_5.815000	293	374	0	23	81	0.2839506
NODE_16857_length_699_cov_5.815000	293	374	1	14	81	0.1728395
NODE_16857_length_699_cov_5.815000	293	374	2	44	81	0.5432099
NODE_16858_length_699_cov_5.520000	302	382	0	80	80	1.0000000
NODE_16858_length_699_cov_5.520000	355	435	0	80	80	1.0000000
NODE_16860_length_699_cov_4.051667	289	369	1	22	80	0.2750000
NODE_16860_length_699_cov_4.051667	289	369	2	37	80	0.4625000
NODE_16860_length_699_cov_4.051667	289	369	3	1	80	0.0125000
NODE_16860_length_699_cov_4.051667	289	369	4	14	80	0.1750000
NODE_16860_length_699_cov_4.051667	289	369	5	6	80	0.0750000
NODE_16860_length_699_cov_4.051667	342	422	1	5	80	0.0625000
NODE_16860_length_699_cov_4.051667	342	422	2	1	80	0.0125000
NODE_16860_length_699_cov_4.051667	342	422	3	1	80	0.0125000
NODE_16860_length_699_cov_4.051667	342	422	4	67	80	0.8375000
NODE_16860_length_699_cov_4.051667	342	422	5	6	80	0.0750000
NODE_16868_length_699_cov_2.498333	204	284	0	80	80	1.0000000
NODE_16868_length_699_cov_2.498333	257	337	0	80	80	1.0000000
NODE_16908_length_698_cov_47.350584	321	401	14	25	80	0.3125000
NODE_16908_length_698_cov_47.350584	321	401	16	2	80	0.0250000
NODE_16908_length_698_cov_47.350584	321	401	17	19	80	0.2375000
NODE_16908_length_698_cov_47.350584	321	401	20	13	80	0.1625000
NODE_16908_length_698_cov_47.350584	321	401	21	13	80	0.1625000
NODE_16908_length_698_cov_47.350584	321	401	22	6	80	0.0750000
NODE_16908_length_698_cov_47.350584	321	401	23	2	80	0.0250000
NODE_16908_length_698_cov_47.350584	374	454	14	4	80	0.0500000
NODE_16908_length_698_cov_47.350584	374	454	16	4	80	0.0500000
NODE_16908_length_698_cov_47.350584	374	454	17	1	80	0.0125000
NODE_16908_length_698_cov_47.350584	374	454	19	40	80	0.5000000
NODE_16908_length_698_cov_47.350584	374	454	20	10	80	0.1250000
NODE_16908_length_698_cov_47.350584	374	454	21	14	80	0.1750000
NODE_16908_length_698_cov_47.350584	374	454	22	5	80	0.0625000
NODE_16908_length_698_cov_47.350584	374	454	23	2	80	0.0250000
NODE_16909_length_698_cov_42.848080	255	335	2	53	80	0.6625000
NODE_16909_length_698_cov_42.848080	255	335	3	27	80	0.3375000
NODE_16909_length_698_cov_42.848080	308	388	2	41	80	0.5125000
NODE_16909_length_698_cov_42.848080	308	388	3	39	80	0.4875000
NODE_16910_length_698_cov_36.697830	366	446	3	12	80	0.1500000
NODE_16910_length_698_cov_36.697830	366	446	8	38	80	0.4750000
NODE_16910_length_698_cov_36.697830	366	446	9	30	80	0.3750000
NODE_16910_length_698_cov_36.697830	419	484	7	5	65	0.0769231
NODE_16910_length_698_cov_36.697830	419	484	8	60	65	0.9230769
NODE_16911_length_698_cov_23.874791	222	302	2	8	80	0.1000000
NODE_16911_length_698_cov_23.874791	222	302	3	38	80	0.4750000
NODE_16911_length_698_cov_23.874791	222	302	4	34	80	0.4250000
NODE_16911_length_698_cov_23.874791	275	355	2	34	80	0.4250000
NODE_16911_length_698_cov_23.874791	275	355	4	46	80	0.5750000
NODE_16912_length_698_cov_7.133556	360	440	4	13	80	0.1625000
NODE_16912_length_698_cov_7.133556	360	440	5	49	80	0.6125000
NODE_16912_length_698_cov_7.133556	360	440	6	16	80	0.2000000
NODE_16912_length_698_cov_7.133556	360	440	7	2	80	0.0250000
NODE_16912_length_698_cov_7.133556	413	493	4	24	80	0.3000000
NODE_16912_length_698_cov_7.133556	413	493	5	56	80	0.7000000
NODE_16913_length_698_cov_6.520868	267	347	0	44	80	0.5500000
NODE_16913_length_698_cov_6.520868	267	347	2	9	80	0.1125000
NODE_16913_length_698_cov_6.520868	267	347	4	27	80	0.3375000
NODE_16913_length_698_cov_6.520868	320	400	4	80	80	1.0000000
NODE_16917_length_698_cov_4.762938	329	359	2	30	30	1.0000000
NODE_16926_length_698_cov_2.577629	309	389	0	80	80	1.0000000
NODE_16926_length_698_cov_2.577629	362	442	0	80	80	1.0000000
NODE_16962_length_697_cov_16.013378	305	385	0	19	80	0.2375000
NODE_16962_length_697_cov_16.013378	305	385	1	49	80	0.6125000
NODE_16962_length_697_cov_16.013378	305	385	2	4	80	0.0500000
NODE_16962_length_697_cov_16.013378	305	385	4	7	80	0.0875000
NODE_16962_length_697_cov_16.013378	305	385	5	1	80	0.0125000
NODE_16962_length_697_cov_16.013378	358	438	1	15	80	0.1875000
NODE_16962_length_697_cov_16.013378	358	438	2	4	80	0.0500000
NODE_16962_length_697_cov_16.013378	358	438	4	7	80	0.0875000
NODE_16962_length_697_cov_16.013378	358	438	5	54	80	0.6750000
NODE_16963_length_697_cov_14.411371	440	520	2	8	80	0.1000000
NODE_16963_length_697_cov_14.411371	440	520	3	7	80	0.0875000
NODE_16963_length_697_cov_14.411371	440	520	4	32	80	0.4000000
NODE_16963_length_697_cov_14.411371	440	520	5	33	80	0.4125000
NODE_16963_length_697_cov_14.411371	493	573	1	16	80	0.2000000
NODE_16963_length_697_cov_14.411371	493	573	2	45	80	0.5625000
NODE_16963_length_697_cov_14.411371	493	573	3	7	80	0.0875000
NODE_16963_length_697_cov_14.411371	493	573	4	12	80	0.1500000
NODE_16964_length_697_cov_14.282609	257	354	1	26	97	0.2680412
NODE_16964_length_697_cov_14.282609	257	354	2	62	97	0.6391752
NODE_16964_length_697_cov_14.282609	257	354	3	9	97	0.0927835
NODE_16964_length_697_cov_14.282609	327	385	1	18	58	0.3103448
NODE_16964_length_697_cov_14.282609	327	385	2	40	58	0.6896552
NODE_16965_length_697_cov_9.969900	360	440	0	80	80	1.0000000
NODE_16965_length_697_cov_9.969900	413	493	0	80	80	1.0000000
NODE_16968_length_697_cov_6.117057	236	316	3	71	80	0.8875000
NODE_16968_length_697_cov_6.117057	236	316	4	9	80	0.1125000
NODE_16968_length_697_cov_6.117057	289	369	2	38	80	0.4750000
NODE_16968_length_697_cov_6.117057	289	369	3	42	80	0.5250000
NODE_17025_length_696_cov_28.360134	319	399	2	21	80	0.2625000
NODE_17025_length_696_cov_28.360134	319	399	4	10	80	0.1250000
NODE_17025_length_696_cov_28.360134	319	399	6	49	80	0.6125000
NODE_17025_length_696_cov_28.360134	372	452	4	44	80	0.5500000
NODE_17025_length_696_cov_28.360134	372	452	6	36	80	0.4500000
NODE_17026_length_696_cov_18.708543	367	447	2	80	80	1.0000000
NODE_17026_length_696_cov_18.708543	420	500	0	33	80	0.4125000
NODE_17026_length_696_cov_18.708543	420	500	2	47	80	0.5875000
NODE_17027_length_696_cov_18.170854	390	470	2	8	80	0.1000000
NODE_17027_length_696_cov_18.170854	390	470	3	72	80	0.9000000
NODE_17027_length_696_cov_18.170854	443	523	1	5	80	0.0625000
NODE_17027_length_696_cov_18.170854	443	523	2	8	80	0.1000000
NODE_17027_length_696_cov_18.170854	443	523	3	67	80	0.8375000
NODE_17028_length_696_cov_13.738693	266	346	2	31	80	0.3875000
NODE_17028_length_696_cov_13.738693	266	346	4	5	80	0.0625000
NODE_17028_length_696_cov_13.738693	266	346	6	19	80	0.2375000
NODE_17028_length_696_cov_13.738693	266	346	8	5	80	0.0625000
NODE_17028_length_696_cov_13.738693	266	346	10	20	80	0.2500000
NODE_17028_length_696_cov_13.738693	319	399	6	2	80	0.0250000
NODE_17028_length_696_cov_13.738693	319	399	7	14	80	0.1750000
NODE_17028_length_696_cov_13.738693	319	399	8	44	80	0.5500000
NODE_17028_length_696_cov_13.738693	319	399	10	20	80	0.2500000
NODE_17030_length_696_cov_10.693467	239	266	0	27	27	1.0000000
NODE_17031_length_696_cov_9.949749	248	328	2	2	80	0.0250000
NODE_17031_length_696_cov_9.949749	248	328	3	19	80	0.2375000
NODE_17031_length_696_cov_9.949749	248	328	4	41	80	0.5125000
NODE_17031_length_696_cov_9.949749	248	328	5	8	80	0.1000000
NODE_17031_length_696_cov_9.949749	248	328	6	10	80	0.1250000
NODE_17031_length_696_cov_9.949749	301	381	4	9	80	0.1125000
NODE_17031_length_696_cov_9.949749	301	381	5	35	80	0.4375000
NODE_17031_length_696_cov_9.949749	301	381	6	36	80	0.4500000
NODE_17032_length_696_cov_8.658291	247	327	0	7	80	0.0875000
NODE_17032_length_696_cov_8.658291	247	327	1	7	80	0.0875000
NODE_17032_length_696_cov_8.658291	247	327	2	66	80	0.8250000
NODE_17032_length_696_cov_8.658291	300	380	0	60	80	0.7500000
NODE_17032_length_696_cov_8.658291	300	380	1	7	80	0.0875000
NODE_17032_length_696_cov_8.658291	300	380	2	13	80	0.1625000
NODE_17032_length_696_cov_8.658291	376	456	0	80	80	1.0000000
NODE_17032_length_696_cov_8.658291	429	509	0	80	80	1.0000000
NODE_17068_length_696_cov_1.675042	498	543	0	45	45	1.0000000
NODE_17100_length_695_cov_24.112416	388	468	5	4	80	0.0500000
NODE_17100_length_695_cov_24.112416	388	468	6	2	80	0.0250000
NODE_17100_length_695_cov_24.112416	388	468	7	28	80	0.3500000
NODE_17100_length_695_cov_24.112416	388	468	8	26	80	0.3250000
NODE_17100_length_695_cov_24.112416	388	468	9	20	80	0.2500000
NODE_17100_length_695_cov_24.112416	441	521	5	53	80	0.6625000
NODE_17100_length_695_cov_24.112416	441	521	6	6	80	0.0750000
NODE_17100_length_695_cov_24.112416	441	521	8	6	80	0.0750000
NODE_17100_length_695_cov_24.112416	441	521	9	15	80	0.1875000
NODE_17101_length_695_cov_12.152685	349	429	3	12	80	0.1500000
NODE_17101_length_695_cov_12.152685	349	429	4	66	80	0.8250000
NODE_17101_length_695_cov_12.152685	349	429	5	2	80	0.0250000
NODE_17101_length_695_cov_12.152685	402	482	3	65	80	0.8125000
NODE_17101_length_695_cov_12.152685	402	482	4	15	80	0.1875000
NODE_17103_length_695_cov_8.466443	345	425	0	11	80	0.1375000
NODE_17103_length_695_cov_8.466443	345	425	2	69	80	0.8625000
NODE_17103_length_695_cov_8.466443	398	478	2	80	80	1.0000000
NODE_17106_length_695_cov_5.661074	283	363	1	23	80	0.2875000
NODE_17106_length_695_cov_5.661074	283	363	2	12	80	0.1500000
NODE_17106_length_695_cov_5.661074	283	363	4	14	80	0.1750000
NODE_17106_length_695_cov_5.661074	283	363	5	31	80	0.3875000
NODE_17106_length_695_cov_5.661074	346	416	4	25	70	0.3571429
NODE_17106_length_695_cov_5.661074	346	416	5	45	70	0.6428571
NODE_17124_length_695_cov_2.050336	36	112	0	76	76	1.0000000
NODE_17161_length_694_cov_46.675630	30	110	0	80	80	1.0000000
NODE_17161_length_694_cov_46.675630	83	163	0	80	80	1.0000000
NODE_17161_length_694_cov_46.675630	159	239	0	80	80	1.0000000
NODE_17161_length_694_cov_46.675630	212	292	0	80	80	1.0000000
NODE_17162_length_694_cov_12.850420	326	406	1	80	80	1.0000000
NODE_17162_length_694_cov_12.850420	379	459	0	14	80	0.1750000
NODE_17162_length_694_cov_12.850420	379	459	1	66	80	0.8250000
NODE_17163_length_694_cov_7.236975	318	396	3	59	78	0.7564102
NODE_17163_length_694_cov_7.236975	318	396	5	19	78	0.2435897
NODE_17163_length_694_cov_7.236975	371	450	2	5	79	0.0632911
NODE_17163_length_694_cov_7.236975	371	450	3	16	79	0.2025317
NODE_17163_length_694_cov_7.236975	371	450	4	6	79	0.0759494
NODE_17163_length_694_cov_7.236975	371	450	5	52	79	0.6582279
NODE_17166_length_694_cov_5.554622	404	484	0	80	80	1.0000000
NODE_17166_length_694_cov_5.554622	457	537	0	80	80	1.0000000
NODE_17168_length_694_cov_5.373109	152	232	0	39	80	0.4875000
NODE_17168_length_694_cov_5.373109	152	232	2	41	80	0.5125000
NODE_17168_length_694_cov_5.373109	205	285	2	80	80	1.0000000
NODE_17227_length_693_cov_26.616162	435	515	6	9	80	0.1125000
NODE_17227_length_693_cov_26.616162	435	515	7	3	80	0.0375000
NODE_17227_length_693_cov_26.616162	435	515	9	24	80	0.3000000
NODE_17227_length_693_cov_26.616162	435	515	10	2	80	0.0250000
NODE_17227_length_693_cov_26.616162	435	515	11	3	80	0.0375000
NODE_17227_length_693_cov_26.616162	435	515	12	39	80	0.4875000
NODE_17227_length_693_cov_26.616162	488	568	6	4	80	0.0500000
NODE_17227_length_693_cov_26.616162	488	568	8	26	80	0.3250000
NODE_17227_length_693_cov_26.616162	488	568	10	20	80	0.2500000
NODE_17227_length_693_cov_26.616162	488	568	11	6	80	0.0750000
NODE_17227_length_693_cov_26.616162	488	568	12	24	80	0.3000000
NODE_17228_length_693_cov_23.552189	193	273	6	3	80	0.0375000
NODE_17228_length_693_cov_23.552189	193	273	8	12	80	0.1500000
NODE_17228_length_693_cov_23.552189	193	273	10	5	80	0.0625000
NODE_17228_length_693_cov_23.552189	193	273	11	44	80	0.5500000
NODE_17228_length_693_cov_23.552189	193	273	12	16	80	0.2000000
NODE_17228_length_693_cov_23.552189	246	326	4	2	80	0.0250000
NODE_17228_length_693_cov_23.552189	246	326	5	29	80	0.3625000
NODE_17228_length_693_cov_23.552189	246	326	6	25	80	0.3125000
NODE_17228_length_693_cov_23.552189	246	326	8	12	80	0.1500000
NODE_17228_length_693_cov_23.552189	246	326	10	5	80	0.0625000
NODE_17228_length_693_cov_23.552189	246	326	12	7	80	0.0875000
NODE_17229_length_693_cov_22.848485	231	311	6	4	80	0.0500000
NODE_17229_length_693_cov_22.848485	231	311	7	76	80	0.9500000
NODE_17229_length_693_cov_22.848485	284	364	1	17	80	0.2125000
NODE_17229_length_693_cov_22.848485	284	364	2	5	80	0.0625000
NODE_17229_length_693_cov_22.848485	284	364	4	25	80	0.3125000
NODE_17229_length_693_cov_22.848485	284	364	7	33	80	0.4125000
NODE_17230_length_693_cov_13.616162	219	299	2	27	80	0.3375000
NODE_17230_length_693_cov_13.616162	219	299	3	12	80	0.1500000
NODE_17230_length_693_cov_13.616162	219	299	4	41	80	0.5125000
NODE_17230_length_693_cov_13.616162	272	352	2	70	80	0.8750000
NODE_17230_length_693_cov_13.616162	272	352	3	1	80	0.0125000
NODE_17230_length_693_cov_13.616162	272	352	4	9	80	0.1125000
NODE_17231_length_693_cov_12.382155	305	385	0	21	80	0.2625000
NODE_17231_length_693_cov_12.382155	305	385	2	59	80	0.7375000
NODE_17231_length_693_cov_12.382155	358	424	2	66	66	1.0000000
NODE_17232_length_693_cov_10.053872	279	359	4	28	80	0.3500000
NODE_17232_length_693_cov_10.053872	279	359	5	52	80	0.6500000
NODE_17232_length_693_cov_10.053872	332	412	2	5	80	0.0625000
NODE_17232_length_693_cov_10.053872	332	412	3	39	80	0.4875000
NODE_17232_length_693_cov_10.053872	332	412	4	8	80	0.1000000
NODE_17232_length_693_cov_10.053872	332	412	5	28	80	0.3500000
NODE_17233_length_693_cov_9.659933	247	327	6	13	80	0.1625000
NODE_17233_length_693_cov_9.659933	247	327	8	16	80	0.2000000
NODE_17233_length_693_cov_9.659933	247	327	9	51	80	0.6375000
NODE_17233_length_693_cov_9.659933	300	380	2	4	80	0.0500000
NODE_17233_length_693_cov_9.659933	300	380	3	12	80	0.1500000
NODE_17233_length_693_cov_9.659933	300	380	4	4	80	0.0500000
NODE_17233_length_693_cov_9.659933	300	380	6	15	80	0.1875000
NODE_17233_length_693_cov_9.659933	300	380	7	7	80	0.0875000
NODE_17233_length_693_cov_9.659933	300	380	9	38	80	0.4750000
NODE_17235_length_693_cov_8.077441	343	423	1	80	80	1.0000000
NODE_17235_length_693_cov_8.077441	396	476	1	67	80	0.8375000
NODE_17235_length_693_cov_8.077441	396	476	2	13	80	0.1625000
NODE_17243_length_693_cov_3.680135	250	321	1	10	71	0.1408451
NODE_17243_length_693_cov_3.680135	250	321	2	61	71	0.8591549
NODE_17280_length_692_cov_33.416526	462	542	17	5	80	0.0625000
NODE_17280_length_692_cov_33.416526	462	542	18	5	80	0.0625000
NODE_17280_length_692_cov_33.416526	462	542	19	7	80	0.0875000
NODE_17280_length_692_cov_33.416526	462	542	20	22	80	0.2750000
NODE_17280_length_692_cov_33.416526	462	542	21	1	80	0.0125000
NODE_17280_length_692_cov_33.416526	462	542	23	22	80	0.2750000
NODE_17280_length_692_cov_33.416526	462	542	24	18	80	0.2250000
NODE_17280_length_692_cov_33.416526	515	595	9	4	80	0.0500000
NODE_17280_length_692_cov_33.416526	515	595	11	6	80	0.0750000
NODE_17280_length_692_cov_33.416526	515	595	13	2	80	0.0250000
NODE_17280_length_692_cov_33.416526	515	595	15	14	80	0.1750000
NODE_17280_length_692_cov_33.416526	515	595	17	12	80	0.1500000
NODE_17280_length_692_cov_33.416526	515	595	18	11	80	0.1375000
NODE_17280_length_692_cov_33.416526	515	595	19	9	80	0.1125000
NODE_17280_length_692_cov_33.416526	515	595	20	10	80	0.1250000
NODE_17280_length_692_cov_33.416526	515	595	23	6	80	0.0750000
NODE_17280_length_692_cov_33.416526	515	595	24	6	80	0.0750000
NODE_17281_length_692_cov_17.559865	291	371	0	8	80	0.1000000
NODE_17281_length_692_cov_17.559865	291	371	2	72	80	0.9000000
NODE_17282_length_692_cov_15.070826	304	375	0	71	71	1.0000000
NODE_17283_length_692_cov_13.279933	308	388	10	17	80	0.2125000
NODE_17283_length_692_cov_13.279933	308	388	11	3	80	0.0375000
NODE_17283_length_692_cov_13.279933	308	388	13	7	80	0.0875000
NODE_17283_length_692_cov_13.279933	308	388	14	10	80	0.1250000
NODE_17283_length_692_cov_13.279933	308	388	15	6	80	0.0750000
NODE_17283_length_692_cov_13.279933	308	388	16	9	80	0.1125000
NODE_17283_length_692_cov_13.279933	308	388	17	14	80	0.1750000
NODE_17283_length_692_cov_13.279933	308	388	18	14	80	0.1750000
NODE_17283_length_692_cov_13.279933	361	441	11	11	80	0.1375000
NODE_17283_length_692_cov_13.279933	361	441	12	27	80	0.3375000
NODE_17283_length_692_cov_13.279933	361	441	13	2	80	0.0250000
NODE_17283_length_692_cov_13.279933	361	441	15	11	80	0.1375000
NODE_17283_length_692_cov_13.279933	361	441	16	5	80	0.0625000
NODE_17283_length_692_cov_13.279933	361	441	17	10	80	0.1250000
NODE_17283_length_692_cov_13.279933	361	441	18	14	80	0.1750000
NODE_17285_length_692_cov_10.750422	317	397	1	16	80	0.2000000
NODE_17285_length_692_cov_10.750422	317	397	2	64	80	0.8000000
NODE_17287_length_692_cov_7.497470	175	255	3	43	80	0.5375000
NODE_17287_length_692_cov_7.497470	175	255	5	37	80	0.4625000
NODE_17287_length_692_cov_7.497470	228	312	1	6	84	0.0714286
NODE_17287_length_692_cov_7.497470	228	312	2	2	84	0.0238095
NODE_17287_length_692_cov_7.497470	228	312	3	1	84	0.0119048
NODE_17287_length_692_cov_7.497470	228	312	5	59	84	0.7023810
NODE_17287_length_692_cov_7.497470	228	312	6	16	84	0.1904762
NODE_17289_length_692_cov_7.370995	235	315	0	8	80	0.1000000
NODE_17289_length_692_cov_7.370995	235	315	2	72	80	0.9000000
NODE_17289_length_692_cov_7.370995	288	369	0	62	81	0.7654321
NODE_17289_length_692_cov_7.370995	288	369	2	19	81	0.2345679
NODE_17328_length_692_cov_1.514334	404	484	0	23	80	0.2875000
NODE_17328_length_692_cov_1.514334	404	484	2	26	80	0.3250000
NODE_17328_length_692_cov_1.514334	404	484	4	31	80	0.3875000
NODE_17350_length_691_cov_115.233108	276	356	1	16	80	0.2000000
NODE_17350_length_691_cov_115.233108	276	356	2	8	80	0.1000000
NODE_17350_length_691_cov_115.233108	276	356	3	44	80	0.5500000
NODE_17350_length_691_cov_115.233108	276	356	4	2	80	0.0250000
NODE_17350_length_691_cov_115.233108	276	356	5	5	80	0.0625000
NODE_17350_length_691_cov_115.233108	276	356	6	5	80	0.0625000
NODE_17350_length_691_cov_115.233108	329	409	3	15	80	0.1875000
NODE_17350_length_691_cov_115.233108	329	409	4	2	80	0.0250000
NODE_17350_length_691_cov_115.233108	329	409	5	9	80	0.1125000
NODE_17350_length_691_cov_115.233108	329	409	6	23	80	0.2875000
NODE_17350_length_691_cov_115.233108	329	409	7	31	80	0.3875000
NODE_17350_length_691_cov_115.233108	405	485	5	3	80	0.0375000
NODE_17350_length_691_cov_115.233108	405	485	6	1	80	0.0125000
NODE_17350_length_691_cov_115.233108	405	485	7	9	80	0.1125000
NODE_17350_length_691_cov_115.233108	405	485	9	4	80	0.0500000
NODE_17350_length_691_cov_115.233108	405	485	10	6	80	0.0750000
NODE_17350_length_691_cov_115.233108	405	485	12	25	80	0.3125000
NODE_17350_length_691_cov_115.233108	405	485	13	32	80	0.4000000
NODE_17350_length_691_cov_115.233108	458	538	10	15	80	0.1875000
NODE_17350_length_691_cov_115.233108	458	538	11	11	80	0.1375000
NODE_17350_length_691_cov_115.233108	458	538	12	19	80	0.2375000
NODE_17350_length_691_cov_115.233108	458	538	13	35	80	0.4375000
NODE_17351_length_691_cov_26.076014	188	268	6	10	80	0.1250000
NODE_17351_length_691_cov_26.076014	188	268	8	30	80	0.3750000
NODE_17351_length_691_cov_26.076014	188	268	9	29	80	0.3625000
NODE_17351_length_691_cov_26.076014	188	268	10	11	80	0.1375000
NODE_17351_length_691_cov_26.076014	241	321	7	20	80	0.2500000
NODE_17351_length_691_cov_26.076014	241	321	8	4	80	0.0500000
NODE_17351_length_691_cov_26.076014	241	321	9	51	80	0.6375000
NODE_17351_length_691_cov_26.076014	241	321	10	5	80	0.0625000
NODE_17352_length_691_cov_21.991554	288	368	0	80	80	1.0000000
NODE_17352_length_691_cov_21.991554	341	419	0	78	78	1.0000000
NODE_17353_length_691_cov_14.908784	226	306	1	17	80	0.2125000
NODE_17353_length_691_cov_14.908784	226	306	3	51	80	0.6375000
NODE_17353_length_691_cov_14.908784	226	306	4	12	80	0.1500000
NODE_17353_length_691_cov_14.908784	279	359	3	15	80	0.1875000
NODE_17353_length_691_cov_14.908784	279	359	4	65	80	0.8125000
NODE_17358_length_691_cov_5.670608	325	402	1	22	77	0.2857143
NODE_17358_length_691_cov_5.670608	325	402	2	32	77	0.4155844
NODE_17358_length_691_cov_5.670608	325	402	3	23	77	0.2987013
NODE_17358_length_691_cov_5.670608	375	455	2	4	80	0.0500000
NODE_17358_length_691_cov_5.670608	375	455	3	26	80	0.3250000
NODE_17358_length_691_cov_5.670608	375	455	4	50	80	0.6250000
NODE_17361_length_691_cov_4.866554	103	183	0	56	80	0.7000000
NODE_17361_length_691_cov_4.866554	103	183	1	24	80	0.3000000
NODE_17361_length_691_cov_4.866554	156	236	0	3	80	0.0375000
NODE_17361_length_691_cov_4.866554	156	236	1	77	80	0.9625000
NODE_17367_length_691_cov_3.388514	304	384	0	80	80	1.0000000
NODE_17367_length_691_cov_3.388514	357	437	0	80	80	1.0000000
NODE_17415_length_690_cov_39.538071	563	612	1	49	49	1.0000000
NODE_17415_length_690_cov_39.538071	598	678	1	80	80	1.0000000
NODE_17415_length_690_cov_39.538071	651	690	0	4	39	0.1025641
NODE_17415_length_690_cov_39.538071	651	690	1	35	39	0.8974359
NODE_17417_length_690_cov_30.336717	319	394	1	23	75	0.3066667
NODE_17417_length_690_cov_30.336717	319	394	2	1	75	0.0133333
NODE_17417_length_690_cov_30.336717	319	394	3	51	75	0.6800000
NODE_17417_length_690_cov_30.336717	372	453	3	63	81	0.7777778
NODE_17417_length_690_cov_30.336717	372	453	4	15	81	0.1851852
NODE_17417_length_690_cov_30.336717	372	453	5	3	81	0.0370370
NODE_17417_length_690_cov_30.336717	449	529	4	62	80	0.7750000
NODE_17417_length_690_cov_30.336717	449	529	5	5	80	0.0625000
NODE_17417_length_690_cov_30.336717	449	529	6	13	80	0.1625000
NODE_17417_length_690_cov_30.336717	502	582	4	80	80	1.0000000
NODE_17418_length_690_cov_26.888325	270	350	0	1	80	0.0125000
NODE_17418_length_690_cov_26.888325	270	350	2	23	80	0.2875000
NODE_17418_length_690_cov_26.888325	270	350	3	56	80	0.7000000
NODE_17418_length_690_cov_26.888325	323	403	1	1	80	0.0125000
NODE_17418_length_690_cov_26.888325	323	403	2	38	80	0.4750000
NODE_17418_length_690_cov_26.888325	323	403	3	41	80	0.5125000
NODE_17419_length_690_cov_23.360406	131	211	7	71	80	0.8875000
NODE_17419_length_690_cov_23.360406	131	211	8	3	80	0.0375000
NODE_17419_length_690_cov_23.360406	131	211	9	6	80	0.0750000
NODE_17419_length_690_cov_23.360406	188	264	4	21	76	0.2763158
NODE_17419_length_690_cov_23.360406	188	264	5	6	76	0.0789474
NODE_17419_length_690_cov_23.360406	188	264	6	2	76	0.0263158
NODE_17419_length_690_cov_23.360406	188	264	7	18	76	0.2368421
NODE_17419_length_690_cov_23.360406	188	264	8	21	76	0.2763158
NODE_17419_length_690_cov_23.360406	188	264	9	8	76	0.1052632
NODE_17420_length_690_cov_18.737733	316	396	0	37	80	0.4625000
NODE_17420_length_690_cov_18.737733	316	396	2	43	80	0.5375000
NODE_17420_length_690_cov_18.737733	369	449	0	80	80	1.0000000
NODE_17421_length_690_cov_16.593909	364	444	2	7	80	0.0875000
NODE_17421_length_690_cov_16.593909	364	444	3	5	80	0.0625000
NODE_17421_length_690_cov_16.593909	364	444	4	2	80	0.0250000
NODE_17421_length_690_cov_16.593909	364	444	5	10	80	0.1250000
NODE_17421_length_690_cov_16.593909	364	444	6	28	80	0.3500000
NODE_17421_length_690_cov_16.593909	364	444	7	1	80	0.0125000
NODE_17421_length_690_cov_16.593909	364	444	8	27	80	0.3375000
NODE_17421_length_690_cov_16.593909	417	497	2	7	80	0.0875000
NODE_17421_length_690_cov_16.593909	417	497	3	16	80	0.2000000
NODE_17421_length_690_cov_16.593909	417	497	4	44	80	0.5500000
NODE_17421_length_690_cov_16.593909	417	497	5	10	80	0.1250000
NODE_17421_length_690_cov_16.593909	417	497	6	3	80	0.0375000
NODE_17422_length_690_cov_12.896785	320	400	12	6	80	0.0750000
NODE_17422_length_690_cov_12.896785	320	400	13	20	80	0.2500000
NODE_17422_length_690_cov_12.896785	320	400	14	26	80	0.3250000
NODE_17422_length_690_cov_12.896785	320	400	15	9	80	0.1125000
NODE_17422_length_690_cov_12.896785	320	400	16	13	80	0.1625000
NODE_17422_length_690_cov_12.896785	320	400	17	6	80	0.0750000
NODE_17422_length_690_cov_12.896785	373	453	8	17	80	0.2125000
NODE_17422_length_690_cov_12.896785	373	453	10	11	80	0.1375000
NODE_17422_length_690_cov_12.896785	373	453	11	8	80	0.1000000
NODE_17422_length_690_cov_12.896785	373	453	13	15	80	0.1875000
NODE_17422_length_690_cov_12.896785	373	453	14	11	80	0.1375000
NODE_17422_length_690_cov_12.896785	373	453	15	3	80	0.0375000
NODE_17422_length_690_cov_12.896785	373	453	16	9	80	0.1125000
NODE_17422_length_690_cov_12.896785	373	453	17	6	80	0.0750000
NODE_17423_length_690_cov_10.818951	349	429	5	10	80	0.1250000
NODE_17423_length_690_cov_10.818951	349	429	6	26	80	0.3250000
NODE_17423_length_690_cov_10.818951	349	429	7	44	80	0.5500000
NODE_17424_length_690_cov_7.015228	273	353	2	30	80	0.3750000
NODE_17424_length_690_cov_7.015228	273	353	3	18	80	0.2250000
NODE_17424_length_690_cov_7.015228	273	353	4	32	80	0.4000000
NODE_17424_length_690_cov_7.015228	326	406	2	80	80	1.0000000
NODE_17429_length_690_cov_4.793570	316	365	18	8	49	0.1632653
NODE_17429_length_690_cov_4.793570	316	365	19	2	49	0.0408163
NODE_17429_length_690_cov_4.793570	316	365	20	4	49	0.0816327
NODE_17429_length_690_cov_4.793570	316	365	21	9	49	0.1836735
NODE_17429_length_690_cov_4.793570	316	365	22	4	49	0.0816327
NODE_17429_length_690_cov_4.793570	316	365	23	15	49	0.3061225
NODE_17429_length_690_cov_4.793570	316	365	24	7	49	0.1428571
NODE_17430_length_690_cov_4.717428	316	396	0	80	80	1.0000000
NODE_17430_length_690_cov_4.717428	369	449	0	80	80	1.0000000
NODE_17484_length_689_cov_45.984746	244	322	1	9	78	0.1153846
NODE_17484_length_689_cov_45.984746	244	322	2	69	78	0.8846154
NODE_17484_length_689_cov_45.984746	297	377	1	7	80	0.0875000
NODE_17484_length_689_cov_45.984746	297	377	2	73	80	0.9125000
NODE_17485_length_689_cov_35.705085	436	516	0	24	80	0.3000000
NODE_17485_length_689_cov_35.705085	436	516	2	56	80	0.7000000
NODE_17485_length_689_cov_35.705085	489	569	2	80	80	1.0000000
NODE_17486_length_689_cov_25.372881	211	291	3	59	80	0.7375000
NODE_17486_length_689_cov_25.372881	211	291	4	21	80	0.2625000
NODE_17486_length_689_cov_25.372881	264	344	1	17	80	0.2125000
NODE_17486_length_689_cov_25.372881	264	344	2	11	80	0.1375000
NODE_17486_length_689_cov_25.372881	264	344	3	52	80	0.6500000
NODE_17487_length_689_cov_20.138983	319	399	0	7	80	0.0875000
NODE_17487_length_689_cov_20.138983	319	399	1	34	80	0.4250000
NODE_17487_length_689_cov_20.138983	319	399	2	39	80	0.4875000
NODE_17487_length_689_cov_20.138983	372	452	2	80	80	1.0000000
NODE_17488_length_689_cov_14.377966	351	431	0	45	80	0.5625000
NODE_17488_length_689_cov_14.377966	351	431	1	35	80	0.4375000
NODE_17488_length_689_cov_14.377966	404	484	0	80	80	1.0000000
NODE_17489_length_689_cov_9.477966	201	281	0	6	80	0.0750000
NODE_17489_length_689_cov_9.477966	201	281	2	17	80	0.2125000
NODE_17489_length_689_cov_9.477966	201	281	3	43	80	0.5375000
NODE_17489_length_689_cov_9.477966	201	281	4	14	80	0.1750000
NODE_17489_length_689_cov_9.477966	254	334	2	9	80	0.1125000
NODE_17489_length_689_cov_9.477966	254	334	3	13	80	0.1625000
NODE_17489_length_689_cov_9.477966	254	334	4	58	80	0.7250000
NODE_17491_length_689_cov_7.367797	122	207	2	4	85	0.0470588
NODE_17491_length_689_cov_7.367797	122	207	3	62	85	0.7294118
NODE_17491_length_689_cov_7.367797	122	207	4	19	85	0.2235294
NODE_17492_length_689_cov_6.649153	242	322	1	3	80	0.0375000
NODE_17492_length_689_cov_6.649153	242	322	2	9	80	0.1125000
NODE_17492_length_689_cov_6.649153	242	322	4	18	80	0.2250000
NODE_17492_length_689_cov_6.649153	242	322	5	50	80	0.6250000
NODE_17492_length_689_cov_6.649153	295	375	1	21	80	0.2625000
NODE_17492_length_689_cov_6.649153	295	375	2	9	80	0.1125000
NODE_17492_length_689_cov_6.649153	295	375	3	35	80	0.4375000
NODE_17492_length_689_cov_6.649153	295	375	4	7	80	0.0875000
NODE_17492_length_689_cov_6.649153	295	375	5	8	80	0.1000000
NODE_17504_length_689_cov_2.788136	128	208	0	80	80	1.0000000
NODE_17504_length_689_cov_2.788136	181	261	0	80	80	1.0000000
NODE_17548_length_688_cov_52.256367	198	278	5	10	80	0.1250000
NODE_17548_length_688_cov_52.256367	198	278	6	14	80	0.1750000
NODE_17548_length_688_cov_52.256367	198	278	7	24	80	0.3000000
NODE_17548_length_688_cov_52.256367	198	278	10	9	80	0.1125000
NODE_17548_length_688_cov_52.256367	198	278	11	1	80	0.0125000
NODE_17548_length_688_cov_52.256367	198	278	12	4	80	0.0500000
NODE_17548_length_688_cov_52.256367	198	278	13	8	80	0.1000000
NODE_17548_length_688_cov_52.256367	198	278	14	1	80	0.0125000
NODE_17548_length_688_cov_52.256367	198	278	15	9	80	0.1125000
NODE_17548_length_688_cov_52.256367	251	331	10	4	80	0.0500000
NODE_17548_length_688_cov_52.256367	251	331	11	1	80	0.0125000
NODE_17548_length_688_cov_52.256367	251	331	12	4	80	0.0500000
NODE_17548_length_688_cov_52.256367	251	331	13	8	80	0.1000000
NODE_17548_length_688_cov_52.256367	251	331	14	11	80	0.1375000
NODE_17548_length_688_cov_52.256367	251	331	15	20	80	0.2500000
NODE_17548_length_688_cov_52.256367	251	331	16	4	80	0.0500000
NODE_17548_length_688_cov_52.256367	251	331	17	28	80	0.3500000
NODE_17549_length_688_cov_37.563667	373	453	5	10	80	0.1250000
NODE_17549_length_688_cov_37.563667	373	453	6	70	80	0.8750000
NODE_17549_length_688_cov_37.563667	426	506	1	2	80	0.0250000
NODE_17549_length_688_cov_37.563667	426	506	2	5	80	0.0625000
NODE_17549_length_688_cov_37.563667	426	506	3	41	80	0.5125000
NODE_17549_length_688_cov_37.563667	426	506	4	5	80	0.0625000
NODE_17549_length_688_cov_37.563667	426	506	6	27	80	0.3375000
NODE_17549_length_688_cov_37.563667	514	594	0	61	80	0.7625000
NODE_17549_length_688_cov_37.563667	514	594	1	19	80	0.2375000
NODE_17549_length_688_cov_37.563667	514	594	0	61	80	0.7625000
NODE_17549_length_688_cov_37.563667	514	594	1	19	80	0.2375000
NODE_17549_length_688_cov_37.563667	514	584	0	51	70	0.7285714
NODE_17549_length_688_cov_37.563667	514	584	1	19	70	0.2714286
NODE_17549_length_688_cov_37.563667	567	647	0	80	80	1.0000000
NODE_17549_length_688_cov_37.563667	567	646	0	79	79	1.0000000
NODE_17550_length_688_cov_33.898132	373	453	4	10	80	0.1250000
NODE_17550_length_688_cov_33.898132	373	453	5	6	80	0.0750000
NODE_17550_length_688_cov_33.898132	373	453	8	5	80	0.0625000
NODE_17550_length_688_cov_33.898132	373	453	9	59	80	0.7375000
NODE_17550_length_688_cov_33.898132	426	506	4	2	80	0.0250000
NODE_17550_length_688_cov_33.898132	426	506	6	24	80	0.3000000
NODE_17550_length_688_cov_33.898132	426	506	8	32	80	0.4000000
NODE_17550_length_688_cov_33.898132	426	506	9	22	80	0.2750000
NODE_17551_length_688_cov_26.769100	457	537	7	31	80	0.3875000
NODE_17551_length_688_cov_26.769100	457	537	8	49	80	0.6125000
NODE_17551_length_688_cov_26.769100	510	590	1	22	80	0.2750000
NODE_17551_length_688_cov_26.769100	510	590	2	3	80	0.0375000
NODE_17551_length_688_cov_26.769100	510	590	3	15	80	0.1875000
NODE_17551_length_688_cov_26.769100	510	590	4	7	80	0.0875000
NODE_17551_length_688_cov_26.769100	510	590	6	2	80	0.0250000
NODE_17551_length_688_cov_26.769100	510	590	7	18	80	0.2250000
NODE_17551_length_688_cov_26.769100	510	590	8	13	80	0.1625000
NODE_17552_length_688_cov_22.517827	332	412	1	29	80	0.3625000
NODE_17552_length_688_cov_22.517827	332	412	3	9	80	0.1125000
NODE_17552_length_688_cov_22.517827	332	412	4	42	80	0.5250000
NODE_17552_length_688_cov_22.517827	385	465	0	32	80	0.4000000
NODE_17552_length_688_cov_22.517827	385	465	1	48	80	0.6000000
NODE_17553_length_688_cov_16.796265	225	305	0	80	80	1.0000000
NODE_17553_length_688_cov_16.796265	278	358	0	80	80	1.0000000
NODE_17555_length_688_cov_13.758913	378	458	5	33	80	0.4125000
NODE_17555_length_688_cov_13.758913	378	458	6	47	80	0.5875000
NODE_17555_length_688_cov_13.758913	431	511	2	18	80	0.2250000
NODE_17555_length_688_cov_13.758913	431	511	3	1	80	0.0125000
NODE_17555_length_688_cov_13.758913	431	511	4	21	80	0.2625000
NODE_17555_length_688_cov_13.758913	431	511	6	40	80	0.5000000
NODE_17556_length_688_cov_12.511036	330	410	0	52	80	0.6500000
NODE_17556_length_688_cov_12.511036	330	410	1	28	80	0.3500000
NODE_17556_length_688_cov_12.511036	383	463	1	80	80	1.0000000
NODE_17561_length_688_cov_5.446520	366	414	0	48	48	1.0000000
NODE_17567_length_688_cov_3.692699	265	345	4	7	80	0.0875000
NODE_17567_length_688_cov_3.692699	265	345	5	46	80	0.5750000
NODE_17567_length_688_cov_3.692699	265	345	6	27	80	0.3375000
NODE_17567_length_688_cov_3.692699	322	380	5	37	58	0.6379310
NODE_17567_length_688_cov_3.692699	322	380	6	21	58	0.3620690
NODE_17621_length_687_cov_50.214286	430	510	11	3	80	0.0375000
NODE_17621_length_687_cov_50.214286	430	510	12	13	80	0.1625000
NODE_17621_length_687_cov_50.214286	430	510	13	59	80	0.7375000
NODE_17621_length_687_cov_50.214286	430	510	14	5	80	0.0625000
NODE_17621_length_687_cov_50.214286	483	563	4	2	80	0.0250000
NODE_17621_length_687_cov_50.214286	483	563	5	7	80	0.0875000
NODE_17621_length_687_cov_50.214286	483	563	6	11	80	0.1375000
NODE_17621_length_687_cov_50.214286	483	563	7	2	80	0.0250000
NODE_17621_length_687_cov_50.214286	483	563	9	9	80	0.1125000
NODE_17621_length_687_cov_50.214286	483	563	11	7	80	0.0875000
NODE_17621_length_687_cov_50.214286	483	563	12	4	80	0.0500000
NODE_17621_length_687_cov_50.214286	483	563	13	35	80	0.4375000
NODE_17621_length_687_cov_50.214286	483	563	14	3	80	0.0375000
NODE_17622_length_687_cov_32.564626	204	284	5	1	80	0.0125000
NODE_17622_length_687_cov_32.564626	204	284	6	4	80	0.0500000
NODE_17622_length_687_cov_32.564626	204	284	7	4	80	0.0500000
NODE_17622_length_687_cov_32.564626	204	284	8	9	80	0.1125000
NODE_17622_length_687_cov_32.564626	204	284	9	7	80	0.0875000
NODE_17622_length_687_cov_32.564626	204	284	10	5	80	0.0625000
NODE_17622_length_687_cov_32.564626	204	284	11	18	80	0.2250000
NODE_17622_length_687_cov_32.564626	204	284	12	13	80	0.1625000
NODE_17622_length_687_cov_32.564626	204	284	13	19	80	0.2375000
NODE_17622_length_687_cov_32.564626	257	337	8	3	80	0.0375000
NODE_17622_length_687_cov_32.564626	257	337	9	23	80	0.2875000
NODE_17622_length_687_cov_32.564626	257	337	11	45	80	0.5625000
NODE_17622_length_687_cov_32.564626	257	337	13	9	80	0.1125000
NODE_17623_length_687_cov_22.365646	231	311	3	12	80	0.1500000
NODE_17623_length_687_cov_22.365646	231	311	4	68	80	0.8500000
NODE_17623_length_687_cov_22.365646	284	364	1	10	80	0.1250000
NODE_17623_length_687_cov_22.365646	284	364	2	24	80	0.3000000
NODE_17623_length_687_cov_22.365646	284	364	3	27	80	0.3375000
NODE_17623_length_687_cov_22.365646	284	364	4	19	80	0.2375000
NODE_17626_length_687_cov_11.943878	233	313	1	25	80	0.3125000
NODE_17626_length_687_cov_11.943878	233	313	3	3	80	0.0375000
NODE_17626_length_687_cov_11.943878	233	313	5	8	80	0.1000000
NODE_17626_length_687_cov_11.943878	233	313	6	3	80	0.0375000
NODE_17626_length_687_cov_11.943878	233	313	7	41	80	0.5125000
NODE_17626_length_687_cov_11.943878	286	366	5	2	80	0.0250000
NODE_17626_length_687_cov_11.943878	286	366	7	49	80	0.6125000
NODE_17626_length_687_cov_11.943878	286	366	8	21	80	0.2625000
NODE_17626_length_687_cov_11.943878	286	366	9	8	80	0.1000000
NODE_17627_length_687_cov_7.865646	311	391	3	80	80	1.0000000
NODE_17627_length_687_cov_7.865646	364	444	1	14	80	0.1750000
NODE_17627_length_687_cov_7.865646	364	444	3	54	80	0.6750000
NODE_17627_length_687_cov_7.865646	364	444	4	12	80	0.1500000
NODE_17628_length_687_cov_7.353741	286	366	2	80	80	1.0000000
NODE_17628_length_687_cov_7.353741	339	419	2	52	80	0.6500000
NODE_17628_length_687_cov_7.353741	339	419	3	28	80	0.3500000
NODE_17631_length_687_cov_5.903061	369	449	0	80	80	1.0000000
NODE_17631_length_687_cov_5.903061	422	502	0	80	80	1.0000000
NODE_17695_length_686_cov_34.642249	355	440	6	7	85	0.0823529
NODE_17695_length_686_cov_34.642249	355	440	7	3	85	0.0352941
NODE_17695_length_686_cov_34.642249	355	440	8	46	85	0.5411765
NODE_17695_length_686_cov_34.642249	355	440	9	22	85	0.2588235
NODE_17695_length_686_cov_34.642249	355	440	10	7	85	0.0823529
NODE_17695_length_686_cov_34.642249	413	493	4	17	80	0.2125000
NODE_17695_length_686_cov_34.642249	413	493	6	19	80	0.2375000
NODE_17695_length_686_cov_34.642249	413	493	8	44	80	0.5500000
NODE_17697_length_686_cov_26.357751	413	493	5	14	80	0.1750000
NODE_17697_length_686_cov_26.357751	413	493	6	14	80	0.1750000
NODE_17697_length_686_cov_26.357751	413	493	7	15	80	0.1875000
NODE_17697_length_686_cov_26.357751	413	493	8	3	80	0.0375000
NODE_17697_length_686_cov_26.357751	413	493	9	9	80	0.1125000
NODE_17697_length_686_cov_26.357751	413	493	10	25	80	0.3125000
NODE_17697_length_686_cov_26.357751	466	546	6	5	80	0.0625000
NODE_17697_length_686_cov_26.357751	466	546	7	11	80	0.1375000
NODE_17697_length_686_cov_26.357751	466	546	8	38	80	0.4750000
NODE_17697_length_686_cov_26.357751	466	546	9	1	80	0.0125000
NODE_17697_length_686_cov_26.357751	466	546	10	25	80	0.3125000
NODE_17698_length_686_cov_16.715503	400	480	0	80	80	1.0000000
NODE_17698_length_686_cov_16.715503	453	533	0	80	80	1.0000000
NODE_17757_length_685_cov_8.769625	178	258	0	8	80	0.1000000
NODE_17757_length_685_cov_8.769625	178	258	2	72	80	0.9000000
NODE_17757_length_685_cov_8.769625	222	250	2	28	28	1.0000000
NODE_17757_length_685_cov_8.769625	231	311	0	61	80	0.7625000
NODE_17757_length_685_cov_8.769625	231	311	2	19	80	0.2375000
NODE_17764_length_685_cov_4.447099	249	329	1	27	80	0.3375000
NODE_17764_length_685_cov_4.447099	249	329	2	47	80	0.5875000
NODE_17764_length_685_cov_4.447099	249	329	3	6	80	0.0750000
NODE_17764_length_685_cov_4.447099	302	382	2	64	80	0.8000000
NODE_17764_length_685_cov_4.447099	302	382	3	16	80	0.2000000
NODE_17768_length_685_cov_3.556314	338	418	0	53	80	0.6625000
NODE_17768_length_685_cov_3.556314	338	418	1	27	80	0.3375000
NODE_17768_length_685_cov_3.556314	391	471	1	80	80	1.0000000
NODE_17821_length_684_cov_7.521368	189	269	0	23	80	0.2875000
NODE_17821_length_684_cov_7.521368	189	269	2	57	80	0.7125000
NODE_17821_length_684_cov_7.521368	242	322	2	80	80	1.0000000
NODE_17832_length_684_cov_3.639316	306	386	3	30	80	0.3750000
NODE_17832_length_684_cov_3.639316	306	386	4	24	80	0.3000000
NODE_17832_length_684_cov_3.639316	306	386	5	1	80	0.0125000
NODE_17832_length_684_cov_3.639316	306	386	6	25	80	0.3125000
NODE_17832_length_684_cov_3.639316	359	439	0	18	80	0.2250000
NODE_17832_length_684_cov_3.639316	359	439	2	34	80	0.4250000
NODE_17832_length_684_cov_3.639316	359	439	3	28	80	0.3500000
NODE_17866_length_683_cov_27.493151	346	426	1	42	80	0.5250000
NODE_17866_length_683_cov_27.493151	346	426	2	24	80	0.3000000
NODE_17866_length_683_cov_27.493151	346	426	3	14	80	0.1750000
NODE_17866_length_683_cov_27.493151	399	479	2	13	80	0.1625000
NODE_17866_length_683_cov_27.493151	399	479	3	15	80	0.1875000
NODE_17866_length_683_cov_27.493151	399	479	4	52	80	0.6500000
NODE_17867_length_683_cov_12.880137	242	321	1	20	79	0.2531646
NODE_17867_length_683_cov_12.880137	242	321	2	59	79	0.7468355
NODE_17868_length_683_cov_11.772260	218	274	1	56	56	1.0000000
NODE_17868_length_683_cov_11.772260	247	333	1	76	86	0.8837209
NODE_17868_length_683_cov_11.772260	247	333	3	10	86	0.1162791
NODE_17869_length_683_cov_9.936644	435	515	2	31	80	0.3875000
NODE_17869_length_683_cov_9.936644	435	515	3	11	80	0.1375000
NODE_17869_length_683_cov_9.936644	435	515	4	38	80	0.4750000
NODE_17869_length_683_cov_9.936644	488	568	1	13	80	0.1625000
NODE_17869_length_683_cov_9.936644	488	568	2	67	80	0.8375000
NODE_17871_length_683_cov_9.017123	296	364	5	68	68	1.0000000
NODE_17871_length_683_cov_9.017123	337	417	1	19	80	0.2375000
NODE_17871_length_683_cov_9.017123	337	417	3	5	80	0.0625000
NODE_17871_length_683_cov_9.017123	337	417	5	56	80	0.7000000
NODE_17873_length_683_cov_6.797945	359	415	2	56	56	1.0000000
NODE_17884_length_683_cov_3.176370	113	186	0	73	73	1.0000000
NODE_17947_length_682_cov_33.516295	423	503	7	18	80	0.2250000
NODE_17947_length_682_cov_33.516295	423	503	8	47	80	0.5875000
NODE_17947_length_682_cov_33.516295	423	503	9	9	80	0.1125000
NODE_17947_length_682_cov_33.516295	423	503	10	6	80	0.0750000
NODE_17947_length_682_cov_33.516295	476	556	4	18	80	0.2250000
NODE_17947_length_682_cov_33.516295	476	556	6	29	80	0.3625000
NODE_17947_length_682_cov_33.516295	476	556	7	24	80	0.3000000
NODE_17947_length_682_cov_33.516295	476	556	9	9	80	0.1125000
NODE_17948_length_682_cov_27.022298	479	559	2	71	80	0.8875000
NODE_17948_length_682_cov_27.022298	479	559	4	9	80	0.1125000
NODE_17948_length_682_cov_27.022298	532	612	2	20	80	0.2500000
NODE_17948_length_682_cov_27.022298	532	612	3	2	80	0.0250000
NODE_17948_length_682_cov_27.022298	532	612	4	58	80	0.7250000
NODE_17949_length_682_cov_19.612350	434	514	11	14	80	0.1750000
NODE_17949_length_682_cov_19.612350	434	514	12	5	80	0.0625000
NODE_17949_length_682_cov_19.612350	434	514	13	17	80	0.2125000
NODE_17949_length_682_cov_19.612350	434	514	15	44	80	0.5500000
NODE_17949_length_682_cov_19.612350	487	567	2	23	80	0.2875000
NODE_17949_length_682_cov_19.612350	487	567	3	8	80	0.1000000
NODE_17949_length_682_cov_19.612350	487	567	4	4	80	0.0500000
NODE_17949_length_682_cov_19.612350	487	567	5	7	80	0.0875000
NODE_17949_length_682_cov_19.612350	487	567	8	2	80	0.0250000
NODE_17949_length_682_cov_19.612350	487	567	10	5	80	0.0625000
NODE_17949_length_682_cov_19.612350	487	567	11	18	80	0.2250000
NODE_17949_length_682_cov_19.612350	487	567	13	13	80	0.1625000
NODE_17950_length_682_cov_16.620926	261	341	3	80	80	1.0000000
NODE_17950_length_682_cov_16.620926	314	394	0	21	80	0.2625000
NODE_17950_length_682_cov_16.620926	314	394	1	31	80	0.3875000
NODE_17950_length_682_cov_16.620926	314	394	3	28	80	0.3500000
NODE_17951_length_682_cov_13.735849	251	331	0	80	80	1.0000000
NODE_17951_length_682_cov_13.735849	304	384	0	80	80	1.0000000
NODE_17952_length_682_cov_12.835334	228	308	4	53	80	0.6625000
NODE_17952_length_682_cov_12.835334	228	308	5	1	80	0.0125000
NODE_17952_length_682_cov_12.835334	228	308	6	26	80	0.3250000
NODE_17952_length_682_cov_12.835334	281	361	3	45	80	0.5625000
NODE_17952_length_682_cov_12.835334	281	361	4	20	80	0.2500000
NODE_17952_length_682_cov_12.835334	281	361	5	1	80	0.0125000
NODE_17952_length_682_cov_12.835334	281	361	6	14	80	0.1750000
NODE_17956_length_682_cov_7.504288	224	304	0	57	80	0.7125000
NODE_17956_length_682_cov_7.504288	224	304	2	23	80	0.2875000
NODE_17956_length_682_cov_7.504288	277	357	0	4	80	0.0500000
NODE_17956_length_682_cov_7.504288	277	357	2	45	80	0.5625000
NODE_17956_length_682_cov_7.504288	277	357	3	31	80	0.3875000
NODE_17960_length_682_cov_5.102916	314	351	0	37	37	1.0000000
NODE_17963_length_682_cov_4.579760	152	232	0	37	80	0.4625000
NODE_17963_length_682_cov_4.579760	152	232	2	43	80	0.5375000
NODE_17963_length_682_cov_4.579760	205	285	2	80	80	1.0000000
NODE_17967_length_682_cov_4.006861	317	397	0	80	80	1.0000000
NODE_17967_length_682_cov_4.006861	370	450	0	80	80	1.0000000
NODE_17968_length_682_cov_3.859348	160	240	0	80	80	1.0000000
NODE_17968_length_682_cov_3.859348	213	293	0	80	80	1.0000000
NODE_18010_length_681_cov_51.810997	181	261	10	4	80	0.0500000
NODE_18010_length_681_cov_51.810997	181	261	11	15	80	0.1875000
NODE_18010_length_681_cov_51.810997	181	261	12	18	80	0.2250000
NODE_18010_length_681_cov_51.810997	181	261	13	43	80	0.5375000
NODE_18010_length_681_cov_51.810997	234	316	8	6	82	0.0731707
NODE_18010_length_681_cov_51.810997	234	316	9	18	82	0.2195122
NODE_18010_length_681_cov_51.810997	234	316	11	12	82	0.1463415
NODE_18010_length_681_cov_51.810997	234	316	12	5	82	0.0609756
NODE_18010_length_681_cov_51.810997	234	316	13	30	82	0.3658537
NODE_18010_length_681_cov_51.810997	234	316	14	11	82	0.1341463
NODE_18011_length_681_cov_32.128866	347	427	1	17	80	0.2125000
NODE_18011_length_681_cov_32.128866	347	427	2	24	80	0.3000000
NODE_18011_length_681_cov_32.128866	347	427	3	1	80	0.0125000
NODE_18011_length_681_cov_32.128866	347	427	7	12	80	0.1500000
NODE_18011_length_681_cov_32.128866	347	427	8	26	80	0.3250000
NODE_18011_length_681_cov_32.128866	400	475	7	59	75	0.7866667
NODE_18011_length_681_cov_32.128866	400	475	8	16	75	0.2133333
NODE_18012_length_681_cov_19.079038	282	362	4	10	80	0.1250000
NODE_18012_length_681_cov_19.079038	282	362	6	6	80	0.0750000
NODE_18012_length_681_cov_19.079038	282	362	7	12	80	0.1500000
NODE_18012_length_681_cov_19.079038	282	362	9	1	80	0.0125000
NODE_18012_length_681_cov_19.079038	282	362	11	27	80	0.3375000
NODE_18012_length_681_cov_19.079038	282	362	12	10	80	0.1250000
NODE_18012_length_681_cov_19.079038	282	362	13	3	80	0.0375000
NODE_18012_length_681_cov_19.079038	282	362	15	11	80	0.1375000
NODE_18012_length_681_cov_19.079038	335	415	10	8	80	0.1000000
NODE_18012_length_681_cov_19.079038	335	415	11	14	80	0.1750000
NODE_18012_length_681_cov_19.079038	335	415	12	10	80	0.1250000
NODE_18012_length_681_cov_19.079038	335	415	13	20	80	0.2500000
NODE_18012_length_681_cov_19.079038	335	415	15	28	80	0.3500000
NODE_18013_length_681_cov_17.053265	294	374	0	80	80	1.0000000
NODE_18013_length_681_cov_17.053265	347	427	0	80	80	1.0000000
NODE_18014_length_681_cov_11.183849	306	386	1	5	80	0.0625000
NODE_18014_length_681_cov_11.183849	306	386	2	48	80	0.6000000
NODE_18014_length_681_cov_11.183849	306	386	3	27	80	0.3375000
NODE_18014_length_681_cov_11.183849	359	439	1	58	80	0.7250000
NODE_18014_length_681_cov_11.183849	359	439	3	22	80	0.2750000
NODE_18015_length_681_cov_8.065292	236	316	0	80	80	1.0000000
NODE_18015_length_681_cov_8.065292	289	369	0	80	80	1.0000000
NODE_18017_length_681_cov_6.888316	344	424	0	17	80	0.2125000
NODE_18017_length_681_cov_6.888316	344	424	1	63	80	0.7875000
NODE_18017_length_681_cov_6.888316	397	477	0	17	80	0.2125000
NODE_18017_length_681_cov_6.888316	397	477	1	63	80	0.7875000
NODE_18080_length_680_cov_35.695353	348	428	3	15	80	0.1875000
NODE_18080_length_680_cov_35.695353	348	428	4	13	80	0.1625000
NODE_18080_length_680_cov_35.695353	348	428	5	2	80	0.0250000
NODE_18080_length_680_cov_35.695353	348	428	7	4	80	0.0500000
NODE_18080_length_680_cov_35.695353	348	428	8	4	80	0.0500000
NODE_18080_length_680_cov_35.695353	348	428	9	19	80	0.2375000
NODE_18080_length_680_cov_35.695353	348	428	10	22	80	0.2750000
NODE_18080_length_680_cov_35.695353	348	428	11	1	80	0.0125000
NODE_18080_length_680_cov_35.695353	401	481	7	5	80	0.0625000
NODE_18080_length_680_cov_35.695353	401	481	8	4	80	0.0500000
NODE_18080_length_680_cov_35.695353	401	481	9	4	80	0.0500000
NODE_18080_length_680_cov_35.695353	401	481	10	57	80	0.7125000
NODE_18080_length_680_cov_35.695353	401	481	11	10	80	0.1250000
NODE_18081_length_680_cov_17.500861	296	376	0	80	80	1.0000000
NODE_18081_length_680_cov_17.500861	349	429	0	80	80	1.0000000
NODE_18082_length_680_cov_16.685026	260	340	2	4	80	0.0500000
NODE_18082_length_680_cov_16.685026	260	340	3	3	80	0.0375000
NODE_18082_length_680_cov_16.685026	260	340	4	6	80	0.0750000
NODE_18082_length_680_cov_16.685026	260	340	5	6	80	0.0750000
NODE_18082_length_680_cov_16.685026	260	340	7	11	80	0.1375000
NODE_18082_length_680_cov_16.685026	260	340	8	29	80	0.3625000
NODE_18082_length_680_cov_16.685026	260	340	10	21	80	0.2625000
NODE_18082_length_680_cov_16.685026	313	393	8	18	80	0.2250000
NODE_18082_length_680_cov_16.685026	313	393	9	4	80	0.0500000
NODE_18082_length_680_cov_16.685026	313	393	10	35	80	0.4375000
NODE_18082_length_680_cov_16.685026	313	393	11	23	80	0.2875000
NODE_18083_length_680_cov_15.345955	332	412	3	2	80	0.0250000
NODE_18083_length_680_cov_15.345955	332	412	4	10	80	0.1250000
NODE_18083_length_680_cov_15.345955	332	412	5	54	80	0.6750000
NODE_18083_length_680_cov_15.345955	332	412	6	14	80	0.1750000
NODE_18083_length_680_cov_15.345955	385	465	4	1	80	0.0125000
NODE_18083_length_680_cov_15.345955	385	465	5	12	80	0.1500000
NODE_18083_length_680_cov_15.345955	385	465	6	30	80	0.3750000
NODE_18083_length_680_cov_15.345955	385	465	7	24	80	0.3000000
NODE_18083_length_680_cov_15.345955	385	465	8	13	80	0.1625000
NODE_18089_length_680_cov_3.858864	458	538	0	80	80	1.0000000
NODE_18107_length_680_cov_1.879518	236	256	0	20	20	1.0000000
NODE_18146_length_679_cov_52.046552	367	447	11	7	80	0.0875000
NODE_18146_length_679_cov_52.046552	367	447	12	21	80	0.2625000
NODE_18146_length_679_cov_52.046552	367	447	14	31	80	0.3875000
NODE_18146_length_679_cov_52.046552	367	447	15	21	80	0.2625000
NODE_18146_length_679_cov_52.046552	420	500	3	7	80	0.0875000
NODE_18146_length_679_cov_52.046552	420	500	5	3	80	0.0375000
NODE_18146_length_679_cov_52.046552	420	500	7	7	80	0.0875000
NODE_18146_length_679_cov_52.046552	420	500	8	15	80	0.1875000
NODE_18146_length_679_cov_52.046552	420	500	9	2	80	0.0250000
NODE_18146_length_679_cov_52.046552	420	500	11	10	80	0.1250000
NODE_18146_length_679_cov_52.046552	420	500	12	10	80	0.1250000
NODE_18146_length_679_cov_52.046552	420	500	13	9	80	0.1125000
NODE_18146_length_679_cov_52.046552	420	500	14	17	80	0.2125000
NODE_18147_length_679_cov_40.353448	179	259	3	40	80	0.5000000
NODE_18147_length_679_cov_40.353448	179	259	4	23	80	0.2875000
NODE_18147_length_679_cov_40.353448	179	259	5	17	80	0.2125000
NODE_18147_length_679_cov_40.353448	232	312	3	33	80	0.4125000
NODE_18147_length_679_cov_40.353448	232	312	4	43	80	0.5375000
NODE_18147_length_679_cov_40.353448	232	312	5	4	80	0.0500000
NODE_18148_length_679_cov_38.144828	364	428	3	39	64	0.6093750
NODE_18148_length_679_cov_38.144828	364	428	4	7	64	0.1093750
NODE_18148_length_679_cov_38.144828	364	428	5	18	64	0.2812500
NODE_18148_length_679_cov_38.144828	401	481	2	5	80	0.0625000
NODE_18148_length_679_cov_38.144828	401	481	3	30	80	0.3750000
NODE_18148_length_679_cov_38.144828	401	481	4	27	80	0.3375000
NODE_18148_length_679_cov_38.144828	401	481	5	18	80	0.2250000
NODE_18149_length_679_cov_17.134483	277	357	3	48	80	0.6000000
NODE_18149_length_679_cov_17.134483	277	357	5	10	80	0.1250000
NODE_18149_length_679_cov_17.134483	277	357	6	22	80	0.2750000
NODE_18149_length_679_cov_17.134483	330	410	0	13	80	0.1625000
NODE_18149_length_679_cov_17.134483	330	410	1	14	80	0.1750000
NODE_18149_length_679_cov_17.134483	330	410	3	53	80	0.6625000
NODE_18150_length_679_cov_15.046552	310	375	0	65	65	1.0000000
NODE_18151_length_679_cov_12.586207	247	327	0	57	80	0.7125000
NODE_18151_length_679_cov_12.586207	247	327	1	23	80	0.2875000
NODE_18151_length_679_cov_12.586207	303	381	0	1	78	0.0128205
NODE_18151_length_679_cov_12.586207	303	381	1	77	78	0.9871795
NODE_18152_length_679_cov_12.282759	337	417	0	57	80	0.7125000
NODE_18152_length_679_cov_12.282759	337	417	2	23	80	0.2875000
NODE_18152_length_679_cov_12.282759	390	470	0	4	80	0.0500000
NODE_18152_length_679_cov_12.282759	390	470	2	76	80	0.9500000
NODE_18153_length_679_cov_11.532759	205	285	0	80	80	1.0000000
NODE_18153_length_679_cov_11.532759	258	338	0	80	80	1.0000000
NODE_18155_length_679_cov_8.043103	269	341	0	72	72	1.0000000
NODE_18155_length_679_cov_8.043103	314	394	0	80	80	1.0000000
NODE_18156_length_679_cov_7.267241	191	271	2	17	80	0.2125000
NODE_18156_length_679_cov_7.267241	191	271	3	33	80	0.4125000
NODE_18156_length_679_cov_7.267241	191	271	4	1	80	0.0125000
NODE_18156_length_679_cov_7.267241	191	271	5	14	80	0.1750000
NODE_18156_length_679_cov_7.267241	191	271	7	15	80	0.1875000
NODE_18156_length_679_cov_7.267241	244	324	5	12	80	0.1500000
NODE_18156_length_679_cov_7.267241	244	324	7	68	80	0.8500000
NODE_18162_length_679_cov_5.391379	279	331	1	52	52	1.0000000
NODE_18164_length_679_cov_3.813793	10	69	2	54	59	0.9152542
NODE_18164_length_679_cov_3.813793	10	69	4	5	59	0.0847458
NODE_18164_length_679_cov_3.813793	48	122	2	18	74	0.2432432
NODE_18164_length_679_cov_3.813793	48	122	4	56	74	0.7567568
NODE_18217_length_678_cov_38.910190	252	332	5	6	80	0.0750000
NODE_18217_length_678_cov_38.910190	252	332	9	28	80	0.3500000
NODE_18217_length_678_cov_38.910190	252	332	10	46	80	0.5750000
NODE_18217_length_678_cov_38.910190	305	385	4	22	80	0.2750000
NODE_18217_length_678_cov_38.910190	305	385	5	36	80	0.4500000
NODE_18217_length_678_cov_38.910190	305	385	6	1	80	0.0125000
NODE_18217_length_678_cov_38.910190	305	385	9	4	80	0.0500000
NODE_18217_length_678_cov_38.910190	305	385	10	17	80	0.2125000
NODE_18217_length_678_cov_38.910190	381	461	3	33	80	0.4125000
NODE_18217_length_678_cov_38.910190	381	461	4	47	80	0.5875000
NODE_18217_length_678_cov_38.910190	434	514	3	17	80	0.2125000
NODE_18217_length_678_cov_38.910190	434	514	4	63	80	0.7875000
NODE_18218_length_678_cov_20.663212	243	323	9	13	80	0.1625000
NODE_18218_length_678_cov_20.663212	243	323	11	7	80	0.0875000
NODE_18218_length_678_cov_20.663212	243	323	12	5	80	0.0625000
NODE_18218_length_678_cov_20.663212	243	323	13	9	80	0.1125000
NODE_18218_length_678_cov_20.663212	243	323	14	20	80	0.2500000
NODE_18218_length_678_cov_20.663212	243	323	15	26	80	0.3250000
NODE_18218_length_678_cov_20.663212	296	376	9	15	80	0.1875000
NODE_18218_length_678_cov_20.663212	296	376	10	3	80	0.0375000
NODE_18218_length_678_cov_20.663212	296	376	11	5	80	0.0625000
NODE_18218_length_678_cov_20.663212	296	376	12	16	80	0.2000000
NODE_18218_length_678_cov_20.663212	296	376	13	19	80	0.2375000
NODE_18218_length_678_cov_20.663212	296	376	15	22	80	0.2750000
NODE_18219_length_678_cov_12.081174	243	323	0	80	80	1.0000000
NODE_18219_length_678_cov_12.081174	296	376	0	80	80	1.0000000
NODE_18224_length_678_cov_6.559585	195	264	0	63	69	0.9130435
NODE_18224_length_678_cov_6.559585	195	264	1	6	69	0.0869565
NODE_18224_length_678_cov_6.559585	237	317	0	21	80	0.2625000
NODE_18224_length_678_cov_6.559585	237	317	1	59	80	0.7375000
NODE_18228_length_678_cov_4.462867	133	213	0	47	80	0.5875000
NODE_18228_length_678_cov_4.462867	133	213	1	14	80	0.1750000
NODE_18228_length_678_cov_4.462867	133	213	3	19	80	0.2375000
NODE_18228_length_678_cov_4.462867	186	266	1	8	80	0.1000000
NODE_18228_length_678_cov_4.462867	186	266	3	25	80	0.3125000
NODE_18228_length_678_cov_4.462867	186	266	4	29	80	0.3625000
NODE_18228_length_678_cov_4.462867	186	266	5	18	80	0.2250000
NODE_18239_length_678_cov_2.716753	351	431	5	37	80	0.4625000
NODE_18239_length_678_cov_2.716753	351	431	6	5	80	0.0625000
NODE_18239_length_678_cov_2.716753	351	431	7	38	80	0.4750000
NODE_18239_length_678_cov_2.716753	404	484	3	11	80	0.1375000
NODE_18239_length_678_cov_2.716753	404	484	4	4	80	0.0500000
NODE_18239_length_678_cov_2.716753	404	484	5	65	80	0.8125000
NODE_18289_length_677_cov_22.235294	274	354	0	80	80	1.0000000
NODE_18289_length_677_cov_22.235294	327	407	0	80	80	1.0000000
NODE_18290_length_677_cov_16.410035	124	206	2	82	82	1.0000000
NODE_18290_length_677_cov_16.410035	177	261	0	16	84	0.1904762
NODE_18290_length_677_cov_16.410035	177	261	1	37	84	0.4404762
NODE_18290_length_677_cov_16.410035	177	261	2	31	84	0.3690476
NODE_18291_length_677_cov_11.031142	393	473	0	53	80	0.6625000
NODE_18291_length_677_cov_11.031142	393	473	1	27	80	0.3375000
NODE_18291_length_677_cov_11.031142	446	526	1	80	80	1.0000000
NODE_18292_length_677_cov_10.129758	258	338	2	80	80	1.0000000
NODE_18292_length_677_cov_10.129758	311	391	0	21	80	0.2625000
NODE_18292_length_677_cov_10.129758	311	391	2	59	80	0.7375000
NODE_18295_length_677_cov_6.660900	217	297	2	80	80	1.0000000
NODE_18297_length_677_cov_5.228374	366	446	0	80	80	1.0000000
NODE_18312_length_677_cov_2.306228	230	278	1	25	48	0.5208333
NODE_18312_length_677_cov_2.306228	230	278	2	22	48	0.4583333
NODE_18312_length_677_cov_2.306228	230	278	4	1	48	0.0208333
NODE_18329_length_677_cov_1.709343	369	449	0	24	80	0.3000000
NODE_18329_length_677_cov_1.709343	369	449	1	30	80	0.3750000
NODE_18329_length_677_cov_1.709343	369	449	2	26	80	0.3250000
NODE_18329_length_677_cov_1.709343	422	502	0	1	80	0.0125000
NODE_18329_length_677_cov_1.709343	422	502	2	79	80	0.9875000
NODE_18368_length_676_cov_66.473137	286	366	0	80	80	1.0000000
NODE_18368_length_676_cov_66.473137	339	419	0	43	80	0.5375000
NODE_18368_length_676_cov_66.473137	339	419	1	4	80	0.0500000
NODE_18368_length_676_cov_66.473137	339	419	2	1	80	0.0125000
NODE_18368_length_676_cov_66.473137	339	419	3	4	80	0.0500000
NODE_18368_length_676_cov_66.473137	339	419	4	1	80	0.0125000
NODE_18368_length_676_cov_66.473137	339	419	5	11	80	0.1375000
NODE_18368_length_676_cov_66.473137	339	419	6	9	80	0.1125000
NODE_18368_length_676_cov_66.473137	339	419	7	7	80	0.0875000
NODE_18368_length_676_cov_66.473137	383	419	1	3	36	0.0833333
NODE_18368_length_676_cov_66.473137	383	419	2	1	36	0.0277778
NODE_18368_length_676_cov_66.473137	383	419	3	4	36	0.1111111
NODE_18368_length_676_cov_66.473137	383	419	4	1	36	0.0277778
NODE_18368_length_676_cov_66.473137	383	419	5	11	36	0.3055556
NODE_18368_length_676_cov_66.473137	383	419	6	9	36	0.2500000
NODE_18368_length_676_cov_66.473137	383	419	7	7	36	0.1944444
NODE_18368_length_676_cov_66.473137	383	419	1	3	36	0.0833333
NODE_18368_length_676_cov_66.473137	383	419	2	1	36	0.0277778
NODE_18368_length_676_cov_66.473137	383	419	3	4	36	0.1111111
NODE_18368_length_676_cov_66.473137	383	419	4	1	36	0.0277778
NODE_18368_length_676_cov_66.473137	383	419	5	11	36	0.3055556
NODE_18368_length_676_cov_66.473137	383	419	6	9	36	0.2500000
NODE_18368_length_676_cov_66.473137	383	419	7	7	36	0.1944444
NODE_18368_length_676_cov_66.473137	398	419	5	5	21	0.2380952
NODE_18368_length_676_cov_66.473137	398	419	6	9	21	0.4285714
NODE_18368_length_676_cov_66.473137	398	419	7	7	21	0.3333333
NODE_18369_length_676_cov_14.429809	259	330	0	71	71	1.0000000
NODE_18370_length_676_cov_13.882149	292	372	0	12	80	0.1500000
NODE_18370_length_676_cov_13.882149	292	372	1	48	80	0.6000000
NODE_18370_length_676_cov_13.882149	292	372	2	20	80	0.2500000
NODE_18370_length_676_cov_13.882149	345	425	1	7	80	0.0875000
NODE_18370_length_676_cov_13.882149	345	425	2	73	80	0.9125000
NODE_18374_length_676_cov_7.225303	363	443	0	80	80	1.0000000
NODE_18374_length_676_cov_7.225303	416	496	0	80	80	1.0000000
NODE_18375_length_676_cov_6.740035	373	433	0	32	60	0.5333334
NODE_18375_length_676_cov_6.740035	373	433	1	28	60	0.4666667
NODE_18375_length_676_cov_6.740035	406	486	1	42	80	0.5250000
NODE_18375_length_676_cov_6.740035	406	486	3	11	80	0.1375000
NODE_18375_length_676_cov_6.740035	406	486	4	27	80	0.3375000
NODE_18378_length_676_cov_4.658579	167	240	0	73	73	1.0000000
NODE_18397_length_676_cov_2.292894	146	226	2	6	80	0.0750000
NODE_18397_length_676_cov_2.292894	146	226	3	29	80	0.3625000
NODE_18397_length_676_cov_2.292894	146	226	4	11	80	0.1375000
NODE_18397_length_676_cov_2.292894	146	226	5	34	80	0.4250000
NODE_18401_length_676_cov_2.157712	175	226	0	51	51	1.0000000
NODE_18417_length_676_cov_1.547660	133	164	0	31	31	1.0000000
NODE_18447_length_675_cov_27.574653	190	270	2	3	80	0.0375000
NODE_18447_length_675_cov_27.574653	190	270	3	8	80	0.1000000
NODE_18447_length_675_cov_27.574653	190	270	5	8	80	0.1000000
NODE_18447_length_675_cov_27.574653	190	270	7	13	80	0.1625000
NODE_18447_length_675_cov_27.574653	190	270	9	32	80	0.4000000
NODE_18447_length_675_cov_27.574653	190	270	10	16	80	0.2000000
NODE_18447_length_675_cov_27.574653	243	323	4	19	80	0.2375000
NODE_18447_length_675_cov_27.574653	243	323	5	8	80	0.1000000
NODE_18447_length_675_cov_27.574653	243	323	7	3	80	0.0375000
NODE_18447_length_675_cov_27.574653	243	323	8	3	80	0.0375000
NODE_18447_length_675_cov_27.574653	243	323	9	11	80	0.1375000
NODE_18447_length_675_cov_27.574653	243	323	10	36	80	0.4500000
NODE_18448_length_675_cov_11.895833	336	416	0	15	80	0.1875000
NODE_18448_length_675_cov_11.895833	336	416	2	31	80	0.3875000
NODE_18448_length_675_cov_11.895833	336	416	3	34	80	0.4250000
NODE_18448_length_675_cov_11.895833	389	469	1	3	80	0.0375000
NODE_18448_length_675_cov_11.895833	389	469	2	4	80	0.0500000
NODE_18448_length_675_cov_11.895833	389	469	3	73	80	0.9125000
NODE_18449_length_675_cov_8.157986	414	494	0	80	80	1.0000000
NODE_18449_length_675_cov_8.157986	467	547	0	80	80	1.0000000
NODE_18450_length_675_cov_8.026042	320	400	0	2	80	0.0250000
NODE_18450_length_675_cov_8.026042	320	400	1	24	80	0.3000000
NODE_18450_length_675_cov_8.026042	320	400	2	54	80	0.6750000
NODE_18450_length_675_cov_8.026042	373	453	0	55	80	0.6875000
NODE_18450_length_675_cov_8.026042	373	453	1	24	80	0.3000000
NODE_18450_length_675_cov_8.026042	373	453	2	1	80	0.0125000
NODE_18451_length_675_cov_7.277778	317	397	0	80	80	1.0000000
NODE_18455_length_675_cov_5.666667	142	222	1	19	80	0.2375000
NODE_18455_length_675_cov_5.666667	142	222	2	9	80	0.1125000
NODE_18455_length_675_cov_5.666667	142	222	3	52	80	0.6500000
NODE_18455_length_675_cov_5.666667	195	275	1	72	80	0.9000000
NODE_18455_length_675_cov_5.666667	195	275	3	8	80	0.1000000
NODE_18464_length_675_cov_2.751736	67	122	0	55	55	1.0000000
NODE_18467_length_675_cov_2.623264	251	289	0	38	38	1.0000000
NODE_18467_length_675_cov_2.623264	279	343	0	64	64	1.0000000
NODE_18467_length_675_cov_2.623264	432	494	0	62	62	1.0000000
NODE_18515_length_674_cov_38.401739	225	305	8	16	80	0.2000000
NODE_18515_length_674_cov_38.401739	225	305	9	19	80	0.2375000
NODE_18515_length_674_cov_38.401739	225	305	10	18	80	0.2250000
NODE_18515_length_674_cov_38.401739	225	305	11	20	80	0.2500000
NODE_18515_length_674_cov_38.401739	225	305	12	7	80	0.0875000
NODE_18515_length_674_cov_38.401739	278	358	5	20	80	0.2500000
NODE_18515_length_674_cov_38.401739	278	358	6	16	80	0.2000000
NODE_18515_length_674_cov_38.401739	278	358	8	4	80	0.0500000
NODE_18515_length_674_cov_38.401739	278	358	9	3	80	0.0375000
NODE_18515_length_674_cov_38.401739	278	358	11	29	80	0.3625000
NODE_18515_length_674_cov_38.401739	278	358	12	8	80	0.1000000
NODE_18516_length_674_cov_30.215652	519	599	4	16	80	0.2000000
NODE_18516_length_674_cov_30.215652	519	599	6	64	80	0.8000000
NODE_18516_length_674_cov_30.215652	572	602	6	30	30	1.0000000
NODE_18517_length_674_cov_19.636522	283	363	1	4	80	0.0500000
NODE_18517_length_674_cov_19.636522	283	363	2	18	80	0.2250000
NODE_18517_length_674_cov_19.636522	283	363	3	8	80	0.1000000
NODE_18517_length_674_cov_19.636522	283	363	5	8	80	0.1000000
NODE_18517_length_674_cov_19.636522	283	363	6	35	80	0.4375000
NODE_18517_length_674_cov_19.636522	283	363	7	7	80	0.0875000
NODE_18517_length_674_cov_19.636522	336	416	6	20	80	0.2500000
NODE_18517_length_674_cov_19.636522	336	416	7	60	80	0.7500000
NODE_18518_length_674_cov_19.436522	81	161	2	15	80	0.1875000
NODE_18518_length_674_cov_19.436522	81	161	3	21	80	0.2625000
NODE_18518_length_674_cov_19.436522	81	161	5	15	80	0.1875000
NODE_18518_length_674_cov_19.436522	81	161	7	8	80	0.1000000
NODE_18518_length_674_cov_19.436522	81	161	8	21	80	0.2625000
NODE_18518_length_674_cov_19.436522	134	214	7	12	80	0.1500000
NODE_18518_length_674_cov_19.436522	134	214	8	35	80	0.4375000
NODE_18518_length_674_cov_19.436522	134	214	9	7	80	0.0875000
NODE_18518_length_674_cov_19.436522	134	214	10	26	80	0.3250000
NODE_18519_length_674_cov_16.819130	185	265	2	80	80	1.0000000
NODE_18519_length_674_cov_16.819130	238	318	0	31	80	0.3875000
NODE_18519_length_674_cov_16.819130	238	318	2	49	80	0.6125000
NODE_18520_length_674_cov_14.733913	169	249	4	37	80	0.4625000
NODE_18520_length_674_cov_14.733913	169	249	6	11	80	0.1375000
NODE_18520_length_674_cov_14.733913	169	249	8	32	80	0.4000000
NODE_18520_length_674_cov_14.733913	222	302	4	6	80	0.0750000
NODE_18520_length_674_cov_14.733913	222	302	6	46	80	0.5750000
NODE_18520_length_674_cov_14.733913	222	302	8	28	80	0.3500000
NODE_18524_length_674_cov_7.086957	357	437	0	15	80	0.1875000
NODE_18524_length_674_cov_7.086957	357	437	2	16	80	0.2000000
NODE_18524_length_674_cov_7.086957	357	437	3	6	80	0.0750000
NODE_18524_length_674_cov_7.086957	357	437	4	43	80	0.5375000
NODE_18524_length_674_cov_7.086957	410	490	2	38	80	0.4750000
NODE_18524_length_674_cov_7.086957	410	490	4	42	80	0.5250000
NODE_18528_length_674_cov_4.808696	262	342	0	80	80	1.0000000
NODE_18528_length_674_cov_4.808696	315	395	0	80	80	1.0000000
NODE_18592_length_673_cov_47.109756	405	485	6	2	80	0.0250000
NODE_18592_length_673_cov_47.109756	405	485	7	7	80	0.0875000
NODE_18592_length_673_cov_47.109756	405	485	8	49	80	0.6125000
NODE_18592_length_673_cov_47.109756	405	485	10	22	80	0.2750000
NODE_18592_length_673_cov_47.109756	458	538	2	11	80	0.1375000
NODE_18592_length_673_cov_47.109756	458	538	4	7	80	0.0875000
NODE_18592_length_673_cov_47.109756	458	538	5	27	80	0.3375000
NODE_18592_length_673_cov_47.109756	458	538	7	15	80	0.1875000
NODE_18592_length_673_cov_47.109756	458	538	8	13	80	0.1625000
NODE_18592_length_673_cov_47.109756	458	538	10	7	80	0.0875000
NODE_18593_length_673_cov_20.548780	214	294	2	25	80	0.3125000
NODE_18593_length_673_cov_20.548780	214	294	3	36	80	0.4500000
NODE_18593_length_673_cov_20.548780	214	294	5	19	80	0.2375000
NODE_18593_length_673_cov_20.548780	267	347	2	2	80	0.0250000
NODE_18593_length_673_cov_20.548780	267	347	3	8	80	0.1000000
NODE_18593_length_673_cov_20.548780	267	347	4	21	80	0.2625000
NODE_18593_length_673_cov_20.548780	267	347	5	49	80	0.6125000
NODE_18596_length_673_cov_8.306620	337	426	0	7	89	0.0786517
NODE_18596_length_673_cov_8.306620	337	426	1	41	89	0.4606742
NODE_18596_length_673_cov_8.306620	337	426	2	41	89	0.4606742
NODE_18607_length_673_cov_3.041812	196	276	3	1	80	0.0125000
NODE_18607_length_673_cov_3.041812	196	276	4	30	80	0.3750000
NODE_18607_length_673_cov_3.041812	196	276	6	49	80	0.6125000
NODE_18607_length_673_cov_3.041812	249	329	1	7	80	0.0875000
NODE_18607_length_673_cov_3.041812	249	329	2	15	80	0.1875000
NODE_18607_length_673_cov_3.041812	249	329	3	32	80	0.4000000
NODE_18607_length_673_cov_3.041812	249	329	4	26	80	0.3250000
NODE_18660_length_672_cov_15.380454	282	362	1	65	80	0.8125000
NODE_18660_length_672_cov_15.380454	282	362	2	15	80	0.1875000
NODE_18660_length_672_cov_15.380454	335	415	0	29	80	0.3625000
NODE_18660_length_672_cov_15.380454	335	415	1	51	80	0.6375000
NODE_18661_length_672_cov_9.902269	328	408	2	7	80	0.0875000
NODE_18661_length_672_cov_9.902269	328	408	3	35	80	0.4375000
NODE_18661_length_672_cov_9.902269	328	408	4	38	80	0.4750000
NODE_18661_length_672_cov_9.902269	381	461	0	6	80	0.0750000
NODE_18661_length_672_cov_9.902269	381	461	1	19	80	0.2375000
NODE_18661_length_672_cov_9.902269	381	461	3	55	80	0.6875000
NODE_18662_length_672_cov_9.462478	309	389	2	80	80	1.0000000
NODE_18662_length_672_cov_9.462478	362	442	0	21	80	0.2625000
NODE_18662_length_672_cov_9.462478	362	442	1	30	80	0.3750000
NODE_18662_length_672_cov_9.462478	362	442	2	29	80	0.3625000
NODE_18666_length_672_cov_6.516579	354	434	3	12	80	0.1500000
NODE_18666_length_672_cov_6.516579	354	434	4	46	80	0.5750000
NODE_18666_length_672_cov_6.516579	354	434	5	22	80	0.2750000
NODE_18666_length_672_cov_6.516579	407	487	2	4	80	0.0500000
NODE_18666_length_672_cov_6.516579	407	487	3	7	80	0.0875000
NODE_18666_length_672_cov_6.516579	407	487	4	60	80	0.7500000
NODE_18666_length_672_cov_6.516579	407	487	5	9	80	0.1125000
NODE_18668_length_672_cov_6.108202	135	215	2	22	80	0.2750000
NODE_18668_length_672_cov_6.108202	135	215	4	58	80	0.7250000
NODE_18668_length_672_cov_6.108202	188	268	2	69	80	0.8625000
NODE_18668_length_672_cov_6.108202	188	268	4	11	80	0.1375000
NODE_18670_length_672_cov_4.949389	115	152	2	37	37	1.0000000
NODE_18670_length_672_cov_4.949389	125	205	1	1	80	0.0125000
NODE_18670_length_672_cov_4.949389	125	205	2	79	80	0.9875000
NODE_18670_length_672_cov_4.949389	278	326	0	48	48	1.0000000
NODE_18672_length_672_cov_4.753927	378	450	5	45	72	0.6250000
NODE_18672_length_672_cov_4.753927	378	450	6	27	72	0.3750000
NODE_18704_length_672_cov_1.713787	340	401	0	61	61	1.0000000
NODE_18742_length_671_cov_28.874126	306	387	3	28	81	0.3456790
NODE_18742_length_671_cov_28.874126	306	387	4	53	81	0.6543210
NODE_18742_length_671_cov_28.874126	360	440	1	4	80	0.0500000
NODE_18742_length_671_cov_28.874126	360	440	2	18	80	0.2250000
NODE_18742_length_671_cov_28.874126	360	440	3	58	80	0.7250000
NODE_18744_length_671_cov_18.526224	294	333	1	39	39	1.0000000
NODE_18744_length_671_cov_18.526224	331	404	1	56	73	0.7671233
NODE_18744_length_671_cov_18.526224	331	404	2	17	73	0.2328767
NODE_18744_length_671_cov_18.526224	331	351	1	20	20	1.0000000
NODE_18745_length_671_cov_16.094406	417	497	2	13	80	0.1625000
NODE_18745_length_671_cov_16.094406	417	497	3	12	80	0.1500000
NODE_18745_length_671_cov_16.094406	417	497	5	7	80	0.0875000
NODE_18745_length_671_cov_16.094406	417	497	7	10	80	0.1250000
NODE_18745_length_671_cov_16.094406	417	497	9	17	80	0.2125000
NODE_18745_length_671_cov_16.094406	417	497	10	17	80	0.2125000
NODE_18745_length_671_cov_16.094406	417	497	12	4	80	0.0500000
NODE_18745_length_671_cov_16.094406	470	550	8	38	80	0.4750000
NODE_18745_length_671_cov_16.094406	470	550	9	6	80	0.0750000
NODE_18745_length_671_cov_16.094406	470	550	10	17	80	0.2125000
NODE_18745_length_671_cov_16.094406	470	550	12	19	80	0.2375000
NODE_18746_length_671_cov_11.756993	337	417	2	31	80	0.3875000
NODE_18746_length_671_cov_11.756993	337	417	3	42	80	0.5250000
NODE_18746_length_671_cov_11.756993	337	417	4	7	80	0.0875000
NODE_18746_length_671_cov_11.756993	390	470	2	80	80	1.0000000
NODE_18747_length_671_cov_9.237762	305	382	0	77	77	1.0000000
NODE_18748_length_671_cov_8.491259	298	379	1	32	81	0.3950617
NODE_18748_length_671_cov_8.491259	298	379	2	49	81	0.6049383
NODE_18748_length_671_cov_8.491259	352	430	0	46	78	0.5897436
NODE_18748_length_671_cov_8.491259	352	430	1	32	78	0.4102564
NODE_18749_length_671_cov_8.241259	97	128	0	31	31	1.0000000
NODE_18752_length_671_cov_7.201049	368	448	3	32	80	0.4000000
NODE_18752_length_671_cov_7.201049	368	448	4	48	80	0.6000000
NODE_18752_length_671_cov_7.201049	421	501	0	17	80	0.2125000
NODE_18752_length_671_cov_7.201049	421	501	2	23	80	0.2875000
NODE_18752_length_671_cov_7.201049	421	501	3	40	80	0.5000000
NODE_18753_length_671_cov_5.680070	370	450	4	14	80	0.1750000
NODE_18753_length_671_cov_5.680070	370	450	5	66	80	0.8250000
NODE_18753_length_671_cov_5.680070	423	503	0	21	80	0.2625000
NODE_18753_length_671_cov_5.680070	423	503	1	3	80	0.0375000
NODE_18753_length_671_cov_5.680070	423	503	3	11	80	0.1375000
NODE_18753_length_671_cov_5.680070	423	503	4	32	80	0.4000000
NODE_18753_length_671_cov_5.680070	423	503	5	13	80	0.1625000
NODE_18754_length_671_cov_4.769231	362	414	6	24	52	0.4615385
NODE_18754_length_671_cov_4.769231	362	414	7	28	52	0.5384616
NODE_18760_length_671_cov_3.804196	360	440	0	5	80	0.0625000
NODE_18760_length_671_cov_3.804196	360	440	2	41	80	0.5125000
NODE_18760_length_671_cov_3.804196	360	440	4	18	80	0.2250000
NODE_18760_length_671_cov_3.804196	360	440	6	16	80	0.2000000
NODE_18812_length_670_cov_21.017513	443	523	3	11	80	0.1375000
NODE_18812_length_670_cov_21.017513	443	523	4	41	80	0.5125000
NODE_18812_length_670_cov_21.017513	443	523	6	28	80	0.3500000
NODE_18812_length_670_cov_21.017513	496	576	4	21	80	0.2625000
NODE_18812_length_670_cov_21.017513	496	576	6	59	80	0.7375000
NODE_18813_length_670_cov_20.346760	372	452	3	18	80	0.2250000
NODE_18813_length_670_cov_20.346760	372	452	4	18	80	0.2250000
NODE_18813_length_670_cov_20.346760	372	452	5	44	80	0.5500000
NODE_18813_length_670_cov_20.346760	425	505	1	28	80	0.3500000
NODE_18813_length_670_cov_20.346760	425	505	3	43	80	0.5375000
NODE_18813_length_670_cov_20.346760	425	505	4	6	80	0.0750000
NODE_18813_length_670_cov_20.346760	425	505	5	3	80	0.0375000
NODE_18814_length_670_cov_15.728546	157	237	0	80	80	1.0000000
NODE_18814_length_670_cov_15.728546	210	290	0	61	80	0.7625000
NODE_18814_length_670_cov_15.728546	210	290	1	19	80	0.2375000
NODE_18814_length_670_cov_15.728546	286	366	1	15	80	0.1875000
NODE_18814_length_670_cov_15.728546	286	366	2	65	80	0.8125000
NODE_18814_length_670_cov_15.728546	339	419	2	80	80	1.0000000
NODE_18818_length_670_cov_6.499124	390	470	0	78	80	0.9750000
NODE_18818_length_670_cov_6.499124	390	470	1	2	80	0.0250000
NODE_18834_length_670_cov_3.099825	159	217	1	25	58	0.4310345
NODE_18834_length_670_cov_3.099825	159	217	2	14	58	0.2413793
NODE_18834_length_670_cov_3.099825	159	217	4	19	58	0.3275862
NODE_18838_length_670_cov_2.700525	252	332	0	80	80	1.0000000
NODE_18838_length_670_cov_2.700525	305	385	0	80	80	1.0000000
NODE_18883_length_669_cov_13.307018	432	512	7	8	80	0.1000000
NODE_18883_length_669_cov_13.307018	432	512	9	3	80	0.0375000
NODE_18883_length_669_cov_13.307018	432	512	10	8	80	0.1000000
NODE_18883_length_669_cov_13.307018	432	512	11	11	80	0.1375000
NODE_18883_length_669_cov_13.307018	432	512	13	50	80	0.6250000
NODE_18883_length_669_cov_13.307018	485	565	5	1	80	0.0125000
NODE_18883_length_669_cov_13.307018	485	565	7	11	80	0.1375000
NODE_18883_length_669_cov_13.307018	485	565	8	5	80	0.0625000
NODE_18883_length_669_cov_13.307018	485	565	10	11	80	0.1375000
NODE_18883_length_669_cov_13.307018	485	565	11	2	80	0.0250000
NODE_18883_length_669_cov_13.307018	485	565	13	50	80	0.6250000
NODE_18886_length_669_cov_6.921053	245	325	4	62	80	0.7750000
NODE_18886_length_669_cov_6.921053	245	325	6	18	80	0.2250000
NODE_18886_length_669_cov_6.921053	298	370	2	22	72	0.3055556
NODE_18886_length_669_cov_6.921053	298	370	3	1	72	0.0138889
NODE_18886_length_669_cov_6.921053	298	370	4	49	72	0.6805556
NODE_18901_length_669_cov_3.633333	277	347	0	9	70	0.1285714
NODE_18901_length_669_cov_3.633333	277	347	1	8	70	0.1142857
NODE_18901_length_669_cov_3.633333	277	347	3	53	70	0.7571428
NODE_18909_length_669_cov_2.361404	434	490	0	56	56	1.0000000
NODE_18958_length_668_cov_23.131810	275	355	0	67	80	0.8375000
NODE_18958_length_668_cov_23.131810	275	355	1	13	80	0.1625000
NODE_18958_length_668_cov_23.131810	328	408	0	80	80	1.0000000
NODE_18959_length_668_cov_14.978910	324	404	1	10	80	0.1250000
NODE_18959_length_668_cov_14.978910	324	404	3	48	80	0.6000000
NODE_18959_length_668_cov_14.978910	324	404	4	22	80	0.2750000
NODE_18959_length_668_cov_14.978910	377	457	3	39	80	0.4875000
NODE_18959_length_668_cov_14.978910	377	457	4	41	80	0.5125000
NODE_18962_length_668_cov_11.184534	187	267	0	80	80	1.0000000
NODE_18962_length_668_cov_11.184534	240	320	0	80	80	1.0000000
NODE_18963_length_668_cov_10.548330	211	291	0	80	80	1.0000000
NODE_18963_length_668_cov_10.548330	264	344	0	80	80	1.0000000
NODE_18964_length_668_cov_10.370826	226	308	0	30	82	0.3658537
NODE_18964_length_668_cov_10.370826	226	308	2	52	82	0.6341463
NODE_18964_length_668_cov_10.370826	279	361	2	82	82	1.0000000
NODE_18965_length_668_cov_10.223199	238	318	0	11	80	0.1375000
NODE_18965_length_668_cov_10.223199	238	318	1	22	80	0.2750000
NODE_18965_length_668_cov_10.223199	238	318	2	47	80	0.5875000
NODE_18965_length_668_cov_10.223199	291	371	2	80	80	1.0000000
NODE_18967_length_668_cov_9.340949	310	390	0	24	80	0.3000000
NODE_18967_length_668_cov_9.340949	310	390	2	34	80	0.4250000
NODE_18967_length_668_cov_9.340949	310	390	4	22	80	0.2750000
NODE_18967_length_668_cov_9.340949	363	443	2	5	80	0.0625000
NODE_18967_length_668_cov_9.340949	363	443	4	75	80	0.9375000
NODE_18975_length_668_cov_4.077329	304	384	2	80	80	1.0000000
NODE_18975_length_668_cov_4.077329	338	367	2	29	29	1.0000000
NODE_18975_length_668_cov_4.077329	358	427	2	69	69	1.0000000
NODE_19032_length_667_cov_33.848592	168	248	0	40	80	0.5000000
NODE_19032_length_667_cov_33.848592	168	248	2	40	80	0.5000000
NODE_19032_length_667_cov_33.848592	221	301	2	51	80	0.6375000
NODE_19032_length_667_cov_33.848592	221	301	4	29	80	0.3625000
NODE_19033_length_667_cov_21.218310	270	350	3	8	80	0.1000000
NODE_19033_length_667_cov_21.218310	270	350	4	44	80	0.5500000
NODE_19033_length_667_cov_21.218310	270	350	6	6	80	0.0750000
NODE_19033_length_667_cov_21.218310	270	350	7	2	80	0.0250000
NODE_19033_length_667_cov_21.218310	270	350	8	20	80	0.2500000
NODE_19033_length_667_cov_21.218310	323	403	6	5	80	0.0625000
NODE_19033_length_667_cov_21.218310	323	403	7	2	80	0.0250000
NODE_19033_length_667_cov_21.218310	323	403	8	33	80	0.4125000
NODE_19033_length_667_cov_21.218310	323	403	9	30	80	0.3750000
NODE_19033_length_667_cov_21.218310	323	403	10	10	80	0.1250000
NODE_19034_length_667_cov_19.204225	258	338	4	80	80	1.0000000
NODE_19034_length_667_cov_19.204225	311	391	1	17	80	0.2125000
NODE_19034_length_667_cov_19.204225	311	391	2	9	80	0.1125000
NODE_19034_length_667_cov_19.204225	311	391	3	13	80	0.1625000
NODE_19034_length_667_cov_19.204225	311	391	4	41	80	0.5125000
NODE_19036_length_667_cov_8.264085	299	379	2	77	80	0.9625000
NODE_19036_length_667_cov_8.264085	299	379	4	3	80	0.0375000
NODE_19036_length_667_cov_8.264085	352	432	0	34	80	0.4250000
NODE_19036_length_667_cov_8.264085	352	432	1	11	80	0.1375000
NODE_19036_length_667_cov_8.264085	352	432	2	35	80	0.4375000
NODE_19037_length_667_cov_8.248239	76	156	2	80	80	1.0000000
NODE_19037_length_667_cov_8.248239	129	209	0	35	80	0.4375000
NODE_19037_length_667_cov_8.248239	129	209	2	45	80	0.5625000
NODE_19038_length_667_cov_8.207746	257	323	5	25	66	0.3787879
NODE_19038_length_667_cov_8.207746	257	323	6	17	66	0.2575758
NODE_19038_length_667_cov_8.207746	257	323	7	4	66	0.0606061
NODE_19038_length_667_cov_8.207746	257	323	8	20	66	0.3030303
NODE_19038_length_667_cov_8.207746	296	376	4	11	80	0.1375000
NODE_19038_length_667_cov_8.207746	296	376	5	49	80	0.6125000
NODE_19038_length_667_cov_8.207746	296	376	6	12	80	0.1500000
NODE_19038_length_667_cov_8.207746	296	376	7	8	80	0.1000000
NODE_19039_length_667_cov_7.232394	357	437	1	22	80	0.2750000
NODE_19039_length_667_cov_7.232394	357	437	2	58	80	0.7250000
NODE_19039_length_667_cov_7.232394	410	490	1	15	80	0.1875000
NODE_19039_length_667_cov_7.232394	410	490	2	65	80	0.8125000
NODE_19042_length_667_cov_4.941901	199	279	0	26	80	0.3250000
NODE_19042_length_667_cov_4.941901	199	279	1	16	80	0.2000000
NODE_19042_length_667_cov_4.941901	199	279	2	38	80	0.4750000
NODE_19042_length_667_cov_4.941901	252	332	2	39	80	0.4875000
NODE_19042_length_667_cov_4.941901	252	332	3	21	80	0.2625000
NODE_19042_length_667_cov_4.941901	252	332	4	20	80	0.2500000
NODE_19053_length_667_cov_3.404930	501	536	0	35	35	1.0000000
NODE_19053_length_667_cov_3.404930	503	533	0	30	30	1.0000000
NODE_19100_length_666_cov_24.811287	179	254	0	75	75	1.0000000
NODE_19100_length_666_cov_24.811287	182	254	0	72	72	1.0000000
NODE_19100_length_666_cov_24.811287	227	307	0	80	80	1.0000000
NODE_19100_length_666_cov_24.811287	227	307	0	80	80	1.0000000
NODE_19100_length_666_cov_24.811287	303	383	0	52	80	0.6500000
NODE_19100_length_666_cov_24.811287	303	383	2	28	80	0.3500000
NODE_19100_length_666_cov_24.811287	356	436	2	80	80	1.0000000
NODE_19102_length_666_cov_20.114638	172	252	1	10	80	0.1250000
NODE_19102_length_666_cov_20.114638	172	252	2	33	80	0.4125000
NODE_19102_length_666_cov_20.114638	172	252	3	37	80	0.4625000
NODE_19102_length_666_cov_20.114638	225	305	0	25	80	0.3125000
NODE_19102_length_666_cov_20.114638	225	305	1	2	80	0.0250000
NODE_19102_length_666_cov_20.114638	225	305	2	53	80	0.6625000
NODE_19103_length_666_cov_16.813051	220	286	2	7	66	0.1060606
NODE_19103_length_666_cov_16.813051	220	286	3	59	66	0.8939394
NODE_19103_length_666_cov_16.813051	259	344	2	2	85	0.0235294
NODE_19103_length_666_cov_16.813051	259	344	3	83	85	0.9764706
NODE_19104_length_666_cov_15.384480	306	386	2	5	80	0.0625000
NODE_19104_length_666_cov_15.384480	306	386	3	75	80	0.9375000
NODE_19104_length_666_cov_15.384480	359	439	0	19	80	0.2375000
NODE_19104_length_666_cov_15.384480	359	439	1	33	80	0.4125000
NODE_19104_length_666_cov_15.384480	359	439	2	6	80	0.0750000
NODE_19104_length_666_cov_15.384480	359	439	3	22	80	0.2750000
NODE_19105_length_666_cov_14.195767	485	565	3	3	80	0.0375000
NODE_19105_length_666_cov_14.195767	485	565	4	77	80	0.9625000
NODE_19105_length_666_cov_14.195767	538	618	1	13	80	0.1625000
NODE_19105_length_666_cov_14.195767	538	618	3	9	80	0.1125000
NODE_19105_length_666_cov_14.195767	538	618	4	58	80	0.7250000
NODE_19108_length_666_cov_7.770723	226	306	0	80	80	1.0000000
NODE_19108_length_666_cov_7.770723	279	359	0	80	80	1.0000000
NODE_19163_length_665_cov_28.786219	391	471	3	14	80	0.1750000
NODE_19163_length_665_cov_28.786219	391	471	4	21	80	0.2625000
NODE_19163_length_665_cov_28.786219	391	471	8	19	80	0.2375000
NODE_19163_length_665_cov_28.786219	391	471	9	26	80	0.3250000
NODE_19163_length_665_cov_28.786219	444	524	5	19	80	0.2375000
NODE_19163_length_665_cov_28.786219	444	524	8	1	80	0.0125000
NODE_19163_length_665_cov_28.786219	444	524	9	60	80	0.7500000
NODE_19164_length_665_cov_21.740283	311	391	3	80	80	1.0000000
NODE_19164_length_665_cov_21.740283	364	444	1	42	80	0.5250000
NODE_19164_length_665_cov_21.740283	364	444	3	38	80	0.4750000
NODE_19165_length_665_cov_15.904594	390	470	1	29	80	0.3625000
NODE_19165_length_665_cov_15.904594	390	470	2	41	80	0.5125000
NODE_19165_length_665_cov_15.904594	390	470	3	10	80	0.1250000
NODE_19165_length_665_cov_15.904594	443	523	2	17	80	0.2125000
NODE_19165_length_665_cov_15.904594	443	523	3	57	80	0.7125000
NODE_19165_length_665_cov_15.904594	443	523	4	6	80	0.0750000
NODE_19224_length_664_cov_27.208850	259	339	0	58	80	0.7250000
NODE_19224_length_664_cov_27.208850	259	339	2	22	80	0.2750000
NODE_19224_length_664_cov_27.208850	345	404	0	59	59	1.0000000
NODE_19225_length_664_cov_16.116814	241	321	0	80	80	1.0000000
NODE_19225_length_664_cov_16.116814	294	374	0	80	80	1.0000000
NODE_19227_length_664_cov_14.185841	332	412	6	9	80	0.1125000
NODE_19227_length_664_cov_14.185841	332	412	8	4	80	0.0500000
NODE_19227_length_664_cov_14.185841	332	412	9	17	80	0.2125000
NODE_19227_length_664_cov_14.185841	332	412	10	27	80	0.3375000
NODE_19227_length_664_cov_14.185841	332	412	11	23	80	0.2875000
NODE_19227_length_664_cov_14.185841	385	465	7	12	80	0.1500000
NODE_19227_length_664_cov_14.185841	385	465	8	21	80	0.2625000
NODE_19227_length_664_cov_14.185841	385	465	9	37	80	0.4625000
NODE_19227_length_664_cov_14.185841	385	465	11	10	80	0.1250000
NODE_19228_length_664_cov_12.256637	325	405	3	6	80	0.0750000
NODE_19228_length_664_cov_12.256637	325	405	4	29	80	0.3625000
NODE_19228_length_664_cov_12.256637	325	405	5	45	80	0.5625000
NODE_19228_length_664_cov_12.256637	378	454	1	45	76	0.5921053
NODE_19228_length_664_cov_12.256637	378	454	3	10	76	0.1315790
NODE_19228_length_664_cov_12.256637	378	454	5	21	76	0.2763158
NODE_19229_length_664_cov_8.378761	252	332	2	56	80	0.7000000
NODE_19229_length_664_cov_8.378761	252	332	3	24	80	0.3000000
NODE_19229_length_664_cov_8.378761	305	385	2	19	80	0.2375000
NODE_19229_length_664_cov_8.378761	305	385	3	61	80	0.7625000
NODE_19229_length_664_cov_8.378761	381	461	1	3	80	0.0375000
NODE_19229_length_664_cov_8.378761	381	461	2	77	80	0.9625000
NODE_19229_length_664_cov_8.378761	434	514	1	56	80	0.7000000
NODE_19229_length_664_cov_8.378761	434	514	2	24	80	0.3000000
NODE_19254_length_664_cov_1.922124	393	434	0	41	41	1.0000000
NODE_19298_length_663_cov_26.601064	398	478	3	5	80	0.0625000
NODE_19298_length_663_cov_26.601064	398	478	5	5	80	0.0625000
NODE_19298_length_663_cov_26.601064	398	478	8	70	80	0.8750000
NODE_19298_length_663_cov_26.601064	451	531	1	6	80	0.0750000
NODE_19298_length_663_cov_26.601064	451	531	2	20	80	0.2500000
NODE_19298_length_663_cov_26.601064	451	531	4	16	80	0.2000000
NODE_19298_length_663_cov_26.601064	451	531	6	4	80	0.0500000
NODE_19298_length_663_cov_26.601064	451	531	8	34	80	0.4250000
NODE_19299_length_663_cov_16.948582	368	448	2	9	80	0.1125000
NODE_19299_length_663_cov_16.948582	368	448	3	15	80	0.1875000
NODE_19299_length_663_cov_16.948582	368	448	4	56	80	0.7000000
NODE_19299_length_663_cov_16.948582	421	501	2	53	80	0.6625000
NODE_19299_length_663_cov_16.948582	421	501	3	9	80	0.1125000
NODE_19299_length_663_cov_16.948582	421	501	4	18	80	0.2250000
NODE_19300_length_663_cov_16.225177	118	198	3	2	80	0.0250000
NODE_19300_length_663_cov_16.225177	118	198	4	63	80	0.7875000
NODE_19300_length_663_cov_16.225177	118	198	5	12	80	0.1500000
NODE_19300_length_663_cov_16.225177	118	198	6	3	80	0.0375000
NODE_19300_length_663_cov_16.225177	171	251	3	2	80	0.0250000
NODE_19300_length_663_cov_16.225177	171	251	4	10	80	0.1250000
NODE_19300_length_663_cov_16.225177	171	251	5	12	80	0.1500000
NODE_19300_length_663_cov_16.225177	171	251	6	53	80	0.6625000
NODE_19300_length_663_cov_16.225177	171	251	7	3	80	0.0375000
NODE_19302_length_663_cov_13.748227	277	357	1	15	80	0.1875000
NODE_19302_length_663_cov_13.748227	277	357	2	6	80	0.0750000
NODE_19302_length_663_cov_13.748227	277	357	4	52	80	0.6500000
NODE_19302_length_663_cov_13.748227	277	357	5	7	80	0.0875000
NODE_19302_length_663_cov_13.748227	330	410	4	35	80	0.4375000
NODE_19302_length_663_cov_13.748227	330	410	5	45	80	0.5625000
NODE_19303_length_663_cov_10.377660	300	380	0	80	80	1.0000000
NODE_19304_length_663_cov_9.549645	199	279	0	80	80	1.0000000
NODE_19304_length_663_cov_9.549645	252	332	0	32	80	0.4000000
NODE_19304_length_663_cov_9.549645	252	332	4	48	80	0.6000000
NODE_19305_length_663_cov_7.397163	151	231	0	80	80	1.0000000
NODE_19305_length_663_cov_7.397163	204	284	0	80	80	1.0000000
NODE_19307_length_663_cov_5.081560	317	397	1	10	80	0.1250000
NODE_19307_length_663_cov_5.081560	317	397	2	70	80	0.8750000
NODE_19368_length_662_cov_29.218472	233	313	0	6	80	0.0750000
NODE_19368_length_662_cov_29.218472	233	313	1	28	80	0.3500000
NODE_19368_length_662_cov_29.218472	233	313	2	46	80	0.5750000
NODE_19368_length_662_cov_29.218472	286	366	2	80	80	1.0000000
NODE_19369_length_662_cov_18.717584	193	273	3	35	80	0.4375000
NODE_19369_length_662_cov_18.717584	193	273	4	40	80	0.5000000
NODE_19369_length_662_cov_18.717584	193	273	6	5	80	0.0625000
NODE_19369_length_662_cov_18.717584	246	326	3	12	80	0.1500000
NODE_19369_length_662_cov_18.717584	246	326	4	68	80	0.8500000
NODE_19370_length_662_cov_16.358792	258	338	2	80	80	1.0000000
NODE_19370_length_662_cov_16.358792	311	391	0	46	80	0.5750000
NODE_19370_length_662_cov_16.358792	311	391	2	34	80	0.4250000
NODE_19371_length_662_cov_12.845471	259	339	1	4	80	0.0500000
NODE_19371_length_662_cov_12.845471	259	339	2	17	80	0.2125000
NODE_19371_length_662_cov_12.845471	259	339	3	58	80	0.7250000
NODE_19371_length_662_cov_12.845471	259	339	4	1	80	0.0125000
NODE_19371_length_662_cov_12.845471	312	392	3	80	80	1.0000000
NODE_19372_length_662_cov_12.476021	299	379	3	8	80	0.1000000
NODE_19372_length_662_cov_12.476021	299	379	4	56	80	0.7000000
NODE_19372_length_662_cov_12.476021	299	379	5	6	80	0.0750000
NODE_19372_length_662_cov_12.476021	299	379	7	10	80	0.1250000
NODE_19372_length_662_cov_12.476021	352	432	3	8	80	0.1000000
NODE_19372_length_662_cov_12.476021	352	432	4	3	80	0.0375000
NODE_19372_length_662_cov_12.476021	352	432	5	59	80	0.7375000
NODE_19372_length_662_cov_12.476021	352	432	7	10	80	0.1250000
NODE_19373_length_662_cov_10.252220	239	319	0	13	80	0.1625000
NODE_19373_length_662_cov_10.252220	239	319	1	49	80	0.6125000
NODE_19373_length_662_cov_10.252220	239	319	2	18	80	0.2250000
NODE_19373_length_662_cov_10.252220	292	372	1	9	80	0.1125000
NODE_19373_length_662_cov_10.252220	292	372	2	71	80	0.8875000
NODE_19376_length_662_cov_6.335702	267	347	0	80	80	1.0000000
NODE_19376_length_662_cov_6.335702	320	400	0	80	80	1.0000000
NODE_19378_length_662_cov_5.738899	295	331	0	36	36	1.0000000
NODE_19378_length_662_cov_5.738899	301	322	0	21	21	1.0000000
NODE_19402_length_662_cov_1.905861	150	230	5	47	80	0.5875000
NODE_19402_length_662_cov_1.905861	150	230	6	26	80	0.3250000
NODE_19402_length_662_cov_1.905861	150	230	7	7	80	0.0875000
NODE_19402_length_662_cov_1.905861	203	277	3	14	74	0.1891892
NODE_19402_length_662_cov_1.905861	203	277	5	59	74	0.7972973
NODE_19402_length_662_cov_1.905861	203	277	6	1	74	0.0135135
NODE_19441_length_661_cov_55.176157	236	316	12	15	80	0.1875000
NODE_19441_length_661_cov_55.176157	236	316	14	38	80	0.4750000
NODE_19441_length_661_cov_55.176157	236	316	18	27	80	0.3375000
NODE_19441_length_661_cov_55.176157	289	369	8	24	80	0.3000000
NODE_19441_length_661_cov_55.176157	289	369	10	2	80	0.0250000
NODE_19441_length_661_cov_55.176157	289	369	12	2	80	0.0250000
NODE_19441_length_661_cov_55.176157	289	369	13	1	80	0.0125000
NODE_19441_length_661_cov_55.176157	289	369	14	2	80	0.0250000
NODE_19441_length_661_cov_55.176157	289	369	15	2	80	0.0250000
NODE_19441_length_661_cov_55.176157	289	369	16	3	80	0.0375000
NODE_19441_length_661_cov_55.176157	289	369	18	40	80	0.5000000
NODE_19441_length_661_cov_55.176157	289	369	19	4	80	0.0500000
NODE_19442_length_661_cov_38.501779	231	311	1	68	80	0.8500000
NODE_19442_length_661_cov_38.501779	231	311	2	12	80	0.1500000
NODE_19442_length_661_cov_38.501779	284	364	1	15	80	0.1875000
NODE_19442_length_661_cov_38.501779	284	364	2	52	80	0.6500000
NODE_19442_length_661_cov_38.501779	284	364	3	2	80	0.0250000
NODE_19442_length_661_cov_38.501779	284	364	4	11	80	0.1375000
NODE_19442_length_661_cov_38.501779	360	440	3	40	80	0.5000000
NODE_19442_length_661_cov_38.501779	360	440	4	40	80	0.5000000
NODE_19442_length_661_cov_38.501779	413	493	1	6	80	0.0750000
NODE_19442_length_661_cov_38.501779	413	493	3	38	80	0.4750000
NODE_19442_length_661_cov_38.501779	413	493	4	36	80	0.4500000
NODE_19443_length_661_cov_31.460854	128	208	1	80	80	1.0000000
NODE_19443_length_661_cov_31.460854	181	261	0	13	80	0.1625000
NODE_19443_length_661_cov_31.460854	181	261	1	67	80	0.8375000
NODE_19444_length_661_cov_18.960854	216	296	0	50	80	0.6250000
NODE_19444_length_661_cov_18.960854	216	296	2	30	80	0.3750000
NODE_19444_length_661_cov_18.960854	269	349	2	80	80	1.0000000
NODE_19445_length_661_cov_16.035587	201	281	1	19	80	0.2375000
NODE_19445_length_661_cov_16.035587	201	281	2	61	80	0.7625000
NODE_19445_length_661_cov_16.035587	254	334	2	80	80	1.0000000
NODE_19447_length_661_cov_13.005338	281	343	0	62	62	1.0000000
NODE_19447_length_661_cov_13.005338	353	433	0	80	80	1.0000000
NODE_19447_length_661_cov_13.005338	406	486	0	80	80	1.0000000
NODE_19452_length_661_cov_5.670819	374	454	0	17	80	0.2125000
NODE_19452_length_661_cov_5.670819	374	454	1	63	80	0.7875000
NODE_19452_length_661_cov_5.670819	427	507	1	80	80	1.0000000
NODE_19457_length_661_cov_4.601423	319	395	2	76	76	1.0000000
NODE_19459_length_661_cov_3.532028	282	362	0	78	80	0.9750000
NODE_19459_length_661_cov_3.532028	282	362	2	2	80	0.0250000
NODE_19459_length_661_cov_3.532028	335	415	0	25	80	0.3125000
NODE_19459_length_661_cov_3.532028	335	415	2	55	80	0.6875000
NODE_19515_length_660_cov_20.741533	343	423	3	4	80	0.0500000
NODE_19515_length_660_cov_20.741533	343	423	4	69	80	0.8625000
NODE_19515_length_660_cov_20.741533	343	423	5	7	80	0.0875000
NODE_19515_length_660_cov_20.741533	396	476	4	49	80	0.6125000
NODE_19515_length_660_cov_20.741533	396	476	5	31	80	0.3875000
NODE_19516_length_660_cov_15.089127	148	228	0	12	80	0.1500000
NODE_19516_length_660_cov_15.089127	148	228	2	1	80	0.0125000
NODE_19516_length_660_cov_15.089127	148	228	5	66	80	0.8250000
NODE_19516_length_660_cov_15.089127	148	228	7	1	80	0.0125000
NODE_19516_length_660_cov_15.089127	201	281	5	33	80	0.4125000
NODE_19516_length_660_cov_15.089127	201	281	7	47	80	0.5875000
NODE_19518_length_660_cov_13.301248	276	356	0	80	80	1.0000000
NODE_19518_length_660_cov_13.301248	329	409	0	80	80	1.0000000
NODE_19519_length_660_cov_12.393939	234	314	2	68	80	0.8500000
NODE_19519_length_660_cov_12.393939	234	314	3	5	80	0.0625000
NODE_19519_length_660_cov_12.393939	234	314	4	7	80	0.0875000
NODE_19519_length_660_cov_12.393939	287	367	0	33	80	0.4125000
NODE_19519_length_660_cov_12.393939	287	367	2	47	80	0.5875000
NODE_19521_length_660_cov_11.495544	399	479	2	1	80	0.0125000
NODE_19521_length_660_cov_11.495544	399	479	3	62	80	0.7750000
NODE_19521_length_660_cov_11.495544	399	479	4	17	80	0.2125000
NODE_19521_length_660_cov_11.495544	452	532	1	24	80	0.3000000
NODE_19521_length_660_cov_11.495544	452	532	2	30	80	0.3750000
NODE_19521_length_660_cov_11.495544	452	532	3	9	80	0.1125000
NODE_19521_length_660_cov_11.495544	452	532	4	17	80	0.2125000
NODE_19522_length_660_cov_10.522282	177	257	0	80	80	1.0000000
NODE_19522_length_660_cov_10.522282	230	311	0	81	81	1.0000000
NODE_19524_length_660_cov_8.887701	254	325	4	2	71	0.0281690
NODE_19524_length_660_cov_8.887701	254	325	6	44	71	0.6197183
NODE_19524_length_660_cov_8.887701	254	325	8	25	71	0.3521127
NODE_19527_length_660_cov_7.278075	225	305	3	46	80	0.5750000
NODE_19527_length_660_cov_7.278075	225	305	4	34	80	0.4250000
NODE_19527_length_660_cov_7.278075	278	358	1	19	80	0.2375000
NODE_19527_length_660_cov_7.278075	278	358	2	24	80	0.3000000
NODE_19527_length_660_cov_7.278075	278	358	4	37	80	0.4625000
NODE_19529_length_660_cov_6.577540	350	430	0	80	80	1.0000000
NODE_19529_length_660_cov_6.577540	403	483	0	80	80	1.0000000
NODE_19549_length_660_cov_2.354724	421	470	0	49	49	1.0000000
NODE_19594_length_659_cov_43.587500	2	82	0	80	80	1.0000000
NODE_19594_length_659_cov_43.587500	55	135	0	48	80	0.6000000
NODE_19594_length_659_cov_43.587500	55	135	6	23	80	0.2875000
NODE_19594_length_659_cov_43.587500	55	135	8	9	80	0.1125000
NODE_19594_length_659_cov_43.587500	131	211	8	80	80	1.0000000
NODE_19594_length_659_cov_43.587500	184	264	2	11	80	0.1375000
NODE_19594_length_659_cov_43.587500	184	264	5	1	80	0.0125000
NODE_19594_length_659_cov_43.587500	184	264	6	20	80	0.2500000
NODE_19594_length_659_cov_43.587500	184	264	8	48	80	0.6000000
NODE_19595_length_659_cov_23.330357	236	316	6	13	80	0.1625000
NODE_19595_length_659_cov_23.330357	236	316	8	27	80	0.3375000
NODE_19595_length_659_cov_23.330357	236	316	9	25	80	0.3125000
NODE_19595_length_659_cov_23.330357	236	316	10	5	80	0.0625000
NODE_19595_length_659_cov_23.330357	236	316	11	10	80	0.1250000
NODE_19595_length_659_cov_23.330357	289	369	7	2	80	0.0250000
NODE_19595_length_659_cov_23.330357	289	369	8	23	80	0.2875000
NODE_19595_length_659_cov_23.330357	289	369	9	12	80	0.1500000
NODE_19595_length_659_cov_23.330357	289	369	10	33	80	0.4125000
NODE_19595_length_659_cov_23.330357	289	369	11	10	80	0.1250000
NODE_19596_length_659_cov_12.775000	255	335	6	33	80	0.4125000
NODE_19596_length_659_cov_12.775000	255	335	8	10	80	0.1250000
NODE_19596_length_659_cov_12.775000	255	335	10	36	80	0.4500000
NODE_19596_length_659_cov_12.775000	255	335	11	1	80	0.0125000
NODE_19596_length_659_cov_12.775000	308	388	10	26	80	0.3250000
NODE_19596_length_659_cov_12.775000	308	388	11	54	80	0.6750000
NODE_19598_length_659_cov_9.683929	220	298	0	78	78	1.0000000
NODE_19598_length_659_cov_9.683929	271	351	0	80	80	1.0000000
NODE_19613_length_659_cov_3.658929	305	385	0	80	80	1.0000000
NODE_19613_length_659_cov_3.658929	358	438	0	80	80	1.0000000
NODE_19678_length_658_cov_38.479428	289	369	5	2	80	0.0250000
NODE_19678_length_658_cov_38.479428	289	369	6	11	80	0.1375000
NODE_19678_length_658_cov_38.479428	289	369	7	20	80	0.2500000
NODE_19678_length_658_cov_38.479428	289	369	8	7	80	0.0875000
NODE_19678_length_658_cov_38.479428	289	369	9	40	80	0.5000000
NODE_19678_length_658_cov_38.479428	342	422	1	1	80	0.0125000
NODE_19678_length_658_cov_38.479428	342	422	2	19	80	0.2375000
NODE_19678_length_658_cov_38.479428	342	422	4	21	80	0.2625000
NODE_19678_length_658_cov_38.479428	342	422	5	14	80	0.1750000
NODE_19678_length_658_cov_38.479428	342	422	6	11	80	0.1375000
NODE_19678_length_658_cov_38.479428	342	422	7	14	80	0.1750000
NODE_19679_length_658_cov_35.409660	242	322	5	26	80	0.3250000
NODE_19679_length_658_cov_35.409660	242	322	6	4	80	0.0500000
NODE_19679_length_658_cov_35.409660	242	322	8	13	80	0.1625000
NODE_19679_length_658_cov_35.409660	242	322	10	6	80	0.0750000
NODE_19679_length_658_cov_35.409660	242	322	11	4	80	0.0500000
NODE_19679_length_658_cov_35.409660	242	322	12	5	80	0.0625000
NODE_19679_length_658_cov_35.409660	242	322	13	10	80	0.1250000
NODE_19679_length_658_cov_35.409660	242	322	14	12	80	0.1500000
NODE_19679_length_658_cov_35.409660	295	375	10	7	80	0.0875000
NODE_19679_length_658_cov_35.409660	295	375	12	23	80	0.2875000
NODE_19679_length_658_cov_35.409660	295	375	13	10	80	0.1250000
NODE_19679_length_658_cov_35.409660	295	375	14	40	80	0.5000000
NODE_19680_length_658_cov_20.322004	191	271	0	2	80	0.0250000
NODE_19680_length_658_cov_20.322004	191	271	1	61	80	0.7625000
NODE_19680_length_658_cov_20.322004	191	271	2	16	80	0.2000000
NODE_19680_length_658_cov_20.322004	191	271	3	1	80	0.0125000
NODE_19680_length_658_cov_20.322004	244	321	0	4	77	0.0519481
NODE_19680_length_658_cov_20.322004	244	321	1	25	77	0.3246753
NODE_19680_length_658_cov_20.322004	244	321	2	10	77	0.1298701
NODE_19680_length_658_cov_20.322004	244	321	3	7	77	0.0909091
NODE_19680_length_658_cov_20.322004	244	321	4	6	77	0.0779221
NODE_19680_length_658_cov_20.322004	244	321	5	14	77	0.1818182
NODE_19680_length_658_cov_20.322004	244	321	7	2	77	0.0259740
NODE_19680_length_658_cov_20.322004	244	321	9	9	77	0.1168831
NODE_19680_length_658_cov_20.322004	317	397	7	36	80	0.4500000
NODE_19680_length_658_cov_20.322004	317	397	9	44	80	0.5500000
NODE_19680_length_658_cov_20.322004	370	449	2	7	79	0.0886076
NODE_19680_length_658_cov_20.322004	370	449	3	5	79	0.0632911
NODE_19680_length_658_cov_20.322004	370	449	4	7	79	0.0886076
NODE_19680_length_658_cov_20.322004	370	449	5	3	79	0.0379747
NODE_19680_length_658_cov_20.322004	370	449	7	57	79	0.7215190
NODE_19681_length_658_cov_11.352415	324	404	0	6	80	0.0750000
NODE_19681_length_658_cov_11.352415	324	404	2	32	80	0.4000000
NODE_19681_length_658_cov_11.352415	324	404	4	42	80	0.5250000
NODE_19681_length_658_cov_11.352415	377	457	0	19	80	0.2375000
NODE_19681_length_658_cov_11.352415	377	457	2	28	80	0.3500000
NODE_19681_length_658_cov_11.352415	377	457	4	33	80	0.4125000
NODE_19685_length_658_cov_8.241503	227	307	2	80	80	1.0000000
NODE_19685_length_658_cov_8.241503	280	360	1	14	80	0.1750000
NODE_19685_length_658_cov_8.241503	280	360	2	66	80	0.8250000
NODE_19689_length_658_cov_5.477639	450	530	0	80	80	1.0000000
NODE_19705_length_658_cov_2.277281	286	366	0	70	80	0.8750000
NODE_19705_length_658_cov_2.277281	286	366	2	10	80	0.1250000
NODE_19705_length_658_cov_2.277281	339	419	0	50	80	0.6250000
NODE_19705_length_658_cov_2.277281	339	419	1	11	80	0.1375000
NODE_19705_length_658_cov_2.277281	339	419	2	6	80	0.0750000
NODE_19705_length_658_cov_2.277281	339	419	3	13	80	0.1625000
NODE_19750_length_657_cov_71.087814	306	372	0	66	66	1.0000000
NODE_19750_length_657_cov_71.087814	382	462	0	80	80	1.0000000
NODE_19750_length_657_cov_71.087814	382	462	0	80	80	1.0000000
NODE_19750_length_657_cov_71.087814	435	515	0	80	80	1.0000000
NODE_19750_length_657_cov_71.087814	440	515	0	75	75	1.0000000
NODE_19751_length_657_cov_67.408602	98	178	2	21	80	0.2625000
NODE_19751_length_657_cov_67.408602	98	178	3	18	80	0.2250000
NODE_19751_length_657_cov_67.408602	98	178	5	27	80	0.3375000
NODE_19751_length_657_cov_67.408602	98	178	6	14	80	0.1750000
NODE_19751_length_657_cov_67.408602	151	231	3	29	80	0.3625000
NODE_19751_length_657_cov_67.408602	151	231	4	8	80	0.1000000
NODE_19751_length_657_cov_67.408602	151	231	5	29	80	0.3625000
NODE_19751_length_657_cov_67.408602	151	231	6	14	80	0.1750000
NODE_19752_length_657_cov_15.568100	265	345	0	80	80	1.0000000
NODE_19752_length_657_cov_15.568100	341	421	0	80	80	1.0000000
NODE_19759_length_657_cov_5.161290	185	256	4	1	71	0.0140845
NODE_19759_length_657_cov_5.161290	185	256	5	4	71	0.0563380
NODE_19759_length_657_cov_5.161290	185	256	6	66	71	0.9295775
NODE_19759_length_657_cov_5.161290	229	309	4	8	80	0.1000000
NODE_19759_length_657_cov_5.161290	229	309	5	7	80	0.0875000
NODE_19759_length_657_cov_5.161290	229	309	6	65	80	0.8125000
NODE_19824_length_656_cov_37.023339	470	550	8	4	80	0.0500000
NODE_19824_length_656_cov_37.023339	470	550	9	27	80	0.3375000
NODE_19824_length_656_cov_37.023339	470	550	10	9	80	0.1125000
NODE_19824_length_656_cov_37.023339	470	550	11	40	80	0.5000000
NODE_19824_length_656_cov_37.023339	523	603	2	4	80	0.0500000
NODE_19824_length_656_cov_37.023339	523	603	5	12	80	0.1500000
NODE_19824_length_656_cov_37.023339	523	603	6	10	80	0.1250000
NODE_19824_length_656_cov_37.023339	523	603	7	20	80	0.2500000
NODE_19824_length_656_cov_37.023339	523	603	8	11	80	0.1375000
NODE_19824_length_656_cov_37.023339	523	603	9	6	80	0.0750000
NODE_19824_length_656_cov_37.023339	523	603	10	9	80	0.1125000
NODE_19824_length_656_cov_37.023339	523	603	11	8	80	0.1000000
NODE_19825_length_656_cov_22.804309	173	253	1	22	80	0.2750000
NODE_19825_length_656_cov_22.804309	173	253	3	22	80	0.2750000
NODE_19825_length_656_cov_22.804309	173	253	4	17	80	0.2125000
NODE_19825_length_656_cov_22.804309	173	253	6	5	80	0.0625000
NODE_19825_length_656_cov_22.804309	173	253	8	2	80	0.0250000
NODE_19825_length_656_cov_22.804309	173	253	9	12	80	0.1500000
NODE_19825_length_656_cov_22.804309	226	306	4	8	80	0.1000000
NODE_19825_length_656_cov_22.804309	226	306	6	5	80	0.0625000
NODE_19825_length_656_cov_22.804309	226	306	7	21	80	0.2625000
NODE_19825_length_656_cov_22.804309	226	306	8	2	80	0.0250000
NODE_19825_length_656_cov_22.804309	226	306	9	44	80	0.5500000
NODE_19826_length_656_cov_19.280072	345	425	2	2	80	0.0250000
NODE_19826_length_656_cov_19.280072	345	425	3	13	80	0.1625000
NODE_19826_length_656_cov_19.280072	345	425	4	65	80	0.8125000
NODE_19826_length_656_cov_19.280072	398	478	1	37	80	0.4625000
NODE_19826_length_656_cov_19.280072	398	478	2	2	80	0.0250000
NODE_19826_length_656_cov_19.280072	398	478	3	29	80	0.3625000
NODE_19826_length_656_cov_19.280072	398	478	4	12	80	0.1500000
NODE_19827_length_656_cov_18.267504	272	352	4	34	80	0.4250000
NODE_19827_length_656_cov_18.267504	272	352	5	30	80	0.3750000
NODE_19827_length_656_cov_18.267504	272	352	6	16	80	0.2000000
NODE_19827_length_656_cov_18.267504	325	405	2	40	80	0.5000000
NODE_19827_length_656_cov_18.267504	325	405	4	35	80	0.4375000
NODE_19827_length_656_cov_18.267504	325	405	5	5	80	0.0625000
NODE_19828_length_656_cov_15.928187	223	303	0	26	80	0.3250000
NODE_19828_length_656_cov_15.928187	223	303	2	54	80	0.6750000
NODE_19829_length_656_cov_15.091562	297	377	8	80	80	1.0000000
NODE_19829_length_656_cov_15.091562	350	430	5	7	80	0.0875000
NODE_19829_length_656_cov_15.091562	350	430	6	17	80	0.2125000
NODE_19829_length_656_cov_15.091562	350	430	7	13	80	0.1625000
NODE_19829_length_656_cov_15.091562	350	430	8	32	80	0.4000000
NODE_19829_length_656_cov_15.091562	350	430	9	1	80	0.0125000
NODE_19829_length_656_cov_15.091562	350	430	10	10	80	0.1250000
NODE_19830_length_656_cov_12.773788	269	349	0	80	80	1.0000000
NODE_19830_length_656_cov_12.773788	322	399	0	77	77	1.0000000
NODE_19831_length_656_cov_12.493716	212	292	1	6	80	0.0750000
NODE_19831_length_656_cov_12.493716	212	292	2	74	80	0.9250000
NODE_19831_length_656_cov_12.493716	265	345	1	37	80	0.4625000
NODE_19831_length_656_cov_12.493716	265	345	2	43	80	0.5375000
NODE_19832_length_656_cov_10.946140	197	277	4	53	80	0.6625000
NODE_19832_length_656_cov_10.946140	197	277	5	27	80	0.3375000
NODE_19832_length_656_cov_10.946140	250	330	1	3	80	0.0375000
NODE_19832_length_656_cov_10.946140	250	330	2	24	80	0.3000000
NODE_19832_length_656_cov_10.946140	250	330	4	35	80	0.4375000
NODE_19832_length_656_cov_10.946140	250	330	5	18	80	0.2250000
NODE_19833_length_656_cov_9.412926	295	375	0	45	80	0.5625000
NODE_19833_length_656_cov_9.412926	295	375	1	35	80	0.4375000
NODE_19833_length_656_cov_9.412926	348	428	1	49	80	0.6125000
NODE_19833_length_656_cov_9.412926	348	428	3	31	80	0.3875000
NODE_19904_length_655_cov_31.019784	212	292	7	10	80	0.1250000
NODE_19904_length_655_cov_31.019784	212	292	8	1	80	0.0125000
NODE_19904_length_655_cov_31.019784	212	292	9	12	80	0.1500000
NODE_19904_length_655_cov_31.019784	212	292	11	1	80	0.0125000
NODE_19904_length_655_cov_31.019784	212	292	12	3	80	0.0375000
NODE_19904_length_655_cov_31.019784	212	292	13	46	80	0.5750000
NODE_19904_length_655_cov_31.019784	212	292	14	7	80	0.0875000
NODE_19904_length_655_cov_31.019784	265	345	11	12	80	0.1500000
NODE_19904_length_655_cov_31.019784	265	345	12	18	80	0.2250000
NODE_19904_length_655_cov_31.019784	265	345	13	30	80	0.3750000
NODE_19904_length_655_cov_31.019784	265	345	14	8	80	0.1000000
NODE_19904_length_655_cov_31.019784	265	345	15	12	80	0.1500000
NODE_19907_length_655_cov_8.672662	216	296	1	80	80	1.0000000
NODE_19907_length_655_cov_8.672662	269	349	1	80	80	1.0000000
NODE_19908_length_655_cov_8.250000	204	234	1	30	30	1.0000000
NODE_19909_length_655_cov_7.910072	366	446	3	12	80	0.1500000
NODE_19909_length_655_cov_7.910072	366	446	4	5	80	0.0625000
NODE_19909_length_655_cov_7.910072	366	446	5	63	80	0.7875000
NODE_19909_length_655_cov_7.910072	419	499	1	23	80	0.2875000
NODE_19909_length_655_cov_7.910072	419	499	2	22	80	0.2750000
NODE_19909_length_655_cov_7.910072	419	499	3	20	80	0.2500000
NODE_19909_length_655_cov_7.910072	419	499	5	15	80	0.1875000
NODE_19916_length_655_cov_5.478417	178	255	0	77	77	1.0000000
NODE_19916_length_655_cov_5.478417	178	221	0	43	43	1.0000000
NODE_19919_length_655_cov_5.174460	347	428	0	81	81	1.0000000
NODE_19919_length_655_cov_5.174460	401	481	0	75	80	0.9375000
NODE_19919_length_655_cov_5.174460	401	481	2	5	80	0.0625000
NODE_19979_length_654_cov_17.086486	323	403	6	27	80	0.3375000
NODE_19979_length_654_cov_17.086486	323	403	7	9	80	0.1125000
NODE_19979_length_654_cov_17.086486	323	403	8	44	80	0.5500000
NODE_19979_length_654_cov_17.086486	376	456	3	13	80	0.1625000
NODE_19979_length_654_cov_17.086486	376	456	4	5	80	0.0625000
NODE_19979_length_654_cov_17.086486	376	456	5	35	80	0.4375000
NODE_19979_length_654_cov_17.086486	376	456	6	2	80	0.0250000
NODE_19979_length_654_cov_17.086486	376	456	7	9	80	0.1125000
NODE_19979_length_654_cov_17.086486	376	456	8	16	80	0.2000000
NODE_19980_length_654_cov_16.194595	318	398	8	16	80	0.2000000
NODE_19980_length_654_cov_16.194595	318	398	9	19	80	0.2375000
NODE_19980_length_654_cov_16.194595	318	398	10	10	80	0.1250000
NODE_19980_length_654_cov_16.194595	318	398	11	35	80	0.4375000
NODE_19980_length_654_cov_16.194595	371	451	5	20	80	0.2500000
NODE_19980_length_654_cov_16.194595	371	451	6	1	80	0.0125000
NODE_19980_length_654_cov_16.194595	371	451	8	25	80	0.3125000
NODE_19980_length_654_cov_16.194595	371	451	9	1	80	0.0125000
NODE_19980_length_654_cov_16.194595	371	451	11	33	80	0.4125000
NODE_19983_length_654_cov_5.556757	341	412	0	56	71	0.7887324
NODE_19983_length_654_cov_5.556757	341	412	2	15	71	0.2112676
NODE_19990_length_654_cov_3.236036	105	181	0	76	76	1.0000000
NODE_19990_length_654_cov_3.236036	158	236	0	78	78	1.0000000
NODE_19998_length_654_cov_2.549550	279	366	0	87	87	1.0000000
NODE_20013_length_654_cov_1.790991	480	560	0	80	80	1.0000000
NODE_20044_length_653_cov_70.296029	277	357	7	8	80	0.1000000
NODE_20044_length_653_cov_70.296029	277	357	9	8	80	0.1000000
NODE_20044_length_653_cov_70.296029	277	357	10	2	80	0.0250000
NODE_20044_length_653_cov_70.296029	277	357	12	15	80	0.1875000
NODE_20044_length_653_cov_70.296029	277	357	14	32	80	0.4000000
NODE_20044_length_653_cov_70.296029	277	357	15	6	80	0.0750000
NODE_20044_length_653_cov_70.296029	277	357	16	9	80	0.1125000
NODE_20044_length_653_cov_70.296029	330	410	6	16	80	0.2000000
NODE_20044_length_653_cov_70.296029	330	410	8	12	80	0.1500000
NODE_20044_length_653_cov_70.296029	330	410	10	1	80	0.0125000
NODE_20044_length_653_cov_70.296029	330	410	12	5	80	0.0625000
NODE_20044_length_653_cov_70.296029	330	410	14	31	80	0.3875000
NODE_20044_length_653_cov_70.296029	330	410	15	6	80	0.0750000
NODE_20044_length_653_cov_70.296029	330	410	16	9	80	0.1125000
NODE_20045_length_653_cov_28.072202	302	382	6	3	80	0.0375000
NODE_20045_length_653_cov_28.072202	302	382	8	48	80	0.6000000
NODE_20045_length_653_cov_28.072202	302	382	9	9	80	0.1125000
NODE_20045_length_653_cov_28.072202	302	382	10	17	80	0.2125000
NODE_20045_length_653_cov_28.072202	302	382	11	3	80	0.0375000
NODE_20045_length_653_cov_28.072202	355	435	3	23	80	0.2875000
NODE_20045_length_653_cov_28.072202	355	435	4	1	80	0.0125000
NODE_20045_length_653_cov_28.072202	355	435	5	8	80	0.1000000
NODE_20045_length_653_cov_28.072202	355	435	6	24	80	0.3000000
NODE_20045_length_653_cov_28.072202	355	435	8	18	80	0.2250000
NODE_20045_length_653_cov_28.072202	355	435	9	6	80	0.0750000
NODE_20046_length_653_cov_18.382671	214	294	5	20	80	0.2500000
NODE_20046_length_653_cov_18.382671	214	294	6	2	80	0.0250000
NODE_20046_length_653_cov_18.382671	214	294	7	25	80	0.3125000
NODE_20046_length_653_cov_18.382671	214	294	8	33	80	0.4125000
NODE_20046_length_653_cov_18.382671	267	347	2	7	80	0.0875000
NODE_20046_length_653_cov_18.382671	267	347	3	9	80	0.1125000
NODE_20046_length_653_cov_18.382671	267	347	5	23	80	0.2875000
NODE_20046_length_653_cov_18.382671	267	347	6	2	80	0.0250000
NODE_20046_length_653_cov_18.382671	267	347	7	32	80	0.4000000
NODE_20046_length_653_cov_18.382671	267	347	8	7	80	0.0875000
NODE_20047_length_653_cov_8.821300	292	372	4	80	80	1.0000000
NODE_20047_length_653_cov_8.821300	345	425	0	17	80	0.2125000
NODE_20047_length_653_cov_8.821300	345	425	2	24	80	0.3000000
NODE_20047_length_653_cov_8.821300	345	425	4	39	80	0.4875000
NODE_20048_length_653_cov_8.660650	200	280	1	60	80	0.7500000
NODE_20048_length_653_cov_8.660650	200	280	2	20	80	0.2500000
NODE_20048_length_653_cov_8.660650	253	333	1	30	80	0.3750000
NODE_20048_length_653_cov_8.660650	253	333	2	50	80	0.6250000
NODE_20052_length_653_cov_5.777978	308	383	3	41	75	0.5466667
NODE_20052_length_653_cov_5.777978	308	383	4	34	75	0.4533333
NODE_20052_length_653_cov_5.777978	361	435	3	72	74	0.9729730
NODE_20052_length_653_cov_5.777978	361	435	4	2	74	0.0270270
NODE_20054_length_653_cov_5.193141	304	356	2	52	52	1.0000000
NODE_20058_length_653_cov_4.823105	178	251	0	73	73	1.0000000
NODE_20058_length_653_cov_4.823105	178	256	0	78	78	1.0000000
NODE_20058_length_653_cov_4.823105	229	309	0	80	80	1.0000000
NODE_20058_length_653_cov_4.823105	229	309	0	80	80	1.0000000
NODE_20058_length_653_cov_4.823105	239	309	0	70	70	1.0000000
NODE_20127_length_652_cov_215.211573	185	248	5	4	63	0.0634921
NODE_20127_length_652_cov_215.211573	185	248	6	6	63	0.0952381
NODE_20127_length_652_cov_215.211573	185	248	7	6	63	0.0952381
NODE_20127_length_652_cov_215.211573	185	248	8	9	63	0.1428571
NODE_20127_length_652_cov_215.211573	185	248	9	13	63	0.2063492
NODE_20127_length_652_cov_215.211573	185	248	11	10	63	0.1587302
NODE_20127_length_652_cov_215.211573	185	248	13	8	63	0.1269841
NODE_20127_length_652_cov_215.211573	185	248	14	3	63	0.0476190
NODE_20127_length_652_cov_215.211573	185	248	16	4	63	0.0634921
NODE_20127_length_652_cov_215.211573	221	301	9	2	80	0.0250000
NODE_20127_length_652_cov_215.211573	221	301	11	10	80	0.1250000
NODE_20127_length_652_cov_215.211573	221	301	13	8	80	0.1000000
NODE_20127_length_652_cov_215.211573	221	301	14	3	80	0.0375000
NODE_20127_length_652_cov_215.211573	221	301	16	5	80	0.0625000
NODE_20127_length_652_cov_215.211573	221	301	18	7	80	0.0875000
NODE_20127_length_652_cov_215.211573	221	301	20	6	80	0.0750000
NODE_20127_length_652_cov_215.211573	221	301	21	4	80	0.0500000
NODE_20127_length_652_cov_215.211573	221	301	22	32	80	0.4000000
NODE_20127_length_652_cov_215.211573	221	301	23	3	80	0.0375000
NODE_20128_length_652_cov_21.267631	299	379	6	43	80	0.5375000
NODE_20128_length_652_cov_21.267631	299	379	7	37	80	0.4625000
NODE_20128_length_652_cov_21.267631	352	432	6	43	80	0.5375000
NODE_20128_length_652_cov_21.267631	352	432	7	14	80	0.1750000
NODE_20128_length_652_cov_21.267631	352	432	8	15	80	0.1875000
NODE_20128_length_652_cov_21.267631	352	432	9	8	80	0.1000000
NODE_20138_length_652_cov_4.622061	266	315	0	49	49	1.0000000
NODE_20138_length_652_cov_4.622061	288	368	0	80	80	1.0000000
NODE_20210_length_651_cov_49.981884	425	505	3	1	80	0.0125000
NODE_20210_length_651_cov_49.981884	425	505	5	6	80	0.0750000
NODE_20210_length_651_cov_49.981884	425	505	7	16	80	0.2000000
NODE_20210_length_651_cov_49.981884	425	505	8	57	80	0.7125000
NODE_20210_length_651_cov_49.981884	425	505	3	1	80	0.0125000
NODE_20210_length_651_cov_49.981884	425	505	5	6	80	0.0750000
NODE_20210_length_651_cov_49.981884	425	505	7	16	80	0.2000000
NODE_20210_length_651_cov_49.981884	425	505	8	57	80	0.7125000
NODE_20210_length_651_cov_49.981884	425	505	3	1	80	0.0125000
NODE_20210_length_651_cov_49.981884	425	505	5	6	80	0.0750000
NODE_20210_length_651_cov_49.981884	425	505	7	16	80	0.2000000
NODE_20210_length_651_cov_49.981884	425	505	8	57	80	0.7125000
NODE_20210_length_651_cov_49.981884	425	505	3	1	80	0.0125000
NODE_20210_length_651_cov_49.981884	425	505	5	6	80	0.0750000
NODE_20210_length_651_cov_49.981884	425	505	7	16	80	0.2000000
NODE_20210_length_651_cov_49.981884	425	505	8	57	80	0.7125000
NODE_20210_length_651_cov_49.981884	478	540	2	19	62	0.3064516
NODE_20210_length_651_cov_49.981884	478	540	3	3	62	0.0483871
NODE_20210_length_651_cov_49.981884	478	540	5	6	62	0.0967742
NODE_20210_length_651_cov_49.981884	478	540	6	1	62	0.0161290
NODE_20210_length_651_cov_49.981884	478	540	8	33	62	0.5322581
NODE_20210_length_651_cov_49.981884	478	540	2	19	62	0.3064516
NODE_20210_length_651_cov_49.981884	478	540	3	3	62	0.0483871
NODE_20210_length_651_cov_49.981884	478	540	5	6	62	0.0967742
NODE_20210_length_651_cov_49.981884	478	540	6	1	62	0.0161290
NODE_20210_length_651_cov_49.981884	478	540	8	33	62	0.5322581
NODE_20210_length_651_cov_49.981884	478	540	2	19	62	0.3064516
NODE_20210_length_651_cov_49.981884	478	540	3	3	62	0.0483871
NODE_20210_length_651_cov_49.981884	478	540	5	6	62	0.0967742
NODE_20210_length_651_cov_49.981884	478	540	6	1	62	0.0161290
NODE_20210_length_651_cov_49.981884	478	540	8	33	62	0.5322581
NODE_20210_length_651_cov_49.981884	478	542	0	2	64	0.0312500
NODE_20210_length_651_cov_49.981884	478	542	2	19	64	0.2968750
NODE_20210_length_651_cov_49.981884	478	542	3	3	64	0.0468750
NODE_20210_length_651_cov_49.981884	478	542	5	6	64	0.0937500
NODE_20210_length_651_cov_49.981884	478	542	6	1	64	0.0156250
NODE_20210_length_651_cov_49.981884	478	542	8	33	64	0.5156250
NODE_20211_length_651_cov_36.121377	422	502	2	3	80	0.0375000
NODE_20211_length_651_cov_36.121377	422	502	3	25	80	0.3125000
NODE_20211_length_651_cov_36.121377	422	502	4	16	80	0.2000000
NODE_20211_length_651_cov_36.121377	422	502	5	36	80	0.4500000
NODE_20211_length_651_cov_36.121377	475	555	1	9	80	0.1125000
NODE_20211_length_651_cov_36.121377	475	555	2	3	80	0.0375000
NODE_20211_length_651_cov_36.121377	475	555	3	58	80	0.7250000
NODE_20211_length_651_cov_36.121377	475	555	4	10	80	0.1250000
NODE_20212_length_651_cov_20.045290	252	332	1	11	80	0.1375000
NODE_20212_length_651_cov_20.045290	252	332	2	1	80	0.0125000
NODE_20212_length_651_cov_20.045290	252	332	6	8	80	0.1000000
NODE_20212_length_651_cov_20.045290	252	332	8	18	80	0.2250000
NODE_20212_length_651_cov_20.045290	252	332	9	8	80	0.1000000
NODE_20212_length_651_cov_20.045290	252	332	10	1	80	0.0125000
NODE_20212_length_651_cov_20.045290	252	332	11	10	80	0.1250000
NODE_20212_length_651_cov_20.045290	252	332	12	4	80	0.0500000
NODE_20212_length_651_cov_20.045290	252	332	13	19	80	0.2375000
NODE_20212_length_651_cov_20.045290	305	385	11	8	80	0.1000000
NODE_20212_length_651_cov_20.045290	305	385	13	72	80	0.9000000
NODE_20213_length_651_cov_12.704710	264	344	0	37	80	0.4625000
NODE_20213_length_651_cov_12.704710	264	344	2	2	80	0.0250000
NODE_20213_length_651_cov_12.704710	264	344	4	17	80	0.2125000
NODE_20213_length_651_cov_12.704710	264	344	6	24	80	0.3000000
NODE_20213_length_651_cov_12.704710	317	397	4	3	80	0.0375000
NODE_20213_length_651_cov_12.704710	317	397	6	77	80	0.9625000
NODE_20214_length_651_cov_11.632246	205	285	2	65	80	0.8125000
NODE_20214_length_651_cov_11.632246	205	285	3	15	80	0.1875000
NODE_20214_length_651_cov_11.632246	258	338	0	25	80	0.3125000
NODE_20214_length_651_cov_11.632246	258	338	2	55	80	0.6875000
NODE_20215_length_651_cov_10.074275	369	449	6	76	80	0.9500000
NODE_20215_length_651_cov_10.074275	369	449	7	4	80	0.0500000
NODE_20215_length_651_cov_10.074275	422	502	1	27	80	0.3375000
NODE_20215_length_651_cov_10.074275	422	502	2	6	80	0.0750000
NODE_20215_length_651_cov_10.074275	422	502	3	5	80	0.0625000
NODE_20215_length_651_cov_10.074275	422	502	4	1	80	0.0125000
NODE_20215_length_651_cov_10.074275	422	502	5	13	80	0.1625000
NODE_20215_length_651_cov_10.074275	422	502	6	28	80	0.3500000
NODE_20216_length_651_cov_9.699275	199	279	3	16	80	0.2000000
NODE_20216_length_651_cov_9.699275	199	279	4	26	80	0.3250000
NODE_20216_length_651_cov_9.699275	199	279	5	25	80	0.3125000
NODE_20216_length_651_cov_9.699275	199	279	6	8	80	0.1000000
NODE_20216_length_651_cov_9.699275	199	279	7	5	80	0.0625000
NODE_20216_length_651_cov_9.699275	252	332	3	62	80	0.7750000
NODE_20216_length_651_cov_9.699275	252	332	4	7	80	0.0875000
NODE_20216_length_651_cov_9.699275	252	332	5	8	80	0.1000000
NODE_20216_length_651_cov_9.699275	252	332	7	3	80	0.0375000
NODE_20219_length_651_cov_8.309783	217	296	2	49	79	0.6202531
NODE_20219_length_651_cov_8.309783	217	296	4	30	79	0.3797468
NODE_20219_length_651_cov_8.309783	269	349	2	36	80	0.4500000
NODE_20219_length_651_cov_8.309783	269	349	4	44	80	0.5500000
NODE_20220_length_651_cov_5.621377	148	228	0	33	80	0.4125000
NODE_20220_length_651_cov_5.621377	148	228	2	19	80	0.2375000
NODE_20220_length_651_cov_5.621377	148	228	4	28	80	0.3500000
NODE_20220_length_651_cov_5.621377	201	281	4	80	80	1.0000000
NODE_20221_length_651_cov_5.610507	342	422	0	80	80	1.0000000
NODE_20221_length_651_cov_5.610507	395	475	0	80	80	1.0000000
NODE_20225_length_651_cov_4.246377	299	359	0	60	60	1.0000000
NODE_20238_length_651_cov_2.744565	340	421	0	81	81	1.0000000
NODE_20252_length_651_cov_2.016304	280	311	0	31	31	1.0000000
NODE_20292_length_650_cov_22.644283	233	313	0	80	80	1.0000000
NODE_20292_length_650_cov_22.644283	286	366	0	80	80	1.0000000
NODE_20293_length_650_cov_22.156080	269	349	1	80	80	1.0000000
NODE_20293_length_650_cov_22.156080	322	402	0	9	80	0.1125000
NODE_20293_length_650_cov_22.156080	322	402	1	71	80	0.8875000
NODE_20294_length_650_cov_20.012704	186	266	0	80	80	1.0000000
NODE_20294_length_650_cov_20.012704	239	319	0	80	80	1.0000000
NODE_20295_length_650_cov_17.626134	52	132	0	6	80	0.0750000
NODE_20295_length_650_cov_17.626134	52	132	2	74	80	0.9250000
NODE_20295_length_650_cov_17.626134	105	185	0	7	80	0.0875000
NODE_20295_length_650_cov_17.626134	105	185	2	73	80	0.9125000
NODE_20297_length_650_cov_10.687840	289	369	0	80	80	1.0000000
NODE_20297_length_650_cov_10.687840	342	422	0	80	80	1.0000000
NODE_20301_length_650_cov_6.519056	312	365	1	53	53	1.0000000
NODE_20301_length_650_cov_6.519056	338	417	1	79	79	1.0000000
NODE_20302_length_650_cov_6.159710	243	323	2	80	80	1.0000000
NODE_20302_length_650_cov_6.159710	296	376	2	80	80	1.0000000
NODE_20318_length_650_cov_2.488203	213	266	2	2	53	0.0377358
NODE_20318_length_650_cov_2.488203	213	266	3	33	53	0.6226415
NODE_20318_length_650_cov_2.488203	213	266	4	18	53	0.3396226
NODE_20370_length_649_cov_20.780000	111	140	7	8	29	0.2758621
NODE_20370_length_649_cov_20.780000	111	140	8	6	29	0.2068966
NODE_20370_length_649_cov_20.780000	111	140	10	3	29	0.1034483
NODE_20370_length_649_cov_20.780000	111	140	11	12	29	0.4137931
NODE_20370_length_649_cov_20.780000	111	191	7	8	80	0.1000000
NODE_20370_length_649_cov_20.780000	111	191	8	6	80	0.0750000
NODE_20370_length_649_cov_20.780000	111	191	10	14	80	0.1750000
NODE_20370_length_649_cov_20.780000	111	191	11	52	80	0.6500000
NODE_20370_length_649_cov_20.780000	138	161	11	23	23	1.0000000
NODE_20370_length_649_cov_20.780000	138	214	10	20	76	0.2631579
NODE_20370_length_649_cov_20.780000	138	214	11	49	76	0.6447368
NODE_20370_length_649_cov_20.780000	138	214	12	7	76	0.0921053
NODE_20370_length_649_cov_20.780000	164	244	7	6	80	0.0750000
NODE_20370_length_649_cov_20.780000	164	244	8	16	80	0.2000000
NODE_20370_length_649_cov_20.780000	164	244	9	4	80	0.0500000
NODE_20370_length_649_cov_20.780000	164	244	10	24	80	0.3000000
NODE_20370_length_649_cov_20.780000	164	244	11	23	80	0.2875000
NODE_20370_length_649_cov_20.780000	164	244	12	7	80	0.0875000
NODE_20371_length_649_cov_17.938182	162	242	0	58	80	0.7250000
NODE_20371_length_649_cov_17.938182	162	242	2	22	80	0.2750000
NODE_20371_length_649_cov_17.938182	215	295	0	6	80	0.0750000
NODE_20371_length_649_cov_17.938182	215	295	2	74	80	0.9250000
NODE_20372_length_649_cov_16.761818	395	475	0	63	80	0.7875000
NODE_20372_length_649_cov_16.761818	395	475	2	17	80	0.2125000
NODE_20372_length_649_cov_16.761818	448	528	0	10	80	0.1250000
NODE_20372_length_649_cov_16.761818	448	528	2	70	80	0.8750000
NODE_20373_length_649_cov_15.632727	226	306	2	11	80	0.1375000
NODE_20373_length_649_cov_15.632727	226	306	3	19	80	0.2375000
NODE_20373_length_649_cov_15.632727	226	306	4	5	80	0.0625000
NODE_20373_length_649_cov_15.632727	226	306	5	45	80	0.5625000
NODE_20373_length_649_cov_15.632727	279	359	4	15	80	0.1875000
NODE_20373_length_649_cov_15.632727	279	359	5	65	80	0.8125000
NODE_20374_length_649_cov_15.516364	329	409	3	6	80	0.0750000
NODE_20374_length_649_cov_15.516364	329	409	4	24	80	0.3000000
NODE_20374_length_649_cov_15.516364	329	409	5	50	80	0.6250000
NODE_20374_length_649_cov_15.516364	382	462	1	9	80	0.1125000
NODE_20374_length_649_cov_15.516364	382	462	4	56	80	0.7000000
NODE_20374_length_649_cov_15.516364	382	462	5	15	80	0.1875000
NODE_20375_length_649_cov_10.374545	453	533	5	6	80	0.0750000
NODE_20375_length_649_cov_10.374545	453	533	6	7	80	0.0875000
NODE_20375_length_649_cov_10.374545	453	533	7	21	80	0.2625000
NODE_20375_length_649_cov_10.374545	453	533	8	46	80	0.5750000
NODE_20375_length_649_cov_10.374545	506	586	3	14	80	0.1750000
NODE_20375_length_649_cov_10.374545	506	586	4	7	80	0.0875000
NODE_20375_length_649_cov_10.374545	506	586	5	22	80	0.2750000
NODE_20375_length_649_cov_10.374545	506	586	6	16	80	0.2000000
NODE_20375_length_649_cov_10.374545	506	586	7	7	80	0.0875000
NODE_20375_length_649_cov_10.374545	506	586	8	14	80	0.1750000
NODE_20382_length_649_cov_4.403636	213	293	0	80	80	1.0000000
NODE_20382_length_649_cov_4.403636	266	346	0	80	80	1.0000000
NODE_20454_length_648_cov_34.287796	343	423	0	80	80	1.0000000
NODE_20454_length_648_cov_34.287796	396	476	0	80	80	1.0000000
NODE_20454_length_648_cov_34.287796	472	552	0	80	80	1.0000000
NODE_20454_length_648_cov_34.287796	525	605	0	80	80	1.0000000
NODE_20455_length_648_cov_19.433515	259	339	0	80	80	1.0000000
NODE_20455_length_648_cov_19.433515	312	392	0	80	80	1.0000000
NODE_20457_length_648_cov_8.391621	206	286	0	12	80	0.1500000
NODE_20457_length_648_cov_8.391621	206	286	1	68	80	0.8500000
NODE_20457_length_648_cov_8.391621	259	339	1	37	80	0.4625000
NODE_20457_length_648_cov_8.391621	259	339	2	43	80	0.5375000
NODE_20459_length_648_cov_6.573770	293	373	0	33	80	0.4125000
NODE_20459_length_648_cov_6.573770	293	373	1	29	80	0.3625000
NODE_20459_length_648_cov_6.573770	293	373	3	18	80	0.2250000
NODE_20459_length_648_cov_6.573770	346	426	1	9	80	0.1125000
NODE_20459_length_648_cov_6.573770	346	426	3	71	80	0.8875000
NODE_20460_length_648_cov_6.431694	285	328	0	43	43	1.0000000
NODE_20463_length_648_cov_6.085610	257	337	6	1	80	0.0125000
NODE_20463_length_648_cov_6.085610	257	337	8	14	80	0.1750000
NODE_20463_length_648_cov_6.085610	257	337	9	1	80	0.0125000
NODE_20463_length_648_cov_6.085610	257	337	10	13	80	0.1625000
NODE_20463_length_648_cov_6.085610	257	337	11	3	80	0.0375000
NODE_20463_length_648_cov_6.085610	257	337	12	22	80	0.2750000
NODE_20463_length_648_cov_6.085610	257	337	13	5	80	0.0625000
NODE_20463_length_648_cov_6.085610	257	337	14	21	80	0.2625000
NODE_20463_length_648_cov_6.085610	310	390	12	24	80	0.3000000
NODE_20463_length_648_cov_6.085610	310	390	13	12	80	0.1500000
NODE_20463_length_648_cov_6.085610	310	390	14	37	80	0.4625000
NODE_20463_length_648_cov_6.085610	310	390	15	7	80	0.0875000
NODE_20483_length_648_cov_2.333333	19	86	0	67	67	1.0000000
NODE_20531_length_647_cov_18.489051	295	375	0	33	80	0.4125000
NODE_20531_length_647_cov_18.489051	295	375	4	47	80	0.5875000
NODE_20531_length_647_cov_18.489051	348	428	0	2	80	0.0250000
NODE_20531_length_647_cov_18.489051	348	428	4	78	80	0.9750000
NODE_20532_length_647_cov_14.677007	286	366	0	2	80	0.0250000
NODE_20532_length_647_cov_14.677007	286	366	1	6	80	0.0750000
NODE_20532_length_647_cov_14.677007	286	366	2	72	80	0.9000000
NODE_20532_length_647_cov_14.677007	339	419	2	80	80	1.0000000
NODE_20533_length_647_cov_10.895985	231	311	1	4	80	0.0500000
NODE_20533_length_647_cov_10.895985	231	311	3	69	80	0.8625000
NODE_20533_length_647_cov_10.895985	231	311	5	7	80	0.0875000
NODE_20533_length_647_cov_10.895985	284	364	3	20	80	0.2500000
NODE_20533_length_647_cov_10.895985	284	364	4	3	80	0.0375000
NODE_20533_length_647_cov_10.895985	284	364	5	57	80	0.7125000
NODE_20534_length_647_cov_9.116788	372	452	6	11	80	0.1375000
NODE_20534_length_647_cov_9.116788	372	452	7	20	80	0.2500000
NODE_20534_length_647_cov_9.116788	372	452	8	49	80	0.6125000
NODE_20534_length_647_cov_9.116788	425	505	5	24	80	0.3000000
NODE_20534_length_647_cov_9.116788	425	505	6	40	80	0.5000000
NODE_20534_length_647_cov_9.116788	425	505	8	16	80	0.2000000
NODE_20536_length_647_cov_6.410584	150	221	0	50	71	0.7042254
NODE_20536_length_647_cov_6.410584	150	221	1	21	71	0.2957746
NODE_20536_length_647_cov_6.410584	194	274	0	6	80	0.0750000
NODE_20536_length_647_cov_6.410584	194	274	1	29	80	0.3625000
NODE_20536_length_647_cov_6.410584	194	274	2	45	80	0.5625000
NODE_20539_length_647_cov_5.567518	239	319	0	80	80	1.0000000
NODE_20539_length_647_cov_5.567518	292	355	0	63	63	1.0000000
NODE_20539_length_647_cov_5.567518	348	416	0	68	68	1.0000000
NODE_20539_length_647_cov_5.567518	401	469	0	68	68	1.0000000
NODE_20544_length_647_cov_3.775547	356	399	0	43	43	1.0000000
NODE_20550_length_647_cov_2.678832	239	319	1	70	80	0.8750000
NODE_20550_length_647_cov_2.678832	239	319	3	10	80	0.1250000
NODE_20550_length_647_cov_2.678832	292	372	1	17	80	0.2125000
NODE_20550_length_647_cov_2.678832	292	372	3	60	80	0.7500000
NODE_20550_length_647_cov_2.678832	292	372	4	3	80	0.0375000
NODE_20561_length_647_cov_1.937956	254	304	0	50	50	1.0000000
NODE_20607_length_646_cov_56.226691	267	347	3	8	80	0.1000000
NODE_20607_length_646_cov_56.226691	267	347	4	22	80	0.2750000
NODE_20607_length_646_cov_56.226691	267	347	6	15	80	0.1875000
NODE_20607_length_646_cov_56.226691	267	347	8	1	80	0.0125000
NODE_20607_length_646_cov_56.226691	267	347	9	34	80	0.4250000
NODE_20607_length_646_cov_56.226691	320	400	2	18	80	0.2250000
NODE_20607_length_646_cov_56.226691	320	400	3	43	80	0.5375000
NODE_20607_length_646_cov_56.226691	320	400	4	19	80	0.2375000
NODE_20608_length_646_cov_23.747715	76	153	2	29	77	0.3766234
NODE_20608_length_646_cov_23.747715	76	153	3	5	77	0.0649351
NODE_20608_length_646_cov_23.747715	76	153	4	43	77	0.5584416
NODE_20608_length_646_cov_23.747715	129	209	4	40	80	0.5000000
NODE_20608_length_646_cov_23.747715	129	209	5	35	80	0.4375000
NODE_20608_length_646_cov_23.747715	129	209	6	5	80	0.0625000
NODE_20609_length_646_cov_22.740402	326	406	1	73	80	0.9125000
NODE_20609_length_646_cov_22.740402	326	406	3	7	80	0.0875000
NODE_20609_length_646_cov_22.740402	379	459	1	20	80	0.2500000
NODE_20609_length_646_cov_22.740402	379	459	2	43	80	0.5375000
NODE_20609_length_646_cov_22.740402	379	459	3	17	80	0.2125000
NODE_20610_length_646_cov_15.160878	363	443	1	7	80	0.0875000
NODE_20610_length_646_cov_15.160878	363	443	2	2	80	0.0250000
NODE_20610_length_646_cov_15.160878	363	443	3	2	80	0.0250000
NODE_20610_length_646_cov_15.160878	363	443	6	28	80	0.3500000
NODE_20610_length_646_cov_15.160878	363	443	7	41	80	0.5125000
NODE_20610_length_646_cov_15.160878	416	496	1	7	80	0.0875000
NODE_20610_length_646_cov_15.160878	416	496	2	55	80	0.6875000
NODE_20610_length_646_cov_15.160878	416	496	3	2	80	0.0250000
NODE_20610_length_646_cov_15.160878	416	496	7	16	80	0.2000000
NODE_20611_length_646_cov_9.429616	309	389	3	35	80	0.4375000
NODE_20611_length_646_cov_9.429616	309	389	4	45	80	0.5625000
NODE_20611_length_646_cov_9.429616	362	442	1	4	80	0.0500000
NODE_20611_length_646_cov_9.429616	362	442	2	7	80	0.0875000
NODE_20611_length_646_cov_9.429616	362	442	3	19	80	0.2375000
NODE_20611_length_646_cov_9.429616	362	442	4	50	80	0.6250000
NODE_20612_length_646_cov_9.246801	149	221	0	72	72	1.0000000
NODE_20613_length_646_cov_7.539305	227	307	0	80	80	1.0000000
NODE_20613_length_646_cov_7.539305	280	360	0	80	80	1.0000000
NODE_20614_length_646_cov_6.756856	236	316	0	60	80	0.7500000
NODE_20614_length_646_cov_6.756856	236	316	1	2	80	0.0250000
NODE_20614_length_646_cov_6.756856	236	316	2	18	80	0.2250000
NODE_20614_length_646_cov_6.756856	289	369	0	80	80	1.0000000
NODE_20615_length_646_cov_6.480804	373	437	3	64	64	1.0000000
NODE_20615_length_646_cov_6.480804	410	490	2	38	80	0.4750000
NODE_20615_length_646_cov_6.480804	410	490	3	42	80	0.5250000
NODE_20616_length_646_cov_6.396709	194	274	2	4	80	0.0500000
NODE_20616_length_646_cov_6.396709	194	274	3	23	80	0.2875000
NODE_20616_length_646_cov_6.396709	194	274	4	53	80	0.6625000
NODE_20616_length_646_cov_6.396709	254	327	2	15	73	0.2054795
NODE_20616_length_646_cov_6.396709	254	327	3	33	73	0.4520548
NODE_20616_length_646_cov_6.396709	254	327	4	25	73	0.3424658
NODE_20619_length_646_cov_4.652651	265	345	0	75	80	0.9375000
NODE_20619_length_646_cov_4.652651	265	345	1	5	80	0.0625000
NODE_20623_length_646_cov_4.122486	401	452	0	51	51	1.0000000
NODE_20688_length_645_cov_95.882784	179	259	7	11	80	0.1375000
NODE_20688_length_645_cov_95.882784	179	259	8	10	80	0.1250000
NODE_20688_length_645_cov_95.882784	179	259	9	2	80	0.0250000
NODE_20688_length_645_cov_95.882784	179	259	11	4	80	0.0500000
NODE_20688_length_645_cov_95.882784	179	259	12	27	80	0.3375000
NODE_20688_length_645_cov_95.882784	179	259	13	6	80	0.0750000
NODE_20688_length_645_cov_95.882784	179	259	14	10	80	0.1250000
NODE_20688_length_645_cov_95.882784	179	259	15	10	80	0.1250000
NODE_20688_length_645_cov_95.882784	232	312	9	3	80	0.0375000
NODE_20688_length_645_cov_95.882784	232	312	10	14	80	0.1750000
NODE_20688_length_645_cov_95.882784	232	312	11	38	80	0.4750000
NODE_20688_length_645_cov_95.882784	232	312	13	5	80	0.0625000
NODE_20688_length_645_cov_95.882784	232	312	14	10	80	0.1250000
NODE_20688_length_645_cov_95.882784	232	312	15	10	80	0.1250000
NODE_20689_length_645_cov_12.985348	343	423	0	80	80	1.0000000
NODE_20689_length_645_cov_12.985348	396	476	0	80	80	1.0000000
NODE_20691_length_645_cov_9.228938	254	334	4	52	80	0.6500000
NODE_20691_length_645_cov_9.228938	254	334	5	28	80	0.3500000
NODE_20691_length_645_cov_9.228938	307	387	2	18	80	0.2250000
NODE_20691_length_645_cov_9.228938	307	387	3	8	80	0.1000000
NODE_20691_length_645_cov_9.228938	307	387	4	20	80	0.2500000
NODE_20691_length_645_cov_9.228938	307	387	5	34	80	0.4250000
NODE_20692_length_645_cov_9.172161	293	373	1	80	80	1.0000000
NODE_20692_length_645_cov_9.172161	346	426	1	80	80	1.0000000
NODE_20697_length_645_cov_5.609890	461	541	0	80	80	1.0000000
NODE_20697_length_645_cov_5.609890	514	594	0	80	80	1.0000000
NODE_20698_length_645_cov_4.743590	237	317	0	80	80	1.0000000
NODE_20698_length_645_cov_4.743590	290	370	0	80	80	1.0000000
NODE_20716_length_645_cov_2.177656	373	416	0	43	43	1.0000000
NODE_20762_length_644_cov_59.286239	323	401	16	4	78	0.0512821
NODE_20762_length_644_cov_59.286239	323	401	18	2	78	0.0256410
NODE_20762_length_644_cov_59.286239	323	401	21	22	78	0.2820513
NODE_20762_length_644_cov_59.286239	323	401	25	4	78	0.0512821
NODE_20762_length_644_cov_59.286239	323	401	27	1	78	0.0128205
NODE_20762_length_644_cov_59.286239	323	401	29	1	78	0.0128205
NODE_20762_length_644_cov_59.286239	323	401	31	2	78	0.0256410
NODE_20762_length_644_cov_59.286239	323	401	32	2	78	0.0256410
NODE_20762_length_644_cov_59.286239	323	401	33	5	78	0.0641026
NODE_20762_length_644_cov_59.286239	323	401	35	7	78	0.0897436
NODE_20762_length_644_cov_59.286239	323	401	37	1	78	0.0128205
NODE_20762_length_644_cov_59.286239	323	401	38	1	78	0.0128205
NODE_20762_length_644_cov_59.286239	323	401	39	9	78	0.1153846
NODE_20762_length_644_cov_59.286239	323	401	41	3	78	0.0384615
NODE_20762_length_644_cov_59.286239	323	401	42	1	78	0.0128205
NODE_20762_length_644_cov_59.286239	323	401	43	3	78	0.0384615
NODE_20762_length_644_cov_59.286239	323	401	46	1	78	0.0128205
NODE_20762_length_644_cov_59.286239	323	401	47	6	78	0.0769231
NODE_20762_length_644_cov_59.286239	323	401	51	2	78	0.0256410
NODE_20762_length_644_cov_59.286239	323	401	53	1	78	0.0128205
NODE_20763_length_644_cov_27.577982	63	143	2	22	80	0.2750000
NODE_20763_length_644_cov_27.577982	63	143	4	1	80	0.0125000
NODE_20763_length_644_cov_27.577982	63	143	6	57	80	0.7125000
NODE_20763_length_644_cov_27.577982	116	196	1	11	80	0.1375000
NODE_20763_length_644_cov_27.577982	116	196	2	18	80	0.2250000
NODE_20763_length_644_cov_27.577982	116	196	3	9	80	0.1125000
NODE_20763_length_644_cov_27.577982	116	196	4	2	80	0.0250000
NODE_20763_length_644_cov_27.577982	116	196	6	40	80	0.5000000
NODE_20765_length_644_cov_10.073394	284	364	0	80	80	1.0000000
NODE_20765_length_644_cov_10.073394	337	417	0	80	80	1.0000000
NODE_20845_length_643_cov_27.562500	201	281	0	6	80	0.0750000
NODE_20845_length_643_cov_27.562500	201	281	1	24	80	0.3000000
NODE_20845_length_643_cov_27.562500	201	281	2	3	80	0.0375000
NODE_20845_length_643_cov_27.562500	201	281	3	14	80	0.1750000
NODE_20845_length_643_cov_27.562500	201	281	4	3	80	0.0375000
NODE_20845_length_643_cov_27.562500	201	281	5	30	80	0.3750000
NODE_20845_length_643_cov_27.562500	254	334	5	60	80	0.7500000
NODE_20845_length_643_cov_27.562500	254	334	6	20	80	0.2500000
NODE_20845_length_643_cov_27.562500	330	410	1	10	80	0.1250000
NODE_20845_length_643_cov_27.562500	330	410	2	2	80	0.0250000
NODE_20845_length_643_cov_27.562500	330	410	3	14	80	0.1750000
NODE_20845_length_643_cov_27.562500	330	410	4	3	80	0.0375000
NODE_20845_length_643_cov_27.562500	330	410	5	5	80	0.0625000
NODE_20845_length_643_cov_27.562500	330	410	6	46	80	0.5750000
NODE_20845_length_643_cov_27.562500	383	463	1	19	80	0.2375000
NODE_20845_length_643_cov_27.562500	383	463	2	46	80	0.5750000
NODE_20845_length_643_cov_27.562500	383	463	3	14	80	0.1750000
NODE_20845_length_643_cov_27.562500	383	463	4	1	80	0.0125000
NODE_20846_length_643_cov_12.895221	203	283	5	8	80	0.1000000
NODE_20846_length_643_cov_12.895221	203	283	6	61	80	0.7625000
NODE_20846_length_643_cov_12.895221	203	283	7	11	80	0.1375000
NODE_20846_length_643_cov_12.895221	256	336	0	8	80	0.1000000
NODE_20846_length_643_cov_12.895221	256	336	1	6	80	0.0750000
NODE_20846_length_643_cov_12.895221	256	336	2	30	80	0.3750000
NODE_20846_length_643_cov_12.895221	256	336	3	4	80	0.0500000
NODE_20846_length_643_cov_12.895221	256	336	5	13	80	0.1625000
NODE_20846_length_643_cov_12.895221	256	336	6	19	80	0.2375000
NODE_20847_length_643_cov_10.501838	280	360	2	35	80	0.4375000
NODE_20847_length_643_cov_10.501838	280	360	3	45	80	0.5625000
NODE_20847_length_643_cov_10.501838	333	413	1	20	80	0.2500000
NODE_20847_length_643_cov_10.501838	333	413	2	60	80	0.7500000
NODE_20848_length_643_cov_9.136029	307	385	0	11	78	0.1410256
NODE_20848_length_643_cov_9.136029	307	385	2	67	78	0.8589743
NODE_20848_length_643_cov_9.136029	358	438	0	64	80	0.8000000
NODE_20848_length_643_cov_9.136029	358	438	2	16	80	0.2000000
NODE_20849_length_643_cov_8.264706	202	282	0	80	80	1.0000000
NODE_20849_length_643_cov_8.264706	255	335	0	80	80	1.0000000
NODE_20851_length_643_cov_7.137868	173	253	2	18	80	0.2250000
NODE_20851_length_643_cov_7.137868	173	253	4	62	80	0.7750000
NODE_20851_length_643_cov_7.137868	226	306	0	28	80	0.3500000
NODE_20851_length_643_cov_7.137868	226	306	4	52	80	0.6500000
NODE_20855_length_643_cov_5.851103	255	335	1	63	80	0.7875000
NODE_20855_length_643_cov_5.851103	255	335	3	17	80	0.2125000
NODE_20855_length_643_cov_5.851103	308	388	1	10	80	0.1250000
NODE_20855_length_643_cov_5.851103	308	388	3	70	80	0.8750000
NODE_20869_length_643_cov_3.121324	283	348	0	45	65	0.6923077
NODE_20869_length_643_cov_3.121324	283	348	2	20	65	0.3076923
NODE_20872_length_643_cov_2.806985	387	451	0	4	64	0.0625000
NODE_20872_length_643_cov_2.806985	387	451	2	60	64	0.9375000
NODE_20942_length_642_cov_36.309392	156	236	4	6	80	0.0750000
NODE_20942_length_642_cov_36.309392	156	236	6	13	80	0.1625000
NODE_20942_length_642_cov_36.309392	156	236	7	9	80	0.1125000
NODE_20942_length_642_cov_36.309392	156	236	8	52	80	0.6500000
NODE_20942_length_642_cov_36.309392	209	289	0	1	80	0.0125000
NODE_20942_length_642_cov_36.309392	209	289	1	16	80	0.2000000
NODE_20942_length_642_cov_36.309392	209	289	2	1	80	0.0125000
NODE_20942_length_642_cov_36.309392	209	289	3	9	80	0.1125000
NODE_20942_length_642_cov_36.309392	209	289	5	3	80	0.0375000
NODE_20942_length_642_cov_36.309392	209	289	7	32	80	0.4000000
NODE_20942_length_642_cov_36.309392	209	289	8	18	80	0.2250000
NODE_20943_length_642_cov_27.046041	154	234	1	6	80	0.0750000
NODE_20943_length_642_cov_27.046041	154	234	3	6	80	0.0750000
NODE_20943_length_642_cov_27.046041	154	234	5	2	80	0.0250000
NODE_20943_length_642_cov_27.046041	154	234	6	41	80	0.5125000
NODE_20943_length_642_cov_27.046041	154	234	7	15	80	0.1875000
NODE_20943_length_642_cov_27.046041	154	234	8	10	80	0.1250000
NODE_20943_length_642_cov_27.046041	207	287	6	65	80	0.8125000
NODE_20943_length_642_cov_27.046041	207	287	7	5	80	0.0625000
NODE_20943_length_642_cov_27.046041	207	287	8	10	80	0.1250000
NODE_20944_length_642_cov_26.290976	209	289	7	4	80	0.0500000
NODE_20944_length_642_cov_26.290976	209	289	8	3	80	0.0375000
NODE_20944_length_642_cov_26.290976	209	289	10	73	80	0.9125000
NODE_20944_length_642_cov_26.290976	262	342	8	8	80	0.1000000
NODE_20944_length_642_cov_26.290976	262	342	9	1	80	0.0125000
NODE_20944_length_642_cov_26.290976	262	342	10	71	80	0.8875000
NODE_20945_length_642_cov_11.651934	309	389	2	51	80	0.6375000
NODE_20945_length_642_cov_11.651934	309	389	4	29	80	0.3625000
NODE_20945_length_642_cov_11.651934	362	442	2	28	80	0.3500000
NODE_20945_length_642_cov_11.651934	362	442	3	2	80	0.0250000
NODE_20945_length_642_cov_11.651934	362	442	4	50	80	0.6250000
NODE_20947_length_642_cov_6.692449	453	533	3	9	80	0.1125000
NODE_20947_length_642_cov_6.692449	453	533	4	39	80	0.4875000
NODE_20947_length_642_cov_6.692449	453	533	5	4	80	0.0500000
NODE_20947_length_642_cov_6.692449	453	533	6	28	80	0.3500000
NODE_20947_length_642_cov_6.692449	506	586	2	30	80	0.3750000
NODE_20947_length_642_cov_6.692449	506	586	3	32	80	0.4000000
NODE_20947_length_642_cov_6.692449	506	586	4	8	80	0.1000000
NODE_20947_length_642_cov_6.692449	506	586	5	4	80	0.0500000
NODE_20947_length_642_cov_6.692449	506	586	6	6	80	0.0750000
NODE_20951_length_642_cov_5.933702	260	340	0	80	80	1.0000000
NODE_20951_length_642_cov_5.933702	313	391	0	78	78	1.0000000
NODE_20967_length_642_cov_2.823204	115	158	1	20	43	0.4651163
NODE_20967_length_642_cov_2.823204	115	158	2	4	43	0.0930233
NODE_20967_length_642_cov_2.823204	115	158	3	19	43	0.4418605
NODE_20967_length_642_cov_2.823204	245	300	8	11	55	0.2000000
NODE_20967_length_642_cov_2.823204	245	300	9	4	55	0.0727273
NODE_20967_length_642_cov_2.823204	245	300	10	8	55	0.1454545
NODE_20967_length_642_cov_2.823204	245	300	12	1	55	0.0181818
NODE_20967_length_642_cov_2.823204	245	300	13	5	55	0.0909091
NODE_20967_length_642_cov_2.823204	245	300	14	26	55	0.4727273
NODE_20967_length_642_cov_2.823204	329	410	3	20	81	0.2469136
NODE_20967_length_642_cov_2.823204	329	410	4	10	81	0.1234568
NODE_20967_length_642_cov_2.823204	329	410	5	1	81	0.0123457
NODE_20967_length_642_cov_2.823204	329	410	6	22	81	0.2716049
NODE_20967_length_642_cov_2.823204	329	410	7	14	81	0.1728395
NODE_20967_length_642_cov_2.823204	329	410	8	10	81	0.1234568
NODE_20967_length_642_cov_2.823204	329	410	9	4	81	0.0493827
NODE_20991_length_642_cov_1.357274	0	75	0	75	75	1.0000000
NODE_21018_length_641_cov_38.675277	284	345	1	25	61	0.4098361
NODE_21018_length_641_cov_38.675277	284	345	2	6	61	0.0983607
NODE_21018_length_641_cov_38.675277	284	345	3	13	61	0.2131148
NODE_21018_length_641_cov_38.675277	284	345	4	17	61	0.2786885
NODE_21018_length_641_cov_38.675277	318	369	3	10	51	0.1960784
NODE_21018_length_641_cov_38.675277	318	369	4	41	51	0.8039216
NODE_21019_length_641_cov_15.271218	260	340	4	23	80	0.2875000
NODE_21019_length_641_cov_15.271218	260	340	5	29	80	0.3625000
NODE_21019_length_641_cov_15.271218	260	340	7	26	80	0.3250000
NODE_21019_length_641_cov_15.271218	260	340	8	2	80	0.0250000
NODE_21019_length_641_cov_15.271218	313	393	5	41	80	0.5125000
NODE_21019_length_641_cov_15.271218	313	393	6	3	80	0.0375000
NODE_21019_length_641_cov_15.271218	313	393	7	34	80	0.4250000
NODE_21019_length_641_cov_15.271218	313	393	8	2	80	0.0250000
NODE_21021_length_641_cov_12.584871	363	443	8	2	80	0.0250000
NODE_21021_length_641_cov_12.584871	363	443	10	1	80	0.0125000
NODE_21021_length_641_cov_12.584871	363	443	11	62	80	0.7750000
NODE_21021_length_641_cov_12.584871	363	443	12	15	80	0.1875000
NODE_21021_length_641_cov_12.584871	416	496	3	17	80	0.2125000
NODE_21021_length_641_cov_12.584871	416	496	5	13	80	0.1625000
NODE_21021_length_641_cov_12.584871	416	496	6	3	80	0.0375000
NODE_21021_length_641_cov_12.584871	416	496	7	15	80	0.1875000
NODE_21021_length_641_cov_12.584871	416	496	8	7	80	0.0875000
NODE_21021_length_641_cov_12.584871	416	496	11	25	80	0.3125000
NODE_21022_length_641_cov_11.125461	38	118	2	50	80	0.6250000
NODE_21022_length_641_cov_11.125461	38	118	4	7	80	0.0875000
NODE_21022_length_641_cov_11.125461	38	118	5	23	80	0.2875000
NODE_21022_length_641_cov_11.125461	91	171	4	40	80	0.5000000
NODE_21022_length_641_cov_11.125461	91	171	5	32	80	0.4000000
NODE_21022_length_641_cov_11.125461	91	171	6	8	80	0.1000000
NODE_21025_length_641_cov_7.719557	84	138	0	3	54	0.0555556
NODE_21025_length_641_cov_7.719557	84	138	2	51	54	0.9444444
NODE_21025_length_641_cov_7.719557	113	193	2	80	80	1.0000000
NODE_21026_length_641_cov_7.675277	232	312	1	68	80	0.8500000
NODE_21026_length_641_cov_7.675277	232	312	2	12	80	0.1500000
NODE_21026_length_641_cov_7.675277	285	365	0	43	80	0.5375000
NODE_21026_length_641_cov_7.675277	285	365	1	37	80	0.4625000
NODE_21027_length_641_cov_7.675277	255	335	1	3	80	0.0375000
NODE_21027_length_641_cov_7.675277	255	335	2	18	80	0.2250000
NODE_21027_length_641_cov_7.675277	255	335	3	59	80	0.7375000
NODE_21027_length_641_cov_7.675277	308	388	0	53	80	0.6625000
NODE_21027_length_641_cov_7.675277	308	388	2	18	80	0.2250000
NODE_21027_length_641_cov_7.675277	308	388	3	9	80	0.1125000
NODE_21028_length_641_cov_7.627306	262	342	7	16	80	0.2000000
NODE_21028_length_641_cov_7.627306	262	342	8	40	80	0.5000000
NODE_21028_length_641_cov_7.627306	262	342	9	24	80	0.3000000
NODE_21028_length_641_cov_7.627306	315	395	6	24	80	0.3000000
NODE_21028_length_641_cov_7.627306	315	395	7	13	80	0.1625000
NODE_21028_length_641_cov_7.627306	315	395	8	35	80	0.4375000
NODE_21028_length_641_cov_7.627306	315	395	9	8	80	0.1000000
NODE_21029_length_641_cov_7.282288	247	300	0	53	53	1.0000000
NODE_21031_length_641_cov_5.029520	138	218	0	34	80	0.4250000
NODE_21031_length_641_cov_5.029520	138	218	1	9	80	0.1125000
NODE_21031_length_641_cov_5.029520	138	218	3	37	80	0.4625000
NODE_21031_length_641_cov_5.029520	191	271	3	56	80	0.7000000
NODE_21031_length_641_cov_5.029520	191	271	4	24	80	0.3000000
NODE_21034_length_641_cov_4.701107	238	282	0	44	44	1.0000000
NODE_21109_length_640_cov_39.676525	524	597	10	3	73	0.0410959
NODE_21109_length_640_cov_39.676525	524	597	11	1	73	0.0136986
NODE_21109_length_640_cov_39.676525	524	597	12	10	73	0.1369863
NODE_21109_length_640_cov_39.676525	524	597	14	7	73	0.0958904
NODE_21109_length_640_cov_39.676525	524	597	15	2	73	0.0273973
NODE_21109_length_640_cov_39.676525	524	597	17	13	73	0.1780822
NODE_21109_length_640_cov_39.676525	524	597	18	14	73	0.1917808
NODE_21109_length_640_cov_39.676525	524	597	20	6	73	0.0821918
NODE_21109_length_640_cov_39.676525	524	597	21	17	73	0.2328767
NODE_21109_length_640_cov_39.676525	564	605	8	5	41	0.1219512
NODE_21109_length_640_cov_39.676525	564	605	10	6	41	0.1463415
NODE_21109_length_640_cov_39.676525	564	605	11	1	41	0.0243902
NODE_21109_length_640_cov_39.676525	564	605	12	10	41	0.2439024
NODE_21109_length_640_cov_39.676525	564	605	14	7	41	0.1707317
NODE_21109_length_640_cov_39.676525	564	605	15	2	41	0.0487805
NODE_21109_length_640_cov_39.676525	564	605	17	10	41	0.2439024
NODE_21110_length_640_cov_19.578558	273	353	1	15	80	0.1875000
NODE_21110_length_640_cov_19.578558	273	353	2	1	80	0.0125000
NODE_21110_length_640_cov_19.578558	273	353	3	64	80	0.8000000
NODE_21110_length_640_cov_19.578558	326	406	3	80	80	1.0000000
NODE_21111_length_640_cov_15.717190	178	258	2	1	80	0.0125000
NODE_21111_length_640_cov_15.717190	178	258	3	79	80	0.9875000
NODE_21111_length_640_cov_15.717190	231	311	3	80	80	1.0000000
NODE_21112_length_640_cov_15.338262	319	399	0	1	80	0.0125000
NODE_21112_length_640_cov_15.338262	319	399	1	29	80	0.3625000
NODE_21112_length_640_cov_15.338262	319	399	2	50	80	0.6250000
NODE_21112_length_640_cov_15.338262	372	452	2	80	80	1.0000000
NODE_21113_length_640_cov_9.523105	20	43	0	23	23	1.0000000
NODE_21118_length_640_cov_5.123845	272	335	3	63	63	1.0000000
NODE_21121_length_640_cov_4.410351	254	334	7	7	80	0.0875000
NODE_21121_length_640_cov_4.410351	254	334	8	43	80	0.5375000
NODE_21121_length_640_cov_4.410351	254	334	10	30	80	0.3750000
NODE_21121_length_640_cov_4.410351	307	387	2	5	80	0.0625000
NODE_21121_length_640_cov_4.410351	307	387	3	3	80	0.0375000
NODE_21121_length_640_cov_4.410351	307	387	7	11	80	0.1375000
NODE_21121_length_640_cov_4.410351	307	387	8	61	80	0.7625000
NODE_21129_length_640_cov_3.406654	244	324	0	80	80	1.0000000
NODE_21140_length_640_cov_2.316081	21	57	0	36	36	1.0000000
NODE_21190_length_639_cov_58.092593	302	377	0	75	75	1.0000000
NODE_21190_length_639_cov_58.092593	350	430	0	80	80	1.0000000
NODE_21191_length_639_cov_32.951852	213	293	14	19	80	0.2375000
NODE_21191_length_639_cov_32.951852	213	293	15	28	80	0.3500000
NODE_21191_length_639_cov_32.951852	213	293	16	5	80	0.0625000
NODE_21191_length_639_cov_32.951852	213	293	17	14	80	0.1750000
NODE_21191_length_639_cov_32.951852	213	293	18	14	80	0.1750000
NODE_21191_length_639_cov_32.951852	266	346	10	2	80	0.0250000
NODE_21191_length_639_cov_32.951852	266	346	11	7	80	0.0875000
NODE_21191_length_639_cov_32.951852	266	346	13	2	80	0.0250000
NODE_21191_length_639_cov_32.951852	266	346	14	6	80	0.0750000
NODE_21191_length_639_cov_32.951852	266	346	15	16	80	0.2000000
NODE_21191_length_639_cov_32.951852	266	346	16	11	80	0.1375000
NODE_21191_length_639_cov_32.951852	266	346	17	23	80	0.2875000
NODE_21191_length_639_cov_32.951852	266	346	18	13	80	0.1625000
NODE_21192_length_639_cov_24.564815	290	370	2	2	80	0.0250000
NODE_21192_length_639_cov_24.564815	290	370	3	29	80	0.3625000
NODE_21192_length_639_cov_24.564815	290	370	4	49	80	0.6125000
NODE_21192_length_639_cov_24.564815	343	423	0	23	80	0.2875000
NODE_21192_length_639_cov_24.564815	343	423	2	14	80	0.1750000
NODE_21192_length_639_cov_24.564815	343	423	3	35	80	0.4375000
NODE_21192_length_639_cov_24.564815	343	423	4	8	80	0.1000000
NODE_21193_length_639_cov_14.448148	288	368	3	30	80	0.3750000
NODE_21193_length_639_cov_14.448148	288	368	4	50	80	0.6250000
NODE_21193_length_639_cov_14.448148	341	421	2	13	80	0.1625000
NODE_21193_length_639_cov_14.448148	341	421	3	51	80	0.6375000
NODE_21193_length_639_cov_14.448148	341	421	4	16	80	0.2000000
NODE_21195_length_639_cov_9.001852	265	345	1	12	80	0.1500000
NODE_21195_length_639_cov_9.001852	265	345	2	26	80	0.3250000
NODE_21195_length_639_cov_9.001852	265	345	3	42	80	0.5250000
NODE_21195_length_639_cov_9.001852	318	398	1	36	80	0.4500000
NODE_21195_length_639_cov_9.001852	318	398	2	43	80	0.5375000
NODE_21195_length_639_cov_9.001852	318	398	3	1	80	0.0125000
NODE_21197_length_639_cov_8.444444	161	241	3	1	80	0.0125000
NODE_21197_length_639_cov_8.444444	161	241	5	5	80	0.0625000
NODE_21197_length_639_cov_8.444444	161	241	7	18	80	0.2250000
NODE_21197_length_639_cov_8.444444	161	241	8	56	80	0.7000000
NODE_21197_length_639_cov_8.444444	214	294	4	16	80	0.2000000
NODE_21197_length_639_cov_8.444444	214	294	5	12	80	0.1500000
NODE_21197_length_639_cov_8.444444	214	294	6	5	80	0.0625000
NODE_21197_length_639_cov_8.444444	214	294	7	1	80	0.0125000
NODE_21197_length_639_cov_8.444444	214	294	8	46	80	0.5750000
NODE_21202_length_639_cov_6.283333	157	176	3	18	19	0.9473684
NODE_21202_length_639_cov_6.283333	157	176	4	1	19	0.0526316
NODE_21207_length_639_cov_4.188889	258	335	0	77	77	1.0000000
NODE_21207_length_639_cov_4.188889	308	354	0	46	46	1.0000000
NODE_21213_length_639_cov_3.448148	126	206	0	80	80	1.0000000
NODE_21213_length_639_cov_3.448148	179	259	0	80	80	1.0000000
NODE_21223_length_639_cov_2.683333	256	288	1	32	32	1.0000000
NODE_21224_length_639_cov_2.555556	189	240	2	6	51	0.1176471
NODE_21224_length_639_cov_2.555556	189	240	4	45	51	0.8823529
NODE_21225_length_639_cov_2.477778	562	635	0	71	73	0.9726027
NODE_21225_length_639_cov_2.477778	562	635	1	2	73	0.0273973
NODE_21265_length_639_cov_1.179630	542	564	0	22	22	1.0000000
NODE_21269_length_639_cov_1.051852	404	455	0	51	51	1.0000000
NODE_21278_length_638_cov_13.018553	273	353	1	24	80	0.3000000
NODE_21278_length_638_cov_13.018553	273	353	2	19	80	0.2375000
NODE_21278_length_638_cov_13.018553	273	353	3	37	80	0.4625000
NODE_21278_length_638_cov_13.018553	326	406	3	80	80	1.0000000
NODE_21279_length_638_cov_12.656772	343	423	1	51	80	0.6375000
NODE_21279_length_638_cov_12.656772	343	423	2	29	80	0.3625000
NODE_21279_length_638_cov_12.656772	396	476	2	49	80	0.6125000
NODE_21279_length_638_cov_12.656772	396	476	3	10	80	0.1250000
NODE_21279_length_638_cov_12.656772	396	476	4	21	80	0.2625000
NODE_21280_length_638_cov_11.877551	298	378	0	80	80	1.0000000
NODE_21280_length_638_cov_11.877551	351	431	0	80	80	1.0000000
NODE_21281_length_638_cov_8.779221	330	408	0	1	78	0.0128205
NODE_21281_length_638_cov_8.779221	330	408	1	20	78	0.2564103
NODE_21281_length_638_cov_8.779221	330	408	2	57	78	0.7307692
NODE_21281_length_638_cov_8.779221	383	461	2	78	78	1.0000000
NODE_21284_length_638_cov_5.543599	315	395	0	80	80	1.0000000
NODE_21290_length_638_cov_3.966605	307	387	0	80	80	1.0000000
NODE_21301_length_638_cov_2.786642	157	208	0	51	51	1.0000000
NODE_21301_length_638_cov_2.786642	181	261	0	80	80	1.0000000
NODE_21364_length_637_cov_67.157993	285	365	1	29	80	0.3625000
NODE_21364_length_637_cov_67.157993	285	365	2	18	80	0.2250000
NODE_21364_length_637_cov_67.157993	285	365	3	33	80	0.4125000
NODE_21364_length_637_cov_67.157993	338	418	3	35	80	0.4375000
NODE_21364_length_637_cov_67.157993	338	418	4	45	80	0.5625000
NODE_21364_length_637_cov_67.157993	414	494	4	19	80	0.2375000
NODE_21364_length_637_cov_67.157993	414	494	5	1	80	0.0125000
NODE_21364_length_637_cov_67.157993	414	494	6	12	80	0.1500000
NODE_21364_length_637_cov_67.157993	414	494	7	30	80	0.3750000
NODE_21364_length_637_cov_67.157993	414	494	8	18	80	0.2250000
NODE_21364_length_637_cov_67.157993	467	547	4	22	80	0.2750000
NODE_21364_length_637_cov_67.157993	467	547	5	5	80	0.0625000
NODE_21364_length_637_cov_67.157993	467	547	6	38	80	0.4750000
NODE_21364_length_637_cov_67.157993	467	547	7	15	80	0.1875000
NODE_21365_length_637_cov_63.029740	195	275	2	32	80	0.4000000
NODE_21365_length_637_cov_63.029740	195	275	4	3	80	0.0375000
NODE_21365_length_637_cov_63.029740	195	275	5	19	80	0.2375000
NODE_21365_length_637_cov_63.029740	195	275	6	10	80	0.1250000
NODE_21365_length_637_cov_63.029740	195	275	7	16	80	0.2000000
NODE_21365_length_637_cov_63.029740	248	328	5	9	80	0.1125000
NODE_21365_length_637_cov_63.029740	248	328	6	20	80	0.2500000
NODE_21365_length_637_cov_63.029740	248	328	7	51	80	0.6375000
NODE_21366_length_637_cov_44.923792	53	133	0	80	80	1.0000000
NODE_21366_length_637_cov_44.923792	54	133	0	79	79	1.0000000
NODE_21366_length_637_cov_44.923792	106	186	0	80	80	1.0000000
NODE_21366_length_637_cov_44.923792	106	186	0	80	80	1.0000000
NODE_21366_length_637_cov_44.923792	182	262	0	80	80	1.0000000
NODE_21366_length_637_cov_44.923792	235	315	0	80	80	1.0000000
NODE_21367_length_637_cov_44.193309	193	273	1	3	80	0.0375000
NODE_21367_length_637_cov_44.193309	193	273	2	2	80	0.0250000
NODE_21367_length_637_cov_44.193309	193	273	4	2	80	0.0250000
NODE_21367_length_637_cov_44.193309	193	273	5	12	80	0.1500000
NODE_21367_length_637_cov_44.193309	193	273	7	56	80	0.7000000
NODE_21367_length_637_cov_44.193309	193	273	8	1	80	0.0125000
NODE_21367_length_637_cov_44.193309	193	273	9	4	80	0.0500000
NODE_21367_length_637_cov_44.193309	246	326	7	34	80	0.4250000
NODE_21367_length_637_cov_44.193309	246	326	8	30	80	0.3750000
NODE_21367_length_637_cov_44.193309	246	326	9	16	80	0.2000000
NODE_21368_length_637_cov_37.855019	215	295	8	1	80	0.0125000
NODE_21368_length_637_cov_37.855019	215	295	9	6	80	0.0750000
NODE_21368_length_637_cov_37.855019	215	295	10	67	80	0.8375000
NODE_21368_length_637_cov_37.855019	215	295	11	6	80	0.0750000
NODE_21368_length_637_cov_37.855019	268	347	8	12	79	0.1518987
NODE_21368_length_637_cov_37.855019	268	347	9	2	79	0.0253165
NODE_21368_length_637_cov_37.855019	268	347	10	52	79	0.6582279
NODE_21368_length_637_cov_37.855019	268	347	11	13	79	0.1645570
NODE_21369_length_637_cov_33.957249	332	412	12	31	80	0.3875000
NODE_21369_length_637_cov_33.957249	332	412	13	8	80	0.1000000
NODE_21369_length_637_cov_33.957249	332	412	14	33	80	0.4125000
NODE_21369_length_637_cov_33.957249	332	412	15	8	80	0.1000000
NODE_21369_length_637_cov_33.957249	385	465	3	5	80	0.0625000
NODE_21369_length_637_cov_33.957249	385	465	4	13	80	0.1625000
NODE_21369_length_637_cov_33.957249	385	465	5	1	80	0.0125000
NODE_21369_length_637_cov_33.957249	385	465	6	23	80	0.2875000
NODE_21369_length_637_cov_33.957249	385	465	7	3	80	0.0375000
NODE_21369_length_637_cov_33.957249	385	465	9	2	80	0.0250000
NODE_21369_length_637_cov_33.957249	385	465	11	2	80	0.0250000
NODE_21369_length_637_cov_33.957249	385	465	12	21	80	0.2625000
NODE_21369_length_637_cov_33.957249	385	465	13	10	80	0.1250000
NODE_21370_length_637_cov_23.682156	275	355	4	4	80	0.0500000
NODE_21370_length_637_cov_23.682156	275	355	5	6	80	0.0750000
NODE_21370_length_637_cov_23.682156	275	355	6	16	80	0.2000000
NODE_21370_length_637_cov_23.682156	275	355	7	14	80	0.1750000
NODE_21370_length_637_cov_23.682156	275	355	8	40	80	0.5000000
NODE_21370_length_637_cov_23.682156	328	408	6	42	80	0.5250000
NODE_21370_length_637_cov_23.682156	328	408	7	6	80	0.0750000
NODE_21370_length_637_cov_23.682156	328	408	8	32	80	0.4000000
NODE_21371_length_637_cov_19.676580	267	347	7	13	80	0.1625000
NODE_21371_length_637_cov_19.676580	267	347	8	10	80	0.1250000
NODE_21371_length_637_cov_19.676580	267	347	9	11	80	0.1375000
NODE_21371_length_637_cov_19.676580	267	347	10	6	80	0.0750000
NODE_21371_length_637_cov_19.676580	267	347	12	13	80	0.1625000
NODE_21371_length_637_cov_19.676580	267	347	13	2	80	0.0250000
NODE_21371_length_637_cov_19.676580	267	347	14	23	80	0.2875000
NODE_21371_length_637_cov_19.676580	267	347	15	2	80	0.0250000
NODE_21371_length_637_cov_19.676580	320	400	11	2	80	0.0250000
NODE_21371_length_637_cov_19.676580	320	400	13	16	80	0.2000000
NODE_21371_length_637_cov_19.676580	320	400	14	23	80	0.2875000
NODE_21371_length_637_cov_19.676580	320	400	15	39	80	0.4875000
NODE_21373_length_637_cov_9.182156	226	276	0	50	50	1.0000000
NODE_21373_length_637_cov_9.182156	312	357	0	45	45	1.0000000
NODE_21374_length_637_cov_9.078067	276	357	0	21	81	0.2592593
NODE_21374_length_637_cov_9.078067	276	357	1	18	81	0.2222222
NODE_21374_length_637_cov_9.078067	276	357	2	11	81	0.1358025
NODE_21374_length_637_cov_9.078067	276	357	3	31	81	0.3827161
NODE_21374_length_637_cov_9.078067	330	410	0	9	80	0.1125000
NODE_21374_length_637_cov_9.078067	330	410	1	71	80	0.8875000
NODE_21375_length_637_cov_8.566914	235	315	1	16	80	0.2000000
NODE_21375_length_637_cov_8.566914	235	315	2	64	80	0.8000000
NODE_21375_length_637_cov_8.566914	288	368	1	3	80	0.0375000
NODE_21375_length_637_cov_8.566914	288	368	2	77	80	0.9625000
NODE_21378_length_637_cov_6.652416	337	415	1	10	78	0.1282051
NODE_21378_length_637_cov_6.652416	337	415	2	10	78	0.1282051
NODE_21378_length_637_cov_6.652416	337	415	3	58	78	0.7435898
NODE_21378_length_637_cov_6.652416	390	472	1	67	82	0.8170732
NODE_21378_length_637_cov_6.652416	390	472	3	15	82	0.1829268
NODE_21385_length_637_cov_4.522305	284	364	0	80	80	1.0000000
NODE_21385_length_637_cov_4.522305	337	417	0	80	80	1.0000000
NODE_21389_length_637_cov_4.131970	292	370	3	4	78	0.0512821
NODE_21389_length_637_cov_4.131970	292	370	4	23	78	0.2948718
NODE_21389_length_637_cov_4.131970	292	370	5	42	78	0.5384616
NODE_21389_length_637_cov_4.131970	292	370	6	9	78	0.1153846
NODE_21389_length_637_cov_4.131970	343	423	2	42	80	0.5250000
NODE_21389_length_637_cov_4.131970	343	423	3	15	80	0.1875000
NODE_21389_length_637_cov_4.131970	343	423	4	1	80	0.0125000
NODE_21389_length_637_cov_4.131970	343	423	5	22	80	0.2750000
NODE_21457_length_636_cov_19.938547	214	294	2	18	80	0.2250000
NODE_21457_length_636_cov_19.938547	214	294	4	62	80	0.7750000
NODE_21457_length_636_cov_19.938547	267	347	3	6	80	0.0750000
NODE_21457_length_636_cov_19.938547	267	347	4	69	80	0.8625000
NODE_21457_length_636_cov_19.938547	267	347	5	5	80	0.0625000
NODE_21458_length_636_cov_12.283054	295	375	0	80	80	1.0000000
NODE_21458_length_636_cov_12.283054	348	428	0	80	80	1.0000000
NODE_21460_length_636_cov_8.312849	346	413	2	37	67	0.5522388
NODE_21460_length_636_cov_8.312849	346	413	4	30	67	0.4477612
NODE_21460_length_636_cov_8.312849	399	479	0	59	80	0.7375000
NODE_21460_length_636_cov_8.312849	399	479	2	21	80	0.2625000
NODE_21467_length_636_cov_4.324022	185	251	0	66	66	1.0000000
NODE_21467_length_636_cov_4.324022	224	266	0	42	42	1.0000000
NODE_21467_length_636_cov_4.324022	224	264	0	40	40	1.0000000
NODE_21539_length_635_cov_45.483209	195	239	20	1	44	0.0227273
NODE_21539_length_635_cov_45.483209	195	239	22	9	44	0.2045455
NODE_21539_length_635_cov_45.483209	195	239	23	17	44	0.3863636
NODE_21539_length_635_cov_45.483209	195	239	24	10	44	0.2272727
NODE_21539_length_635_cov_45.483209	195	239	25	7	44	0.1590909
NODE_21539_length_635_cov_45.483209	225	268	19	2	43	0.0465116
NODE_21539_length_635_cov_45.483209	225	268	20	1	43	0.0232558
NODE_21539_length_635_cov_45.483209	225	268	21	5	43	0.1162791
NODE_21539_length_635_cov_45.483209	225	268	22	6	43	0.1395349
NODE_21539_length_635_cov_45.483209	225	268	23	9	43	0.2093023
NODE_21539_length_635_cov_45.483209	225	268	24	6	43	0.1395349
NODE_21539_length_635_cov_45.483209	225	268	25	14	43	0.3255814
NODE_21539_length_635_cov_45.483209	248	298	16	3	50	0.0600000
NODE_21539_length_635_cov_45.483209	248	298	18	3	50	0.0600000
NODE_21539_length_635_cov_45.483209	248	298	19	17	50	0.3400000
NODE_21539_length_635_cov_45.483209	248	298	20	1	50	0.0200000
NODE_21539_length_635_cov_45.483209	248	298	21	14	50	0.2800000
NODE_21539_length_635_cov_45.483209	248	298	22	6	50	0.1200000
NODE_21539_length_635_cov_45.483209	248	298	23	3	50	0.0600000
NODE_21539_length_635_cov_45.483209	248	298	24	2	50	0.0400000
NODE_21539_length_635_cov_45.483209	248	298	25	1	50	0.0200000
NODE_21541_length_635_cov_23.895522	179	259	0	80	80	1.0000000
NODE_21541_length_635_cov_23.895522	232	312	0	80	80	1.0000000
NODE_21543_length_635_cov_14.772388	48	128	0	80	80	1.0000000
NODE_21543_length_635_cov_14.772388	101	181	0	80	80	1.0000000
NODE_21549_length_635_cov_6.180970	276	356	0	11	80	0.1375000
NODE_21549_length_635_cov_6.180970	276	356	2	69	80	0.8625000
NODE_21549_length_635_cov_6.180970	329	409	0	17	80	0.2125000
NODE_21549_length_635_cov_6.180970	329	409	2	63	80	0.7875000
NODE_21554_length_635_cov_4.421642	442	522	0	80	80	1.0000000
NODE_21560_length_635_cov_2.985075	296	376	6	25	80	0.3125000
NODE_21560_length_635_cov_2.985075	296	376	8	55	80	0.6875000
NODE_21625_length_634_cov_53.315888	349	429	8	44	80	0.5500000
NODE_21625_length_634_cov_53.315888	349	429	9	27	80	0.3375000
NODE_21625_length_634_cov_53.315888	349	429	10	9	80	0.1125000
NODE_21625_length_634_cov_53.315888	402	482	5	15	80	0.1875000
NODE_21625_length_634_cov_53.315888	402	482	6	20	80	0.2500000
NODE_21625_length_634_cov_53.315888	402	482	7	15	80	0.1875000
NODE_21625_length_634_cov_53.315888	402	482	8	30	80	0.3750000
NODE_21626_length_634_cov_28.530841	156	236	8	6	80	0.0750000
NODE_21626_length_634_cov_28.530841	156	236	10	17	80	0.2125000
NODE_21626_length_634_cov_28.530841	156	236	12	15	80	0.1875000
NODE_21626_length_634_cov_28.530841	156	236	14	21	80	0.2625000
NODE_21626_length_634_cov_28.530841	156	236	15	15	80	0.1875000
NODE_21626_length_634_cov_28.530841	156	236	16	6	80	0.0750000
NODE_21626_length_634_cov_28.530841	209	289	12	6	80	0.0750000
NODE_21626_length_634_cov_28.530841	209	289	13	9	80	0.1125000
NODE_21626_length_634_cov_28.530841	209	289	14	23	80	0.2875000
NODE_21626_length_634_cov_28.530841	209	289	15	22	80	0.2750000
NODE_21626_length_634_cov_28.530841	209	289	16	9	80	0.1125000
NODE_21626_length_634_cov_28.530841	209	289	17	11	80	0.1375000
NODE_21627_length_634_cov_19.117757	151	229	0	78	78	1.0000000
NODE_21627_length_634_cov_19.117757	204	268	0	64	64	1.0000000
NODE_21628_length_634_cov_18.762617	84	164	1	9	80	0.1125000
NODE_21628_length_634_cov_18.762617	84	164	2	71	80	0.8875000
NODE_21628_length_634_cov_18.762617	137	217	1	46	80	0.5750000
NODE_21628_length_634_cov_18.762617	137	217	2	34	80	0.4250000
NODE_21629_length_634_cov_18.136449	162	242	1	9	80	0.1125000
NODE_21629_length_634_cov_18.136449	162	242	2	29	80	0.3625000
NODE_21629_length_634_cov_18.136449	162	242	4	42	80	0.5250000
NODE_21629_length_634_cov_18.136449	215	295	4	59	80	0.7375000
NODE_21629_length_634_cov_18.136449	215	295	5	21	80	0.2625000
NODE_21635_length_634_cov_9.988785	508	553	0	45	45	1.0000000
NODE_21636_length_634_cov_9.381308	267	353	2	21	86	0.2441860
NODE_21636_length_634_cov_9.381308	267	353	4	65	86	0.7558140
NODE_21636_length_634_cov_9.381308	324	404	2	1	80	0.0125000
NODE_21636_length_634_cov_9.381308	324	404	4	79	80	0.9875000
NODE_21651_length_634_cov_3.702804	460	532	0	72	72	1.0000000
NODE_21720_length_633_cov_30.076779	180	214	0	30	34	0.8823529
NODE_21720_length_633_cov_30.076779	180	214	1	4	34	0.1176471
NODE_21720_length_633_cov_30.076779	187	267	0	23	80	0.2875000
NODE_21720_length_633_cov_30.076779	187	267	1	45	80	0.5625000
NODE_21720_length_633_cov_30.076779	187	267	2	12	80	0.1500000
NODE_21720_length_633_cov_30.076779	263	343	2	11	80	0.1375000
NODE_21720_length_633_cov_30.076779	263	343	3	7	80	0.0875000
NODE_21720_length_633_cov_30.076779	263	343	4	62	80	0.7750000
NODE_21720_length_633_cov_30.076779	316	396	4	70	80	0.8750000
NODE_21720_length_633_cov_30.076779	316	396	5	10	80	0.1250000
NODE_21721_length_633_cov_17.595506	282	362	5	12	80	0.1500000
NODE_21721_length_633_cov_17.595506	282	362	6	68	80	0.8500000
NODE_21721_length_633_cov_17.595506	335	415	1	21	80	0.2625000
NODE_21721_length_633_cov_17.595506	335	415	2	13	80	0.1625000
NODE_21721_length_633_cov_17.595506	335	415	4	2	80	0.0250000
NODE_21721_length_633_cov_17.595506	335	415	5	29	80	0.3625000
NODE_21721_length_633_cov_17.595506	335	415	6	15	80	0.1875000
NODE_21722_length_633_cov_17.327715	228	308	3	28	80	0.3500000
NODE_21722_length_633_cov_17.327715	228	308	4	36	80	0.4500000
NODE_21722_length_633_cov_17.327715	228	308	5	16	80	0.2000000
NODE_21722_length_633_cov_17.327715	281	361	3	4	80	0.0500000
NODE_21722_length_633_cov_17.327715	281	361	4	11	80	0.1375000
NODE_21722_length_633_cov_17.327715	281	361	5	65	80	0.8125000
NODE_21723_length_633_cov_9.689139	79	147	0	68	68	1.0000000
NODE_21729_length_633_cov_7.018727	309	389	1	80	80	1.0000000
NODE_21729_length_633_cov_7.018727	362	442	0	41	80	0.5125000
NODE_21729_length_633_cov_7.018727	362	442	1	39	80	0.4875000
NODE_21755_length_633_cov_2.644195	166	240	0	2	74	0.0270270
NODE_21755_length_633_cov_2.644195	166	240	1	72	74	0.9729730
NODE_21816_length_632_cov_25.425891	332	412	7	7	80	0.0875000
NODE_21816_length_632_cov_25.425891	332	412	8	34	80	0.4250000
NODE_21816_length_632_cov_25.425891	332	412	10	39	80	0.4875000
NODE_21816_length_632_cov_25.425891	385	465	1	14	80	0.1750000
NODE_21816_length_632_cov_25.425891	385	465	4	9	80	0.1125000
NODE_21816_length_632_cov_25.425891	385	465	5	24	80	0.3000000
NODE_21816_length_632_cov_25.425891	385	465	7	13	80	0.1625000
NODE_21816_length_632_cov_25.425891	385	465	8	20	80	0.2500000
NODE_21817_length_632_cov_21.613508	243	323	2	43	80	0.5375000
NODE_21817_length_632_cov_21.613508	243	323	4	37	80	0.4625000
NODE_21817_length_632_cov_21.613508	296	376	2	30	80	0.3750000
NODE_21817_length_632_cov_21.613508	296	376	4	50	80	0.6250000
NODE_21818_length_632_cov_16.465291	293	373	1	80	80	1.0000000
NODE_21818_length_632_cov_16.465291	346	426	0	27	80	0.3375000
NODE_21818_length_632_cov_16.465291	346	426	1	53	80	0.6625000
NODE_21819_length_632_cov_13.260788	232	312	7	1	80	0.0125000
NODE_21819_length_632_cov_13.260788	232	312	8	19	80	0.2375000
NODE_21819_length_632_cov_13.260788	232	312	9	13	80	0.1625000
NODE_21819_length_632_cov_13.260788	232	312	10	35	80	0.4375000
NODE_21819_length_632_cov_13.260788	232	312	11	12	80	0.1500000
NODE_21819_length_632_cov_13.260788	285	365	6	25	80	0.3125000
NODE_21819_length_632_cov_13.260788	285	365	7	2	80	0.0250000
NODE_21819_length_632_cov_13.260788	285	365	8	14	80	0.1750000
NODE_21819_length_632_cov_13.260788	285	365	9	8	80	0.1000000
NODE_21819_length_632_cov_13.260788	285	365	10	19	80	0.2375000
NODE_21819_length_632_cov_13.260788	285	365	11	12	80	0.1500000
NODE_21821_length_632_cov_9.106942	188	268	0	80	80	1.0000000
NODE_21821_length_632_cov_9.106942	241	321	0	80	80	1.0000000
NODE_21834_length_632_cov_4.135084	229	309	1	17	80	0.2125000
NODE_21834_length_632_cov_4.135084	229	309	2	55	80	0.6875000
NODE_21834_length_632_cov_4.135084	229	309	3	3	80	0.0375000
NODE_21834_length_632_cov_4.135084	229	309	4	5	80	0.0625000
NODE_21834_length_632_cov_4.135084	282	359	1	67	77	0.8701299
NODE_21834_length_632_cov_4.135084	282	359	2	10	77	0.1298701
NODE_21841_length_632_cov_2.939962	216	274	3	39	58	0.6724138
NODE_21841_length_632_cov_2.939962	216	274	4	19	58	0.3275862
NODE_21841_length_632_cov_2.939962	247	327	2	10	80	0.1250000
NODE_21841_length_632_cov_2.939962	247	327	3	16	80	0.2000000
NODE_21841_length_632_cov_2.939962	247	327	4	54	80	0.6750000
NODE_21848_length_632_cov_2.330206	57	76	0	19	19	1.0000000
NODE_21912_length_631_cov_31.469925	321	396	0	75	75	1.0000000
NODE_21912_length_631_cov_31.469925	369	449	0	80	80	1.0000000
NODE_21913_length_631_cov_26.453008	383	463	0	80	80	1.0000000
NODE_21913_length_631_cov_26.453008	436	516	0	80	80	1.0000000
NODE_21917_length_631_cov_8.374060	318	398	2	36	80	0.4500000
NODE_21917_length_631_cov_8.374060	318	398	3	5	80	0.0625000
NODE_21917_length_631_cov_8.374060	318	398	5	35	80	0.4375000
NODE_21917_length_631_cov_8.374060	318	398	6	4	80	0.0500000
NODE_21917_length_631_cov_8.374060	371	451	1	11	80	0.1375000
NODE_21917_length_631_cov_8.374060	371	451	2	69	80	0.8625000
NODE_21924_length_631_cov_5.507519	335	386	2	51	51	1.0000000
NODE_21927_length_631_cov_5.227444	443	523	0	80	80	1.0000000
NODE_21927_length_631_cov_5.227444	496	576	0	80	80	1.0000000
NODE_21942_length_631_cov_2.926692	307	354	0	47	47	1.0000000
NODE_21983_length_631_cov_1.383459	248	267	0	19	19	1.0000000
NODE_22011_length_630_cov_41.728814	6	86	0	68	80	0.8500000
NODE_22011_length_630_cov_41.728814	6	86	1	1	80	0.0125000
NODE_22011_length_630_cov_41.728814	6	86	2	11	80	0.1375000
NODE_22011_length_630_cov_41.728814	59	139	0	15	80	0.1875000
NODE_22011_length_630_cov_41.728814	59	139	1	1	80	0.0125000
NODE_22011_length_630_cov_41.728814	59	139	2	64	80	0.8000000
NODE_22012_length_630_cov_24.856874	421	501	3	1	80	0.0125000
NODE_22012_length_630_cov_24.856874	421	501	4	18	80	0.2250000
NODE_22012_length_630_cov_24.856874	421	501	5	2	80	0.0250000
NODE_22012_length_630_cov_24.856874	421	501	6	59	80	0.7375000
NODE_22012_length_630_cov_24.856874	474	554	3	6	80	0.0750000
NODE_22012_length_630_cov_24.856874	474	554	4	43	80	0.5375000
NODE_22012_length_630_cov_24.856874	474	554	6	31	80	0.3875000
NODE_22013_length_630_cov_14.323917	196	276	2	33	80	0.4125000
NODE_22013_length_630_cov_14.323917	196	276	4	37	80	0.4625000
NODE_22013_length_630_cov_14.323917	196	276	6	10	80	0.1250000
NODE_22013_length_630_cov_14.323917	249	329	4	17	80	0.2125000
NODE_22013_length_630_cov_14.323917	249	329	6	59	80	0.7375000
NODE_22013_length_630_cov_14.323917	249	329	7	4	80	0.0500000
NODE_22014_length_630_cov_9.964218	284	364	0	80	80	1.0000000
NODE_22014_length_630_cov_9.964218	337	417	0	80	80	1.0000000
NODE_22086_length_629_cov_38.271698	288	368	6	7	80	0.0875000
NODE_22086_length_629_cov_38.271698	288	368	8	1	80	0.0125000
NODE_22086_length_629_cov_38.271698	288	368	9	10	80	0.1250000
NODE_22086_length_629_cov_38.271698	288	368	11	2	80	0.0250000
NODE_22086_length_629_cov_38.271698	288	368	12	1	80	0.0125000
NODE_22086_length_629_cov_38.271698	288	368	13	1	80	0.0125000
NODE_22086_length_629_cov_38.271698	288	368	14	14	80	0.1750000
NODE_22086_length_629_cov_38.271698	288	368	15	44	80	0.5500000
NODE_22086_length_629_cov_38.271698	341	421	11	20	80	0.2500000
NODE_22086_length_629_cov_38.271698	341	421	12	3	80	0.0375000
NODE_22086_length_629_cov_38.271698	341	421	13	21	80	0.2625000
NODE_22086_length_629_cov_38.271698	341	421	14	11	80	0.1375000
NODE_22086_length_629_cov_38.271698	341	421	15	25	80	0.3125000
NODE_22087_length_629_cov_27.556604	212	292	0	51	80	0.6375000
NODE_22087_length_629_cov_27.556604	212	292	1	29	80	0.3625000
NODE_22087_length_629_cov_27.556604	265	345	0	20	80	0.2500000
NODE_22087_length_629_cov_27.556604	265	345	1	60	80	0.7500000
NODE_22088_length_629_cov_24.150943	356	436	8	1	80	0.0125000
NODE_22088_length_629_cov_24.150943	356	436	9	24	80	0.3000000
NODE_22088_length_629_cov_24.150943	356	436	10	39	80	0.4875000
NODE_22088_length_629_cov_24.150943	356	436	11	16	80	0.2000000
NODE_22088_length_629_cov_24.150943	409	489	6	15	80	0.1875000
NODE_22088_length_629_cov_24.150943	409	489	7	18	80	0.2250000
NODE_22088_length_629_cov_24.150943	409	489	8	8	80	0.1000000
NODE_22088_length_629_cov_24.150943	409	489	9	26	80	0.3250000
NODE_22088_length_629_cov_24.150943	409	489	10	7	80	0.0875000
NODE_22088_length_629_cov_24.150943	409	489	11	6	80	0.0750000
NODE_22091_length_629_cov_13.641509	176	256	2	3	80	0.0375000
NODE_22091_length_629_cov_13.641509	176	256	3	10	80	0.1250000
NODE_22091_length_629_cov_13.641509	176	256	4	67	80	0.8375000
NODE_22091_length_629_cov_13.641509	229	309	0	15	80	0.1875000
NODE_22091_length_629_cov_13.641509	229	309	1	5	80	0.0625000
NODE_22091_length_629_cov_13.641509	229	309	2	36	80	0.4500000
NODE_22091_length_629_cov_13.641509	229	309	3	10	80	0.1250000
NODE_22091_length_629_cov_13.641509	229	309	4	14	80	0.1750000
NODE_22101_length_629_cov_4.264151	362	442	0	80	80	1.0000000
NODE_22188_length_628_cov_5.015123	210	274	0	64	64	1.0000000
NODE_22257_length_627_cov_24.500000	217	297	3	32	80	0.4000000
NODE_22257_length_627_cov_24.500000	217	297	4	48	80	0.6000000
NODE_22257_length_627_cov_24.500000	270	350	1	15	80	0.1875000
NODE_22257_length_627_cov_24.500000	270	350	2	9	80	0.1125000
NODE_22257_length_627_cov_24.500000	270	350	4	56	80	0.7000000
NODE_22258_length_627_cov_20.395833	84	164	3	24	80	0.3000000
NODE_22258_length_627_cov_20.395833	84	164	4	10	80	0.1250000
NODE_22258_length_627_cov_20.395833	84	164	6	9	80	0.1125000
NODE_22258_length_627_cov_20.395833	84	164	8	37	80	0.4625000
NODE_22258_length_627_cov_20.395833	137	217	8	27	80	0.3375000
NODE_22258_length_627_cov_20.395833	137	217	9	3	80	0.0375000
NODE_22258_length_627_cov_20.395833	137	217	10	33	80	0.4125000
NODE_22258_length_627_cov_20.395833	137	217	11	17	80	0.2125000
NODE_22259_length_627_cov_19.676136	308	388	0	80	80	1.0000000
NODE_22259_length_627_cov_19.676136	361	441	0	80	80	1.0000000
NODE_22260_length_627_cov_17.634470	264	296	0	32	32	1.0000000
NODE_22260_length_627_cov_17.634470	360	385	0	25	25	1.0000000
NODE_22260_length_627_cov_17.634470	365	385	0	20	20	1.0000000
NODE_22260_length_627_cov_17.634470	385	424	0	39	39	1.0000000
NODE_22267_length_627_cov_5.634470	298	346	1	48	48	1.0000000
NODE_22274_length_627_cov_4.517045	323	403	0	80	80	1.0000000
NODE_22274_length_627_cov_4.517045	376	456	0	80	80	1.0000000
NODE_22357_length_626_cov_24.184061	140	220	2	64	80	0.8000000
NODE_22357_length_626_cov_24.184061	140	220	4	16	80	0.2000000
NODE_22357_length_626_cov_24.184061	193	273	2	57	80	0.7125000
NODE_22357_length_626_cov_24.184061	193	273	4	23	80	0.2875000
NODE_22358_length_626_cov_21.189753	342	419	0	7	77	0.0909091
NODE_22358_length_626_cov_21.189753	342	419	2	70	77	0.9090909
NODE_22358_length_626_cov_21.189753	342	419	0	7	77	0.0909091
NODE_22358_length_626_cov_21.189753	342	419	2	70	77	0.9090909
NODE_22358_length_626_cov_21.189753	392	453	2	61	61	1.0000000
NODE_22364_length_626_cov_7.100569	236	311	0	75	75	1.0000000
NODE_22364_length_626_cov_7.100569	284	364	0	80	80	1.0000000
NODE_22366_length_626_cov_6.296015	193	273	2	36	80	0.4500000
NODE_22366_length_626_cov_6.296015	193	273	4	7	80	0.0875000
NODE_22366_length_626_cov_6.296015	193	273	6	8	80	0.1000000
NODE_22366_length_626_cov_6.296015	193	273	7	29	80	0.3625000
NODE_22366_length_626_cov_6.296015	246	326	6	48	80	0.6000000
NODE_22366_length_626_cov_6.296015	246	326	7	32	80	0.4000000
NODE_22367_length_626_cov_6.163188	257	337	0	5	80	0.0625000
NODE_22367_length_626_cov_6.163188	257	337	1	30	80	0.3750000
NODE_22367_length_626_cov_6.163188	257	337	2	45	80	0.5625000
NODE_22367_length_626_cov_6.163188	310	390	2	80	80	1.0000000
NODE_22438_length_625_cov_33.100760	239	319	2	48	80	0.6000000
NODE_22438_length_625_cov_33.100760	239	319	4	32	80	0.4000000
NODE_22438_length_625_cov_33.100760	292	372	4	75	80	0.9375000
NODE_22438_length_625_cov_33.100760	292	372	5	3	80	0.0375000
NODE_22438_length_625_cov_33.100760	292	372	6	2	80	0.0250000
NODE_22438_length_625_cov_33.100760	368	448	4	19	80	0.2375000
NODE_22438_length_625_cov_33.100760	368	448	5	2	80	0.0250000
NODE_22438_length_625_cov_33.100760	368	448	6	59	80	0.7375000
NODE_22438_length_625_cov_33.100760	421	501	4	64	80	0.8000000
NODE_22438_length_625_cov_33.100760	421	501	6	16	80	0.2000000
NODE_22439_length_625_cov_21.062738	267	347	1	17	80	0.2125000
NODE_22439_length_625_cov_21.062738	267	347	2	63	80	0.7875000
NODE_22439_length_625_cov_21.062738	320	400	2	62	80	0.7750000
NODE_22439_length_625_cov_21.062738	320	400	3	18	80	0.2250000
NODE_22440_length_625_cov_14.237643	28	108	0	80	80	1.0000000
NODE_22440_length_625_cov_14.237643	81	161	0	80	80	1.0000000
NODE_22441_length_625_cov_14.207224	358	438	2	3	80	0.0375000
NODE_22441_length_625_cov_14.207224	358	438	3	12	80	0.1500000
NODE_22441_length_625_cov_14.207224	358	438	4	65	80	0.8125000
NODE_22441_length_625_cov_14.207224	411	491	2	45	80	0.5625000
NODE_22441_length_625_cov_14.207224	411	491	4	35	80	0.4375000
NODE_22455_length_625_cov_4.157795	548	600	0	52	52	1.0000000
NODE_22466_length_625_cov_2.929658	118	198	1	80	80	1.0000000
NODE_22466_length_625_cov_2.929658	171	251	0	49	80	0.6125000
NODE_22466_length_625_cov_2.929658	171	251	1	31	80	0.3875000
NODE_22491_length_625_cov_1.570342	471	502	0	31	31	1.0000000
NODE_22542_length_624_cov_9.598095	77	126	0	49	49	1.0000000
NODE_22542_length_624_cov_9.598095	103	183	0	72	80	0.9000000
NODE_22542_length_624_cov_9.598095	103	183	2	8	80	0.1000000
NODE_22544_length_624_cov_8.485714	271	351	1	80	80	1.0000000
NODE_22544_length_624_cov_8.485714	324	404	1	30	80	0.3750000
NODE_22544_length_624_cov_8.485714	324	404	2	50	80	0.6250000
NODE_22546_length_624_cov_6.691429	386	466	3	79	80	0.9875000
NODE_22546_length_624_cov_6.691429	386	466	4	1	80	0.0125000
NODE_22546_length_624_cov_6.691429	439	519	0	26	80	0.3250000
NODE_22546_length_624_cov_6.691429	439	519	2	19	80	0.2375000
NODE_22546_length_624_cov_6.691429	439	519	3	35	80	0.4375000
NODE_22547_length_624_cov_5.592381	312	387	1	53	75	0.7066666
NODE_22547_length_624_cov_5.592381	312	387	2	22	75	0.2933333
NODE_22551_length_624_cov_4.638095	328	388	0	60	60	1.0000000
NODE_22642_length_623_cov_41.877863	419	499	1	13	80	0.1625000
NODE_22642_length_623_cov_41.877863	419	499	2	46	80	0.5750000
NODE_22642_length_623_cov_41.877863	419	499	3	21	80	0.2625000
NODE_22642_length_623_cov_41.877863	472	552	2	65	80	0.8125000
NODE_22642_length_623_cov_41.877863	472	552	3	15	80	0.1875000
NODE_22643_length_623_cov_31.875954	148	228	3	33	80	0.4125000
NODE_22643_length_623_cov_31.875954	148	228	4	43	80	0.5375000
NODE_22643_length_623_cov_31.875954	148	228	5	4	80	0.0500000
NODE_22643_length_623_cov_31.875954	201	281	0	6	80	0.0750000
NODE_22643_length_623_cov_31.875954	201	281	1	15	80	0.1875000
NODE_22643_length_623_cov_31.875954	201	281	2	4	80	0.0500000
NODE_22643_length_623_cov_31.875954	201	281	4	55	80	0.6875000
NODE_22644_length_623_cov_31.192748	313	393	9	40	80	0.5000000
NODE_22644_length_623_cov_31.192748	313	393	10	30	80	0.3750000
NODE_22644_length_623_cov_31.192748	313	393	11	10	80	0.1250000
NODE_22644_length_623_cov_31.192748	366	446	6	6	80	0.0750000
NODE_22644_length_623_cov_31.192748	366	446	8	30	80	0.3750000
NODE_22644_length_623_cov_31.192748	366	446	9	37	80	0.4625000
NODE_22644_length_623_cov_31.192748	366	446	10	6	80	0.0750000
NODE_22644_length_623_cov_31.192748	366	446	11	1	80	0.0125000
NODE_22645_length_623_cov_20.187023	287	367	2	9	80	0.1125000
NODE_22645_length_623_cov_20.187023	287	367	3	53	80	0.6625000
NODE_22645_length_623_cov_20.187023	287	367	4	18	80	0.2250000
NODE_22645_length_623_cov_20.187023	340	420	1	2	80	0.0250000
NODE_22645_length_623_cov_20.187023	340	420	2	10	80	0.1250000
NODE_22645_length_623_cov_20.187023	340	420	3	68	80	0.8500000
NODE_22646_length_623_cov_12.045802	377	457	3	8	80	0.1000000
NODE_22646_length_623_cov_12.045802	377	457	4	18	80	0.2250000
NODE_22646_length_623_cov_12.045802	377	457	6	54	80	0.6750000
NODE_22646_length_623_cov_12.045802	430	510	3	18	80	0.2250000
NODE_22646_length_623_cov_12.045802	430	510	4	22	80	0.2750000
NODE_22646_length_623_cov_12.045802	430	510	6	40	80	0.5000000
NODE_22668_length_623_cov_2.891221	457	535	0	25	78	0.3205128
NODE_22668_length_623_cov_2.891221	457	535	2	53	78	0.6794872
NODE_22725_length_622_cov_19.042065	368	448	0	5	80	0.0625000
NODE_22725_length_622_cov_19.042065	368	448	1	49	80	0.6125000
NODE_22725_length_622_cov_19.042065	368	448	2	26	80	0.3250000
NODE_22725_length_622_cov_19.042065	421	501	1	1	80	0.0125000
NODE_22725_length_622_cov_19.042065	421	501	2	79	80	0.9875000
NODE_22726_length_622_cov_13.470363	109	189	3	53	80	0.6625000
NODE_22726_length_622_cov_13.470363	109	189	5	18	80	0.2250000
NODE_22726_length_622_cov_13.470363	109	189	6	9	80	0.1125000
NODE_22726_length_622_cov_13.470363	162	242	3	6	80	0.0750000
NODE_22726_length_622_cov_13.470363	162	242	5	65	80	0.8125000
NODE_22726_length_622_cov_13.470363	162	242	6	9	80	0.1125000
NODE_22752_length_622_cov_2.407266	94	170	0	76	76	1.0000000
NODE_22796_length_622_cov_1.353728	346	376	0	30	30	1.0000000
NODE_22819_length_621_cov_46.247126	0	52	0	52	52	1.0000000
NODE_22819_length_621_cov_46.247126	25	105	0	80	80	1.0000000
NODE_22819_length_621_cov_46.247126	101	181	0	80	80	1.0000000
NODE_22819_length_621_cov_46.247126	154	234	0	80	80	1.0000000
NODE_22820_length_621_cov_45.764368	344	424	7	6	80	0.0750000
NODE_22820_length_621_cov_45.764368	344	424	8	4	80	0.0500000
NODE_22820_length_621_cov_45.764368	344	424	9	9	80	0.1125000
NODE_22820_length_621_cov_45.764368	344	424	10	2	80	0.0250000
NODE_22820_length_621_cov_45.764368	344	424	14	37	80	0.4625000
NODE_22820_length_621_cov_45.764368	344	424	15	22	80	0.2750000
NODE_22820_length_621_cov_45.764368	397	477	5	9	80	0.1125000
NODE_22820_length_621_cov_45.764368	397	477	6	5	80	0.0625000
NODE_22820_length_621_cov_45.764368	397	477	11	1	80	0.0125000
NODE_22820_length_621_cov_45.764368	397	477	13	13	80	0.1625000
NODE_22820_length_621_cov_45.764368	397	477	14	43	80	0.5375000
NODE_22820_length_621_cov_45.764368	397	477	15	9	80	0.1125000
NODE_22821_length_621_cov_35.147510	393	473	1	3	80	0.0375000
NODE_22821_length_621_cov_35.147510	393	473	3	34	80	0.4250000
NODE_22821_length_621_cov_35.147510	393	473	4	43	80	0.5375000
NODE_22821_length_621_cov_35.147510	446	526	1	2	80	0.0250000
NODE_22821_length_621_cov_35.147510	446	526	3	7	80	0.0875000
NODE_22821_length_621_cov_35.147510	446	526	4	71	80	0.8875000
NODE_22822_length_621_cov_13.842912	231	311	3	44	80	0.5500000
NODE_22822_length_621_cov_13.842912	231	311	4	36	80	0.4500000
NODE_22822_length_621_cov_13.842912	284	364	2	2	80	0.0250000
NODE_22822_length_621_cov_13.842912	284	364	3	28	80	0.3500000
NODE_22822_length_621_cov_13.842912	284	364	4	50	80	0.6250000
NODE_22825_length_621_cov_6.279693	376	406	0	30	30	1.0000000
NODE_22845_length_621_cov_2.645594	367	426	0	59	59	1.0000000
NODE_22914_length_620_cov_23.913628	433	513	7	5	80	0.0625000
NODE_22914_length_620_cov_23.913628	433	513	9	6	80	0.0750000
NODE_22914_length_620_cov_23.913628	433	513	10	5	80	0.0625000
NODE_22914_length_620_cov_23.913628	433	513	11	37	80	0.4625000
NODE_22914_length_620_cov_23.913628	433	513	12	19	80	0.2375000
NODE_22914_length_620_cov_23.913628	433	513	13	8	80	0.1000000
NODE_22914_length_620_cov_23.913628	486	566	4	9	80	0.1125000
NODE_22914_length_620_cov_23.913628	486	566	6	7	80	0.0875000
NODE_22914_length_620_cov_23.913628	486	566	7	42	80	0.5250000
NODE_22914_length_620_cov_23.913628	486	566	9	6	80	0.0750000
NODE_22914_length_620_cov_23.913628	486	566	11	16	80	0.2000000
NODE_22915_length_620_cov_9.222649	186	266	3	80	80	1.0000000
NODE_22915_length_620_cov_9.222649	239	319	0	28	80	0.3500000
NODE_22915_length_620_cov_9.222649	239	319	1	25	80	0.3125000
NODE_22915_length_620_cov_9.222649	239	319	3	27	80	0.3375000
NODE_22919_length_620_cov_7.804223	57	137	0	58	80	0.7250000
NODE_22919_length_620_cov_7.804223	57	137	2	22	80	0.2750000
NODE_22919_length_620_cov_7.804223	110	190	0	8	80	0.1000000
NODE_22919_length_620_cov_7.804223	110	190	2	72	80	0.9000000
NODE_22920_length_620_cov_6.909789	199	279	0	80	80	1.0000000
NODE_22920_length_620_cov_6.909789	252	332	0	80	80	1.0000000
NODE_22930_length_620_cov_4.560461	309	347	4	38	38	1.0000000
NODE_22930_length_620_cov_4.560461	395	421	1	17	26	0.6538461
NODE_22930_length_620_cov_4.560461	395	421	3	9	26	0.3461539
NODE_22930_length_620_cov_4.560461	395	451	1	29	56	0.5178571
NODE_22930_length_620_cov_4.560461	395	451	3	27	56	0.4821429
NODE_23031_length_619_cov_26.309615	118	198	1	13	80	0.1625000
NODE_23031_length_619_cov_26.309615	118	198	3	13	80	0.1625000
NODE_23031_length_619_cov_26.309615	118	198	4	54	80	0.6750000
NODE_23031_length_619_cov_26.309615	171	251	4	80	80	1.0000000
NODE_23033_length_619_cov_10.417308	427	487	0	60	60	1.0000000
NODE_23034_length_619_cov_7.944231	213	293	3	12	80	0.1500000
NODE_23034_length_619_cov_7.944231	213	293	4	8	80	0.1000000
NODE_23034_length_619_cov_7.944231	213	293	5	60	80	0.7500000
NODE_23034_length_619_cov_7.944231	266	346	3	7	80	0.0875000
NODE_23034_length_619_cov_7.944231	266	346	4	32	80	0.4000000
NODE_23034_length_619_cov_7.944231	266	346	5	41	80	0.5125000
NODE_23135_length_618_cov_14.477842	223	299	4	76	76	1.0000000
NODE_23135_length_618_cov_14.477842	223	299	4	76	76	1.0000000
NODE_23135_length_618_cov_14.477842	276	337	2	11	61	0.1803279
NODE_23135_length_618_cov_14.477842	276	337	3	13	61	0.2131148
NODE_23135_length_618_cov_14.477842	276	337	4	37	61	0.6065574
NODE_23136_length_618_cov_13.840077	377	457	0	35	80	0.4375000
NODE_23136_length_618_cov_13.840077	377	457	2	45	80	0.5625000
NODE_23136_length_618_cov_13.840077	430	510	2	80	80	1.0000000
NODE_23137_length_618_cov_12.048170	348	428	2	14	80	0.1750000
NODE_23137_length_618_cov_12.048170	348	428	4	66	80	0.8250000
NODE_23137_length_618_cov_12.048170	401	481	0	2	80	0.0250000
NODE_23137_length_618_cov_12.048170	401	481	2	65	80	0.8125000
NODE_23137_length_618_cov_12.048170	401	481	4	13	80	0.1625000
NODE_23138_length_618_cov_8.799615	353	433	6	51	80	0.6375000
NODE_23138_length_618_cov_8.799615	353	433	7	2	80	0.0250000
NODE_23138_length_618_cov_8.799615	353	433	8	3	80	0.0375000
NODE_23138_length_618_cov_8.799615	353	433	9	24	80	0.3000000
NODE_23138_length_618_cov_8.799615	406	486	4	20	80	0.2500000
NODE_23138_length_618_cov_8.799615	406	486	5	11	80	0.1375000
NODE_23138_length_618_cov_8.799615	406	486	6	36	80	0.4500000
NODE_23138_length_618_cov_8.799615	406	486	8	3	80	0.0375000
NODE_23138_length_618_cov_8.799615	406	486	9	10	80	0.1250000
NODE_23147_length_618_cov_3.793834	412	478	0	66	66	1.0000000
NODE_23148_length_618_cov_3.761079	305	385	0	80	80	1.0000000
NODE_23252_length_617_cov_29.565637	378	458	15	15	80	0.1875000
NODE_23252_length_617_cov_29.565637	378	458	16	1	80	0.0125000
NODE_23252_length_617_cov_29.565637	378	458	17	31	80	0.3875000
NODE_23252_length_617_cov_29.565637	378	458	19	15	80	0.1875000
NODE_23252_length_617_cov_29.565637	378	458	20	5	80	0.0625000
NODE_23252_length_617_cov_29.565637	378	458	21	13	80	0.1625000
NODE_23252_length_617_cov_29.565637	431	511	7	19	80	0.2375000
NODE_23252_length_617_cov_29.565637	431	511	9	12	80	0.1500000
NODE_23252_length_617_cov_29.565637	431	511	11	4	80	0.0500000
NODE_23252_length_617_cov_29.565637	431	511	12	4	80	0.0500000
NODE_23252_length_617_cov_29.565637	431	511	14	3	80	0.0375000
NODE_23252_length_617_cov_29.565637	431	511	16	4	80	0.0500000
NODE_23252_length_617_cov_29.565637	431	511	17	9	80	0.1125000
NODE_23252_length_617_cov_29.565637	431	511	19	7	80	0.0875000
NODE_23252_length_617_cov_29.565637	431	511	20	5	80	0.0625000
NODE_23252_length_617_cov_29.565637	431	511	21	13	80	0.1625000
NODE_23253_length_617_cov_16.781853	253	333	6	41	80	0.5125000
NODE_23253_length_617_cov_16.781853	253	333	7	14	80	0.1750000
NODE_23253_length_617_cov_16.781853	253	333	8	25	80	0.3125000
NODE_23253_length_617_cov_16.781853	306	386	1	13	80	0.1625000
NODE_23253_length_617_cov_16.781853	306	386	3	3	80	0.0375000
NODE_23253_length_617_cov_16.781853	306	386	4	4	80	0.0500000
NODE_23253_length_617_cov_16.781853	306	386	6	26	80	0.3250000
NODE_23253_length_617_cov_16.781853	306	386	7	21	80	0.2625000
NODE_23253_length_617_cov_16.781853	306	386	8	13	80	0.1625000
NODE_23254_length_617_cov_9.175676	373	453	0	80	80	1.0000000
NODE_23254_length_617_cov_9.175676	426	506	0	39	80	0.4875000
NODE_23254_length_617_cov_9.175676	426	506	2	41	80	0.5125000
NODE_23255_length_617_cov_8.774131	320	406	0	50	86	0.5813953
NODE_23255_length_617_cov_8.774131	320	406	2	36	86	0.4186046
NODE_23255_length_617_cov_8.774131	379	458	0	19	79	0.2405063
NODE_23255_length_617_cov_8.774131	379	458	2	60	79	0.7594936
NODE_23257_length_617_cov_8.416988	359	439	0	80	80	1.0000000
NODE_23257_length_617_cov_8.416988	412	492	0	80	80	1.0000000
NODE_23259_length_617_cov_7.683398	197	275	0	78	78	1.0000000
NODE_23259_length_617_cov_7.683398	250	330	0	80	80	1.0000000
NODE_23263_length_617_cov_5.330116	288	360	0	72	72	1.0000000
NODE_23263_length_617_cov_5.330116	333	413	0	80	80	1.0000000
NODE_23302_length_617_cov_1.967181	384	430	0	17	46	0.3695652
NODE_23302_length_617_cov_1.967181	384	430	1	9	46	0.1956522
NODE_23302_length_617_cov_1.967181	384	430	2	20	46	0.4347826
NODE_23311_length_617_cov_1.847490	273	344	0	71	71	1.0000000
NODE_23331_length_617_cov_1.322394	269	318	4	9	49	0.1836735
NODE_23331_length_617_cov_1.322394	269	318	6	32	49	0.6530612
NODE_23331_length_617_cov_1.322394	269	318	8	8	49	0.1632653
NODE_23365_length_616_cov_15.914894	292	370	1	20	78	0.2564103
NODE_23365_length_616_cov_15.914894	292	370	2	41	78	0.5256410
NODE_23365_length_616_cov_15.914894	292	370	3	17	78	0.2179487
NODE_23365_length_616_cov_15.914894	343	423	1	10	80	0.1250000
NODE_23365_length_616_cov_15.914894	343	423	2	13	80	0.1625000
NODE_23365_length_616_cov_15.914894	343	423	3	57	80	0.7125000
NODE_23366_length_616_cov_14.276596	191	271	0	80	80	1.0000000
NODE_23366_length_616_cov_14.276596	244	319	0	75	75	1.0000000
NODE_23366_length_616_cov_14.276596	368	448	0	32	80	0.4000000
NODE_23366_length_616_cov_14.276596	368	448	2	48	80	0.6000000
NODE_23367_length_616_cov_12.119923	273	353	1	14	80	0.1750000
NODE_23367_length_616_cov_12.119923	273	353	2	57	80	0.7125000
NODE_23367_length_616_cov_12.119923	273	353	3	9	80	0.1125000
NODE_23367_length_616_cov_12.119923	326	406	2	60	80	0.7500000
NODE_23367_length_616_cov_12.119923	326	406	3	20	80	0.2500000
NODE_23373_length_616_cov_6.379110	305	385	0	36	80	0.4500000
NODE_23373_length_616_cov_6.379110	305	385	1	44	80	0.5500000
NODE_23373_length_616_cov_6.379110	358	438	1	80	80	1.0000000
NODE_23381_length_616_cov_4.441006	286	350	0	64	64	1.0000000
NODE_23381_length_616_cov_4.441006	286	306	0	20	20	1.0000000
NODE_23400_length_616_cov_2.541586	375	415	0	40	40	1.0000000
NODE_23430_length_616_cov_1.491296	105	183	0	4	78	0.0512821
NODE_23430_length_616_cov_1.491296	105	183	1	74	78	0.9487180
NODE_23474_length_615_cov_27.519380	302	382	0	11	80	0.1375000
NODE_23474_length_615_cov_27.519380	302	382	2	69	80	0.8625000
NODE_23474_length_615_cov_27.519380	355	435	2	80	80	1.0000000
NODE_23475_length_615_cov_17.792636	239	319	0	80	80	1.0000000
NODE_23475_length_615_cov_17.792636	292	372	0	80	80	1.0000000
NODE_23477_length_615_cov_11.835271	240	320	0	80	80	1.0000000
NODE_23477_length_615_cov_11.835271	293	373	0	80	80	1.0000000
NODE_23478_length_615_cov_8.591085	287	367	3	6	80	0.0750000
NODE_23478_length_615_cov_8.591085	287	367	5	38	80	0.4750000
NODE_23478_length_615_cov_8.591085	287	367	6	36	80	0.4500000
NODE_23478_length_615_cov_8.591085	340	420	5	41	80	0.5125000
NODE_23478_length_615_cov_8.591085	340	420	6	39	80	0.4875000
NODE_23513_length_615_cov_2.461240	429	509	0	64	80	0.8000000
NODE_23513_length_615_cov_2.461240	429	509	1	2	80	0.0250000
NODE_23513_length_615_cov_2.461240	429	509	2	10	80	0.1250000
NODE_23513_length_615_cov_2.461240	429	509	4	4	80	0.0500000
NODE_23513_length_615_cov_2.461240	482	562	0	80	80	1.0000000
NODE_23516_length_615_cov_2.379845	405	467	0	62	62	1.0000000
NODE_23516_length_615_cov_2.379845	440	520	0	80	80	1.0000000
NODE_23517_length_615_cov_2.294574	205	268	0	63	63	1.0000000
NODE_23554_length_615_cov_1.122093	255	335	0	30	80	0.3750000
NODE_23554_length_615_cov_1.122093	255	335	2	50	80	0.6250000
NODE_23566_length_615_cov_0.887597	561	582	0	21	21	1.0000000
NODE_23575_length_614_cov_17.772816	257	337	0	15	80	0.1875000
NODE_23575_length_614_cov_17.772816	257	337	2	65	80	0.8125000
NODE_23575_length_614_cov_17.772816	310	390	0	12	80	0.1500000
NODE_23575_length_614_cov_17.772816	310	390	2	68	80	0.8500000
NODE_23576_length_614_cov_10.706796	425	505	3	26	80	0.3250000
NODE_23576_length_614_cov_10.706796	425	505	4	54	80	0.6750000
NODE_23576_length_614_cov_10.706796	478	558	1	20	80	0.2500000
NODE_23576_length_614_cov_10.706796	478	558	2	21	80	0.2625000
NODE_23576_length_614_cov_10.706796	478	558	4	39	80	0.4875000
NODE_23578_length_614_cov_8.545631	193	273	1	51	80	0.6375000
NODE_23578_length_614_cov_8.545631	193	273	3	6	80	0.0750000
NODE_23578_length_614_cov_8.545631	193	273	7	15	80	0.1875000
NODE_23578_length_614_cov_8.545631	193	273	9	8	80	0.1000000
NODE_23578_length_614_cov_8.545631	246	326	1	59	80	0.7375000
NODE_23578_length_614_cov_8.545631	246	326	2	21	80	0.2625000
NODE_23604_length_614_cov_2.450485	315	393	0	78	78	1.0000000
NODE_23604_length_614_cov_2.450485	355	383	0	28	28	1.0000000
NODE_23604_length_614_cov_2.450485	368	448	0	80	80	1.0000000
NODE_23604_length_614_cov_2.450485	379	448	0	69	69	1.0000000
NODE_23662_length_613_cov_18.075875	211	291	7	2	80	0.0250000
NODE_23662_length_613_cov_18.075875	211	291	8	13	80	0.1625000
NODE_23662_length_613_cov_18.075875	211	291	9	27	80	0.3375000
NODE_23662_length_613_cov_18.075875	211	291	10	38	80	0.4750000
NODE_23662_length_613_cov_18.075875	264	344	4	12	80	0.1500000
NODE_23662_length_613_cov_18.075875	264	344	5	5	80	0.0625000
NODE_23662_length_613_cov_18.075875	264	344	6	12	80	0.1500000
NODE_23662_length_613_cov_18.075875	264	344	7	26	80	0.3250000
NODE_23662_length_613_cov_18.075875	264	344	8	8	80	0.1000000
NODE_23662_length_613_cov_18.075875	264	344	9	17	80	0.2125000
NODE_23663_length_613_cov_16.118677	283	363	3	80	80	1.0000000
NODE_23663_length_613_cov_16.118677	336	416	0	19	80	0.2375000
NODE_23663_length_613_cov_16.118677	336	416	1	4	80	0.0500000
NODE_23663_length_613_cov_16.118677	336	416	2	25	80	0.3125000
NODE_23663_length_613_cov_16.118677	336	416	3	32	80	0.4000000
NODE_23665_length_613_cov_12.883268	155	235	0	80	80	1.0000000
NODE_23665_length_613_cov_12.883268	208	288	0	80	80	1.0000000
NODE_23674_length_613_cov_3.857977	167	247	0	80	80	1.0000000
NODE_23674_length_613_cov_3.857977	220	300	0	80	80	1.0000000
NODE_23771_length_612_cov_24.023392	173	253	1	9	80	0.1125000
NODE_23771_length_612_cov_24.023392	173	253	2	71	80	0.8875000
NODE_23771_length_612_cov_24.023392	226	306	1	62	80	0.7750000
NODE_23771_length_612_cov_24.023392	226	306	2	18	80	0.2250000
NODE_23772_length_612_cov_23.846004	141	221	10	33	80	0.4125000
NODE_23772_length_612_cov_23.846004	141	221	11	10	80	0.1250000
NODE_23772_length_612_cov_23.846004	141	221	12	37	80	0.4625000
NODE_23772_length_612_cov_23.846004	194	274	6	13	80	0.1625000
NODE_23772_length_612_cov_23.846004	194	274	7	15	80	0.1875000
NODE_23772_length_612_cov_23.846004	194	274	9	22	80	0.2750000
NODE_23772_length_612_cov_23.846004	194	274	10	22	80	0.2750000
NODE_23772_length_612_cov_23.846004	194	274	12	8	80	0.1000000
NODE_23773_length_612_cov_12.448343	244	324	1	31	80	0.3875000
NODE_23773_length_612_cov_12.448343	244	324	2	49	80	0.6125000
NODE_23773_length_612_cov_12.448343	297	377	0	14	80	0.1750000
NODE_23773_length_612_cov_12.448343	297	377	1	66	80	0.8250000
NODE_23774_length_612_cov_12.068226	267	347	2	80	80	1.0000000
NODE_23774_length_612_cov_12.068226	320	400	2	67	80	0.8375000
NODE_23774_length_612_cov_12.068226	320	400	4	13	80	0.1625000
NODE_23779_length_612_cov_6.393762	242	322	0	80	80	1.0000000
NODE_23779_length_612_cov_6.393762	295	375	0	80	80	1.0000000
NODE_23814_length_612_cov_1.904483	288	354	0	66	66	1.0000000
NODE_23869_length_611_cov_38.705078	132	212	0	80	80	1.0000000
NODE_23869_length_611_cov_38.705078	185	262	0	77	77	1.0000000
NODE_23869_length_611_cov_38.705078	185	262	0	77	77	1.0000000
NODE_23871_length_611_cov_12.669922	264	344	0	9	80	0.1125000
NODE_23871_length_611_cov_12.669922	264	344	1	20	80	0.2500000
NODE_23871_length_611_cov_12.669922	264	344	2	51	80	0.6375000
NODE_23871_length_611_cov_12.669922	317	397	0	62	80	0.7750000
NODE_23871_length_611_cov_12.669922	317	397	1	18	80	0.2250000
NODE_23880_length_611_cov_4.943359	27	107	2	22	80	0.2750000
NODE_23880_length_611_cov_4.943359	27	107	4	3	80	0.0375000
NODE_23880_length_611_cov_4.943359	27	107	5	55	80	0.6875000
NODE_23880_length_611_cov_4.943359	80	137	3	24	57	0.4210526
NODE_23880_length_611_cov_4.943359	80	137	5	33	57	0.5789474
NODE_23880_length_611_cov_4.943359	143	209	4	66	66	1.0000000
NODE_23880_length_611_cov_4.943359	182	262	1	4	80	0.0500000
NODE_23880_length_611_cov_4.943359	182	262	3	21	80	0.2625000
NODE_23880_length_611_cov_4.943359	182	262	4	55	80	0.6875000
NODE_23894_length_611_cov_3.294922	271	300	0	29	29	1.0000000
NODE_23894_length_611_cov_3.294922	434	469	0	35	35	1.0000000
NODE_23897_length_611_cov_3.162109	313	342	0	29	29	1.0000000
NODE_23973_length_610_cov_20.673190	87	167	5	58	80	0.7250000
NODE_23973_length_610_cov_20.673190	87	167	6	19	80	0.2375000
NODE_23973_length_610_cov_20.673190	87	167	7	3	80	0.0375000
NODE_23973_length_610_cov_20.673190	140	220	4	1	80	0.0125000
NODE_23973_length_610_cov_20.673190	140	220	5	17	80	0.2125000
NODE_23973_length_610_cov_20.673190	140	220	6	41	80	0.5125000
NODE_23973_length_610_cov_20.673190	140	220	7	21	80	0.2625000
NODE_23974_length_610_cov_10.191781	250	330	0	3	80	0.0375000
NODE_23974_length_610_cov_10.191781	250	330	1	29	80	0.3625000
NODE_23974_length_610_cov_10.191781	250	330	3	48	80	0.6000000
NODE_23974_length_610_cov_10.191781	303	383	3	79	80	0.9875000
NODE_23974_length_610_cov_10.191781	303	383	4	1	80	0.0125000
NODE_23980_length_610_cov_4.998043	129	181	0	52	52	1.0000000
NODE_23980_length_610_cov_4.998043	182	234	0	52	52	1.0000000
NODE_23989_length_610_cov_3.479452	215	267	0	52	52	1.0000000
NODE_24059_length_609_cov_21.117647	80	160	3	63	80	0.7875000
NODE_24059_length_609_cov_21.117647	80	160	4	17	80	0.2125000
NODE_24059_length_609_cov_21.117647	133	213	2	18	80	0.2250000
NODE_24059_length_609_cov_21.117647	133	213	3	21	80	0.2625000
NODE_24059_length_609_cov_21.117647	133	213	4	41	80	0.5125000
NODE_24060_length_609_cov_11.300000	218	298	0	80	80	1.0000000
NODE_24060_length_609_cov_11.300000	271	351	0	80	80	1.0000000
NODE_24061_length_609_cov_10.778431	239	319	0	80	80	1.0000000
NODE_24061_length_609_cov_10.778431	292	372	0	80	80	1.0000000
NODE_24062_length_609_cov_10.298039	340	420	4	18	80	0.2250000
NODE_24062_length_609_cov_10.298039	340	420	5	6	80	0.0750000
NODE_24062_length_609_cov_10.298039	340	420	6	56	80	0.7000000
NODE_24062_length_609_cov_10.298039	393	473	2	29	80	0.3625000
NODE_24062_length_609_cov_10.298039	393	473	4	27	80	0.3375000
NODE_24062_length_609_cov_10.298039	393	473	6	24	80	0.3000000
NODE_24062_length_609_cov_10.298039	469	537	0	26	68	0.3823529
NODE_24062_length_609_cov_10.298039	469	537	1	6	68	0.0882353
NODE_24062_length_609_cov_10.298039	469	537	2	36	68	0.5294118
NODE_24063_length_609_cov_10.270588	217	297	0	80	80	1.0000000
NODE_24063_length_609_cov_10.270588	270	353	0	83	83	1.0000000
NODE_24064_length_609_cov_8.345098	408	488	0	3	80	0.0375000
NODE_24064_length_609_cov_8.345098	408	488	2	4	80	0.0500000
NODE_24064_length_609_cov_8.345098	408	488	4	18	80	0.2250000
NODE_24064_length_609_cov_8.345098	408	488	6	55	80	0.6875000
NODE_24064_length_609_cov_8.345098	461	515	0	30	54	0.5555556
NODE_24064_length_609_cov_8.345098	461	515	2	4	54	0.0740741
NODE_24064_length_609_cov_8.345098	461	515	4	18	54	0.3333333
NODE_24064_length_609_cov_8.345098	461	515	6	2	54	0.0370370
NODE_24064_length_609_cov_8.345098	537	566	0	29	29	1.0000000
NODE_24066_length_609_cov_6.054902	219	299	0	51	80	0.6375000
NODE_24066_length_609_cov_6.054902	219	299	1	29	80	0.3625000
NODE_24066_length_609_cov_6.054902	272	352	0	80	80	1.0000000
NODE_24067_length_609_cov_5.986275	219	299	2	15	80	0.1875000
NODE_24067_length_609_cov_5.986275	219	299	3	65	80	0.8125000
NODE_24067_length_609_cov_5.986275	272	352	2	18	80	0.2250000
NODE_24067_length_609_cov_5.986275	272	352	3	62	80	0.7750000
NODE_24160_length_608_cov_76.257367	300	380	6	27	80	0.3375000
NODE_24160_length_608_cov_76.257367	300	380	7	53	80	0.6625000
NODE_24160_length_608_cov_76.257367	353	433	4	14	80	0.1750000
NODE_24160_length_608_cov_76.257367	353	433	5	37	80	0.4625000
NODE_24160_length_608_cov_76.257367	353	433	6	11	80	0.1375000
NODE_24160_length_608_cov_76.257367	353	433	7	18	80	0.2250000
NODE_24161_length_608_cov_13.271120	252	332	0	27	80	0.3375000
NODE_24161_length_608_cov_13.271120	252	332	1	53	80	0.6625000
NODE_24161_length_608_cov_13.271120	305	385	0	63	80	0.7875000
NODE_24161_length_608_cov_13.271120	305	385	1	17	80	0.2125000
NODE_24162_length_608_cov_11.583497	63	139	6	1	76	0.0131579
NODE_24162_length_608_cov_11.583497	63	139	7	1	76	0.0131579
NODE_24162_length_608_cov_11.583497	63	139	8	25	76	0.3289474
NODE_24162_length_608_cov_11.583497	63	139	9	47	76	0.6184211
NODE_24162_length_608_cov_11.583497	63	139	10	2	76	0.0263158
NODE_24162_length_608_cov_11.583497	112	192	5	1	80	0.0125000
NODE_24162_length_608_cov_11.583497	112	192	6	18	80	0.2250000
NODE_24162_length_608_cov_11.583497	112	192	8	39	80	0.4875000
NODE_24162_length_608_cov_11.583497	112	192	9	20	80	0.2500000
NODE_24162_length_608_cov_11.583497	112	192	10	2	80	0.0250000
NODE_24164_length_608_cov_8.076621	53	133	6	16	80	0.2000000
NODE_24164_length_608_cov_8.076621	53	133	8	64	80	0.8000000
NODE_24164_length_608_cov_8.076621	106	186	0	36	80	0.4500000
NODE_24164_length_608_cov_8.076621	106	186	2	12	80	0.1500000
NODE_24164_length_608_cov_8.076621	106	186	4	4	80	0.0500000
NODE_24164_length_608_cov_8.076621	106	186	6	17	80	0.2125000
NODE_24164_length_608_cov_8.076621	106	186	8	11	80	0.1375000
NODE_24165_length_608_cov_7.994106	279	326	5	10	47	0.2127660
NODE_24165_length_608_cov_7.994106	279	326	6	13	47	0.2765957
NODE_24165_length_608_cov_7.994106	279	326	7	24	47	0.5106383
NODE_24165_length_608_cov_7.994106	348	373	6	11	25	0.4400000
NODE_24165_length_608_cov_7.994106	348	373	7	14	25	0.5600000
NODE_24166_length_608_cov_7.939096	247	277	0	30	30	1.0000000
NODE_24177_length_608_cov_3.829077	313	393	0	23	80	0.2875000
NODE_24177_length_608_cov_3.829077	313	393	2	57	80	0.7125000
NODE_24177_length_608_cov_3.829077	366	446	0	71	80	0.8875000
NODE_24177_length_608_cov_3.829077	366	446	2	9	80	0.1125000
NODE_24251_length_608_cov_1.064833	472	512	1	40	40	1.0000000
NODE_24281_length_607_cov_61.316929	347	427	3	27	80	0.3375000
NODE_24281_length_607_cov_61.316929	347	427	5	10	80	0.1250000
NODE_24281_length_607_cov_61.316929	347	427	6	43	80	0.5375000
NODE_24281_length_607_cov_61.316929	347	427	3	27	80	0.3375000
NODE_24281_length_607_cov_61.316929	347	427	5	10	80	0.1250000
NODE_24281_length_607_cov_61.316929	347	427	6	43	80	0.5375000
NODE_24281_length_607_cov_61.316929	347	427	3	27	80	0.3375000
NODE_24281_length_607_cov_61.316929	347	427	5	10	80	0.1250000
NODE_24281_length_607_cov_61.316929	347	427	6	43	80	0.5375000
NODE_24281_length_607_cov_61.316929	364	427	3	10	63	0.1587302
NODE_24281_length_607_cov_61.316929	364	427	5	10	63	0.1587302
NODE_24281_length_607_cov_61.316929	364	427	6	43	63	0.6825397
NODE_24281_length_607_cov_61.316929	400	480	4	9	80	0.1125000
NODE_24281_length_607_cov_61.316929	400	480	6	36	80	0.4500000
NODE_24281_length_607_cov_61.316929	400	480	7	11	80	0.1375000
NODE_24281_length_607_cov_61.316929	400	480	8	24	80	0.3000000
NODE_24281_length_607_cov_61.316929	400	480	4	9	80	0.1125000
NODE_24281_length_607_cov_61.316929	400	480	6	36	80	0.4500000
NODE_24281_length_607_cov_61.316929	400	480	7	11	80	0.1375000
NODE_24281_length_607_cov_61.316929	400	480	8	24	80	0.3000000
NODE_24281_length_607_cov_61.316929	400	480	4	9	80	0.1125000
NODE_24281_length_607_cov_61.316929	400	480	6	36	80	0.4500000
NODE_24281_length_607_cov_61.316929	400	480	7	11	80	0.1375000
NODE_24281_length_607_cov_61.316929	400	480	8	24	80	0.3000000
NODE_24281_length_607_cov_61.316929	400	480	4	9	80	0.1125000
NODE_24281_length_607_cov_61.316929	400	480	6	36	80	0.4500000
NODE_24281_length_607_cov_61.316929	400	480	7	11	80	0.1375000
NODE_24281_length_607_cov_61.316929	400	480	8	24	80	0.3000000
NODE_24281_length_607_cov_61.316929	476	556	2	22	80	0.2750000
NODE_24281_length_607_cov_61.316929	476	556	3	53	80	0.6625000
NODE_24281_length_607_cov_61.316929	476	556	4	5	80	0.0625000
NODE_24281_length_607_cov_61.316929	476	556	2	22	80	0.2750000
NODE_24281_length_607_cov_61.316929	476	556	3	53	80	0.6625000
NODE_24281_length_607_cov_61.316929	476	556	4	5	80	0.0625000
NODE_24281_length_607_cov_61.316929	476	556	2	22	80	0.2750000
NODE_24281_length_607_cov_61.316929	476	556	3	53	80	0.6625000
NODE_24281_length_607_cov_61.316929	476	556	4	5	80	0.0625000
NODE_24281_length_607_cov_61.316929	529	595	0	6	66	0.0909091
NODE_24281_length_607_cov_61.316929	529	595	1	14	66	0.2121212
NODE_24281_length_607_cov_61.316929	529	595	2	41	66	0.6212121
NODE_24281_length_607_cov_61.316929	529	595	3	5	66	0.0757576
NODE_24281_length_607_cov_61.316929	529	607	0	18	78	0.2307692
NODE_24281_length_607_cov_61.316929	529	607	1	14	78	0.1794872
NODE_24281_length_607_cov_61.316929	529	607	2	41	78	0.5256410
NODE_24281_length_607_cov_61.316929	529	607	3	5	78	0.0641026
NODE_24281_length_607_cov_61.316929	529	600	0	11	71	0.1549296
NODE_24281_length_607_cov_61.316929	529	600	1	14	71	0.1971831
NODE_24281_length_607_cov_61.316929	529	600	2	41	71	0.5774648
NODE_24281_length_607_cov_61.316929	529	600	3	5	71	0.0704225
NODE_24281_length_607_cov_61.316929	534	607	0	18	73	0.2465753
NODE_24281_length_607_cov_61.316929	534	607	1	14	73	0.1917808
NODE_24281_length_607_cov_61.316929	534	607	2	41	73	0.5616438
NODE_24282_length_607_cov_16.852362	383	463	1	13	80	0.1625000
NODE_24282_length_607_cov_16.852362	383	463	2	59	80	0.7375000
NODE_24282_length_607_cov_16.852362	383	463	3	8	80	0.1000000
NODE_24282_length_607_cov_16.852362	436	516	0	44	80	0.5500000
NODE_24282_length_607_cov_16.852362	436	516	1	22	80	0.2750000
NODE_24282_length_607_cov_16.852362	436	516	2	14	80	0.1750000
NODE_24283_length_607_cov_12.889764	67	147	3	11	80	0.1375000
NODE_24283_length_607_cov_12.889764	67	147	5	2	80	0.0250000
NODE_24283_length_607_cov_12.889764	67	147	6	4	80	0.0500000
NODE_24283_length_607_cov_12.889764	67	147	7	46	80	0.5750000
NODE_24283_length_607_cov_12.889764	67	147	8	4	80	0.0500000
NODE_24283_length_607_cov_12.889764	67	147	10	9	80	0.1125000
NODE_24283_length_607_cov_12.889764	67	147	11	4	80	0.0500000
NODE_24283_length_607_cov_12.889764	120	200	7	10	80	0.1250000
NODE_24283_length_607_cov_12.889764	120	200	8	4	80	0.0500000
NODE_24283_length_607_cov_12.889764	120	200	10	12	80	0.1500000
NODE_24283_length_607_cov_12.889764	120	200	11	54	80	0.6750000
NODE_24284_length_607_cov_11.023622	122	202	3	44	80	0.5500000
NODE_24284_length_607_cov_11.023622	122	202	4	7	80	0.0875000
NODE_24284_length_607_cov_11.023622	122	202	5	29	80	0.3625000
NODE_24284_length_607_cov_11.023622	175	255	2	13	80	0.1625000
NODE_24284_length_607_cov_11.023622	175	255	3	29	80	0.3625000
NODE_24284_length_607_cov_11.023622	175	255	4	38	80	0.4750000
NODE_24285_length_607_cov_10.690945	199	279	2	1	80	0.0125000
NODE_24285_length_607_cov_10.690945	199	279	4	24	80	0.3000000
NODE_24285_length_607_cov_10.690945	199	279	5	2	80	0.0250000
NODE_24285_length_607_cov_10.690945	199	279	6	18	80	0.2250000
NODE_24285_length_607_cov_10.690945	199	279	7	35	80	0.4375000
NODE_24285_length_607_cov_10.690945	252	332	4	55	80	0.6875000
NODE_24285_length_607_cov_10.690945	252	332	5	2	80	0.0250000
NODE_24285_length_607_cov_10.690945	252	332	6	2	80	0.0250000
NODE_24285_length_607_cov_10.690945	252	332	7	21	80	0.2625000
NODE_24290_length_607_cov_5.818898	301	386	0	85	85	1.0000000
NODE_24291_length_607_cov_5.771654	278	358	0	10	80	0.1250000
NODE_24291_length_607_cov_5.771654	278	358	2	3	80	0.0375000
NODE_24291_length_607_cov_5.771654	278	358	3	23	80	0.2875000
NODE_24291_length_607_cov_5.771654	278	358	4	44	80	0.5500000
NODE_24291_length_607_cov_5.771654	331	411	4	80	80	1.0000000
NODE_24295_length_607_cov_4.816929	282	362	0	80	80	1.0000000
NODE_24295_length_607_cov_4.816929	335	415	0	80	80	1.0000000
NODE_24300_length_607_cov_4.015748	295	354	1	59	59	1.0000000
NODE_24310_length_607_cov_3.088583	107	158	0	51	51	1.0000000
NODE_24331_length_607_cov_1.791339	204	247	0	43	43	1.0000000
NODE_24400_length_606_cov_42.264300	182	262	5	64	80	0.8000000
NODE_24400_length_606_cov_42.264300	182	262	6	15	80	0.1875000
NODE_24400_length_606_cov_42.264300	182	262	7	1	80	0.0125000
NODE_24400_length_606_cov_42.264300	235	315	5	21	80	0.2625000
NODE_24400_length_606_cov_42.264300	235	315	6	5	80	0.0625000
NODE_24400_length_606_cov_42.264300	235	315	7	3	80	0.0375000
NODE_24400_length_606_cov_42.264300	235	315	8	35	80	0.4375000
NODE_24400_length_606_cov_42.264300	235	315	9	4	80	0.0500000
NODE_24400_length_606_cov_42.264300	235	315	10	12	80	0.1500000
NODE_24402_length_606_cov_26.341223	371	451	3	2	80	0.0250000
NODE_24402_length_606_cov_26.341223	371	451	4	56	80	0.7000000
NODE_24402_length_606_cov_26.341223	371	451	5	22	80	0.2750000
NODE_24402_length_606_cov_26.341223	424	504	4	15	80	0.1875000
NODE_24402_length_606_cov_26.341223	424	504	5	65	80	0.8125000
NODE_24403_length_606_cov_14.895464	308	388	6	3	80	0.0375000
NODE_24403_length_606_cov_14.895464	308	388	7	10	80	0.1250000
NODE_24403_length_606_cov_14.895464	308	388	8	9	80	0.1125000
NODE_24403_length_606_cov_14.895464	308	388	9	39	80	0.4875000
NODE_24403_length_606_cov_14.895464	308	388	10	19	80	0.2375000
NODE_24403_length_606_cov_14.895464	361	441	4	10	80	0.1250000
NODE_24403_length_606_cov_14.895464	361	441	5	30	80	0.3750000
NODE_24403_length_606_cov_14.895464	361	441	8	14	80	0.1750000
NODE_24403_length_606_cov_14.895464	361	441	9	7	80	0.0875000
NODE_24403_length_606_cov_14.895464	361	441	10	19	80	0.2375000
NODE_24406_length_606_cov_7.934911	412	492	1	66	80	0.8250000
NODE_24406_length_606_cov_7.934911	412	492	2	2	80	0.0250000
NODE_24406_length_606_cov_7.934911	412	492	3	12	80	0.1500000
NODE_24406_length_606_cov_7.934911	465	545	0	6	80	0.0750000
NODE_24406_length_606_cov_7.934911	465	545	1	74	80	0.9250000
NODE_24407_length_606_cov_7.481262	250	330	0	80	80	1.0000000
NODE_24407_length_606_cov_7.481262	303	383	0	80	80	1.0000000
NODE_24409_length_606_cov_6.842209	139	219	3	3	80	0.0375000
NODE_24409_length_606_cov_6.842209	139	219	4	13	80	0.1625000
NODE_24409_length_606_cov_6.842209	139	219	5	64	80	0.8000000
NODE_24409_length_606_cov_6.842209	192	272	4	66	80	0.8250000
NODE_24409_length_606_cov_6.842209	192	272	5	14	80	0.1750000
NODE_24428_length_606_cov_3.384615	156	206	0	50	50	1.0000000
NODE_24433_length_606_cov_2.670611	113	193	0	77	80	0.9625000
NODE_24433_length_606_cov_2.670611	113	193	2	3	80	0.0375000
NODE_24525_length_605_cov_63.343874	7	83	0	28	76	0.3684210
NODE_24525_length_605_cov_63.343874	7	83	1	48	76	0.6315789
NODE_24525_length_605_cov_63.343874	12	83	0	23	71	0.3239437
NODE_24525_length_605_cov_63.343874	12	83	1	48	71	0.6760563
NODE_24525_length_605_cov_63.343874	17	83	0	18	66	0.2727273
NODE_24525_length_605_cov_63.343874	17	83	1	48	66	0.7272727
NODE_24525_length_605_cov_63.343874	56	136	1	80	80	1.0000000
NODE_24525_length_605_cov_63.343874	56	136	1	80	80	1.0000000
NODE_24525_length_605_cov_63.343874	56	136	1	80	80	1.0000000
NODE_24525_length_605_cov_63.343874	132	212	1	34	80	0.4250000
NODE_24525_length_605_cov_63.343874	132	212	2	46	80	0.5750000
NODE_24525_length_605_cov_63.343874	132	212	1	34	80	0.4250000
NODE_24525_length_605_cov_63.343874	132	212	2	46	80	0.5750000
NODE_24525_length_605_cov_63.343874	132	210	1	32	78	0.4102564
NODE_24525_length_605_cov_63.343874	132	210	2	46	78	0.5897436
NODE_24525_length_605_cov_63.343874	132	212	1	34	80	0.4250000
NODE_24525_length_605_cov_63.343874	132	212	2	46	80	0.5750000
NODE_24525_length_605_cov_63.343874	132	212	1	34	80	0.4250000
NODE_24525_length_605_cov_63.343874	132	212	2	46	80	0.5750000
NODE_24525_length_605_cov_63.343874	185	265	1	63	80	0.7875000
NODE_24525_length_605_cov_63.343874	185	265	2	17	80	0.2125000
NODE_24526_length_605_cov_48.191700	298	374	1	76	76	1.0000000
NODE_24526_length_605_cov_48.191700	347	427	0	16	80	0.2000000
NODE_24526_length_605_cov_48.191700	347	427	1	64	80	0.8000000
NODE_24528_length_605_cov_33.328063	57	137	25	2	80	0.0250000
NODE_24528_length_605_cov_33.328063	57	137	27	2	80	0.0250000
NODE_24528_length_605_cov_33.328063	57	137	28	9	80	0.1125000
NODE_24528_length_605_cov_33.328063	57	137	29	1	80	0.0125000
NODE_24528_length_605_cov_33.328063	57	137	30	2	80	0.0250000
NODE_24528_length_605_cov_33.328063	57	137	32	1	80	0.0125000
NODE_24528_length_605_cov_33.328063	57	137	33	4	80	0.0500000
NODE_24528_length_605_cov_33.328063	57	137	34	2	80	0.0250000
NODE_24528_length_605_cov_33.328063	57	137	38	9	80	0.1125000
NODE_24528_length_605_cov_33.328063	57	137	40	7	80	0.0875000
NODE_24528_length_605_cov_33.328063	57	137	42	11	80	0.1375000
NODE_24528_length_605_cov_33.328063	57	137	43	3	80	0.0375000
NODE_24528_length_605_cov_33.328063	57	137	46	2	80	0.0250000
NODE_24528_length_605_cov_33.328063	57	137	48	2	80	0.0250000
NODE_24528_length_605_cov_33.328063	57	137	50	3	80	0.0375000
NODE_24528_length_605_cov_33.328063	57	137	52	6	80	0.0750000
NODE_24528_length_605_cov_33.328063	57	137	53	3	80	0.0375000
NODE_24528_length_605_cov_33.328063	57	137	54	4	80	0.0500000
NODE_24528_length_605_cov_33.328063	57	137	55	3	80	0.0375000
NODE_24528_length_605_cov_33.328063	57	137	56	1	80	0.0125000
NODE_24528_length_605_cov_33.328063	57	137	57	1	80	0.0125000
NODE_24528_length_605_cov_33.328063	57	137	58	2	80	0.0250000
NODE_24528_length_605_cov_33.328063	140	175	65	5	35	0.1428571
NODE_24528_length_605_cov_33.328063	140	175	67	2	35	0.0571429
NODE_24528_length_605_cov_33.328063	140	175	69	11	35	0.3142857
NODE_24528_length_605_cov_33.328063	140	175	70	1	35	0.0285714
NODE_24528_length_605_cov_33.328063	140	175	71	9	35	0.2571429
NODE_24528_length_605_cov_33.328063	140	175	72	4	35	0.1142857
NODE_24528_length_605_cov_33.328063	140	175	73	1	35	0.0285714
NODE_24528_length_605_cov_33.328063	140	175	74	2	35	0.0571429
NODE_24529_length_605_cov_26.717391	353	433	0	37	80	0.4625000
NODE_24529_length_605_cov_26.717391	353	433	2	43	80	0.5375000
NODE_24529_length_605_cov_26.717391	406	486	2	80	80	1.0000000
NODE_24530_length_605_cov_17.677866	215	295	0	80	80	1.0000000
NODE_24530_length_605_cov_17.677866	268	348	0	80	80	1.0000000
NODE_24531_length_605_cov_15.225296	144	224	3	1	80	0.0125000
NODE_24531_length_605_cov_15.225296	144	224	4	79	80	0.9875000
NODE_24531_length_605_cov_15.225296	197	277	1	16	80	0.2000000
NODE_24531_length_605_cov_15.225296	197	277	3	11	80	0.1375000
NODE_24531_length_605_cov_15.225296	197	277	4	53	80	0.6625000
NODE_24532_length_605_cov_14.990119	136	216	6	35	80	0.4375000
NODE_24532_length_605_cov_14.990119	136	216	7	10	80	0.1250000
NODE_24532_length_605_cov_14.990119	136	216	9	16	80	0.2000000
NODE_24532_length_605_cov_14.990119	136	216	10	19	80	0.2375000
NODE_24532_length_605_cov_14.990119	189	269	3	5	80	0.0625000
NODE_24532_length_605_cov_14.990119	189	269	4	12	80	0.1500000
NODE_24532_length_605_cov_14.990119	189	269	5	20	80	0.2500000
NODE_24532_length_605_cov_14.990119	189	269	9	26	80	0.3250000
NODE_24532_length_605_cov_14.990119	189	269	10	17	80	0.2125000
NODE_24533_length_605_cov_10.835968	103	183	3	15	80	0.1875000
NODE_24533_length_605_cov_10.835968	103	183	5	55	80	0.6875000
NODE_24533_length_605_cov_10.835968	103	183	6	3	80	0.0375000
NODE_24533_length_605_cov_10.835968	103	183	7	7	80	0.0875000
NODE_24533_length_605_cov_10.835968	156	236	5	39	80	0.4875000
NODE_24533_length_605_cov_10.835968	156	236	6	34	80	0.4250000
NODE_24533_length_605_cov_10.835968	156	236	7	7	80	0.0875000
NODE_24534_length_605_cov_9.169960	306	377	0	71	71	1.0000000
NODE_24534_length_605_cov_9.169960	359	432	0	73	73	1.0000000
NODE_24546_length_605_cov_4.308300	159	239	0	49	80	0.6125000
NODE_24546_length_605_cov_4.308300	159	239	1	31	80	0.3875000
NODE_24546_length_605_cov_4.308300	271	338	0	24	67	0.3582090
NODE_24546_length_605_cov_4.308300	271	338	1	3	67	0.0447761
NODE_24546_length_605_cov_4.308300	271	338	3	40	67	0.5970149
NODE_24546_length_605_cov_4.308300	275	350	0	20	75	0.2666667
NODE_24546_length_605_cov_4.308300	275	350	1	3	75	0.0400000
NODE_24546_length_605_cov_4.308300	275	350	3	52	75	0.6933333
NODE_24546_length_605_cov_4.308300	315	372	1	4	57	0.0701754
NODE_24546_length_605_cov_4.308300	315	372	3	53	57	0.9298246
NODE_24546_length_605_cov_4.308300	328	373	1	5	45	0.1111111
NODE_24546_length_605_cov_4.308300	328	373	3	40	45	0.8888889
NODE_24558_length_605_cov_3.120553	216	287	0	71	71	1.0000000
NODE_24561_length_605_cov_2.909091	408	487	2	17	79	0.2151899
NODE_24561_length_605_cov_2.909091	408	487	4	62	79	0.7848101
NODE_24577_length_605_cov_1.897233	230	273	0	43	43	1.0000000
NODE_24603_length_605_cov_1.339921	168	210	1	42	42	1.0000000
NODE_24636_length_604_cov_30.411881	93	173	2	9	80	0.1125000
NODE_24636_length_604_cov_30.411881	93	173	4	66	80	0.8250000
NODE_24636_length_604_cov_30.411881	93	173	6	5	80	0.0625000
NODE_24636_length_604_cov_30.411881	146	226	2	47	80	0.5875000
NODE_24636_length_604_cov_30.411881	146	226	4	28	80	0.3500000
NODE_24636_length_604_cov_30.411881	146	226	6	5	80	0.0625000
NODE_24637_length_604_cov_20.099010	414	494	5	30	80	0.3750000
NODE_24637_length_604_cov_20.099010	414	494	7	4	80	0.0500000
NODE_24637_length_604_cov_20.099010	414	494	8	22	80	0.2750000
NODE_24637_length_604_cov_20.099010	414	494	9	24	80	0.3000000
NODE_24637_length_604_cov_20.099010	467	547	2	11	80	0.1375000
NODE_24637_length_604_cov_20.099010	467	547	4	8	80	0.1000000
NODE_24637_length_604_cov_20.099010	467	547	6	32	80	0.4000000
NODE_24637_length_604_cov_20.099010	467	547	7	2	80	0.0250000
NODE_24637_length_604_cov_20.099010	467	547	8	22	80	0.2750000
NODE_24637_length_604_cov_20.099010	467	547	9	5	80	0.0625000
NODE_24639_length_604_cov_10.291089	184	264	0	80	80	1.0000000
NODE_24639_length_604_cov_10.291089	237	317	0	80	80	1.0000000
NODE_24646_length_604_cov_6.033663	265	345	0	62	80	0.7750000
NODE_24646_length_604_cov_6.033663	265	345	3	18	80	0.2250000
NODE_24646_length_604_cov_6.033663	318	397	0	9	79	0.1139240
NODE_24646_length_604_cov_6.033663	318	397	3	19	79	0.2405063
NODE_24646_length_604_cov_6.033663	318	397	4	18	79	0.2278481
NODE_24646_length_604_cov_6.033663	318	397	5	9	79	0.1139240
NODE_24646_length_604_cov_6.033663	318	397	6	24	79	0.3037975
NODE_24654_length_604_cov_4.316832	40	106	0	66	66	1.0000000
NODE_24654_length_604_cov_4.316832	377	435	0	58	58	1.0000000
NODE_24692_length_604_cov_1.805941	299	380	0	45	81	0.5555556
NODE_24692_length_604_cov_1.805941	299	380	1	36	81	0.4444444
NODE_24692_length_604_cov_1.805941	353	433	1	52	80	0.6500000
NODE_24692_length_604_cov_1.805941	353	433	2	28	80	0.3500000
NODE_24732_length_603_cov_18.761905	108	188	0	80	80	1.0000000
NODE_24732_length_603_cov_18.761905	161	241	0	80	80	1.0000000
NODE_24734_length_603_cov_8.996032	163	243	2	69	80	0.8625000
NODE_24734_length_603_cov_8.996032	163	243	4	11	80	0.1375000
NODE_24734_length_603_cov_8.996032	216	296	2	16	80	0.2000000
NODE_24734_length_603_cov_8.996032	216	296	3	19	80	0.2375000
NODE_24734_length_603_cov_8.996032	216	296	4	41	80	0.5125000
NODE_24734_length_603_cov_8.996032	216	296	5	4	80	0.0500000
NODE_24735_length_603_cov_8.970238	413	493	3	7	80	0.0875000
NODE_24735_length_603_cov_8.970238	413	493	4	10	80	0.1250000
NODE_24735_length_603_cov_8.970238	413	493	5	63	80	0.7875000
NODE_24736_length_603_cov_7.212302	324	404	0	80	80	1.0000000
NODE_24736_length_603_cov_7.212302	377	457	0	40	80	0.5000000
NODE_24736_length_603_cov_7.212302	377	457	1	40	80	0.5000000
NODE_24739_length_603_cov_5.831349	351	385	0	34	34	1.0000000
NODE_24744_length_603_cov_4.744048	103	183	0	80	80	1.0000000
NODE_24744_length_603_cov_4.744048	156	236	0	80	80	1.0000000
NODE_24748_length_603_cov_4.115079	219	259	0	35	40	0.8750000
NODE_24748_length_603_cov_4.115079	219	259	1	5	40	0.1250000
NODE_24755_length_603_cov_3.269841	186	223	2	37	37	1.0000000
NODE_24755_length_603_cov_3.269841	196	276	2	80	80	1.0000000
NODE_24755_length_603_cov_3.269841	367	441	0	74	74	1.0000000
NODE_24843_length_602_cov_33.208748	106	186	5	41	80	0.5125000
NODE_24843_length_602_cov_33.208748	106	186	7	8	80	0.1000000
NODE_24843_length_602_cov_33.208748	106	186	8	15	80	0.1875000
NODE_24843_length_602_cov_33.208748	106	186	9	10	80	0.1250000
NODE_24843_length_602_cov_33.208748	106	186	10	1	80	0.0125000
NODE_24843_length_602_cov_33.208748	106	186	11	5	80	0.0625000
NODE_24843_length_602_cov_33.208748	159	239	7	4	80	0.0500000
NODE_24843_length_602_cov_33.208748	159	239	8	7	80	0.0875000
NODE_24843_length_602_cov_33.208748	159	239	9	18	80	0.2250000
NODE_24843_length_602_cov_33.208748	159	239	10	40	80	0.5000000
NODE_24843_length_602_cov_33.208748	159	239	11	11	80	0.1375000
NODE_24844_length_602_cov_28.922465	319	399	7	3	80	0.0375000
NODE_24844_length_602_cov_28.922465	319	399	9	10	80	0.1250000
NODE_24844_length_602_cov_28.922465	319	399	10	15	80	0.1875000
NODE_24844_length_602_cov_28.922465	319	399	11	1	80	0.0125000
NODE_24844_length_602_cov_28.922465	319	399	12	51	80	0.6375000
NODE_24844_length_602_cov_28.922465	372	452	6	7	80	0.0875000
NODE_24844_length_602_cov_28.922465	372	452	8	11	80	0.1375000
NODE_24844_length_602_cov_28.922465	372	452	9	8	80	0.1000000
NODE_24844_length_602_cov_28.922465	372	452	10	33	80	0.4125000
NODE_24844_length_602_cov_28.922465	372	452	11	1	80	0.0125000
NODE_24844_length_602_cov_28.922465	372	452	12	20	80	0.2500000
NODE_24846_length_602_cov_10.930417	248	328	6	39	80	0.4875000
NODE_24846_length_602_cov_10.930417	248	328	7	32	80	0.4000000
NODE_24846_length_602_cov_10.930417	248	328	8	9	80	0.1125000
NODE_24846_length_602_cov_10.930417	301	381	3	8	80	0.1000000
NODE_24846_length_602_cov_10.930417	301	381	4	1	80	0.0125000
NODE_24846_length_602_cov_10.930417	301	381	5	1	80	0.0125000
NODE_24846_length_602_cov_10.930417	301	381	6	37	80	0.4625000
NODE_24846_length_602_cov_10.930417	301	381	7	15	80	0.1875000
NODE_24846_length_602_cov_10.930417	301	381	8	18	80	0.2250000
NODE_24847_length_602_cov_10.447316	148	207	2	5	59	0.0847458
NODE_24847_length_602_cov_10.447316	148	207	3	23	59	0.3898305
NODE_24847_length_602_cov_10.447316	148	207	4	26	59	0.4406780
NODE_24847_length_602_cov_10.447316	148	207	5	5	59	0.0847458
NODE_24847_length_602_cov_10.447316	181	207	4	21	26	0.8076923
NODE_24847_length_602_cov_10.447316	181	207	5	5	26	0.1923077
NODE_24847_length_602_cov_10.447316	259	291	5	32	32	1.0000000
NODE_24851_length_602_cov_7.787276	544	565	0	21	21	1.0000000
NODE_24875_length_602_cov_3.332008	157	239	0	82	82	1.0000000
NODE_24957_length_601_cov_14.952191	183	263	0	80	80	1.0000000
NODE_24957_length_601_cov_14.952191	236	316	0	80	80	1.0000000
NODE_24958_length_601_cov_14.747012	324	404	6	15	80	0.1875000
NODE_24958_length_601_cov_14.747012	324	404	7	50	80	0.6250000
NODE_24958_length_601_cov_14.747012	324	404	10	15	80	0.1875000
NODE_24958_length_601_cov_14.747012	377	457	2	21	80	0.2625000
NODE_24958_length_601_cov_14.747012	377	457	4	22	80	0.2750000
NODE_24958_length_601_cov_14.747012	377	457	7	37	80	0.4625000
NODE_24959_length_601_cov_11.561753	226	306	1	61	80	0.7625000
NODE_24959_length_601_cov_11.561753	226	306	2	19	80	0.2375000
NODE_24959_length_601_cov_11.561753	279	359	1	80	80	1.0000000
NODE_24960_length_601_cov_10.826693	320	388	0	23	68	0.3382353
NODE_24960_length_601_cov_10.826693	320	388	1	30	68	0.4411765
NODE_24960_length_601_cov_10.826693	320	388	2	15	68	0.2205882
NODE_24961_length_601_cov_10.392430	243	323	2	30	80	0.3750000
NODE_24961_length_601_cov_10.392430	243	323	4	20	80	0.2500000
NODE_24961_length_601_cov_10.392430	243	323	5	8	80	0.1000000
NODE_24961_length_601_cov_10.392430	243	323	6	17	80	0.2125000
NODE_24961_length_601_cov_10.392430	243	323	7	5	80	0.0625000
NODE_24961_length_601_cov_10.392430	296	375	5	55	79	0.6962025
NODE_24961_length_601_cov_10.392430	296	375	6	19	79	0.2405063
NODE_24961_length_601_cov_10.392430	296	375	7	5	79	0.0632911
NODE_24965_length_601_cov_7.037849	236	316	3	42	80	0.5250000
NODE_24965_length_601_cov_7.037849	236	316	4	7	80	0.0875000
NODE_24965_length_601_cov_7.037849	236	316	5	31	80	0.3875000
NODE_24965_length_601_cov_7.037849	289	369	2	27	80	0.3375000
NODE_24965_length_601_cov_7.037849	289	369	3	46	80	0.5750000
NODE_24965_length_601_cov_7.037849	289	369	4	6	80	0.0750000
NODE_24965_length_601_cov_7.037849	289	369	5	1	80	0.0125000
NODE_24969_length_601_cov_5.798805	290	361	0	71	71	1.0000000
NODE_24970_length_601_cov_5.657371	228	308	2	10	80	0.1250000
NODE_24970_length_601_cov_5.657371	228	308	4	70	80	0.8750000
NODE_24973_length_601_cov_5.039841	395	462	1	67	67	1.0000000
NODE_24975_length_601_cov_4.735060	184	247	0	63	63	1.0000000
NODE_24995_length_601_cov_2.599602	371	430	2	59	59	1.0000000
NODE_24995_length_601_cov_2.599602	441	494	0	14	53	0.2641509
NODE_24995_length_601_cov_2.599602	441	494	2	39	53	0.7358491
NODE_25090_length_600_cov_6.341317	125	147	0	22	22	1.0000000
NODE_25103_length_600_cov_3.754491	142	222	0	80	80	1.0000000
NODE_25126_length_600_cov_2.081836	282	328	0	46	46	1.0000000
NODE_25141_length_600_cov_1.728543	381	423	0	42	42	1.0000000
NODE_25190_length_599_cov_36.488000	25	105	2	80	80	1.0000000
NODE_25191_length_599_cov_27.870000	255	335	0	20	80	0.2500000
NODE_25191_length_599_cov_27.870000	255	335	1	23	80	0.2875000
NODE_25191_length_599_cov_27.870000	255	335	3	37	80	0.4625000
NODE_25191_length_599_cov_27.870000	308	388	3	32	80	0.4000000
NODE_25191_length_599_cov_27.870000	308	388	4	48	80	0.6000000
NODE_25192_length_599_cov_22.640000	229	309	0	80	80	1.0000000
NODE_25192_length_599_cov_22.640000	229	309	0	80	80	1.0000000
NODE_25192_length_599_cov_22.640000	229	309	0	80	80	1.0000000
NODE_25192_length_599_cov_22.640000	229	309	0	80	80	1.0000000
NODE_25192_length_599_cov_22.640000	229	309	0	80	80	1.0000000
NODE_25192_length_599_cov_22.640000	282	362	0	80	80	1.0000000
NODE_25192_length_599_cov_22.640000	282	362	0	80	80	1.0000000
NODE_25192_length_599_cov_22.640000	282	353	0	71	71	1.0000000
NODE_25192_length_599_cov_22.640000	285	355	0	70	70	1.0000000
NODE_25192_length_599_cov_22.640000	287	362	0	75	75	1.0000000
NODE_25193_length_599_cov_14.618000	279	359	5	5	80	0.0625000
NODE_25193_length_599_cov_14.618000	279	359	6	50	80	0.6250000
NODE_25193_length_599_cov_14.618000	279	359	7	25	80	0.3125000
NODE_25193_length_599_cov_14.618000	332	412	2	1	80	0.0125000
NODE_25193_length_599_cov_14.618000	332	412	3	8	80	0.1000000
NODE_25193_length_599_cov_14.618000	332	412	4	14	80	0.1750000
NODE_25193_length_599_cov_14.618000	332	412	5	34	80	0.4250000
NODE_25193_length_599_cov_14.618000	332	412	6	23	80	0.2875000
NODE_25195_length_599_cov_10.308000	245	325	1	80	80	1.0000000
NODE_25195_length_599_cov_10.308000	298	378	1	80	80	1.0000000
NODE_25196_length_599_cov_9.224000	160	240	2	14	80	0.1750000
NODE_25196_length_599_cov_9.224000	160	240	3	49	80	0.6125000
NODE_25196_length_599_cov_9.224000	160	240	4	17	80	0.2125000
NODE_25196_length_599_cov_9.224000	213	297	0	49	84	0.5833333
NODE_25196_length_599_cov_9.224000	213	297	2	22	84	0.2619048
NODE_25196_length_599_cov_9.224000	213	297	3	13	84	0.1547619
NODE_25201_length_599_cov_5.536000	58	112	0	54	54	1.0000000
NODE_25208_length_599_cov_3.810000	271	334	0	63	63	1.0000000
NODE_25208_length_599_cov_3.810000	324	390	0	66	66	1.0000000
NODE_25211_length_599_cov_3.598000	238	318	0	80	80	1.0000000
NODE_25211_length_599_cov_3.598000	291	371	0	80	80	1.0000000
NODE_25308_length_598_cov_54.450902	264	344	3	1	80	0.0125000
NODE_25308_length_598_cov_54.450902	264	344	4	42	80	0.5250000
NODE_25308_length_598_cov_54.450902	264	344	5	19	80	0.2375000
NODE_25308_length_598_cov_54.450902	264	344	6	18	80	0.2250000
NODE_25308_length_598_cov_54.450902	317	397	5	23	80	0.2875000
NODE_25308_length_598_cov_54.450902	317	397	6	51	80	0.6375000
NODE_25308_length_598_cov_54.450902	317	397	7	6	80	0.0750000
NODE_25309_length_598_cov_8.326653	204	284	0	80	80	1.0000000
NODE_25309_length_598_cov_8.326653	257	337	0	35	80	0.4375000
NODE_25309_length_598_cov_8.326653	257	337	1	45	80	0.5625000
NODE_25316_length_598_cov_5.623246	169	240	0	17	71	0.2394366
NODE_25316_length_598_cov_5.623246	169	240	2	6	71	0.0845070
NODE_25316_length_598_cov_5.623246	169	240	3	48	71	0.6760563
NODE_25320_length_598_cov_4.929860	73	153	1	22	80	0.2750000
NODE_25320_length_598_cov_4.929860	73	153	2	58	80	0.7250000
NODE_25320_length_598_cov_4.929860	126	206	2	80	80	1.0000000
NODE_25421_length_597_cov_15.142570	197	277	3	25	80	0.3125000
NODE_25421_length_597_cov_15.142570	197	277	4	55	80	0.6875000
NODE_25421_length_597_cov_15.142570	250	330	2	23	80	0.2875000
NODE_25421_length_597_cov_15.142570	250	330	3	10	80	0.1250000
NODE_25421_length_597_cov_15.142570	250	330	4	47	80	0.5875000
NODE_25422_length_597_cov_12.387550	118	198	4	15	80	0.1875000
NODE_25422_length_597_cov_12.387550	118	198	6	1	80	0.0125000
NODE_25422_length_597_cov_12.387550	118	198	7	17	80	0.2125000
NODE_25422_length_597_cov_12.387550	118	198	9	6	80	0.0750000
NODE_25422_length_597_cov_12.387550	118	198	10	32	80	0.4000000
NODE_25422_length_597_cov_12.387550	118	198	11	9	80	0.1125000
NODE_25422_length_597_cov_12.387550	171	251	5	10	80	0.1250000
NODE_25422_length_597_cov_12.387550	171	251	6	12	80	0.1500000
NODE_25422_length_597_cov_12.387550	171	251	8	1	80	0.0125000
NODE_25422_length_597_cov_12.387550	171	251	9	4	80	0.0500000
NODE_25422_length_597_cov_12.387550	171	251	10	53	80	0.6625000
NODE_25423_length_597_cov_7.016064	213	293	0	22	80	0.2750000
NODE_25423_length_597_cov_7.016064	213	293	2	58	80	0.7250000
NODE_25423_length_597_cov_7.016064	266	346	2	80	80	1.0000000
NODE_25426_length_597_cov_6.212851	374	449	0	75	75	1.0000000
NODE_25434_length_597_cov_4.273092	368	448	0	17	80	0.2125000
NODE_25434_length_597_cov_4.273092	368	448	1	52	80	0.6500000
NODE_25434_length_597_cov_4.273092	368	448	2	11	80	0.1375000
NODE_25434_length_597_cov_4.273092	421	507	0	76	86	0.8837209
NODE_25434_length_597_cov_4.273092	421	507	1	10	86	0.1162791
NODE_25464_length_597_cov_2.162651	92	172	0	13	80	0.1625000
NODE_25464_length_597_cov_2.162651	92	172	1	58	80	0.7250000
NODE_25464_length_597_cov_2.162651	92	172	2	9	80	0.1125000
NODE_25464_length_597_cov_2.162651	145	225	1	18	80	0.2250000
NODE_25464_length_597_cov_2.162651	145	225	2	62	80	0.7750000
NODE_25467_length_597_cov_2.096386	440	509	0	61	69	0.8840580
NODE_25467_length_597_cov_2.096386	440	509	1	8	69	0.1159420
NODE_25469_length_597_cov_1.977912	392	472	0	80	80	1.0000000
NODE_25469_length_597_cov_1.977912	437	494	0	57	57	1.0000000
NODE_25469_length_597_cov_1.977912	445	525	0	80	80	1.0000000
NODE_25552_length_596_cov_32.293763	221	301	1	8	80	0.1000000
NODE_25552_length_596_cov_32.293763	221	301	3	47	80	0.5875000
NODE_25552_length_596_cov_32.293763	221	301	5	25	80	0.3125000
NODE_25552_length_596_cov_32.293763	274	354	3	8	80	0.1000000
NODE_25552_length_596_cov_32.293763	274	354	4	9	80	0.1125000
NODE_25552_length_596_cov_32.293763	274	354	5	49	80	0.6125000
NODE_25552_length_596_cov_32.293763	274	354	6	14	80	0.1750000
NODE_25552_length_596_cov_32.293763	351	406	3	4	55	0.0727273
NODE_25552_length_596_cov_32.293763	351	406	5	35	55	0.6363636
NODE_25552_length_596_cov_32.293763	351	406	6	16	55	0.2909091
NODE_25552_length_596_cov_32.293763	381	459	2	6	78	0.0769231
NODE_25552_length_596_cov_32.293763	381	459	3	38	78	0.4871795
NODE_25552_length_596_cov_32.293763	381	459	4	13	78	0.1666667
NODE_25552_length_596_cov_32.293763	381	459	5	21	78	0.2692308
NODE_25553_length_596_cov_26.891348	199	279	11	3	80	0.0375000
NODE_25553_length_596_cov_26.891348	199	279	12	5	80	0.0625000
NODE_25553_length_596_cov_26.891348	199	279	13	1	80	0.0125000
NODE_25553_length_596_cov_26.891348	199	279	14	5	80	0.0625000
NODE_25553_length_596_cov_26.891348	199	279	15	12	80	0.1500000
NODE_25553_length_596_cov_26.891348	199	279	16	13	80	0.1625000
NODE_25553_length_596_cov_26.891348	199	279	17	5	80	0.0625000
NODE_25553_length_596_cov_26.891348	199	279	18	25	80	0.3125000
NODE_25553_length_596_cov_26.891348	199	279	19	4	80	0.0500000
NODE_25553_length_596_cov_26.891348	199	279	20	7	80	0.0875000
NODE_25553_length_596_cov_26.891348	252	332	13	1	80	0.0125000
NODE_25553_length_596_cov_26.891348	252	332	14	5	80	0.0625000
NODE_25553_length_596_cov_26.891348	252	332	15	34	80	0.4250000
NODE_25553_length_596_cov_26.891348	252	332	16	19	80	0.2375000
NODE_25553_length_596_cov_26.891348	252	332	17	19	80	0.2375000
NODE_25553_length_596_cov_26.891348	252	332	19	2	80	0.0250000
NODE_25554_length_596_cov_17.082495	179	259	3	13	80	0.1625000
NODE_25554_length_596_cov_17.082495	179	259	4	67	80	0.8375000
NODE_25554_length_596_cov_17.082495	232	312	1	4	80	0.0500000
NODE_25554_length_596_cov_17.082495	232	312	2	38	80	0.4750000
NODE_25554_length_596_cov_17.082495	232	312	4	38	80	0.4750000
NODE_25555_length_596_cov_10.372233	354	434	0	80	80	1.0000000
NODE_25555_length_596_cov_10.372233	407	487	0	80	80	1.0000000
NODE_25557_length_596_cov_6.955734	142	222	0	19	80	0.2375000
NODE_25557_length_596_cov_6.955734	142	222	1	61	80	0.7625000
NODE_25558_length_596_cov_6.225352	242	322	0	80	80	1.0000000
NODE_25558_length_596_cov_6.225352	308	375	0	67	67	1.0000000
NODE_25567_length_596_cov_4.197183	369	444	0	38	75	0.5066667
NODE_25567_length_596_cov_4.197183	369	444	2	37	75	0.4933333
NODE_25593_length_596_cov_2.066398	534	583	0	49	49	1.0000000
NODE_25666_length_595_cov_52.532258	248	328	0	5	80	0.0625000
NODE_25666_length_595_cov_52.532258	248	328	2	16	80	0.2000000
NODE_25666_length_595_cov_52.532258	248	328	4	3	80	0.0375000
NODE_25666_length_595_cov_52.532258	248	328	5	26	80	0.3250000
NODE_25666_length_595_cov_52.532258	248	328	6	30	80	0.3750000
NODE_25666_length_595_cov_52.532258	301	381	2	12	80	0.1500000
NODE_25666_length_595_cov_52.532258	301	381	4	23	80	0.2875000
NODE_25666_length_595_cov_52.532258	301	381	6	45	80	0.5625000
NODE_25667_length_595_cov_38.584677	122	202	7	14	80	0.1750000
NODE_25667_length_595_cov_38.584677	122	202	9	13	80	0.1625000
NODE_25667_length_595_cov_38.584677	122	202	11	2	80	0.0250000
NODE_25667_length_595_cov_38.584677	122	202	12	6	80	0.0750000
NODE_25667_length_595_cov_38.584677	122	202	14	45	80	0.5625000
NODE_25667_length_595_cov_38.584677	175	255	12	17	80	0.2125000
NODE_25667_length_595_cov_38.584677	175	255	13	11	80	0.1375000
NODE_25667_length_595_cov_38.584677	175	255	14	52	80	0.6500000
NODE_25669_length_595_cov_10.576613	323	403	0	80	80	1.0000000
NODE_25669_length_595_cov_10.576613	376	456	0	80	80	1.0000000
NODE_25672_length_595_cov_7.917339	342	415	0	73	73	1.0000000
NODE_25672_length_595_cov_7.917339	388	438	0	36	50	0.7200000
NODE_25672_length_595_cov_7.917339	388	438	1	14	50	0.2800000
NODE_25702_length_595_cov_2.792339	178	258	1	11	80	0.1375000
NODE_25702_length_595_cov_2.792339	178	258	2	52	80	0.6500000
NODE_25702_length_595_cov_2.792339	178	258	3	17	80	0.2125000
NODE_25702_length_595_cov_2.792339	231	311	1	64	80	0.8000000
NODE_25702_length_595_cov_2.792339	231	311	2	16	80	0.2000000
NODE_25807_length_594_cov_34.157576	283	363	7	9	80	0.1125000
NODE_25807_length_594_cov_34.157576	283	363	8	53	80	0.6625000
NODE_25807_length_594_cov_34.157576	283	363	9	17	80	0.2125000
NODE_25807_length_594_cov_34.157576	283	363	10	1	80	0.0125000
NODE_25807_length_594_cov_34.157576	336	416	4	17	80	0.2125000
NODE_25807_length_594_cov_34.157576	336	416	5	9	80	0.1125000
NODE_25807_length_594_cov_34.157576	336	416	6	8	80	0.1000000
NODE_25807_length_594_cov_34.157576	336	416	8	22	80	0.2750000
NODE_25807_length_594_cov_34.157576	336	416	9	23	80	0.2875000
NODE_25807_length_594_cov_34.157576	336	416	10	1	80	0.0125000
NODE_25811_length_594_cov_8.933333	258	338	2	4	80	0.0500000
NODE_25811_length_594_cov_8.933333	258	338	3	20	80	0.2500000
NODE_25811_length_594_cov_8.933333	258	338	5	19	80	0.2375000
NODE_25811_length_594_cov_8.933333	258	338	6	37	80	0.4625000
NODE_25811_length_594_cov_8.933333	311	389	2	4	78	0.0512821
NODE_25811_length_594_cov_8.933333	311	389	4	36	78	0.4615385
NODE_25811_length_594_cov_8.933333	311	389	6	38	78	0.4871795
NODE_25815_length_594_cov_5.759596	82	118	0	21	36	0.5833333
NODE_25815_length_594_cov_5.759596	82	118	2	15	36	0.4166667
NODE_25815_length_594_cov_5.759596	114	194	2	24	80	0.3000000
NODE_25815_length_594_cov_5.759596	114	194	4	56	80	0.7000000
NODE_25815_length_594_cov_5.759596	167	242	0	8	75	0.1066667
NODE_25815_length_594_cov_5.759596	167	242	1	3	75	0.0400000
NODE_25815_length_594_cov_5.759596	167	242	3	12	75	0.1600000
NODE_25815_length_594_cov_5.759596	167	242	4	52	75	0.6933333
NODE_25825_length_594_cov_3.913131	275	355	0	80	80	1.0000000
NODE_25844_length_594_cov_2.470707	209	247	0	38	38	1.0000000
NODE_25919_length_594_cov_0.698990	33	73	0	40	40	1.0000000
NODE_25928_length_593_cov_124.985830	247	285	7	1	38	0.0263158
NODE_25928_length_593_cov_124.985830	247	285	8	11	38	0.2894737
NODE_25928_length_593_cov_124.985830	247	285	11	1	38	0.0263158
NODE_25928_length_593_cov_124.985830	247	285	12	1	38	0.0263158
NODE_25928_length_593_cov_124.985830	247	285	14	2	38	0.0526316
NODE_25928_length_593_cov_124.985830	247	285	16	2	38	0.0526316
NODE_25928_length_593_cov_124.985830	247	285	17	4	38	0.1052632
NODE_25928_length_593_cov_124.985830	247	285	18	4	38	0.1052632
NODE_25928_length_593_cov_124.985830	247	285	19	2	38	0.0526316
NODE_25928_length_593_cov_124.985830	247	285	20	10	38	0.2631579
NODE_25929_length_593_cov_36.161943	150	230	4	12	80	0.1500000
NODE_25929_length_593_cov_36.161943	150	230	5	21	80	0.2625000
NODE_25929_length_593_cov_36.161943	150	230	6	9	80	0.1125000
NODE_25929_length_593_cov_36.161943	150	230	7	2	80	0.0250000
NODE_25929_length_593_cov_36.161943	150	230	9	36	80	0.4500000
NODE_25929_length_593_cov_36.161943	203	283	6	13	80	0.1625000
NODE_25929_length_593_cov_36.161943	203	283	7	17	80	0.2125000
NODE_25929_length_593_cov_36.161943	203	283	8	18	80	0.2250000
NODE_25929_length_593_cov_36.161943	203	283	9	32	80	0.4000000
NODE_25930_length_593_cov_14.979757	219	299	1	52	80	0.6500000
NODE_25930_length_593_cov_14.979757	219	299	2	28	80	0.3500000
NODE_25930_length_593_cov_14.979757	272	352	1	80	80	1.0000000
NODE_25931_length_593_cov_11.018219	324	404	0	80	80	1.0000000
NODE_25931_length_593_cov_11.018219	377	457	0	80	80	1.0000000
NODE_25946_length_593_cov_3.232794	210	273	0	63	63	1.0000000
NODE_25946_length_593_cov_3.232794	263	326	0	16	63	0.2539683
NODE_25946_length_593_cov_3.232794	263	326	2	47	63	0.7460318
NODE_25996_length_593_cov_1.261134	227	249	0	22	22	1.0000000
NODE_26033_length_592_cov_18.908722	163	243	0	61	80	0.7625000
NODE_26033_length_592_cov_18.908722	163	243	1	14	80	0.1750000
NODE_26033_length_592_cov_18.908722	163	243	2	5	80	0.0625000
NODE_26033_length_592_cov_18.908722	230	296	1	8	66	0.1212121
NODE_26033_length_592_cov_18.908722	230	296	2	11	66	0.1666667
NODE_26033_length_592_cov_18.908722	230	296	4	47	66	0.7121212
NODE_26034_length_592_cov_7.531440	232	312	0	80	80	1.0000000
NODE_26034_length_592_cov_7.531440	285	361	0	76	76	1.0000000
NODE_26035_length_592_cov_7.000000	77	157	1	32	80	0.4000000
NODE_26035_length_592_cov_7.000000	77	157	2	48	80	0.6000000
NODE_26035_length_592_cov_7.000000	130	210	2	80	80	1.0000000
NODE_26040_length_592_cov_5.036511	270	349	0	79	79	1.0000000
NODE_26041_length_592_cov_5.024341	205	285	0	80	80	1.0000000
NODE_26041_length_592_cov_5.024341	258	309	0	51	51	1.0000000
NODE_26062_length_592_cov_2.866126	61	127	0	66	66	1.0000000
NODE_26069_length_592_cov_2.361055	476	526	0	50	50	1.0000000
NODE_26142_length_591_cov_11.286585	245	325	0	35	80	0.4375000
NODE_26142_length_591_cov_11.286585	245	325	1	45	80	0.5625000
NODE_26142_length_591_cov_11.286585	298	378	1	80	80	1.0000000
NODE_26143_length_591_cov_9.432927	241	321	2	4	80	0.0500000
NODE_26143_length_591_cov_9.432927	241	321	3	51	80	0.6375000
NODE_26143_length_591_cov_9.432927	241	321	4	22	80	0.2750000
NODE_26143_length_591_cov_9.432927	241	321	6	3	80	0.0375000
NODE_26143_length_591_cov_9.432927	294	374	3	2	80	0.0250000
NODE_26143_length_591_cov_9.432927	294	374	4	69	80	0.8625000
NODE_26143_length_591_cov_9.432927	294	374	6	9	80	0.1125000
NODE_26184_length_591_cov_2.365854	396	476	1	80	80	1.0000000
NODE_26184_length_591_cov_2.365854	449	529	1	37	80	0.4625000
NODE_26184_length_591_cov_2.365854	449	529	2	43	80	0.5375000
NODE_26272_length_590_cov_29.661914	26	106	0	80	80	1.0000000
NODE_26272_length_590_cov_29.661914	79	159	0	80	80	1.0000000
NODE_26272_length_590_cov_29.661914	155	235	0	35	80	0.4375000
NODE_26272_length_590_cov_29.661914	155	235	2	15	80	0.1875000
NODE_26272_length_590_cov_29.661914	155	235	3	13	80	0.1625000
NODE_26272_length_590_cov_29.661914	155	235	4	17	80	0.2125000
NODE_26272_length_590_cov_29.661914	208	288	3	10	80	0.1250000
NODE_26272_length_590_cov_29.661914	208	288	4	70	80	0.8750000
NODE_26273_length_590_cov_21.360489	178	258	3	12	80	0.1500000
NODE_26273_length_590_cov_21.360489	178	258	4	12	80	0.1500000
NODE_26273_length_590_cov_21.360489	178	258	5	56	80	0.7000000
NODE_26273_length_590_cov_21.360489	231	311	3	37	80	0.4625000
NODE_26273_length_590_cov_21.360489	231	311	4	28	80	0.3500000
NODE_26273_length_590_cov_21.360489	231	311	5	15	80	0.1875000
NODE_26274_length_590_cov_18.395112	161	241	1	6	80	0.0750000
NODE_26274_length_590_cov_18.395112	161	241	2	18	80	0.2250000
NODE_26274_length_590_cov_18.395112	161	241	3	4	80	0.0500000
NODE_26274_length_590_cov_18.395112	161	241	5	52	80	0.6500000
NODE_26274_length_590_cov_18.395112	214	294	4	5	80	0.0625000
NODE_26274_length_590_cov_18.395112	214	294	5	75	80	0.9375000
NODE_26275_length_590_cov_17.376782	238	318	4	6	80	0.0750000
NODE_26275_length_590_cov_17.376782	238	318	5	58	80	0.7250000
NODE_26275_length_590_cov_17.376782	238	318	6	16	80	0.2000000
NODE_26275_length_590_cov_17.376782	291	371	2	11	80	0.1375000
NODE_26275_length_590_cov_17.376782	291	371	3	41	80	0.5125000
NODE_26275_length_590_cov_17.376782	291	371	5	28	80	0.3500000
NODE_26279_length_590_cov_6.205703	262	333	2	37	71	0.5211267
NODE_26279_length_590_cov_6.205703	262	333	4	34	71	0.4788733
NODE_26283_length_590_cov_5.319756	224	304	2	80	80	1.0000000
NODE_26283_length_590_cov_5.319756	277	357	0	48	80	0.6000000
NODE_26283_length_590_cov_5.319756	277	357	2	32	80	0.4000000
NODE_26366_length_590_cov_0.971487	0	32	0	32	32	1.0000000
NODE_26390_length_589_cov_15.810204	384	464	0	80	80	1.0000000
NODE_26390_length_589_cov_15.810204	437	517	0	80	80	1.0000000
NODE_26391_length_589_cov_13.855102	320	400	3	7	80	0.0875000
NODE_26391_length_589_cov_13.855102	320	400	4	17	80	0.2125000
NODE_26391_length_589_cov_13.855102	320	400	5	5	80	0.0625000
NODE_26391_length_589_cov_13.855102	320	400	7	51	80	0.6375000
NODE_26391_length_589_cov_13.855102	373	453	3	1	80	0.0125000
NODE_26391_length_589_cov_13.855102	373	453	5	13	80	0.1625000
NODE_26391_length_589_cov_13.855102	373	453	7	66	80	0.8250000
NODE_26395_length_589_cov_6.297959	186	266	2	37	80	0.4625000
NODE_26395_length_589_cov_6.297959	186	266	4	35	80	0.4375000
NODE_26395_length_589_cov_6.297959	186	266	6	8	80	0.1000000
NODE_26395_length_589_cov_6.297959	239	319	4	24	80	0.3000000
NODE_26395_length_589_cov_6.297959	239	319	5	23	80	0.2875000
NODE_26395_length_589_cov_6.297959	239	319	6	33	80	0.4125000
NODE_26430_length_589_cov_2.320408	431	511	0	30	80	0.3750000
NODE_26430_length_589_cov_2.320408	431	511	2	50	80	0.6250000
NODE_26515_length_588_cov_49.936605	264	341	0	49	77	0.6363636
NODE_26515_length_588_cov_49.936605	264	341	2	28	77	0.3636364
NODE_26515_length_588_cov_49.936605	314	394	2	71	80	0.8875000
NODE_26515_length_588_cov_49.936605	314	394	3	9	80	0.1125000
NODE_26516_length_588_cov_33.691207	273	353	4	16	80	0.2000000
NODE_26516_length_588_cov_33.691207	273	353	5	60	80	0.7500000
NODE_26516_length_588_cov_33.691207	273	353	6	4	80	0.0500000
NODE_26516_length_588_cov_33.691207	326	406	4	36	80	0.4500000
NODE_26516_length_588_cov_33.691207	326	406	5	35	80	0.4375000
NODE_26516_length_588_cov_33.691207	326	406	6	4	80	0.0500000
NODE_26516_length_588_cov_33.691207	326	406	7	5	80	0.0625000
NODE_26517_length_588_cov_16.564417	245	325	2	24	80	0.3000000
NODE_26517_length_588_cov_16.564417	245	325	3	56	80	0.7000000
NODE_26517_length_588_cov_16.564417	298	378	1	38	80	0.4750000
NODE_26517_length_588_cov_16.564417	298	378	2	22	80	0.2750000
NODE_26517_length_588_cov_16.564417	298	378	3	20	80	0.2500000
NODE_26518_length_588_cov_14.595092	266	346	0	5	80	0.0625000
NODE_26518_length_588_cov_14.595092	266	346	1	47	80	0.5875000
NODE_26518_length_588_cov_14.595092	266	346	2	12	80	0.1500000
NODE_26518_length_588_cov_14.595092	266	346	3	16	80	0.2000000
NODE_26518_length_588_cov_14.595092	319	399	2	11	80	0.1375000
NODE_26518_length_588_cov_14.595092	319	399	3	69	80	0.8625000
NODE_26522_length_588_cov_7.439673	155	235	0	8	80	0.1000000
NODE_26522_length_588_cov_7.439673	155	235	2	72	80	0.9000000
NODE_26522_length_588_cov_7.439673	208	288	0	51	80	0.6375000
NODE_26522_length_588_cov_7.439673	208	288	2	29	80	0.3625000
NODE_26523_length_588_cov_7.094070	191	263	0	72	72	1.0000000
NODE_26523_length_588_cov_7.094070	244	310	0	66	66	1.0000000
NODE_26523_length_588_cov_7.094070	439	519	0	80	80	1.0000000
NODE_26523_length_588_cov_7.094070	492	572	0	80	80	1.0000000
NODE_26534_length_588_cov_4.167689	65	122	0	57	57	1.0000000
NODE_26634_length_587_cov_39.782787	123	203	5	9	80	0.1125000
NODE_26634_length_587_cov_39.782787	123	203	6	2	80	0.0250000
NODE_26634_length_587_cov_39.782787	123	203	8	7	80	0.0875000
NODE_26634_length_587_cov_39.782787	123	203	9	41	80	0.5125000
NODE_26634_length_587_cov_39.782787	123	203	10	21	80	0.2625000
NODE_26634_length_587_cov_39.782787	176	256	8	3	80	0.0375000
NODE_26634_length_587_cov_39.782787	176	256	9	31	80	0.3875000
NODE_26634_length_587_cov_39.782787	176	256	10	11	80	0.1375000
NODE_26634_length_587_cov_39.782787	176	256	11	15	80	0.1875000
NODE_26634_length_587_cov_39.782787	176	256	12	17	80	0.2125000
NODE_26634_length_587_cov_39.782787	176	256	13	3	80	0.0375000
NODE_26634_length_587_cov_39.782787	252	332	6	3	80	0.0375000
NODE_26634_length_587_cov_39.782787	252	332	7	27	80	0.3375000
NODE_26634_length_587_cov_39.782787	252	332	8	17	80	0.2125000
NODE_26634_length_587_cov_39.782787	252	332	9	1	80	0.0125000
NODE_26634_length_587_cov_39.782787	252	332	10	18	80	0.2250000
NODE_26634_length_587_cov_39.782787	252	332	11	13	80	0.1625000
NODE_26634_length_587_cov_39.782787	252	332	12	1	80	0.0125000
NODE_26634_length_587_cov_39.782787	305	385	4	6	80	0.0750000
NODE_26634_length_587_cov_39.782787	305	385	5	10	80	0.1250000
NODE_26634_length_587_cov_39.782787	305	385	6	40	80	0.5000000
NODE_26634_length_587_cov_39.782787	305	385	7	24	80	0.3000000
NODE_26635_length_587_cov_31.807377	141	221	2	5	80	0.0625000
NODE_26635_length_587_cov_31.807377	141	221	4	75	80	0.9375000
NODE_26635_length_587_cov_31.807377	194	274	0	2	80	0.0250000
NODE_26635_length_587_cov_31.807377	194	274	2	20	80	0.2500000
NODE_26635_length_587_cov_31.807377	194	274	4	58	80	0.7250000
NODE_26636_length_587_cov_12.629098	219	299	2	19	80	0.2375000
NODE_26636_length_587_cov_12.629098	219	299	4	61	80	0.7625000
NODE_26636_length_587_cov_12.629098	272	352	2	38	80	0.4750000
NODE_26636_length_587_cov_12.629098	272	352	3	28	80	0.3500000
NODE_26636_length_587_cov_12.629098	272	352	4	14	80	0.1750000
NODE_26639_length_587_cov_9.067623	203	283	0	8	80	0.1000000
NODE_26639_length_587_cov_9.067623	203	283	1	13	80	0.1625000
NODE_26639_length_587_cov_9.067623	203	283	3	29	80	0.3625000
NODE_26639_length_587_cov_9.067623	203	283	5	28	80	0.3500000
NODE_26639_length_587_cov_9.067623	203	283	7	2	80	0.0250000
NODE_26639_length_587_cov_9.067623	256	336	5	25	80	0.3125000
NODE_26639_length_587_cov_9.067623	256	336	7	55	80	0.6875000
NODE_26640_length_587_cov_8.411885	253	311	0	58	58	1.0000000
NODE_26656_length_587_cov_3.231557	201	256	2	55	55	1.0000000
NODE_26665_length_587_cov_2.850410	255	288	0	33	33	1.0000000
NODE_26749_length_586_cov_37.843943	268	348	8	11	80	0.1375000
NODE_26749_length_586_cov_37.843943	268	348	9	27	80	0.3375000
NODE_26749_length_586_cov_37.843943	268	348	10	42	80	0.5250000
NODE_26749_length_586_cov_37.843943	321	401	4	28	80	0.3500000
NODE_26749_length_586_cov_37.843943	321	401	5	10	80	0.1250000
NODE_26749_length_586_cov_37.843943	321	401	6	14	80	0.1750000
NODE_26749_length_586_cov_37.843943	321	401	8	10	80	0.1250000
NODE_26749_length_586_cov_37.843943	321	401	9	18	80	0.2250000
NODE_26749_length_586_cov_37.843943	397	477	4	25	80	0.3125000
NODE_26749_length_586_cov_37.843943	397	477	5	23	80	0.2875000
NODE_26749_length_586_cov_37.843943	397	477	6	32	80	0.4000000
NODE_26749_length_586_cov_37.843943	450	531	4	6	81	0.0740741
NODE_26749_length_586_cov_37.843943	450	531	5	6	81	0.0740741
NODE_26749_length_586_cov_37.843943	450	531	6	69	81	0.8518519
NODE_26750_length_586_cov_12.831622	186	266	2	80	80	1.0000000
NODE_26750_length_586_cov_12.831622	239	319	0	16	80	0.2000000
NODE_26750_length_586_cov_12.831622	239	319	2	64	80	0.8000000
NODE_26752_length_586_cov_11.264887	108	188	3	9	80	0.1125000
NODE_26752_length_586_cov_11.264887	108	188	4	6	80	0.0750000
NODE_26752_length_586_cov_11.264887	108	188	5	38	80	0.4750000
NODE_26752_length_586_cov_11.264887	108	188	6	27	80	0.3375000
NODE_26752_length_586_cov_11.264887	161	241	2	4	80	0.0500000
NODE_26752_length_586_cov_11.264887	161	241	3	21	80	0.2625000
NODE_26752_length_586_cov_11.264887	161	241	5	55	80	0.6875000
NODE_26754_length_586_cov_9.624230	299	360	0	61	61	1.0000000
NODE_26754_length_586_cov_9.624230	299	360	0	61	61	1.0000000
NODE_26754_length_586_cov_9.624230	299	360	0	61	61	1.0000000
NODE_26754_length_586_cov_9.624230	301	360	0	59	59	1.0000000
NODE_26756_length_586_cov_8.591376	273	353	3	9	80	0.1125000
NODE_26756_length_586_cov_8.591376	273	353	5	71	80	0.8875000
NODE_26756_length_586_cov_8.591376	326	406	2	39	80	0.4875000
NODE_26756_length_586_cov_8.591376	326	406	3	23	80	0.2875000
NODE_26756_length_586_cov_8.591376	326	406	5	18	80	0.2250000
NODE_26758_length_586_cov_6.135524	334	375	0	16	41	0.3902439
NODE_26758_length_586_cov_6.135524	334	375	2	20	41	0.4878049
NODE_26758_length_586_cov_6.135524	334	375	3	5	41	0.1219512
NODE_26758_length_586_cov_6.135524	334	375	0	16	41	0.3902439
NODE_26758_length_586_cov_6.135524	334	375	2	20	41	0.4878049
NODE_26758_length_586_cov_6.135524	334	375	3	5	41	0.1219512
NODE_26760_length_586_cov_5.634497	150	230	0	43	80	0.5375000
NODE_26760_length_586_cov_5.634497	150	230	2	37	80	0.4625000
NODE_26760_length_586_cov_5.634497	203	283	2	80	80	1.0000000
NODE_26765_length_586_cov_4.626283	296	362	0	66	66	1.0000000
NODE_26765_length_586_cov_4.626283	453	533	0	80	80	1.0000000
NODE_26885_length_585_cov_112.094650	456	536	13	1	80	0.0125000
NODE_26885_length_585_cov_112.094650	456	536	14	2	80	0.0250000
NODE_26885_length_585_cov_112.094650	456	536	15	4	80	0.0500000
NODE_26885_length_585_cov_112.094650	456	536	17	15	80	0.1875000
NODE_26885_length_585_cov_112.094650	456	536	18	4	80	0.0500000
NODE_26885_length_585_cov_112.094650	456	536	19	4	80	0.0500000
NODE_26885_length_585_cov_112.094650	456	536	20	8	80	0.1000000
NODE_26885_length_585_cov_112.094650	456	536	21	11	80	0.1375000
NODE_26885_length_585_cov_112.094650	456	536	22	8	80	0.1000000
NODE_26885_length_585_cov_112.094650	456	536	24	1	80	0.0125000
NODE_26885_length_585_cov_112.094650	456	536	26	3	80	0.0375000
NODE_26885_length_585_cov_112.094650	456	536	27	2	80	0.0250000
NODE_26885_length_585_cov_112.094650	456	536	28	3	80	0.0375000
NODE_26885_length_585_cov_112.094650	456	536	29	1	80	0.0125000
NODE_26885_length_585_cov_112.094650	456	536	30	3	80	0.0375000
NODE_26885_length_585_cov_112.094650	456	536	32	4	80	0.0500000
NODE_26885_length_585_cov_112.094650	456	536	33	6	80	0.0750000
NODE_26885_length_585_cov_112.094650	509	585	4	9	76	0.1184211
NODE_26885_length_585_cov_112.094650	509	585	5	1	76	0.0131579
NODE_26885_length_585_cov_112.094650	509	585	6	1	76	0.0131579
NODE_26885_length_585_cov_112.094650	509	585	8	7	76	0.0921053
NODE_26885_length_585_cov_112.094650	509	585	9	6	76	0.0789474
NODE_26885_length_585_cov_112.094650	509	585	13	26	76	0.3421053
NODE_26885_length_585_cov_112.094650	509	585	14	2	76	0.0263158
NODE_26885_length_585_cov_112.094650	509	585	15	4	76	0.0526316
NODE_26885_length_585_cov_112.094650	509	585	17	15	76	0.1973684
NODE_26885_length_585_cov_112.094650	509	585	18	4	76	0.0526316
NODE_26885_length_585_cov_112.094650	509	585	19	1	76	0.0131579
NODE_26886_length_585_cov_23.872428	168	248	5	41	80	0.5125000
NODE_26886_length_585_cov_23.872428	168	248	6	11	80	0.1375000
NODE_26886_length_585_cov_23.872428	168	248	7	28	80	0.3500000
NODE_26886_length_585_cov_23.872428	222	301	6	18	79	0.2278481
NODE_26886_length_585_cov_23.872428	222	301	7	59	79	0.7468355
NODE_26886_length_585_cov_23.872428	222	301	8	2	79	0.0253165
NODE_26887_length_585_cov_18.981481	360	440	11	4	80	0.0500000
NODE_26887_length_585_cov_18.981481	360	440	13	21	80	0.2625000
NODE_26887_length_585_cov_18.981481	360	440	14	2	80	0.0250000
NODE_26887_length_585_cov_18.981481	360	440	15	12	80	0.1500000
NODE_26887_length_585_cov_18.981481	360	440	16	18	80	0.2250000
NODE_26887_length_585_cov_18.981481	360	440	17	5	80	0.0625000
NODE_26887_length_585_cov_18.981481	360	440	18	17	80	0.2125000
NODE_26887_length_585_cov_18.981481	360	440	19	1	80	0.0125000
NODE_26887_length_585_cov_18.981481	413	493	10	10	80	0.1250000
NODE_26887_length_585_cov_18.981481	413	493	11	4	80	0.0500000
NODE_26887_length_585_cov_18.981481	413	493	12	16	80	0.2000000
NODE_26887_length_585_cov_18.981481	413	493	14	2	80	0.0250000
NODE_26887_length_585_cov_18.981481	413	493	16	15	80	0.1875000
NODE_26887_length_585_cov_18.981481	413	493	17	7	80	0.0875000
NODE_26887_length_585_cov_18.981481	413	493	18	25	80	0.3125000
NODE_26887_length_585_cov_18.981481	413	493	19	1	80	0.0125000
NODE_26888_length_585_cov_13.967078	323	387	0	64	64	1.0000000
NODE_26889_length_585_cov_10.555556	229	309	0	26	80	0.3250000
NODE_26889_length_585_cov_10.555556	229	309	2	54	80	0.6750000
NODE_26889_length_585_cov_10.555556	282	362	0	18	80	0.2250000
NODE_26889_length_585_cov_10.555556	282	362	2	62	80	0.7750000
NODE_26891_length_585_cov_9.216049	233	313	0	44	80	0.5500000
NODE_26891_length_585_cov_9.216049	233	313	2	36	80	0.4500000
NODE_26891_length_585_cov_9.216049	286	366	0	54	80	0.6750000
NODE_26891_length_585_cov_9.216049	286	366	1	26	80	0.3250000
NODE_26894_length_585_cov_8.090535	292	372	0	25	80	0.3125000
NODE_26894_length_585_cov_8.090535	292	372	1	55	80	0.6875000
NODE_26894_length_585_cov_8.090535	345	425	0	78	80	0.9750000
NODE_26894_length_585_cov_8.090535	345	425	1	2	80	0.0250000
NODE_26895_length_585_cov_8.018519	339	381	0	42	42	1.0000000
NODE_26895_length_585_cov_8.018519	354	419	0	65	65	1.0000000
NODE_26900_length_585_cov_4.954733	147	227	4	80	80	1.0000000
NODE_26912_length_585_cov_3.751029	288	368	3	9	80	0.1125000
NODE_26912_length_585_cov_3.751029	288	368	4	27	80	0.3375000
NODE_26912_length_585_cov_3.751029	288	368	5	44	80	0.5500000
NODE_26912_length_585_cov_3.751029	341	421	3	4	80	0.0500000
NODE_26912_length_585_cov_3.751029	341	421	4	13	80	0.1625000
NODE_26912_length_585_cov_3.751029	341	421	5	60	80	0.7500000
NODE_26912_length_585_cov_3.751029	341	421	7	3	80	0.0375000
NODE_27019_length_584_cov_21.657732	57	137	5	3	80	0.0375000
NODE_27019_length_584_cov_21.657732	57	137	7	1	80	0.0125000
NODE_27019_length_584_cov_21.657732	57	137	8	11	80	0.1375000
NODE_27019_length_584_cov_21.657732	57	137	9	5	80	0.0625000
NODE_27019_length_584_cov_21.657732	57	137	11	4	80	0.0500000
NODE_27019_length_584_cov_21.657732	57	137	13	12	80	0.1500000
NODE_27019_length_584_cov_21.657732	57	137	15	44	80	0.5500000
NODE_27019_length_584_cov_21.657732	110	190	8	4	80	0.0500000
NODE_27019_length_584_cov_21.657732	110	190	10	5	80	0.0625000
NODE_27019_length_584_cov_21.657732	110	190	12	8	80	0.1000000
NODE_27019_length_584_cov_21.657732	110	190	13	24	80	0.3000000
NODE_27019_length_584_cov_21.657732	110	190	14	3	80	0.0375000
NODE_27019_length_584_cov_21.657732	110	190	15	36	80	0.4500000
NODE_27020_length_584_cov_11.915464	280	360	10	9	80	0.1125000
NODE_27020_length_584_cov_11.915464	280	360	11	5	80	0.0625000
NODE_27020_length_584_cov_11.915464	280	360	12	11	80	0.1375000
NODE_27020_length_584_cov_11.915464	280	360	13	29	80	0.3625000
NODE_27020_length_584_cov_11.915464	280	360	15	26	80	0.3250000
NODE_27020_length_584_cov_11.915464	333	413	8	1	80	0.0125000
NODE_27020_length_584_cov_11.915464	333	413	9	17	80	0.2125000
NODE_27020_length_584_cov_11.915464	333	413	11	12	80	0.1500000
NODE_27020_length_584_cov_11.915464	333	413	13	18	80	0.2250000
NODE_27020_length_584_cov_11.915464	333	413	14	1	80	0.0125000
NODE_27020_length_584_cov_11.915464	333	413	15	31	80	0.3875000
NODE_27021_length_584_cov_11.197938	217	297	3	6	80	0.0750000
NODE_27021_length_584_cov_11.197938	217	297	5	19	80	0.2375000
NODE_27021_length_584_cov_11.197938	217	297	6	1	80	0.0125000
NODE_27021_length_584_cov_11.197938	217	297	7	29	80	0.3625000
NODE_27021_length_584_cov_11.197938	217	297	8	25	80	0.3125000
NODE_27021_length_584_cov_11.197938	270	350	4	1	80	0.0125000
NODE_27021_length_584_cov_11.197938	270	350	6	20	80	0.2500000
NODE_27021_length_584_cov_11.197938	270	350	7	43	80	0.5375000
NODE_27021_length_584_cov_11.197938	270	350	8	16	80	0.2000000
NODE_27022_length_584_cov_9.824742	375	441	0	66	66	1.0000000
NODE_27022_length_584_cov_9.824742	375	441	0	66	66	1.0000000
NODE_27023_length_584_cov_9.160825	369	449	2	23	80	0.2875000
NODE_27023_length_584_cov_9.160825	369	449	3	54	80	0.6750000
NODE_27023_length_584_cov_9.160825	369	449	4	3	80	0.0375000
NODE_27023_length_584_cov_9.160825	422	502	2	13	80	0.1625000
NODE_27023_length_584_cov_9.160825	422	502	3	16	80	0.2000000
NODE_27023_length_584_cov_9.160825	422	502	4	51	80	0.6375000
NODE_27023_length_584_cov_9.160825	422	502	2	13	80	0.1625000
NODE_27023_length_584_cov_9.160825	422	502	3	16	80	0.2000000
NODE_27023_length_584_cov_9.160825	422	502	4	51	80	0.6375000
NODE_27026_length_584_cov_7.736082	51	131	0	15	80	0.1875000
NODE_27026_length_584_cov_7.736082	51	131	1	48	80	0.6000000
NODE_27026_length_584_cov_7.736082	51	131	2	17	80	0.2125000
NODE_27026_length_584_cov_7.736082	104	184	1	10	80	0.1250000
NODE_27026_length_584_cov_7.736082	104	184	2	70	80	0.8750000
NODE_27031_length_584_cov_7.113402	213	293	2	18	80	0.2250000
NODE_27031_length_584_cov_7.113402	213	293	3	16	80	0.2000000
NODE_27031_length_584_cov_7.113402	213	293	4	46	80	0.5750000
NODE_27031_length_584_cov_7.113402	266	346	0	53	80	0.6625000
NODE_27031_length_584_cov_7.113402	266	346	2	18	80	0.2250000
NODE_27031_length_584_cov_7.113402	266	346	3	9	80	0.1125000
NODE_27035_length_584_cov_5.843299	281	341	0	60	60	1.0000000
NODE_27039_length_584_cov_5.032990	240	320	2	4	80	0.0500000
NODE_27039_length_584_cov_5.032990	240	320	3	32	80	0.4000000
NODE_27039_length_584_cov_5.032990	240	320	4	44	80	0.5500000
NODE_27039_length_584_cov_5.032990	293	373	2	12	80	0.1500000
NODE_27039_length_584_cov_5.032990	293	373	4	68	80	0.8500000
NODE_27061_length_584_cov_2.707216	186	257	1	22	71	0.3098592
NODE_27061_length_584_cov_2.707216	186	257	2	49	71	0.6901408
NODE_27147_length_583_cov_7.973140	232	312	0	80	80	1.0000000
NODE_27147_length_583_cov_7.973140	285	365	0	80	80	1.0000000
NODE_27148_length_583_cov_6.731405	328	408	2	80	80	1.0000000
NODE_27148_length_583_cov_6.731405	381	461	2	53	80	0.6625000
NODE_27148_length_583_cov_6.731405	381	461	3	27	80	0.3375000
NODE_27149_length_583_cov_6.363636	161	231	0	37	70	0.5285714
NODE_27149_length_583_cov_6.363636	161	231	1	33	70	0.4714286
NODE_27152_length_583_cov_5.766529	132	186	0	54	54	1.0000000
NODE_27263_length_583_cov_0.762397	9	50	0	41	41	1.0000000
NODE_27278_length_582_cov_74.269151	295	375	8	10	80	0.1250000
NODE_27278_length_582_cov_74.269151	295	375	10	4	80	0.0500000
NODE_27278_length_582_cov_74.269151	295	375	12	1	80	0.0125000
NODE_27278_length_582_cov_74.269151	295	375	13	3	80	0.0375000
NODE_27278_length_582_cov_74.269151	295	375	14	31	80	0.3875000
NODE_27278_length_582_cov_74.269151	295	375	15	13	80	0.1625000
NODE_27278_length_582_cov_74.269151	295	375	16	10	80	0.1250000
NODE_27278_length_582_cov_74.269151	295	375	17	8	80	0.1000000
NODE_27278_length_582_cov_74.269151	348	428	9	12	80	0.1500000
NODE_27278_length_582_cov_74.269151	348	428	11	8	80	0.1000000
NODE_27278_length_582_cov_74.269151	348	428	13	2	80	0.0250000
NODE_27278_length_582_cov_74.269151	348	428	15	28	80	0.3500000
NODE_27278_length_582_cov_74.269151	348	428	16	16	80	0.2000000
NODE_27278_length_582_cov_74.269151	348	428	17	14	80	0.1750000
NODE_27279_length_582_cov_53.093168	11	91	0	19	80	0.2375000
NODE_27279_length_582_cov_53.093168	11	91	2	57	80	0.7125000
NODE_27279_length_582_cov_53.093168	11	91	3	4	80	0.0500000
NODE_27279_length_582_cov_53.093168	64	144	2	23	80	0.2875000
NODE_27279_length_582_cov_53.093168	64	144	3	57	80	0.7125000
NODE_27279_length_582_cov_53.093168	140	220	1	70	80	0.8750000
NODE_27279_length_582_cov_53.093168	140	220	3	10	80	0.1250000
NODE_27279_length_582_cov_53.093168	193	273	0	36	80	0.4500000
NODE_27279_length_582_cov_53.093168	193	273	1	44	80	0.5500000
NODE_27280_length_582_cov_47.393375	345	425	6	4	80	0.0500000
NODE_27280_length_582_cov_47.393375	345	425	7	44	80	0.5500000
NODE_27280_length_582_cov_47.393375	345	425	8	32	80	0.4000000
NODE_27280_length_582_cov_47.393375	398	478	3	44	80	0.5500000
NODE_27280_length_582_cov_47.393375	398	478	4	3	80	0.0375000
NODE_27280_length_582_cov_47.393375	398	478	5	6	80	0.0750000
NODE_27280_length_582_cov_47.393375	398	478	7	27	80	0.3375000
NODE_27281_length_582_cov_16.358178	297	377	2	18	80	0.2250000
NODE_27281_length_582_cov_16.358178	297	377	4	25	80	0.3125000
NODE_27281_length_582_cov_16.358178	297	377	6	2	80	0.0250000
NODE_27281_length_582_cov_16.358178	297	377	7	2	80	0.0250000
NODE_27281_length_582_cov_16.358178	297	377	8	6	80	0.0750000
NODE_27281_length_582_cov_16.358178	297	377	9	27	80	0.3375000
NODE_27281_length_582_cov_16.358178	350	431	2	72	81	0.8888889
NODE_27281_length_582_cov_16.358178	350	431	4	9	81	0.1111111
NODE_27282_length_582_cov_14.107660	128	208	2	43	80	0.5375000
NODE_27282_length_582_cov_14.107660	128	208	3	37	80	0.4625000
NODE_27282_length_582_cov_14.107660	181	261	2	27	80	0.3375000
NODE_27282_length_582_cov_14.107660	181	261	3	53	80	0.6625000
NODE_27283_length_582_cov_7.923395	208	287	2	63	79	0.7974684
NODE_27283_length_582_cov_7.923395	208	287	3	16	79	0.2025317
NODE_27283_length_582_cov_7.923395	262	340	0	33	78	0.4230769
NODE_27283_length_582_cov_7.923395	262	340	1	9	78	0.1153846
NODE_27283_length_582_cov_7.923395	262	340	2	36	78	0.4615385
NODE_27284_length_582_cov_7.722567	216	296	0	80	80	1.0000000
NODE_27284_length_582_cov_7.722567	269	349	0	80	80	1.0000000
NODE_27289_length_582_cov_4.956522	294	325	0	19	31	0.6129032
NODE_27289_length_582_cov_4.956522	294	325	2	12	31	0.3870968
NODE_27295_length_582_cov_4.308489	151	192	2	4	41	0.0975610
NODE_27295_length_582_cov_4.308489	151	192	4	36	41	0.8780488
NODE_27295_length_582_cov_4.308489	151	192	5	1	41	0.0243902
NODE_27297_length_582_cov_3.838509	223	299	1	76	76	1.0000000
NODE_27297_length_582_cov_3.838509	272	354	1	82	82	1.0000000
NODE_27350_length_582_cov_1.650104	375	450	1	64	75	0.8533334
NODE_27350_length_582_cov_1.650104	375	450	2	11	75	0.1466667
NODE_27405_length_581_cov_16.890041	244	316	0	72	72	1.0000000
NODE_27413_length_581_cov_6.340249	262	342	2	80	80	1.0000000
NODE_27413_length_581_cov_6.340249	315	395	0	45	80	0.5625000
NODE_27413_length_581_cov_6.340249	315	395	2	35	80	0.4375000
NODE_27416_length_581_cov_5.827801	122	192	0	23	70	0.3285714
NODE_27416_length_581_cov_5.827801	122	192	2	47	70	0.6714286
NODE_27420_length_581_cov_5.072614	392	466	0	74	74	1.0000000
NODE_27420_length_581_cov_5.072614	424	444	0	20	20	1.0000000
NODE_27464_length_581_cov_1.881743	474	538	0	16	64	0.2500000
NODE_27464_length_581_cov_1.881743	474	538	2	48	64	0.7500000
NODE_27541_length_580_cov_39.353430	358	438	0	80	80	1.0000000
NODE_27541_length_580_cov_39.353430	411	491	0	80	80	1.0000000
NODE_27541_length_580_cov_39.353430	487	567	0	80	80	1.0000000
NODE_27541_length_580_cov_39.353430	487	567	0	80	80	1.0000000
NODE_27541_length_580_cov_39.353430	487	567	0	80	80	1.0000000
NODE_27541_length_580_cov_39.353430	487	567	0	80	80	1.0000000
NODE_27541_length_580_cov_39.353430	487	567	0	80	80	1.0000000
NODE_27541_length_580_cov_39.353430	487	567	0	80	80	1.0000000
NODE_27544_length_580_cov_8.925156	198	238	0	40	40	1.0000000
NODE_27544_length_580_cov_8.925156	258	338	0	34	80	0.4250000
NODE_27544_length_580_cov_8.925156	258	338	1	46	80	0.5750000
NODE_27545_length_580_cov_8.634096	197	277	1	50	80	0.6250000
NODE_27545_length_580_cov_8.634096	197	277	2	30	80	0.3750000
NODE_27545_length_580_cov_8.634096	250	330	2	66	80	0.8250000
NODE_27545_length_580_cov_8.634096	250	330	3	14	80	0.1750000
NODE_27551_length_580_cov_6.291060	356	398	0	42	42	1.0000000
NODE_27554_length_580_cov_5.494802	110	190	0	33	80	0.4125000
NODE_27554_length_580_cov_5.494802	110	190	2	32	80	0.4000000
NODE_27554_length_580_cov_5.494802	110	190	4	15	80	0.1875000
NODE_27554_length_580_cov_5.494802	163	243	2	12	80	0.1500000
NODE_27554_length_580_cov_5.494802	163	243	4	68	80	0.8500000
NODE_27559_length_580_cov_4.563410	231	292	2	61	61	1.0000000
NODE_27559_length_580_cov_4.563410	322	357	0	35	35	1.0000000
NODE_27590_length_580_cov_2.264033	215	277	0	62	62	1.0000000
NODE_27597_length_580_cov_2.116424	265	345	2	80	80	1.0000000
NODE_27659_length_579_cov_24.231250	159	239	8	6	80	0.0750000
NODE_27659_length_579_cov_24.231250	159	239	9	17	80	0.2125000
NODE_27659_length_579_cov_24.231250	159	239	11	13	80	0.1625000
NODE_27659_length_579_cov_24.231250	159	239	12	23	80	0.2875000
NODE_27659_length_579_cov_24.231250	159	239	13	21	80	0.2625000
NODE_27659_length_579_cov_24.231250	212	287	4	11	75	0.1466667
NODE_27659_length_579_cov_24.231250	212	287	5	1	75	0.0133333
NODE_27659_length_579_cov_24.231250	212	287	7	2	75	0.0266667
NODE_27659_length_579_cov_24.231250	212	287	8	4	75	0.0533333
NODE_27659_length_579_cov_24.231250	212	287	10	15	75	0.2000000
NODE_27659_length_579_cov_24.231250	212	287	11	3	75	0.0400000
NODE_27659_length_579_cov_24.231250	212	287	12	35	75	0.4666667
NODE_27659_length_579_cov_24.231250	212	287	13	4	75	0.0533333
NODE_27660_length_579_cov_12.602083	246	326	0	80	80	1.0000000
NODE_27660_length_579_cov_12.602083	299	377	0	78	78	1.0000000
NODE_27663_length_579_cov_9.195833	254	334	2	65	80	0.8125000
NODE_27663_length_579_cov_9.195833	254	334	4	15	80	0.1875000
NODE_27663_length_579_cov_9.195833	307	387	2	28	80	0.3500000
NODE_27663_length_579_cov_9.195833	307	387	3	8	80	0.1000000
NODE_27663_length_579_cov_9.195833	307	387	4	44	80	0.5500000
NODE_27663_length_579_cov_9.195833	383	463	0	45	80	0.5625000
NODE_27663_length_579_cov_9.195833	383	463	2	35	80	0.4375000
NODE_27664_length_579_cov_6.600000	169	249	0	80	80	1.0000000
NODE_27664_length_579_cov_6.600000	222	302	0	80	80	1.0000000
NODE_27667_length_579_cov_5.956250	225	295	0	70	70	1.0000000
NODE_27667_length_579_cov_5.956250	279	316	0	37	37	1.0000000
NODE_27674_length_579_cov_4.850000	105	185	1	16	80	0.2000000
NODE_27674_length_579_cov_4.850000	105	185	2	36	80	0.4500000
NODE_27674_length_579_cov_4.850000	105	185	3	14	80	0.1750000
NODE_27674_length_579_cov_4.850000	105	185	4	14	80	0.1750000
NODE_27674_length_579_cov_4.850000	158	238	3	14	80	0.1750000
NODE_27674_length_579_cov_4.850000	158	238	4	66	80	0.8250000
NODE_27688_length_579_cov_3.291667	290	343	0	53	53	1.0000000
NODE_27695_length_579_cov_2.420833	251	331	0	10	80	0.1250000
NODE_27695_length_579_cov_2.420833	251	331	1	40	80	0.5000000
NODE_27695_length_579_cov_2.420833	251	331	3	30	80	0.3750000
NODE_27695_length_579_cov_2.420833	304	384	0	63	80	0.7875000
NODE_27695_length_579_cov_2.420833	304	384	1	17	80	0.2125000
NODE_27724_length_579_cov_1.435417	463	497	0	34	34	1.0000000
NODE_27781_length_578_cov_70.192067	100	180	4	27	80	0.3375000
NODE_27781_length_578_cov_70.192067	100	180	6	41	80	0.5125000
NODE_27781_length_578_cov_70.192067	100	180	7	10	80	0.1250000
NODE_27781_length_578_cov_70.192067	100	180	8	2	80	0.0250000
NODE_27781_length_578_cov_70.192067	153	233	3	7	80	0.0875000
NODE_27781_length_578_cov_70.192067	153	233	5	4	80	0.0500000
NODE_27781_length_578_cov_70.192067	153	233	6	23	80	0.2875000
NODE_27781_length_578_cov_70.192067	153	233	7	44	80	0.5500000
NODE_27781_length_578_cov_70.192067	153	233	8	2	80	0.0250000
NODE_27782_length_578_cov_51.676409	129	209	6	7	80	0.0875000
NODE_27782_length_578_cov_51.676409	129	209	8	5	80	0.0625000
NODE_27782_length_578_cov_51.676409	129	209	9	6	80	0.0750000
NODE_27782_length_578_cov_51.676409	129	209	11	29	80	0.3625000
NODE_27782_length_578_cov_51.676409	129	209	12	9	80	0.1125000
NODE_27782_length_578_cov_51.676409	129	209	13	1	80	0.0125000
NODE_27782_length_578_cov_51.676409	129	209	14	23	80	0.2875000
NODE_27782_length_578_cov_51.676409	182	262	11	3	80	0.0375000
NODE_27782_length_578_cov_51.676409	182	262	13	34	80	0.4250000
NODE_27782_length_578_cov_51.676409	182	262	14	43	80	0.5375000
NODE_27783_length_578_cov_32.152401	310	390	6	12	80	0.1500000
NODE_27783_length_578_cov_32.152401	310	390	7	14	80	0.1750000
NODE_27783_length_578_cov_32.152401	310	390	8	16	80	0.2000000
NODE_27783_length_578_cov_32.152401	310	390	9	34	80	0.4250000
NODE_27783_length_578_cov_32.152401	310	390	11	3	80	0.0375000
NODE_27783_length_578_cov_32.152401	310	390	12	1	80	0.0125000
NODE_27783_length_578_cov_32.152401	363	443	6	1	80	0.0125000
NODE_27783_length_578_cov_32.152401	363	443	7	1	80	0.0125000
NODE_27783_length_578_cov_32.152401	363	443	9	32	80	0.4000000
NODE_27783_length_578_cov_32.152401	363	443	11	17	80	0.2125000
NODE_27783_length_578_cov_32.152401	363	443	12	29	80	0.3625000
NODE_27784_length_578_cov_30.484342	215	295	2	80	80	1.0000000
NODE_27784_length_578_cov_30.484342	268	348	1	4	80	0.0500000
NODE_27784_length_578_cov_30.484342	268	348	2	76	80	0.9500000
NODE_27785_length_578_cov_15.983299	213	265	1	52	52	1.0000000
NODE_27786_length_578_cov_14.968685	147	227	1	41	80	0.5125000
NODE_27786_length_578_cov_14.968685	147	227	2	10	80	0.1250000
NODE_27786_length_578_cov_14.968685	147	227	3	11	80	0.1375000
NODE_27786_length_578_cov_14.968685	147	227	4	18	80	0.2250000
NODE_27786_length_578_cov_14.968685	200	280	3	41	80	0.5125000
NODE_27786_length_578_cov_14.968685	200	280	4	39	80	0.4875000
NODE_27787_length_578_cov_9.567850	273	328	3	6	55	0.1090909
NODE_27787_length_578_cov_9.567850	273	328	4	49	55	0.8909091
NODE_27792_length_578_cov_6.670146	273	353	1	80	80	1.0000000
NODE_27792_length_578_cov_6.670146	326	406	1	80	80	1.0000000
NODE_27793_length_578_cov_6.465553	320	400	2	80	80	1.0000000
NODE_27793_length_578_cov_6.465553	373	453	0	29	80	0.3625000
NODE_27793_length_578_cov_6.465553	373	453	1	15	80	0.1875000
NODE_27793_length_578_cov_6.465553	373	453	2	36	80	0.4500000
NODE_27863_length_578_cov_1.480167	185	265	0	24	80	0.3000000
NODE_27863_length_578_cov_1.480167	185	265	2	56	80	0.7000000
NODE_27863_length_578_cov_1.480167	238	318	2	80	80	1.0000000
NODE_27935_length_577_cov_11.638075	312	392	0	80	80	1.0000000
NODE_27942_length_577_cov_4.912134	218	249	0	31	31	1.0000000
NODE_27942_length_577_cov_4.912134	301	330	0	29	29	1.0000000
NODE_27961_length_577_cov_2.970711	78	126	1	4	48	0.0833333
NODE_27961_length_577_cov_2.970711	78	126	3	44	48	0.9166667
NODE_27968_length_577_cov_2.631799	169	253	1	34	84	0.4047619
NODE_27968_length_577_cov_2.631799	169	253	2	1	84	0.0119048
NODE_27968_length_577_cov_2.631799	169	253	3	45	84	0.5357143
NODE_27968_length_577_cov_2.631799	169	253	5	4	84	0.0476190
NODE_27968_length_577_cov_2.631799	226	269	1	12	43	0.2790698
NODE_27968_length_577_cov_2.631799	226	269	2	1	43	0.0232558
NODE_27968_length_577_cov_2.631799	226	269	3	30	43	0.6976744
NODE_28003_length_577_cov_1.468619	71	146	0	75	75	1.0000000
NODE_28003_length_577_cov_1.468619	119	199	0	55	80	0.6875000
NODE_28003_length_577_cov_1.468619	119	199	1	23	80	0.2875000
NODE_28003_length_577_cov_1.468619	119	199	2	2	80	0.0250000
NODE_28058_length_576_cov_10.903564	194	274	1	7	80	0.0875000
NODE_28058_length_576_cov_10.903564	194	274	2	73	80	0.9125000
NODE_28059_length_576_cov_9.039832	271	351	2	80	80	1.0000000
NODE_28059_length_576_cov_9.039832	324	404	0	13	80	0.1625000
NODE_28059_length_576_cov_9.039832	324	404	2	67	80	0.8375000
NODE_28060_length_576_cov_8.490566	338	418	0	10	80	0.1250000
NODE_28060_length_576_cov_8.490566	338	418	1	27	80	0.3375000
NODE_28060_length_576_cov_8.490566	338	418	2	43	80	0.5375000
NODE_28060_length_576_cov_8.490566	391	471	0	63	80	0.7875000
NODE_28060_length_576_cov_8.490566	391	471	1	17	80	0.2125000
NODE_28061_length_576_cov_7.002096	157	237	0	17	80	0.2125000
NODE_28061_length_576_cov_7.002096	157	237	2	63	80	0.7875000
NODE_28061_length_576_cov_7.002096	210	290	2	80	80	1.0000000
NODE_28076_length_576_cov_3.322851	118	183	0	36	65	0.5538462
NODE_28076_length_576_cov_3.322851	118	183	1	29	65	0.4461538
NODE_28102_length_576_cov_1.964361	148	228	1	18	80	0.2250000
NODE_28102_length_576_cov_1.964361	148	228	2	62	80	0.7750000
NODE_28102_length_576_cov_1.964361	201	281	1	6	80	0.0750000
NODE_28102_length_576_cov_1.964361	201	281	2	74	80	0.9250000
NODE_28104_length_576_cov_1.951782	159	239	1	54	80	0.6750000
NODE_28104_length_576_cov_1.951782	159	239	2	26	80	0.3250000
NODE_28104_length_576_cov_1.951782	212	292	0	27	80	0.3375000
NODE_28104_length_576_cov_1.951782	212	292	1	53	80	0.6625000
NODE_28116_length_576_cov_1.584906	381	455	0	60	74	0.8108108
NODE_28116_length_576_cov_1.584906	381	455	1	14	74	0.1891892
NODE_28179_length_575_cov_15.319328	319	399	0	47	80	0.5875000
NODE_28179_length_575_cov_15.319328	319	399	1	33	80	0.4125000
NODE_28179_length_575_cov_15.319328	372	452	1	52	80	0.6500000
NODE_28179_length_575_cov_15.319328	372	452	2	28	80	0.3500000
NODE_28181_length_575_cov_8.254202	286	366	2	6	80	0.0750000
NODE_28181_length_575_cov_8.254202	286	366	3	25	80	0.3125000
NODE_28181_length_575_cov_8.254202	286	366	4	49	80	0.6125000
NODE_28181_length_575_cov_8.254202	339	419	2	10	80	0.1250000
NODE_28181_length_575_cov_8.254202	339	419	3	10	80	0.1250000
NODE_28181_length_575_cov_8.254202	339	419	4	60	80	0.7500000
NODE_28182_length_575_cov_7.558824	300	380	0	80	80	1.0000000
NODE_28313_length_574_cov_6.282105	185	265	2	19	80	0.2375000
NODE_28313_length_574_cov_6.282105	185	265	4	61	80	0.7625000
NODE_28313_length_574_cov_6.282105	238	318	0	16	80	0.2000000
NODE_28313_length_574_cov_6.282105	238	318	2	32	80	0.4000000
NODE_28313_length_574_cov_6.282105	238	318	4	32	80	0.4000000
NODE_28330_length_574_cov_2.993684	215	234	0	19	19	1.0000000
NODE_28438_length_573_cov_53.668776	393	473	4	1	80	0.0125000
NODE_28438_length_573_cov_53.668776	393	473	6	1	80	0.0125000
NODE_28438_length_573_cov_53.668776	393	473	7	36	80	0.4500000
NODE_28438_length_573_cov_53.668776	393	473	8	42	80	0.5250000
NODE_28438_length_573_cov_53.668776	446	526	2	4	80	0.0500000
NODE_28438_length_573_cov_53.668776	446	526	4	11	80	0.1375000
NODE_28438_length_573_cov_53.668776	446	526	5	20	80	0.2500000
NODE_28438_length_573_cov_53.668776	446	526	7	34	80	0.4250000
NODE_28438_length_573_cov_53.668776	446	526	8	11	80	0.1375000
NODE_28439_length_573_cov_30.658228	451	531	0	80	80	1.0000000
NODE_28440_length_573_cov_30.116034	435	515	15	3	80	0.0375000
NODE_28440_length_573_cov_30.116034	435	515	16	2	80	0.0250000
NODE_28440_length_573_cov_30.116034	435	515	18	21	80	0.2625000
NODE_28440_length_573_cov_30.116034	435	515	19	2	80	0.0250000
NODE_28440_length_573_cov_30.116034	435	515	20	1	80	0.0125000
NODE_28440_length_573_cov_30.116034	435	515	21	18	80	0.2250000
NODE_28440_length_573_cov_30.116034	435	515	22	5	80	0.0625000
NODE_28440_length_573_cov_30.116034	435	515	24	2	80	0.0250000
NODE_28440_length_573_cov_30.116034	435	515	25	9	80	0.1125000
NODE_28440_length_573_cov_30.116034	435	515	26	1	80	0.0125000
NODE_28440_length_573_cov_30.116034	435	515	27	4	80	0.0500000
NODE_28440_length_573_cov_30.116034	435	515	28	1	80	0.0125000
NODE_28440_length_573_cov_30.116034	435	515	30	3	80	0.0375000
NODE_28440_length_573_cov_30.116034	435	515	31	2	80	0.0250000
NODE_28440_length_573_cov_30.116034	435	515	32	2	80	0.0250000
NODE_28440_length_573_cov_30.116034	435	515	33	4	80	0.0500000
NODE_28440_length_573_cov_30.116034	488	568	4	5	80	0.0625000
NODE_28440_length_573_cov_30.116034	488	568	6	9	80	0.1125000
NODE_28440_length_573_cov_30.116034	488	568	7	7	80	0.0875000
NODE_28440_length_573_cov_30.116034	488	568	9	3	80	0.0375000
NODE_28440_length_573_cov_30.116034	488	568	10	1	80	0.0125000
NODE_28440_length_573_cov_30.116034	488	568	12	21	80	0.2625000
NODE_28440_length_573_cov_30.116034	488	568	14	3	80	0.0375000
NODE_28440_length_573_cov_30.116034	488	568	15	7	80	0.0875000
NODE_28440_length_573_cov_30.116034	488	568	16	2	80	0.0250000
NODE_28440_length_573_cov_30.116034	488	568	18	21	80	0.2625000
NODE_28440_length_573_cov_30.116034	488	568	19	1	80	0.0125000
NODE_28441_length_573_cov_24.234177	210	290	4	4	80	0.0500000
NODE_28441_length_573_cov_24.234177	210	290	5	1	80	0.0125000
NODE_28441_length_573_cov_24.234177	210	290	6	2	80	0.0250000
NODE_28441_length_573_cov_24.234177	210	290	7	12	80	0.1500000
NODE_28441_length_573_cov_24.234177	210	290	8	5	80	0.0625000
NODE_28441_length_573_cov_24.234177	210	290	9	41	80	0.5125000
NODE_28441_length_573_cov_24.234177	210	290	11	15	80	0.1875000
NODE_28441_length_573_cov_24.234177	263	343	8	18	80	0.2250000
NODE_28441_length_573_cov_24.234177	263	343	9	25	80	0.3125000
NODE_28441_length_573_cov_24.234177	263	343	10	2	80	0.0250000
NODE_28441_length_573_cov_24.234177	263	343	11	35	80	0.4375000
NODE_28442_length_573_cov_13.464135	278	358	0	71	80	0.8875000
NODE_28442_length_573_cov_13.464135	278	358	2	9	80	0.1125000
NODE_28442_length_573_cov_13.464135	331	411	0	18	80	0.2250000
NODE_28442_length_573_cov_13.464135	331	411	2	62	80	0.7750000
NODE_28443_length_573_cov_8.761603	124	204	0	31	80	0.3875000
NODE_28443_length_573_cov_8.761603	124	204	1	25	80	0.3125000
NODE_28443_length_573_cov_8.761603	124	204	2	24	80	0.3000000
NODE_28443_length_573_cov_8.761603	177	257	1	20	80	0.2500000
NODE_28443_length_573_cov_8.761603	177	257	2	60	80	0.7500000
NODE_28456_length_573_cov_3.364979	365	398	7	16	33	0.4848485
NODE_28456_length_573_cov_3.364979	365	398	8	3	33	0.0909091
NODE_28456_length_573_cov_3.364979	365	398	11	14	33	0.4242424
NODE_28565_length_572_cov_17.530655	312	392	4	8	80	0.1000000
NODE_28565_length_572_cov_17.530655	312	392	5	22	80	0.2750000
NODE_28565_length_572_cov_17.530655	312	392	7	22	80	0.2750000
NODE_28565_length_572_cov_17.530655	312	392	8	8	80	0.1000000
NODE_28565_length_572_cov_17.530655	312	392	9	20	80	0.2500000
NODE_28565_length_572_cov_17.530655	365	445	2	8	80	0.1000000
NODE_28565_length_572_cov_17.530655	365	445	3	18	80	0.2250000
NODE_28565_length_572_cov_17.530655	365	445	4	35	80	0.4375000
NODE_28565_length_572_cov_17.530655	365	445	5	19	80	0.2375000
NODE_28567_length_572_cov_8.059197	250	321	3	3	71	0.0422535
NODE_28567_length_572_cov_8.059197	250	321	4	14	71	0.1971831
NODE_28567_length_572_cov_8.059197	250	321	5	10	71	0.1408451
NODE_28567_length_572_cov_8.059197	250	321	6	44	71	0.6197183
NODE_28568_length_572_cov_7.873150	134	214	1	8	80	0.1000000
NODE_28568_length_572_cov_7.873150	134	214	2	72	80	0.9000000
NODE_28568_length_572_cov_7.873150	187	267	1	22	80	0.2750000
NODE_28568_length_572_cov_7.873150	187	267	2	58	80	0.7250000
NODE_28570_length_572_cov_6.706131	365	445	0	80	80	1.0000000
NODE_28570_length_572_cov_6.706131	418	498	0	80	80	1.0000000
NODE_28573_length_572_cov_5.625793	137	217	0	80	80	1.0000000
NODE_28573_length_572_cov_5.625793	190	270	0	80	80	1.0000000
NODE_28574_length_572_cov_5.617336	331	401	1	7	70	0.1000000
NODE_28574_length_572_cov_5.617336	331	401	2	63	70	0.9000000
NODE_28578_length_572_cov_4.596195	212	288	0	76	76	1.0000000
NODE_28578_length_572_cov_4.596195	261	341	0	80	80	1.0000000
NODE_28585_length_572_cov_3.843552	210	290	4	20	80	0.2500000
NODE_28585_length_572_cov_3.843552	210	290	5	60	80	0.7500000
NODE_28585_length_572_cov_3.843552	263	343	3	7	80	0.0875000
NODE_28585_length_572_cov_3.843552	263	343	4	10	80	0.1250000
NODE_28585_length_572_cov_3.843552	263	343	5	36	80	0.4500000
NODE_28585_length_572_cov_3.843552	263	343	6	27	80	0.3375000
NODE_28621_length_572_cov_2.319239	357	431	0	74	74	1.0000000
NODE_28621_length_572_cov_2.319239	410	478	0	68	68	1.0000000
NODE_28625_length_572_cov_2.107822	184	254	2	70	70	1.0000000
NODE_28625_length_572_cov_2.107822	415	493	0	78	78	1.0000000
NODE_28631_length_572_cov_1.947146	327	363	0	36	36	1.0000000
NODE_28631_length_572_cov_1.947146	328	354	0	26	26	1.0000000
NODE_28700_length_571_cov_14.262712	237	317	2	2	80	0.0250000
NODE_28700_length_571_cov_14.262712	237	317	4	78	80	0.9750000
NODE_28700_length_571_cov_14.262712	290	370	2	16	80	0.2000000
NODE_28700_length_571_cov_14.262712	290	370	4	64	80	0.8000000
NODE_28717_length_571_cov_4.033898	154	234	0	80	80	1.0000000
NODE_28717_length_571_cov_4.033898	207	273	0	66	66	1.0000000
NODE_28809_length_570_cov_28.269639	487	559	6	12	72	0.1666667
NODE_28809_length_570_cov_28.269639	487	559	8	6	72	0.0833333
NODE_28809_length_570_cov_28.269639	487	559	10	11	72	0.1527778
NODE_28809_length_570_cov_28.269639	487	559	11	43	72	0.5972222
NODE_28812_length_570_cov_10.161359	167	247	0	80	80	1.0000000
NODE_28812_length_570_cov_10.161359	220	256	0	36	36	1.0000000
NODE_28819_length_570_cov_5.010616	179	216	2	5	37	0.1351351
NODE_28819_length_570_cov_5.010616	179	216	3	32	37	0.8648649
NODE_28819_length_570_cov_5.010616	189	269	0	4	80	0.0500000
NODE_28819_length_570_cov_5.010616	189	269	1	24	80	0.3000000
NODE_28819_length_570_cov_5.010616	189	269	2	30	80	0.3750000
NODE_28819_length_570_cov_5.010616	189	269	3	22	80	0.2750000
NODE_28828_length_570_cov_3.898089	236	316	0	80	80	1.0000000
NODE_28828_length_570_cov_3.898089	289	369	0	80	80	1.0000000
NODE_28840_length_570_cov_2.938429	202	280	0	45	78	0.5769231
NODE_28840_length_570_cov_2.938429	202	280	2	33	78	0.4230769
NODE_28840_length_570_cov_2.938429	262	333	0	71	71	1.0000000
NODE_28842_length_570_cov_2.891720	204	260	2	56	56	1.0000000
NODE_28950_length_569_cov_20.559574	275	355	0	80	80	1.0000000
NODE_28950_length_569_cov_20.559574	328	408	0	80	80	1.0000000
NODE_28951_length_569_cov_15.282979	272	352	0	71	80	0.8875000
NODE_28951_length_569_cov_15.282979	272	352	2	9	80	0.1125000
NODE_28951_length_569_cov_15.282979	325	405	0	18	80	0.2250000
NODE_28951_length_569_cov_15.282979	325	405	2	62	80	0.7750000
NODE_28952_length_569_cov_11.023404	280	360	0	13	80	0.1625000
NODE_28952_length_569_cov_11.023404	280	360	1	1	80	0.0125000
NODE_28952_length_569_cov_11.023404	280	360	2	12	80	0.1500000
NODE_28952_length_569_cov_11.023404	280	360	4	54	80	0.6750000
NODE_28952_length_569_cov_11.023404	333	413	2	18	80	0.2250000
NODE_28952_length_569_cov_11.023404	333	413	4	62	80	0.7750000
NODE_28953_length_569_cov_9.310638	231	277	0	46	46	1.0000000
NODE_28956_length_569_cov_6.989362	258	338	0	80	80	1.0000000
NODE_28956_length_569_cov_6.989362	294	329	0	35	35	1.0000000
NODE_28956_length_569_cov_6.989362	296	338	0	42	42	1.0000000
NODE_28957_length_569_cov_6.978723	264	344	0	61	80	0.7625000
NODE_28957_length_569_cov_6.978723	264	344	1	9	80	0.1125000
NODE_28957_length_569_cov_6.978723	264	344	2	10	80	0.1250000
NODE_28957_length_569_cov_6.978723	317	397	0	8	80	0.1000000
NODE_28957_length_569_cov_6.978723	317	397	1	9	80	0.1125000
NODE_28957_length_569_cov_6.978723	317	397	2	63	80	0.7875000
NODE_28960_length_569_cov_6.434043	228	308	0	80	80	1.0000000
NODE_28973_length_569_cov_3.353191	340	419	0	79	79	1.0000000
NODE_28981_length_569_cov_3.027660	277	348	0	71	71	1.0000000
NODE_29072_length_568_cov_59.729211	124	204	10	9	80	0.1125000
NODE_29072_length_568_cov_59.729211	124	204	11	1	80	0.0125000
NODE_29072_length_568_cov_59.729211	124	204	12	19	80	0.2375000
NODE_29072_length_568_cov_59.729211	124	204	13	5	80	0.0625000
NODE_29072_length_568_cov_59.729211	124	204	15	13	80	0.1625000
NODE_29072_length_568_cov_59.729211	124	204	16	33	80	0.4125000
NODE_29072_length_568_cov_59.729211	177	257	3	30	80	0.3750000
NODE_29072_length_568_cov_59.729211	177	257	5	17	80	0.2125000
NODE_29072_length_568_cov_59.729211	177	257	6	3	80	0.0375000
NODE_29072_length_568_cov_59.729211	177	257	8	1	80	0.0125000
NODE_29072_length_568_cov_59.729211	177	257	10	11	80	0.1375000
NODE_29072_length_568_cov_59.729211	177	257	11	1	80	0.0125000
NODE_29072_length_568_cov_59.729211	177	257	12	17	80	0.2125000
NODE_29075_length_568_cov_7.763326	215	294	0	79	79	1.0000000
NODE_29075_length_568_cov_7.763326	267	347	0	80	80	1.0000000
NODE_29078_length_568_cov_6.257996	397	471	0	74	74	1.0000000
NODE_29091_length_568_cov_3.748401	170	236	0	66	66	1.0000000
NODE_29091_length_568_cov_3.748401	262	311	0	49	49	1.0000000
NODE_29133_length_568_cov_1.769723	192	233	0	41	41	1.0000000
NODE_29160_length_568_cov_1.358209	355	432	0	77	77	1.0000000
NODE_29182_length_568_cov_1.038380	195	275	0	80	80	1.0000000
NODE_29216_length_567_cov_21.155983	347	427	4	3	80	0.0375000
NODE_29216_length_567_cov_21.155983	347	427	6	32	80	0.4000000
NODE_29216_length_567_cov_21.155983	347	427	8	45	80	0.5625000
NODE_29216_length_567_cov_21.155983	400	480	6	54	80	0.6750000
NODE_29216_length_567_cov_21.155983	400	480	8	26	80	0.3250000
NODE_29217_length_567_cov_18.292735	367	447	4	80	80	1.0000000
NODE_29217_length_567_cov_18.292735	420	500	0	27	80	0.3375000
NODE_29217_length_567_cov_18.292735	420	500	2	1	80	0.0125000
NODE_29217_length_567_cov_18.292735	420	500	3	6	80	0.0750000
NODE_29217_length_567_cov_18.292735	420	500	4	46	80	0.5750000
NODE_29218_length_567_cov_17.579060	259	339	0	9	80	0.1125000
NODE_29218_length_567_cov_17.579060	259	339	1	12	80	0.1500000
NODE_29218_length_567_cov_17.579060	259	339	2	8	80	0.1000000
NODE_29218_length_567_cov_17.579060	259	339	3	23	80	0.2875000
NODE_29218_length_567_cov_17.579060	259	339	5	21	80	0.2625000
NODE_29218_length_567_cov_17.579060	259	339	6	7	80	0.0875000
NODE_29218_length_567_cov_17.579060	312	392	5	20	80	0.2500000
NODE_29218_length_567_cov_17.579060	312	392	6	26	80	0.3250000
NODE_29218_length_567_cov_17.579060	312	392	8	34	80	0.4250000
NODE_29220_length_567_cov_15.457265	276	356	3	7	80	0.0875000
NODE_29220_length_567_cov_15.457265	276	356	4	18	80	0.2250000
NODE_29220_length_567_cov_15.457265	276	356	5	6	80	0.0750000
NODE_29220_length_567_cov_15.457265	276	356	6	28	80	0.3500000
NODE_29220_length_567_cov_15.457265	276	356	7	10	80	0.1250000
NODE_29220_length_567_cov_15.457265	276	356	8	11	80	0.1375000
NODE_29220_length_567_cov_15.457265	329	409	1	18	80	0.2250000
NODE_29220_length_567_cov_15.457265	329	409	3	42	80	0.5250000
NODE_29220_length_567_cov_15.457265	329	409	5	6	80	0.0750000
NODE_29220_length_567_cov_15.457265	329	409	7	10	80	0.1250000
NODE_29220_length_567_cov_15.457265	329	409	8	4	80	0.0500000
NODE_29221_length_567_cov_14.393162	270	350	1	80	80	1.0000000
NODE_29221_length_567_cov_14.393162	323	403	1	27	80	0.3375000
NODE_29221_length_567_cov_14.393162	323	403	2	53	80	0.6625000
NODE_29225_length_567_cov_6.611111	356	436	1	7	80	0.0875000
NODE_29225_length_567_cov_6.611111	356	436	2	73	80	0.9125000
NODE_29225_length_567_cov_6.611111	409	489	1	33	80	0.4125000
NODE_29225_length_567_cov_6.611111	409	489	2	45	80	0.5625000
NODE_29225_length_567_cov_6.611111	409	489	3	2	80	0.0250000
NODE_29245_length_567_cov_2.884615	204	284	0	80	80	1.0000000
NODE_29245_length_567_cov_2.884615	204	254	0	50	50	1.0000000
NODE_29245_length_567_cov_2.884615	266	297	0	31	31	1.0000000
NODE_29363_length_566_cov_47.747323	157	237	12	18	80	0.2250000
NODE_29363_length_566_cov_47.747323	157	237	13	8	80	0.1000000
NODE_29363_length_566_cov_47.747323	157	237	14	11	80	0.1375000
NODE_29363_length_566_cov_47.747323	157	237	15	7	80	0.0875000
NODE_29363_length_566_cov_47.747323	157	237	16	28	80	0.3500000
NODE_29363_length_566_cov_47.747323	157	237	18	8	80	0.1000000
NODE_29363_length_566_cov_47.747323	210	290	8	23	80	0.2875000
NODE_29363_length_566_cov_47.747323	210	290	9	24	80	0.3000000
NODE_29363_length_566_cov_47.747323	210	290	12	1	80	0.0125000
NODE_29363_length_566_cov_47.747323	210	290	13	5	80	0.0625000
NODE_29363_length_566_cov_47.747323	210	290	14	11	80	0.1375000
NODE_29363_length_566_cov_47.747323	210	290	16	16	80	0.2000000
NODE_29364_length_566_cov_44.824411	14	94	3	10	80	0.1250000
NODE_29364_length_566_cov_44.824411	14	94	4	2	80	0.0250000
NODE_29364_length_566_cov_44.824411	14	94	6	7	80	0.0875000
NODE_29364_length_566_cov_44.824411	14	94	8	57	80	0.7125000
NODE_29364_length_566_cov_44.824411	14	94	9	4	80	0.0500000
NODE_29364_length_566_cov_44.824411	15	94	3	9	79	0.1139240
NODE_29364_length_566_cov_44.824411	15	94	4	2	79	0.0253165
NODE_29364_length_566_cov_44.824411	15	94	6	7	79	0.0886076
NODE_29364_length_566_cov_44.824411	15	94	8	57	79	0.7215190
NODE_29364_length_566_cov_44.824411	15	94	9	4	79	0.0506329
NODE_29364_length_566_cov_44.824411	67	147	3	3	80	0.0375000
NODE_29364_length_566_cov_44.824411	67	147	5	7	80	0.0875000
NODE_29364_length_566_cov_44.824411	67	147	7	24	80	0.3000000
NODE_29364_length_566_cov_44.824411	67	147	8	23	80	0.2875000
NODE_29364_length_566_cov_44.824411	67	147	9	23	80	0.2875000
NODE_29364_length_566_cov_44.824411	67	147	3	3	80	0.0375000
NODE_29364_length_566_cov_44.824411	67	147	5	7	80	0.0875000
NODE_29364_length_566_cov_44.824411	67	147	7	24	80	0.3000000
NODE_29364_length_566_cov_44.824411	67	147	8	23	80	0.2875000
NODE_29364_length_566_cov_44.824411	67	147	9	23	80	0.2875000
NODE_29364_length_566_cov_44.824411	77	147	3	3	70	0.0428571
NODE_29364_length_566_cov_44.824411	77	147	5	7	70	0.1000000
NODE_29364_length_566_cov_44.824411	77	147	7	24	70	0.3428572
NODE_29364_length_566_cov_44.824411	77	147	8	13	70	0.1857143
NODE_29364_length_566_cov_44.824411	77	147	9	23	70	0.3285714
NODE_29364_length_566_cov_44.824411	143	223	1	66	80	0.8250000
NODE_29364_length_566_cov_44.824411	143	223	2	6	80	0.0750000
NODE_29364_length_566_cov_44.824411	143	223	3	7	80	0.0875000
NODE_29364_length_566_cov_44.824411	143	223	5	1	80	0.0125000
NODE_29364_length_566_cov_44.824411	196	276	0	36	80	0.4500000
NODE_29364_length_566_cov_44.824411	196	276	1	44	80	0.5500000
NODE_29367_length_566_cov_18.494647	344	424	0	80	80	1.0000000
NODE_29367_length_566_cov_18.494647	397	477	0	80	80	1.0000000
NODE_29368_length_566_cov_17.537473	324	404	2	13	80	0.1625000
NODE_29368_length_566_cov_17.537473	324	404	3	18	80	0.2250000
NODE_29368_length_566_cov_17.537473	324	404	5	3	80	0.0375000
NODE_29368_length_566_cov_17.537473	324	404	6	45	80	0.5625000
NODE_29368_length_566_cov_17.537473	324	404	7	1	80	0.0125000
NODE_29368_length_566_cov_17.537473	377	457	2	66	80	0.8250000
NODE_29368_length_566_cov_17.537473	377	457	3	14	80	0.1750000
NODE_29369_length_566_cov_13.019272	157	237	3	52	80	0.6500000
NODE_29369_length_566_cov_13.019272	157	237	5	28	80	0.3500000
NODE_29369_length_566_cov_13.019272	210	290	3	24	80	0.3000000
NODE_29369_length_566_cov_13.019272	210	290	4	50	80	0.6250000
NODE_29369_length_566_cov_13.019272	210	290	5	6	80	0.0750000
NODE_29371_length_566_cov_9.513919	191	279	2	59	88	0.6704546
NODE_29371_length_566_cov_9.513919	191	279	3	29	88	0.3295455
NODE_29371_length_566_cov_9.513919	252	332	2	33	80	0.4125000
NODE_29371_length_566_cov_9.513919	252	332	3	47	80	0.5875000
NODE_29397_length_566_cov_3.239829	292	334	0	42	42	1.0000000
NODE_29397_length_566_cov_3.239829	351	375	0	24	24	1.0000000
NODE_29437_length_566_cov_1.698073	432	481	0	49	49	1.0000000
NODE_29472_length_566_cov_0.957173	378	405	0	27	27	1.0000000
NODE_29503_length_565_cov_10.508584	202	280	0	78	78	1.0000000
NODE_29503_length_565_cov_10.508584	253	334	0	81	81	1.0000000
NODE_29509_length_565_cov_7.560086	170	246	0	19	76	0.2500000
NODE_29509_length_565_cov_7.560086	170	246	1	57	76	0.7500000
NODE_29520_length_565_cov_4.045064	231	311	0	7	80	0.0875000
NODE_29520_length_565_cov_4.045064	231	311	2	48	80	0.6000000
NODE_29520_length_565_cov_4.045064	231	311	3	25	80	0.3125000
NODE_29520_length_565_cov_4.045064	284	364	2	2	80	0.0250000
NODE_29520_length_565_cov_4.045064	284	364	3	78	80	0.9750000
NODE_29528_length_565_cov_3.399142	161	241	2	80	80	1.0000000
NODE_29528_length_565_cov_3.399142	214	294	0	21	80	0.2625000
NODE_29528_length_565_cov_3.399142	214	294	2	59	80	0.7375000
NODE_29542_length_565_cov_2.542918	302	382	1	48	80	0.6000000
NODE_29542_length_565_cov_2.542918	302	382	2	32	80	0.4000000
NODE_29542_length_565_cov_2.542918	355	435	1	80	80	1.0000000
NODE_29650_length_564_cov_46.901075	129	209	2	21	80	0.2625000
NODE_29650_length_564_cov_46.901075	129	209	3	13	80	0.1625000
NODE_29650_length_564_cov_46.901075	129	209	5	46	80	0.5750000
NODE_29650_length_564_cov_46.901075	182	262	3	8	80	0.1000000
NODE_29650_length_564_cov_46.901075	182	262	4	3	80	0.0375000
NODE_29650_length_564_cov_46.901075	182	262	5	69	80	0.8625000
NODE_29651_length_564_cov_13.520430	300	380	3	6	80	0.0750000
NODE_29651_length_564_cov_13.520430	300	380	4	57	80	0.7125000
NODE_29651_length_564_cov_13.520430	300	380	5	17	80	0.2125000
NODE_29651_length_564_cov_13.520430	353	433	1	6	80	0.0750000
NODE_29651_length_564_cov_13.520430	353	433	2	24	80	0.3000000
NODE_29651_length_564_cov_13.520430	353	433	3	29	80	0.3625000
NODE_29651_length_564_cov_13.520430	353	433	4	21	80	0.2625000
NODE_29653_length_564_cov_7.965591	291	332	2	41	41	1.0000000
NODE_29796_length_563_cov_24.487069	97	177	1	29	80	0.3625000
NODE_29796_length_563_cov_24.487069	97	177	2	51	80	0.6375000
NODE_29796_length_563_cov_24.487069	150	230	2	80	80	1.0000000
NODE_29800_length_563_cov_6.758621	301	367	1	30	66	0.4545455
NODE_29800_length_563_cov_6.758621	301	367	3	9	66	0.1363636
NODE_29800_length_563_cov_6.758621	301	367	4	27	66	0.4090909
NODE_29800_length_563_cov_6.758621	378	422	0	44	44	1.0000000
NODE_29802_length_563_cov_5.762931	48	135	0	87	87	1.0000000
NODE_29802_length_563_cov_5.762931	108	188	0	80	80	1.0000000
NODE_29808_length_563_cov_4.176724	197	277	1	2	80	0.0250000
NODE_29808_length_563_cov_4.176724	197	277	2	68	80	0.8500000
NODE_29808_length_563_cov_4.176724	197	277	3	10	80	0.1250000
NODE_29808_length_563_cov_4.176724	250	330	1	2	80	0.0250000
NODE_29808_length_563_cov_4.176724	250	330	2	53	80	0.6625000
NODE_29808_length_563_cov_4.176724	250	330	3	25	80	0.3125000
NODE_29809_length_563_cov_4.155172	273	315	2	2	42	0.0476190
NODE_29809_length_563_cov_4.155172	273	315	3	2	42	0.0476190
NODE_29809_length_563_cov_4.155172	273	315	4	38	42	0.9047619
NODE_29809_length_563_cov_4.155172	288	358	3	36	70	0.5142857
NODE_29809_length_563_cov_4.155172	288	358	4	34	70	0.4857143
NODE_29925_length_562_cov_31.194384	47	127	2	8	80	0.1000000
NODE_29925_length_562_cov_31.194384	47	127	3	3	80	0.0375000
NODE_29925_length_562_cov_31.194384	47	127	4	8	80	0.1000000
NODE_29925_length_562_cov_31.194384	47	127	5	16	80	0.2000000
NODE_29925_length_562_cov_31.194384	47	127	7	28	80	0.3500000
NODE_29925_length_562_cov_31.194384	47	127	8	8	80	0.1000000
NODE_29925_length_562_cov_31.194384	47	127	9	4	80	0.0500000
NODE_29925_length_562_cov_31.194384	47	127	10	5	80	0.0625000
NODE_29925_length_562_cov_31.194384	100	180	7	29	80	0.3625000
NODE_29925_length_562_cov_31.194384	100	180	8	11	80	0.1375000
NODE_29925_length_562_cov_31.194384	100	180	9	9	80	0.1125000
NODE_29925_length_562_cov_31.194384	100	180	10	31	80	0.3875000
NODE_29926_length_562_cov_29.857451	33	113	6	20	80	0.2500000
NODE_29926_length_562_cov_29.857451	33	113	8	1	80	0.0125000
NODE_29926_length_562_cov_29.857451	33	113	9	22	80	0.2750000
NODE_29926_length_562_cov_29.857451	33	113	11	5	80	0.0625000
NODE_29926_length_562_cov_29.857451	33	113	12	6	80	0.0750000
NODE_29926_length_562_cov_29.857451	33	113	13	9	80	0.1125000
NODE_29926_length_562_cov_29.857451	33	113	14	17	80	0.2125000
NODE_29926_length_562_cov_29.857451	86	166	6	6	80	0.0750000
NODE_29926_length_562_cov_29.857451	86	166	8	2	80	0.0250000
NODE_29926_length_562_cov_29.857451	86	166	10	5	80	0.0625000
NODE_29926_length_562_cov_29.857451	86	166	12	46	80	0.5750000
NODE_29926_length_562_cov_29.857451	86	166	13	4	80	0.0500000
NODE_29926_length_562_cov_29.857451	86	166	14	17	80	0.2125000
NODE_29927_length_562_cov_23.194384	245	325	1	4	80	0.0500000
NODE_29927_length_562_cov_23.194384	245	325	7	21	80	0.2625000
NODE_29927_length_562_cov_23.194384	245	325	8	55	80	0.6875000
NODE_29927_length_562_cov_23.194384	298	378	1	34	80	0.4250000
NODE_29927_length_562_cov_23.194384	298	378	2	17	80	0.2125000
NODE_29927_length_562_cov_23.194384	298	378	8	29	80	0.3625000
NODE_29930_length_562_cov_10.304536	271	321	1	37	50	0.7400000
NODE_29930_length_562_cov_10.304536	271	321	3	13	50	0.2600000
NODE_29931_length_562_cov_9.131749	265	346	3	49	81	0.6049383
NODE_29931_length_562_cov_9.131749	265	346	4	32	81	0.3950617
NODE_29931_length_562_cov_9.131749	319	399	2	42	80	0.5250000
NODE_29931_length_562_cov_9.131749	319	399	3	38	80	0.4750000
NODE_29960_length_562_cov_2.961123	350	398	0	48	48	1.0000000
NODE_30083_length_561_cov_18.049784	54	134	3	10	80	0.1250000
NODE_30083_length_561_cov_18.049784	54	134	4	3	80	0.0375000
NODE_30083_length_561_cov_18.049784	54	134	5	29	80	0.3625000
NODE_30083_length_561_cov_18.049784	54	134	6	38	80	0.4750000
NODE_30083_length_561_cov_18.049784	107	187	2	40	80	0.5000000
NODE_30083_length_561_cov_18.049784	107	187	4	16	80	0.2000000
NODE_30083_length_561_cov_18.049784	107	187	6	24	80	0.3000000
NODE_30087_length_561_cov_5.348485	208	274	0	66	66	1.0000000
NODE_30105_length_561_cov_2.787879	216	285	0	69	69	1.0000000
NODE_30120_length_561_cov_2.233766	339	419	1	80	80	1.0000000
NODE_30120_length_561_cov_2.233766	391	445	0	21	54	0.3888889
NODE_30120_length_561_cov_2.233766	391	445	1	33	54	0.6111111
NODE_30120_length_561_cov_2.233766	392	438	0	14	46	0.3043478
NODE_30120_length_561_cov_2.233766	392	438	1	32	46	0.6956522
NODE_30133_length_561_cov_1.803030	258	334	2	76	76	1.0000000
NODE_30224_length_560_cov_41.433839	67	147	1	4	80	0.0500000
NODE_30224_length_560_cov_41.433839	67	147	2	53	80	0.6625000
NODE_30224_length_560_cov_41.433839	67	147	3	6	80	0.0750000
NODE_30224_length_560_cov_41.433839	67	147	4	17	80	0.2125000
NODE_30224_length_560_cov_41.433839	120	200	2	4	80	0.0500000
NODE_30224_length_560_cov_41.433839	120	200	3	6	80	0.0750000
NODE_30224_length_560_cov_41.433839	120	200	4	19	80	0.2375000
NODE_30224_length_560_cov_41.433839	120	200	6	51	80	0.6375000
NODE_30225_length_560_cov_35.993492	366	446	8	5	80	0.0625000
NODE_30225_length_560_cov_35.993492	366	446	10	38	80	0.4750000
NODE_30225_length_560_cov_35.993492	366	446	11	23	80	0.2875000
NODE_30225_length_560_cov_35.993492	366	446	13	14	80	0.1750000
NODE_30225_length_560_cov_35.993492	419	499	1	6	80	0.0750000
NODE_30225_length_560_cov_35.993492	419	499	2	9	80	0.1125000
NODE_30225_length_560_cov_35.993492	419	499	4	2	80	0.0250000
NODE_30225_length_560_cov_35.993492	419	499	5	13	80	0.1625000
NODE_30225_length_560_cov_35.993492	419	499	6	7	80	0.0875000
NODE_30225_length_560_cov_35.993492	419	499	7	3	80	0.0375000
NODE_30225_length_560_cov_35.993492	419	499	8	18	80	0.2250000
NODE_30225_length_560_cov_35.993492	419	499	10	22	80	0.2750000
NODE_30226_length_560_cov_20.433839	342	422	8	7	80	0.0875000
NODE_30226_length_560_cov_20.433839	342	422	9	29	80	0.3625000
NODE_30226_length_560_cov_20.433839	342	422	10	44	80	0.5500000
NODE_30226_length_560_cov_20.433839	395	475	3	24	80	0.3000000
NODE_30226_length_560_cov_20.433839	395	475	5	5	80	0.0625000
NODE_30226_length_560_cov_20.433839	395	475	6	10	80	0.1250000
NODE_30226_length_560_cov_20.433839	395	475	8	2	80	0.0250000
NODE_30226_length_560_cov_20.433839	395	475	9	39	80	0.4875000
NODE_30227_length_560_cov_13.850325	274	327	2	53	53	1.0000000
NODE_30228_length_560_cov_12.075922	233	314	0	30	81	0.3703704
NODE_30228_length_560_cov_12.075922	233	314	1	51	81	0.6296296
NODE_30229_length_560_cov_8.594360	263	343	1	72	80	0.9000000
NODE_30229_length_560_cov_8.594360	263	343	2	8	80	0.1000000
NODE_30229_length_560_cov_8.594360	316	396	1	23	80	0.2875000
NODE_30229_length_560_cov_8.594360	316	396	2	57	80	0.7125000
NODE_30237_length_560_cov_5.227766	264	328	3	64	64	1.0000000
NODE_30238_length_560_cov_5.056399	299	379	2	80	80	1.0000000
NODE_30238_length_560_cov_5.056399	352	432	0	48	80	0.6000000
NODE_30238_length_560_cov_5.056399	352	432	2	32	80	0.4000000
NODE_30244_length_560_cov_4.518438	156	236	0	80	80	1.0000000
NODE_30281_length_560_cov_2.154013	204	275	0	71	71	1.0000000
NODE_30281_length_560_cov_2.154013	255	335	0	80	80	1.0000000
NODE_30288_length_560_cov_2.017354	52	114	0	62	62	1.0000000
NODE_30363_length_559_cov_37.526087	289	370	0	81	81	1.0000000
NODE_30363_length_559_cov_37.526087	343	423	0	80	80	1.0000000
NODE_30363_length_559_cov_37.526087	419	500	0	81	81	1.0000000
NODE_30363_length_559_cov_37.526087	473	553	0	80	80	1.0000000
NODE_30365_length_559_cov_19.126087	388	468	0	34	80	0.4250000
NODE_30365_length_559_cov_19.126087	388	468	1	46	80	0.5750000
NODE_30365_length_559_cov_19.126087	441	521	0	80	80	1.0000000
NODE_30366_length_559_cov_12.489130	262	341	4	40	79	0.5063291
NODE_30366_length_559_cov_12.489130	262	341	5	39	79	0.4936709
NODE_30366_length_559_cov_12.489130	316	394	4	28	78	0.3589744
NODE_30366_length_559_cov_12.489130	316	394	5	44	78	0.5641026
NODE_30366_length_559_cov_12.489130	316	394	6	1	78	0.0128205
NODE_30366_length_559_cov_12.489130	316	394	7	5	78	0.0641026
NODE_30370_length_559_cov_6.530435	283	363	3	26	80	0.3250000
NODE_30370_length_559_cov_6.530435	283	363	5	6	80	0.0750000
NODE_30370_length_559_cov_6.530435	283	363	6	48	80	0.6000000
NODE_30377_length_559_cov_4.930435	112	192	0	80	80	1.0000000
NODE_30377_length_559_cov_4.930435	165	244	0	79	79	1.0000000
NODE_30419_length_559_cov_1.776087	395	433	34	2	38	0.0526316
NODE_30419_length_559_cov_1.776087	395	433	36	6	38	0.1578947
NODE_30419_length_559_cov_1.776087	395	433	37	30	38	0.7894737
NODE_30480_length_558_cov_13.102397	297	364	0	9	67	0.1343284
NODE_30480_length_558_cov_13.102397	297	364	1	8	67	0.1194030
NODE_30480_length_558_cov_13.102397	297	364	3	48	67	0.7164179
NODE_30480_length_558_cov_13.102397	297	364	5	2	67	0.0298507
NODE_30482_length_558_cov_9.309368	369	449	0	4	80	0.0500000
NODE_30482_length_558_cov_9.309368	369	449	1	76	80	0.9500000
NODE_30482_length_558_cov_9.309368	422	502	0	57	80	0.7125000
NODE_30482_length_558_cov_9.309368	422	502	1	23	80	0.2875000
NODE_30489_length_558_cov_5.921569	304	361	0	57	57	1.0000000
NODE_30493_length_558_cov_4.801743	197	266	0	69	69	1.0000000
NODE_30493_length_558_cov_4.801743	197	277	0	78	80	0.9750000
NODE_30493_length_558_cov_4.801743	197	277	2	2	80	0.0250000
NODE_30493_length_558_cov_4.801743	250	330	0	25	80	0.3125000
NODE_30493_length_558_cov_4.801743	250	330	2	55	80	0.6875000
NODE_30493_length_558_cov_4.801743	250	330	0	25	80	0.3125000
NODE_30493_length_558_cov_4.801743	250	330	2	55	80	0.6875000
NODE_30495_length_558_cov_4.570806	188	244	0	36	56	0.6428571
NODE_30495_length_558_cov_4.570806	188	244	2	20	56	0.3571429
NODE_30536_length_558_cov_2.259259	236	294	0	58	58	1.0000000
NODE_30536_length_558_cov_2.259259	267	347	0	80	80	1.0000000
NODE_30568_length_558_cov_1.544662	403	483	1	31	80	0.3875000
NODE_30568_length_558_cov_1.544662	403	483	2	49	80	0.6125000
NODE_30568_length_558_cov_1.544662	456	536	1	37	80	0.4625000
NODE_30568_length_558_cov_1.544662	456	536	2	43	80	0.5375000
NODE_30623_length_557_cov_9.141921	255	335	0	1	80	0.0125000
NODE_30623_length_557_cov_9.141921	255	335	1	79	80	0.9875000
NODE_30623_length_557_cov_9.141921	308	388	0	39	80	0.4875000
NODE_30623_length_557_cov_9.141921	308	388	1	41	80	0.5125000
NODE_30626_length_557_cov_7.316594	210	290	0	51	80	0.6375000
NODE_30626_length_557_cov_7.316594	210	290	2	29	80	0.3625000
NODE_30626_length_557_cov_7.316594	263	341	0	40	78	0.5128205
NODE_30626_length_557_cov_7.316594	263	341	1	38	78	0.4871795
NODE_30636_length_557_cov_4.259825	185	267	0	82	82	1.0000000
NODE_30646_length_557_cov_3.794760	131	188	3	57	57	1.0000000
NODE_30646_length_557_cov_3.794760	139	219	3	80	80	1.0000000
NODE_30650_length_557_cov_3.517467	246	325	0	79	79	1.0000000
NODE_30650_length_557_cov_3.517467	298	378	0	80	80	1.0000000
NODE_30652_length_557_cov_3.390830	366	395	4	14	29	0.4827586
NODE_30652_length_557_cov_3.390830	366	395	6	15	29	0.5172414
NODE_30792_length_556_cov_37.258206	122	202	0	80	80	1.0000000
NODE_30792_length_556_cov_37.258206	175	255	0	71	80	0.8875000
NODE_30792_length_556_cov_37.258206	175	255	1	3	80	0.0375000
NODE_30792_length_556_cov_37.258206	175	255	2	6	80	0.0750000
NODE_30793_length_556_cov_15.266958	360	440	0	80	80	1.0000000
NODE_30793_length_556_cov_15.266958	413	493	0	80	80	1.0000000
NODE_30794_length_556_cov_12.781182	341	421	7	17	80	0.2125000
NODE_30794_length_556_cov_12.781182	341	421	8	6	80	0.0750000
NODE_30794_length_556_cov_12.781182	341	421	9	3	80	0.0375000
NODE_30794_length_556_cov_12.781182	341	421	10	54	80	0.6750000
NODE_30794_length_556_cov_12.781182	394	474	2	25	80	0.3125000
NODE_30794_length_556_cov_12.781182	394	474	4	10	80	0.1250000
NODE_30794_length_556_cov_12.781182	394	474	5	18	80	0.2250000
NODE_30794_length_556_cov_12.781182	394	474	7	17	80	0.2125000
NODE_30794_length_556_cov_12.781182	394	474	8	6	80	0.0750000
NODE_30794_length_556_cov_12.781182	394	474	9	3	80	0.0375000
NODE_30794_length_556_cov_12.781182	394	474	10	1	80	0.0125000
NODE_30795_length_556_cov_11.131291	304	384	2	17	80	0.2125000
NODE_30795_length_556_cov_11.131291	304	384	3	23	80	0.2875000
NODE_30795_length_556_cov_11.131291	304	384	4	40	80	0.5000000
NODE_30795_length_556_cov_11.131291	357	437	2	62	80	0.7750000
NODE_30795_length_556_cov_11.131291	357	437	4	18	80	0.2250000
NODE_30797_length_556_cov_7.168490	163	243	2	80	80	1.0000000
NODE_30797_length_556_cov_7.168490	216	296	0	49	80	0.6125000
NODE_30797_length_556_cov_7.168490	216	296	2	31	80	0.3875000
NODE_30798_length_556_cov_7.089716	325	379	2	54	54	1.0000000
NODE_30801_length_556_cov_6.505470	232	312	0	80	80	1.0000000
NODE_30801_length_556_cov_6.505470	285	365	0	80	80	1.0000000
NODE_30802_length_556_cov_6.496718	140	179	0	34	39	0.8717949
NODE_30802_length_556_cov_6.496718	140	179	1	5	39	0.1282051
NODE_30802_length_556_cov_6.496718	226	255	1	29	29	1.0000000
NODE_30809_length_556_cov_4.457330	197	277	0	9	80	0.1125000
NODE_30809_length_556_cov_4.457330	197	277	2	71	80	0.8875000
NODE_30818_length_556_cov_3.761488	234	307	0	73	73	1.0000000
NODE_30930_length_555_cov_20.949561	322	402	0	41	80	0.5125000
NODE_30930_length_555_cov_20.949561	322	402	1	25	80	0.3125000
NODE_30930_length_555_cov_20.949561	322	402	2	11	80	0.1375000
NODE_30930_length_555_cov_20.949561	322	402	3	3	80	0.0375000
NODE_30930_length_555_cov_20.949561	375	455	1	13	80	0.1625000
NODE_30930_length_555_cov_20.949561	375	455	2	11	80	0.1375000
NODE_30930_length_555_cov_20.949561	375	455	3	20	80	0.2500000
NODE_30930_length_555_cov_20.949561	375	455	4	36	80	0.4500000
NODE_30931_length_555_cov_16.822368	268	348	0	80	80	1.0000000
NODE_30931_length_555_cov_16.822368	321	401	0	80	80	1.0000000
NODE_30933_length_555_cov_9.912281	313	393	0	80	80	1.0000000
NODE_30935_length_555_cov_8.057018	277	357	2	7	80	0.0875000
NODE_30935_length_555_cov_8.057018	277	357	3	68	80	0.8500000
NODE_30935_length_555_cov_8.057018	277	357	4	5	80	0.0625000
NODE_30935_length_555_cov_8.057018	330	410	2	21	80	0.2625000
NODE_30935_length_555_cov_8.057018	330	410	3	34	80	0.4250000
NODE_30935_length_555_cov_8.057018	330	410	4	25	80	0.3125000
NODE_30938_length_555_cov_6.778509	62	92	0	30	30	1.0000000
NODE_30986_length_555_cov_2.177632	208	288	0	80	80	1.0000000
NODE_30986_length_555_cov_2.177632	261	329	0	68	68	1.0000000
NODE_31092_length_554_cov_11.942857	118	198	0	80	80	1.0000000
NODE_31092_length_554_cov_11.942857	171	251	0	80	80	1.0000000
NODE_31096_length_554_cov_8.426374	242	322	3	1	80	0.0125000
NODE_31096_length_554_cov_8.426374	242	322	6	34	80	0.4250000
NODE_31096_length_554_cov_8.426374	242	322	7	24	80	0.3000000
NODE_31096_length_554_cov_8.426374	242	322	8	21	80	0.2625000
NODE_31096_length_554_cov_8.426374	295	375	1	4	80	0.0500000
NODE_31096_length_554_cov_8.426374	295	375	5	9	80	0.1125000
NODE_31096_length_554_cov_8.426374	295	375	6	67	80	0.8375000
NODE_31101_length_554_cov_6.116484	264	344	2	39	80	0.4875000
NODE_31101_length_554_cov_6.116484	264	344	4	41	80	0.5125000
NODE_31101_length_554_cov_6.116484	317	393	2	15	76	0.1973684
NODE_31101_length_554_cov_6.116484	317	393	3	22	76	0.2894737
NODE_31101_length_554_cov_6.116484	317	393	4	39	76	0.5131579
NODE_31115_length_554_cov_3.586813	207	286	0	79	79	1.0000000
NODE_31240_length_553_cov_42.017621	197	277	2	39	80	0.4875000
NODE_31240_length_553_cov_42.017621	197	277	3	28	80	0.3500000
NODE_31240_length_553_cov_42.017621	197	277	4	13	80	0.1625000
NODE_31240_length_553_cov_42.017621	250	330	2	42	80	0.5250000
NODE_31240_length_553_cov_42.017621	250	330	3	14	80	0.1750000
NODE_31240_length_553_cov_42.017621	250	330	4	24	80	0.3000000
NODE_31241_length_553_cov_28.944934	333	413	5	51	80	0.6375000
NODE_31241_length_553_cov_28.944934	333	413	6	20	80	0.2500000
NODE_31241_length_553_cov_28.944934	333	413	7	9	80	0.1125000
NODE_31241_length_553_cov_28.944934	386	466	1	19	80	0.2375000
NODE_31241_length_553_cov_28.944934	386	466	3	11	80	0.1375000
NODE_31241_length_553_cov_28.944934	386	466	4	15	80	0.1875000
NODE_31241_length_553_cov_28.944934	386	466	5	35	80	0.4375000
NODE_31242_length_553_cov_12.176211	242	322	5	28	80	0.3500000
NODE_31242_length_553_cov_12.176211	242	322	6	3	80	0.0375000
NODE_31242_length_553_cov_12.176211	242	322	7	49	80	0.6125000
NODE_31242_length_553_cov_12.176211	295	375	0	1	80	0.0125000
NODE_31242_length_553_cov_12.176211	295	375	2	3	80	0.0375000
NODE_31242_length_553_cov_12.176211	295	375	3	30	80	0.3750000
NODE_31242_length_553_cov_12.176211	295	375	5	21	80	0.2625000
NODE_31242_length_553_cov_12.176211	295	375	6	3	80	0.0375000
NODE_31242_length_553_cov_12.176211	295	375	7	22	80	0.2750000
NODE_31244_length_553_cov_9.876652	232	312	0	80	80	1.0000000
NODE_31244_length_553_cov_9.876652	285	365	0	80	80	1.0000000
NODE_31246_length_553_cov_9.306167	207	287	0	80	80	1.0000000
NODE_31246_length_553_cov_9.306167	207	287	0	80	80	1.0000000
NODE_31246_length_553_cov_9.306167	260	340	0	80	80	1.0000000
NODE_31259_length_553_cov_3.729075	36	93	2	52	57	0.9122807
NODE_31259_length_553_cov_3.729075	36	93	3	5	57	0.0877193
NODE_31259_length_553_cov_3.729075	89	146	3	57	57	1.0000000
NODE_31266_length_553_cov_3.310573	226	293	0	67	67	1.0000000
NODE_31279_length_553_cov_2.678414	102	180	1	28	78	0.3589744
NODE_31279_length_553_cov_2.678414	102	180	2	50	78	0.6410257
NODE_31279_length_553_cov_2.678414	248	275	0	27	27	1.0000000
NODE_31295_length_553_cov_1.958150	416	462	0	21	46	0.4565217
NODE_31295_length_553_cov_1.958150	416	462	2	25	46	0.5434783
NODE_31295_length_553_cov_1.958150	469	515	2	46	46	1.0000000
NODE_31377_length_552_cov_92.070640	298	378	0	3	80	0.0375000
NODE_31377_length_552_cov_92.070640	298	378	1	13	80	0.1625000
NODE_31377_length_552_cov_92.070640	298	378	2	38	80	0.4750000
NODE_31377_length_552_cov_92.070640	298	378	4	26	80	0.3250000
NODE_31377_length_552_cov_92.070640	298	378	0	3	80	0.0375000
NODE_31377_length_552_cov_92.070640	298	378	1	13	80	0.1625000
NODE_31377_length_552_cov_92.070640	298	378	2	38	80	0.4750000
NODE_31377_length_552_cov_92.070640	298	378	4	26	80	0.3250000
NODE_31377_length_552_cov_92.070640	374	454	3	3	80	0.0375000
NODE_31377_length_552_cov_92.070640	374	454	4	29	80	0.3625000
NODE_31377_length_552_cov_92.070640	374	454	5	13	80	0.1625000
NODE_31377_length_552_cov_92.070640	374	454	6	35	80	0.4375000
NODE_31377_length_552_cov_92.070640	374	454	3	3	80	0.0375000
NODE_31377_length_552_cov_92.070640	374	454	4	29	80	0.3625000
NODE_31377_length_552_cov_92.070640	374	454	5	13	80	0.1625000
NODE_31377_length_552_cov_92.070640	374	454	6	35	80	0.4375000
NODE_31377_length_552_cov_92.070640	374	454	3	3	80	0.0375000
NODE_31377_length_552_cov_92.070640	374	454	4	29	80	0.3625000
NODE_31377_length_552_cov_92.070640	374	454	5	13	80	0.1625000
NODE_31377_length_552_cov_92.070640	374	454	6	35	80	0.4375000
NODE_31377_length_552_cov_92.070640	374	454	3	3	80	0.0375000
NODE_31377_length_552_cov_92.070640	374	454	4	29	80	0.3625000
NODE_31377_length_552_cov_92.070640	374	454	5	13	80	0.1625000
NODE_31377_length_552_cov_92.070640	374	454	6	35	80	0.4375000
NODE_31377_length_552_cov_92.070640	374	450	4	28	76	0.3684210
NODE_31377_length_552_cov_92.070640	374	450	5	13	76	0.1710526
NODE_31377_length_552_cov_92.070640	374	450	6	35	76	0.4605263
NODE_31377_length_552_cov_92.070640	427	507	2	43	80	0.5375000
NODE_31377_length_552_cov_92.070640	427	507	3	13	80	0.1625000
NODE_31377_length_552_cov_92.070640	427	507	4	23	80	0.2875000
NODE_31377_length_552_cov_92.070640	427	507	6	1	80	0.0125000
NODE_31377_length_552_cov_92.070640	427	507	2	43	80	0.5375000
NODE_31377_length_552_cov_92.070640	427	507	3	13	80	0.1625000
NODE_31377_length_552_cov_92.070640	427	507	4	23	80	0.2875000
NODE_31377_length_552_cov_92.070640	427	507	6	1	80	0.0125000
NODE_31377_length_552_cov_92.070640	427	498	2	34	71	0.4788733
NODE_31377_length_552_cov_92.070640	427	498	3	13	71	0.1830986
NODE_31377_length_552_cov_92.070640	427	498	4	23	71	0.3239437
NODE_31377_length_552_cov_92.070640	427	498	6	1	71	0.0140845
NODE_31377_length_552_cov_92.070640	430	500	2	36	70	0.5142857
NODE_31377_length_552_cov_92.070640	430	500	3	13	70	0.1857143
NODE_31377_length_552_cov_92.070640	430	500	4	21	70	0.3000000
NODE_31377_length_552_cov_92.070640	432	507	2	43	75	0.5733333
NODE_31377_length_552_cov_92.070640	432	507	3	13	75	0.1733333
NODE_31377_length_552_cov_92.070640	432	507	4	19	75	0.2533333
NODE_31378_length_552_cov_20.432671	151	231	3	5	80	0.0625000
NODE_31378_length_552_cov_20.432671	151	231	4	53	80	0.6625000
NODE_31378_length_552_cov_20.432671	151	231	5	22	80	0.2750000
NODE_31378_length_552_cov_20.432671	204	284	2	23	80	0.2875000
NODE_31378_length_552_cov_20.432671	204	284	3	35	80	0.4375000
NODE_31378_length_552_cov_20.432671	204	284	4	5	80	0.0625000
NODE_31378_length_552_cov_20.432671	204	284	5	17	80	0.2125000
NODE_31379_length_552_cov_18.075055	257	333	0	76	76	1.0000000
NODE_31380_length_552_cov_13.331126	214	294	0	4	80	0.0500000
NODE_31380_length_552_cov_13.331126	214	294	1	76	80	0.9500000
NODE_31380_length_552_cov_13.331126	267	347	1	80	80	1.0000000
NODE_31381_length_552_cov_12.774834	360	440	0	37	80	0.4625000
NODE_31381_length_552_cov_12.774834	360	440	1	43	80	0.5375000
NODE_31381_length_552_cov_12.774834	413	493	0	80	80	1.0000000
NODE_31384_length_552_cov_8.883002	310	390	0	28	80	0.3500000
NODE_31384_length_552_cov_8.883002	310	390	1	24	80	0.3000000
NODE_31384_length_552_cov_8.883002	310	390	2	28	80	0.3500000
NODE_31384_length_552_cov_8.883002	363	443	2	80	80	1.0000000
NODE_31385_length_552_cov_6.916115	206	281	5	56	75	0.7466667
NODE_31385_length_552_cov_6.916115	206	281	7	19	75	0.2533333
NODE_31538_length_551_cov_34.070796	324	406	0	82	82	1.0000000
NODE_31538_length_551_cov_34.070796	379	444	0	65	65	1.0000000
NODE_31541_length_551_cov_10.252212	164	244	2	80	80	1.0000000
NODE_31541_length_551_cov_10.252212	217	297	1	16	80	0.2000000
NODE_31541_length_551_cov_10.252212	217	297	2	48	80	0.6000000
NODE_31541_length_551_cov_10.252212	217	297	3	16	80	0.2000000
NODE_31543_length_551_cov_8.075221	363	406	1	35	43	0.8139535
NODE_31543_length_551_cov_8.075221	363	406	2	8	43	0.1860465
NODE_31547_length_551_cov_5.668142	213	293	0	6	80	0.0750000
NODE_31547_length_551_cov_5.668142	213	293	2	74	80	0.9250000
NODE_31547_length_551_cov_5.668142	266	346	0	59	80	0.7375000
NODE_31547_length_551_cov_5.668142	266	346	2	21	80	0.2625000
NODE_31552_length_551_cov_4.212389	171	242	0	7	71	0.0985916
NODE_31552_length_551_cov_4.212389	171	242	1	32	71	0.4507042
NODE_31552_length_551_cov_4.212389	171	242	2	32	71	0.4507042
NODE_31552_length_551_cov_4.212389	215	263	0	28	48	0.5833333
NODE_31552_length_551_cov_4.212389	215	263	1	20	48	0.4166667
NODE_31563_length_551_cov_3.307522	227	307	1	10	80	0.1250000
NODE_31563_length_551_cov_3.307522	227	307	2	70	80	0.8750000
NODE_31563_length_551_cov_3.307522	280	360	2	80	80	1.0000000
NODE_31693_length_550_cov_17.308204	101	181	1	14	80	0.1750000
NODE_31693_length_550_cov_17.308204	101	181	2	2	80	0.0250000
NODE_31693_length_550_cov_17.308204	101	181	4	36	80	0.4500000
NODE_31693_length_550_cov_17.308204	101	181	5	28	80	0.3500000
NODE_31693_length_550_cov_17.308204	154	234	5	65	80	0.8125000
NODE_31693_length_550_cov_17.308204	154	234	6	15	80	0.1875000
NODE_31700_length_550_cov_5.580931	286	329	0	43	43	1.0000000
NODE_31701_length_550_cov_5.490022	458	500	0	42	42	1.0000000
NODE_31701_length_550_cov_5.490022	459	523	0	64	64	1.0000000
NODE_31703_length_550_cov_5.243902	194	274	0	76	80	0.9500000
NODE_31703_length_550_cov_5.243902	194	274	1	4	80	0.0500000
NODE_31703_length_550_cov_5.243902	247	327	0	23	80	0.2875000
NODE_31703_length_550_cov_5.243902	247	327	1	57	80	0.7125000
NODE_31706_length_550_cov_4.815965	184	264	0	80	80	1.0000000
NODE_31726_length_550_cov_3.252772	308	388	1	39	80	0.4875000
NODE_31726_length_550_cov_3.252772	308	388	2	41	80	0.5125000
NODE_31756_length_550_cov_1.864745	189	259	0	70	70	1.0000000
NODE_31756_length_550_cov_1.864745	189	258	0	69	69	1.0000000
NODE_31847_length_549_cov_31.826667	216	292	15	5	76	0.0657895
NODE_31847_length_549_cov_31.826667	216	292	16	9	76	0.1184211
NODE_31847_length_549_cov_31.826667	216	292	17	3	76	0.0394737
NODE_31847_length_549_cov_31.826667	216	292	18	3	76	0.0394737
NODE_31847_length_549_cov_31.826667	216	292	19	21	76	0.2763158
NODE_31847_length_549_cov_31.826667	216	292	20	10	76	0.1315790
NODE_31847_length_549_cov_31.826667	216	292	21	19	76	0.2500000
NODE_31847_length_549_cov_31.826667	216	292	22	6	76	0.0789474
NODE_31847_length_549_cov_31.826667	267	331	18	21	64	0.3281250
NODE_31847_length_549_cov_31.826667	267	331	19	28	64	0.4375000
NODE_31847_length_549_cov_31.826667	267	331	20	5	64	0.0781250
NODE_31847_length_549_cov_31.826667	267	331	21	8	64	0.1250000
NODE_31847_length_549_cov_31.826667	267	331	22	2	64	0.0312500
NODE_31848_length_549_cov_14.124444	174	263	0	89	89	1.0000000
NODE_31848_length_549_cov_14.124444	242	315	0	73	73	1.0000000
NODE_31857_length_549_cov_5.375556	181	257	52	4	76	0.0526316
NODE_31857_length_549_cov_5.375556	181	257	53	6	76	0.0789474
NODE_31857_length_549_cov_5.375556	181	257	56	9	76	0.1184211
NODE_31857_length_549_cov_5.375556	181	257	57	1	76	0.0131579
NODE_31857_length_549_cov_5.375556	181	257	58	6	76	0.0789474
NODE_31857_length_549_cov_5.375556	181	257	59	10	76	0.1315790
NODE_31857_length_549_cov_5.375556	181	257	60	2	76	0.0263158
NODE_31857_length_549_cov_5.375556	181	257	61	7	76	0.0921053
NODE_31857_length_549_cov_5.375556	181	257	62	5	76	0.0657895
NODE_31857_length_549_cov_5.375556	181	257	63	1	76	0.0131579
NODE_31857_length_549_cov_5.375556	181	257	64	3	76	0.0394737
NODE_31857_length_549_cov_5.375556	181	257	65	3	76	0.0394737
NODE_31857_length_549_cov_5.375556	181	257	66	8	76	0.1052632
NODE_31857_length_549_cov_5.375556	181	257	67	7	76	0.0921053
NODE_31857_length_549_cov_5.375556	181	257	68	4	76	0.0526316
NODE_31859_length_549_cov_4.933333	260	340	1	22	80	0.2750000
NODE_31859_length_549_cov_4.933333	260	340	2	58	80	0.7250000
NODE_31864_length_549_cov_4.537778	345	430	1	14	85	0.1647059
NODE_31864_length_549_cov_4.537778	345	430	2	71	85	0.8352941
NODE_31864_length_549_cov_4.537778	403	483	1	41	80	0.5125000
NODE_31864_length_549_cov_4.537778	403	483	2	39	80	0.4875000
NODE_31865_length_549_cov_4.124444	406	486	2	35	80	0.4375000
NODE_31865_length_549_cov_4.124444	406	486	3	45	80	0.5625000
NODE_31866_length_549_cov_3.931111	182	219	0	37	37	1.0000000
NODE_31868_length_549_cov_3.893333	287	367	0	5	80	0.0625000
NODE_31868_length_549_cov_3.893333	287	367	1	21	80	0.2625000
NODE_31868_length_549_cov_3.893333	287	367	3	54	80	0.6750000
NODE_31868_length_549_cov_3.893333	340	420	3	40	80	0.5000000
NODE_31868_length_549_cov_3.893333	340	420	4	40	80	0.5000000
NODE_31887_length_549_cov_2.673333	282	343	2	61	61	1.0000000
NODE_31890_length_549_cov_2.622222	144	220	2	76	76	1.0000000
NODE_32013_length_548_cov_13.962138	285	371	0	12	86	0.1395349
NODE_32013_length_548_cov_13.962138	285	371	4	25	86	0.2906977
NODE_32013_length_548_cov_13.962138	285	371	6	49	86	0.5697674
NODE_32013_length_548_cov_13.962138	344	424	0	19	80	0.2375000
NODE_32013_length_548_cov_13.962138	344	424	4	5	80	0.0625000
NODE_32013_length_548_cov_13.962138	344	424	6	56	80	0.7000000
NODE_32022_length_548_cov_4.683742	261	336	0	64	75	0.8533334
NODE_32022_length_548_cov_4.683742	261	336	2	11	75	0.1466667
NODE_32023_length_548_cov_4.670379	140	182	0	19	42	0.4523810
NODE_32023_length_548_cov_4.670379	140	182	1	22	42	0.5238096
NODE_32023_length_548_cov_4.670379	140	182	2	1	42	0.0238095
NODE_32023_length_548_cov_4.670379	282	311	2	29	29	1.0000000
NODE_32023_length_548_cov_4.670379	410	455	0	45	45	1.0000000
NODE_32029_length_548_cov_3.630290	111	177	0	66	66	1.0000000
NODE_32039_length_548_cov_3.080178	142	191	0	49	49	1.0000000
NODE_32180_length_547_cov_23.982143	243	323	0	48	80	0.6000000
NODE_32180_length_547_cov_23.982143	243	323	1	8	80	0.1000000
NODE_32180_length_547_cov_23.982143	243	323	2	24	80	0.3000000
NODE_32180_length_547_cov_23.982143	243	323	0	48	80	0.6000000
NODE_32180_length_547_cov_23.982143	243	323	1	8	80	0.1000000
NODE_32180_length_547_cov_23.982143	243	323	2	24	80	0.3000000
NODE_32180_length_547_cov_23.982143	252	323	0	39	71	0.5492958
NODE_32180_length_547_cov_23.982143	252	323	1	8	71	0.1126761
NODE_32180_length_547_cov_23.982143	252	323	2	24	71	0.3380282
NODE_32181_length_547_cov_23.555804	42	122	4	3	80	0.0375000
NODE_32181_length_547_cov_23.555804	42	122	5	27	80	0.3375000
NODE_32181_length_547_cov_23.555804	42	122	6	9	80	0.1125000
NODE_32181_length_547_cov_23.555804	42	122	8	8	80	0.1000000
NODE_32181_length_547_cov_23.555804	42	122	10	5	80	0.0625000
NODE_32181_length_547_cov_23.555804	42	122	11	10	80	0.1250000
NODE_32181_length_547_cov_23.555804	42	122	13	5	80	0.0625000
NODE_32181_length_547_cov_23.555804	42	122	14	1	80	0.0125000
NODE_32181_length_547_cov_23.555804	42	122	15	12	80	0.1500000
NODE_32181_length_547_cov_23.555804	95	175	11	9	80	0.1125000
NODE_32181_length_547_cov_23.555804	95	175	13	33	80	0.4125000
NODE_32181_length_547_cov_23.555804	95	175	14	2	80	0.0250000
NODE_32181_length_547_cov_23.555804	95	175	15	36	80	0.4500000
NODE_32183_length_547_cov_12.819196	190	270	0	80	80	1.0000000
NODE_32195_length_547_cov_5.207589	290	370	0	80	80	1.0000000
NODE_32195_length_547_cov_5.207589	343	423	0	80	80	1.0000000
NODE_32197_length_547_cov_4.975446	411	488	0	77	77	1.0000000
NODE_32197_length_547_cov_4.975446	461	542	0	81	81	1.0000000
NODE_32199_length_547_cov_4.683036	451	492	2	41	41	1.0000000
NODE_32204_length_547_cov_4.138393	97	175	2	78	78	1.0000000
NODE_32204_length_547_cov_4.138393	151	228	2	28	77	0.3636364
NODE_32204_length_547_cov_4.138393	151	228	3	3	77	0.0389610
NODE_32204_length_547_cov_4.138393	151	228	4	46	77	0.5974026
NODE_32206_length_547_cov_4.026786	136	216	2	3	80	0.0375000
NODE_32206_length_547_cov_4.026786	136	216	3	52	80	0.6500000
NODE_32206_length_547_cov_4.026786	136	216	4	25	80	0.3125000
NODE_32206_length_547_cov_4.026786	189	269	2	48	80	0.6000000
NODE_32206_length_547_cov_4.026786	189	269	3	32	80	0.4000000
NODE_32215_length_547_cov_3.468750	219	299	0	80	80	1.0000000
NODE_32222_length_547_cov_2.901786	304	384	0	80	80	1.0000000
NODE_32347_length_546_cov_17.733781	159	239	5	11	80	0.1375000
NODE_32347_length_546_cov_17.733781	159	239	9	10	80	0.1250000
NODE_32347_length_546_cov_17.733781	159	239	10	10	80	0.1250000
NODE_32347_length_546_cov_17.733781	159	239	11	10	80	0.1250000
NODE_32347_length_546_cov_17.733781	159	239	12	15	80	0.1875000
NODE_32347_length_546_cov_17.733781	159	239	13	24	80	0.3000000
NODE_32347_length_546_cov_17.733781	212	293	6	6	81	0.0740741
NODE_32347_length_546_cov_17.733781	212	293	9	1	81	0.0123457
NODE_32347_length_546_cov_17.733781	212	293	10	21	81	0.2592593
NODE_32347_length_546_cov_17.733781	212	293	11	19	81	0.2345679
NODE_32347_length_546_cov_17.733781	212	293	12	3	81	0.0370370
NODE_32347_length_546_cov_17.733781	212	293	13	31	81	0.3827161
NODE_32348_length_546_cov_16.275168	272	352	1	3	80	0.0375000
NODE_32348_length_546_cov_16.275168	272	352	2	51	80	0.6375000
NODE_32348_length_546_cov_16.275168	272	352	3	1	80	0.0125000
NODE_32348_length_546_cov_16.275168	272	352	4	25	80	0.3125000
NODE_32348_length_546_cov_16.275168	325	405	2	1	80	0.0125000
NODE_32348_length_546_cov_16.275168	325	405	3	1	80	0.0125000
NODE_32348_length_546_cov_16.275168	325	405	4	78	80	0.9750000
NODE_32349_length_546_cov_8.201342	179	259	2	13	80	0.1625000
NODE_32349_length_546_cov_8.201342	179	259	4	59	80	0.7375000
NODE_32349_length_546_cov_8.201342	179	259	5	8	80	0.1000000
NODE_32351_length_546_cov_7.454139	241	321	0	80	80	1.0000000
NODE_32351_length_546_cov_7.454139	294	374	0	80	80	1.0000000
NODE_32380_length_546_cov_3.192394	171	251	0	80	80	1.0000000
NODE_32510_length_545_cov_31.524664	38	118	2	4	80	0.0500000
NODE_32510_length_545_cov_31.524664	38	118	3	4	80	0.0500000
NODE_32510_length_545_cov_31.524664	38	118	4	6	80	0.0750000
NODE_32510_length_545_cov_31.524664	38	118	5	5	80	0.0625000
NODE_32510_length_545_cov_31.524664	38	118	6	31	80	0.3875000
NODE_32510_length_545_cov_31.524664	38	118	8	7	80	0.0875000
NODE_32510_length_545_cov_31.524664	38	118	12	23	80	0.2875000
NODE_32510_length_545_cov_31.524664	91	171	8	4	80	0.0500000
NODE_32510_length_545_cov_31.524664	91	171	9	4	80	0.0500000
NODE_32510_length_545_cov_31.524664	91	171	11	13	80	0.1625000
NODE_32510_length_545_cov_31.524664	91	171	12	59	80	0.7375000
NODE_32517_length_545_cov_5.524664	268	348	0	80	80	1.0000000
NODE_32525_length_545_cov_3.885650	137	217	0	51	80	0.6375000
NODE_32525_length_545_cov_3.885650	137	217	2	29	80	0.3625000
NODE_32571_length_545_cov_2.013453	246	318	0	20	72	0.2777778
NODE_32571_length_545_cov_2.013453	246	318	4	52	72	0.7222222
NODE_32599_length_545_cov_1.450673	130	179	0	49	49	1.0000000
NODE_32616_length_545_cov_1.179372	431	469	0	38	38	1.0000000
NODE_32673_length_544_cov_37.705618	258	338	5	48	80	0.6000000
NODE_32673_length_544_cov_37.705618	258	338	6	7	80	0.0875000
NODE_32673_length_544_cov_37.705618	258	338	8	20	80	0.2500000
NODE_32673_length_544_cov_37.705618	258	338	10	5	80	0.0625000
NODE_32673_length_544_cov_37.705618	311	391	6	2	80	0.0250000
NODE_32673_length_544_cov_37.705618	311	391	8	23	80	0.2875000
NODE_32673_length_544_cov_37.705618	311	391	9	2	80	0.0250000
NODE_32673_length_544_cov_37.705618	311	391	10	18	80	0.2250000
NODE_32673_length_544_cov_37.705618	311	391	11	35	80	0.4375000
NODE_32674_length_544_cov_33.847191	189	269	3	30	80	0.3750000
NODE_32674_length_544_cov_33.847191	189	269	4	4	80	0.0500000
NODE_32674_length_544_cov_33.847191	189	269	5	1	80	0.0125000
NODE_32674_length_544_cov_33.847191	189	269	6	45	80	0.5625000
NODE_32674_length_544_cov_33.847191	242	327	4	49	85	0.5764706
NODE_32674_length_544_cov_33.847191	242	327	6	36	85	0.4235294
NODE_32675_length_544_cov_19.467416	251	331	0	80	80	1.0000000
NODE_32675_length_544_cov_19.467416	304	384	0	80	80	1.0000000
NODE_32676_length_544_cov_16.775281	163	243	4	6	80	0.0750000
NODE_32676_length_544_cov_16.775281	163	243	5	40	80	0.5000000
NODE_32676_length_544_cov_16.775281	163	243	6	34	80	0.4250000
NODE_32676_length_544_cov_16.775281	216	296	1	10	80	0.1250000
NODE_32676_length_544_cov_16.775281	216	296	3	7	80	0.0875000
NODE_32676_length_544_cov_16.775281	216	296	4	42	80	0.5250000
NODE_32676_length_544_cov_16.775281	216	296	6	21	80	0.2625000
NODE_32677_length_544_cov_8.943820	81	161	0	80	80	1.0000000
NODE_32677_length_544_cov_8.943820	134	214	0	80	80	1.0000000
NODE_32678_length_544_cov_8.537079	283	363	0	80	80	1.0000000
NODE_32678_length_544_cov_8.537079	336	416	0	80	80	1.0000000
NODE_32680_length_544_cov_8.440449	209	289	0	11	80	0.1375000
NODE_32680_length_544_cov_8.440449	209	289	2	69	80	0.8625000
NODE_32680_length_544_cov_8.440449	262	342	0	64	80	0.8000000
NODE_32680_length_544_cov_8.440449	262	342	2	16	80	0.2000000
NODE_32681_length_544_cov_7.604494	332	412	4	8	80	0.1000000
NODE_32681_length_544_cov_7.604494	332	412	5	19	80	0.2375000
NODE_32681_length_544_cov_7.604494	332	412	6	53	80	0.6625000
NODE_32681_length_544_cov_7.604494	385	465	0	11	80	0.1375000
NODE_32681_length_544_cov_7.604494	385	465	1	14	80	0.1750000
NODE_32681_length_544_cov_7.604494	385	465	3	6	80	0.0750000
NODE_32681_length_544_cov_7.604494	385	465	4	27	80	0.3375000
NODE_32681_length_544_cov_7.604494	385	465	5	19	80	0.2375000
NODE_32681_length_544_cov_7.604494	385	465	6	3	80	0.0375000
NODE_32684_length_544_cov_6.000000	461	513	0	52	52	1.0000000
NODE_32830_length_543_cov_38.790541	116	196	5	41	80	0.5125000
NODE_32830_length_543_cov_38.790541	116	196	6	31	80	0.3875000
NODE_32830_length_543_cov_38.790541	116	196	7	8	80	0.1000000
NODE_32830_length_543_cov_38.790541	169	249	5	5	80	0.0625000
NODE_32830_length_543_cov_38.790541	169	249	6	14	80	0.1750000
NODE_32830_length_543_cov_38.790541	169	249	7	25	80	0.3125000
NODE_32830_length_543_cov_38.790541	169	249	8	36	80	0.4500000
NODE_32831_length_543_cov_31.713964	193	273	1	55	80	0.6875000
NODE_32831_length_543_cov_31.713964	193	273	2	25	80	0.3125000
NODE_32831_length_543_cov_31.713964	246	326	0	4	80	0.0500000
NODE_32831_length_543_cov_31.713964	246	326	1	76	80	0.9500000
NODE_32832_length_543_cov_13.689189	118	198	0	66	80	0.8250000
NODE_32832_length_543_cov_13.689189	118	198	1	14	80	0.1750000
NODE_32832_length_543_cov_13.689189	171	251	0	80	80	1.0000000
NODE_32833_length_543_cov_10.601351	271	351	2	2	80	0.0250000
NODE_32833_length_543_cov_10.601351	271	351	3	59	80	0.7375000
NODE_32833_length_543_cov_10.601351	271	351	4	4	80	0.0500000
NODE_32833_length_543_cov_10.601351	271	351	6	15	80	0.1875000
NODE_32833_length_543_cov_10.601351	324	404	3	8	80	0.1000000
NODE_32833_length_543_cov_10.601351	324	404	4	4	80	0.0500000
NODE_32833_length_543_cov_10.601351	324	404	6	26	80	0.3250000
NODE_32833_length_543_cov_10.601351	324	404	7	1	80	0.0125000
NODE_32833_length_543_cov_10.601351	324	404	8	41	80	0.5125000
NODE_32833_length_543_cov_10.601351	400	480	3	33	80	0.4125000
NODE_32833_length_543_cov_10.601351	400	480	5	24	80	0.3000000
NODE_32833_length_543_cov_10.601351	400	480	6	12	80	0.1500000
NODE_32833_length_543_cov_10.601351	400	480	7	4	80	0.0500000
NODE_32833_length_543_cov_10.601351	400	480	8	7	80	0.0875000
NODE_32833_length_543_cov_10.601351	453	533	0	20	80	0.2500000
NODE_32833_length_543_cov_10.601351	453	533	1	1	80	0.0125000
NODE_32833_length_543_cov_10.601351	453	533	2	30	80	0.3750000
NODE_32833_length_543_cov_10.601351	453	533	3	29	80	0.3625000
NODE_32834_length_543_cov_9.202703	291	341	3	50	50	1.0000000
NODE_32834_length_543_cov_9.202703	347	384	2	21	37	0.5675676
NODE_32834_length_543_cov_9.202703	347	384	3	16	37	0.4324324
NODE_32835_length_543_cov_7.722973	300	378	1	4	78	0.0512821
NODE_32835_length_543_cov_7.722973	300	378	2	35	78	0.4487180
NODE_32835_length_543_cov_7.722973	300	378	3	39	78	0.5000000
NODE_32835_length_543_cov_7.722973	351	431	1	4	80	0.0500000
NODE_32835_length_543_cov_7.722973	351	431	2	55	80	0.6875000
NODE_32835_length_543_cov_7.722973	351	431	3	21	80	0.2625000
NODE_32836_length_543_cov_6.815315	181	260	0	79	79	1.0000000
NODE_32845_length_543_cov_4.704955	145	225	0	80	80	1.0000000
NODE_32845_length_543_cov_4.704955	198	275	0	77	77	1.0000000
NODE_32864_length_543_cov_3.301802	247	312	0	65	65	1.0000000
NODE_32875_length_543_cov_2.635135	253	316	0	63	63	1.0000000
NODE_32875_length_543_cov_2.635135	293	373	0	80	80	1.0000000
NODE_33002_length_543_cov_0.682432	98	178	0	19	80	0.2375000
NODE_33002_length_543_cov_0.682432	98	178	1	2	80	0.0250000
NODE_33002_length_543_cov_0.682432	98	178	2	10	80	0.1250000
NODE_33002_length_543_cov_0.682432	98	178	3	13	80	0.1625000
NODE_33002_length_543_cov_0.682432	98	178	4	36	80	0.4500000
NODE_33012_length_542_cov_57.370203	287	367	2	6	80	0.0750000
NODE_33012_length_542_cov_57.370203	287	367	6	23	80	0.2875000
NODE_33012_length_542_cov_57.370203	287	367	7	51	80	0.6375000
NODE_33012_length_542_cov_57.370203	340	378	2	17	38	0.4473684
NODE_33012_length_542_cov_57.370203	340	378	6	21	38	0.5526316
NODE_33014_length_542_cov_11.616253	277	357	2	5	80	0.0625000
NODE_33014_length_542_cov_11.616253	277	357	4	75	80	0.9375000
NODE_33014_length_542_cov_11.616253	330	410	0	17	80	0.2125000
NODE_33014_length_542_cov_11.616253	330	410	2	3	80	0.0375000
NODE_33014_length_542_cov_11.616253	330	410	3	11	80	0.1375000
NODE_33014_length_542_cov_11.616253	330	410	4	49	80	0.6125000
NODE_33015_length_542_cov_9.988713	253	333	0	7	80	0.0875000
NODE_33015_length_542_cov_9.988713	253	333	2	73	80	0.9125000
NODE_33015_length_542_cov_9.988713	306	386	0	60	80	0.7500000
NODE_33015_length_542_cov_9.988713	306	386	2	20	80	0.2500000
NODE_33018_length_542_cov_7.934537	215	295	0	80	80	1.0000000
NODE_33018_length_542_cov_7.934537	268	348	0	80	80	1.0000000
NODE_33020_length_542_cov_7.266366	159	239	0	80	80	1.0000000
NODE_33021_length_542_cov_7.069977	230	304	0	74	74	1.0000000
NODE_33021_length_542_cov_7.069977	284	362	0	78	78	1.0000000
NODE_33025_length_542_cov_4.783296	237	267	0	30	30	1.0000000
NODE_33035_length_542_cov_3.882619	275	303	0	28	28	1.0000000
NODE_33040_length_542_cov_3.600451	82	131	0	49	49	1.0000000
NODE_33188_length_541_cov_22.463801	247	327	5	3	80	0.0375000
NODE_33188_length_541_cov_22.463801	247	327	6	8	80	0.1000000
NODE_33188_length_541_cov_22.463801	247	327	8	8	80	0.1000000
NODE_33188_length_541_cov_22.463801	247	327	9	14	80	0.1750000
NODE_33188_length_541_cov_22.463801	247	327	10	15	80	0.1875000
NODE_33188_length_541_cov_22.463801	247	327	12	6	80	0.0750000
NODE_33188_length_541_cov_22.463801	247	327	14	26	80	0.3250000
NODE_33188_length_541_cov_22.463801	300	380	12	1	80	0.0125000
NODE_33188_length_541_cov_22.463801	300	380	13	42	80	0.5250000
NODE_33188_length_541_cov_22.463801	300	380	14	37	80	0.4625000
NODE_33190_length_541_cov_11.070136	60	140	0	80	80	1.0000000
NODE_33190_length_541_cov_11.070136	113	193	0	34	80	0.4250000
NODE_33190_length_541_cov_11.070136	113	193	2	46	80	0.5750000
NODE_33204_length_541_cov_3.690045	179	250	0	71	71	1.0000000
NODE_33300_length_541_cov_1.187783	352	400	0	48	48	1.0000000
NODE_33359_length_540_cov_78.353741	219	299	5	11	80	0.1375000
NODE_33359_length_540_cov_78.353741	219	299	6	23	80	0.2875000
NODE_33359_length_540_cov_78.353741	219	299	7	16	80	0.2000000
NODE_33359_length_540_cov_78.353741	219	299	8	18	80	0.2250000
NODE_33359_length_540_cov_78.353741	219	299	9	12	80	0.1500000
NODE_33359_length_540_cov_78.353741	272	352	3	13	80	0.1625000
NODE_33359_length_540_cov_78.353741	272	352	4	22	80	0.2750000
NODE_33359_length_540_cov_78.353741	272	352	5	29	80	0.3625000
NODE_33359_length_540_cov_78.353741	272	352	6	16	80	0.2000000
NODE_33360_length_540_cov_33.473923	59	139	3	37	80	0.4625000
NODE_33360_length_540_cov_33.473923	59	139	4	4	80	0.0500000
NODE_33360_length_540_cov_33.473923	59	139	6	39	80	0.4875000
NODE_33360_length_540_cov_33.473923	112	192	4	52	80	0.6500000
NODE_33360_length_540_cov_33.473923	112	192	6	28	80	0.3500000
NODE_33361_length_540_cov_20.380952	97	177	2	6	80	0.0750000
NODE_33361_length_540_cov_20.380952	97	177	5	26	80	0.3250000
NODE_33361_length_540_cov_20.380952	97	177	7	37	80	0.4625000
NODE_33361_length_540_cov_20.380952	97	177	9	11	80	0.1375000
NODE_33361_length_540_cov_20.380952	150	230	7	16	80	0.2000000
NODE_33361_length_540_cov_20.380952	150	230	9	12	80	0.1500000
NODE_33361_length_540_cov_20.380952	150	230	10	35	80	0.4375000
NODE_33361_length_540_cov_20.380952	150	230	11	12	80	0.1500000
NODE_33361_length_540_cov_20.380952	150	230	12	5	80	0.0625000
NODE_33362_length_540_cov_12.657596	248	328	3	14	80	0.1750000
NODE_33362_length_540_cov_12.657596	248	328	4	1	80	0.0125000
NODE_33362_length_540_cov_12.657596	248	328	5	65	80	0.8125000
NODE_33362_length_540_cov_12.657596	301	381	4	34	80	0.4250000
NODE_33362_length_540_cov_12.657596	301	381	5	42	80	0.5250000
NODE_33362_length_540_cov_12.657596	301	381	6	4	80	0.0500000
NODE_33363_length_540_cov_11.111111	180	260	1	29	80	0.3625000
NODE_33363_length_540_cov_11.111111	180	260	2	51	80	0.6375000
NODE_33363_length_540_cov_11.111111	233	313	1	22	80	0.2750000
NODE_33363_length_540_cov_11.111111	233	313	2	58	80	0.7250000
NODE_33365_length_540_cov_6.328798	260	340	0	14	80	0.1750000
NODE_33365_length_540_cov_6.328798	260	340	1	44	80	0.5500000
NODE_33365_length_540_cov_6.328798	260	340	2	22	80	0.2750000
NODE_33365_length_540_cov_6.328798	313	393	1	5	80	0.0625000
NODE_33365_length_540_cov_6.328798	313	393	2	75	80	0.9375000
NODE_33382_length_540_cov_3.587302	351	411	0	60	60	1.0000000
NODE_33503_length_539_cov_1023.604545	264	344	175	1	80	0.0125000
NODE_33503_length_539_cov_1023.604545	264	344	176	1	80	0.0125000
NODE_33503_length_539_cov_1023.604545	264	344	177	2	80	0.0250000
NODE_33503_length_539_cov_1023.604545	264	344	179	5	80	0.0625000
NODE_33503_length_539_cov_1023.604545	264	344	180	2	80	0.0250000
NODE_33503_length_539_cov_1023.604545	264	344	186	1	80	0.0125000
NODE_33503_length_539_cov_1023.604545	264	344	189	1	80	0.0125000
NODE_33503_length_539_cov_1023.604545	264	344	196	1	80	0.0125000
NODE_33503_length_539_cov_1023.604545	264	344	199	2	80	0.0250000
NODE_33503_length_539_cov_1023.604545	264	344	202	1	80	0.0125000
NODE_33503_length_539_cov_1023.604545	264	344	205	1	80	0.0125000
NODE_33503_length_539_cov_1023.604545	264	344	210	1	80	0.0125000
NODE_33503_length_539_cov_1023.604545	264	344	212	1	80	0.0125000
NODE_33503_length_539_cov_1023.604545	264	344	213	1	80	0.0125000
NODE_33503_length_539_cov_1023.604545	264	344	219	1	80	0.0125000
NODE_33503_length_539_cov_1023.604545	264	344	221	1	80	0.0125000
NODE_33503_length_539_cov_1023.604545	264	344	222	2	80	0.0250000
NODE_33503_length_539_cov_1023.604545	264	344	223	1	80	0.0125000
NODE_33503_length_539_cov_1023.604545	264	344	225	5	80	0.0625000
NODE_33503_length_539_cov_1023.604545	264	344	226	4	80	0.0500000
NODE_33503_length_539_cov_1023.604545	264	344	227	4	80	0.0500000
NODE_33503_length_539_cov_1023.604545	264	344	228	2	80	0.0250000
NODE_33503_length_539_cov_1023.604545	264	344	229	3	80	0.0375000
NODE_33503_length_539_cov_1023.604545	264	344	230	4	80	0.0500000
NODE_33503_length_539_cov_1023.604545	264	344	231	2	80	0.0250000
NODE_33503_length_539_cov_1023.604545	264	344	233	4	80	0.0500000
NODE_33503_length_539_cov_1023.604545	264	344	234	7	80	0.0875000
NODE_33503_length_539_cov_1023.604545	264	344	235	1	80	0.0125000
NODE_33503_length_539_cov_1023.604545	264	344	236	4	80	0.0500000
NODE_33503_length_539_cov_1023.604545	264	344	237	1	80	0.0125000
NODE_33503_length_539_cov_1023.604545	264	344	240	1	80	0.0125000
NODE_33503_length_539_cov_1023.604545	264	344	242	1	80	0.0125000
NODE_33503_length_539_cov_1023.604545	264	344	243	1	80	0.0125000
NODE_33503_length_539_cov_1023.604545	264	344	247	2	80	0.0250000
NODE_33503_length_539_cov_1023.604545	264	344	248	1	80	0.0125000
NODE_33503_length_539_cov_1023.604545	264	344	249	3	80	0.0375000
NODE_33503_length_539_cov_1023.604545	264	344	250	2	80	0.0250000
NODE_33503_length_539_cov_1023.604545	264	344	251	2	80	0.0250000
NODE_33503_length_539_cov_1023.604545	317	397	226	1	80	0.0125000
NODE_33503_length_539_cov_1023.604545	317	397	227	1	80	0.0125000
NODE_33503_length_539_cov_1023.604545	317	397	228	1	80	0.0125000
NODE_33503_length_539_cov_1023.604545	317	397	229	2	80	0.0250000
NODE_33503_length_539_cov_1023.604545	317	397	230	2	80	0.0250000
NODE_33503_length_539_cov_1023.604545	317	397	231	1	80	0.0125000
NODE_33503_length_539_cov_1023.604545	317	397	232	1	80	0.0125000
NODE_33503_length_539_cov_1023.604545	317	397	233	7	80	0.0875000
NODE_33503_length_539_cov_1023.604545	317	397	234	7	80	0.0875000
NODE_33503_length_539_cov_1023.604545	317	397	235	3	80	0.0375000
NODE_33503_length_539_cov_1023.604545	317	397	236	5	80	0.0625000
NODE_33503_length_539_cov_1023.604545	317	397	237	2	80	0.0250000
NODE_33503_length_539_cov_1023.604545	317	397	238	2	80	0.0250000
NODE_33503_length_539_cov_1023.604545	317	397	239	1	80	0.0125000
NODE_33503_length_539_cov_1023.604545	317	397	240	1	80	0.0125000
NODE_33503_length_539_cov_1023.604545	317	397	241	1	80	0.0125000
NODE_33503_length_539_cov_1023.604545	317	397	242	2	80	0.0250000
NODE_33503_length_539_cov_1023.604545	317	397	243	1	80	0.0125000
NODE_33503_length_539_cov_1023.604545	317	397	245	1	80	0.0125000
NODE_33503_length_539_cov_1023.604545	317	397	247	7	80	0.0875000
NODE_33503_length_539_cov_1023.604545	317	397	248	4	80	0.0500000
NODE_33503_length_539_cov_1023.604545	317	397	249	8	80	0.1000000
NODE_33503_length_539_cov_1023.604545	317	397	250	6	80	0.0750000
NODE_33503_length_539_cov_1023.604545	317	397	251	5	80	0.0625000
NODE_33503_length_539_cov_1023.604545	317	397	252	3	80	0.0375000
NODE_33503_length_539_cov_1023.604545	317	397	253	5	80	0.0625000
NODE_33504_length_539_cov_99.579545	478	539	0	61	61	1.0000000
NODE_33505_length_539_cov_15.247727	217	297	0	1	80	0.0125000
NODE_33505_length_539_cov_15.247727	217	297	1	79	80	0.9875000
NODE_33505_length_539_cov_15.247727	270	350	0	54	80	0.6750000
NODE_33505_length_539_cov_15.247727	270	350	1	26	80	0.3250000
NODE_33506_length_539_cov_14.172727	278	350	1	37	72	0.5138889
NODE_33506_length_539_cov_14.172727	278	350	2	35	72	0.4861111
NODE_33507_length_539_cov_13.154545	118	198	2	12	80	0.1500000
NODE_33507_length_539_cov_13.154545	118	198	3	18	80	0.2250000
NODE_33507_length_539_cov_13.154545	118	198	5	50	80	0.6250000
NODE_33507_length_539_cov_13.154545	171	251	4	51	80	0.6375000
NODE_33507_length_539_cov_13.154545	171	251	5	29	80	0.3625000
NODE_33508_length_539_cov_10.811364	48	128	0	46	80	0.5750000
NODE_33508_length_539_cov_10.811364	48	128	1	31	80	0.3875000
NODE_33508_length_539_cov_10.811364	48	128	2	3	80	0.0375000
NODE_33508_length_539_cov_10.811364	101	181	1	24	80	0.3000000
NODE_33508_length_539_cov_10.811364	101	181	2	9	80	0.1125000
NODE_33508_length_539_cov_10.811364	101	181	3	47	80	0.5875000
NODE_33509_length_539_cov_9.563636	201	277	3	76	76	1.0000000
NODE_33510_length_539_cov_7.934091	311	369	0	58	58	1.0000000
NODE_33510_length_539_cov_7.934091	342	422	0	80	80	1.0000000
NODE_33517_length_539_cov_5.740909	251	319	2	45	68	0.6617647
NODE_33517_length_539_cov_5.740909	251	319	4	8	68	0.1176471
NODE_33517_length_539_cov_5.740909	251	319	5	15	68	0.2205882
NODE_33517_length_539_cov_5.740909	301	372	4	3	71	0.0422535
NODE_33517_length_539_cov_5.740909	301	372	5	24	71	0.3380282
NODE_33517_length_539_cov_5.740909	301	372	6	31	71	0.4366197
NODE_33517_length_539_cov_5.740909	301	372	7	13	71	0.1830986
NODE_33533_length_539_cov_3.627273	80	157	0	15	77	0.1948052
NODE_33533_length_539_cov_3.627273	80	157	1	62	77	0.8051948
NODE_33533_length_539_cov_3.627273	130	175	1	45	45	1.0000000
NODE_33569_length_539_cov_2.143182	325	371	0	46	46	1.0000000
NODE_33595_length_539_cov_1.618182	408	456	0	2	48	0.0416667
NODE_33595_length_539_cov_1.618182	408	456	1	46	48	0.9583333
NODE_33623_length_539_cov_1.129545	97	134	0	37	37	1.0000000
NODE_33669_length_538_cov_23.193622	171	256	1	20	85	0.2352941
NODE_33669_length_538_cov_23.193622	171	256	2	65	85	0.7647059
NODE_33669_length_538_cov_23.193622	225	305	0	28	80	0.3500000
NODE_33669_length_538_cov_23.193622	225	305	1	41	80	0.5125000
NODE_33669_length_538_cov_23.193622	225	305	2	11	80	0.1375000
NODE_33672_length_538_cov_7.378132	145	225	1	17	80	0.2125000
NODE_33672_length_538_cov_7.378132	145	225	2	63	80	0.7875000
NODE_33672_length_538_cov_7.378132	198	278	0	50	80	0.6250000
NODE_33672_length_538_cov_7.378132	198	278	1	20	80	0.2500000
NODE_33672_length_538_cov_7.378132	198	278	2	10	80	0.1250000
NODE_33683_length_538_cov_4.496583	277	357	1	21	80	0.2625000
NODE_33683_length_538_cov_4.496583	277	357	2	59	80	0.7375000
NODE_33683_length_538_cov_4.496583	330	410	2	80	80	1.0000000
NODE_33687_length_538_cov_3.753986	251	309	1	40	58	0.6896552
NODE_33687_length_538_cov_3.753986	251	309	2	18	58	0.3103448
NODE_33713_length_538_cov_2.239180	256	338	0	82	82	1.0000000
NODE_33814_length_538_cov_0.822323	397	477	0	18	80	0.2250000
NODE_33814_length_538_cov_0.822323	397	477	1	62	80	0.7750000
NODE_33852_length_537_cov_13.031963	258	309	2	51	51	1.0000000
NODE_33854_length_537_cov_9.552511	198	278	0	80	80	1.0000000
NODE_33854_length_537_cov_9.552511	251	332	0	81	81	1.0000000
NODE_33960_length_537_cov_1.244292	107	187	0	1	80	0.0125000
NODE_33960_length_537_cov_1.244292	107	187	2	8	80	0.1000000
NODE_33960_length_537_cov_1.244292	107	187	4	11	80	0.1375000
NODE_33960_length_537_cov_1.244292	107	187	6	9	80	0.1125000
NODE_33960_length_537_cov_1.244292	107	187	7	2	80	0.0250000
NODE_33960_length_537_cov_1.244292	107	187	8	6	80	0.0750000
NODE_33960_length_537_cov_1.244292	107	187	9	8	80	0.1000000
NODE_33960_length_537_cov_1.244292	107	187	11	10	80	0.1250000
NODE_33960_length_537_cov_1.244292	107	187	12	20	80	0.2500000
NODE_33960_length_537_cov_1.244292	107	187	14	5	80	0.0625000
NODE_34029_length_536_cov_87.622426	430	462	42	8	32	0.2500000
NODE_34029_length_536_cov_87.622426	430	462	43	2	32	0.0625000
NODE_34029_length_536_cov_87.622426	430	462	44	1	32	0.0312500
NODE_34029_length_536_cov_87.622426	430	462	45	1	32	0.0312500
NODE_34029_length_536_cov_87.622426	430	462	47	4	32	0.1250000
NODE_34029_length_536_cov_87.622426	430	462	48	1	32	0.0312500
NODE_34029_length_536_cov_87.622426	430	462	50	11	32	0.3437500
NODE_34029_length_536_cov_87.622426	430	462	51	2	32	0.0625000
NODE_34029_length_536_cov_87.622426	430	462	52	1	32	0.0312500
NODE_34029_length_536_cov_87.622426	430	462	54	1	32	0.0312500
NODE_34030_length_536_cov_11.629291	119	199	3	36	80	0.4500000
NODE_34030_length_536_cov_11.629291	119	199	4	26	80	0.3250000
NODE_34030_length_536_cov_11.629291	119	199	5	18	80	0.2250000
NODE_34030_length_536_cov_11.629291	172	252	3	29	80	0.3625000
NODE_34030_length_536_cov_11.629291	172	252	4	33	80	0.4125000
NODE_34030_length_536_cov_11.629291	172	252	5	18	80	0.2250000
NODE_34032_length_536_cov_6.613272	286	372	1	29	86	0.3372093
NODE_34032_length_536_cov_6.613272	286	372	2	57	86	0.6627907
NODE_34035_length_536_cov_5.810069	191	271	0	20	80	0.2500000
NODE_34035_length_536_cov_5.810069	191	271	2	39	80	0.4875000
NODE_34035_length_536_cov_5.810069	191	271	4	21	80	0.2625000
NODE_34035_length_536_cov_5.810069	244	324	2	25	80	0.3125000
NODE_34035_length_536_cov_5.810069	244	324	4	55	80	0.6875000
NODE_34035_length_536_cov_5.810069	374	404	0	24	30	0.8000000
NODE_34035_length_536_cov_5.810069	374	404	2	6	30	0.2000000
NODE_34039_length_536_cov_4.729977	202	245	0	43	43	1.0000000
NODE_34057_length_536_cov_3.297483	86	126	0	1	40	0.0250000
NODE_34057_length_536_cov_3.297483	86	126	2	39	40	0.9750000
NODE_34068_length_536_cov_2.796339	223	280	0	57	57	1.0000000
NODE_34094_length_536_cov_1.956522	181	230	8	13	49	0.2653061
NODE_34094_length_536_cov_1.956522	181	230	9	5	49	0.1020408
NODE_34094_length_536_cov_1.956522	181	230	10	8	49	0.1632653
NODE_34094_length_536_cov_1.956522	181	230	11	4	49	0.0816327
NODE_34094_length_536_cov_1.956522	181	230	12	16	49	0.3265306
NODE_34094_length_536_cov_1.956522	181	230	13	2	49	0.0408163
NODE_34094_length_536_cov_1.956522	181	230	14	1	49	0.0204082
NODE_34095_length_536_cov_1.951945	203	284	0	81	81	1.0000000
NODE_34095_length_536_cov_1.951945	306	368	0	62	62	1.0000000
NODE_34209_length_535_cov_32.277523	158	238	0	72	80	0.9000000
NODE_34209_length_535_cov_32.277523	158	238	3	8	80	0.1000000
NODE_34209_length_535_cov_32.277523	211	291	0	37	80	0.4625000
NODE_34209_length_535_cov_32.277523	211	291	2	43	80	0.5375000
NODE_34215_length_535_cov_5.910550	110	162	0	52	52	1.0000000
NODE_34229_length_535_cov_3.795872	217	297	0	1	80	0.0125000
NODE_34229_length_535_cov_3.795872	217	297	2	79	80	0.9875000
NODE_34375_length_534_cov_54.331034	435	498	0	57	63	0.9047619
NODE_34375_length_534_cov_54.331034	435	498	1	2	63	0.0317460
NODE_34375_length_534_cov_54.331034	435	498	5	4	63	0.0634921
NODE_34375_length_534_cov_54.331034	471	534	0	63	63	1.0000000
NODE_34377_length_534_cov_15.462069	460	534	1	74	74	1.0000000
NODE_34377_length_534_cov_15.462069	512	534	1	22	22	1.0000000
NODE_34378_length_534_cov_10.308046	268	348	0	80	80	1.0000000
NODE_34378_length_534_cov_10.308046	321	401	0	80	80	1.0000000
NODE_34380_length_534_cov_9.041379	204	284	1	3	80	0.0375000
NODE_34380_length_534_cov_9.041379	204	284	2	5	80	0.0625000
NODE_34380_length_534_cov_9.041379	204	284	3	1	80	0.0125000
NODE_34380_length_534_cov_9.041379	204	284	4	24	80	0.3000000
NODE_34380_length_534_cov_9.041379	204	284	5	47	80	0.5875000
NODE_34380_length_534_cov_9.041379	257	332	4	32	75	0.4266667
NODE_34380_length_534_cov_9.041379	257	332	5	43	75	0.5733333
NODE_34383_length_534_cov_6.958621	273	303	0	30	30	1.0000000
NODE_34392_length_534_cov_5.022989	291	371	0	1	80	0.0125000
NODE_34392_length_534_cov_5.022989	291	371	1	7	80	0.0875000
NODE_34392_length_534_cov_5.022989	291	371	2	72	80	0.9000000
NODE_34402_length_534_cov_3.873563	110	190	0	80	80	1.0000000
NODE_34409_length_534_cov_3.202299	221	301	0	80	80	1.0000000
NODE_34411_length_534_cov_3.158621	171	200	0	29	29	1.0000000
NODE_34418_length_534_cov_3.002299	175	219	0	35	44	0.7954546
NODE_34418_length_534_cov_3.002299	175	219	1	6	44	0.1363636
NODE_34418_length_534_cov_3.002299	175	219	2	3	44	0.0681818
NODE_34489_length_534_cov_1.344828	475	518	0	43	43	1.0000000
NODE_34494_length_534_cov_1.291954	273	336	0	63	63	1.0000000
NODE_34511_length_534_cov_1.160920	227	264	1	1	37	0.0270270
NODE_34511_length_534_cov_1.160920	227	264	2	36	37	0.9729730
NODE_34570_length_533_cov_13.956221	216	296	0	15	80	0.1875000
NODE_34570_length_533_cov_13.956221	216	296	1	3	80	0.0375000
NODE_34570_length_533_cov_13.956221	216	296	2	62	80	0.7750000
NODE_34570_length_533_cov_13.956221	269	349	2	80	80	1.0000000
NODE_34575_length_533_cov_8.207373	244	322	0	78	78	1.0000000
NODE_34576_length_533_cov_8.023041	230	310	3	45	80	0.5625000
NODE_34576_length_533_cov_8.023041	230	310	4	14	80	0.1750000
NODE_34576_length_533_cov_8.023041	230	310	5	9	80	0.1125000
NODE_34576_length_533_cov_8.023041	230	310	6	12	80	0.1500000
NODE_34576_length_533_cov_8.023041	283	364	4	6	81	0.0740741
NODE_34576_length_533_cov_8.023041	283	364	5	21	81	0.2592593
NODE_34576_length_533_cov_8.023041	283	364	6	54	81	0.6666667
NODE_34585_length_533_cov_5.170507	308	369	0	61	61	1.0000000
NODE_34588_length_533_cov_4.988479	229	309	0	48	80	0.6000000
NODE_34588_length_533_cov_4.988479	229	309	1	13	80	0.1625000
NODE_34588_length_533_cov_4.988479	229	309	2	19	80	0.2375000
NODE_34588_length_533_cov_4.988479	282	362	1	8	80	0.1000000
NODE_34588_length_533_cov_4.988479	282	362	2	72	80	0.9000000
NODE_34600_length_533_cov_3.638249	201	265	0	64	64	1.0000000
NODE_34603_length_533_cov_3.511521	138	218	0	80	80	1.0000000
NODE_34615_length_533_cov_3.073733	294	340	0	46	46	1.0000000
NODE_34617_length_533_cov_3.052995	256	304	0	48	48	1.0000000
NODE_34631_length_533_cov_2.366359	229	311	0	82	82	1.0000000
NODE_34635_length_533_cov_2.288018	468	490	0	22	22	1.0000000
NODE_34767_length_532_cov_73.279446	0	64	0	3	64	0.0468750
NODE_34767_length_532_cov_73.279446	0	64	2	61	64	0.9531250
NODE_34768_length_532_cov_23.055427	168	248	7	4	80	0.0500000
NODE_34768_length_532_cov_23.055427	168	248	8	34	80	0.4250000
NODE_34768_length_532_cov_23.055427	168	248	9	2	80	0.0250000
NODE_34768_length_532_cov_23.055427	168	248	10	40	80	0.5000000
NODE_34768_length_532_cov_23.055427	221	301	5	7	80	0.0875000
NODE_34768_length_532_cov_23.055427	221	301	9	2	80	0.0250000
NODE_34768_length_532_cov_23.055427	221	301	10	58	80	0.7250000
NODE_34768_length_532_cov_23.055427	221	301	11	13	80	0.1625000
NODE_34769_length_532_cov_22.778291	256	336	3	21	80	0.2625000
NODE_34769_length_532_cov_22.778291	256	336	4	21	80	0.2625000
NODE_34769_length_532_cov_22.778291	256	336	5	18	80	0.2250000
NODE_34769_length_532_cov_22.778291	256	336	6	20	80	0.2500000
NODE_34769_length_532_cov_22.778291	309	389	3	1	80	0.0125000
NODE_34769_length_532_cov_22.778291	309	389	4	1	80	0.0125000
NODE_34769_length_532_cov_22.778291	309	389	5	69	80	0.8625000
NODE_34769_length_532_cov_22.778291	309	389	6	9	80	0.1125000
NODE_34770_length_532_cov_13.279446	85	165	0	80	80	1.0000000
NODE_34770_length_532_cov_13.279446	138	218	0	80	80	1.0000000
NODE_34774_length_532_cov_7.591224	171	235	0	64	64	1.0000000
NODE_34774_length_532_cov_7.591224	172	235	0	63	63	1.0000000
NODE_34774_length_532_cov_7.591224	173	226	0	53	53	1.0000000
NODE_34774_length_532_cov_7.591224	173	228	0	55	55	1.0000000
NODE_34774_length_532_cov_7.591224	208	282	0	74	74	1.0000000
NODE_34774_length_532_cov_7.591224	208	282	0	74	74	1.0000000
NODE_34774_length_532_cov_7.591224	208	282	0	74	74	1.0000000
NODE_34774_length_532_cov_7.591224	208	282	0	74	74	1.0000000
NODE_34788_length_532_cov_4.524249	84	151	0	67	67	1.0000000
NODE_34788_length_532_cov_4.524249	137	218	0	81	81	1.0000000
NODE_34838_length_532_cov_1.866051	263	309	0	46	46	1.0000000
NODE_34845_length_532_cov_1.757506	126	146	0	20	20	1.0000000
NODE_34948_length_531_cov_35.539352	7	45	1	3	38	0.0789474
NODE_34948_length_531_cov_35.539352	7	45	2	35	38	0.9210526
NODE_34948_length_531_cov_35.539352	18	98	2	60	80	0.7500000
NODE_34948_length_531_cov_35.539352	18	98	4	20	80	0.2500000
NODE_34949_length_531_cov_13.162037	129	209	2	24	80	0.3000000
NODE_34949_length_531_cov_13.162037	129	209	3	19	80	0.2375000
NODE_34949_length_531_cov_13.162037	129	209	4	37	80	0.4625000
NODE_34949_length_531_cov_13.162037	182	251	3	5	69	0.0724638
NODE_34949_length_531_cov_13.162037	182	251	4	64	69	0.9275362
NODE_34953_length_531_cov_6.821759	242	322	0	80	80	1.0000000
NODE_34953_length_531_cov_6.821759	295	375	0	80	80	1.0000000
NODE_34958_length_531_cov_5.261574	261	336	0	29	75	0.3866667
NODE_34958_length_531_cov_5.261574	261	336	2	46	75	0.6133333
NODE_34958_length_531_cov_5.261574	309	362	2	53	53	1.0000000
NODE_34963_length_531_cov_4.527778	177	255	0	78	78	1.0000000
NODE_34965_length_531_cov_4.319444	283	363	2	80	80	1.0000000
NODE_34965_length_531_cov_4.319444	336	416	0	9	80	0.1125000
NODE_34965_length_531_cov_4.319444	336	416	1	37	80	0.4625000
NODE_34965_length_531_cov_4.319444	336	416	2	34	80	0.4250000
NODE_34979_length_531_cov_3.488426	238	318	4	5	80	0.0625000
NODE_34979_length_531_cov_3.488426	238	318	5	20	80	0.2500000
NODE_34979_length_531_cov_3.488426	238	318	6	55	80	0.6875000
NODE_34979_length_531_cov_3.488426	291	371	3	11	80	0.1375000
NODE_34979_length_531_cov_3.488426	291	371	4	13	80	0.1625000
NODE_34979_length_531_cov_3.488426	291	371	5	38	80	0.4750000
NODE_34979_length_531_cov_3.488426	291	371	6	18	80	0.2250000
NODE_34980_length_531_cov_3.375000	153	207	1	46	54	0.8518519
NODE_34980_length_531_cov_3.375000	153	207	2	8	54	0.1481481
NODE_34980_length_531_cov_3.375000	180	260	1	19	80	0.2375000
NODE_34980_length_531_cov_3.375000	180	260	2	61	80	0.7625000
NODE_34986_length_531_cov_3.111111	243	323	2	80	80	1.0000000
NODE_34986_length_531_cov_3.111111	296	376	0	48	80	0.6000000
NODE_34986_length_531_cov_3.111111	296	376	2	32	80	0.4000000
NODE_35008_length_531_cov_2.201389	302	373	0	71	71	1.0000000
NODE_35008_length_531_cov_2.201389	350	426	0	76	76	1.0000000
NODE_35141_length_530_cov_30.605568	250	330	5	4	80	0.0500000
NODE_35141_length_530_cov_30.605568	250	330	6	27	80	0.3375000
NODE_35141_length_530_cov_30.605568	250	330	7	6	80	0.0750000
NODE_35141_length_530_cov_30.605568	250	330	8	43	80	0.5375000
NODE_35141_length_530_cov_30.605568	303	383	4	1	80	0.0125000
NODE_35141_length_530_cov_30.605568	303	383	5	6	80	0.0750000
NODE_35141_length_530_cov_30.605568	303	383	6	20	80	0.2500000
NODE_35141_length_530_cov_30.605568	303	383	7	40	80	0.5000000
NODE_35141_length_530_cov_30.605568	303	383	8	13	80	0.1625000
NODE_35142_length_530_cov_16.937355	404	484	0	7	80	0.0875000
NODE_35142_length_530_cov_16.937355	404	484	2	73	80	0.9125000
NODE_35142_length_530_cov_16.937355	457	530	0	22	73	0.3013699
NODE_35142_length_530_cov_16.937355	457	530	2	51	73	0.6986302
NODE_35143_length_530_cov_9.902552	273	353	0	80	80	1.0000000
NODE_35143_length_530_cov_9.902552	326	406	0	80	80	1.0000000
NODE_35144_length_530_cov_7.928074	46	126	0	51	80	0.6375000
NODE_35144_length_530_cov_7.928074	46	126	1	29	80	0.3625000
NODE_35144_length_530_cov_7.928074	99	179	0	38	80	0.4750000
NODE_35144_length_530_cov_7.928074	99	179	1	42	80	0.5250000
NODE_35150_length_530_cov_4.647332	188	268	2	80	80	1.0000000
NODE_35150_length_530_cov_4.647332	241	321	0	37	80	0.4625000
NODE_35150_length_530_cov_4.647332	241	321	2	43	80	0.5375000
NODE_35154_length_530_cov_4.389791	162	242	8	4	80	0.0500000
NODE_35154_length_530_cov_4.389791	162	242	9	14	80	0.1750000
NODE_35154_length_530_cov_4.389791	162	242	10	37	80	0.4625000
NODE_35154_length_530_cov_4.389791	162	242	11	7	80	0.0875000
NODE_35154_length_530_cov_4.389791	162	242	12	2	80	0.0250000
NODE_35154_length_530_cov_4.389791	162	242	13	16	80	0.2000000
NODE_35159_length_530_cov_4.046404	76	111	0	35	35	1.0000000
NODE_35319_length_529_cov_38.983721	140	220	3	22	80	0.2750000
NODE_35319_length_529_cov_38.983721	140	220	4	46	80	0.5750000
NODE_35319_length_529_cov_38.983721	140	220	5	12	80	0.1500000
NODE_35320_length_529_cov_18.223256	189	269	2	39	80	0.4875000
NODE_35320_length_529_cov_18.223256	189	269	3	24	80	0.3000000
NODE_35320_length_529_cov_18.223256	189	269	4	17	80	0.2125000
NODE_35320_length_529_cov_18.223256	242	322	0	21	80	0.2625000
NODE_35320_length_529_cov_18.223256	242	322	2	59	80	0.7375000
NODE_35321_length_529_cov_17.009302	358	438	3	6	80	0.0750000
NODE_35321_length_529_cov_17.009302	358	438	4	15	80	0.1875000
NODE_35321_length_529_cov_17.009302	358	438	5	14	80	0.1750000
NODE_35321_length_529_cov_17.009302	358	438	6	34	80	0.4250000
NODE_35321_length_529_cov_17.009302	358	438	7	11	80	0.1375000
NODE_35321_length_529_cov_17.009302	411	491	1	12	80	0.1500000
NODE_35321_length_529_cov_17.009302	411	491	2	9	80	0.1125000
NODE_35321_length_529_cov_17.009302	411	491	3	38	80	0.4750000
NODE_35321_length_529_cov_17.009302	411	491	4	15	80	0.1875000
NODE_35321_length_529_cov_17.009302	411	491	5	6	80	0.0750000
NODE_35331_length_529_cov_6.195349	211	291	0	80	80	1.0000000
NODE_35331_length_529_cov_6.195349	264	322	0	58	58	1.0000000
NODE_35336_length_529_cov_5.176744	139	207	0	68	68	1.0000000
NODE_35336_length_529_cov_5.176744	185	260	0	75	75	1.0000000
NODE_35364_length_529_cov_2.883721	223	281	2	58	58	1.0000000
NODE_35374_length_529_cov_2.660465	89	168	0	72	79	0.9113924
NODE_35374_length_529_cov_2.660465	89	168	2	7	79	0.0886076
NODE_35375_length_529_cov_2.595349	278	321	0	43	43	1.0000000
NODE_35384_length_529_cov_2.272093	247	313	2	26	66	0.3939394
NODE_35384_length_529_cov_2.272093	247	313	3	16	66	0.2424242
NODE_35384_length_529_cov_2.272093	247	313	4	24	66	0.3636364
NODE_35427_length_529_cov_1.597674	289	332	0	43	43	1.0000000
NODE_35521_length_528_cov_25.808858	233	313	7	3	80	0.0375000
NODE_35521_length_528_cov_25.808858	233	313	8	16	80	0.2000000
NODE_35521_length_528_cov_25.808858	233	313	9	14	80	0.1750000
NODE_35521_length_528_cov_25.808858	233	313	10	5	80	0.0625000
NODE_35521_length_528_cov_25.808858	233	313	11	22	80	0.2750000
NODE_35521_length_528_cov_25.808858	233	313	12	20	80	0.2500000
NODE_35521_length_528_cov_25.808858	286	366	3	4	80	0.0500000
NODE_35521_length_528_cov_25.808858	286	366	4	19	80	0.2375000
NODE_35521_length_528_cov_25.808858	286	366	5	12	80	0.1500000
NODE_35521_length_528_cov_25.808858	286	366	7	8	80	0.1000000
NODE_35521_length_528_cov_25.808858	286	366	8	9	80	0.1125000
NODE_35521_length_528_cov_25.808858	286	366	10	6	80	0.0750000
NODE_35521_length_528_cov_25.808858	286	366	11	2	80	0.0250000
NODE_35521_length_528_cov_25.808858	286	366	12	20	80	0.2500000
NODE_35522_length_528_cov_17.331002	219	299	6	14	80	0.1750000
NODE_35522_length_528_cov_17.331002	219	299	7	1	80	0.0125000
NODE_35522_length_528_cov_17.331002	219	299	8	65	80	0.8125000
NODE_35522_length_528_cov_17.331002	272	352	4	34	80	0.4250000
NODE_35522_length_528_cov_17.331002	272	352	6	31	80	0.3875000
NODE_35522_length_528_cov_17.331002	272	352	8	15	80	0.1875000
NODE_35523_length_528_cov_16.165501	262	342	2	4	80	0.0500000
NODE_35523_length_528_cov_16.165501	262	342	3	13	80	0.1625000
NODE_35523_length_528_cov_16.165501	262	342	4	57	80	0.7125000
NODE_35523_length_528_cov_16.165501	262	342	5	6	80	0.0750000
NODE_35523_length_528_cov_16.165501	315	395	4	34	80	0.4250000
NODE_35523_length_528_cov_16.165501	315	395	5	36	80	0.4500000
NODE_35523_length_528_cov_16.165501	315	395	6	10	80	0.1250000
NODE_35529_length_528_cov_5.776224	204	284	2	80	80	1.0000000
NODE_35529_length_528_cov_5.776224	257	337	0	29	80	0.3625000
NODE_35529_length_528_cov_5.776224	257	337	2	51	80	0.6375000
NODE_35542_length_528_cov_4.016317	235	315	6	61	80	0.7625000
NODE_35542_length_528_cov_4.016317	235	315	7	19	80	0.2375000
NODE_35542_length_528_cov_4.016317	288	368	1	27	80	0.3375000
NODE_35542_length_528_cov_4.016317	288	368	4	18	80	0.2250000
NODE_35542_length_528_cov_4.016317	288	368	6	26	80	0.3250000
NODE_35542_length_528_cov_4.016317	288	368	7	9	80	0.1125000
NODE_35545_length_528_cov_3.799534	144	192	0	48	48	1.0000000
NODE_35561_length_528_cov_2.902098	252	305	0	53	53	1.0000000
NODE_35575_length_528_cov_2.324009	137	188	2	46	51	0.9019608
NODE_35575_length_528_cov_2.324009	137	188	4	5	51	0.0980392
NODE_35575_length_528_cov_2.324009	161	241	2	32	80	0.4000000
NODE_35575_length_528_cov_2.324009	161	241	4	48	80	0.6000000
NODE_35597_length_528_cov_1.755245	268	348	0	5	80	0.0625000
NODE_35597_length_528_cov_1.755245	268	348	2	2	80	0.0250000
NODE_35597_length_528_cov_1.755245	268	348	4	14	80	0.1750000
NODE_35597_length_528_cov_1.755245	268	348	5	9	80	0.1125000
NODE_35597_length_528_cov_1.755245	268	348	6	50	80	0.6250000
NODE_35597_length_528_cov_1.755245	321	401	4	63	80	0.7875000
NODE_35597_length_528_cov_1.755245	321	401	6	17	80	0.2125000
NODE_35687_length_527_cov_19.247664	306	386	3	18	80	0.2250000
NODE_35687_length_527_cov_19.247664	306	386	4	39	80	0.4875000
NODE_35687_length_527_cov_19.247664	306	386	6	23	80	0.2875000
NODE_35687_length_527_cov_19.247664	359	439	3	16	80	0.2000000
NODE_35687_length_527_cov_19.247664	359	439	4	38	80	0.4750000
NODE_35687_length_527_cov_19.247664	359	439	6	26	80	0.3250000
NODE_35688_length_527_cov_15.974299	250	349	0	99	99	1.0000000
NODE_35688_length_527_cov_15.974299	322	402	0	80	80	1.0000000
NODE_35691_length_527_cov_8.221963	235	315	4	2	80	0.0250000
NODE_35691_length_527_cov_8.221963	235	315	5	13	80	0.1625000
NODE_35691_length_527_cov_8.221963	235	315	7	27	80	0.3375000
NODE_35691_length_527_cov_8.221963	235	315	8	9	80	0.1125000
NODE_35691_length_527_cov_8.221963	235	315	9	17	80	0.2125000
NODE_35691_length_527_cov_8.221963	235	315	10	12	80	0.1500000
NODE_35691_length_527_cov_8.221963	288	368	3	4	80	0.0500000
NODE_35691_length_527_cov_8.221963	288	368	4	20	80	0.2500000
NODE_35691_length_527_cov_8.221963	288	368	5	44	80	0.5500000
NODE_35691_length_527_cov_8.221963	288	368	7	12	80	0.1500000
NODE_35693_length_527_cov_7.200935	190	270	0	80	80	1.0000000
NODE_35693_length_527_cov_7.200935	243	346	0	48	103	0.4660194
NODE_35693_length_527_cov_7.200935	243	346	2	27	103	0.2621359
NODE_35693_length_527_cov_7.200935	243	346	3	12	103	0.1165049
NODE_35693_length_527_cov_7.200935	243	346	5	16	103	0.1553398
NODE_35693_length_527_cov_7.200935	342	422	5	5	80	0.0625000
NODE_35693_length_527_cov_7.200935	342	422	6	75	80	0.9375000
NODE_35693_length_527_cov_7.200935	395	475	1	7	80	0.0875000
NODE_35693_length_527_cov_7.200935	395	475	2	26	80	0.3250000
NODE_35693_length_527_cov_7.200935	395	475	4	6	80	0.0750000
NODE_35693_length_527_cov_7.200935	395	475	6	41	80	0.5125000
NODE_35696_length_527_cov_6.862150	279	359	1	29	80	0.3625000
NODE_35696_length_527_cov_6.862150	279	359	2	51	80	0.6375000
NODE_35697_length_527_cov_6.046729	155	235	2	80	80	1.0000000
NODE_35697_length_527_cov_6.046729	208	288	2	80	80	1.0000000
NODE_35736_length_527_cov_2.238318	226	306	1	77	80	0.9625000
NODE_35736_length_527_cov_2.238318	226	306	2	3	80	0.0375000
NODE_35858_length_526_cov_50.866511	169	242	2	15	73	0.2054795
NODE_35858_length_526_cov_50.866511	169	242	6	31	73	0.4246575
NODE_35858_length_526_cov_50.866511	169	242	7	1	73	0.0136986
NODE_35858_length_526_cov_50.866511	169	242	8	26	73	0.3561644
NODE_35858_length_526_cov_50.866511	215	295	4	11	80	0.1375000
NODE_35858_length_526_cov_50.866511	215	295	6	22	80	0.2750000
NODE_35858_length_526_cov_50.866511	215	295	7	1	80	0.0125000
NODE_35858_length_526_cov_50.866511	215	295	8	46	80	0.5750000
NODE_35858_length_526_cov_50.866511	291	371	2	5	80	0.0625000
NODE_35858_length_526_cov_50.866511	291	371	4	36	80	0.4500000
NODE_35858_length_526_cov_50.866511	291	371	6	39	80	0.4875000
NODE_35858_length_526_cov_50.866511	344	424	0	5	80	0.0625000
NODE_35858_length_526_cov_50.866511	344	424	2	53	80	0.6625000
NODE_35858_length_526_cov_50.866511	344	424	4	22	80	0.2750000
NODE_35860_length_526_cov_26.395785	315	395	7	4	80	0.0500000
NODE_35860_length_526_cov_26.395785	315	395	8	61	80	0.7625000
NODE_35860_length_526_cov_26.395785	315	395	9	15	80	0.1875000
NODE_35860_length_526_cov_26.395785	368	448	4	1	80	0.0125000
NODE_35860_length_526_cov_26.395785	368	448	5	29	80	0.3625000
NODE_35860_length_526_cov_26.395785	368	448	6	4	80	0.0500000
NODE_35860_length_526_cov_26.395785	368	448	7	23	80	0.2875000
NODE_35860_length_526_cov_26.395785	368	448	8	20	80	0.2500000
NODE_35860_length_526_cov_26.395785	368	448	9	3	80	0.0375000
NODE_35861_length_526_cov_16.611241	305	385	3	15	80	0.1875000
NODE_35861_length_526_cov_16.611241	305	385	4	10	80	0.1250000
NODE_35861_length_526_cov_16.611241	305	385	5	2	80	0.0250000
NODE_35861_length_526_cov_16.611241	305	385	6	2	80	0.0250000
NODE_35861_length_526_cov_16.611241	305	385	8	11	80	0.1375000
NODE_35861_length_526_cov_16.611241	305	385	9	31	80	0.3875000
NODE_35861_length_526_cov_16.611241	305	385	10	9	80	0.1125000
NODE_35861_length_526_cov_16.611241	358	438	7	26	80	0.3250000
NODE_35861_length_526_cov_16.611241	358	438	8	1	80	0.0125000
NODE_35861_length_526_cov_16.611241	358	438	9	45	80	0.5625000
NODE_35861_length_526_cov_16.611241	358	438	10	8	80	0.1000000
NODE_35866_length_526_cov_6.215457	303	351	1	48	48	1.0000000
NODE_35877_length_526_cov_3.936768	118	142	0	24	24	1.0000000
NODE_35877_length_526_cov_3.936768	118	163	0	45	45	1.0000000
NODE_35901_length_526_cov_2.466042	138	184	1	32	46	0.6956522
NODE_35901_length_526_cov_2.466042	138	184	2	14	46	0.3043478
NODE_36055_length_525_cov_33.910798	98	178	0	49	80	0.6125000
NODE_36055_length_525_cov_33.910798	98	178	1	18	80	0.2250000
NODE_36055_length_525_cov_33.910798	98	178	2	13	80	0.1625000
NODE_36055_length_525_cov_33.910798	151	231	0	9	80	0.1125000
NODE_36055_length_525_cov_33.910798	151	231	1	71	80	0.8875000
NODE_36055_length_525_cov_33.910798	159	231	0	1	72	0.0138889
NODE_36055_length_525_cov_33.910798	159	231	1	71	72	0.9861111
NODE_36058_length_525_cov_8.788732	175	255	1	49	80	0.6125000
NODE_36058_length_525_cov_8.788732	175	255	2	31	80	0.3875000
NODE_36058_length_525_cov_8.788732	228	308	2	74	80	0.9250000
NODE_36058_length_525_cov_8.788732	228	308	3	6	80	0.0750000
NODE_36059_length_525_cov_7.880282	242	285	0	43	43	1.0000000
NODE_36098_length_525_cov_2.417840	229	306	0	77	77	1.0000000
NODE_36230_length_524_cov_21.649412	262	342	5	10	80	0.1250000
NODE_36230_length_524_cov_21.649412	262	342	6	9	80	0.1125000
NODE_36230_length_524_cov_21.649412	262	342	7	3	80	0.0375000
NODE_36230_length_524_cov_21.649412	262	342	8	3	80	0.0375000
NODE_36230_length_524_cov_21.649412	262	342	10	4	80	0.0500000
NODE_36230_length_524_cov_21.649412	262	342	11	51	80	0.6375000
NODE_36230_length_524_cov_21.649412	315	395	4	1	80	0.0125000
NODE_36230_length_524_cov_21.649412	315	395	6	2	80	0.0250000
NODE_36230_length_524_cov_21.649412	315	395	8	26	80	0.3250000
NODE_36230_length_524_cov_21.649412	315	395	9	7	80	0.0875000
NODE_36230_length_524_cov_21.649412	315	395	10	2	80	0.0250000
NODE_36230_length_524_cov_21.649412	315	395	11	42	80	0.5250000
NODE_36231_length_524_cov_14.131765	136	201	0	65	65	1.0000000
NODE_36232_length_524_cov_10.392941	237	317	4	8	80	0.1000000
NODE_36232_length_524_cov_10.392941	237	317	6	7	80	0.0875000
NODE_36232_length_524_cov_10.392941	237	317	8	8	80	0.1000000
NODE_36232_length_524_cov_10.392941	237	317	9	42	80	0.5250000
NODE_36232_length_524_cov_10.392941	237	317	10	15	80	0.1875000
NODE_36232_length_524_cov_10.392941	290	370	3	3	80	0.0375000
NODE_36232_length_524_cov_10.392941	290	370	4	1	80	0.0125000
NODE_36232_length_524_cov_10.392941	290	370	5	13	80	0.1625000
NODE_36232_length_524_cov_10.392941	290	370	6	1	80	0.0125000
NODE_36232_length_524_cov_10.392941	290	370	7	14	80	0.1750000
NODE_36232_length_524_cov_10.392941	290	370	8	20	80	0.2500000
NODE_36232_length_524_cov_10.392941	290	370	9	13	80	0.1625000
NODE_36232_length_524_cov_10.392941	290	370	10	15	80	0.1875000
NODE_36262_length_524_cov_3.221176	195	272	0	77	77	1.0000000
NODE_36262_length_524_cov_3.221176	253	324	0	71	71	1.0000000
NODE_36264_length_524_cov_3.148235	317	397	0	41	80	0.5125000
NODE_36264_length_524_cov_3.148235	317	397	2	39	80	0.4875000
NODE_36410_length_523_cov_113.438679	0	48	0	1	48	0.0208333
NODE_36410_length_523_cov_113.438679	0	48	2	37	48	0.7708333
NODE_36410_length_523_cov_113.438679	0	48	4	10	48	0.2083333
NODE_36410_length_523_cov_113.438679	14	69	2	24	55	0.4363636
NODE_36410_length_523_cov_113.438679	14	69	4	31	55	0.5636364
NODE_36410_length_523_cov_113.438679	25	101	2	13	76	0.1710526
NODE_36410_length_523_cov_113.438679	25	101	4	49	76	0.6447368
NODE_36410_length_523_cov_113.438679	25	101	6	1	76	0.0131579
NODE_36410_length_523_cov_113.438679	25	101	7	3	76	0.0394737
NODE_36410_length_523_cov_113.438679	25	101	8	10	76	0.1315790
NODE_36410_length_523_cov_113.438679	105	181	8	20	76	0.2631579
NODE_36410_length_523_cov_113.438679	105	181	9	25	76	0.3289474
NODE_36410_length_523_cov_113.438679	105	181	11	31	76	0.4078947
NODE_36410_length_523_cov_113.438679	154	234	9	71	80	0.8875000
NODE_36410_length_523_cov_113.438679	154	234	11	9	80	0.1125000
NODE_36410_length_523_cov_113.438679	312	355	7	4	43	0.0930233
NODE_36410_length_523_cov_113.438679	312	355	8	33	43	0.7674419
NODE_36410_length_523_cov_113.438679	312	355	9	6	43	0.1395349
NODE_36412_length_523_cov_64.695755	35	115	0	80	80	1.0000000
NODE_36412_length_523_cov_64.695755	88	168	0	80	80	1.0000000
NODE_36414_length_523_cov_20.724057	235	315	2	28	80	0.3500000
NODE_36414_length_523_cov_20.724057	235	315	4	12	80	0.1500000
NODE_36414_length_523_cov_20.724057	235	315	8	40	80	0.5000000
NODE_36414_length_523_cov_20.724057	288	368	6	41	80	0.5125000
NODE_36414_length_523_cov_20.724057	288	368	8	39	80	0.4875000
NODE_36415_length_523_cov_18.500000	164	244	1	11	80	0.1375000
NODE_36415_length_523_cov_18.500000	164	244	2	67	80	0.8375000
NODE_36415_length_523_cov_18.500000	164	244	4	2	80	0.0250000
NODE_36415_length_523_cov_18.500000	217	297	1	2	80	0.0250000
NODE_36415_length_523_cov_18.500000	217	297	2	78	80	0.9750000
NODE_36416_length_523_cov_15.216981	62	142	1	49	80	0.6125000
NODE_36416_length_523_cov_15.216981	62	142	2	4	80	0.0500000
NODE_36416_length_523_cov_15.216981	62	142	4	5	80	0.0625000
NODE_36416_length_523_cov_15.216981	62	142	5	22	80	0.2750000
NODE_36416_length_523_cov_15.216981	115	195	4	5	80	0.0625000
NODE_36416_length_523_cov_15.216981	115	195	5	75	80	0.9375000
NODE_36417_length_523_cov_10.575472	157	183	1	26	26	1.0000000
NODE_36418_length_523_cov_9.962264	212	292	0	40	80	0.5000000
NODE_36418_length_523_cov_9.962264	212	292	2	35	80	0.4375000
NODE_36418_length_523_cov_9.962264	212	292	4	5	80	0.0625000
NODE_36418_length_523_cov_9.962264	265	345	2	22	80	0.2750000
NODE_36418_length_523_cov_9.962264	265	345	4	58	80	0.7250000
NODE_36427_length_523_cov_4.943396	108	188	4	71	80	0.8875000
NODE_36427_length_523_cov_4.943396	108	188	6	9	80	0.1125000
NODE_36427_length_523_cov_4.943396	161	241	2	25	80	0.3125000
NODE_36427_length_523_cov_4.943396	161	241	4	21	80	0.2625000
NODE_36427_length_523_cov_4.943396	161	241	6	34	80	0.4250000
NODE_36429_length_523_cov_4.787736	110	141	0	31	31	1.0000000
NODE_36429_length_523_cov_4.787736	131	194	0	63	63	1.0000000
NODE_36439_length_523_cov_3.792453	139	219	0	12	80	0.1500000
NODE_36439_length_523_cov_3.792453	139	219	2	57	80	0.7125000
NODE_36439_length_523_cov_3.792453	139	219	4	11	80	0.1375000
NODE_36439_length_523_cov_3.792453	192	272	2	16	80	0.2000000
NODE_36439_length_523_cov_3.792453	192	272	4	64	80	0.8000000
NODE_36481_length_523_cov_2.259434	337	372	4	35	35	1.0000000
NODE_36490_length_523_cov_2.096698	307	351	1	19	44	0.4318182
NODE_36490_length_523_cov_2.096698	307	351	2	1	44	0.0227273
NODE_36490_length_523_cov_2.096698	307	351	3	19	44	0.4318182
NODE_36490_length_523_cov_2.096698	307	351	4	5	44	0.1136364
NODE_36518_length_523_cov_1.700472	176	195	0	19	19	1.0000000
NODE_36632_length_522_cov_33.579196	55	135	2	23	80	0.2875000
NODE_36632_length_522_cov_33.579196	55	135	4	57	80	0.7125000
NODE_36632_length_522_cov_33.579196	108	188	2	31	80	0.3875000
NODE_36632_length_522_cov_33.579196	108	188	4	49	80	0.6125000
NODE_36634_length_522_cov_12.851064	266	342	1	1	76	0.0131579
NODE_36634_length_522_cov_12.851064	266	342	3	22	76	0.2894737
NODE_36634_length_522_cov_12.851064	266	342	4	53	76	0.6973684
NODE_36634_length_522_cov_12.851064	319	395	0	4	76	0.0526316
NODE_36634_length_522_cov_12.851064	319	395	1	50	76	0.6578947
NODE_36634_length_522_cov_12.851064	319	395	3	22	76	0.2894737
NODE_36637_length_522_cov_7.349882	212	283	0	71	71	1.0000000
NODE_36637_length_522_cov_7.349882	400	469	0	69	69	1.0000000
NODE_36670_length_522_cov_2.933806	178	258	0	80	80	1.0000000
NODE_36670_length_522_cov_2.933806	231	311	0	80	80	1.0000000
NODE_36676_length_522_cov_2.661939	187	241	2	54	54	1.0000000
NODE_36820_length_521_cov_9.303318	106	186	2	28	80	0.3500000
NODE_36820_length_521_cov_9.303318	106	186	3	28	80	0.3500000
NODE_36820_length_521_cov_9.303318	106	186	4	24	80	0.3000000
NODE_36820_length_521_cov_9.303318	159	239	1	13	80	0.1625000
NODE_36820_length_521_cov_9.303318	159	239	2	67	80	0.8375000
NODE_36832_length_521_cov_4.971564	218	298	0	80	80	1.0000000
NODE_36832_length_521_cov_4.971564	271	351	0	80	80	1.0000000
NODE_36845_length_521_cov_3.504739	113	191	0	78	78	1.0000000
NODE_36845_length_521_cov_3.504739	164	205	0	41	41	1.0000000
NODE_36848_length_521_cov_3.324645	158	244	0	6	86	0.0697674
NODE_36848_length_521_cov_3.324645	158	244	1	80	86	0.9302326
NODE_36848_length_521_cov_3.324645	217	280	0	42	63	0.6666667
NODE_36848_length_521_cov_3.324645	217	280	1	21	63	0.3333333
NODE_36916_length_521_cov_1.613744	165	227	0	27	62	0.4354839
NODE_36916_length_521_cov_1.613744	165	227	2	35	62	0.5645161
NODE_37036_length_520_cov_50.676960	0	75	0	75	75	1.0000000
NODE_37036_length_520_cov_50.676960	48	128	0	44	80	0.5500000
NODE_37036_length_520_cov_50.676960	48	128	2	36	80	0.4500000
NODE_37036_length_520_cov_50.676960	124	204	2	25	80	0.3125000
NODE_37036_length_520_cov_50.676960	124	204	4	28	80	0.3500000
NODE_37036_length_520_cov_50.676960	124	204	6	27	80	0.3375000
NODE_37036_length_520_cov_50.676960	177	257	2	14	80	0.1750000
NODE_37036_length_520_cov_50.676960	177	257	4	1	80	0.0125000
NODE_37036_length_520_cov_50.676960	177	257	6	65	80	0.8125000
NODE_37037_length_520_cov_43.294537	10	90	1	80	80	1.0000000
NODE_37037_length_520_cov_43.294537	10	90	1	80	80	1.0000000
NODE_37037_length_520_cov_43.294537	10	90	1	80	80	1.0000000
NODE_37037_length_520_cov_43.294537	10	90	1	80	80	1.0000000
NODE_37037_length_520_cov_43.294537	10	90	1	80	80	1.0000000
NODE_37037_length_520_cov_43.294537	10	90	1	80	80	1.0000000
NODE_37037_length_520_cov_43.294537	63	129	1	66	66	1.0000000
NODE_37037_length_520_cov_43.294537	63	142	1	79	79	1.0000000
NODE_37037_length_520_cov_43.294537	63	143	1	80	80	1.0000000
NODE_37037_length_520_cov_43.294537	63	133	1	70	70	1.0000000
NODE_37037_length_520_cov_43.294537	66	133	1	67	67	1.0000000
NODE_37037_length_520_cov_43.294537	68	143	1	75	75	1.0000000
NODE_37038_length_520_cov_29.427553	224	304	1	68	80	0.8500000
NODE_37038_length_520_cov_29.427553	224	304	2	10	80	0.1250000
NODE_37038_length_520_cov_29.427553	224	304	3	2	80	0.0250000
NODE_37038_length_520_cov_29.427553	277	357	1	15	80	0.1875000
NODE_37038_length_520_cov_29.427553	277	357	2	10	80	0.1250000
NODE_37038_length_520_cov_29.427553	277	357	3	28	80	0.3500000
NODE_37038_length_520_cov_29.427553	277	357	4	27	80	0.3375000
NODE_37038_length_520_cov_29.427553	353	433	4	9	80	0.1125000
NODE_37038_length_520_cov_29.427553	353	433	5	8	80	0.1000000
NODE_37038_length_520_cov_29.427553	353	433	6	16	80	0.2000000
NODE_37038_length_520_cov_29.427553	353	433	7	47	80	0.5875000
NODE_37038_length_520_cov_29.427553	406	486	4	10	80	0.1250000
NODE_37038_length_520_cov_29.427553	406	486	5	24	80	0.3000000
NODE_37038_length_520_cov_29.427553	406	486	6	10	80	0.1250000
NODE_37038_length_520_cov_29.427553	406	486	7	36	80	0.4500000
NODE_37039_length_520_cov_14.365796	103	183	3	17	80	0.2125000
NODE_37039_length_520_cov_14.365796	103	183	4	35	80	0.4375000
NODE_37039_length_520_cov_14.365796	103	183	5	28	80	0.3500000
NODE_37039_length_520_cov_14.365796	156	237	4	55	81	0.6790124
NODE_37039_length_520_cov_14.365796	156	237	5	26	81	0.3209876
NODE_37059_length_520_cov_4.121140	79	159	0	48	80	0.6000000
NODE_37059_length_520_cov_4.121140	79	159	2	32	80	0.4000000
NODE_37059_length_520_cov_4.121140	132	212	2	77	80	0.9625000
NODE_37059_length_520_cov_4.121140	132	212	3	3	80	0.0375000
NODE_37063_length_520_cov_3.900238	203	233	0	30	30	1.0000000
NODE_37235_length_519_cov_42.842857	8	88	1	3	80	0.0375000
NODE_37235_length_519_cov_42.842857	8	88	3	7	80	0.0875000
NODE_37235_length_519_cov_42.842857	8	88	4	5	80	0.0625000
NODE_37235_length_519_cov_42.842857	8	88	5	11	80	0.1375000
NODE_37235_length_519_cov_42.842857	8	88	7	54	80	0.6750000
NODE_37235_length_519_cov_42.842857	61	139	7	67	78	0.8589743
NODE_37235_length_519_cov_42.842857	61	139	8	11	78	0.1410256
NODE_37236_length_519_cov_19.269048	284	363	7	54	79	0.6835443
NODE_37236_length_519_cov_19.269048	284	363	8	8	79	0.1012658
NODE_37236_length_519_cov_19.269048	284	363	10	17	79	0.2151899
NODE_37236_length_519_cov_19.269048	336	416	3	3	80	0.0375000
NODE_37236_length_519_cov_19.269048	336	416	4	28	80	0.3500000
NODE_37236_length_519_cov_19.269048	336	416	6	20	80	0.2500000
NODE_37236_length_519_cov_19.269048	336	416	7	29	80	0.3625000
NODE_37237_length_519_cov_8.500000	195	267	0	58	72	0.8055556
NODE_37237_length_519_cov_8.500000	195	267	2	14	72	0.1944444
NODE_37245_length_519_cov_5.169048	282	346	0	64	64	1.0000000
NODE_37290_length_519_cov_2.783333	174	235	0	61	61	1.0000000
NODE_37349_length_519_cov_1.538095	147	213	2	25	66	0.3787879
NODE_37349_length_519_cov_1.538095	147	213	4	41	66	0.6212121
NODE_37447_length_518_cov_40.026253	385	465	6	1	80	0.0125000
NODE_37447_length_518_cov_40.026253	385	465	7	4	80	0.0500000
NODE_37447_length_518_cov_40.026253	385	465	9	19	80	0.2375000
NODE_37447_length_518_cov_40.026253	385	465	10	26	80	0.3250000
NODE_37447_length_518_cov_40.026253	385	465	11	30	80	0.3750000
NODE_37447_length_518_cov_40.026253	438	518	0	3	80	0.0375000
NODE_37447_length_518_cov_40.026253	438	518	1	13	80	0.1625000
NODE_37447_length_518_cov_40.026253	438	518	3	21	80	0.2625000
NODE_37447_length_518_cov_40.026253	438	518	4	7	80	0.0875000
NODE_37447_length_518_cov_40.026253	438	518	5	2	80	0.0250000
NODE_37447_length_518_cov_40.026253	438	518	6	8	80	0.1000000
NODE_37447_length_518_cov_40.026253	438	518	7	4	80	0.0500000
NODE_37447_length_518_cov_40.026253	438	518	9	17	80	0.2125000
NODE_37447_length_518_cov_40.026253	438	518	10	5	80	0.0625000
NODE_37449_length_518_cov_12.083532	144	224	0	13	80	0.1625000
NODE_37449_length_518_cov_12.083532	144	224	2	67	80	0.8375000
NODE_37449_length_518_cov_12.083532	197	277	2	80	80	1.0000000
NODE_37449_length_518_cov_12.083532	407	481	0	74	74	1.0000000
NODE_37449_length_518_cov_12.083532	454	518	0	64	64	1.0000000
NODE_37450_length_518_cov_11.467780	171	200	0	17	29	0.5862069
NODE_37450_length_518_cov_11.467780	171	200	2	12	29	0.4137931
NODE_37450_length_518_cov_11.467780	253	320	0	25	67	0.3731343
NODE_37450_length_518_cov_11.467780	253	320	2	42	67	0.6268657
NODE_37450_length_518_cov_11.467780	253	282	2	29	29	1.0000000
NODE_37454_length_518_cov_7.441527	188	273	1	78	85	0.9176471
NODE_37454_length_518_cov_7.441527	188	273	2	7	85	0.0823529
NODE_37461_length_518_cov_5.563246	315	366	0	51	51	1.0000000
NODE_37461_length_518_cov_5.563246	339	383	0	44	44	1.0000000
NODE_37465_length_518_cov_4.732697	214	276	1	5	62	0.0806452
NODE_37465_length_518_cov_4.732697	214	276	2	57	62	0.9193549
NODE_37465_length_518_cov_4.732697	350	430	0	80	80	1.0000000
NODE_37479_length_518_cov_3.503580	291	333	0	42	42	1.0000000
NODE_37479_length_518_cov_3.503580	306	363	0	57	57	1.0000000
NODE_37483_length_518_cov_3.136038	269	338	1	66	69	0.9565217
NODE_37483_length_518_cov_3.136038	269	338	2	3	69	0.0434783
NODE_37483_length_518_cov_3.136038	269	348	1	76	79	0.9620253
NODE_37483_length_518_cov_3.136038	269	348	2	3	79	0.0379747
NODE_37483_length_518_cov_3.136038	269	349	1	77	80	0.9625000
NODE_37483_length_518_cov_3.136038	269	349	2	3	80	0.0375000
NODE_37483_length_518_cov_3.136038	322	402	1	68	80	0.8500000
NODE_37483_length_518_cov_3.136038	322	402	2	12	80	0.1500000
NODE_37483_length_518_cov_3.136038	322	364	1	42	42	1.0000000
NODE_37483_length_518_cov_3.136038	322	368	1	46	46	1.0000000
NODE_37483_length_518_cov_3.136038	331	366	1	35	35	1.0000000
NODE_37637_length_517_cov_55.267943	177	257	8	3	80	0.0375000
NODE_37637_length_517_cov_55.267943	177	257	9	7	80	0.0875000
NODE_37637_length_517_cov_55.267943	177	257	11	28	80	0.3500000
NODE_37637_length_517_cov_55.267943	177	257	13	18	80	0.2250000
NODE_37637_length_517_cov_55.267943	177	257	15	16	80	0.2000000
NODE_37637_length_517_cov_55.267943	177	257	16	8	80	0.1000000
NODE_37637_length_517_cov_55.267943	230	310	9	15	80	0.1875000
NODE_37637_length_517_cov_55.267943	230	310	11	2	80	0.0250000
NODE_37637_length_517_cov_55.267943	230	310	13	3	80	0.0375000
NODE_37637_length_517_cov_55.267943	230	310	14	14	80	0.1750000
NODE_37637_length_517_cov_55.267943	230	310	15	38	80	0.4750000
NODE_37637_length_517_cov_55.267943	230	310	16	8	80	0.1000000
NODE_37639_length_517_cov_30.863636	0	72	3	12	72	0.1666667
NODE_37639_length_517_cov_30.863636	0	72	4	53	72	0.7361111
NODE_37639_length_517_cov_30.863636	0	72	5	7	72	0.0972222
NODE_37639_length_517_cov_30.863636	0	72	3	12	72	0.1666667
NODE_37639_length_517_cov_30.863636	0	72	4	53	72	0.7361111
NODE_37639_length_517_cov_30.863636	0	72	5	7	72	0.0972222
NODE_37639_length_517_cov_30.863636	45	125	3	5	80	0.0625000
NODE_37639_length_517_cov_30.863636	45	125	4	20	80	0.2500000
NODE_37639_length_517_cov_30.863636	45	125	5	55	80	0.6875000
NODE_37639_length_517_cov_30.863636	45	99	4	20	54	0.3703704
NODE_37639_length_517_cov_30.863636	45	99	5	34	54	0.6296296
NODE_37641_length_517_cov_12.258373	305	385	5	1	80	0.0125000
NODE_37641_length_517_cov_12.258373	305	385	6	59	80	0.7375000
NODE_37641_length_517_cov_12.258373	305	385	7	12	80	0.1500000
NODE_37641_length_517_cov_12.258373	305	385	8	8	80	0.1000000
NODE_37641_length_517_cov_12.258373	358	438	3	33	80	0.4125000
NODE_37641_length_517_cov_12.258373	358	438	5	11	80	0.1375000
NODE_37641_length_517_cov_12.258373	358	438	6	14	80	0.1750000
NODE_37641_length_517_cov_12.258373	358	438	7	12	80	0.1500000
NODE_37641_length_517_cov_12.258373	358	438	8	10	80	0.1250000
NODE_37643_length_517_cov_7.131579	100	152	2	52	52	1.0000000
NODE_37662_length_517_cov_4.492823	140	220	0	51	80	0.6375000
NODE_37662_length_517_cov_4.492823	140	220	2	3	80	0.0375000
NODE_37662_length_517_cov_4.492823	140	220	3	26	80	0.3250000
NODE_37662_length_517_cov_4.492823	193	273	2	1	80	0.0125000
NODE_37662_length_517_cov_4.492823	193	273	3	78	80	0.9750000
NODE_37662_length_517_cov_4.492823	193	273	4	1	80	0.0125000
NODE_37697_length_517_cov_2.437799	331	388	0	6	57	0.1052632
NODE_37697_length_517_cov_2.437799	331	388	1	51	57	0.8947368
NODE_37850_length_516_cov_17.570743	147	227	0	10	80	0.1250000
NODE_37850_length_516_cov_17.570743	147	227	1	34	80	0.4250000
NODE_37850_length_516_cov_17.570743	147	227	2	36	80	0.4500000
NODE_37850_length_516_cov_17.570743	200	280	2	80	80	1.0000000
NODE_37861_length_516_cov_5.268585	402	448	0	46	46	1.0000000
NODE_37862_length_516_cov_5.067146	114	194	0	80	80	1.0000000
NODE_37862_length_516_cov_5.067146	167	247	0	80	80	1.0000000
NODE_37864_length_516_cov_4.788969	156	236	0	80	80	1.0000000
NODE_37864_length_516_cov_4.788969	209	277	0	68	68	1.0000000
NODE_37881_length_516_cov_3.167866	48	93	2	1	45	0.0222222
NODE_37881_length_516_cov_3.167866	48	93	15	3	45	0.0666667
NODE_37881_length_516_cov_3.167866	48	93	16	13	45	0.2888889
NODE_37881_length_516_cov_3.167866	48	93	18	7	45	0.1555556
NODE_37881_length_516_cov_3.167866	48	93	19	21	45	0.4666667
NODE_37881_length_516_cov_3.167866	103	177	0	21	74	0.2837838
NODE_37881_length_516_cov_3.167866	103	177	1	1	74	0.0135135
NODE_37881_length_516_cov_3.167866	103	177	15	2	74	0.0270270
NODE_37881_length_516_cov_3.167866	103	177	16	2	74	0.0270270
NODE_37881_length_516_cov_3.167866	103	177	17	14	74	0.1891892
NODE_37881_length_516_cov_3.167866	103	177	18	2	74	0.0270270
NODE_37881_length_516_cov_3.167866	103	177	19	32	74	0.4324324
NODE_38044_length_515_cov_69.442308	177	257	10	6	80	0.0750000
NODE_38044_length_515_cov_69.442308	177	257	11	9	80	0.1125000
NODE_38044_length_515_cov_69.442308	177	257	12	48	80	0.6000000
NODE_38044_length_515_cov_69.442308	177	257	13	6	80	0.0750000
NODE_38044_length_515_cov_69.442308	177	257	14	11	80	0.1375000
NODE_38044_length_515_cov_69.442308	177	257	10	6	80	0.0750000
NODE_38044_length_515_cov_69.442308	177	257	11	9	80	0.1125000
NODE_38044_length_515_cov_69.442308	177	257	12	48	80	0.6000000
NODE_38044_length_515_cov_69.442308	177	257	13	6	80	0.0750000
NODE_38044_length_515_cov_69.442308	177	257	14	11	80	0.1375000
NODE_38044_length_515_cov_69.442308	177	257	10	6	80	0.0750000
NODE_38044_length_515_cov_69.442308	177	257	11	9	80	0.1125000
NODE_38044_length_515_cov_69.442308	177	257	12	48	80	0.6000000
NODE_38044_length_515_cov_69.442308	177	257	13	6	80	0.0750000
NODE_38044_length_515_cov_69.442308	177	257	14	11	80	0.1375000
NODE_38044_length_515_cov_69.442308	230	291	5	1	61	0.0163934
NODE_38044_length_515_cov_69.442308	230	291	7	9	61	0.1475410
NODE_38044_length_515_cov_69.442308	230	291	8	18	61	0.2950820
NODE_38044_length_515_cov_69.442308	230	291	10	12	61	0.1967213
NODE_38044_length_515_cov_69.442308	230	291	11	9	61	0.1475410
NODE_38044_length_515_cov_69.442308	230	291	12	12	61	0.1967213
NODE_38044_length_515_cov_69.442308	230	308	3	10	78	0.1282051
NODE_38044_length_515_cov_69.442308	230	308	4	6	78	0.0769231
NODE_38044_length_515_cov_69.442308	230	308	5	2	78	0.0256410
NODE_38044_length_515_cov_69.442308	230	308	7	9	78	0.1153846
NODE_38044_length_515_cov_69.442308	230	308	8	18	78	0.2307692
NODE_38044_length_515_cov_69.442308	230	308	10	12	78	0.1538462
NODE_38044_length_515_cov_69.442308	230	308	11	9	78	0.1153846
NODE_38044_length_515_cov_69.442308	230	308	12	12	78	0.1538462
NODE_38044_length_515_cov_69.442308	235	308	3	10	73	0.1369863
NODE_38044_length_515_cov_69.442308	235	308	4	6	73	0.0821918
NODE_38044_length_515_cov_69.442308	235	308	5	2	73	0.0273973
NODE_38044_length_515_cov_69.442308	235	308	7	9	73	0.1232877
NODE_38044_length_515_cov_69.442308	235	308	8	18	73	0.2465753
NODE_38044_length_515_cov_69.442308	235	308	10	12	73	0.1643836
NODE_38044_length_515_cov_69.442308	235	308	11	9	73	0.1232877
NODE_38044_length_515_cov_69.442308	235	308	12	7	73	0.0958904
NODE_38045_length_515_cov_13.271635	168	248	0	17	80	0.2125000
NODE_38045_length_515_cov_13.271635	168	248	1	2	80	0.0250000
NODE_38045_length_515_cov_13.271635	168	248	2	61	80	0.7625000
NODE_38045_length_515_cov_13.271635	221	301	0	70	80	0.8750000
NODE_38045_length_515_cov_13.271635	221	301	1	2	80	0.0250000
NODE_38045_length_515_cov_13.271635	221	301	2	8	80	0.1000000
NODE_38048_length_515_cov_8.314904	213	290	0	77	77	1.0000000
NODE_38054_length_515_cov_5.487981	317	402	0	19	85	0.2235294
NODE_38054_length_515_cov_5.487981	317	402	2	66	85	0.7764706
NODE_38242_length_514_cov_26.910843	170	250	6	4	80	0.0500000
NODE_38242_length_514_cov_26.910843	170	250	7	16	80	0.2000000
NODE_38242_length_514_cov_26.910843	170	250	9	18	80	0.2250000
NODE_38242_length_514_cov_26.910843	170	250	10	42	80	0.5250000
NODE_38242_length_514_cov_26.910843	223	303	0	11	80	0.1375000
NODE_38242_length_514_cov_26.910843	223	303	1	20	80	0.2500000
NODE_38242_length_514_cov_26.910843	223	303	2	5	80	0.0625000
NODE_38242_length_514_cov_26.910843	223	303	3	7	80	0.0875000
NODE_38242_length_514_cov_26.910843	223	303	4	8	80	0.1000000
NODE_38242_length_514_cov_26.910843	223	303	6	6	80	0.0750000
NODE_38242_length_514_cov_26.910843	223	303	7	16	80	0.2000000
NODE_38242_length_514_cov_26.910843	223	303	9	7	80	0.0875000
NODE_38243_length_514_cov_12.775904	85	149	0	64	64	1.0000000
NODE_38243_length_514_cov_12.775904	123	202	0	79	79	1.0000000
NODE_38244_length_514_cov_11.156627	124	204	1	9	80	0.1125000
NODE_38244_length_514_cov_11.156627	124	204	2	71	80	0.8875000
NODE_38244_length_514_cov_11.156627	177	257	1	9	80	0.1125000
NODE_38244_length_514_cov_11.156627	177	257	2	71	80	0.8875000
NODE_38253_length_514_cov_5.802410	165	217	3	18	52	0.3461539
NODE_38253_length_514_cov_5.802410	165	217	4	28	52	0.5384616
NODE_38253_length_514_cov_5.802410	165	217	5	6	52	0.1153846
NODE_38253_length_514_cov_5.802410	190	270	2	11	80	0.1375000
NODE_38253_length_514_cov_5.802410	190	270	3	1	80	0.0125000
NODE_38253_length_514_cov_5.802410	190	270	4	68	80	0.8500000
NODE_38254_length_514_cov_5.554217	192	272	0	4	80	0.0500000
NODE_38254_length_514_cov_5.554217	192	272	1	4	80	0.0500000
NODE_38254_length_514_cov_5.554217	192	272	2	72	80	0.9000000
NODE_38254_length_514_cov_5.554217	294	340	2	46	46	1.0000000
NODE_38257_length_514_cov_5.322892	230	260	2	30	30	1.0000000
NODE_38262_length_514_cov_4.337349	220	300	0	80	80	1.0000000
NODE_38286_length_514_cov_3.012048	264	328	0	64	64	1.0000000
NODE_38432_length_513_cov_14.613527	118	198	8	53	80	0.6625000
NODE_38432_length_513_cov_14.613527	118	198	9	27	80	0.3375000
NODE_38432_length_513_cov_14.613527	171	251	5	4	80	0.0500000
NODE_38432_length_513_cov_14.613527	171	251	6	1	80	0.0125000
NODE_38432_length_513_cov_14.613527	171	251	7	12	80	0.1500000
NODE_38432_length_513_cov_14.613527	171	251	8	18	80	0.2250000
NODE_38432_length_513_cov_14.613527	171	251	9	45	80	0.5625000
NODE_38433_length_513_cov_9.898551	253	333	0	56	80	0.7000000
NODE_38433_length_513_cov_9.898551	253	333	1	24	80	0.3000000
NODE_38433_length_513_cov_9.898551	306	386	0	3	80	0.0375000
NODE_38433_length_513_cov_9.898551	306	386	1	34	80	0.4250000
NODE_38433_length_513_cov_9.898551	306	386	2	43	80	0.5375000
NODE_38434_length_513_cov_9.164251	185	265	6	39	80	0.4875000
NODE_38434_length_513_cov_9.164251	185	265	7	3	80	0.0375000
NODE_38434_length_513_cov_9.164251	185	265	9	13	80	0.1625000
NODE_38434_length_513_cov_9.164251	185	265	11	25	80	0.3125000
NODE_38434_length_513_cov_9.164251	238	318	7	5	80	0.0625000
NODE_38434_length_513_cov_9.164251	238	318	9	58	80	0.7250000
NODE_38434_length_513_cov_9.164251	238	318	11	11	80	0.1375000
NODE_38434_length_513_cov_9.164251	238	318	13	1	80	0.0125000
NODE_38434_length_513_cov_9.164251	238	318	14	5	80	0.0625000
NODE_38441_length_513_cov_6.123188	284	364	0	80	80	1.0000000
NODE_38441_length_513_cov_6.123188	337	417	0	80	80	1.0000000
NODE_38460_length_513_cov_3.456522	283	350	0	2	67	0.0298507
NODE_38460_length_513_cov_3.456522	283	350	2	65	67	0.9701493
NODE_38460_length_513_cov_3.456522	336	398	0	3	62	0.0483871
NODE_38460_length_513_cov_3.456522	336	398	2	59	62	0.9516129
NODE_38482_length_513_cov_2.309179	134	174	0	40	40	1.0000000
NODE_38482_length_513_cov_2.309179	170	223	0	53	53	1.0000000
NODE_38482_length_513_cov_2.309179	238	285	0	47	47	1.0000000
NODE_38515_length_513_cov_1.671498	427	476	0	49	49	1.0000000
NODE_38646_length_512_cov_45.070218	34	114	8	3	80	0.0375000
NODE_38646_length_512_cov_45.070218	34	114	10	6	80	0.0750000
NODE_38646_length_512_cov_45.070218	34	114	11	5	80	0.0625000
NODE_38646_length_512_cov_45.070218	34	114	12	31	80	0.3875000
NODE_38646_length_512_cov_45.070218	34	114	14	13	80	0.1625000
NODE_38646_length_512_cov_45.070218	34	114	15	13	80	0.1625000
NODE_38646_length_512_cov_45.070218	34	114	16	7	80	0.0875000
NODE_38646_length_512_cov_45.070218	34	114	17	2	80	0.0250000
NODE_38646_length_512_cov_45.070218	87	167	12	1	80	0.0125000
NODE_38646_length_512_cov_45.070218	87	167	14	14	80	0.1750000
NODE_38646_length_512_cov_45.070218	87	167	15	13	80	0.1625000
NODE_38646_length_512_cov_45.070218	87	167	16	8	80	0.1000000
NODE_38646_length_512_cov_45.070218	87	167	17	14	80	0.1750000
NODE_38646_length_512_cov_45.070218	87	167	18	8	80	0.1000000
NODE_38646_length_512_cov_45.070218	87	167	19	22	80	0.2750000
NODE_38647_length_512_cov_39.639225	323	404	0	81	81	1.0000000
NODE_38647_length_512_cov_39.639225	377	457	0	80	80	1.0000000
NODE_38648_length_512_cov_8.581114	192	256	4	7	64	0.1093750
NODE_38648_length_512_cov_8.581114	192	256	5	12	64	0.1875000
NODE_38648_length_512_cov_8.581114	192	256	6	45	64	0.7031250
NODE_38661_length_512_cov_4.869249	327	407	3	35	80	0.4375000
NODE_38661_length_512_cov_4.869249	327	407	4	45	80	0.5625000
NODE_38661_length_512_cov_4.869249	380	460	2	12	80	0.1500000
NODE_38661_length_512_cov_4.869249	380	460	3	68	80	0.8500000
NODE_38668_length_512_cov_4.157385	161	204	0	43	43	1.0000000
NODE_38668_length_512_cov_4.157385	178	257	0	79	79	1.0000000
NODE_38677_length_512_cov_3.435835	138	218	3	5	80	0.0625000
NODE_38677_length_512_cov_3.435835	138	218	4	28	80	0.3500000
NODE_38677_length_512_cov_3.435835	138	218	5	47	80	0.5875000
NODE_38677_length_512_cov_3.435835	191	271	2	11	80	0.1375000
NODE_38677_length_512_cov_3.435835	191	271	3	26	80	0.3250000
NODE_38677_length_512_cov_3.435835	191	271	4	9	80	0.1125000
NODE_38677_length_512_cov_3.435835	191	271	5	34	80	0.4250000
NODE_38693_length_512_cov_2.888620	320	400	0	51	80	0.6375000
NODE_38693_length_512_cov_2.888620	320	400	1	2	80	0.0250000
NODE_38693_length_512_cov_2.888620	320	400	2	17	80	0.2125000
NODE_38693_length_512_cov_2.888620	320	400	3	10	80	0.1250000
NODE_38768_length_512_cov_1.341404	198	269	0	20	71	0.2816902
NODE_38768_length_512_cov_1.341404	198	269	1	1	71	0.0140845
NODE_38768_length_512_cov_1.341404	198	269	2	9	71	0.1267606
NODE_38768_length_512_cov_1.341404	198	269	3	10	71	0.1408451
NODE_38768_length_512_cov_1.341404	198	269	4	15	71	0.2112676
NODE_38768_length_512_cov_1.341404	198	269	5	6	71	0.0845070
NODE_38768_length_512_cov_1.341404	198	269	6	10	71	0.1408451
NODE_38866_length_511_cov_9.796117	251	331	0	80	80	1.0000000
NODE_38866_length_511_cov_9.796117	304	370	0	66	66	1.0000000
NODE_38869_length_511_cov_8.873786	239	319	0	15	80	0.1875000
NODE_38869_length_511_cov_8.873786	239	319	1	21	80	0.2625000
NODE_38869_length_511_cov_8.873786	239	319	2	44	80	0.5500000
NODE_38869_length_511_cov_8.873786	292	356	2	64	64	1.0000000
NODE_38870_length_511_cov_8.434466	232	312	0	80	80	1.0000000
NODE_38870_length_511_cov_8.434466	285	366	0	81	81	1.0000000
NODE_38872_length_511_cov_7.519417	157	237	1	27	80	0.3375000
NODE_38872_length_511_cov_7.519417	157	237	2	53	80	0.6625000
NODE_38872_length_511_cov_7.519417	210	290	1	70	80	0.8750000
NODE_38872_length_511_cov_7.519417	210	290	2	10	80	0.1250000
NODE_38877_length_511_cov_5.762136	102	179	0	77	77	1.0000000
NODE_38877_length_511_cov_5.762136	155	230	0	75	75	1.0000000
NODE_38878_length_511_cov_5.655340	133	213	1	42	80	0.5250000
NODE_38878_length_511_cov_5.655340	133	213	2	38	80	0.4750000
NODE_38878_length_511_cov_5.655340	186	266	1	25	80	0.3125000
NODE_38878_length_511_cov_5.655340	186	266	2	55	80	0.6875000
NODE_38911_length_511_cov_2.978155	219	255	0	36	36	1.0000000
NODE_39013_length_511_cov_1.225728	99	127	0	19	28	0.6785714
NODE_39013_length_511_cov_1.225728	99	127	1	9	28	0.3214286
NODE_39092_length_511_cov_0.708738	98	146	0	48	48	1.0000000
NODE_39105_length_510_cov_18.206813	334	414	7	8	80	0.1000000
NODE_39105_length_510_cov_18.206813	334	414	8	43	80	0.5375000
NODE_39105_length_510_cov_18.206813	334	414	12	5	80	0.0625000
NODE_39105_length_510_cov_18.206813	334	414	13	14	80	0.1750000
NODE_39105_length_510_cov_18.206813	334	414	14	10	80	0.1250000
NODE_39105_length_510_cov_18.206813	387	467	7	10	80	0.1250000
NODE_39105_length_510_cov_18.206813	387	467	9	1	80	0.0125000
NODE_39105_length_510_cov_18.206813	387	467	11	27	80	0.3375000
NODE_39105_length_510_cov_18.206813	387	467	12	3	80	0.0375000
NODE_39105_length_510_cov_18.206813	387	467	13	29	80	0.3625000
NODE_39105_length_510_cov_18.206813	387	467	14	10	80	0.1250000
NODE_39110_length_510_cov_8.017032	211	291	3	34	80	0.4250000
NODE_39110_length_510_cov_8.017032	211	291	4	46	80	0.5750000
NODE_39110_length_510_cov_8.017032	264	344	1	30	80	0.3750000
NODE_39110_length_510_cov_8.017032	264	344	2	21	80	0.2625000
NODE_39110_length_510_cov_8.017032	264	344	3	29	80	0.3625000
NODE_39110_length_510_cov_8.017032	391	413	0	22	22	1.0000000
NODE_39112_length_510_cov_6.476886	208	251	1	43	43	1.0000000
NODE_39115_length_510_cov_6.133820	149	200	1	51	51	1.0000000
NODE_39122_length_510_cov_4.313869	32	106	0	74	74	1.0000000
NODE_39131_length_510_cov_3.435523	149	213	0	64	64	1.0000000
NODE_39131_length_510_cov_3.435523	191	249	0	58	58	1.0000000
NODE_39293_length_509_cov_13.378049	160	240	0	80	80	1.0000000
NODE_39293_length_509_cov_13.378049	213	294	0	81	81	1.0000000
NODE_39302_length_509_cov_5.190244	203	283	2	3	80	0.0375000
NODE_39302_length_509_cov_5.190244	203	283	4	77	80	0.9625000
NODE_39302_length_509_cov_5.190244	256	336	0	52	80	0.6500000
NODE_39302_length_509_cov_5.190244	256	336	2	4	80	0.0500000
NODE_39302_length_509_cov_5.190244	256	336	4	24	80	0.3000000
NODE_39309_length_509_cov_4.478049	221	301	0	80	80	1.0000000
NODE_39309_length_509_cov_4.478049	274	354	0	80	80	1.0000000
NODE_39311_length_509_cov_4.451220	203	283	0	44	80	0.5500000
NODE_39311_length_509_cov_4.451220	203	283	1	33	80	0.4125000
NODE_39311_length_509_cov_4.451220	203	283	2	3	80	0.0375000
NODE_39322_length_509_cov_3.443902	133	185	0	52	52	1.0000000
NODE_39326_length_509_cov_3.207317	367	445	0	78	78	1.0000000
NODE_39337_length_509_cov_2.853659	194	274	0	80	80	1.0000000
NODE_39480_length_509_cov_0.809756	229	272	0	43	43	1.0000000
NODE_39506_length_508_cov_22.009780	440	508	2	39	68	0.5735294
NODE_39506_length_508_cov_22.009780	440	508	4	29	68	0.4264706
NODE_39512_length_508_cov_5.158924	248	284	2	36	36	1.0000000
NODE_39539_length_508_cov_2.662592	165	244	0	79	79	1.0000000
NODE_39698_length_507_cov_32.286765	0	61	3	3	61	0.0491803
NODE_39698_length_507_cov_32.286765	0	61	4	2	61	0.0327869
NODE_39698_length_507_cov_32.286765	0	61	6	2	61	0.0327869
NODE_39698_length_507_cov_32.286765	0	61	7	5	61	0.0819672
NODE_39698_length_507_cov_32.286765	0	61	10	4	61	0.0655738
NODE_39698_length_507_cov_32.286765	0	61	11	13	61	0.2131148
NODE_39698_length_507_cov_32.286765	0	61	13	2	61	0.0327869
NODE_39698_length_507_cov_32.286765	0	61	14	3	61	0.0491803
NODE_39698_length_507_cov_32.286765	0	61	15	6	61	0.0983607
NODE_39698_length_507_cov_32.286765	0	61	16	3	61	0.0491803
NODE_39698_length_507_cov_32.286765	0	61	17	11	61	0.1803279
NODE_39698_length_507_cov_32.286765	0	61	21	1	61	0.0163934
NODE_39698_length_507_cov_32.286765	0	61	22	6	61	0.0983607
NODE_39698_length_507_cov_32.286765	53	97	17	1	44	0.0227273
NODE_39698_length_507_cov_32.286765	53	97	21	1	44	0.0227273
NODE_39698_length_507_cov_32.286765	53	97	22	6	44	0.1363636
NODE_39698_length_507_cov_32.286765	53	97	24	1	44	0.0227273
NODE_39698_length_507_cov_32.286765	53	97	25	9	44	0.2045455
NODE_39698_length_507_cov_32.286765	53	97	27	1	44	0.0227273
NODE_39698_length_507_cov_32.286765	53	97	29	3	44	0.0681818
NODE_39698_length_507_cov_32.286765	53	97	30	8	44	0.1818182
NODE_39698_length_507_cov_32.286765	53	97	31	4	44	0.0909091
NODE_39698_length_507_cov_32.286765	53	97	32	6	44	0.1363636
NODE_39698_length_507_cov_32.286765	53	97	34	4	44	0.0909091
NODE_39701_length_507_cov_7.553922	203	283	1	18	80	0.2250000
NODE_39701_length_507_cov_7.553922	203	283	2	62	80	0.7750000
NODE_39709_length_507_cov_5.154412	296	362	0	66	66	1.0000000
NODE_39714_length_507_cov_4.710784	248	328	0	8	80	0.1000000
NODE_39714_length_507_cov_4.710784	248	328	2	72	80	0.9000000
NODE_39714_length_507_cov_4.710784	308	379	0	59	71	0.8309859
NODE_39714_length_507_cov_4.710784	308	379	2	12	71	0.1690141
NODE_39728_length_507_cov_3.649510	80	109	0	29	29	1.0000000
NODE_39728_length_507_cov_3.649510	184	266	0	82	82	1.0000000
NODE_39728_length_507_cov_3.649510	189	273	0	84	84	1.0000000
NODE_39728_length_507_cov_3.649510	207	266	0	59	59	1.0000000
NODE_39747_length_507_cov_2.754902	345	425	0	80	80	1.0000000
NODE_39747_length_507_cov_2.754902	428	463	0	35	35	1.0000000
NODE_39918_length_506_cov_31.987715	71	156	2	85	85	1.0000000
NODE_39918_length_506_cov_31.987715	71	156	2	85	85	1.0000000
NODE_39918_length_506_cov_31.987715	71	156	2	85	85	1.0000000
NODE_39918_length_506_cov_31.987715	129	209	0	9	80	0.1125000
NODE_39918_length_506_cov_31.987715	129	209	1	21	80	0.2625000
NODE_39918_length_506_cov_31.987715	129	209	2	50	80	0.6250000
NODE_39919_length_506_cov_15.877150	210	279	1	55	69	0.7971014
NODE_39919_length_506_cov_15.877150	210	279	2	14	69	0.2028985
NODE_39920_length_506_cov_15.461916	334	414	6	70	80	0.8750000
NODE_39920_length_506_cov_15.461916	334	414	7	10	80	0.1250000
NODE_39920_length_506_cov_15.461916	387	467	2	9	80	0.1125000
NODE_39920_length_506_cov_15.461916	387	467	3	3	80	0.0375000
NODE_39920_length_506_cov_15.461916	387	467	4	33	80	0.4125000
NODE_39920_length_506_cov_15.461916	387	467	5	8	80	0.1000000
NODE_39920_length_506_cov_15.461916	387	467	6	27	80	0.3375000
NODE_39921_length_506_cov_9.749386	197	276	0	79	79	1.0000000
NODE_39921_length_506_cov_9.749386	249	329	0	80	80	1.0000000
NODE_39947_length_506_cov_3.122850	218	298	0	9	80	0.1125000
NODE_39947_length_506_cov_3.122850	218	298	2	71	80	0.8875000
NODE_39947_length_506_cov_3.122850	271	351	0	62	80	0.7750000
NODE_39947_length_506_cov_3.122850	271	351	2	18	80	0.2250000
NODE_39951_length_506_cov_2.894349	190	270	0	80	80	1.0000000
NODE_40133_length_505_cov_35.541872	373	453	0	6	80	0.0750000
NODE_40133_length_505_cov_35.541872	373	453	1	74	80	0.9250000
NODE_40135_length_505_cov_10.339901	30	110	0	30	80	0.3750000
NODE_40135_length_505_cov_10.339901	30	110	1	17	80	0.2125000
NODE_40135_length_505_cov_10.339901	30	110	2	33	80	0.4125000
NODE_40135_length_505_cov_10.339901	83	163	2	80	80	1.0000000
NODE_40158_length_505_cov_3.554187	225	305	0	71	80	0.8875000
NODE_40158_length_505_cov_3.554187	225	305	2	9	80	0.1125000
NODE_40158_length_505_cov_3.554187	278	358	0	18	80	0.2250000
NODE_40158_length_505_cov_3.554187	278	358	2	62	80	0.7750000
NODE_40160_length_505_cov_3.403941	207	287	0	64	80	0.8000000
NODE_40160_length_505_cov_3.403941	207	287	1	16	80	0.2000000
NODE_40175_length_505_cov_2.975369	162	227	1	65	65	1.0000000
NODE_40222_length_505_cov_1.864532	55	126	0	33	71	0.4647887
NODE_40222_length_505_cov_1.864532	55	126	2	38	71	0.5352113
NODE_40368_length_504_cov_115.891358	122	202	48	5	80	0.0625000
NODE_40368_length_504_cov_115.891358	122	202	49	1	80	0.0125000
NODE_40368_length_504_cov_115.891358	122	202	51	1	80	0.0125000
NODE_40368_length_504_cov_115.891358	122	202	53	1	80	0.0125000
NODE_40368_length_504_cov_115.891358	122	202	54	1	80	0.0125000
NODE_40368_length_504_cov_115.891358	122	202	55	2	80	0.0250000
NODE_40368_length_504_cov_115.891358	122	202	57	4	80	0.0500000
NODE_40368_length_504_cov_115.891358	122	202	59	6	80	0.0750000
NODE_40368_length_504_cov_115.891358	122	202	61	1	80	0.0125000
NODE_40368_length_504_cov_115.891358	122	202	62	1	80	0.0125000
NODE_40368_length_504_cov_115.891358	122	202	63	1	80	0.0125000
NODE_40368_length_504_cov_115.891358	122	202	64	3	80	0.0375000
NODE_40368_length_504_cov_115.891358	122	202	66	7	80	0.0875000
NODE_40368_length_504_cov_115.891358	122	202	67	12	80	0.1500000
NODE_40368_length_504_cov_115.891358	122	202	73	2	80	0.0250000
NODE_40368_length_504_cov_115.891358	122	202	74	1	80	0.0125000
NODE_40368_length_504_cov_115.891358	122	202	76	1	80	0.0125000
NODE_40368_length_504_cov_115.891358	122	202	77	1	80	0.0125000
NODE_40368_length_504_cov_115.891358	122	202	78	7	80	0.0875000
NODE_40368_length_504_cov_115.891358	122	202	79	1	80	0.0125000
NODE_40368_length_504_cov_115.891358	122	202	80	2	80	0.0250000
NODE_40368_length_504_cov_115.891358	122	202	81	3	80	0.0375000
NODE_40368_length_504_cov_115.891358	122	202	82	7	80	0.0875000
NODE_40368_length_504_cov_115.891358	122	202	84	4	80	0.0500000
NODE_40368_length_504_cov_115.891358	122	202	85	4	80	0.0500000
NODE_40368_length_504_cov_115.891358	122	202	86	1	80	0.0125000
NODE_40368_length_504_cov_115.891358	175	255	53	5	80	0.0625000
NODE_40368_length_504_cov_115.891358	175	255	54	9	80	0.1125000
NODE_40368_length_504_cov_115.891358	175	255	56	6	80	0.0750000
NODE_40368_length_504_cov_115.891358	175	255	57	4	80	0.0500000
NODE_40368_length_504_cov_115.891358	175	255	59	1	80	0.0125000
NODE_40368_length_504_cov_115.891358	175	255	61	3	80	0.0375000
NODE_40368_length_504_cov_115.891358	175	255	66	1	80	0.0125000
NODE_40368_length_504_cov_115.891358	175	255	67	1	80	0.0125000
NODE_40368_length_504_cov_115.891358	175	255	68	1	80	0.0125000
NODE_40368_length_504_cov_115.891358	175	255	71	6	80	0.0750000
NODE_40368_length_504_cov_115.891358	175	255	72	1	80	0.0125000
NODE_40368_length_504_cov_115.891358	175	255	73	5	80	0.0625000
NODE_40368_length_504_cov_115.891358	175	255	74	7	80	0.0875000
NODE_40368_length_504_cov_115.891358	175	255	75	2	80	0.0250000
NODE_40368_length_504_cov_115.891358	175	255	77	1	80	0.0125000
NODE_40368_length_504_cov_115.891358	175	255	78	6	80	0.0750000
NODE_40368_length_504_cov_115.891358	175	255	79	1	80	0.0125000
NODE_40368_length_504_cov_115.891358	175	255	80	1	80	0.0125000
NODE_40368_length_504_cov_115.891358	175	255	81	3	80	0.0375000
NODE_40368_length_504_cov_115.891358	175	255	82	7	80	0.0875000
NODE_40368_length_504_cov_115.891358	175	255	84	4	80	0.0500000
NODE_40368_length_504_cov_115.891358	175	255	85	4	80	0.0500000
NODE_40368_length_504_cov_115.891358	175	255	86	1	80	0.0125000
NODE_40369_length_504_cov_33.360494	28	108	0	23	80	0.2875000
NODE_40369_length_504_cov_33.360494	28	108	2	31	80	0.3875000
NODE_40369_length_504_cov_33.360494	28	108	4	26	80	0.3250000
NODE_40369_length_504_cov_33.360494	81	161	2	59	80	0.7375000
NODE_40369_length_504_cov_33.360494	81	161	4	21	80	0.2625000
NODE_40370_length_504_cov_15.669136	176	256	0	39	80	0.4875000
NODE_40370_length_504_cov_15.669136	176	256	2	1	80	0.0125000
NODE_40370_length_504_cov_15.669136	176	256	3	40	80	0.5000000
NODE_40370_length_504_cov_15.669136	229	309	3	33	80	0.4125000
NODE_40370_length_504_cov_15.669136	229	309	4	47	80	0.5875000
NODE_40371_length_504_cov_13.202469	134	215	0	10	81	0.1234568
NODE_40371_length_504_cov_13.202469	134	215	2	1	81	0.0123457
NODE_40371_length_504_cov_13.202469	134	215	4	3	81	0.0370370
NODE_40371_length_504_cov_13.202469	134	215	6	67	81	0.8271605
NODE_40371_length_504_cov_13.202469	188	268	4	42	80	0.5250000
NODE_40371_length_504_cov_13.202469	188	268	6	38	80	0.4750000
NODE_40377_length_504_cov_6.770370	55	135	0	80	80	1.0000000
NODE_40377_length_504_cov_6.770370	108	188	0	80	80	1.0000000
NODE_40427_length_504_cov_2.234568	359	407	0	34	48	0.7083333
NODE_40427_length_504_cov_2.234568	359	407	1	14	48	0.2916667
NODE_40428_length_504_cov_2.227160	307	370	0	63	63	1.0000000
NODE_40434_length_504_cov_2.116049	245	325	0	33	80	0.4125000
NODE_40434_length_504_cov_2.116049	245	325	1	7	80	0.0875000
NODE_40434_length_504_cov_2.116049	245	325	2	40	80	0.5000000
NODE_40434_length_504_cov_2.116049	298	378	0	3	80	0.0375000
NODE_40434_length_504_cov_2.116049	298	378	2	77	80	0.9625000
NODE_40446_length_504_cov_1.925926	196	262	0	66	66	1.0000000
NODE_40601_length_503_cov_11.356436	268	348	1	80	80	1.0000000
NODE_40601_length_503_cov_11.356436	321	401	0	44	80	0.5500000
NODE_40601_length_503_cov_11.356436	321	401	1	36	80	0.4500000
NODE_40615_length_503_cov_5.537129	314	381	0	67	67	1.0000000
NODE_40645_length_503_cov_3.012376	264	285	0	21	21	1.0000000
NODE_40652_length_503_cov_2.757426	266	334	0	68	68	1.0000000
NODE_40652_length_503_cov_2.757426	307	387	0	80	80	1.0000000
NODE_40655_length_503_cov_2.705446	158	237	0	79	79	1.0000000
NODE_40655_length_503_cov_2.705446	211	291	0	80	80	1.0000000
NODE_40656_length_503_cov_2.705446	251	331	0	80	80	1.0000000
NODE_40656_length_503_cov_2.705446	251	321	0	70	70	1.0000000
NODE_40656_length_503_cov_2.705446	330	384	0	54	54	1.0000000
NODE_40656_length_503_cov_2.705446	338	384	0	46	46	1.0000000
NODE_40664_length_503_cov_2.584158	95	163	0	68	68	1.0000000
NODE_40857_length_502_cov_45.292804	353	433	0	80	80	1.0000000
NODE_40864_length_502_cov_5.980149	305	381	0	31	76	0.4078947
NODE_40864_length_502_cov_5.980149	305	381	1	45	76	0.5921053
NODE_41070_length_501_cov_208.708955	288	350	23	3	62	0.0483871
NODE_41070_length_501_cov_208.708955	288	350	24	1	62	0.0161290
NODE_41070_length_501_cov_208.708955	288	350	25	9	62	0.1451613
NODE_41070_length_501_cov_208.708955	288	350	26	8	62	0.1290323
NODE_41070_length_501_cov_208.708955	288	350	27	3	62	0.0483871
NODE_41070_length_501_cov_208.708955	288	350	28	9	62	0.1451613
NODE_41070_length_501_cov_208.708955	288	350	29	2	62	0.0322581
NODE_41070_length_501_cov_208.708955	288	350	31	4	62	0.0645161
NODE_41070_length_501_cov_208.708955	288	350	32	10	62	0.1612903
NODE_41070_length_501_cov_208.708955	288	350	34	4	62	0.0645161
NODE_41070_length_501_cov_208.708955	288	350	35	9	62	0.1451613
NODE_41070_length_501_cov_208.708955	327	413	24	3	86	0.0348837
NODE_41070_length_501_cov_208.708955	327	413	25	8	86	0.0930233
NODE_41070_length_501_cov_208.708955	327	413	27	2	86	0.0232558
NODE_41070_length_501_cov_208.708955	327	413	30	3	86	0.0348837
NODE_41070_length_501_cov_208.708955	327	413	32	14	86	0.1627907
NODE_41070_length_501_cov_208.708955	327	413	34	5	86	0.0581395
NODE_41070_length_501_cov_208.708955	327	413	35	18	86	0.2093023
NODE_41070_length_501_cov_208.708955	327	413	36	7	86	0.0813954
NODE_41070_length_501_cov_208.708955	327	413	37	26	86	0.3023256
NODE_41071_length_501_cov_29.126866	23	103	2	10	80	0.1250000
NODE_41071_length_501_cov_29.126866	23	103	6	5	80	0.0625000
NODE_41071_length_501_cov_29.126866	23	103	7	5	80	0.0625000
NODE_41071_length_501_cov_29.126866	23	103	9	10	80	0.1250000
NODE_41071_length_501_cov_29.126866	23	103	10	9	80	0.1125000
NODE_41071_length_501_cov_29.126866	23	103	11	7	80	0.0875000
NODE_41071_length_501_cov_29.126866	23	103	13	34	80	0.4250000
NODE_41071_length_501_cov_29.126866	76	156	10	17	80	0.2125000
NODE_41071_length_501_cov_29.126866	76	156	12	13	80	0.1625000
NODE_41071_length_501_cov_29.126866	76	156	13	32	80	0.4000000
NODE_41071_length_501_cov_29.126866	76	156	14	18	80	0.2250000
NODE_41072_length_501_cov_23.736318	85	165	1	7	80	0.0875000
NODE_41072_length_501_cov_23.736318	85	165	2	9	80	0.1125000
NODE_41072_length_501_cov_23.736318	85	165	3	20	80	0.2500000
NODE_41072_length_501_cov_23.736318	85	165	5	44	80	0.5500000
NODE_41072_length_501_cov_23.736318	138	218	2	45	80	0.5625000
NODE_41072_length_501_cov_23.736318	138	218	5	35	80	0.4375000
NODE_41075_length_501_cov_7.820896	270	350	0	80	80	1.0000000
NODE_41075_length_501_cov_7.820896	323	403	0	45	80	0.5625000
NODE_41075_length_501_cov_7.820896	323	403	2	35	80	0.4375000
NODE_41080_length_501_cov_6.437811	309	389	2	14	80	0.1750000
NODE_41080_length_501_cov_6.437811	309	389	6	30	80	0.3750000
NODE_41080_length_501_cov_6.437811	309	389	7	25	80	0.3125000
NODE_41080_length_501_cov_6.437811	309	389	8	11	80	0.1375000
NODE_41097_length_501_cov_3.656716	289	312	0	23	23	1.0000000
NODE_41097_length_501_cov_3.656716	355	420	0	65	65	1.0000000
NODE_41103_length_501_cov_3.477612	329	409	0	80	80	1.0000000
NODE_41109_length_501_cov_3.134328	266	345	0	79	79	1.0000000
NODE_41308_length_500_cov_77.895262	456	500	0	44	44	1.0000000
NODE_41309_length_500_cov_35.805486	326	406	5	10	80	0.1250000
NODE_41309_length_500_cov_35.805486	326	406	7	5	80	0.0625000
NODE_41309_length_500_cov_35.805486	326	406	9	49	80	0.6125000
NODE_41309_length_500_cov_35.805486	326	406	10	16	80	0.2000000
NODE_41309_length_500_cov_35.805486	379	459	5	63	80	0.7875000
NODE_41309_length_500_cov_35.805486	379	459	7	5	80	0.0625000
NODE_41309_length_500_cov_35.805486	379	459	9	12	80	0.1500000
NODE_41310_length_500_cov_13.084788	160	221	3	60	61	0.9836066
NODE_41310_length_500_cov_13.084788	160	221	6	1	61	0.0163934
NODE_41311_length_500_cov_12.650873	215	295	0	2	80	0.0250000
NODE_41311_length_500_cov_12.650873	215	295	2	78	80	0.9750000
NODE_41311_length_500_cov_12.650873	268	348	0	20	80	0.2500000
NODE_41311_length_500_cov_12.650873	268	348	2	60	80	0.7500000
NODE_41312_length_500_cov_12.009975	203	268	4	65	65	1.0000000
NODE_41312_length_500_cov_12.009975	241	321	2	1	80	0.0125000
NODE_41312_length_500_cov_12.009975	241	321	4	79	80	0.9875000
NODE_41325_length_500_cov_4.653367	224	295	0	71	71	1.0000000
NODE_41415_length_500_cov_1.650873	355	435	0	80	80	1.0000000
NODE_41415_length_500_cov_1.650873	408	488	0	80	80	1.0000000
NODE_41462_length_500_cov_1.231920	169	212	2	21	43	0.4883721
NODE_41462_length_500_cov_1.231920	169	212	4	22	43	0.5116279
NODE_41542_length_499_cov_358.730000	425	492	8	1	67	0.0149254
NODE_41542_length_499_cov_358.730000	425	492	11	2	67	0.0298507
NODE_41542_length_499_cov_358.730000	425	492	13	1	67	0.0149254
NODE_41542_length_499_cov_358.730000	425	492	15	1	67	0.0149254
NODE_41542_length_499_cov_358.730000	425	492	16	1	67	0.0149254
NODE_41542_length_499_cov_358.730000	425	492	18	3	67	0.0447761
NODE_41542_length_499_cov_358.730000	425	492	19	1	67	0.0149254
NODE_41542_length_499_cov_358.730000	425	492	21	1	67	0.0149254
NODE_41542_length_499_cov_358.730000	425	492	22	1	67	0.0149254
NODE_41542_length_499_cov_358.730000	425	492	24	2	67	0.0298507
NODE_41542_length_499_cov_358.730000	425	492	25	1	67	0.0149254
NODE_41542_length_499_cov_358.730000	425	492	27	1	67	0.0149254
NODE_41542_length_499_cov_358.730000	425	492	29	7	67	0.1044776
NODE_41542_length_499_cov_358.730000	425	492	31	1	67	0.0149254
NODE_41542_length_499_cov_358.730000	425	492	33	1	67	0.0149254
NODE_41542_length_499_cov_358.730000	425	492	36	2	67	0.0298507
NODE_41542_length_499_cov_358.730000	425	492	38	4	67	0.0597015
NODE_41542_length_499_cov_358.730000	425	492	40	3	67	0.0447761
NODE_41542_length_499_cov_358.730000	425	492	41	1	67	0.0149254
NODE_41542_length_499_cov_358.730000	425	492	43	2	67	0.0298507
NODE_41542_length_499_cov_358.730000	425	492	46	1	67	0.0149254
NODE_41542_length_499_cov_358.730000	425	492	49	2	67	0.0298507
NODE_41542_length_499_cov_358.730000	425	492	50	1	67	0.0149254
NODE_41542_length_499_cov_358.730000	425	492	51	4	67	0.0597015
NODE_41542_length_499_cov_358.730000	425	492	53	1	67	0.0149254
NODE_41542_length_499_cov_358.730000	425	492	54	3	67	0.0447761
NODE_41542_length_499_cov_358.730000	425	492	56	1	67	0.0149254
NODE_41542_length_499_cov_358.730000	425	492	57	1	67	0.0149254
NODE_41542_length_499_cov_358.730000	425	492	58	1	67	0.0149254
NODE_41542_length_499_cov_358.730000	425	492	61	2	67	0.0298507
NODE_41542_length_499_cov_358.730000	425	492	65	4	67	0.0597015
NODE_41542_length_499_cov_358.730000	425	492	66	1	67	0.0149254
NODE_41542_length_499_cov_358.730000	425	492	73	1	67	0.0149254
NODE_41542_length_499_cov_358.730000	425	492	74	2	67	0.0298507
NODE_41542_length_499_cov_358.730000	425	492	75	1	67	0.0149254
NODE_41542_length_499_cov_358.730000	425	492	77	1	67	0.0149254
NODE_41542_length_499_cov_358.730000	425	492	79	3	67	0.0447761
NODE_41543_length_499_cov_21.135000	52	132	0	80	80	1.0000000
NODE_41543_length_499_cov_21.135000	105	185	0	80	80	1.0000000
NODE_41544_length_499_cov_11.917500	50	130	0	80	80	1.0000000
NODE_41544_length_499_cov_11.917500	103	183	0	80	80	1.0000000
NODE_41549_length_499_cov_5.007500	0	54	0	54	54	1.0000000
NODE_41563_length_499_cov_3.482500	307	336	3	6	29	0.2068966
NODE_41563_length_499_cov_3.482500	307	336	4	2	29	0.0689655
NODE_41563_length_499_cov_3.482500	307	336	6	12	29	0.4137931
NODE_41563_length_499_cov_3.482500	307	336	8	9	29	0.3103448
NODE_41594_length_499_cov_2.420000	198	247	2	49	49	1.0000000
NODE_41662_length_499_cov_1.445000	311	372	0	61	61	1.0000000
NODE_41770_length_498_cov_31.704261	12	92	0	80	80	1.0000000
NODE_41770_length_498_cov_31.704261	65	145	0	80	80	1.0000000
NODE_41775_length_498_cov_7.002506	256	336	1	1	80	0.0125000
NODE_41775_length_498_cov_7.002506	256	336	2	79	80	0.9875000
NODE_41780_length_498_cov_5.759398	217	247	0	30	30	1.0000000
NODE_41814_length_498_cov_3.075188	225	262	0	22	37	0.5945946
NODE_41814_length_498_cov_3.075188	225	262	1	15	37	0.4054054
NODE_41814_length_498_cov_3.075188	246	324	0	1	78	0.0128205
NODE_41814_length_498_cov_3.075188	246	324	1	19	78	0.2435897
NODE_41814_length_498_cov_3.075188	246	324	3	58	78	0.7435898
NODE_42016_length_497_cov_44.105528	169	249	12	3	80	0.0375000
NODE_42016_length_497_cov_44.105528	169	249	13	4	80	0.0500000
NODE_42016_length_497_cov_44.105528	169	249	14	6	80	0.0750000
NODE_42016_length_497_cov_44.105528	169	249	15	18	80	0.2250000
NODE_42016_length_497_cov_44.105528	169	249	17	1	80	0.0125000
NODE_42016_length_497_cov_44.105528	169	249	18	4	80	0.0500000
NODE_42016_length_497_cov_44.105528	169	249	19	4	80	0.0500000
NODE_42016_length_497_cov_44.105528	169	249	20	2	80	0.0250000
NODE_42016_length_497_cov_44.105528	169	249	21	7	80	0.0875000
NODE_42016_length_497_cov_44.105528	169	249	22	9	80	0.1125000
NODE_42016_length_497_cov_44.105528	169	249	23	19	80	0.2375000
NODE_42016_length_497_cov_44.105528	169	249	24	3	80	0.0375000
NODE_42016_length_497_cov_44.105528	222	302	14	9	80	0.1125000
NODE_42016_length_497_cov_44.105528	222	302	16	5	80	0.0625000
NODE_42016_length_497_cov_44.105528	222	302	17	8	80	0.1000000
NODE_42016_length_497_cov_44.105528	222	302	19	12	80	0.1500000
NODE_42016_length_497_cov_44.105528	222	302	20	12	80	0.1500000
NODE_42016_length_497_cov_44.105528	222	302	21	1	80	0.0125000
NODE_42016_length_497_cov_44.105528	222	302	22	13	80	0.1625000
NODE_42016_length_497_cov_44.105528	222	302	23	17	80	0.2125000
NODE_42016_length_497_cov_44.105528	222	302	24	3	80	0.0375000
NODE_42017_length_497_cov_10.145729	85	165	4	34	80	0.4250000
NODE_42017_length_497_cov_10.145729	85	165	5	10	80	0.1250000
NODE_42017_length_497_cov_10.145729	85	165	6	36	80	0.4500000
NODE_42017_length_497_cov_10.145729	138	226	2	1	88	0.0113636
NODE_42017_length_497_cov_10.145729	138	226	3	39	88	0.4431818
NODE_42017_length_497_cov_10.145729	138	226	4	14	88	0.1590909
NODE_42017_length_497_cov_10.145729	138	226	5	17	88	0.1931818
NODE_42017_length_497_cov_10.145729	138	226	6	17	88	0.1931818
NODE_42024_length_497_cov_6.618090	231	304	0	73	73	1.0000000
NODE_42024_length_497_cov_6.618090	284	364	0	80	80	1.0000000
NODE_42065_length_497_cov_2.889447	109	189	0	49	80	0.6125000
NODE_42065_length_497_cov_2.889447	109	189	2	2	80	0.0250000
NODE_42065_length_497_cov_2.889447	109	189	4	29	80	0.3625000
NODE_42065_length_497_cov_2.889447	162	242	0	80	80	1.0000000
NODE_42071_length_497_cov_2.623116	302	368	0	66	66	1.0000000
NODE_42071_length_497_cov_2.623116	355	406	0	51	51	1.0000000
NODE_42100_length_497_cov_1.909548	106	186	0	10	80	0.1250000
NODE_42100_length_497_cov_1.909548	106	186	2	44	80	0.5500000
NODE_42100_length_497_cov_1.909548	106	186	4	26	80	0.3250000
NODE_42100_length_497_cov_1.909548	159	240	2	9	81	0.1111111
NODE_42100_length_497_cov_1.909548	159	240	4	37	81	0.4567901
NODE_42100_length_497_cov_1.909548	159	240	6	4	81	0.0493827
NODE_42100_length_497_cov_1.909548	159	240	8	31	81	0.3827161
NODE_42100_length_497_cov_1.909548	262	324	0	4	62	0.0645161
NODE_42100_length_497_cov_1.909548	262	324	2	6	62	0.0967742
NODE_42100_length_497_cov_1.909548	262	324	6	9	62	0.1451613
NODE_42100_length_497_cov_1.909548	262	324	8	43	62	0.6935484
NODE_42131_length_497_cov_1.500000	259	339	0	39	80	0.4875000
NODE_42131_length_497_cov_1.500000	259	339	1	41	80	0.5125000
NODE_42136_length_497_cov_1.404523	211	263	0	52	52	1.0000000
NODE_42279_length_496_cov_5.619647	239	269	0	8	30	0.2666667
NODE_42279_length_496_cov_5.619647	239	269	1	22	30	0.7333333
NODE_42281_length_496_cov_5.392947	103	168	0	65	65	1.0000000
NODE_42281_length_496_cov_5.392947	141	221	0	39	80	0.4875000
NODE_42281_length_496_cov_5.392947	141	221	2	15	80	0.1875000
NODE_42281_length_496_cov_5.392947	141	221	4	26	80	0.3250000
NODE_42281_length_496_cov_5.392947	217	295	4	78	78	1.0000000
NODE_42281_length_496_cov_5.392947	270	295	4	25	25	1.0000000
NODE_42287_length_496_cov_4.397985	388	467	0	79	79	1.0000000
NODE_42288_length_496_cov_4.193955	235	315	0	20	80	0.2500000
NODE_42288_length_496_cov_4.193955	235	315	1	60	80	0.7500000
NODE_42297_length_496_cov_3.531486	192	273	0	1	81	0.0123457
NODE_42297_length_496_cov_3.531486	192	273	2	80	81	0.9876543
NODE_42297_length_496_cov_3.531486	245	325	0	53	80	0.6625000
NODE_42297_length_496_cov_3.531486	245	325	2	27	80	0.3375000
NODE_42298_length_496_cov_3.377834	252	332	0	80	80	1.0000000
NODE_42298_length_496_cov_3.377834	305	383	0	78	78	1.0000000
NODE_42316_length_496_cov_2.659950	203	251	0	48	48	1.0000000
NODE_42328_length_496_cov_2.445844	95	165	1	55	70	0.7857143
NODE_42328_length_496_cov_2.445844	95	165	2	15	70	0.2142857
NODE_42328_length_496_cov_2.445844	148	228	1	80	80	1.0000000
NODE_42333_length_496_cov_2.214106	299	359	0	21	60	0.3500000
NODE_42333_length_496_cov_2.214106	299	359	1	39	60	0.6500000
NODE_42415_length_496_cov_1.395466	273	317	1	44	44	1.0000000
NODE_42461_length_496_cov_0.979849	214	294	2	63	80	0.7875000
NODE_42461_length_496_cov_0.979849	214	294	4	17	80	0.2125000
NODE_42525_length_495_cov_34.888889	209	264	0	55	55	1.0000000
NODE_42526_length_495_cov_12.800505	268	348	0	80	80	1.0000000
NODE_42526_length_495_cov_12.800505	321	401	0	80	80	1.0000000
NODE_42529_length_495_cov_7.080808	386	416	0	30	30	1.0000000
NODE_42548_length_495_cov_3.868687	218	298	0	80	80	1.0000000
NODE_42736_length_495_cov_0.792929	274	309	0	28	35	0.8000000
NODE_42736_length_495_cov_0.792929	274	309	1	7	35	0.2000000
NODE_42773_length_494_cov_20.096203	182	262	6	33	80	0.4125000
NODE_42773_length_494_cov_20.096203	182	262	8	39	80	0.4875000
NODE_42773_length_494_cov_20.096203	182	262	10	8	80	0.1000000
NODE_42773_length_494_cov_20.096203	235	315	3	4	80	0.0500000
NODE_42773_length_494_cov_20.096203	235	315	4	5	80	0.0625000
NODE_42773_length_494_cov_20.096203	235	315	6	4	80	0.0500000
NODE_42773_length_494_cov_20.096203	235	315	7	26	80	0.3250000
NODE_42773_length_494_cov_20.096203	235	315	8	33	80	0.4125000
NODE_42773_length_494_cov_20.096203	235	315	10	8	80	0.1000000
NODE_42778_length_494_cov_7.498734	187	240	0	53	53	1.0000000
NODE_42788_length_494_cov_4.283544	255	332	0	77	77	1.0000000
NODE_42804_length_494_cov_3.496203	209	276	1	55	67	0.8208955
NODE_42804_length_494_cov_3.496203	209	276	2	12	67	0.1791045
NODE_42812_length_494_cov_3.032911	385	432	0	47	47	1.0000000
NODE_42816_length_494_cov_2.908861	189	269	0	80	80	1.0000000
NODE_42822_length_494_cov_2.777215	145	188	0	43	43	1.0000000
NODE_42834_length_494_cov_2.531646	371	430	0	59	59	1.0000000
NODE_42834_length_494_cov_2.531646	428	494	0	66	66	1.0000000
NODE_43021_length_493_cov_34.946701	140	220	3	19	80	0.2375000
NODE_43021_length_493_cov_34.946701	140	220	4	24	80	0.3000000
NODE_43021_length_493_cov_34.946701	140	220	5	15	80	0.1875000
NODE_43021_length_493_cov_34.946701	140	220	8	22	80	0.2750000
NODE_43021_length_493_cov_34.946701	193	265	5	5	72	0.0694444
NODE_43021_length_493_cov_34.946701	193	265	6	2	72	0.0277778
NODE_43021_length_493_cov_34.946701	193	265	7	15	72	0.2083333
NODE_43021_length_493_cov_34.946701	193	265	8	50	72	0.6944444
NODE_43022_length_493_cov_12.451777	173	253	1	12	80	0.1500000
NODE_43022_length_493_cov_12.451777	173	253	2	68	80	0.8500000
NODE_43022_length_493_cov_12.451777	226	306	1	50	80	0.6250000
NODE_43022_length_493_cov_12.451777	226	306	2	30	80	0.3750000
NODE_43025_length_493_cov_8.540609	116	146	3	12	30	0.4000000
NODE_43025_length_493_cov_8.540609	116	146	4	6	30	0.2000000
NODE_43025_length_493_cov_8.540609	116	146	5	12	30	0.4000000
NODE_43025_length_493_cov_8.540609	119	199	3	9	80	0.1125000
NODE_43025_length_493_cov_8.540609	119	199	4	6	80	0.0750000
NODE_43025_length_493_cov_8.540609	119	199	5	65	80	0.8125000
NODE_43031_length_493_cov_6.144670	300	380	0	80	80	1.0000000
NODE_43031_length_493_cov_6.144670	353	433	0	80	80	1.0000000
NODE_43046_length_493_cov_3.840102	178	258	2	80	80	1.0000000
NODE_43046_length_493_cov_3.840102	231	311	0	50	80	0.6250000
NODE_43046_length_493_cov_3.840102	231	311	2	30	80	0.3750000
NODE_43125_length_493_cov_1.588832	126	206	0	80	80	1.0000000
NODE_43125_length_493_cov_1.588832	179	259	0	80	80	1.0000000
NODE_43261_length_492_cov_5.488550	117	197	1	72	80	0.9000000
NODE_43261_length_492_cov_5.488550	117	197	2	8	80	0.1000000
NODE_43261_length_492_cov_5.488550	170	250	1	72	80	0.9000000
NODE_43261_length_492_cov_5.488550	170	250	2	8	80	0.1000000
NODE_43270_length_492_cov_4.445293	158	234	0	76	76	1.0000000
NODE_43270_length_492_cov_4.445293	207	285	0	78	78	1.0000000
NODE_43273_length_492_cov_4.244275	272	315	1	43	43	1.0000000
NODE_43293_length_492_cov_3.297710	113	193	0	1	80	0.0125000
NODE_43293_length_492_cov_3.297710	113	193	2	3	80	0.0375000
NODE_43293_length_492_cov_3.297710	113	193	5	2	80	0.0250000
NODE_43293_length_492_cov_3.297710	113	193	6	74	80	0.9250000
NODE_43528_length_491_cov_17.196429	138	218	1	19	80	0.2375000
NODE_43528_length_491_cov_17.196429	138	218	2	6	80	0.0750000
NODE_43528_length_491_cov_17.196429	138	218	3	55	80	0.6875000
NODE_43528_length_491_cov_17.196429	191	271	3	80	80	1.0000000
NODE_43529_length_491_cov_17.193878	77	157	0	6	80	0.0750000
NODE_43529_length_491_cov_17.193878	77	157	1	64	80	0.8000000
NODE_43529_length_491_cov_17.193878	77	157	2	10	80	0.1250000
NODE_43529_length_491_cov_17.193878	130	210	1	17	80	0.2125000
NODE_43529_length_491_cov_17.193878	130	210	2	63	80	0.7875000
NODE_43535_length_491_cov_5.505102	215	284	0	69	69	1.0000000
NODE_43535_length_491_cov_5.505102	215	295	0	80	80	1.0000000
NODE_43535_length_491_cov_5.505102	268	348	0	80	80	1.0000000
NODE_43536_length_491_cov_5.477041	169	222	0	53	53	1.0000000
NODE_43546_length_491_cov_4.176020	383	449	0	1	66	0.0151515
NODE_43546_length_491_cov_4.176020	383	449	2	65	66	0.9848485
NODE_43546_length_491_cov_4.176020	422	476	0	26	54	0.4814815
NODE_43546_length_491_cov_4.176020	422	476	2	28	54	0.5185185
NODE_43570_length_491_cov_2.887755	348	428	1	80	80	1.0000000
NODE_43570_length_491_cov_2.887755	401	472	0	38	71	0.5352113
NODE_43570_length_491_cov_2.887755	401	472	1	33	71	0.4647887
NODE_43575_length_491_cov_2.693878	239	316	0	75	77	0.9740260
NODE_43575_length_491_cov_2.693878	239	316	1	2	77	0.0259740
NODE_43744_length_490_cov_10.058824	192	272	2	78	80	0.9750000
NODE_43744_length_490_cov_10.058824	192	272	4	2	80	0.0250000
NODE_43744_length_490_cov_10.058824	245	325	0	44	80	0.5500000
NODE_43744_length_490_cov_10.058824	245	325	2	36	80	0.4500000
NODE_43748_length_490_cov_6.652174	304	363	0	59	59	1.0000000
NODE_43816_length_490_cov_2.212276	241	300	0	16	59	0.2711864
NODE_43816_length_490_cov_2.212276	241	300	1	43	59	0.7288136
NODE_43816_length_490_cov_2.212276	280	358	1	78	78	1.0000000
NODE_43886_length_490_cov_1.360614	97	159	2	62	62	1.0000000
NODE_43886_length_490_cov_1.360614	132	212	0	6	80	0.0750000
NODE_43886_length_490_cov_1.360614	132	212	1	31	80	0.3875000
NODE_43886_length_490_cov_1.360614	132	212	2	43	80	0.5375000
NODE_43993_length_489_cov_55.992308	50	130	3	8	80	0.1000000
NODE_43993_length_489_cov_55.992308	50	130	4	8	80	0.1000000
NODE_43993_length_489_cov_55.992308	50	130	5	18	80	0.2250000
NODE_43993_length_489_cov_55.992308	50	130	7	21	80	0.2625000
NODE_43993_length_489_cov_55.992308	50	130	8	21	80	0.2625000
NODE_43993_length_489_cov_55.992308	50	130	9	4	80	0.0500000
NODE_43993_length_489_cov_55.992308	103	183	7	2	80	0.0250000
NODE_43993_length_489_cov_55.992308	103	183	8	21	80	0.2625000
NODE_43993_length_489_cov_55.992308	103	183	9	25	80	0.3125000
NODE_43993_length_489_cov_55.992308	103	183	10	32	80	0.4000000
NODE_43993_length_489_cov_55.992308	179	259	2	4	80	0.0500000
NODE_43993_length_489_cov_55.992308	179	259	3	40	80	0.5000000
NODE_43993_length_489_cov_55.992308	179	259	4	7	80	0.0875000
NODE_43993_length_489_cov_55.992308	179	259	5	9	80	0.1125000
NODE_43993_length_489_cov_55.992308	179	259	6	10	80	0.1250000
NODE_43993_length_489_cov_55.992308	179	259	8	4	80	0.0500000
NODE_43993_length_489_cov_55.992308	179	259	9	6	80	0.0750000
NODE_43993_length_489_cov_55.992308	232	312	0	18	80	0.2250000
NODE_43993_length_489_cov_55.992308	232	312	1	18	80	0.2250000
NODE_43993_length_489_cov_55.992308	232	312	2	21	80	0.2625000
NODE_43993_length_489_cov_55.992308	232	312	3	23	80	0.2875000
NODE_43994_length_489_cov_31.707692	299	384	0	85	85	1.0000000
NODE_43994_length_489_cov_31.707692	299	384	0	85	85	1.0000000
NODE_43996_length_489_cov_13.661538	227	307	2	80	80	1.0000000
NODE_43996_length_489_cov_13.661538	280	358	0	1	78	0.0128205
NODE_43996_length_489_cov_13.661538	280	358	2	77	78	0.9871795
NODE_43997_length_489_cov_12.017949	214	294	2	8	80	0.1000000
NODE_43997_length_489_cov_12.017949	214	294	4	5	80	0.0625000
NODE_43997_length_489_cov_12.017949	214	294	5	14	80	0.1750000
NODE_43997_length_489_cov_12.017949	214	294	7	14	80	0.1750000
NODE_43997_length_489_cov_12.017949	214	294	8	39	80	0.4875000
NODE_43997_length_489_cov_12.017949	267	347	4	4	80	0.0500000
NODE_43997_length_489_cov_12.017949	267	347	6	11	80	0.1375000
NODE_43997_length_489_cov_12.017949	267	347	8	65	80	0.8125000
NODE_43998_length_489_cov_10.774359	262	304	0	42	42	1.0000000
NODE_44001_length_489_cov_8.094872	141	221	4	72	80	0.9000000
NODE_44001_length_489_cov_8.094872	141	221	5	8	80	0.1000000
NODE_44001_length_489_cov_8.094872	194	247	1	9	53	0.1698113
NODE_44001_length_489_cov_8.094872	194	247	2	6	53	0.1132075
NODE_44001_length_489_cov_8.094872	194	247	4	37	53	0.6981132
NODE_44001_length_489_cov_8.094872	194	247	5	1	53	0.0188679
NODE_44007_length_489_cov_5.284615	176	256	2	40	80	0.5000000
NODE_44007_length_489_cov_5.284615	176	256	3	4	80	0.0500000
NODE_44007_length_489_cov_5.284615	176	256	4	36	80	0.4500000
NODE_44007_length_489_cov_5.284615	229	309	4	73	80	0.9125000
NODE_44007_length_489_cov_5.284615	229	309	5	6	80	0.0750000
NODE_44007_length_489_cov_5.284615	229	309	6	1	80	0.0125000
NODE_44096_length_489_cov_1.646154	234	278	0	44	44	1.0000000
NODE_44105_length_489_cov_1.574359	351	391	0	40	40	1.0000000
NODE_44105_length_489_cov_1.574359	351	383	0	32	32	1.0000000
NODE_44105_length_489_cov_1.574359	365	445	0	80	80	1.0000000
NODE_44105_length_489_cov_1.574359	365	445	0	80	80	1.0000000
NODE_44105_length_489_cov_1.574359	366	445	0	79	79	1.0000000
NODE_44231_length_488_cov_15.406170	235	313	7	52	78	0.6666667
NODE_44231_length_488_cov_15.406170	235	313	8	6	78	0.0769231
NODE_44231_length_488_cov_15.406170	235	313	9	20	78	0.2564103
NODE_44231_length_488_cov_15.406170	286	367	2	5	81	0.0617284
NODE_44231_length_488_cov_15.406170	286	367	3	14	81	0.1728395
NODE_44231_length_488_cov_15.406170	286	367	5	8	81	0.0987654
NODE_44231_length_488_cov_15.406170	286	367	7	54	81	0.6666667
NODE_44234_length_488_cov_8.416452	210	290	0	80	80	1.0000000
NODE_44234_length_488_cov_8.416452	263	343	0	42	80	0.5250000
NODE_44234_length_488_cov_8.416452	263	343	2	38	80	0.4750000
NODE_44240_length_488_cov_6.084833	254	302	0	48	48	1.0000000
NODE_44243_length_488_cov_5.434447	210	279	1	39	69	0.5652174
NODE_44243_length_488_cov_5.434447	210	279	2	30	69	0.4347826
NODE_44243_length_488_cov_5.434447	265	300	1	35	35	1.0000000
NODE_44263_length_488_cov_3.431877	212	248	0	36	36	1.0000000
NODE_44264_length_488_cov_3.424165	320	367	0	45	47	0.9574468
NODE_44264_length_488_cov_3.424165	320	367	1	2	47	0.0425532
NODE_44264_length_488_cov_3.424165	320	378	0	56	58	0.9655172
NODE_44264_length_488_cov_3.424165	320	378	1	2	58	0.0344828
NODE_44264_length_488_cov_3.424165	351	393	0	42	42	1.0000000
NODE_44264_length_488_cov_3.424165	360	395	0	35	35	1.0000000
NODE_44274_length_488_cov_2.850900	276	356	0	80	80	1.0000000
NODE_44376_length_488_cov_1.562982	31	67	0	36	36	1.0000000
NODE_44496_length_487_cov_7.028351	278	358	2	5	80	0.0625000
NODE_44496_length_487_cov_7.028351	278	358	4	4	80	0.0500000
NODE_44496_length_487_cov_7.028351	278	358	5	33	80	0.4125000
NODE_44496_length_487_cov_7.028351	278	358	6	38	80	0.4750000
NODE_44498_length_487_cov_6.804124	242	313	1	17	71	0.2394366
NODE_44498_length_487_cov_6.804124	242	313	2	54	71	0.7605634
NODE_44498_length_487_cov_6.804124	286	366	1	24	80	0.3000000
NODE_44498_length_487_cov_6.804124	286	366	2	56	80	0.7000000
NODE_44500_length_487_cov_5.917526	140	220	0	80	80	1.0000000
NODE_44500_length_487_cov_5.917526	193	273	0	80	80	1.0000000
NODE_44520_length_487_cov_3.296392	235	315	0	41	80	0.5125000
NODE_44520_length_487_cov_3.296392	235	315	2	11	80	0.1375000
NODE_44520_length_487_cov_3.296392	235	315	4	7	80	0.0875000
NODE_44520_length_487_cov_3.296392	235	315	6	21	80	0.2625000
NODE_44521_length_487_cov_3.237113	301	363	0	41	62	0.6612903
NODE_44521_length_487_cov_3.237113	301	363	2	21	62	0.3387097
NODE_44525_length_487_cov_3.074742	214	294	0	80	80	1.0000000
NODE_44723_length_486_cov_6.609819	206	286	0	80	80	1.0000000
NODE_44728_length_486_cov_5.428941	147	227	0	52	80	0.6500000
NODE_44728_length_486_cov_5.428941	147	227	2	28	80	0.3500000
NODE_44754_length_486_cov_3.072351	131	211	0	80	80	1.0000000
NODE_44754_length_486_cov_3.072351	190	235	0	45	45	1.0000000
NODE_44769_length_486_cov_2.581395	156	236	0	16	80	0.2000000
NODE_44769_length_486_cov_2.581395	156	236	2	64	80	0.8000000
NODE_44769_length_486_cov_2.581395	209	289	0	69	80	0.8625000
NODE_44769_length_486_cov_2.581395	209	289	2	11	80	0.1375000
NODE_44781_length_486_cov_2.343669	189	230	0	41	41	1.0000000
NODE_44781_length_486_cov_2.343669	242	306	0	64	64	1.0000000
NODE_44959_length_485_cov_29.505181	270	350	0	80	80	1.0000000
NODE_44959_length_485_cov_29.505181	323	403	0	80	80	1.0000000
NODE_44959_length_485_cov_29.505181	399	479	0	80	80	1.0000000
NODE_44960_length_485_cov_10.450777	67	153	0	86	86	1.0000000
NODE_44960_length_485_cov_10.450777	133	206	0	73	73	1.0000000
NODE_44965_length_485_cov_5.922280	196	273	1	57	77	0.7402598
NODE_44965_length_485_cov_5.922280	196	273	3	20	77	0.2597403
NODE_44965_length_485_cov_5.922280	246	326	1	7	80	0.0875000
NODE_44965_length_485_cov_5.922280	246	326	2	2	80	0.0250000
NODE_44965_length_485_cov_5.922280	246	326	3	71	80	0.8875000
NODE_44966_length_485_cov_5.818653	279	359	2	30	80	0.3750000
NODE_44966_length_485_cov_5.818653	279	359	3	17	80	0.2125000
NODE_44966_length_485_cov_5.818653	279	359	4	33	80	0.4125000
NODE_44966_length_485_cov_5.818653	332	412	1	17	80	0.2125000
NODE_44966_length_485_cov_5.818653	332	412	2	63	80	0.7875000
NODE_44968_length_485_cov_5.670984	321	396	2	75	75	1.0000000
NODE_44992_length_485_cov_3.518135	162	210	1	48	48	1.0000000
NODE_45005_length_485_cov_2.790155	193	253	0	60	60	1.0000000
NODE_45021_length_485_cov_2.427461	170	249	0	45	79	0.5696203
NODE_45021_length_485_cov_2.427461	170	249	2	34	79	0.4303797
NODE_45100_length_485_cov_1.264249	232	251	0	19	19	1.0000000
NODE_45193_length_484_cov_33.384416	92	172	2	61	80	0.7625000
NODE_45193_length_484_cov_33.384416	92	172	3	13	80	0.1625000
NODE_45193_length_484_cov_33.384416	92	172	4	6	80	0.0750000
NODE_45193_length_484_cov_33.384416	145	225	2	20	80	0.2500000
NODE_45193_length_484_cov_33.384416	145	225	3	48	80	0.6000000
NODE_45193_length_484_cov_33.384416	145	225	4	12	80	0.1500000
NODE_45195_length_484_cov_9.111688	136	216	0	80	80	1.0000000
NODE_45195_length_484_cov_9.111688	189	270	0	81	81	1.0000000
NODE_45196_length_484_cov_8.353247	165	244	0	79	79	1.0000000
NODE_45196_length_484_cov_8.353247	217	297	0	80	80	1.0000000
NODE_45197_length_484_cov_8.119481	108	188	2	80	80	1.0000000
NODE_45197_length_484_cov_8.119481	161	241	0	13	80	0.1625000
NODE_45197_length_484_cov_8.119481	161	241	2	67	80	0.8375000
NODE_45200_length_484_cov_7.703896	208	288	1	79	80	0.9875000
NODE_45200_length_484_cov_7.703896	208	288	2	1	80	0.0125000
NODE_45200_length_484_cov_7.703896	261	341	1	52	80	0.6500000
NODE_45200_length_484_cov_7.703896	261	341	2	28	80	0.3500000
NODE_45202_length_484_cov_7.153247	230	292	0	62	62	1.0000000
NODE_45204_length_484_cov_6.594805	221	301	0	80	80	1.0000000
NODE_45204_length_484_cov_6.594805	274	354	0	80	80	1.0000000
NODE_45218_length_484_cov_4.044156	267	347	0	80	80	1.0000000
NODE_45218_length_484_cov_4.044156	342	396	0	54	54	1.0000000
NODE_45225_length_484_cov_3.787013	287	331	2	4	44	0.0909091
NODE_45225_length_484_cov_3.787013	287	331	3	40	44	0.9090909
NODE_45225_length_484_cov_3.787013	307	386	2	52	79	0.6582279
NODE_45225_length_484_cov_3.787013	307	386	3	27	79	0.3417721
NODE_45225_length_484_cov_3.787013	317	386	2	52	69	0.7536232
NODE_45225_length_484_cov_3.787013	317	386	3	17	69	0.2463768
NODE_45276_length_484_cov_2.254545	79	132	0	53	53	1.0000000
NODE_45352_length_484_cov_1.322078	429	477	0	48	48	1.0000000
NODE_45353_length_484_cov_1.314286	431	472	1	5	41	0.1219512
NODE_45353_length_484_cov_1.314286	431	472	2	36	41	0.8780488
NODE_45459_length_483_cov_40.815104	396	473	0	77	77	1.0000000
NODE_45459_length_483_cov_40.815104	396	473	0	77	77	1.0000000
NODE_45473_length_483_cov_5.289062	124	185	0	61	61	1.0000000
NODE_45494_length_483_cov_4.114583	226	306	2	80	80	1.0000000
NODE_45494_length_483_cov_4.114583	226	305	2	79	79	1.0000000
NODE_45494_length_483_cov_4.114583	226	306	2	80	80	1.0000000
NODE_45494_length_483_cov_4.114583	226	306	2	80	80	1.0000000
NODE_45494_length_483_cov_4.114583	279	359	0	27	80	0.3375000
NODE_45494_length_483_cov_4.114583	279	359	2	53	80	0.6625000
NODE_45494_length_483_cov_4.114583	279	325	2	46	46	1.0000000
NODE_45494_length_483_cov_4.114583	297	323	2	26	26	1.0000000
NODE_45495_length_483_cov_4.046875	68	117	0	49	49	1.0000000
NODE_45495_length_483_cov_4.046875	184	250	0	66	66	1.0000000
NODE_45635_length_483_cov_1.205729	249	291	0	42	42	1.0000000
NODE_45725_length_482_cov_37.900783	72	152	10	11	80	0.1375000
NODE_45725_length_482_cov_37.900783	72	152	12	69	80	0.8625000
NODE_45725_length_482_cov_37.900783	125	205	1	3	80	0.0375000
NODE_45725_length_482_cov_37.900783	125	205	3	20	80	0.2500000
NODE_45725_length_482_cov_37.900783	125	205	5	16	80	0.2000000
NODE_45725_length_482_cov_37.900783	125	205	6	10	80	0.1250000
NODE_45725_length_482_cov_37.900783	125	205	8	3	80	0.0375000
NODE_45725_length_482_cov_37.900783	125	205	10	12	80	0.1500000
NODE_45725_length_482_cov_37.900783	125	205	12	16	80	0.2000000
NODE_45728_length_482_cov_10.545692	233	297	3	13	64	0.2031250
NODE_45728_length_482_cov_10.545692	233	297	4	20	64	0.3125000
NODE_45728_length_482_cov_10.545692	233	297	5	31	64	0.4843750
NODE_45729_length_482_cov_9.342037	281	333	0	52	52	1.0000000
NODE_45730_length_482_cov_8.190601	247	311	0	64	64	1.0000000
NODE_45730_length_482_cov_8.190601	284	355	0	71	71	1.0000000
NODE_45734_length_482_cov_6.002611	112	192	0	64	80	0.8000000
NODE_45734_length_482_cov_6.002611	112	192	2	16	80	0.2000000
NODE_45734_length_482_cov_6.002611	165	245	0	11	80	0.1375000
NODE_45734_length_482_cov_6.002611	165	245	2	69	80	0.8625000
NODE_45735_length_482_cov_5.953003	315	395	0	80	80	1.0000000
NODE_45735_length_482_cov_5.953003	368	441	0	73	73	1.0000000
NODE_45748_length_482_cov_4.530026	20	85	0	65	65	1.0000000
NODE_45759_length_482_cov_3.791123	278	358	0	80	80	1.0000000
NODE_45759_length_482_cov_3.791123	331	411	0	80	80	1.0000000
NODE_45842_length_482_cov_1.647520	382	446	0	63	64	0.9843750
NODE_45842_length_482_cov_1.647520	382	446	1	1	64	0.0156250
NODE_45842_length_482_cov_1.647520	435	482	0	47	47	1.0000000
NODE_45994_length_481_cov_50.623037	154	234	4	22	80	0.2750000
NODE_45994_length_481_cov_50.623037	154	234	6	4	80	0.0500000
NODE_45994_length_481_cov_50.623037	154	234	8	1	80	0.0125000
NODE_45994_length_481_cov_50.623037	154	234	9	1	80	0.0125000
NODE_45994_length_481_cov_50.623037	154	234	10	32	80	0.4000000
NODE_45994_length_481_cov_50.623037	154	234	11	20	80	0.2500000
NODE_45994_length_481_cov_50.623037	207	287	5	14	80	0.1750000
NODE_45994_length_481_cov_50.623037	207	287	6	3	80	0.0375000
NODE_45994_length_481_cov_50.623037	207	287	8	26	80	0.3250000
NODE_45994_length_481_cov_50.623037	207	287	9	8	80	0.1000000
NODE_45994_length_481_cov_50.623037	207	287	10	21	80	0.2625000
NODE_45994_length_481_cov_50.623037	207	287	11	8	80	0.1000000
NODE_45995_length_481_cov_30.939791	149	198	0	16	49	0.3265306
NODE_45995_length_481_cov_30.939791	149	198	2	33	49	0.6734694
NODE_45995_length_481_cov_30.939791	171	235	2	64	64	1.0000000
NODE_45995_length_481_cov_30.939791	171	235	2	64	64	1.0000000
NODE_45996_length_481_cov_30.183246	0	41	0	41	41	1.0000000
NODE_45996_length_481_cov_30.183246	0	39	0	39	39	1.0000000
NODE_45996_length_481_cov_30.183246	0	44	0	44	44	1.0000000
NODE_45996_length_481_cov_30.183246	0	44	0	44	44	1.0000000
NODE_45996_length_481_cov_30.183246	0	44	0	44	44	1.0000000
NODE_45996_length_481_cov_30.183246	0	44	0	44	44	1.0000000
NODE_45996_length_481_cov_30.183246	17	97	0	80	80	1.0000000
NODE_45996_length_481_cov_30.183246	17	97	0	80	80	1.0000000
NODE_45996_length_481_cov_30.183246	17	97	0	80	80	1.0000000
NODE_45996_length_481_cov_30.183246	17	97	0	80	80	1.0000000
NODE_45996_length_481_cov_30.183246	17	97	0	80	80	1.0000000
NODE_45996_length_481_cov_30.183246	17	97	0	80	80	1.0000000
NODE_45997_length_481_cov_12.709424	250	330	3	18	80	0.2250000
NODE_45997_length_481_cov_12.709424	250	330	4	17	80	0.2125000
NODE_45997_length_481_cov_12.709424	250	330	5	11	80	0.1375000
NODE_45997_length_481_cov_12.709424	250	330	6	31	80	0.3875000
NODE_45997_length_481_cov_12.709424	250	330	7	3	80	0.0375000
NODE_45997_length_481_cov_12.709424	303	383	5	13	80	0.1625000
NODE_45997_length_481_cov_12.709424	303	383	6	24	80	0.3000000
NODE_45997_length_481_cov_12.709424	303	383	7	43	80	0.5375000
NODE_46037_length_481_cov_3.002618	197	277	0	80	80	1.0000000
NODE_46064_length_481_cov_2.261780	271	351	0	80	80	1.0000000
NODE_46256_length_480_cov_22.346457	318	398	3	30	80	0.3750000
NODE_46256_length_480_cov_22.346457	318	398	4	1	80	0.0125000
NODE_46256_length_480_cov_22.346457	318	398	5	25	80	0.3125000
NODE_46256_length_480_cov_22.346457	318	398	6	24	80	0.3000000
NODE_46256_length_480_cov_22.346457	371	451	0	35	80	0.4375000
NODE_46256_length_480_cov_22.346457	371	451	1	7	80	0.0875000
NODE_46256_length_480_cov_22.346457	371	451	2	3	80	0.0375000
NODE_46256_length_480_cov_22.346457	371	451	3	35	80	0.4375000
NODE_46257_length_480_cov_16.488189	252	332	1	3	80	0.0375000
NODE_46257_length_480_cov_16.488189	252	332	3	47	80	0.5875000
NODE_46257_length_480_cov_16.488189	252	332	4	30	80	0.3750000
NODE_46257_length_480_cov_16.488189	305	385	1	3	80	0.0375000
NODE_46257_length_480_cov_16.488189	305	385	2	7	80	0.0875000
NODE_46257_length_480_cov_16.488189	305	385	4	70	80	0.8750000
NODE_46258_length_480_cov_12.874016	164	234	2	9	70	0.1285714
NODE_46258_length_480_cov_12.874016	164	234	3	21	70	0.3000000
NODE_46258_length_480_cov_12.874016	164	234	4	10	70	0.1428571
NODE_46258_length_480_cov_12.874016	164	234	5	30	70	0.4285714
NODE_46258_length_480_cov_12.874016	207	273	0	6	66	0.0909091
NODE_46258_length_480_cov_12.874016	207	273	1	22	66	0.3333333
NODE_46258_length_480_cov_12.874016	207	273	2	20	66	0.3030303
NODE_46258_length_480_cov_12.874016	207	273	3	18	66	0.2727273
NODE_46260_length_480_cov_11.879265	170	250	5	43	80	0.5375000
NODE_46260_length_480_cov_11.879265	170	250	6	20	80	0.2500000
NODE_46260_length_480_cov_11.879265	170	250	7	17	80	0.2125000
NODE_46260_length_480_cov_11.879265	223	303	3	10	80	0.1250000
NODE_46260_length_480_cov_11.879265	223	303	4	23	80	0.2875000
NODE_46260_length_480_cov_11.879265	223	303	5	11	80	0.1375000
NODE_46260_length_480_cov_11.879265	223	303	6	12	80	0.1500000
NODE_46260_length_480_cov_11.879265	223	303	7	24	80	0.3000000
NODE_46261_length_480_cov_8.774278	114	143	1	29	29	1.0000000
NODE_46261_length_480_cov_8.774278	165	245	0	80	80	1.0000000
NODE_46261_length_480_cov_8.774278	218	298	0	80	80	1.0000000
NODE_46261_length_480_cov_8.774278	385	428	0	43	43	1.0000000
NODE_46271_length_480_cov_5.671916	231	302	0	71	71	1.0000000
NODE_46283_length_480_cov_4.354331	126	187	0	61	61	1.0000000
NODE_46283_length_480_cov_4.354331	218	298	0	80	80	1.0000000
NODE_46445_length_480_cov_1.152231	142	216	0	74	74	1.0000000
NODE_46470_length_480_cov_0.973753	31	71	0	40	40	1.0000000
NODE_46533_length_479_cov_28.205263	308	388	16	8	80	0.1000000
NODE_46533_length_479_cov_28.205263	308	388	17	4	80	0.0500000
NODE_46533_length_479_cov_28.205263	308	388	19	29	80	0.3625000
NODE_46533_length_479_cov_28.205263	308	388	20	33	80	0.4125000
NODE_46533_length_479_cov_28.205263	308	388	21	6	80	0.0750000
NODE_46533_length_479_cov_28.205263	361	441	6	19	80	0.2375000
NODE_46533_length_479_cov_28.205263	361	441	8	2	80	0.0250000
NODE_46533_length_479_cov_28.205263	361	441	10	1	80	0.0125000
NODE_46533_length_479_cov_28.205263	361	441	12	18	80	0.2250000
NODE_46533_length_479_cov_28.205263	361	441	14	1	80	0.0125000
NODE_46533_length_479_cov_28.205263	361	441	15	9	80	0.1125000
NODE_46533_length_479_cov_28.205263	361	441	16	11	80	0.1375000
NODE_46533_length_479_cov_28.205263	361	441	17	4	80	0.0500000
NODE_46533_length_479_cov_28.205263	361	441	19	7	80	0.0875000
NODE_46533_length_479_cov_28.205263	361	441	20	8	80	0.1000000
NODE_46534_length_479_cov_23.944737	189	269	1	19	80	0.2375000
NODE_46534_length_479_cov_23.944737	189	269	2	57	80	0.7125000
NODE_46534_length_479_cov_23.944737	189	269	3	4	80	0.0500000
NODE_46534_length_479_cov_23.944737	242	322	1	72	80	0.9000000
NODE_46534_length_479_cov_23.944737	242	322	2	4	80	0.0500000
NODE_46534_length_479_cov_23.944737	242	322	3	4	80	0.0500000
NODE_46554_length_479_cov_4.942105	283	363	1	19	80	0.2375000
NODE_46554_length_479_cov_4.942105	283	363	2	41	80	0.5125000
NODE_46554_length_479_cov_4.942105	283	363	4	20	80	0.2500000
NODE_46554_length_479_cov_4.942105	336	416	0	10	80	0.1250000
NODE_46554_length_479_cov_4.942105	336	416	1	62	80	0.7750000
NODE_46554_length_479_cov_4.942105	336	416	2	8	80	0.1000000
NODE_46574_length_479_cov_3.494737	217	279	0	40	62	0.6451613
NODE_46574_length_479_cov_3.494737	217	279	2	22	62	0.3548387
NODE_46574_length_479_cov_3.494737	272	332	0	60	60	1.0000000
NODE_46611_length_479_cov_2.281579	219	265	2	17	46	0.3695652
NODE_46611_length_479_cov_2.281579	219	265	3	14	46	0.3043478
NODE_46611_length_479_cov_2.281579	219	265	4	3	46	0.0652174
NODE_46611_length_479_cov_2.281579	219	265	5	12	46	0.2608696
NODE_46638_length_479_cov_1.839474	376	431	1	2	55	0.0363636
NODE_46638_length_479_cov_1.839474	376	431	2	2	55	0.0363636
NODE_46638_length_479_cov_1.839474	376	431	3	9	55	0.1636364
NODE_46638_length_479_cov_1.839474	376	431	4	29	55	0.5272727
NODE_46638_length_479_cov_1.839474	376	431	6	13	55	0.2363636
NODE_46654_length_479_cov_1.710526	203	265	0	62	62	1.0000000
NODE_46654_length_479_cov_1.710526	248	318	0	70	70	1.0000000
NODE_46828_length_478_cov_336.139842	153	233	45	3	80	0.0375000
NODE_46828_length_478_cov_336.139842	153	233	46	8	80	0.1000000
NODE_46828_length_478_cov_336.139842	153	233	47	3	80	0.0375000
NODE_46828_length_478_cov_336.139842	153	233	48	9	80	0.1125000
NODE_46828_length_478_cov_336.139842	153	233	49	9	80	0.1125000
NODE_46828_length_478_cov_336.139842	153	233	50	14	80	0.1750000
NODE_46828_length_478_cov_336.139842	153	233	51	1	80	0.0125000
NODE_46828_length_478_cov_336.139842	153	233	52	2	80	0.0250000
NODE_46828_length_478_cov_336.139842	153	233	55	1	80	0.0125000
NODE_46828_length_478_cov_336.139842	153	233	57	1	80	0.0125000
NODE_46828_length_478_cov_336.139842	153	233	58	7	80	0.0875000
NODE_46828_length_478_cov_336.139842	153	233	59	4	80	0.0500000
NODE_46828_length_478_cov_336.139842	153	233	60	3	80	0.0375000
NODE_46828_length_478_cov_336.139842	153	233	61	10	80	0.1250000
NODE_46828_length_478_cov_336.139842	153	233	62	4	80	0.0500000
NODE_46828_length_478_cov_336.139842	153	233	63	1	80	0.0125000
NODE_46828_length_478_cov_336.139842	206	286	47	6	80	0.0750000
NODE_46828_length_478_cov_336.139842	206	286	51	4	80	0.0500000
NODE_46828_length_478_cov_336.139842	206	286	52	5	80	0.0625000
NODE_46828_length_478_cov_336.139842	206	286	53	1	80	0.0125000
NODE_46828_length_478_cov_336.139842	206	286	55	3	80	0.0375000
NODE_46828_length_478_cov_336.139842	206	286	56	4	80	0.0500000
NODE_46828_length_478_cov_336.139842	206	286	57	5	80	0.0625000
NODE_46828_length_478_cov_336.139842	206	286	58	14	80	0.1750000
NODE_46828_length_478_cov_336.139842	206	286	59	13	80	0.1625000
NODE_46828_length_478_cov_336.139842	206	286	60	7	80	0.0875000
NODE_46828_length_478_cov_336.139842	206	286	61	11	80	0.1375000
NODE_46828_length_478_cov_336.139842	206	286	62	6	80	0.0750000
NODE_46828_length_478_cov_336.139842	206	286	63	1	80	0.0125000
NODE_46846_length_478_cov_4.448549	150	230	0	80	80	1.0000000
NODE_46846_length_478_cov_4.448549	203	284	0	81	81	1.0000000
NODE_46874_length_478_cov_2.627968	228	278	1	50	50	1.0000000
NODE_47128_length_477_cov_36.230159	225	305	4	42	80	0.5250000
NODE_47128_length_477_cov_36.230159	225	305	5	7	80	0.0875000
NODE_47128_length_477_cov_36.230159	225	305	7	14	80	0.1750000
NODE_47128_length_477_cov_36.230159	225	305	9	17	80	0.2125000
NODE_47128_length_477_cov_36.230159	278	358	6	1	80	0.0125000
NODE_47128_length_477_cov_36.230159	278	358	7	25	80	0.3125000
NODE_47128_length_477_cov_36.230159	278	358	8	2	80	0.0250000
NODE_47128_length_477_cov_36.230159	278	358	9	52	80	0.6500000
NODE_47129_length_477_cov_33.111111	307	387	18	17	80	0.2125000
NODE_47129_length_477_cov_33.111111	307	387	19	6	80	0.0750000
NODE_47129_length_477_cov_33.111111	307	387	20	4	80	0.0500000
NODE_47129_length_477_cov_33.111111	307	387	22	5	80	0.0625000
NODE_47129_length_477_cov_33.111111	307	387	23	4	80	0.0500000
NODE_47129_length_477_cov_33.111111	307	387	24	44	80	0.5500000
NODE_47129_length_477_cov_33.111111	360	440	1	4	80	0.0500000
NODE_47129_length_477_cov_33.111111	360	440	2	2	80	0.0250000
NODE_47129_length_477_cov_33.111111	360	440	3	5	80	0.0625000
NODE_47129_length_477_cov_33.111111	360	440	4	2	80	0.0250000
NODE_47129_length_477_cov_33.111111	360	440	5	1	80	0.0125000
NODE_47129_length_477_cov_33.111111	360	440	6	1	80	0.0125000
NODE_47129_length_477_cov_33.111111	360	440	7	4	80	0.0500000
NODE_47129_length_477_cov_33.111111	360	440	9	1	80	0.0125000
NODE_47129_length_477_cov_33.111111	360	440	10	2	80	0.0250000
NODE_47129_length_477_cov_33.111111	360	440	11	3	80	0.0375000
NODE_47129_length_477_cov_33.111111	360	440	12	9	80	0.1125000
NODE_47129_length_477_cov_33.111111	360	440	13	13	80	0.1625000
NODE_47129_length_477_cov_33.111111	360	440	15	2	80	0.0250000
NODE_47129_length_477_cov_33.111111	360	440	18	21	80	0.2625000
NODE_47129_length_477_cov_33.111111	360	440	19	6	80	0.0750000
NODE_47129_length_477_cov_33.111111	360	440	20	4	80	0.0500000
NODE_47133_length_477_cov_11.235450	119	199	2	44	80	0.5500000
NODE_47133_length_477_cov_11.235450	119	199	5	36	80	0.4500000
NODE_47133_length_477_cov_11.235450	172	247	3	38	75	0.5066667
NODE_47133_length_477_cov_11.235450	172	247	5	37	75	0.4933333
NODE_47135_length_477_cov_9.359788	221	301	3	2	80	0.0250000
NODE_47135_length_477_cov_9.359788	221	301	4	57	80	0.7125000
NODE_47135_length_477_cov_9.359788	221	301	5	21	80	0.2625000
NODE_47135_length_477_cov_9.359788	274	354	1	7	80	0.0875000
NODE_47135_length_477_cov_9.359788	274	354	2	25	80	0.3125000
NODE_47135_length_477_cov_9.359788	274	354	3	23	80	0.2875000
NODE_47135_length_477_cov_9.359788	274	354	4	4	80	0.0500000
NODE_47135_length_477_cov_9.359788	274	354	5	21	80	0.2625000
NODE_47139_length_477_cov_7.436508	230	304	2	65	74	0.8783784
NODE_47139_length_477_cov_7.436508	230	304	3	9	74	0.1216216
NODE_47140_length_477_cov_7.433862	43	123	2	46	80	0.5750000
NODE_47140_length_477_cov_7.433862	43	123	4	34	80	0.4250000
NODE_47140_length_477_cov_7.433862	96	176	2	61	80	0.7625000
NODE_47140_length_477_cov_7.433862	96	176	4	19	80	0.2375000
NODE_47143_length_477_cov_6.846561	163	243	0	30	80	0.3750000
NODE_47143_length_477_cov_6.846561	163	243	2	50	80	0.6250000
NODE_47143_length_477_cov_6.846561	216	296	0	14	80	0.1750000
NODE_47143_length_477_cov_6.846561	216	296	2	66	80	0.8250000
NODE_47147_length_477_cov_5.677249	150	228	0	78	78	1.0000000
NODE_47148_length_477_cov_5.084656	227	288	0	19	61	0.3114754
NODE_47148_length_477_cov_5.084656	227	288	1	42	61	0.6885246
NODE_47253_length_477_cov_1.629630	115	171	0	7	56	0.1250000
NODE_47253_length_477_cov_1.629630	115	171	1	49	56	0.8750000
NODE_47253_length_477_cov_1.629630	167	224	1	57	57	1.0000000
NODE_47375_length_477_cov_0.859788	445	477	0	32	32	1.0000000
NODE_47427_length_476_cov_7.533156	221	301	2	80	80	1.0000000
NODE_47427_length_476_cov_7.533156	274	354	1	10	80	0.1250000
NODE_47427_length_476_cov_7.533156	274	354	2	70	80	0.8750000
NODE_47529_length_476_cov_1.618037	385	444	0	59	59	1.0000000
NODE_47601_length_476_cov_1.129973	15	34	0	19	19	1.0000000
NODE_47620_length_476_cov_1.037135	180	243	2	36	63	0.5714286
NODE_47620_length_476_cov_1.037135	180	243	3	5	63	0.0793651
NODE_47620_length_476_cov_1.037135	180	243	4	22	63	0.3492064
NODE_47620_length_476_cov_1.037135	237	296	2	59	59	1.0000000
NODE_47693_length_475_cov_34.460106	270	350	0	80	80	1.0000000
NODE_47693_length_475_cov_34.460106	323	403	0	80	80	1.0000000
NODE_47694_length_475_cov_30.087766	273	353	0	63	80	0.7875000
NODE_47694_length_475_cov_30.087766	273	353	2	17	80	0.2125000
NODE_47694_length_475_cov_30.087766	326	406	0	10	80	0.1250000
NODE_47694_length_475_cov_30.087766	326	406	2	70	80	0.8750000
NODE_47695_length_475_cov_10.247340	42	122	0	80	80	1.0000000
NODE_47701_length_475_cov_8.393617	9	89	0	18	80	0.2250000
NODE_47701_length_475_cov_8.393617	9	89	1	62	80	0.7750000
NODE_47701_length_475_cov_8.393617	62	142	1	80	80	1.0000000
NODE_47828_length_475_cov_1.531915	272	352	0	80	80	1.0000000
NODE_47839_length_475_cov_1.457447	50	93	0	43	43	1.0000000
NODE_47979_length_474_cov_49.453333	392	472	5	5	80	0.0625000
NODE_47979_length_474_cov_49.453333	392	472	10	3	80	0.0375000
NODE_47979_length_474_cov_49.453333	392	472	11	14	80	0.1750000
NODE_47979_length_474_cov_49.453333	392	472	12	4	80	0.0500000
NODE_47979_length_474_cov_49.453333	392	472	13	4	80	0.0500000
NODE_47979_length_474_cov_49.453333	392	472	15	1	80	0.0125000
NODE_47979_length_474_cov_49.453333	392	472	17	2	80	0.0250000
NODE_47979_length_474_cov_49.453333	392	472	19	1	80	0.0125000
NODE_47979_length_474_cov_49.453333	392	472	20	10	80	0.1250000
NODE_47979_length_474_cov_49.453333	392	472	21	3	80	0.0375000
NODE_47979_length_474_cov_49.453333	392	472	22	3	80	0.0375000
NODE_47979_length_474_cov_49.453333	392	472	23	5	80	0.0625000
NODE_47979_length_474_cov_49.453333	392	472	25	4	80	0.0500000
NODE_47979_length_474_cov_49.453333	392	472	26	9	80	0.1125000
NODE_47979_length_474_cov_49.453333	392	472	27	2	80	0.0250000
NODE_47979_length_474_cov_49.453333	392	472	28	7	80	0.0875000
NODE_47979_length_474_cov_49.453333	392	472	29	1	80	0.0125000
NODE_47979_length_474_cov_49.453333	392	472	30	1	80	0.0125000
NODE_47979_length_474_cov_49.453333	392	472	32	1	80	0.0125000
NODE_47979_length_474_cov_49.453333	445	474	2	2	29	0.0689655
NODE_47979_length_474_cov_49.453333	445	474	5	5	29	0.1724138
NODE_47979_length_474_cov_49.453333	445	474	10	3	29	0.1034483
NODE_47979_length_474_cov_49.453333	445	474	11	14	29	0.4827586
NODE_47979_length_474_cov_49.453333	445	474	12	4	29	0.1379310
NODE_47979_length_474_cov_49.453333	445	474	13	1	29	0.0344828
NODE_47981_length_474_cov_24.930667	287	367	2	10	80	0.1250000
NODE_47981_length_474_cov_24.930667	287	367	4	19	80	0.2375000
NODE_47981_length_474_cov_24.930667	287	367	6	51	80	0.6375000
NODE_47981_length_474_cov_24.930667	340	420	4	56	80	0.7000000
NODE_47981_length_474_cov_24.930667	340	420	6	24	80	0.3000000
NODE_47982_length_474_cov_15.952000	258	338	2	36	80	0.4500000
NODE_47982_length_474_cov_15.952000	258	338	4	44	80	0.5500000
NODE_47982_length_474_cov_15.952000	311	391	0	9	80	0.1125000
NODE_47982_length_474_cov_15.952000	311	391	2	30	80	0.3750000
NODE_47982_length_474_cov_15.952000	311	391	3	1	80	0.0125000
NODE_47982_length_474_cov_15.952000	311	391	4	40	80	0.5000000
NODE_48003_length_474_cov_3.986667	172	252	8	80	80	1.0000000
NODE_48015_length_474_cov_3.496000	163	243	1	14	80	0.1750000
NODE_48015_length_474_cov_3.496000	163	243	2	66	80	0.8250000
NODE_48038_length_474_cov_2.784000	259	300	0	10	41	0.2439024
NODE_48038_length_474_cov_2.784000	259	300	1	15	41	0.3658537
NODE_48038_length_474_cov_2.784000	259	300	2	16	41	0.3902439
NODE_48116_length_474_cov_1.538667	41	62	0	21	21	1.0000000
NODE_48181_length_474_cov_1.085333	0	50	0	50	50	1.0000000
NODE_48184_length_474_cov_1.056000	95	133	0	19	38	0.5000000
NODE_48184_length_474_cov_1.056000	95	133	2	19	38	0.5000000
NODE_48266_length_473_cov_82.374332	123	203	8	7	80	0.0875000
NODE_48266_length_473_cov_82.374332	123	203	9	8	80	0.1000000
NODE_48266_length_473_cov_82.374332	123	203	10	10	80	0.1250000
NODE_48266_length_473_cov_82.374332	123	203	13	40	80	0.5000000
NODE_48266_length_473_cov_82.374332	123	203	14	1	80	0.0125000
NODE_48266_length_473_cov_82.374332	123	203	15	14	80	0.1750000
NODE_48266_length_473_cov_82.374332	176	256	4	6	80	0.0750000
NODE_48266_length_473_cov_82.374332	176	256	5	7	80	0.0875000
NODE_48266_length_473_cov_82.374332	176	256	6	17	80	0.2125000
NODE_48266_length_473_cov_82.374332	176	256	7	9	80	0.1125000
NODE_48266_length_473_cov_82.374332	176	256	8	19	80	0.2375000
NODE_48266_length_473_cov_82.374332	176	256	9	10	80	0.1250000
NODE_48266_length_473_cov_82.374332	176	256	10	10	80	0.1250000
NODE_48266_length_473_cov_82.374332	176	256	13	2	80	0.0250000
NODE_48267_length_473_cov_54.882353	199	279	0	10	80	0.1250000
NODE_48267_length_473_cov_54.882353	199	279	2	70	80	0.8750000
NODE_48267_length_473_cov_54.882353	252	332	2	80	80	1.0000000
NODE_48268_length_473_cov_48.997326	119	194	0	14	75	0.1866667
NODE_48268_length_473_cov_48.997326	119	194	1	48	75	0.6400000
NODE_48268_length_473_cov_48.997326	119	194	2	7	75	0.0933333
NODE_48268_length_473_cov_48.997326	119	194	3	6	75	0.0800000
NODE_48268_length_473_cov_48.997326	119	194	0	14	75	0.1866667
NODE_48268_length_473_cov_48.997326	119	194	1	48	75	0.6400000
NODE_48268_length_473_cov_48.997326	119	194	2	7	75	0.0933333
NODE_48268_length_473_cov_48.997326	119	194	3	6	75	0.0800000
NODE_48268_length_473_cov_48.997326	167	247	1	14	80	0.1750000
NODE_48268_length_473_cov_48.997326	167	247	2	7	80	0.0875000
NODE_48268_length_473_cov_48.997326	167	247	3	59	80	0.7375000
NODE_48269_length_473_cov_30.679144	174	254	4	40	80	0.5000000
NODE_48269_length_473_cov_30.679144	174	254	6	13	80	0.1625000
NODE_48269_length_473_cov_30.679144	174	254	7	9	80	0.1125000
NODE_48269_length_473_cov_30.679144	174	254	8	6	80	0.0750000
NODE_48269_length_473_cov_30.679144	174	254	9	2	80	0.0250000
NODE_48269_length_473_cov_30.679144	174	254	10	10	80	0.1250000
NODE_48269_length_473_cov_30.679144	226	307	4	81	81	1.0000000
NODE_48269_length_473_cov_30.679144	227	307	4	80	80	1.0000000
NODE_48270_length_473_cov_24.967914	295	370	2	25	75	0.3333333
NODE_48270_length_473_cov_24.967914	295	370	3	14	75	0.1866667
NODE_48270_length_473_cov_24.967914	295	370	4	36	75	0.4800000
NODE_48270_length_473_cov_24.967914	343	423	2	19	80	0.2375000
NODE_48270_length_473_cov_24.967914	343	423	3	48	80	0.6000000
NODE_48270_length_473_cov_24.967914	343	423	4	13	80	0.1625000
NODE_48271_length_473_cov_18.540107	168	248	1	28	80	0.3500000
NODE_48271_length_473_cov_18.540107	168	248	2	15	80	0.1875000
NODE_48271_length_473_cov_18.540107	168	248	3	37	80	0.4625000
NODE_48271_length_473_cov_18.540107	221	301	2	25	80	0.3125000
NODE_48271_length_473_cov_18.540107	221	301	3	50	80	0.6250000
NODE_48271_length_473_cov_18.540107	221	301	4	5	80	0.0625000
NODE_48272_length_473_cov_15.871658	143	223	1	65	80	0.8125000
NODE_48272_length_473_cov_15.871658	143	223	2	15	80	0.1875000
NODE_48272_length_473_cov_15.871658	196	276	1	80	80	1.0000000
NODE_48291_length_473_cov_4.363636	160	240	0	69	80	0.8625000
NODE_48291_length_473_cov_4.363636	160	240	1	11	80	0.1375000
NODE_48291_length_473_cov_4.363636	213	293	0	80	80	1.0000000
NODE_48320_length_473_cov_2.959893	199	267	0	11	68	0.1617647
NODE_48320_length_473_cov_2.959893	199	267	2	57	68	0.8382353
NODE_48325_length_473_cov_2.804813	207	269	1	39	62	0.6290323
NODE_48325_length_473_cov_2.804813	207	269	2	23	62	0.3709677
NODE_48350_length_473_cov_2.251337	48	128	2	33	80	0.4125000
NODE_48350_length_473_cov_2.251337	48	128	3	5	80	0.0625000
NODE_48350_length_473_cov_2.251337	48	128	4	42	80	0.5250000
NODE_48350_length_473_cov_2.251337	101	181	2	80	80	1.0000000
NODE_48568_length_472_cov_50.077748	1	81	0	3	80	0.0375000
NODE_48568_length_472_cov_50.077748	1	81	1	2	80	0.0250000
NODE_48568_length_472_cov_50.077748	1	81	2	4	80	0.0500000
NODE_48568_length_472_cov_50.077748	1	81	3	1	80	0.0125000
NODE_48568_length_472_cov_50.077748	1	81	4	1	80	0.0125000
NODE_48568_length_472_cov_50.077748	1	81	5	28	80	0.3500000
NODE_48568_length_472_cov_50.077748	1	81	7	40	80	0.5000000
NODE_48568_length_472_cov_50.077748	1	81	8	1	80	0.0125000
NODE_48568_length_472_cov_50.077748	1	81	0	3	80	0.0375000
NODE_48568_length_472_cov_50.077748	1	81	1	2	80	0.0250000
NODE_48568_length_472_cov_50.077748	1	81	2	4	80	0.0500000
NODE_48568_length_472_cov_50.077748	1	81	3	1	80	0.0125000
NODE_48568_length_472_cov_50.077748	1	81	4	1	80	0.0125000
NODE_48568_length_472_cov_50.077748	1	81	5	28	80	0.3500000
NODE_48568_length_472_cov_50.077748	1	81	7	40	80	0.5000000
NODE_48568_length_472_cov_50.077748	1	81	8	1	80	0.0125000
NODE_48568_length_472_cov_50.077748	1	81	0	3	80	0.0375000
NODE_48568_length_472_cov_50.077748	1	81	1	2	80	0.0250000
NODE_48568_length_472_cov_50.077748	1	81	2	4	80	0.0500000
NODE_48568_length_472_cov_50.077748	1	81	3	1	80	0.0125000
NODE_48568_length_472_cov_50.077748	1	81	4	1	80	0.0125000
NODE_48568_length_472_cov_50.077748	1	81	5	28	80	0.3500000
NODE_48568_length_472_cov_50.077748	1	81	7	40	80	0.5000000
NODE_48568_length_472_cov_50.077748	1	81	8	1	80	0.0125000
NODE_48568_length_472_cov_50.077748	1	81	0	3	80	0.0375000
NODE_48568_length_472_cov_50.077748	1	81	1	2	80	0.0250000
NODE_48568_length_472_cov_50.077748	1	81	2	4	80	0.0500000
NODE_48568_length_472_cov_50.077748	1	81	3	1	80	0.0125000
NODE_48568_length_472_cov_50.077748	1	81	4	1	80	0.0125000
NODE_48568_length_472_cov_50.077748	1	81	5	28	80	0.3500000
NODE_48568_length_472_cov_50.077748	1	81	7	40	80	0.5000000
NODE_48568_length_472_cov_50.077748	1	81	8	1	80	0.0125000
NODE_48568_length_472_cov_50.077748	1	81	0	3	80	0.0375000
NODE_48568_length_472_cov_50.077748	1	81	1	2	80	0.0250000
NODE_48568_length_472_cov_50.077748	1	81	2	4	80	0.0500000
NODE_48568_length_472_cov_50.077748	1	81	3	1	80	0.0125000
NODE_48568_length_472_cov_50.077748	1	81	4	1	80	0.0125000
NODE_48568_length_472_cov_50.077748	1	81	5	28	80	0.3500000
NODE_48568_length_472_cov_50.077748	1	81	7	40	80	0.5000000
NODE_48568_length_472_cov_50.077748	1	81	8	1	80	0.0125000
NODE_48568_length_472_cov_50.077748	10	81	3	1	71	0.0140845
NODE_48568_length_472_cov_50.077748	10	81	4	1	71	0.0140845
NODE_48568_length_472_cov_50.077748	10	81	5	28	71	0.3943662
NODE_48568_length_472_cov_50.077748	10	81	7	40	71	0.5633803
NODE_48568_length_472_cov_50.077748	10	81	8	1	71	0.0140845
NODE_48568_length_472_cov_50.077748	54	131	7	26	77	0.3376623
NODE_48568_length_472_cov_50.077748	54	131	8	51	77	0.6623377
NODE_48568_length_472_cov_50.077748	54	131	7	26	77	0.3376623
NODE_48568_length_472_cov_50.077748	54	131	8	51	77	0.6623377
NODE_48568_length_472_cov_50.077748	54	131	7	26	77	0.3376623
NODE_48568_length_472_cov_50.077748	54	131	8	51	77	0.6623377
NODE_48568_length_472_cov_50.077748	130	204	2	42	74	0.5675676
NODE_48568_length_472_cov_50.077748	130	204	3	1	74	0.0135135
NODE_48568_length_472_cov_50.077748	130	204	4	2	74	0.0270270
NODE_48568_length_472_cov_50.077748	130	204	5	3	74	0.0405405
NODE_48568_length_472_cov_50.077748	130	204	6	3	74	0.0405405
NODE_48568_length_472_cov_50.077748	130	204	7	6	74	0.0810811
NODE_48568_length_472_cov_50.077748	130	204	8	17	74	0.2297297
NODE_48569_length_472_cov_10.469169	294	374	1	35	80	0.4375000
NODE_48569_length_472_cov_10.469169	294	374	2	45	80	0.5625000
NODE_48569_length_472_cov_10.469169	347	427	0	40	80	0.5000000
NODE_48569_length_472_cov_10.469169	347	427	1	40	80	0.5000000
NODE_48570_length_472_cov_10.195710	143	223	0	80	80	1.0000000
NODE_48570_length_472_cov_10.195710	196	276	0	80	80	1.0000000
NODE_48593_length_472_cov_4.375335	165	245	2	80	80	1.0000000
NODE_48593_length_472_cov_4.375335	218	251	0	4	33	0.1212121
NODE_48593_length_472_cov_4.375335	218	251	2	29	33	0.8787879
NODE_48614_length_472_cov_3.495979	305	349	0	44	44	1.0000000
NODE_48620_length_472_cov_3.093834	220	295	3	19	75	0.2533333
NODE_48620_length_472_cov_3.093834	220	295	5	56	75	0.7466667
NODE_48638_length_472_cov_2.592493	431	471	0	40	40	1.0000000
NODE_48745_length_472_cov_1.294906	43	98	3	6	55	0.1090909
NODE_48745_length_472_cov_1.294906	43	98	4	20	55	0.3636364
NODE_48745_length_472_cov_1.294906	43	98	5	29	55	0.5272727
NODE_48745_length_472_cov_1.294906	71	151	3	10	80	0.1250000
NODE_48745_length_472_cov_1.294906	71	151	5	70	80	0.8750000
NODE_48768_length_472_cov_1.211796	106	126	0	20	20	1.0000000
NODE_48873_length_471_cov_39.319892	119	193	0	71	74	0.9594595
NODE_48873_length_471_cov_39.319892	119	193	1	2	74	0.0270270
NODE_48873_length_471_cov_39.319892	119	193	4	1	74	0.0135135
NODE_48874_length_471_cov_24.279570	185	265	1	20	80	0.2500000
NODE_48874_length_471_cov_24.279570	185	265	2	60	80	0.7500000
NODE_48874_length_471_cov_24.279570	238	318	1	67	80	0.8375000
NODE_48874_length_471_cov_24.279570	238	318	2	13	80	0.1625000
NODE_48875_length_471_cov_19.669355	83	163	7	6	80	0.0750000
NODE_48875_length_471_cov_19.669355	83	163	8	7	80	0.0875000
NODE_48875_length_471_cov_19.669355	83	163	10	1	80	0.0125000
NODE_48875_length_471_cov_19.669355	83	163	11	5	80	0.0625000
NODE_48875_length_471_cov_19.669355	83	163	12	5	80	0.0625000
NODE_48875_length_471_cov_19.669355	83	163	13	9	80	0.1125000
NODE_48875_length_471_cov_19.669355	83	163	14	11	80	0.1375000
NODE_48875_length_471_cov_19.669355	83	163	15	1	80	0.0125000
NODE_48875_length_471_cov_19.669355	83	163	16	2	80	0.0250000
NODE_48875_length_471_cov_19.669355	83	163	17	23	80	0.2875000
NODE_48875_length_471_cov_19.669355	83	163	18	10	80	0.1250000
NODE_48875_length_471_cov_19.669355	136	216	14	8	80	0.1000000
NODE_48875_length_471_cov_19.669355	136	216	15	18	80	0.2250000
NODE_48875_length_471_cov_19.669355	136	216	16	10	80	0.1250000
NODE_48875_length_471_cov_19.669355	136	216	17	36	80	0.4500000
NODE_48875_length_471_cov_19.669355	136	216	18	8	80	0.1000000
NODE_48876_length_471_cov_14.387097	198	278	0	80	80	1.0000000
NODE_48876_length_471_cov_14.387097	251	331	0	80	80	1.0000000
NODE_48881_length_471_cov_6.948925	186	213	0	27	27	1.0000000
NODE_48881_length_471_cov_6.948925	204	284	0	80	80	1.0000000
NODE_48881_length_471_cov_6.948925	244	275	0	31	31	1.0000000
NODE_48881_length_471_cov_6.948925	257	337	0	80	80	1.0000000
NODE_48881_length_471_cov_6.948925	268	337	0	69	69	1.0000000
NODE_48902_length_471_cov_3.803763	83	162	0	11	79	0.1392405
NODE_48902_length_471_cov_3.803763	83	162	1	23	79	0.2911392
NODE_48902_length_471_cov_3.803763	83	162	2	45	79	0.5696203
NODE_48902_length_471_cov_3.803763	135	215	2	80	80	1.0000000
NODE_48924_length_471_cov_2.954301	284	315	0	3	31	0.0967742
NODE_48924_length_471_cov_2.954301	284	315	1	28	31	0.9032258
NODE_48957_length_471_cov_2.287634	133	200	1	53	67	0.7910448
NODE_48957_length_471_cov_2.287634	133	200	2	14	67	0.2089552
NODE_49186_length_470_cov_57.078167	184	264	1	75	80	0.9375000
NODE_49186_length_470_cov_57.078167	184	264	2	5	80	0.0625000
NODE_49186_length_470_cov_57.078167	237	317	1	22	80	0.2750000
NODE_49186_length_470_cov_57.078167	237	317	2	41	80	0.5125000
NODE_49186_length_470_cov_57.078167	237	317	4	7	80	0.0875000
NODE_49186_length_470_cov_57.078167	237	317	5	10	80	0.1250000
NODE_49186_length_470_cov_57.078167	313	393	4	43	80	0.5375000
NODE_49186_length_470_cov_57.078167	313	393	5	6	80	0.0750000
NODE_49186_length_470_cov_57.078167	313	393	6	31	80	0.3875000
NODE_49186_length_470_cov_57.078167	366	446	1	27	80	0.3375000
NODE_49186_length_470_cov_57.078167	366	446	3	6	80	0.0750000
NODE_49186_length_470_cov_57.078167	366	446	5	4	80	0.0500000
NODE_49186_length_470_cov_57.078167	366	446	6	43	80	0.5375000
NODE_49187_length_470_cov_34.035040	228	308	0	80	80	1.0000000
NODE_49187_length_470_cov_34.035040	281	361	0	80	80	1.0000000
NODE_49187_length_470_cov_34.035040	357	437	0	80	80	1.0000000
NODE_49187_length_470_cov_34.035040	410	470	0	60	60	1.0000000
NODE_49188_length_470_cov_15.539084	142	222	4	9	80	0.1125000
NODE_49188_length_470_cov_15.539084	142	222	6	71	80	0.8875000
NODE_49188_length_470_cov_15.539084	195	275	2	1	80	0.0125000
NODE_49188_length_470_cov_15.539084	195	275	3	6	80	0.0750000
NODE_49188_length_470_cov_15.539084	195	275	4	41	80	0.5125000
NODE_49188_length_470_cov_15.539084	195	275	6	32	80	0.4000000
NODE_49193_length_470_cov_6.070081	272	330	9	5	58	0.0862069
NODE_49193_length_470_cov_6.070081	272	330	10	1	58	0.0172414
NODE_49193_length_470_cov_6.070081	272	330	12	3	58	0.0517241
NODE_49193_length_470_cov_6.070081	272	330	13	4	58	0.0689655
NODE_49193_length_470_cov_6.070081	272	330	14	2	58	0.0344828
NODE_49193_length_470_cov_6.070081	272	330	15	1	58	0.0172414
NODE_49193_length_470_cov_6.070081	272	330	16	9	58	0.1551724
NODE_49193_length_470_cov_6.070081	272	330	18	2	58	0.0344828
NODE_49193_length_470_cov_6.070081	272	330	19	31	58	0.5344828
NODE_49193_length_470_cov_6.070081	325	383	0	8	58	0.1379310
NODE_49193_length_470_cov_6.070081	325	383	1	3	58	0.0517241
NODE_49193_length_470_cov_6.070081	325	383	2	20	58	0.3448276
NODE_49193_length_470_cov_6.070081	325	383	4	3	58	0.0517241
NODE_49193_length_470_cov_6.070081	325	383	5	1	58	0.0172414
NODE_49193_length_470_cov_6.070081	325	383	6	2	58	0.0344828
NODE_49193_length_470_cov_6.070081	325	383	7	2	58	0.0344828
NODE_49193_length_470_cov_6.070081	325	383	8	4	58	0.0689655
NODE_49193_length_470_cov_6.070081	325	383	9	15	58	0.2586207
NODE_49215_length_470_cov_3.735849	194	251	0	57	57	1.0000000
NODE_49260_length_470_cov_2.363881	403	422	2	19	19	1.0000000
NODE_49260_length_470_cov_2.363881	403	422	2	19	19	1.0000000
NODE_49389_length_470_cov_1.142857	414	470	0	56	56	1.0000000
NODE_49502_length_469_cov_221.024324	150	228	24	9	78	0.1153846
NODE_49502_length_469_cov_221.024324	150	228	25	6	78	0.0769231
NODE_49502_length_469_cov_221.024324	150	228	26	16	78	0.2051282
NODE_49502_length_469_cov_221.024324	150	228	27	9	78	0.1153846
NODE_49502_length_469_cov_221.024324	150	228	28	15	78	0.1923077
NODE_49502_length_469_cov_221.024324	150	228	29	7	78	0.0897436
NODE_49502_length_469_cov_221.024324	150	228	30	5	78	0.0641026
NODE_49502_length_469_cov_221.024324	150	228	31	2	78	0.0256410
NODE_49502_length_469_cov_221.024324	150	228	32	5	78	0.0641026
NODE_49502_length_469_cov_221.024324	150	228	33	4	78	0.0512821
NODE_49502_length_469_cov_221.024324	150	228	24	9	78	0.1153846
NODE_49502_length_469_cov_221.024324	150	228	25	6	78	0.0769231
NODE_49502_length_469_cov_221.024324	150	228	26	16	78	0.2051282
NODE_49502_length_469_cov_221.024324	150	228	27	9	78	0.1153846
NODE_49502_length_469_cov_221.024324	150	228	28	15	78	0.1923077
NODE_49502_length_469_cov_221.024324	150	228	29	7	78	0.0897436
NODE_49502_length_469_cov_221.024324	150	228	30	5	78	0.0641026
NODE_49502_length_469_cov_221.024324	150	228	31	2	78	0.0256410
NODE_49502_length_469_cov_221.024324	150	228	32	5	78	0.0641026
NODE_49502_length_469_cov_221.024324	150	228	33	4	78	0.0512821
NODE_49502_length_469_cov_221.024324	150	219	24	9	69	0.1304348
NODE_49502_length_469_cov_221.024324	150	219	25	6	69	0.0869565
NODE_49502_length_469_cov_221.024324	150	219	26	14	69	0.2028985
NODE_49502_length_469_cov_221.024324	150	219	27	9	69	0.1304348
NODE_49502_length_469_cov_221.024324	150	219	28	13	69	0.1884058
NODE_49502_length_469_cov_221.024324	150	219	29	7	69	0.1014493
NODE_49502_length_469_cov_221.024324	150	219	31	2	69	0.0289855
NODE_49502_length_469_cov_221.024324	150	219	32	5	69	0.0724638
NODE_49502_length_469_cov_221.024324	150	219	33	4	69	0.0579710
NODE_49557_length_469_cov_2.686486	263	343	0	80	80	1.0000000
NODE_49561_length_469_cov_2.521622	237	289	0	52	52	1.0000000
NODE_49579_length_469_cov_2.224324	279	331	0	52	52	1.0000000
NODE_49796_length_468_cov_8.043360	190	250	0	60	60	1.0000000
NODE_49796_length_468_cov_8.043360	223	303	0	80	80	1.0000000
NODE_49800_length_468_cov_6.046070	152	232	0	80	80	1.0000000
NODE_49800_length_468_cov_6.046070	205	285	0	80	80	1.0000000
NODE_49801_length_468_cov_5.997290	81	161	0	11	80	0.1375000
NODE_49801_length_468_cov_5.997290	81	161	1	69	80	0.8625000
NODE_49801_length_468_cov_5.997290	134	214	1	80	80	1.0000000
NODE_49801_length_468_cov_5.997290	210	270	0	22	60	0.3666667
NODE_49801_length_468_cov_5.997290	210	270	1	38	60	0.6333333
NODE_49803_length_468_cov_5.872629	133	201	0	68	68	1.0000000
NODE_49807_length_468_cov_5.384824	305	356	0	51	51	1.0000000
NODE_49894_length_468_cov_2.067751	45	96	4	51	51	1.0000000
NODE_49913_length_468_cov_1.891599	4	63	0	59	59	1.0000000
NODE_49928_length_468_cov_1.758808	140	218	0	50	78	0.6410257
NODE_49928_length_468_cov_1.758808	140	218	2	28	78	0.3589744
NODE_49928_length_468_cov_1.758808	191	257	0	66	66	1.0000000
NODE_49974_length_468_cov_1.390244	291	310	0	19	19	1.0000000
NODE_49974_length_468_cov_1.390244	369	405	0	36	36	1.0000000
NODE_50133_length_467_cov_14.100543	176	256	0	80	80	1.0000000
NODE_50134_length_467_cov_11.902174	193	236	2	13	43	0.3023256
NODE_50134_length_467_cov_11.902174	193	236	4	30	43	0.6976744
NODE_50135_length_467_cov_10.875000	226	306	0	80	80	1.0000000
NODE_50135_length_467_cov_10.875000	279	359	0	80	80	1.0000000
NODE_50144_length_467_cov_6.625000	206	275	0	69	69	1.0000000
NODE_50144_length_467_cov_6.625000	257	328	0	34	71	0.4788733
NODE_50144_length_467_cov_6.625000	257	328	2	37	71	0.5211267
NODE_50197_length_467_cov_2.709239	247	327	1	68	80	0.8500000
NODE_50197_length_467_cov_2.709239	247	327	2	12	80	0.1500000
NODE_50215_length_467_cov_2.296196	284	329	0	45	45	1.0000000
NODE_50238_length_467_cov_2.027174	218	269	0	51	51	1.0000000
NODE_50252_length_467_cov_1.836957	55	118	3	59	63	0.9365079
NODE_50252_length_467_cov_1.836957	55	118	5	4	63	0.0634921
NODE_50267_length_467_cov_1.603261	92	141	2	1	49	0.0204082
NODE_50267_length_467_cov_1.603261	92	141	4	48	49	0.9795918
NODE_50283_length_467_cov_1.426630	135	183	1	22	48	0.4583333
NODE_50283_length_467_cov_1.426630	135	183	2	26	48	0.5416667
NODE_50447_length_466_cov_42.839237	0	47	0	47	47	1.0000000
NODE_50447_length_466_cov_42.839237	20	100	0	51	80	0.6375000
NODE_50447_length_466_cov_42.839237	20	100	1	29	80	0.3625000
NODE_50447_length_466_cov_42.839237	96	176	1	6	80	0.0750000
NODE_50447_length_466_cov_42.839237	96	176	2	8	80	0.1000000
NODE_50447_length_466_cov_42.839237	96	176	3	9	80	0.1125000
NODE_50447_length_466_cov_42.839237	96	176	4	45	80	0.5625000
NODE_50447_length_466_cov_42.839237	96	176	5	12	80	0.1500000
NODE_50447_length_466_cov_42.839237	149	229	4	15	80	0.1875000
NODE_50447_length_466_cov_42.839237	149	229	5	34	80	0.4250000
NODE_50447_length_466_cov_42.839237	149	229	6	31	80	0.3875000
NODE_50448_length_466_cov_36.901907	85	165	3	62	80	0.7750000
NODE_50448_length_466_cov_36.901907	85	165	4	18	80	0.2250000
NODE_50448_length_466_cov_36.901907	138	218	2	13	80	0.1625000
NODE_50448_length_466_cov_36.901907	138	218	3	32	80	0.4000000
NODE_50448_length_466_cov_36.901907	138	218	4	35	80	0.4375000
NODE_50448_length_466_cov_36.901907	214	294	0	7	80	0.0875000
NODE_50448_length_466_cov_36.901907	214	294	1	61	80	0.7625000
NODE_50448_length_466_cov_36.901907	214	294	2	12	80	0.1500000
NODE_50448_length_466_cov_36.901907	267	347	0	60	80	0.7500000
NODE_50448_length_466_cov_36.901907	267	347	1	20	80	0.2500000
NODE_50457_length_466_cov_5.122616	275	316	0	41	41	1.0000000
NODE_50457_length_466_cov_5.122616	276	316	0	40	40	1.0000000
NODE_50457_length_466_cov_5.122616	289	338	0	49	49	1.0000000
NODE_50515_length_466_cov_2.602180	9	90	0	81	81	1.0000000
NODE_50515_length_466_cov_2.602180	312	341	0	29	29	1.0000000
NODE_50549_length_466_cov_2.108992	130	182	2	52	52	1.0000000
NODE_50562_length_466_cov_1.980926	183	265	0	35	82	0.4268293
NODE_50562_length_466_cov_1.980926	183	265	1	47	82	0.5731707
NODE_50787_length_465_cov_13.019126	170	250	3	40	80	0.5000000
NODE_50787_length_465_cov_13.019126	170	250	4	38	80	0.4750000
NODE_50787_length_465_cov_13.019126	170	250	5	2	80	0.0250000
NODE_50787_length_465_cov_13.019126	223	301	3	53	78	0.6794872
NODE_50787_length_465_cov_13.019126	223	301	4	23	78	0.2948718
NODE_50787_length_465_cov_13.019126	223	301	5	2	78	0.0256410
NODE_50799_length_465_cov_5.363388	316	393	0	77	77	1.0000000
NODE_50800_length_465_cov_4.898907	376	406	0	30	30	1.0000000
NODE_50869_length_465_cov_2.366120	147	227	0	80	80	1.0000000
NODE_50869_length_465_cov_2.366120	200	271	0	71	71	1.0000000
NODE_50911_length_465_cov_1.737705	338	383	0	45	45	1.0000000
NODE_51100_length_464_cov_8.473973	209	289	0	80	80	1.0000000
NODE_51100_length_464_cov_8.473973	262	342	0	80	80	1.0000000
NODE_51148_length_464_cov_2.528767	136	199	0	63	63	1.0000000
NODE_51167_length_464_cov_2.134247	130	203	0	73	73	1.0000000
NODE_51186_length_464_cov_1.901370	58	138	0	29	80	0.3625000
NODE_51186_length_464_cov_1.901370	58	138	1	51	80	0.6375000
NODE_51203_length_464_cov_1.706849	186	265	1	5	79	0.0632911
NODE_51203_length_464_cov_1.706849	186	265	3	40	79	0.5063291
NODE_51203_length_464_cov_1.706849	186	265	4	34	79	0.4303797
NODE_51377_length_463_cov_64.420330	375	455	1	13	80	0.1625000
NODE_51377_length_463_cov_64.420330	375	455	2	67	80	0.8375000
NODE_51377_length_463_cov_64.420330	375	455	1	13	80	0.1625000
NODE_51377_length_463_cov_64.420330	375	455	2	67	80	0.8375000
NODE_51377_length_463_cov_64.420330	375	455	1	13	80	0.1625000
NODE_51377_length_463_cov_64.420330	375	455	2	67	80	0.8375000
NODE_51377_length_463_cov_64.420330	375	455	1	13	80	0.1625000
NODE_51377_length_463_cov_64.420330	375	455	2	67	80	0.8375000
NODE_51377_length_463_cov_64.420330	375	455	1	13	80	0.1625000
NODE_51377_length_463_cov_64.420330	375	455	2	67	80	0.8375000
NODE_51378_length_463_cov_49.673077	0	71	0	56	71	0.7887324
NODE_51378_length_463_cov_49.673077	0	71	2	15	71	0.2112676
NODE_51378_length_463_cov_49.673077	44	121	0	12	77	0.1558442
NODE_51378_length_463_cov_49.673077	44	121	2	65	77	0.8441558
NODE_51379_length_463_cov_41.005495	8	88	1	16	80	0.2000000
NODE_51379_length_463_cov_41.005495	8	88	2	64	80	0.8000000
NODE_51379_length_463_cov_41.005495	61	141	2	80	80	1.0000000
NODE_51380_length_463_cov_30.626374	318	398	0	22	80	0.2750000
NODE_51380_length_463_cov_30.626374	318	398	2	18	80	0.2250000
NODE_51380_length_463_cov_30.626374	318	398	4	40	80	0.5000000
NODE_51380_length_463_cov_30.626374	371	451	2	10	80	0.1250000
NODE_51380_length_463_cov_30.626374	371	451	4	70	80	0.8750000
NODE_51381_length_463_cov_27.475275	211	291	1	52	80	0.6500000
NODE_51381_length_463_cov_27.475275	211	291	2	28	80	0.3500000
NODE_51381_length_463_cov_27.475275	264	344	2	80	80	1.0000000
NODE_51383_length_463_cov_11.211538	304	377	4	15	73	0.2054795
NODE_51383_length_463_cov_11.211538	304	377	5	16	73	0.2191781
NODE_51383_length_463_cov_11.211538	304	377	7	42	73	0.5753425
NODE_51383_length_463_cov_11.211538	350	430	2	51	80	0.6375000
NODE_51383_length_463_cov_11.211538	350	430	4	17	80	0.2125000
NODE_51383_length_463_cov_11.211538	350	430	5	12	80	0.1500000
NODE_51391_length_463_cov_5.711538	181	261	0	4	80	0.0500000
NODE_51391_length_463_cov_5.711538	181	261	2	76	80	0.9500000
NODE_51391_length_463_cov_5.711538	234	314	0	57	80	0.7125000
NODE_51391_length_463_cov_5.711538	234	314	2	23	80	0.2875000
NODE_51399_length_463_cov_4.398352	119	169	0	50	50	1.0000000
NODE_51402_length_463_cov_4.186813	175	233	0	6	58	0.1034483
NODE_51402_length_463_cov_4.186813	175	233	2	52	58	0.8965517
NODE_51402_length_463_cov_4.186813	206	251	2	45	45	1.0000000
NODE_51408_length_463_cov_3.846154	235	268	2	33	33	1.0000000
NODE_51421_length_463_cov_3.063187	193	248	0	34	55	0.6181818
NODE_51421_length_463_cov_3.063187	193	248	1	21	55	0.3818182
NODE_51421_length_463_cov_3.063187	222	301	0	5	79	0.0632911
NODE_51421_length_463_cov_3.063187	222	301	1	65	79	0.8227848
NODE_51421_length_463_cov_3.063187	222	301	2	9	79	0.1139240
NODE_51680_length_462_cov_21.876033	93	173	2	30	80	0.3750000
NODE_51680_length_462_cov_21.876033	93	173	3	2	80	0.0250000
NODE_51680_length_462_cov_21.876033	93	173	4	31	80	0.3875000
NODE_51680_length_462_cov_21.876033	93	173	5	17	80	0.2125000
NODE_51680_length_462_cov_21.876033	146	226	3	52	80	0.6500000
NODE_51680_length_462_cov_21.876033	146	226	4	10	80	0.1250000
NODE_51680_length_462_cov_21.876033	146	226	5	18	80	0.2250000
NODE_51687_length_462_cov_5.033058	93	154	0	52	61	0.8524590
NODE_51687_length_462_cov_5.033058	93	154	2	9	61	0.1475410
NODE_51687_length_462_cov_5.033058	159	209	2	50	50	1.0000000
NODE_51699_length_462_cov_4.101928	168	246	0	48	78	0.6153846
NODE_51699_length_462_cov_4.101928	168	246	1	30	78	0.3846154
NODE_51699_length_462_cov_4.101928	184	208	0	24	24	1.0000000
NODE_51699_length_462_cov_4.101928	219	299	1	80	80	1.0000000
NODE_51708_length_462_cov_3.630854	149	194	0	45	45	1.0000000
NODE_51720_length_462_cov_3.079890	103	147	0	44	44	1.0000000
NODE_51735_length_462_cov_2.677686	78	118	0	16	40	0.4000000
NODE_51735_length_462_cov_2.677686	78	118	1	24	40	0.6000000
NODE_51763_length_462_cov_2.209366	18	58	0	40	40	1.0000000
NODE_51817_length_462_cov_1.570248	68	113	0	45	45	1.0000000
NODE_51995_length_461_cov_35.116022	0	79	0	12	79	0.1518987
NODE_51995_length_461_cov_35.116022	0	79	1	67	79	0.8481013
NODE_51995_length_461_cov_35.116022	52	132	1	80	80	1.0000000
NODE_51996_length_461_cov_11.124309	77	157	1	1	80	0.0125000
NODE_51996_length_461_cov_11.124309	77	157	2	3	80	0.0375000
NODE_51996_length_461_cov_11.124309	77	157	3	10	80	0.1250000
NODE_51996_length_461_cov_11.124309	77	157	4	36	80	0.4500000
NODE_51996_length_461_cov_11.124309	77	157	5	30	80	0.3750000
NODE_51996_length_461_cov_11.124309	130	210	2	56	80	0.7000000
NODE_51996_length_461_cov_11.124309	130	210	4	2	80	0.0250000
NODE_51996_length_461_cov_11.124309	130	210	5	22	80	0.2750000
NODE_52010_length_461_cov_5.361878	246	322	0	68	76	0.8947368
NODE_52010_length_461_cov_5.361878	246	322	2	8	76	0.1052632
NODE_52018_length_461_cov_4.472376	268	333	0	31	65	0.4769231
NODE_52018_length_461_cov_4.472376	268	333	1	34	65	0.5230770
NODE_52021_length_461_cov_4.168508	159	234	0	75	75	1.0000000
NODE_52047_length_461_cov_2.892265	233	312	0	79	79	1.0000000
NODE_52073_length_461_cov_2.392265	186	223	0	37	37	1.0000000
NODE_52154_length_461_cov_1.389503	283	349	0	66	66	1.0000000
NODE_52292_length_460_cov_172.986150	0	68	7	3	68	0.0441176
NODE_52292_length_460_cov_172.986150	0	68	8	2	68	0.0294118
NODE_52292_length_460_cov_172.986150	0	68	10	4	68	0.0588235
NODE_52292_length_460_cov_172.986150	0	68	12	1	68	0.0147059
NODE_52292_length_460_cov_172.986150	0	68	14	2	68	0.0294118
NODE_52292_length_460_cov_172.986150	0	68	17	1	68	0.0147059
NODE_52292_length_460_cov_172.986150	0	68	23	2	68	0.0294118
NODE_52292_length_460_cov_172.986150	0	68	24	1	68	0.0147059
NODE_52292_length_460_cov_172.986150	0	68	26	1	68	0.0147059
NODE_52292_length_460_cov_172.986150	0	68	27	1	68	0.0147059
NODE_52292_length_460_cov_172.986150	0	68	28	3	68	0.0441176
NODE_52292_length_460_cov_172.986150	0	68	29	2	68	0.0294118
NODE_52292_length_460_cov_172.986150	0	68	33	4	68	0.0588235
NODE_52292_length_460_cov_172.986150	0	68	34	1	68	0.0147059
NODE_52292_length_460_cov_172.986150	0	68	36	1	68	0.0147059
NODE_52292_length_460_cov_172.986150	0	68	37	1	68	0.0147059
NODE_52292_length_460_cov_172.986150	0	68	39	2	68	0.0294118
NODE_52292_length_460_cov_172.986150	0	68	40	2	68	0.0294118
NODE_52292_length_460_cov_172.986150	0	68	41	1	68	0.0147059
NODE_52292_length_460_cov_172.986150	0	68	42	3	68	0.0441176
NODE_52292_length_460_cov_172.986150	0	68	44	2	68	0.0294118
NODE_52292_length_460_cov_172.986150	0	68	48	2	68	0.0294118
NODE_52292_length_460_cov_172.986150	0	68	52	2	68	0.0294118
NODE_52292_length_460_cov_172.986150	0	68	53	1	68	0.0147059
NODE_52292_length_460_cov_172.986150	0	68	54	3	68	0.0441176
NODE_52292_length_460_cov_172.986150	0	68	55	1	68	0.0147059
NODE_52292_length_460_cov_172.986150	0	68	56	4	68	0.0588235
NODE_52292_length_460_cov_172.986150	0	68	58	1	68	0.0147059
NODE_52292_length_460_cov_172.986150	0	68	60	2	68	0.0294118
NODE_52292_length_460_cov_172.986150	0	68	61	2	68	0.0294118
NODE_52292_length_460_cov_172.986150	0	68	68	1	68	0.0147059
NODE_52292_length_460_cov_172.986150	0	68	69	1	68	0.0147059
NODE_52292_length_460_cov_172.986150	0	68	70	2	68	0.0294118
NODE_52292_length_460_cov_172.986150	0	68	71	1	68	0.0147059
NODE_52292_length_460_cov_172.986150	0	68	74	2	68	0.0294118
NODE_52292_length_460_cov_172.986150	0	68	76	2	68	0.0294118
NODE_52292_length_460_cov_172.986150	0	68	77	1	68	0.0147059
NODE_52292_length_460_cov_172.986150	41	121	48	1	80	0.0125000
NODE_52292_length_460_cov_172.986150	41	121	52	2	80	0.0250000
NODE_52292_length_460_cov_172.986150	41	121	53	1	80	0.0125000
NODE_52292_length_460_cov_172.986150	41	121	54	3	80	0.0375000
NODE_52292_length_460_cov_172.986150	41	121	55	1	80	0.0125000
NODE_52292_length_460_cov_172.986150	41	121	56	4	80	0.0500000
NODE_52292_length_460_cov_172.986150	41	121	58	1	80	0.0125000
NODE_52292_length_460_cov_172.986150	41	121	60	2	80	0.0250000
NODE_52292_length_460_cov_172.986150	41	121	61	2	80	0.0250000
NODE_52292_length_460_cov_172.986150	41	121	68	1	80	0.0125000
NODE_52292_length_460_cov_172.986150	41	121	69	1	80	0.0125000
NODE_52292_length_460_cov_172.986150	41	121	70	2	80	0.0250000
NODE_52292_length_460_cov_172.986150	41	121	71	1	80	0.0125000
NODE_52292_length_460_cov_172.986150	41	121	74	2	80	0.0250000
NODE_52292_length_460_cov_172.986150	41	121	76	2	80	0.0250000
NODE_52292_length_460_cov_172.986150	41	121	77	1	80	0.0125000
NODE_52292_length_460_cov_172.986150	41	121	78	1	80	0.0125000
NODE_52292_length_460_cov_172.986150	41	121	81	1	80	0.0125000
NODE_52292_length_460_cov_172.986150	41	121	82	2	80	0.0250000
NODE_52292_length_460_cov_172.986150	41	121	84	7	80	0.0875000
NODE_52292_length_460_cov_172.986150	41	121	86	1	80	0.0125000
NODE_52292_length_460_cov_172.986150	41	121	87	1	80	0.0125000
NODE_52292_length_460_cov_172.986150	41	121	89	3	80	0.0375000
NODE_52292_length_460_cov_172.986150	41	121	90	2	80	0.0250000
NODE_52292_length_460_cov_172.986150	41	121	92	3	80	0.0375000
NODE_52292_length_460_cov_172.986150	41	121	95	2	80	0.0250000
NODE_52292_length_460_cov_172.986150	41	121	96	3	80	0.0375000
NODE_52292_length_460_cov_172.986150	41	121	97	3	80	0.0375000
NODE_52292_length_460_cov_172.986150	41	121	99	4	80	0.0500000
NODE_52292_length_460_cov_172.986150	41	121	100	1	80	0.0125000
NODE_52292_length_460_cov_172.986150	41	121	101	1	80	0.0125000
NODE_52292_length_460_cov_172.986150	41	121	102	1	80	0.0125000
NODE_52292_length_460_cov_172.986150	41	121	104	5	80	0.0625000
NODE_52292_length_460_cov_172.986150	41	121	106	4	80	0.0500000
NODE_52292_length_460_cov_172.986150	41	121	109	1	80	0.0125000
NODE_52292_length_460_cov_172.986150	41	121	112	1	80	0.0125000
NODE_52292_length_460_cov_172.986150	41	121	115	3	80	0.0375000
NODE_52292_length_460_cov_172.986150	41	121	118	1	80	0.0125000
NODE_52292_length_460_cov_172.986150	41	121	119	2	80	0.0250000
NODE_52293_length_460_cov_62.512465	9	48	1	9	39	0.2307692
NODE_52293_length_460_cov_62.512465	9	48	2	5	39	0.1282051
NODE_52293_length_460_cov_62.512465	9	48	3	25	39	0.6410257
NODE_52294_length_460_cov_33.146814	0	47	0	47	47	1.0000000
NODE_52294_length_460_cov_33.146814	43	115	0	72	72	1.0000000
NODE_52294_length_460_cov_33.146814	96	165	0	69	69	1.0000000
NODE_52295_length_460_cov_26.049861	0	63	0	11	63	0.1746032
NODE_52295_length_460_cov_26.049861	0	63	2	31	63	0.4920635
NODE_52295_length_460_cov_26.049861	0	63	3	14	63	0.2222222
NODE_52295_length_460_cov_26.049861	0	63	4	1	63	0.0158730
NODE_52295_length_460_cov_26.049861	0	63	8	4	63	0.0634921
NODE_52295_length_460_cov_26.049861	0	63	10	2	63	0.0317460
NODE_52296_length_460_cov_25.709141	246	326	3	79	80	0.9875000
NODE_52296_length_460_cov_25.709141	246	326	4	1	80	0.0125000
NODE_52296_length_460_cov_25.709141	299	379	1	8	80	0.1000000
NODE_52296_length_460_cov_25.709141	299	379	2	22	80	0.2750000
NODE_52296_length_460_cov_25.709141	299	379	3	50	80	0.6250000
NODE_52297_length_460_cov_11.063712	273	353	0	80	80	1.0000000
NODE_52297_length_460_cov_11.063712	326	406	0	80	80	1.0000000
NODE_52303_length_460_cov_7.285319	172	250	0	78	78	1.0000000
NODE_52312_length_460_cov_5.163435	120	200	0	2	80	0.0250000
NODE_52312_length_460_cov_5.163435	120	200	1	16	80	0.2000000
NODE_52312_length_460_cov_5.163435	120	200	2	62	80	0.7750000
NODE_52312_length_460_cov_5.163435	173	253	0	55	80	0.6875000
NODE_52312_length_460_cov_5.163435	173	253	1	16	80	0.2000000
NODE_52312_length_460_cov_5.163435	173	253	2	9	80	0.1125000
NODE_52333_length_460_cov_3.457064	150	230	0	80	80	1.0000000
NODE_52333_length_460_cov_3.457064	203	246	0	43	43	1.0000000
NODE_52339_length_460_cov_3.027701	167	230	1	41	63	0.6507937
NODE_52339_length_460_cov_3.027701	167	230	2	22	63	0.3492064
NODE_52347_length_460_cov_2.819945	195	266	0	71	71	1.0000000
NODE_52358_length_460_cov_2.626039	223	277	0	54	54	1.0000000
NODE_52612_length_459_cov_34.927778	165	239	0	74	74	1.0000000
NODE_52612_length_459_cov_34.927778	212	292	0	80	80	1.0000000
NODE_52617_length_459_cov_7.261111	143	189	2	9	46	0.1956522
NODE_52617_length_459_cov_7.261111	143	189	3	25	46	0.5434783
NODE_52617_length_459_cov_7.261111	143	189	4	12	46	0.2608696
NODE_52617_length_459_cov_7.261111	162	242	3	15	80	0.1875000
NODE_52617_length_459_cov_7.261111	162	242	4	18	80	0.2250000
NODE_52617_length_459_cov_7.261111	162	242	5	14	80	0.1750000
NODE_52617_length_459_cov_7.261111	162	242	6	27	80	0.3375000
NODE_52617_length_459_cov_7.261111	162	242	7	6	80	0.0750000
NODE_52635_length_459_cov_4.127778	153	233	0	30	80	0.3750000
NODE_52635_length_459_cov_4.127778	153	233	1	12	80	0.1500000
NODE_52635_length_459_cov_4.127778	153	233	3	13	80	0.1625000
NODE_52635_length_459_cov_4.127778	153	233	4	25	80	0.3125000
NODE_52685_length_459_cov_2.158333	219	285	0	66	66	1.0000000
NODE_52685_length_459_cov_2.158333	283	342	0	59	59	1.0000000
NODE_52704_length_459_cov_1.722222	280	353	0	73	73	1.0000000
NODE_52920_length_458_cov_71.047354	0	51	0	51	51	1.0000000
NODE_52920_length_458_cov_71.047354	24	104	0	33	80	0.4125000
NODE_52920_length_458_cov_71.047354	24	104	1	12	80	0.1500000
NODE_52920_length_458_cov_71.047354	24	104	3	10	80	0.1250000
NODE_52920_length_458_cov_71.047354	24	104	4	25	80	0.3125000
NODE_52920_length_458_cov_71.047354	100	180	4	59	80	0.7375000
NODE_52920_length_458_cov_71.047354	100	180	5	21	80	0.2625000
NODE_52920_length_458_cov_71.047354	153	233	4	10	80	0.1250000
NODE_52920_length_458_cov_71.047354	153	233	5	33	80	0.4125000
NODE_52920_length_458_cov_71.047354	153	233	6	1	80	0.0125000
NODE_52920_length_458_cov_71.047354	153	233	7	27	80	0.3375000
NODE_52920_length_458_cov_71.047354	153	233	8	9	80	0.1125000
NODE_52921_length_458_cov_47.966574	151	231	0	80	80	1.0000000
NODE_52921_length_458_cov_47.966574	204	284	0	80	80	1.0000000
NODE_52921_length_458_cov_47.966574	280	360	0	6	80	0.0750000
NODE_52921_length_458_cov_47.966574	280	360	1	2	80	0.0250000
NODE_52921_length_458_cov_47.966574	280	360	2	72	80	0.9000000
NODE_52921_length_458_cov_47.966574	333	413	2	80	80	1.0000000
NODE_52924_length_458_cov_9.935933	267	347	7	44	80	0.5500000
NODE_52924_length_458_cov_9.935933	267	347	8	14	80	0.1750000
NODE_52924_length_458_cov_9.935933	267	347	9	11	80	0.1375000
NODE_52924_length_458_cov_9.935933	267	347	10	11	80	0.1375000
NODE_52924_length_458_cov_9.935933	320	400	6	47	80	0.5875000
NODE_52924_length_458_cov_9.935933	320	400	7	19	80	0.2375000
NODE_52924_length_458_cov_9.935933	320	400	8	14	80	0.1750000
NODE_52929_length_458_cov_7.598886	87	167	2	80	80	1.0000000
NODE_52967_length_458_cov_3.061281	62	91	0	29	29	1.0000000
NODE_52967_length_458_cov_3.061281	185	224	2	39	39	1.0000000
NODE_52992_length_458_cov_2.454039	210	251	2	41	41	1.0000000
NODE_53107_length_458_cov_1.139276	242	289	0	47	47	1.0000000
NODE_53107_length_458_cov_1.139276	262	328	0	66	66	1.0000000
NODE_53205_length_457_cov_20.754190	123	203	0	52	80	0.6500000
NODE_53205_length_457_cov_20.754190	123	203	2	16	80	0.2000000
NODE_53205_length_457_cov_20.754190	123	203	3	12	80	0.1500000
NODE_53205_length_457_cov_20.754190	176	256	2	15	80	0.1875000
NODE_53205_length_457_cov_20.754190	176	256	3	51	80	0.6375000
NODE_53205_length_457_cov_20.754190	176	256	4	14	80	0.1750000
NODE_53207_length_457_cov_13.918994	218	298	0	80	80	1.0000000
NODE_53207_length_457_cov_13.918994	218	298	0	80	80	1.0000000
NODE_53207_length_457_cov_13.918994	218	298	0	80	80	1.0000000
NODE_53207_length_457_cov_13.918994	218	298	0	80	80	1.0000000
NODE_53207_length_457_cov_13.918994	271	320	0	49	49	1.0000000
NODE_53207_length_457_cov_13.918994	271	320	0	49	49	1.0000000
NODE_53207_length_457_cov_13.918994	271	320	0	49	49	1.0000000
NODE_53216_length_457_cov_6.050279	264	326	1	62	62	1.0000000
NODE_53220_length_457_cov_5.078212	71	149	0	78	78	1.0000000
NODE_53220_length_457_cov_5.078212	122	202	0	80	80	1.0000000
NODE_53225_length_457_cov_4.530726	193	273	0	4	80	0.0500000
NODE_53225_length_457_cov_4.530726	193	273	1	76	80	0.9500000
NODE_53225_length_457_cov_4.530726	246	315	0	46	69	0.6666667
NODE_53225_length_457_cov_4.530726	246	315	1	23	69	0.3333333
NODE_53230_length_457_cov_3.986034	192	272	1	44	80	0.5500000
NODE_53230_length_457_cov_3.986034	192	272	2	36	80	0.4500000
NODE_53267_length_457_cov_2.636872	117	197	1	56	80	0.7000000
NODE_53267_length_457_cov_2.636872	117	197	2	24	80	0.3000000
NODE_53462_length_457_cov_0.916201	108	188	0	80	80	1.0000000
NODE_53462_length_457_cov_0.916201	108	188	0	80	80	1.0000000
NODE_53462_length_457_cov_0.916201	161	241	0	80	80	1.0000000
NODE_53462_length_457_cov_0.916201	161	241	0	80	80	1.0000000
NODE_53512_length_456_cov_34.731092	0	63	0	58	63	0.9206349
NODE_53512_length_456_cov_34.731092	0	63	1	5	63	0.0793651
NODE_53512_length_456_cov_34.731092	36	116	0	22	80	0.2750000
NODE_53512_length_456_cov_34.731092	36	116	1	46	80	0.5750000
NODE_53512_length_456_cov_34.731092	36	116	3	4	80	0.0500000
NODE_53512_length_456_cov_34.731092	36	116	4	5	80	0.0625000
NODE_53512_length_456_cov_34.731092	36	116	6	3	80	0.0375000
NODE_53512_length_456_cov_34.731092	112	194	4	1	82	0.0121951
NODE_53512_length_456_cov_34.731092	112	194	6	81	82	0.9878049
NODE_53532_length_456_cov_4.582633	269	349	0	80	80	1.0000000
NODE_53533_length_456_cov_4.554622	124	206	0	82	82	1.0000000
NODE_53533_length_456_cov_4.554622	179	263	0	84	84	1.0000000
NODE_53546_length_456_cov_3.669468	123	186	0	63	63	1.0000000
NODE_53566_length_456_cov_2.921569	302	362	0	60	60	1.0000000
NODE_53859_length_455_cov_113.589888	137	220	3	15	83	0.1807229
NODE_53859_length_455_cov_113.589888	137	220	4	10	83	0.1204819
NODE_53859_length_455_cov_113.589888	137	220	5	38	83	0.4578313
NODE_53859_length_455_cov_113.589888	137	220	6	3	83	0.0361446
NODE_53859_length_455_cov_113.589888	137	220	7	3	83	0.0361446
NODE_53859_length_455_cov_113.589888	137	220	8	14	83	0.1686747
NODE_53859_length_455_cov_113.589888	198	268	5	2	70	0.0285714
NODE_53859_length_455_cov_113.589888	198	268	6	3	70	0.0428571
NODE_53859_length_455_cov_113.589888	198	268	7	3	70	0.0428571
NODE_53859_length_455_cov_113.589888	198	268	8	18	70	0.2571429
NODE_53859_length_455_cov_113.589888	198	268	9	7	70	0.1000000
NODE_53859_length_455_cov_113.589888	198	268	10	37	70	0.5285714
NODE_53859_length_455_cov_113.589888	269	348	9	25	79	0.3164557
NODE_53859_length_455_cov_113.589888	269	348	10	12	79	0.1518987
NODE_53859_length_455_cov_113.589888	269	348	11	42	79	0.5316456
NODE_53859_length_455_cov_113.589888	321	401	5	12	80	0.1500000
NODE_53859_length_455_cov_113.589888	321	401	6	14	80	0.1750000
NODE_53859_length_455_cov_113.589888	321	401	7	2	80	0.0250000
NODE_53859_length_455_cov_113.589888	321	401	8	17	80	0.2125000
NODE_53859_length_455_cov_113.589888	321	401	9	3	80	0.0375000
NODE_53859_length_455_cov_113.589888	321	401	10	3	80	0.0375000
NODE_53859_length_455_cov_113.589888	321	401	11	29	80	0.3625000
NODE_53860_length_455_cov_52.941011	260	340	4	8	80	0.1000000
NODE_53860_length_455_cov_52.941011	260	340	5	13	80	0.1625000
NODE_53860_length_455_cov_52.941011	260	340	6	59	80	0.7375000
NODE_53860_length_455_cov_52.941011	313	393	3	3	80	0.0375000
NODE_53860_length_455_cov_52.941011	313	393	4	58	80	0.7250000
NODE_53860_length_455_cov_52.941011	313	393	5	6	80	0.0750000
NODE_53860_length_455_cov_52.941011	313	393	6	13	80	0.1625000
NODE_53863_length_455_cov_8.584270	250	302	0	52	52	1.0000000
NODE_53863_length_455_cov_8.584270	275	355	0	80	80	1.0000000
NODE_53864_length_455_cov_8.084270	146	226	0	80	80	1.0000000
NODE_53864_length_455_cov_8.084270	199	279	0	80	80	1.0000000
NODE_53870_length_455_cov_6.022472	122	203	2	7	81	0.0864198
NODE_53870_length_455_cov_6.022472	122	203	3	24	81	0.2962963
NODE_53870_length_455_cov_6.022472	122	203	4	50	81	0.6172839
NODE_53872_length_455_cov_5.140449	181	232	0	51	51	1.0000000
NODE_54512_length_453_cov_29.528249	44	124	0	80	80	1.0000000
NODE_54512_length_453_cov_29.528249	97	177	0	73	80	0.9125000
NODE_54512_length_453_cov_29.528249	97	177	1	7	80	0.0875000
NODE_54512_length_453_cov_29.528249	173	253	1	33	80	0.4125000
NODE_54512_length_453_cov_29.528249	173	253	2	47	80	0.5875000
NODE_54512_length_453_cov_29.528249	226	301	2	75	75	1.0000000
NODE_54513_length_453_cov_11.146893	95	140	1	36	45	0.8000000
NODE_54513_length_453_cov_11.146893	95	140	2	9	45	0.2000000
NODE_54513_length_453_cov_11.146893	146	220	2	22	74	0.2972973
NODE_54513_length_453_cov_11.146893	146	220	3	52	74	0.7027027
NODE_54517_length_453_cov_7.709040	194	252	0	55	58	0.9482759
NODE_54517_length_453_cov_7.709040	194	252	2	3	58	0.0517241
NODE_54518_length_453_cov_7.440678	250	319	0	69	69	1.0000000
NODE_54533_length_453_cov_4.282486	190	270	0	80	80	1.0000000
NODE_54533_length_453_cov_4.282486	243	283	0	40	40	1.0000000
NODE_54566_length_453_cov_2.836158	186	266	0	1	80	0.0125000
NODE_54566_length_453_cov_2.836158	186	266	2	79	80	0.9875000
NODE_54566_length_453_cov_2.836158	239	319	2	80	80	1.0000000
NODE_54592_length_453_cov_2.048023	139	174	0	35	35	1.0000000
NODE_54600_length_453_cov_2.002825	78	98	0	20	20	1.0000000
NODE_54767_length_453_cov_0.774011	174	195	0	21	21	1.0000000
NODE_54822_length_452_cov_36.028329	0	72	1	29	72	0.4027778
NODE_54822_length_452_cov_36.028329	0	72	2	4	72	0.0555556
NODE_54822_length_452_cov_36.028329	0	72	3	39	72	0.5416667
NODE_54822_length_452_cov_36.028329	0	72	1	29	72	0.4027778
NODE_54822_length_452_cov_36.028329	0	72	2	4	72	0.0555556
NODE_54822_length_452_cov_36.028329	0	72	3	39	72	0.5416667
NODE_54822_length_452_cov_36.028329	45	99	3	45	54	0.8333333
NODE_54822_length_452_cov_36.028329	45	99	4	9	54	0.1666667
NODE_54822_length_452_cov_36.028329	45	125	3	49	80	0.6125000
NODE_54822_length_452_cov_36.028329	45	125	4	31	80	0.3875000
NODE_54823_length_452_cov_17.424929	29	109	3	8	80	0.1000000
NODE_54823_length_452_cov_17.424929	29	109	4	23	80	0.2875000
NODE_54823_length_452_cov_17.424929	29	109	5	27	80	0.3375000
NODE_54823_length_452_cov_17.424929	29	109	7	22	80	0.2750000
NODE_54823_length_452_cov_17.424929	82	162	3	61	80	0.7625000
NODE_54823_length_452_cov_17.424929	82	162	5	3	80	0.0375000
NODE_54823_length_452_cov_17.424929	82	162	7	16	80	0.2000000
NODE_54844_length_452_cov_4.317280	141	200	0	59	59	1.0000000
NODE_54886_length_452_cov_2.634561	262	338	0	76	76	1.0000000
NODE_55146_length_451_cov_37.090909	230	310	5	9	80	0.1125000
NODE_55146_length_451_cov_37.090909	230	310	6	1	80	0.0125000
NODE_55146_length_451_cov_37.090909	230	310	8	23	80	0.2875000
NODE_55146_length_451_cov_37.090909	230	310	9	39	80	0.4875000
NODE_55146_length_451_cov_37.090909	230	310	10	8	80	0.1000000
NODE_55146_length_451_cov_37.090909	283	363	6	23	80	0.2875000
NODE_55146_length_451_cov_37.090909	283	363	7	5	80	0.0625000
NODE_55146_length_451_cov_37.090909	283	363	8	13	80	0.1625000
NODE_55146_length_451_cov_37.090909	283	363	9	39	80	0.4875000
NODE_55147_length_451_cov_16.517045	205	286	0	81	81	1.0000000
NODE_55147_length_451_cov_16.517045	259	339	0	80	80	1.0000000
NODE_55148_length_451_cov_13.153409	182	262	10	16	80	0.2000000
NODE_55148_length_451_cov_13.153409	182	262	11	23	80	0.2875000
NODE_55148_length_451_cov_13.153409	182	262	12	16	80	0.2000000
NODE_55148_length_451_cov_13.153409	182	262	13	25	80	0.3125000
NODE_55148_length_451_cov_13.153409	235	315	5	6	80	0.0750000
NODE_55148_length_451_cov_13.153409	235	315	7	3	80	0.0375000
NODE_55148_length_451_cov_13.153409	235	315	9	9	80	0.1125000
NODE_55148_length_451_cov_13.153409	235	315	10	51	80	0.6375000
NODE_55148_length_451_cov_13.153409	235	315	11	4	80	0.0500000
NODE_55148_length_451_cov_13.153409	235	315	12	7	80	0.0875000
NODE_55149_length_451_cov_11.926136	141	221	4	80	80	1.0000000
NODE_55149_length_451_cov_11.926136	331	411	0	80	80	1.0000000
NODE_55154_length_451_cov_7.102273	81	143	0	62	62	1.0000000
NODE_55161_length_451_cov_5.610795	1	31	0	30	30	1.0000000
NODE_55161_length_451_cov_5.610795	60	90	0	30	30	1.0000000
NODE_55166_length_451_cov_5.065341	219	285	0	66	66	1.0000000
NODE_55166_length_451_cov_5.065341	272	322	0	50	50	1.0000000
NODE_55184_length_451_cov_3.696023	253	332	4	26	79	0.3291139
NODE_55184_length_451_cov_3.696023	253	332	6	53	79	0.6708861
NODE_55188_length_451_cov_3.406250	176	247	2	25	71	0.3521127
NODE_55188_length_451_cov_3.406250	176	247	3	46	71	0.6478873
NODE_55188_length_451_cov_3.406250	220	300	2	78	80	0.9750000
NODE_55188_length_451_cov_3.406250	220	300	3	2	80	0.0250000
NODE_55198_length_451_cov_3.025568	72	148	0	76	76	1.0000000
NODE_55213_length_451_cov_2.607955	84	143	0	59	59	1.0000000
NODE_55213_length_451_cov_2.607955	257	326	0	69	69	1.0000000
NODE_55234_length_451_cov_2.125000	156	224	0	68	68	1.0000000
NODE_55436_length_450_cov_105.723647	317	386	0	66	69	0.9565217
NODE_55436_length_450_cov_105.723647	317	386	1	1	69	0.0144928
NODE_55436_length_450_cov_105.723647	317	386	2	2	69	0.0289855
NODE_55438_length_450_cov_27.982906	98	120	0	22	22	1.0000000
NODE_55438_length_450_cov_27.982906	225	305	0	80	80	1.0000000
NODE_55438_length_450_cov_27.982906	278	358	0	80	80	1.0000000
NODE_55459_length_450_cov_3.991453	220	290	0	70	70	1.0000000
NODE_55459_length_450_cov_3.991453	223	290	0	67	67	1.0000000
NODE_55459_length_450_cov_3.991453	268	348	0	80	80	1.0000000
NODE_55459_length_450_cov_3.991453	268	348	0	80	80	1.0000000
NODE_55459_length_450_cov_3.991453	278	348	0	70	70	1.0000000
NODE_55459_length_450_cov_3.991453	344	363	0	19	19	1.0000000
NODE_55466_length_450_cov_3.717949	107	177	0	70	70	1.0000000
NODE_55483_length_450_cov_3.162393	99	157	0	58	58	1.0000000
NODE_55550_length_450_cov_1.857550	114	172	0	19	58	0.3275862
NODE_55550_length_450_cov_1.857550	114	172	2	5	58	0.0862069
NODE_55550_length_450_cov_1.857550	114	172	4	34	58	0.5862069
NODE_55560_length_450_cov_1.749288	321	376	1	41	55	0.7454545
NODE_55560_length_450_cov_1.749288	321	376	3	14	55	0.2545455
NODE_55565_length_450_cov_1.723647	101	161	2	60	60	1.0000000
NODE_55685_length_450_cov_1.017094	116	196	0	80	80	1.0000000
NODE_55761_length_449_cov_46.882857	237	317	15	1	80	0.0125000
NODE_55761_length_449_cov_46.882857	237	317	16	1	80	0.0125000
NODE_55761_length_449_cov_46.882857	237	317	17	2	80	0.0250000
NODE_55761_length_449_cov_46.882857	237	317	18	5	80	0.0625000
NODE_55761_length_449_cov_46.882857	237	317	19	3	80	0.0375000
NODE_55761_length_449_cov_46.882857	237	317	20	4	80	0.0500000
NODE_55761_length_449_cov_46.882857	237	317	21	4	80	0.0500000
NODE_55761_length_449_cov_46.882857	237	317	23	20	80	0.2500000
NODE_55761_length_449_cov_46.882857	237	317	24	10	80	0.1250000
NODE_55761_length_449_cov_46.882857	237	317	25	30	80	0.3750000
NODE_55761_length_449_cov_46.882857	290	370	20	4	80	0.0500000
NODE_55761_length_449_cov_46.882857	290	370	22	4	80	0.0500000
NODE_55761_length_449_cov_46.882857	290	370	23	18	80	0.2250000
NODE_55761_length_449_cov_46.882857	290	370	24	14	80	0.1750000
NODE_55761_length_449_cov_46.882857	290	370	25	25	80	0.3125000
NODE_55761_length_449_cov_46.882857	290	370	26	15	80	0.1875000
NODE_55762_length_449_cov_36.031429	238	318	6	6	80	0.0750000
NODE_55762_length_449_cov_36.031429	238	318	8	1	80	0.0125000
NODE_55762_length_449_cov_36.031429	238	318	10	10	80	0.1250000
NODE_55762_length_449_cov_36.031429	238	318	12	7	80	0.0875000
NODE_55762_length_449_cov_36.031429	238	318	13	3	80	0.0375000
NODE_55762_length_449_cov_36.031429	238	318	14	2	80	0.0250000
NODE_55762_length_449_cov_36.031429	238	318	15	51	80	0.6375000
NODE_55762_length_449_cov_36.031429	291	371	9	1	80	0.0125000
NODE_55762_length_449_cov_36.031429	291	371	11	3	80	0.0375000
NODE_55762_length_449_cov_36.031429	291	371	13	8	80	0.1000000
NODE_55762_length_449_cov_36.031429	291	371	14	23	80	0.2875000
NODE_55762_length_449_cov_36.031429	291	371	15	45	80	0.5625000
NODE_55783_length_449_cov_4.594286	137	184	0	47	47	1.0000000
NODE_55794_length_449_cov_3.797143	204	284	2	8	80	0.1000000
NODE_55794_length_449_cov_3.797143	204	284	3	32	80	0.4000000
NODE_55794_length_449_cov_3.797143	204	284	4	40	80	0.5000000
NODE_55844_length_449_cov_2.445714	346	376	0	13	30	0.4333333
NODE_55844_length_449_cov_2.445714	346	376	2	17	30	0.5666667
NODE_56144_length_448_cov_44.664756	126	206	0	80	80	1.0000000
NODE_56144_length_448_cov_44.664756	179	259	0	80	80	1.0000000
NODE_56145_length_448_cov_36.148997	195	275	5	13	80	0.1625000
NODE_56145_length_448_cov_36.148997	195	275	6	25	80	0.3125000
NODE_56145_length_448_cov_36.148997	195	275	7	7	80	0.0875000
NODE_56145_length_448_cov_36.148997	195	275	8	1	80	0.0125000
NODE_56145_length_448_cov_36.148997	195	275	9	10	80	0.1250000
NODE_56145_length_448_cov_36.148997	195	275	10	24	80	0.3000000
NODE_56145_length_448_cov_36.148997	248	328	8	11	80	0.1375000
NODE_56145_length_448_cov_36.148997	248	328	9	11	80	0.1375000
NODE_56145_length_448_cov_36.148997	248	328	10	34	80	0.4250000
NODE_56145_length_448_cov_36.148997	248	328	11	17	80	0.2125000
NODE_56145_length_448_cov_36.148997	248	328	12	7	80	0.0875000
NODE_56145_length_448_cov_36.148997	324	404	3	13	80	0.1625000
NODE_56145_length_448_cov_36.148997	324	404	5	1	80	0.0125000
NODE_56145_length_448_cov_36.148997	324	404	6	7	80	0.0875000
NODE_56145_length_448_cov_36.148997	324	404	7	3	80	0.0375000
NODE_56145_length_448_cov_36.148997	324	404	8	56	80	0.7000000
NODE_56145_length_448_cov_36.148997	377	448	0	10	71	0.1408451
NODE_56145_length_448_cov_36.148997	377	448	2	13	71	0.1830986
NODE_56145_length_448_cov_36.148997	377	448	3	34	71	0.4788733
NODE_56145_length_448_cov_36.148997	377	448	5	1	71	0.0140845
NODE_56145_length_448_cov_36.148997	377	448	6	7	71	0.0985916
NODE_56145_length_448_cov_36.148997	377	448	7	3	71	0.0422535
NODE_56145_length_448_cov_36.148997	377	448	8	3	71	0.0422535
NODE_56146_length_448_cov_31.816619	43	123	2	11	80	0.1375000
NODE_56146_length_448_cov_31.816619	43	123	3	69	80	0.8625000
NODE_56151_length_448_cov_6.779370	197	277	0	80	80	1.0000000
NODE_56151_length_448_cov_6.779370	250	313	0	63	63	1.0000000
NODE_56180_length_448_cov_3.664756	148	189	2	24	41	0.5853658
NODE_56180_length_448_cov_3.664756	148	189	3	17	41	0.4146341
NODE_56189_length_448_cov_3.108883	242	324	1	6	82	0.0731707
NODE_56189_length_448_cov_3.108883	242	324	2	17	82	0.2073171
NODE_56189_length_448_cov_3.108883	242	324	3	9	82	0.1097561
NODE_56189_length_448_cov_3.108883	242	324	4	50	82	0.6097561
NODE_56233_length_448_cov_2.263610	292	360	2	68	68	1.0000000
NODE_56518_length_447_cov_10.505747	205	234	0	29	29	1.0000000
NODE_56518_length_447_cov_10.505747	267	326	0	59	59	1.0000000
NODE_56518_length_447_cov_10.505747	299	379	0	80	80	1.0000000
NODE_56527_length_447_cov_5.767241	176	256	1	5	80	0.0625000
NODE_56527_length_447_cov_5.767241	176	256	2	44	80	0.5500000
NODE_56527_length_447_cov_5.767241	176	256	3	4	80	0.0500000
NODE_56527_length_447_cov_5.767241	176	256	4	27	80	0.3375000
NODE_56527_length_447_cov_5.767241	229	309	4	80	80	1.0000000
NODE_56539_length_447_cov_4.583333	265	289	0	24	24	1.0000000
NODE_56545_length_447_cov_4.037356	58	138	0	80	80	1.0000000
NODE_56545_length_447_cov_4.037356	111	191	0	80	80	1.0000000
NODE_56890_length_446_cov_42.527378	239	310	0	38	71	0.5352113
NODE_56890_length_446_cov_42.527378	239	310	2	28	71	0.3943662
NODE_56890_length_446_cov_42.527378	239	310	4	5	71	0.0704225
NODE_56890_length_446_cov_42.527378	359	433	0	4	74	0.0540541
NODE_56890_length_446_cov_42.527378	359	433	2	47	74	0.6351351
NODE_56890_length_446_cov_42.527378	359	433	4	23	74	0.3108108
NODE_56891_length_446_cov_12.749280	92	172	0	16	80	0.2000000
NODE_56891_length_446_cov_12.749280	92	172	2	34	80	0.4250000
NODE_56891_length_446_cov_12.749280	92	172	3	3	80	0.0375000
NODE_56891_length_446_cov_12.749280	92	172	4	1	80	0.0125000
NODE_56891_length_446_cov_12.749280	92	172	6	26	80	0.3250000
NODE_56891_length_446_cov_12.749280	145	225	4	1	80	0.0125000
NODE_56891_length_446_cov_12.749280	145	225	6	57	80	0.7125000
NODE_56891_length_446_cov_12.749280	145	225	7	22	80	0.2750000
NODE_56896_length_446_cov_6.902017	175	217	1	22	42	0.5238096
NODE_56896_length_446_cov_6.902017	175	217	2	20	42	0.4761905
NODE_56902_length_446_cov_5.930836	165	245	1	49	80	0.6125000
NODE_56902_length_446_cov_5.930836	165	245	2	31	80	0.3875000
NODE_56902_length_446_cov_5.930836	165	245	1	49	80	0.6125000
NODE_56902_length_446_cov_5.930836	165	245	2	31	80	0.3875000
NODE_56902_length_446_cov_5.930836	165	235	1	39	70	0.5571429
NODE_56902_length_446_cov_5.930836	165	235	2	31	70	0.4428571
NODE_56902_length_446_cov_5.930836	218	298	1	80	80	1.0000000
NODE_56902_length_446_cov_5.930836	218	297	1	79	79	1.0000000
NODE_56919_length_446_cov_3.896254	215	274	2	59	59	1.0000000
NODE_56934_length_446_cov_3.282421	130	168	0	38	38	1.0000000
NODE_56952_length_446_cov_2.775216	337	417	0	80	80	1.0000000
NODE_56995_length_446_cov_2.161383	17	97	0	80	80	1.0000000
NODE_57022_length_446_cov_1.907781	196	225	0	29	29	1.0000000
NODE_57277_length_445_cov_75.572254	108	188	0	80	80	1.0000000
NODE_57277_length_445_cov_75.572254	161	241	0	80	80	1.0000000
NODE_57277_length_445_cov_75.572254	237	317	0	80	80	1.0000000
NODE_57277_length_445_cov_75.572254	290	370	0	80	80	1.0000000
NODE_57278_length_445_cov_33.973988	83	163	0	80	80	1.0000000
NODE_57278_length_445_cov_33.973988	136	216	0	80	80	1.0000000
NODE_57280_length_445_cov_9.323699	78	148	0	70	70	1.0000000
NODE_57280_length_445_cov_9.323699	121	201	0	80	80	1.0000000
NODE_57284_length_445_cov_6.439306	210	282	0	68	72	0.9444444
NODE_57284_length_445_cov_6.439306	210	282	2	4	72	0.0555556
NODE_57286_length_445_cov_5.479769	115	184	0	69	69	1.0000000
NODE_57286_length_445_cov_5.479769	157	237	0	80	80	1.0000000
NODE_57286_length_445_cov_5.479769	233	309	0	76	76	1.0000000
NODE_57286_length_445_cov_5.479769	286	309	0	23	23	1.0000000
NODE_57345_length_445_cov_2.843931	124	199	0	75	75	1.0000000
NODE_57352_length_445_cov_2.682081	202	248	0	46	46	1.0000000
NODE_57400_length_445_cov_1.884393	252	332	2	24	80	0.3000000
NODE_57400_length_445_cov_1.884393	252	332	3	56	80	0.7000000
NODE_57409_length_445_cov_1.783237	132	203	0	71	71	1.0000000
NODE_57409_length_445_cov_1.783237	256	331	0	75	75	1.0000000
NODE_57409_length_445_cov_1.783237	256	278	0	22	22	1.0000000
NODE_57644_length_444_cov_34.075362	243	323	14	3	80	0.0375000
NODE_57644_length_444_cov_34.075362	243	323	15	4	80	0.0500000
NODE_57644_length_444_cov_34.075362	243	323	16	13	80	0.1625000
NODE_57644_length_444_cov_34.075362	243	323	17	13	80	0.1625000
NODE_57644_length_444_cov_34.075362	243	323	18	28	80	0.3500000
NODE_57644_length_444_cov_34.075362	243	323	19	19	80	0.2375000
NODE_57644_length_444_cov_34.075362	296	376	4	3	80	0.0375000
NODE_57644_length_444_cov_34.075362	296	376	6	4	80	0.0500000
NODE_57644_length_444_cov_34.075362	296	376	7	4	80	0.0500000
NODE_57644_length_444_cov_34.075362	296	376	8	1	80	0.0125000
NODE_57644_length_444_cov_34.075362	296	376	9	9	80	0.1125000
NODE_57644_length_444_cov_34.075362	296	376	14	2	80	0.0250000
NODE_57644_length_444_cov_34.075362	296	376	16	6	80	0.0750000
NODE_57644_length_444_cov_34.075362	296	376	17	26	80	0.3250000
NODE_57644_length_444_cov_34.075362	296	376	18	25	80	0.3125000
NODE_57645_length_444_cov_22.524638	98	178	4	28	80	0.3500000
NODE_57645_length_444_cov_22.524638	98	178	5	36	80	0.4500000
NODE_57645_length_444_cov_22.524638	98	178	6	16	80	0.2000000
NODE_57645_length_444_cov_22.524638	151	231	1	3	80	0.0375000
NODE_57645_length_444_cov_22.524638	151	231	3	26	80	0.3250000
NODE_57645_length_444_cov_22.524638	151	231	4	51	80	0.6375000
NODE_57646_length_444_cov_16.544928	263	343	6	6	80	0.0750000
NODE_57646_length_444_cov_16.544928	263	343	7	9	80	0.1125000
NODE_57646_length_444_cov_16.544928	263	343	8	65	80	0.8125000
NODE_57646_length_444_cov_16.544928	316	396	2	18	80	0.2250000
NODE_57646_length_444_cov_16.544928	316	396	4	9	80	0.1125000
NODE_57646_length_444_cov_16.544928	316	396	5	2	80	0.0250000
NODE_57646_length_444_cov_16.544928	316	396	6	30	80	0.3750000
NODE_57646_length_444_cov_16.544928	316	396	8	21	80	0.2625000
NODE_57647_length_444_cov_12.684058	293	373	1	80	80	1.0000000
NODE_57647_length_444_cov_12.684058	346	426	1	80	80	1.0000000
NODE_57649_length_444_cov_9.284058	176	256	0	7	80	0.0875000
NODE_57649_length_444_cov_9.284058	176	256	2	73	80	0.9125000
NODE_57649_length_444_cov_9.284058	229	309	0	35	80	0.4375000
NODE_57649_length_444_cov_9.284058	229	309	2	45	80	0.5625000
NODE_57666_length_444_cov_5.159420	170	241	0	71	71	1.0000000
NODE_57668_length_444_cov_5.060870	201	245	0	11	44	0.2500000
NODE_57668_length_444_cov_5.060870	201	245	2	33	44	0.7500000
NODE_57668_length_444_cov_5.060870	218	298	0	64	80	0.8000000
NODE_57668_length_444_cov_5.060870	218	298	2	16	80	0.2000000
NODE_57717_length_444_cov_2.744928	73	136	0	63	63	1.0000000
NODE_57770_length_444_cov_2.028986	46	113	18	1	67	0.0149254
NODE_57770_length_444_cov_2.028986	46	113	20	1	67	0.0149254
NODE_57770_length_444_cov_2.028986	46	113	21	1	67	0.0149254
NODE_57770_length_444_cov_2.028986	46	113	22	2	67	0.0298507
NODE_57770_length_444_cov_2.028986	46	113	24	4	67	0.0597015
NODE_57770_length_444_cov_2.028986	46	113	25	1	67	0.0149254
NODE_57770_length_444_cov_2.028986	46	113	27	1	67	0.0149254
NODE_57770_length_444_cov_2.028986	46	113	29	1	67	0.0149254
NODE_57770_length_444_cov_2.028986	46	113	31	6	67	0.0895522
NODE_57770_length_444_cov_2.028986	46	113	32	2	67	0.0298507
NODE_57770_length_444_cov_2.028986	46	113	33	3	67	0.0447761
NODE_57770_length_444_cov_2.028986	46	113	36	1	67	0.0149254
NODE_57770_length_444_cov_2.028986	46	113	37	2	67	0.0298507
NODE_57770_length_444_cov_2.028986	46	113	39	3	67	0.0447761
NODE_57770_length_444_cov_2.028986	46	113	40	1	67	0.0149254
NODE_57770_length_444_cov_2.028986	46	113	41	6	67	0.0895522
NODE_57770_length_444_cov_2.028986	46	113	43	9	67	0.1343284
NODE_57770_length_444_cov_2.028986	46	113	44	6	67	0.0895522
NODE_57770_length_444_cov_2.028986	46	113	45	16	67	0.2388060
NODE_57770_length_444_cov_2.028986	86	166	37	2	80	0.0250000
NODE_57770_length_444_cov_2.028986	86	166	39	1	80	0.0125000
NODE_57770_length_444_cov_2.028986	86	166	40	2	80	0.0250000
NODE_57770_length_444_cov_2.028986	86	166	42	8	80	0.1000000
NODE_57770_length_444_cov_2.028986	86	166	43	5	80	0.0625000
NODE_57770_length_444_cov_2.028986	86	166	44	6	80	0.0750000
NODE_57770_length_444_cov_2.028986	86	166	45	17	80	0.2125000
NODE_57770_length_444_cov_2.028986	86	166	47	2	80	0.0250000
NODE_57770_length_444_cov_2.028986	86	166	48	1	80	0.0125000
NODE_57770_length_444_cov_2.028986	86	166	49	22	80	0.2750000
NODE_57770_length_444_cov_2.028986	86	166	50	6	80	0.0750000
NODE_57770_length_444_cov_2.028986	86	166	51	8	80	0.1000000
NODE_57873_length_444_cov_1.234783	335	407	0	72	72	1.0000000
NODE_57892_length_444_cov_1.173913	7	87	0	80	80	1.0000000
NODE_58026_length_443_cov_71.284884	209	289	4	18	80	0.2250000
NODE_58026_length_443_cov_71.284884	209	289	6	12	80	0.1500000
NODE_58026_length_443_cov_71.284884	209	289	7	7	80	0.0875000
NODE_58026_length_443_cov_71.284884	209	289	8	43	80	0.5375000
NODE_58026_length_443_cov_71.284884	262	342	7	19	80	0.2375000
NODE_58026_length_443_cov_71.284884	262	342	8	52	80	0.6500000
NODE_58026_length_443_cov_71.284884	262	342	9	9	80	0.1125000
NODE_58026_length_443_cov_71.284884	338	418	1	41	80	0.5125000
NODE_58026_length_443_cov_71.284884	338	418	3	11	80	0.1375000
NODE_58026_length_443_cov_71.284884	338	418	5	11	80	0.1375000
NODE_58026_length_443_cov_71.284884	338	418	6	9	80	0.1125000
NODE_58026_length_443_cov_71.284884	338	418	7	8	80	0.1000000
NODE_58026_length_443_cov_71.284884	391	443	1	52	52	1.0000000
NODE_58027_length_443_cov_68.973837	314	394	4	56	80	0.7000000
NODE_58027_length_443_cov_68.973837	314	394	5	24	80	0.3000000
NODE_58027_length_443_cov_68.973837	367	443	2	7	76	0.0921053
NODE_58027_length_443_cov_68.973837	367	443	4	69	76	0.9078947
NODE_58028_length_443_cov_61.116279	34	114	3	21	80	0.2625000
NODE_58028_length_443_cov_61.116279	34	114	5	20	80	0.2500000
NODE_58028_length_443_cov_61.116279	34	114	6	11	80	0.1375000
NODE_58028_length_443_cov_61.116279	34	114	7	4	80	0.0500000
NODE_58028_length_443_cov_61.116279	34	114	8	3	80	0.0375000
NODE_58028_length_443_cov_61.116279	34	114	10	3	80	0.0375000
NODE_58028_length_443_cov_61.116279	34	114	12	8	80	0.1000000
NODE_58028_length_443_cov_61.116279	34	114	13	10	80	0.1250000
NODE_58028_length_443_cov_61.116279	87	167	7	3	80	0.0375000
NODE_58028_length_443_cov_61.116279	87	167	8	3	80	0.0375000
NODE_58028_length_443_cov_61.116279	87	167	10	3	80	0.0375000
NODE_58028_length_443_cov_61.116279	87	167	12	8	80	0.1000000
NODE_58028_length_443_cov_61.116279	87	167	13	11	80	0.1375000
NODE_58028_length_443_cov_61.116279	87	167	14	5	80	0.0625000
NODE_58028_length_443_cov_61.116279	87	167	15	27	80	0.3375000
NODE_58028_length_443_cov_61.116279	87	167	16	18	80	0.2250000
NODE_58028_length_443_cov_61.116279	87	167	17	2	80	0.0250000
NODE_58041_length_443_cov_4.895349	127	207	0	6	80	0.0750000
NODE_58041_length_443_cov_4.895349	127	207	1	62	80	0.7750000
NODE_58041_length_443_cov_4.895349	127	207	2	12	80	0.1500000
NODE_58086_length_443_cov_2.581395	121	195	0	74	74	1.0000000
NODE_58088_length_443_cov_2.508721	297	347	0	50	50	1.0000000
NODE_58088_length_443_cov_2.508721	320	395	0	75	75	1.0000000
NODE_58091_length_443_cov_2.456395	114	192	0	36	78	0.4615385
NODE_58091_length_443_cov_2.456395	114	192	1	24	78	0.3076923
NODE_58091_length_443_cov_2.456395	114	192	2	18	78	0.2307692
NODE_58091_length_443_cov_2.456395	118	141	0	23	23	1.0000000
NODE_58237_length_443_cov_1.151163	144	224	2	80	80	1.0000000
NODE_58321_length_443_cov_0.715116	52	104	0	49	52	0.9423077
NODE_58321_length_443_cov_0.715116	52	104	1	3	52	0.0576923
NODE_58321_length_443_cov_0.715116	105	146	1	25	41	0.6097561
NODE_58321_length_443_cov_0.715116	105	146	2	16	41	0.3902439
NODE_58346_length_442_cov_42.956268	290	375	3	22	85	0.2588235
NODE_58346_length_442_cov_42.956268	290	375	5	1	85	0.0117647
NODE_58346_length_442_cov_42.956268	290	375	6	1	85	0.0117647
NODE_58346_length_442_cov_42.956268	290	375	7	61	85	0.7176471
NODE_58346_length_442_cov_42.956268	290	375	3	22	85	0.2588235
NODE_58346_length_442_cov_42.956268	290	375	5	1	85	0.0117647
NODE_58346_length_442_cov_42.956268	290	375	6	1	85	0.0117647
NODE_58346_length_442_cov_42.956268	290	375	7	61	85	0.7176471
NODE_58347_length_442_cov_24.093294	225	305	3	4	80	0.0500000
NODE_58347_length_442_cov_24.093294	225	305	4	11	80	0.1375000
NODE_58347_length_442_cov_24.093294	225	305	6	17	80	0.2125000
NODE_58347_length_442_cov_24.093294	225	305	7	46	80	0.5750000
NODE_58347_length_442_cov_24.093294	225	305	8	2	80	0.0250000
NODE_58347_length_442_cov_24.093294	278	358	3	19	80	0.2375000
NODE_58347_length_442_cov_24.093294	278	358	5	19	80	0.2375000
NODE_58347_length_442_cov_24.093294	278	358	7	42	80	0.5250000
NODE_58348_length_442_cov_8.956268	173	192	0	19	19	1.0000000
NODE_58361_length_442_cov_5.052478	213	293	4	38	80	0.4750000
NODE_58361_length_442_cov_5.052478	213	293	5	13	80	0.1625000
NODE_58361_length_442_cov_5.052478	213	293	6	26	80	0.3250000
NODE_58361_length_442_cov_5.052478	213	293	7	3	80	0.0375000
NODE_58361_length_442_cov_5.052478	266	346	3	21	80	0.2625000
NODE_58361_length_442_cov_5.052478	266	346	4	34	80	0.4250000
NODE_58361_length_442_cov_5.052478	266	346	5	25	80	0.3125000
NODE_58376_length_442_cov_3.871720	297	372	2	1	75	0.0133333
NODE_58376_length_442_cov_3.871720	297	372	4	74	75	0.9866667
NODE_58376_length_442_cov_3.871720	360	413	0	13	53	0.2452830
NODE_58376_length_442_cov_3.871720	360	413	2	18	53	0.3396226
NODE_58376_length_442_cov_3.871720	360	413	4	22	53	0.4150943
NODE_58378_length_442_cov_3.804665	211	244	0	32	33	0.9696970
NODE_58378_length_442_cov_3.804665	211	244	4	1	33	0.0303030
NODE_58405_length_442_cov_3.206997	149	217	0	68	68	1.0000000
NODE_58438_length_442_cov_2.434402	203	274	2	71	71	1.0000000
NODE_58438_length_442_cov_2.434402	247	327	2	52	80	0.6500000
NODE_58438_length_442_cov_2.434402	247	327	4	28	80	0.3500000
NODE_58503_length_442_cov_1.746356	95	161	0	66	66	1.0000000
NODE_58503_length_442_cov_1.746356	95	122	0	27	27	1.0000000
NODE_58759_length_441_cov_21.877193	28	108	2	5	80	0.0625000
NODE_58759_length_441_cov_21.877193	28	108	4	15	80	0.1875000
NODE_58759_length_441_cov_21.877193	28	108	5	3	80	0.0375000
NODE_58759_length_441_cov_21.877193	28	108	6	56	80	0.7000000
NODE_58759_length_441_cov_21.877193	28	108	7	1	80	0.0125000
NODE_58759_length_441_cov_21.877193	81	161	6	26	80	0.3250000
NODE_58759_length_441_cov_21.877193	81	161	7	44	80	0.5500000
NODE_58759_length_441_cov_21.877193	81	161	8	10	80	0.1250000
NODE_58760_length_441_cov_13.546784	152	232	0	1	80	0.0125000
NODE_58760_length_441_cov_13.546784	152	232	2	79	80	0.9875000
NODE_58760_length_441_cov_13.546784	205	285	2	80	80	1.0000000
NODE_58771_length_441_cov_5.710526	200	280	0	14	80	0.1750000
NODE_58771_length_441_cov_5.710526	200	280	2	66	80	0.8250000
NODE_58771_length_441_cov_5.710526	253	333	0	67	80	0.8375000
NODE_58771_length_441_cov_5.710526	253	333	2	13	80	0.1625000
NODE_58817_length_441_cov_3.096491	240	324	0	84	84	1.0000000
NODE_58820_length_441_cov_3.023392	105	163	0	58	58	1.0000000
NODE_58852_length_441_cov_2.438596	19	99	0	80	80	1.0000000
NODE_58852_length_441_cov_2.438596	72	126	0	54	54	1.0000000
NODE_58970_length_441_cov_1.435673	105	156	0	51	51	1.0000000
NODE_59142_length_440_cov_43.131965	122	202	3	80	80	1.0000000
NODE_59142_length_440_cov_43.131965	175	255	0	2	80	0.0250000
NODE_59142_length_440_cov_43.131965	175	255	1	19	80	0.2375000
NODE_59142_length_440_cov_43.131965	175	255	2	21	80	0.2625000
NODE_59142_length_440_cov_43.131965	175	255	3	38	80	0.4750000
NODE_59142_length_440_cov_43.131965	251	331	0	3	80	0.0375000
NODE_59142_length_440_cov_43.131965	251	331	1	2	80	0.0250000
NODE_59142_length_440_cov_43.131965	251	331	2	9	80	0.1125000
NODE_59142_length_440_cov_43.131965	251	331	6	39	80	0.4875000
NODE_59142_length_440_cov_43.131965	251	331	8	3	80	0.0375000
NODE_59142_length_440_cov_43.131965	251	331	10	24	80	0.3000000
NODE_59142_length_440_cov_43.131965	304	384	8	3	80	0.0375000
NODE_59142_length_440_cov_43.131965	304	384	10	77	80	0.9625000
NODE_59143_length_440_cov_42.929619	116	196	2	80	80	1.0000000
NODE_59143_length_440_cov_42.929619	169	249	0	1	80	0.0125000
NODE_59143_length_440_cov_42.929619	169	249	2	79	80	0.9875000
NODE_59147_length_440_cov_8.164223	45	125	0	32	80	0.4000000
NODE_59147_length_440_cov_8.164223	45	125	2	48	80	0.6000000
NODE_59147_length_440_cov_8.164223	98	178	2	80	80	1.0000000
NODE_59157_length_440_cov_5.193548	146	210	0	50	64	0.7812500
NODE_59157_length_440_cov_5.193548	146	210	2	14	64	0.2187500
NODE_59157_length_440_cov_5.193548	146	210	0	50	64	0.7812500
NODE_59157_length_440_cov_5.193548	146	210	2	14	64	0.2187500
NODE_59157_length_440_cov_5.193548	146	210	0	50	64	0.7812500
NODE_59157_length_440_cov_5.193548	146	210	2	14	64	0.2187500
NODE_59164_length_440_cov_4.595308	153	233	0	80	80	1.0000000
NODE_59164_length_440_cov_4.595308	153	180	0	27	27	1.0000000
NODE_59188_length_440_cov_3.431085	84	150	0	66	66	1.0000000
NODE_59191_length_440_cov_3.331378	139	195	0	56	56	1.0000000
NODE_59517_length_439_cov_76.552941	0	68	1	3	68	0.0441176
NODE_59517_length_439_cov_76.552941	0	68	2	2	68	0.0294118
NODE_59517_length_439_cov_76.552941	0	68	3	26	68	0.3823529
NODE_59517_length_439_cov_76.552941	0	68	4	11	68	0.1617647
NODE_59517_length_439_cov_76.552941	0	68	6	19	68	0.2794118
NODE_59517_length_439_cov_76.552941	0	68	7	7	68	0.1029412
NODE_59517_length_439_cov_76.552941	0	68	1	3	68	0.0441176
NODE_59517_length_439_cov_76.552941	0	68	2	2	68	0.0294118
NODE_59517_length_439_cov_76.552941	0	68	3	26	68	0.3823529
NODE_59517_length_439_cov_76.552941	0	68	4	11	68	0.1617647
NODE_59517_length_439_cov_76.552941	0	68	6	19	68	0.2794118
NODE_59517_length_439_cov_76.552941	0	68	7	7	68	0.1029412
NODE_59517_length_439_cov_76.552941	0	68	1	3	68	0.0441176
NODE_59517_length_439_cov_76.552941	0	68	2	2	68	0.0294118
NODE_59517_length_439_cov_76.552941	0	68	3	26	68	0.3823529
NODE_59517_length_439_cov_76.552941	0	68	4	11	68	0.1617647
NODE_59517_length_439_cov_76.552941	0	68	6	19	68	0.2794118
NODE_59517_length_439_cov_76.552941	0	68	7	7	68	0.1029412
NODE_59517_length_439_cov_76.552941	1	68	1	2	67	0.0298507
NODE_59517_length_439_cov_76.552941	1	68	2	2	67	0.0298507
NODE_59517_length_439_cov_76.552941	1	68	3	26	67	0.3880597
NODE_59517_length_439_cov_76.552941	1	68	4	11	67	0.1641791
NODE_59517_length_439_cov_76.552941	1	68	6	19	67	0.2835821
NODE_59517_length_439_cov_76.552941	1	68	7	7	67	0.1044776
NODE_59517_length_439_cov_76.552941	64	144	7	39	80	0.4875000
NODE_59517_length_439_cov_76.552941	64	144	8	2	80	0.0250000
NODE_59517_length_439_cov_76.552941	64	144	10	11	80	0.1375000
NODE_59517_length_439_cov_76.552941	64	144	11	12	80	0.1500000
NODE_59517_length_439_cov_76.552941	64	144	12	16	80	0.2000000
NODE_59517_length_439_cov_76.552941	64	144	7	39	80	0.4875000
NODE_59517_length_439_cov_76.552941	64	144	8	2	80	0.0250000
NODE_59517_length_439_cov_76.552941	64	144	10	11	80	0.1375000
NODE_59517_length_439_cov_76.552941	64	144	11	12	80	0.1500000
NODE_59517_length_439_cov_76.552941	64	144	12	16	80	0.2000000
NODE_59517_length_439_cov_76.552941	117	197	7	17	80	0.2125000
NODE_59517_length_439_cov_76.552941	117	197	8	23	80	0.2875000
NODE_59517_length_439_cov_76.552941	117	197	9	2	80	0.0250000
NODE_59517_length_439_cov_76.552941	117	197	10	2	80	0.0250000
NODE_59517_length_439_cov_76.552941	117	197	11	16	80	0.2000000
NODE_59517_length_439_cov_76.552941	117	197	12	20	80	0.2500000
NODE_59517_length_439_cov_76.552941	117	195	7	15	78	0.1923077
NODE_59517_length_439_cov_76.552941	117	195	8	23	78	0.2948718
NODE_59517_length_439_cov_76.552941	117	195	9	2	78	0.0256410
NODE_59517_length_439_cov_76.552941	117	195	10	2	78	0.0256410
NODE_59517_length_439_cov_76.552941	117	195	11	16	78	0.2051282
NODE_59517_length_439_cov_76.552941	117	195	12	20	78	0.2564103
NODE_59533_length_439_cov_4.408824	174	238	0	64	64	1.0000000
NODE_59536_length_439_cov_4.255882	258	318	0	60	60	1.0000000
NODE_59560_length_439_cov_3.011765	57	128	6	50	71	0.7042254
NODE_59560_length_439_cov_3.011765	57	128	7	19	71	0.2676056
NODE_59560_length_439_cov_3.011765	57	128	9	2	71	0.0281690
NODE_59560_length_439_cov_3.011765	101	140	6	6	39	0.1538462
NODE_59560_length_439_cov_3.011765	101	140	7	23	39	0.5897436
NODE_59560_length_439_cov_3.011765	101	140	8	5	39	0.1282051
NODE_59560_length_439_cov_3.011765	101	140	9	5	39	0.1282051
NODE_59592_length_439_cov_2.252941	227	269	0	42	42	1.0000000
NODE_59599_length_439_cov_2.135294	116	179	0	48	63	0.7619048
NODE_59599_length_439_cov_2.135294	116	179	1	15	63	0.2380952
NODE_59617_length_439_cov_1.929412	388	439	0	51	51	1.0000000
NODE_59897_length_438_cov_29.952802	196	276	7	12	80	0.1500000
NODE_59897_length_438_cov_29.952802	196	276	8	62	80	0.7750000
NODE_59897_length_438_cov_29.952802	196	276	9	4	80	0.0500000
NODE_59897_length_438_cov_29.952802	196	276	10	2	80	0.0250000
NODE_59897_length_438_cov_29.952802	249	329	3	10	80	0.1250000
NODE_59897_length_438_cov_29.952802	249	329	5	2	80	0.0250000
NODE_59897_length_438_cov_29.952802	249	329	7	18	80	0.2250000
NODE_59897_length_438_cov_29.952802	249	329	8	44	80	0.5500000
NODE_59897_length_438_cov_29.952802	249	329	9	4	80	0.0500000
NODE_59897_length_438_cov_29.952802	249	329	10	2	80	0.0250000
NODE_59898_length_438_cov_16.330383	225	305	4	80	80	1.0000000
NODE_59898_length_438_cov_16.330383	278	358	0	4	80	0.0500000
NODE_59898_length_438_cov_16.330383	278	358	4	76	80	0.9500000
NODE_59899_length_438_cov_15.436578	74	154	5	4	80	0.0500000
NODE_59899_length_438_cov_15.436578	74	154	7	16	80	0.2000000
NODE_59899_length_438_cov_15.436578	74	154	8	1	80	0.0125000
NODE_59899_length_438_cov_15.436578	74	154	9	10	80	0.1250000
NODE_59899_length_438_cov_15.436578	74	154	10	49	80	0.6125000
NODE_59899_length_438_cov_15.436578	127	207	6	6	80	0.0750000
NODE_59899_length_438_cov_15.436578	127	207	8	20	80	0.2500000
NODE_59899_length_438_cov_15.436578	127	207	10	54	80	0.6750000
NODE_59901_length_438_cov_9.306785	256	309	0	53	53	1.0000000
NODE_59901_length_438_cov_9.306785	282	327	0	45	45	1.0000000
NODE_59916_length_438_cov_4.808260	46	133	3	15	87	0.1724138
NODE_59916_length_438_cov_4.808260	46	133	4	17	87	0.1954023
NODE_59916_length_438_cov_4.808260	46	133	5	8	87	0.0919540
NODE_59916_length_438_cov_4.808260	46	133	6	2	87	0.0229885
NODE_59916_length_438_cov_4.808260	46	133	7	2	87	0.0229885
NODE_59916_length_438_cov_4.808260	46	133	8	6	87	0.0689655
NODE_59916_length_438_cov_4.808260	46	133	9	1	87	0.0114943
NODE_59916_length_438_cov_4.808260	46	133	10	13	87	0.1494253
NODE_59916_length_438_cov_4.808260	46	133	11	23	87	0.2643678
NODE_59916_length_438_cov_4.808260	106	186	10	44	80	0.5500000
NODE_59916_length_438_cov_4.808260	106	186	11	36	80	0.4500000
NODE_59920_length_438_cov_4.622419	135	184	1	29	49	0.5918368
NODE_59920_length_438_cov_4.622419	135	184	2	20	49	0.4081633
NODE_59936_length_438_cov_3.651917	86	166	2	80	80	1.0000000
NODE_59936_length_438_cov_3.651917	139	219	0	12	80	0.1500000
NODE_59936_length_438_cov_3.651917	139	219	2	68	80	0.8500000
NODE_59952_length_438_cov_3.109145	215	273	0	58	58	1.0000000
NODE_59957_length_438_cov_3.005900	175	258	0	83	83	1.0000000
NODE_60317_length_437_cov_57.260355	272	352	0	80	80	1.0000000
NODE_60317_length_437_cov_57.260355	325	405	0	80	80	1.0000000
NODE_60318_length_437_cov_40.964497	0	73	0	26	73	0.3561644
NODE_60318_length_437_cov_40.964497	0	73	1	47	73	0.6438356
NODE_60318_length_437_cov_40.964497	46	126	1	76	80	0.9500000
NODE_60318_length_437_cov_40.964497	46	126	2	4	80	0.0500000
NODE_60319_length_437_cov_30.843195	140	220	0	80	80	1.0000000
NODE_60319_length_437_cov_30.843195	193	273	0	80	80	1.0000000
NODE_60320_length_437_cov_14.736686	164	244	0	80	80	1.0000000
NODE_60320_length_437_cov_14.736686	217	297	0	80	80	1.0000000
NODE_60331_length_437_cov_6.032544	249	320	0	59	71	0.8309859
NODE_60331_length_437_cov_6.032544	249	320	2	12	71	0.1690141
NODE_60332_length_437_cov_6.020710	272	352	1	33	80	0.4125000
NODE_60332_length_437_cov_6.020710	272	352	2	47	80	0.5875000
NODE_60332_length_437_cov_6.020710	325	405	1	57	80	0.7125000
NODE_60332_length_437_cov_6.020710	325	405	2	23	80	0.2875000
NODE_60336_length_437_cov_5.526627	129	209	0	51	80	0.6375000
NODE_60336_length_437_cov_5.526627	129	209	1	29	80	0.3625000
NODE_60336_length_437_cov_5.526627	182	262	1	80	80	1.0000000
NODE_60348_length_437_cov_4.505917	247	327	0	80	80	1.0000000
NODE_60361_length_437_cov_3.470414	204	259	0	55	55	1.0000000
NODE_60369_length_437_cov_3.301775	95	149	0	54	54	1.0000000
NODE_60381_length_437_cov_2.911243	91	171	0	21	80	0.2625000
NODE_60381_length_437_cov_2.911243	91	171	2	11	80	0.1375000
NODE_60381_length_437_cov_2.911243	91	171	3	17	80	0.2125000
NODE_60381_length_437_cov_2.911243	91	171	5	3	80	0.0375000
NODE_60381_length_437_cov_2.911243	91	171	6	3	80	0.0375000
NODE_60381_length_437_cov_2.911243	91	171	7	1	80	0.0125000
NODE_60381_length_437_cov_2.911243	91	171	8	4	80	0.0500000
NODE_60381_length_437_cov_2.911243	91	171	10	20	80	0.2500000
NODE_60400_length_437_cov_2.650888	190	239	2	49	49	1.0000000
NODE_60400_length_437_cov_2.650888	212	292	0	23	80	0.2875000
NODE_60400_length_437_cov_2.650888	212	292	2	57	80	0.7125000
NODE_60411_length_437_cov_2.514793	292	333	0	41	41	1.0000000
NODE_60509_length_437_cov_1.473373	252	324	0	72	72	1.0000000
NODE_60709_length_436_cov_125.940653	204	284	1	38	80	0.4750000
NODE_60709_length_436_cov_125.940653	204	284	2	3	80	0.0375000
NODE_60709_length_436_cov_125.940653	204	284	6	7	80	0.0875000
NODE_60709_length_436_cov_125.940653	204	284	8	10	80	0.1250000
NODE_60709_length_436_cov_125.940653	204	284	9	13	80	0.1625000
NODE_60709_length_436_cov_125.940653	204	284	10	4	80	0.0500000
NODE_60709_length_436_cov_125.940653	204	284	11	5	80	0.0625000
NODE_60709_length_436_cov_125.940653	255	301	0	5	46	0.1086956
NODE_60709_length_436_cov_125.940653	255	301	1	41	46	0.8913044
NODE_60709_length_436_cov_125.940653	257	337	0	15	80	0.1875000
NODE_60709_length_436_cov_125.940653	257	337	1	39	80	0.4875000
NODE_60709_length_436_cov_125.940653	257	337	2	26	80	0.3250000
NODE_60709_length_436_cov_125.940653	333	413	0	24	80	0.3000000
NODE_60709_length_436_cov_125.940653	333	413	2	56	80	0.7000000
NODE_60709_length_436_cov_125.940653	386	436	0	47	50	0.9400000
NODE_60709_length_436_cov_125.940653	386	436	2	3	50	0.0600000
NODE_60712_length_436_cov_45.459941	166	246	1	21	80	0.2625000
NODE_60712_length_436_cov_45.459941	166	246	2	19	80	0.2375000
NODE_60712_length_436_cov_45.459941	166	246	3	38	80	0.4750000
NODE_60712_length_436_cov_45.459941	166	246	4	2	80	0.0250000
NODE_60712_length_436_cov_45.459941	219	299	3	25	80	0.3125000
NODE_60712_length_436_cov_45.459941	219	299	4	15	80	0.1875000
NODE_60712_length_436_cov_45.459941	219	299	5	21	80	0.2625000
NODE_60712_length_436_cov_45.459941	219	299	6	15	80	0.1875000
NODE_60712_length_436_cov_45.459941	219	299	7	4	80	0.0500000
NODE_60712_length_436_cov_45.459941	295	375	7	9	80	0.1125000
NODE_60712_length_436_cov_45.459941	295	375	8	11	80	0.1375000
NODE_60712_length_436_cov_45.459941	295	375	9	33	80	0.4125000
NODE_60712_length_436_cov_45.459941	295	375	10	27	80	0.3375000
NODE_60712_length_436_cov_45.459941	348	428	6	2	80	0.0250000
NODE_60712_length_436_cov_45.459941	348	428	7	17	80	0.2125000
NODE_60712_length_436_cov_45.459941	348	428	8	15	80	0.1875000
NODE_60712_length_436_cov_45.459941	348	428	9	38	80	0.4750000
NODE_60712_length_436_cov_45.459941	348	428	10	8	80	0.1000000
NODE_60713_length_436_cov_10.560831	74	154	0	80	80	1.0000000
NODE_60713_length_436_cov_10.560831	127	207	0	80	80	1.0000000
NODE_60716_length_436_cov_8.317507	51	127	1	21	76	0.2763158
NODE_60716_length_436_cov_8.317507	51	127	2	55	76	0.7236842
NODE_60716_length_436_cov_8.317507	104	182	2	32	78	0.4102564
NODE_60716_length_436_cov_8.317507	104	182	3	17	78	0.2179487
NODE_60716_length_436_cov_8.317507	104	182	6	11	78	0.1410256
NODE_60716_length_436_cov_8.317507	104	182	7	18	78	0.2307692
NODE_60760_length_436_cov_3.109792	153	205	0	52	52	1.0000000
NODE_60786_length_436_cov_2.551929	182	258	0	76	76	1.0000000
NODE_60786_length_436_cov_2.551929	235	315	0	80	80	1.0000000
NODE_60934_length_436_cov_1.207715	105	181	0	76	76	1.0000000
NODE_61088_length_435_cov_17.401786	55	135	5	12	80	0.1500000
NODE_61088_length_435_cov_17.401786	55	135	7	9	80	0.1125000
NODE_61088_length_435_cov_17.401786	55	135	8	7	80	0.0875000
NODE_61088_length_435_cov_17.401786	55	135	9	9	80	0.1125000
NODE_61088_length_435_cov_17.401786	55	135	10	1	80	0.0125000
NODE_61088_length_435_cov_17.401786	55	135	11	18	80	0.2250000
NODE_61088_length_435_cov_17.401786	55	135	16	24	80	0.3000000
NODE_61088_length_435_cov_17.401786	108	188	11	3	80	0.0375000
NODE_61088_length_435_cov_17.401786	108	188	13	12	80	0.1500000
NODE_61088_length_435_cov_17.401786	108	188	15	24	80	0.3000000
NODE_61088_length_435_cov_17.401786	108	188	16	35	80	0.4375000
NODE_61088_length_435_cov_17.401786	108	188	17	6	80	0.0750000
NODE_61094_length_435_cov_6.910714	113	193	0	80	80	1.0000000
NODE_61094_length_435_cov_6.910714	147	194	0	47	47	1.0000000
NODE_61094_length_435_cov_6.910714	149	184	0	35	35	1.0000000
NODE_61094_length_435_cov_6.910714	151	193	0	42	42	1.0000000
NODE_61094_length_435_cov_6.910714	166	251	0	85	85	1.0000000
NODE_61094_length_435_cov_6.910714	167	251	0	84	84	1.0000000
NODE_61102_length_435_cov_5.630952	159	217	0	37	58	0.6379310
NODE_61102_length_435_cov_5.630952	159	217	2	21	58	0.3620690
NODE_61102_length_435_cov_5.630952	190	270	0	6	80	0.0750000
NODE_61102_length_435_cov_5.630952	190	270	2	74	80	0.9250000
NODE_61112_length_435_cov_4.601190	271	309	0	38	38	1.0000000
NODE_61112_length_435_cov_4.601190	282	344	0	62	62	1.0000000
NODE_61122_length_435_cov_3.770833	209	240	2	31	31	1.0000000
NODE_61137_length_435_cov_2.836310	113	194	4	81	81	1.0000000
NODE_61357_length_435_cov_0.988095	286	322	0	36	36	1.0000000
NODE_61451_length_434_cov_136.483582	0	58	2	2	58	0.0344828
NODE_61451_length_434_cov_136.483582	0	58	4	1	58	0.0172414
NODE_61451_length_434_cov_136.483582	0	58	7	2	58	0.0344828
NODE_61451_length_434_cov_136.483582	0	58	8	1	58	0.0172414
NODE_61451_length_434_cov_136.483582	0	58	12	1	58	0.0172414
NODE_61451_length_434_cov_136.483582	0	58	13	4	58	0.0689655
NODE_61451_length_434_cov_136.483582	0	58	14	2	58	0.0344828
NODE_61451_length_434_cov_136.483582	0	58	16	3	58	0.0517241
NODE_61451_length_434_cov_136.483582	0	58	17	5	58	0.0862069
NODE_61451_length_434_cov_136.483582	0	58	18	7	58	0.1206897
NODE_61451_length_434_cov_136.483582	0	58	19	5	58	0.0862069
NODE_61451_length_434_cov_136.483582	0	58	20	3	58	0.0517241
NODE_61451_length_434_cov_136.483582	0	58	21	6	58	0.1034483
NODE_61451_length_434_cov_136.483582	0	58	22	11	58	0.1896552
NODE_61451_length_434_cov_136.483582	0	58	24	1	58	0.0172414
NODE_61451_length_434_cov_136.483582	0	58	25	4	58	0.0689655
NODE_61451_length_434_cov_136.483582	31	111	19	2	80	0.0250000
NODE_61451_length_434_cov_136.483582	31	111	20	3	80	0.0375000
NODE_61451_length_434_cov_136.483582	31	111	21	6	80	0.0750000
NODE_61451_length_434_cov_136.483582	31	111	22	11	80	0.1375000
NODE_61451_length_434_cov_136.483582	31	111	24	1	80	0.0125000
NODE_61451_length_434_cov_136.483582	31	111	25	5	80	0.0625000
NODE_61451_length_434_cov_136.483582	31	111	27	6	80	0.0750000
NODE_61451_length_434_cov_136.483582	31	111	29	2	80	0.0250000
NODE_61451_length_434_cov_136.483582	31	111	30	4	80	0.0500000
NODE_61451_length_434_cov_136.483582	31	111	31	3	80	0.0375000
NODE_61451_length_434_cov_136.483582	31	111	34	1	80	0.0125000
NODE_61451_length_434_cov_136.483582	31	111	35	5	80	0.0625000
NODE_61451_length_434_cov_136.483582	31	111	39	12	80	0.1500000
NODE_61451_length_434_cov_136.483582	31	111	40	1	80	0.0125000
NODE_61451_length_434_cov_136.483582	31	111	42	2	80	0.0250000
NODE_61451_length_434_cov_136.483582	31	111	45	3	80	0.0375000
NODE_61451_length_434_cov_136.483582	31	111	46	6	80	0.0750000
NODE_61451_length_434_cov_136.483582	31	111	49	1	80	0.0125000
NODE_61451_length_434_cov_136.483582	31	111	51	3	80	0.0375000
NODE_61451_length_434_cov_136.483582	31	111	52	2	80	0.0250000
NODE_61451_length_434_cov_136.483582	31	111	53	1	80	0.0125000
NODE_61452_length_434_cov_43.214925	291	366	2	20	75	0.2666667
NODE_61452_length_434_cov_43.214925	291	366	4	12	75	0.1600000
NODE_61452_length_434_cov_43.214925	291	366	5	29	75	0.3866667
NODE_61452_length_434_cov_43.214925	291	366	6	14	75	0.1866667
NODE_61452_length_434_cov_43.214925	344	424	0	11	80	0.1375000
NODE_61452_length_434_cov_43.214925	344	424	2	10	80	0.1250000
NODE_61452_length_434_cov_43.214925	344	424	4	16	80	0.2000000
NODE_61452_length_434_cov_43.214925	344	424	5	43	80	0.5375000
NODE_61452_length_434_cov_43.214925	344	424	0	11	80	0.1375000
NODE_61452_length_434_cov_43.214925	344	424	2	10	80	0.1250000
NODE_61452_length_434_cov_43.214925	344	424	4	16	80	0.2000000
NODE_61452_length_434_cov_43.214925	344	424	5	43	80	0.5375000
NODE_61453_length_434_cov_22.373134	80	160	2	4	80	0.0500000
NODE_61453_length_434_cov_22.373134	80	160	4	76	80	0.9500000
NODE_61453_length_434_cov_22.373134	133	213	4	79	80	0.9875000
NODE_61453_length_434_cov_22.373134	133	213	5	1	80	0.0125000
NODE_61455_length_434_cov_11.549254	74	145	0	37	71	0.5211267
NODE_61455_length_434_cov_11.549254	74	145	1	34	71	0.4788733
NODE_61455_length_434_cov_11.549254	118	198	1	80	80	1.0000000
NODE_61477_length_434_cov_4.125373	191	233	0	42	42	1.0000000
NODE_61477_length_434_cov_4.125373	200	235	0	35	35	1.0000000
NODE_61497_length_434_cov_3.104478	191	263	0	72	72	1.0000000
NODE_61528_length_434_cov_2.197015	129	168	0	39	39	1.0000000
NODE_61563_length_434_cov_1.883582	88	133	0	45	45	1.0000000
NODE_61563_length_434_cov_1.883582	141	182	0	25	41	0.6097561
NODE_61563_length_434_cov_1.883582	141	182	1	16	41	0.3902439
NODE_61603_length_434_cov_1.626866	163	243	3	27	80	0.3375000
NODE_61603_length_434_cov_1.626866	163	243	4	53	80	0.6625000
NODE_61676_length_434_cov_1.220896	118	198	16	4	80	0.0500000
NODE_61676_length_434_cov_1.220896	118	198	17	4	80	0.0500000
NODE_61676_length_434_cov_1.220896	118	198	18	20	80	0.2500000
NODE_61676_length_434_cov_1.220896	118	198	20	2	80	0.0250000
NODE_61676_length_434_cov_1.220896	118	198	22	8	80	0.1000000
NODE_61676_length_434_cov_1.220896	118	198	23	8	80	0.1000000
NODE_61676_length_434_cov_1.220896	118	198	24	31	80	0.3875000
NODE_61676_length_434_cov_1.220896	118	198	26	3	80	0.0375000
NODE_61727_length_434_cov_1.002985	245	286	1	13	41	0.3170732
NODE_61727_length_434_cov_1.002985	245	286	3	17	41	0.4146341
NODE_61727_length_434_cov_1.002985	245	286	4	11	41	0.2682927
NODE_61727_length_434_cov_1.002985	258	339	1	66	81	0.8148148
NODE_61727_length_434_cov_1.002985	258	339	3	15	81	0.1851852
NODE_61826_length_433_cov_51.392216	2	82	0	3	80	0.0375000
NODE_61826_length_433_cov_51.392216	2	82	1	22	80	0.2750000
NODE_61826_length_433_cov_51.392216	2	82	5	55	80	0.6875000
NODE_61826_length_433_cov_51.392216	55	135	5	80	80	1.0000000
NODE_61826_length_433_cov_51.392216	131	213	1	54	82	0.6585366
NODE_61826_length_433_cov_51.392216	131	213	3	4	82	0.0487805
NODE_61826_length_433_cov_51.392216	131	213	4	11	82	0.1341463
NODE_61826_length_433_cov_51.392216	131	213	5	7	82	0.0853659
NODE_61826_length_433_cov_51.392216	131	213	6	6	82	0.0731707
NODE_61826_length_433_cov_51.392216	189	266	1	77	77	1.0000000
NODE_61827_length_433_cov_46.344311	248	328	8	45	80	0.5625000
NODE_61827_length_433_cov_46.344311	248	328	10	35	80	0.4375000
NODE_61827_length_433_cov_46.344311	301	381	3	2	80	0.0250000
NODE_61827_length_433_cov_46.344311	301	381	4	21	80	0.2625000
NODE_61827_length_433_cov_46.344311	301	381	5	7	80	0.0875000
NODE_61827_length_433_cov_46.344311	301	381	6	5	80	0.0625000
NODE_61827_length_433_cov_46.344311	301	381	7	4	80	0.0500000
NODE_61827_length_433_cov_46.344311	301	381	8	1	80	0.0125000
NODE_61827_length_433_cov_46.344311	301	381	9	4	80	0.0500000
NODE_61827_length_433_cov_46.344311	301	381	10	36	80	0.4500000
NODE_61828_length_433_cov_41.808383	92	172	1	18	80	0.2250000
NODE_61828_length_433_cov_41.808383	92	172	3	36	80	0.4500000
NODE_61828_length_433_cov_41.808383	92	172	4	26	80	0.3250000
NODE_61828_length_433_cov_41.808383	145	225	2	15	80	0.1875000
NODE_61828_length_433_cov_41.808383	145	225	3	1	80	0.0125000
NODE_61828_length_433_cov_41.808383	145	225	4	64	80	0.8000000
NODE_61835_length_433_cov_6.227545	157	237	0	80	80	1.0000000
NODE_61836_length_433_cov_6.080838	164	244	0	80	80	1.0000000
NODE_61838_length_433_cov_5.547904	10	80	0	48	70	0.6857143
NODE_61838_length_433_cov_5.547904	10	80	2	22	70	0.3142857
NODE_61838_length_433_cov_5.547904	51	133	0	7	82	0.0853659
NODE_61838_length_433_cov_5.547904	51	133	2	75	82	0.9146342
NODE_61839_length_433_cov_5.476048	81	141	9	10	60	0.1666667
NODE_61839_length_433_cov_5.476048	81	141	10	50	60	0.8333333
NODE_61855_length_433_cov_3.907186	77	107	0	30	30	1.0000000
NODE_61862_length_433_cov_3.595808	231	316	3	4	85	0.0470588
NODE_61862_length_433_cov_3.595808	231	316	5	31	85	0.3647059
NODE_61862_length_433_cov_3.595808	231	316	7	50	85	0.5882353
NODE_61864_length_433_cov_3.526946	107	178	0	71	71	1.0000000
NODE_61931_length_433_cov_2.137725	123	203	0	80	80	1.0000000
NODE_62258_length_432_cov_17.540541	150	230	0	11	80	0.1375000
NODE_62258_length_432_cov_17.540541	150	230	1	69	80	0.8625000
NODE_62258_length_432_cov_17.540541	203	288	0	6	85	0.0705882
NODE_62258_length_432_cov_17.540541	203	288	1	79	85	0.9294118
NODE_62264_length_432_cov_6.555556	52	82	2	30	30	1.0000000
NODE_62268_length_432_cov_5.720721	77	157	3	12	80	0.1500000
NODE_62268_length_432_cov_5.720721	77	157	4	63	80	0.7875000
NODE_62268_length_432_cov_5.720721	77	157	6	5	80	0.0625000
NODE_62268_length_432_cov_5.720721	130	202	0	9	72	0.1250000
NODE_62268_length_432_cov_5.720721	130	202	1	10	72	0.1388889
NODE_62268_length_432_cov_5.720721	130	202	2	12	72	0.1666667
NODE_62268_length_432_cov_5.720721	130	202	3	26	72	0.3611111
NODE_62268_length_432_cov_5.720721	130	202	4	15	72	0.2083333
NODE_62269_length_432_cov_5.387387	65	95	0	30	30	1.0000000
NODE_62270_length_432_cov_5.345345	271	324	2	7	53	0.1320755
NODE_62270_length_432_cov_5.345345	271	324	4	46	53	0.8679245
NODE_62293_length_432_cov_3.678679	78	121	1	1	43	0.0232558
NODE_62293_length_432_cov_3.678679	78	121	2	40	43	0.9302326
NODE_62293_length_432_cov_3.678679	78	121	3	2	43	0.0465116
NODE_62304_length_432_cov_3.246246	87	128	0	29	41	0.7073171
NODE_62304_length_432_cov_3.246246	87	128	2	12	41	0.2926829
NODE_62304_length_432_cov_3.246246	101	167	0	15	66	0.2272727
NODE_62304_length_432_cov_3.246246	101	167	2	15	66	0.2272727
NODE_62304_length_432_cov_3.246246	101	167	4	36	66	0.5454546
NODE_62396_length_432_cov_1.762763	4	71	0	67	67	1.0000000
NODE_62544_length_432_cov_1.027027	44	68	0	24	24	1.0000000
NODE_62650_length_431_cov_35.355422	202	284	0	82	82	1.0000000
NODE_62650_length_431_cov_35.355422	257	333	0	76	76	1.0000000
NODE_62652_length_431_cov_11.207831	185	265	0	20	80	0.2500000
NODE_62652_length_431_cov_11.207831	185	265	2	60	80	0.7500000
NODE_62652_length_431_cov_11.207831	238	318	0	73	80	0.9125000
NODE_62652_length_431_cov_11.207831	238	318	2	7	80	0.0875000
NODE_62657_length_431_cov_7.018072	110	190	0	80	80	1.0000000
NODE_62657_length_431_cov_7.018072	163	243	0	80	80	1.0000000
NODE_62661_length_431_cov_6.292169	123	203	0	80	80	1.0000000
NODE_62668_length_431_cov_5.608434	170	241	0	71	71	1.0000000
NODE_62681_length_431_cov_4.250000	146	216	2	44	70	0.6285715
NODE_62681_length_431_cov_4.250000	146	216	3	26	70	0.3714286
NODE_62684_length_431_cov_3.993976	210	290	0	80	80	1.0000000
NODE_62794_length_431_cov_1.695783	76	156	4	80	80	1.0000000
NODE_62794_length_431_cov_1.695783	129	199	2	16	70	0.2285714
NODE_62794_length_431_cov_1.695783	129	199	4	54	70	0.7714286
NODE_63043_length_430_cov_49.791541	319	399	3	5	80	0.0625000
NODE_63043_length_430_cov_49.791541	319	399	4	10	80	0.1250000
NODE_63043_length_430_cov_49.791541	319	399	5	6	80	0.0750000
NODE_63043_length_430_cov_49.791541	319	399	7	4	80	0.0500000
NODE_63043_length_430_cov_49.791541	319	399	9	3	80	0.0375000
NODE_63043_length_430_cov_49.791541	319	399	10	4	80	0.0500000
NODE_63043_length_430_cov_49.791541	319	399	12	2	80	0.0250000
NODE_63043_length_430_cov_49.791541	319	399	15	3	80	0.0375000
NODE_63043_length_430_cov_49.791541	319	399	16	11	80	0.1375000
NODE_63043_length_430_cov_49.791541	319	399	17	1	80	0.0125000
NODE_63043_length_430_cov_49.791541	319	399	21	13	80	0.1625000
NODE_63043_length_430_cov_49.791541	319	399	23	7	80	0.0875000
NODE_63043_length_430_cov_49.791541	319	399	25	11	80	0.1375000
NODE_63043_length_430_cov_49.791541	372	430	1	25	58	0.4310345
NODE_63043_length_430_cov_49.791541	372	430	3	11	58	0.1896552
NODE_63043_length_430_cov_49.791541	372	430	4	10	58	0.1724138
NODE_63043_length_430_cov_49.791541	372	430	5	6	58	0.1034483
NODE_63043_length_430_cov_49.791541	372	430	7	4	58	0.0689655
NODE_63043_length_430_cov_49.791541	372	430	9	2	58	0.0344828
NODE_63044_length_430_cov_44.365559	109	189	2	9	80	0.1125000
NODE_63044_length_430_cov_44.365559	109	189	5	62	80	0.7750000
NODE_63044_length_430_cov_44.365559	109	189	6	9	80	0.1125000
NODE_63044_length_430_cov_44.365559	162	242	2	62	80	0.7750000
NODE_63044_length_430_cov_44.365559	162	242	5	9	80	0.1125000
NODE_63044_length_430_cov_44.365559	162	242	6	9	80	0.1125000
NODE_63045_length_430_cov_16.746224	92	172	1	3	80	0.0375000
NODE_63045_length_430_cov_16.746224	92	172	2	2	80	0.0250000
NODE_63045_length_430_cov_16.746224	92	172	3	23	80	0.2875000
NODE_63045_length_430_cov_16.746224	92	172	5	20	80	0.2500000
NODE_63045_length_430_cov_16.746224	92	172	7	5	80	0.0625000
NODE_63045_length_430_cov_16.746224	92	172	9	6	80	0.0750000
NODE_63045_length_430_cov_16.746224	92	172	10	21	80	0.2625000
NODE_63045_length_430_cov_16.746224	145	225	9	6	80	0.0750000
NODE_63045_length_430_cov_16.746224	145	225	10	74	80	0.9250000
NODE_63048_length_430_cov_7.737160	180	263	1	7	83	0.0843373
NODE_63048_length_430_cov_7.737160	180	263	2	76	83	0.9156626
NODE_63050_length_430_cov_6.163142	135	197	0	32	62	0.5161290
NODE_63050_length_430_cov_6.163142	135	197	2	30	62	0.4838710
NODE_63051_length_430_cov_5.873112	7	90	0	23	83	0.2771084
NODE_63051_length_430_cov_5.873112	7	90	1	60	83	0.7228916
NODE_63051_length_430_cov_5.873112	60	126	1	66	66	1.0000000
NODE_63066_length_430_cov_4.323263	18	90	0	72	72	1.0000000
NODE_63161_length_430_cov_1.945619	153	233	0	80	80	1.0000000
NODE_63401_length_430_cov_0.664653	391	430	0	39	39	1.0000000
NODE_63437_length_429_cov_10.424242	78	158	0	80	80	1.0000000
NODE_63437_length_429_cov_10.424242	207	287	0	15	80	0.1875000
NODE_63437_length_429_cov_10.424242	207	287	1	13	80	0.1625000
NODE_63437_length_429_cov_10.424242	207	287	2	52	80	0.6500000
NODE_63437_length_429_cov_10.424242	260	340	2	80	80	1.0000000
NODE_63439_length_429_cov_8.957576	213	293	0	80	80	1.0000000
NODE_63439_length_429_cov_8.957576	266	346	0	80	80	1.0000000
NODE_63441_length_429_cov_6.772727	337	366	0	29	29	1.0000000
NODE_63485_length_429_cov_3.003030	173	251	0	78	78	1.0000000
NODE_63516_length_429_cov_2.433333	220	300	3	80	80	1.0000000
NODE_63519_length_429_cov_2.360606	24	85	0	61	61	1.0000000
NODE_63527_length_429_cov_2.224242	115	195	0	80	80	1.0000000
NODE_63547_length_429_cov_2.051515	114	143	2	29	29	1.0000000
NODE_63547_length_429_cov_2.051515	286	348	1	62	62	1.0000000
NODE_63864_length_428_cov_40.449848	217	297	0	80	80	1.0000000
NODE_63864_length_428_cov_40.449848	270	350	0	80	80	1.0000000
NODE_63864_length_428_cov_40.449848	346	426	0	80	80	1.0000000
NODE_63865_length_428_cov_31.066869	249	325	2	11	76	0.1447368
NODE_63865_length_428_cov_31.066869	249	325	4	18	76	0.2368421
NODE_63865_length_428_cov_31.066869	249	325	6	16	76	0.2105263
NODE_63865_length_428_cov_31.066869	249	325	8	31	76	0.4078947
NODE_63865_length_428_cov_31.066869	297	378	0	33	81	0.4074074
NODE_63865_length_428_cov_31.066869	297	378	2	31	81	0.3827161
NODE_63865_length_428_cov_31.066869	297	378	4	17	81	0.2098765
NODE_63866_length_428_cov_11.799392	62	142	0	23	80	0.2875000
NODE_63866_length_428_cov_11.799392	62	142	1	57	80	0.7125000
NODE_63866_length_428_cov_11.799392	115	195	1	80	80	1.0000000
NODE_63867_length_428_cov_10.595745	227	307	0	34	80	0.4250000
NODE_63867_length_428_cov_10.595745	227	307	2	46	80	0.5750000
NODE_63870_length_428_cov_6.784195	344	374	0	30	30	1.0000000
NODE_63871_length_428_cov_6.768997	131	194	0	63	63	1.0000000
NODE_63895_length_428_cov_4.206687	224	304	0	80	80	1.0000000
NODE_63905_length_428_cov_3.525836	168	236	0	68	68	1.0000000
NODE_63905_length_428_cov_3.525836	209	244	0	35	35	1.0000000
NODE_63959_length_428_cov_2.322188	1	42	2	41	41	1.0000000
NODE_63977_length_428_cov_2.124620	228	308	0	80	80	1.0000000
NODE_64011_length_428_cov_1.848024	178	260	0	82	82	1.0000000
NODE_64027_length_428_cov_1.772036	187	255	0	68	68	1.0000000
NODE_64245_length_428_cov_0.790274	275	308	0	33	33	1.0000000
NODE_64245_length_428_cov_0.790274	276	302	0	26	26	1.0000000
NODE_64310_length_427_cov_29.628049	312	392	1	80	80	1.0000000
NODE_64310_length_427_cov_29.628049	365	427	0	35	62	0.5645161
NODE_64310_length_427_cov_29.628049	365	427	1	27	62	0.4354839
NODE_64310_length_427_cov_29.628049	365	427	0	35	62	0.5645161
NODE_64310_length_427_cov_29.628049	365	427	1	27	62	0.4354839
NODE_64312_length_427_cov_9.371951	184	239	0	55	55	1.0000000
NODE_64313_length_427_cov_9.359756	11	82	0	71	71	1.0000000
NODE_64313_length_427_cov_9.359756	70	149	0	79	79	1.0000000
NODE_64313_length_427_cov_9.359756	145	225	0	80	80	1.0000000
NODE_64313_length_427_cov_9.359756	198	278	0	80	80	1.0000000
NODE_64321_length_427_cov_5.929878	405	424	0	19	19	1.0000000
NODE_64324_length_427_cov_5.088415	257	332	0	75	75	1.0000000
NODE_64345_length_427_cov_3.884146	212	260	1	27	48	0.5625000
NODE_64345_length_427_cov_3.884146	212	260	2	21	48	0.4375000
NODE_64383_length_427_cov_2.765244	312	363	2	51	51	1.0000000
NODE_64409_length_427_cov_2.362805	142	177	0	35	35	1.0000000
NODE_64537_length_427_cov_1.359756	56	139	0	83	83	1.0000000
NODE_64728_length_426_cov_21.837920	178	258	0	80	80	1.0000000
NODE_64729_length_426_cov_16.850153	76	156	2	10	80	0.1250000
NODE_64729_length_426_cov_16.850153	76	156	3	14	80	0.1750000
NODE_64729_length_426_cov_16.850153	76	156	4	9	80	0.1125000
NODE_64729_length_426_cov_16.850153	76	156	6	15	80	0.1875000
NODE_64729_length_426_cov_16.850153	76	156	7	32	80	0.4000000
NODE_64729_length_426_cov_16.850153	129	209	7	51	80	0.6375000
NODE_64729_length_426_cov_16.850153	129	209	8	29	80	0.3625000
NODE_64731_length_426_cov_9.033639	152	232	0	80	80	1.0000000
NODE_64731_length_426_cov_9.033639	205	285	0	80	80	1.0000000
NODE_64734_length_426_cov_8.314985	133	213	1	20	80	0.2500000
NODE_64734_length_426_cov_8.314985	133	213	2	60	80	0.7500000
NODE_64734_length_426_cov_8.314985	186	266	0	51	80	0.6375000
NODE_64734_length_426_cov_8.314985	186	266	1	22	80	0.2750000
NODE_64734_length_426_cov_8.314985	186	266	2	7	80	0.0875000
NODE_64735_length_426_cov_8.278287	132	212	3	24	80	0.3000000
NODE_64735_length_426_cov_8.278287	132	212	4	56	80	0.7000000
NODE_64735_length_426_cov_8.278287	185	265	3	24	80	0.3000000
NODE_64735_length_426_cov_8.278287	185	265	4	53	80	0.6625000
NODE_64735_length_426_cov_8.278287	185	265	5	3	80	0.0375000
NODE_64752_length_426_cov_4.926606	116	196	0	80	80	1.0000000
NODE_64754_length_426_cov_4.743119	119	199	2	80	80	1.0000000
NODE_64754_length_426_cov_4.743119	172	252	0	31	80	0.3875000
NODE_64754_length_426_cov_4.743119	172	252	2	49	80	0.6125000
NODE_64833_length_426_cov_2.278287	92	132	0	40	40	1.0000000
NODE_64833_length_426_cov_2.278287	139	205	0	66	66	1.0000000
NODE_64865_length_426_cov_1.896024	80	154	0	74	74	1.0000000
NODE_64948_length_426_cov_1.397554	240	290	0	50	50	1.0000000
NODE_65135_length_426_cov_0.602446	127	158	0	31	31	1.0000000
NODE_65152_length_425_cov_63.938650	0	61	1	13	61	0.2131148
NODE_65152_length_425_cov_63.938650	0	61	3	16	61	0.2622951
NODE_65152_length_425_cov_63.938650	0	61	5	6	61	0.0983607
NODE_65152_length_425_cov_63.938650	0	61	6	26	61	0.4262295
NODE_65152_length_425_cov_63.938650	34	114	5	1	80	0.0125000
NODE_65152_length_425_cov_63.938650	34	114	6	42	80	0.5250000
NODE_65152_length_425_cov_63.938650	34	114	7	2	80	0.0250000
NODE_65152_length_425_cov_63.938650	34	114	8	35	80	0.4375000
NODE_65164_length_425_cov_4.877301	171	229	3	33	58	0.5689655
NODE_65164_length_425_cov_4.877301	171	229	4	25	58	0.4310345
NODE_65165_length_425_cov_4.822086	295	377	0	82	82	1.0000000
NODE_65218_length_425_cov_2.809816	38	118	0	80	80	1.0000000
NODE_65278_length_425_cov_1.935583	93	138	2	42	45	0.9333333
NODE_65278_length_425_cov_1.935583	93	138	4	3	45	0.0666667
NODE_65278_length_425_cov_1.935583	170	225	2	45	55	0.8181818
NODE_65278_length_425_cov_1.935583	170	225	4	10	55	0.1818182
NODE_65278_length_425_cov_1.935583	312	355	2	3	43	0.0697674
NODE_65278_length_425_cov_1.935583	312	355	4	40	43	0.9302326
NODE_65565_length_425_cov_0.628834	104	131	2	27	27	1.0000000
NODE_65602_length_424_cov_5.295385	224	270	1	28	46	0.6086956
NODE_65602_length_424_cov_5.295385	224	270	2	18	46	0.3913043
NODE_65634_length_424_cov_3.255385	266	329	0	63	63	1.0000000
NODE_65669_length_424_cov_2.578462	403	422	0	19	19	1.0000000
NODE_65670_length_424_cov_2.578462	122	144	0	22	22	1.0000000
NODE_66111_length_423_cov_2.728395	150	229	0	14	79	0.1772152
NODE_66111_length_423_cov_2.728395	150	229	2	65	79	0.8227848
NODE_66181_length_423_cov_1.879630	94	142	2	48	48	1.0000000
NODE_66222_length_423_cov_1.580247	128	208	0	80	80	1.0000000
NODE_66258_length_423_cov_1.410494	206	286	0	70	80	0.8750000
NODE_66258_length_423_cov_1.410494	206	286	1	10	80	0.1250000
NODE_66459_length_422_cov_12.021672	201	236	0	10	35	0.2857143
NODE_66459_length_422_cov_12.021672	201	236	1	25	35	0.7142857
NODE_66459_length_422_cov_12.021672	247	289	0	42	42	1.0000000
NODE_66460_length_422_cov_10.712074	62	140	0	78	78	1.0000000
NODE_66460_length_422_cov_10.712074	115	195	0	80	80	1.0000000
NODE_66468_length_422_cov_6.281734	37	117	1	57	80	0.7125000
NODE_66468_length_422_cov_6.281734	37	117	2	23	80	0.2875000
NODE_66468_length_422_cov_6.281734	90	170	1	5	80	0.0625000
NODE_66468_length_422_cov_6.281734	90	170	2	75	80	0.9375000
NODE_66474_length_422_cov_5.266254	176	256	1	80	80	1.0000000
NODE_66485_length_422_cov_4.148607	159	224	0	65	65	1.0000000
NODE_66485_length_422_cov_4.148607	197	277	0	80	80	1.0000000
NODE_66488_length_422_cov_4.003096	146	226	1	40	80	0.5000000
NODE_66488_length_422_cov_4.003096	146	226	3	2	80	0.0250000
NODE_66488_length_422_cov_4.003096	146	226	4	34	80	0.4250000
NODE_66488_length_422_cov_4.003096	146	226	5	4	80	0.0500000
NODE_66488_length_422_cov_4.003096	199	279	4	42	80	0.5250000
NODE_66488_length_422_cov_4.003096	199	279	6	25	80	0.3125000
NODE_66488_length_422_cov_4.003096	199	279	8	13	80	0.1625000
NODE_66512_length_422_cov_3.130031	93	173	0	80	80	1.0000000
NODE_66512_length_422_cov_3.130031	146	226	0	80	80	1.0000000
NODE_66515_length_422_cov_3.077399	291	359	1	54	68	0.7941176
NODE_66515_length_422_cov_3.077399	291	359	3	14	68	0.2058824
NODE_66550_length_422_cov_2.191950	5	24	0	19	19	1.0000000
NODE_66560_length_422_cov_2.108359	97	177	0	80	80	1.0000000
NODE_66560_length_422_cov_2.108359	150	189	0	39	39	1.0000000
NODE_66560_length_422_cov_2.108359	249	289	0	40	40	1.0000000
NODE_66806_length_422_cov_0.845201	2	76	0	74	74	1.0000000
NODE_66869_length_421_cov_10.664596	178	256	0	78	78	1.0000000
NODE_66869_length_421_cov_10.664596	229	309	0	80	80	1.0000000
NODE_66874_length_421_cov_7.552795	325	407	0	80	82	0.9756098
NODE_66874_length_421_cov_7.552795	325	407	6	2	82	0.0243902
NODE_66874_length_421_cov_7.552795	380	421	0	41	41	1.0000000
NODE_66875_length_421_cov_7.431677	96	118	2	22	22	1.0000000
NODE_66883_length_421_cov_5.279503	245	310	0	9	65	0.1384615
NODE_66883_length_421_cov_5.279503	245	310	1	52	65	0.8000000
NODE_66883_length_421_cov_5.279503	245	310	2	4	65	0.0615385
NODE_66884_length_421_cov_5.158385	68	145	0	77	77	1.0000000
NODE_66897_length_421_cov_4.114907	221	287	0	66	66	1.0000000
NODE_66898_length_421_cov_4.102484	202	277	0	75	75	1.0000000
NODE_66899_length_421_cov_4.040373	192	272	1	67	80	0.8375000
NODE_66899_length_421_cov_4.040373	192	272	2	13	80	0.1625000
NODE_66899_length_421_cov_4.040373	245	314	0	8	69	0.1159420
NODE_66899_length_421_cov_4.040373	245	314	1	61	69	0.8840580
NODE_66923_length_421_cov_3.319876	0	57	0	57	57	1.0000000
NODE_66955_length_421_cov_2.708075	95	118	2	23	23	1.0000000
NODE_66955_length_421_cov_2.708075	109	189	2	80	80	1.0000000
NODE_66955_length_421_cov_2.708075	248	300	0	52	52	1.0000000
NODE_67073_length_421_cov_1.559006	240	309	1	69	69	1.0000000
NODE_67073_length_421_cov_1.559006	240	310	1	70	70	1.0000000
NODE_67077_length_421_cov_1.537267	305	383	0	78	78	1.0000000
NODE_67098_length_421_cov_1.413043	254	303	0	49	49	1.0000000
NODE_67283_length_421_cov_0.633540	132	156	0	24	24	1.0000000
NODE_67317_length_420_cov_80.766355	90	170	2	80	80	1.0000000
NODE_67317_length_420_cov_80.766355	143	223	2	48	80	0.6000000
NODE_67317_length_420_cov_80.766355	143	223	3	32	80	0.4000000
NODE_67319_length_420_cov_51.473520	171	250	0	79	79	1.0000000
NODE_67319_length_420_cov_51.473520	223	307	0	84	84	1.0000000
NODE_67319_length_420_cov_51.473520	303	383	0	80	80	1.0000000
NODE_67319_length_420_cov_51.473520	356	420	0	64	64	1.0000000
NODE_67330_length_420_cov_5.071651	230	310	0	80	80	1.0000000
NODE_67334_length_420_cov_4.775701	177	221	0	44	44	1.0000000
NODE_67345_length_420_cov_4.037383	161	240	0	79	79	1.0000000
NODE_67358_length_420_cov_3.657321	291	373	0	82	82	1.0000000
NODE_67398_length_420_cov_2.542056	96	176	0	80	80	1.0000000
NODE_67398_length_420_cov_2.542056	148	202	0	54	54	1.0000000
NODE_67398_length_420_cov_2.542056	149	195	0	46	46	1.0000000
NODE_67414_length_420_cov_2.323988	89	108	1	19	19	1.0000000
NODE_67506_length_420_cov_1.641745	277	312	0	35	35	1.0000000
NODE_67547_length_420_cov_1.429907	15	68	0	53	53	1.0000000
NODE_67547_length_420_cov_1.429907	69	111	0	27	42	0.6428571
NODE_67547_length_420_cov_1.429907	69	111	2	15	42	0.3571429
NODE_67770_length_419_cov_491.015625	0	67	3	3	67	0.0447761
NODE_67770_length_419_cov_491.015625	0	67	4	4	67	0.0597015
NODE_67770_length_419_cov_491.015625	0	67	5	1	67	0.0149254
NODE_67770_length_419_cov_491.015625	0	67	6	1	67	0.0149254
NODE_67770_length_419_cov_491.015625	0	67	7	1	67	0.0149254
NODE_67770_length_419_cov_491.015625	0	67	8	1	67	0.0149254
NODE_67770_length_419_cov_491.015625	0	67	9	1	67	0.0149254
NODE_67770_length_419_cov_491.015625	0	67	10	1	67	0.0149254
NODE_67770_length_419_cov_491.015625	0	67	11	9	67	0.1343284
NODE_67770_length_419_cov_491.015625	0	67	12	1	67	0.0149254
NODE_67770_length_419_cov_491.015625	0	67	13	2	67	0.0298507
NODE_67770_length_419_cov_491.015625	0	67	14	1	67	0.0149254
NODE_67770_length_419_cov_491.015625	0	67	15	4	67	0.0597015
NODE_67770_length_419_cov_491.015625	0	67	16	2	67	0.0298507
NODE_67770_length_419_cov_491.015625	0	67	18	1	67	0.0149254
NODE_67770_length_419_cov_491.015625	0	67	20	8	67	0.1194030
NODE_67770_length_419_cov_491.015625	0	67	22	1	67	0.0149254
NODE_67770_length_419_cov_491.015625	0	67	23	7	67	0.1044776
NODE_67770_length_419_cov_491.015625	0	67	24	1	67	0.0149254
NODE_67770_length_419_cov_491.015625	0	67	27	16	67	0.2388060
NODE_67770_length_419_cov_491.015625	0	67	28	1	67	0.0149254
NODE_67770_length_419_cov_491.015625	0	67	3	3	67	0.0447761
NODE_67770_length_419_cov_491.015625	0	67	4	4	67	0.0597015
NODE_67770_length_419_cov_491.015625	0	67	5	1	67	0.0149254
NODE_67770_length_419_cov_491.015625	0	67	6	1	67	0.0149254
NODE_67770_length_419_cov_491.015625	0	67	7	1	67	0.0149254
NODE_67770_length_419_cov_491.015625	0	67	8	1	67	0.0149254
NODE_67770_length_419_cov_491.015625	0	67	9	1	67	0.0149254
NODE_67770_length_419_cov_491.015625	0	67	10	1	67	0.0149254
NODE_67770_length_419_cov_491.015625	0	67	11	9	67	0.1343284
NODE_67770_length_419_cov_491.015625	0	67	12	1	67	0.0149254
NODE_67770_length_419_cov_491.015625	0	67	13	2	67	0.0298507
NODE_67770_length_419_cov_491.015625	0	67	14	1	67	0.0149254
NODE_67770_length_419_cov_491.015625	0	67	15	4	67	0.0597015
NODE_67770_length_419_cov_491.015625	0	67	16	2	67	0.0298507
NODE_67770_length_419_cov_491.015625	0	67	18	1	67	0.0149254
NODE_67770_length_419_cov_491.015625	0	67	20	8	67	0.1194030
NODE_67770_length_419_cov_491.015625	0	67	22	1	67	0.0149254
NODE_67770_length_419_cov_491.015625	0	67	23	7	67	0.1044776
NODE_67770_length_419_cov_491.015625	0	67	24	1	67	0.0149254
NODE_67770_length_419_cov_491.015625	0	67	27	16	67	0.2388060
NODE_67770_length_419_cov_491.015625	0	67	28	1	67	0.0149254
NODE_67770_length_419_cov_491.015625	0	67	3	3	67	0.0447761
NODE_67770_length_419_cov_491.015625	0	67	4	4	67	0.0597015
NODE_67770_length_419_cov_491.015625	0	67	5	1	67	0.0149254
NODE_67770_length_419_cov_491.015625	0	67	6	1	67	0.0149254
NODE_67770_length_419_cov_491.015625	0	67	7	1	67	0.0149254
NODE_67770_length_419_cov_491.015625	0	67	8	1	67	0.0149254
NODE_67770_length_419_cov_491.015625	0	67	9	1	67	0.0149254
NODE_67770_length_419_cov_491.015625	0	67	10	1	67	0.0149254
NODE_67770_length_419_cov_491.015625	0	67	11	9	67	0.1343284
NODE_67770_length_419_cov_491.015625	0	67	12	1	67	0.0149254
NODE_67770_length_419_cov_491.015625	0	67	13	2	67	0.0298507
NODE_67770_length_419_cov_491.015625	0	67	14	1	67	0.0149254
NODE_67770_length_419_cov_491.015625	0	67	15	4	67	0.0597015
NODE_67770_length_419_cov_491.015625	0	67	16	2	67	0.0298507
NODE_67770_length_419_cov_491.015625	0	67	18	1	67	0.0149254
NODE_67770_length_419_cov_491.015625	0	67	20	8	67	0.1194030
NODE_67770_length_419_cov_491.015625	0	67	22	1	67	0.0149254
NODE_67770_length_419_cov_491.015625	0	67	23	7	67	0.1044776
NODE_67770_length_419_cov_491.015625	0	67	24	1	67	0.0149254
NODE_67770_length_419_cov_491.015625	0	67	27	16	67	0.2388060
NODE_67770_length_419_cov_491.015625	0	67	28	1	67	0.0149254
NODE_67770_length_419_cov_491.015625	0	67	3	3	67	0.0447761
NODE_67770_length_419_cov_491.015625	0	67	4	4	67	0.0597015
NODE_67770_length_419_cov_491.015625	0	67	5	1	67	0.0149254
NODE_67770_length_419_cov_491.015625	0	67	6	1	67	0.0149254
NODE_67770_length_419_cov_491.015625	0	67	7	1	67	0.0149254
NODE_67770_length_419_cov_491.015625	0	67	8	1	67	0.0149254
NODE_67770_length_419_cov_491.015625	0	67	9	1	67	0.0149254
NODE_67770_length_419_cov_491.015625	0	67	10	1	67	0.0149254
NODE_67770_length_419_cov_491.015625	0	67	11	9	67	0.1343284
NODE_67770_length_419_cov_491.015625	0	67	12	1	67	0.0149254
NODE_67770_length_419_cov_491.015625	0	67	13	2	67	0.0298507
NODE_67770_length_419_cov_491.015625	0	67	14	1	67	0.0149254
NODE_67770_length_419_cov_491.015625	0	67	15	4	67	0.0597015
NODE_67770_length_419_cov_491.015625	0	67	16	2	67	0.0298507
NODE_67770_length_419_cov_491.015625	0	67	18	1	67	0.0149254
NODE_67770_length_419_cov_491.015625	0	67	20	8	67	0.1194030
NODE_67770_length_419_cov_491.015625	0	67	22	1	67	0.0149254
NODE_67770_length_419_cov_491.015625	0	67	23	7	67	0.1044776
NODE_67770_length_419_cov_491.015625	0	67	24	1	67	0.0149254
NODE_67770_length_419_cov_491.015625	0	67	27	16	67	0.2388060
NODE_67770_length_419_cov_491.015625	0	67	28	1	67	0.0149254
NODE_67770_length_419_cov_491.015625	63	143	27	3	80	0.0375000
NODE_67770_length_419_cov_491.015625	63	143	28	4	80	0.0500000
NODE_67770_length_419_cov_491.015625	63	143	29	2	80	0.0250000
NODE_67770_length_419_cov_491.015625	63	143	32	3	80	0.0375000
NODE_67770_length_419_cov_491.015625	63	143	33	1	80	0.0125000
NODE_67770_length_419_cov_491.015625	63	143	35	1	80	0.0125000
NODE_67770_length_419_cov_491.015625	63	143	36	1	80	0.0125000
NODE_67770_length_419_cov_491.015625	63	143	40	5	80	0.0625000
NODE_67770_length_419_cov_491.015625	63	143	41	2	80	0.0250000
NODE_67770_length_419_cov_491.015625	63	143	43	6	80	0.0750000
NODE_67770_length_419_cov_491.015625	63	143	44	7	80	0.0875000
NODE_67770_length_419_cov_491.015625	63	143	47	2	80	0.0250000
NODE_67770_length_419_cov_491.015625	63	143	51	1	80	0.0125000
NODE_67770_length_419_cov_491.015625	63	143	52	4	80	0.0500000
NODE_67770_length_419_cov_491.015625	63	143	53	1	80	0.0125000
NODE_67770_length_419_cov_491.015625	63	143	54	4	80	0.0500000
NODE_67770_length_419_cov_491.015625	63	143	56	1	80	0.0125000
NODE_67770_length_419_cov_491.015625	63	143	59	3	80	0.0375000
NODE_67770_length_419_cov_491.015625	63	143	61	2	80	0.0250000
NODE_67770_length_419_cov_491.015625	63	143	62	2	80	0.0250000
NODE_67770_length_419_cov_491.015625	63	143	64	1	80	0.0125000
NODE_67770_length_419_cov_491.015625	63	143	66	19	80	0.2375000
NODE_67770_length_419_cov_491.015625	63	143	72	2	80	0.0250000
NODE_67770_length_419_cov_491.015625	63	143	73	3	80	0.0375000
NODE_67770_length_419_cov_491.015625	63	143	27	3	80	0.0375000
NODE_67770_length_419_cov_491.015625	63	143	28	4	80	0.0500000
NODE_67770_length_419_cov_491.015625	63	143	29	2	80	0.0250000
NODE_67770_length_419_cov_491.015625	63	143	32	3	80	0.0375000
NODE_67770_length_419_cov_491.015625	63	143	33	1	80	0.0125000
NODE_67770_length_419_cov_491.015625	63	143	35	1	80	0.0125000
NODE_67770_length_419_cov_491.015625	63	143	36	1	80	0.0125000
NODE_67770_length_419_cov_491.015625	63	143	40	5	80	0.0625000
NODE_67770_length_419_cov_491.015625	63	143	41	2	80	0.0250000
NODE_67770_length_419_cov_491.015625	63	143	43	6	80	0.0750000
NODE_67770_length_419_cov_491.015625	63	143	44	7	80	0.0875000
NODE_67770_length_419_cov_491.015625	63	143	47	2	80	0.0250000
NODE_67770_length_419_cov_491.015625	63	143	51	1	80	0.0125000
NODE_67770_length_419_cov_491.015625	63	143	52	4	80	0.0500000
NODE_67770_length_419_cov_491.015625	63	143	53	1	80	0.0125000
NODE_67770_length_419_cov_491.015625	63	143	54	4	80	0.0500000
NODE_67770_length_419_cov_491.015625	63	143	56	1	80	0.0125000
NODE_67770_length_419_cov_491.015625	63	143	59	3	80	0.0375000
NODE_67770_length_419_cov_491.015625	63	143	61	2	80	0.0250000
NODE_67770_length_419_cov_491.015625	63	143	62	2	80	0.0250000
NODE_67770_length_419_cov_491.015625	63	143	64	1	80	0.0125000
NODE_67770_length_419_cov_491.015625	63	143	66	19	80	0.2375000
NODE_67770_length_419_cov_491.015625	63	143	72	2	80	0.0250000
NODE_67770_length_419_cov_491.015625	63	143	73	3	80	0.0375000
NODE_67770_length_419_cov_491.015625	63	143	27	3	80	0.0375000
NODE_67770_length_419_cov_491.015625	63	143	28	4	80	0.0500000
NODE_67770_length_419_cov_491.015625	63	143	29	2	80	0.0250000
NODE_67770_length_419_cov_491.015625	63	143	32	3	80	0.0375000
NODE_67770_length_419_cov_491.015625	63	143	33	1	80	0.0125000
NODE_67770_length_419_cov_491.015625	63	143	35	1	80	0.0125000
NODE_67770_length_419_cov_491.015625	63	143	36	1	80	0.0125000
NODE_67770_length_419_cov_491.015625	63	143	40	5	80	0.0625000
NODE_67770_length_419_cov_491.015625	63	143	41	2	80	0.0250000
NODE_67770_length_419_cov_491.015625	63	143	43	6	80	0.0750000
NODE_67770_length_419_cov_491.015625	63	143	44	7	80	0.0875000
NODE_67770_length_419_cov_491.015625	63	143	47	2	80	0.0250000
NODE_67770_length_419_cov_491.015625	63	143	51	1	80	0.0125000
NODE_67770_length_419_cov_491.015625	63	143	52	4	80	0.0500000
NODE_67770_length_419_cov_491.015625	63	143	53	1	80	0.0125000
NODE_67770_length_419_cov_491.015625	63	143	54	4	80	0.0500000
NODE_67770_length_419_cov_491.015625	63	143	56	1	80	0.0125000
NODE_67770_length_419_cov_491.015625	63	143	59	3	80	0.0375000
NODE_67770_length_419_cov_491.015625	63	143	61	2	80	0.0250000
NODE_67770_length_419_cov_491.015625	63	143	62	2	80	0.0250000
NODE_67770_length_419_cov_491.015625	63	143	64	1	80	0.0125000
NODE_67770_length_419_cov_491.015625	63	143	66	19	80	0.2375000
NODE_67770_length_419_cov_491.015625	63	143	72	2	80	0.0250000
NODE_67770_length_419_cov_491.015625	63	143	73	3	80	0.0375000
NODE_67770_length_419_cov_491.015625	116	196	60	4	80	0.0500000
NODE_67770_length_419_cov_491.015625	116	196	61	1	80	0.0125000
NODE_67770_length_419_cov_491.015625	116	196	62	3	80	0.0375000
NODE_67770_length_419_cov_491.015625	116	196	63	3	80	0.0375000
NODE_67770_length_419_cov_491.015625	116	196	64	5	80	0.0625000
NODE_67770_length_419_cov_491.015625	116	196	65	5	80	0.0625000
NODE_67770_length_419_cov_491.015625	116	196	66	28	80	0.3500000
NODE_67770_length_419_cov_491.015625	116	196	67	8	80	0.1000000
NODE_67770_length_419_cov_491.015625	116	196	68	5	80	0.0625000
NODE_67770_length_419_cov_491.015625	116	196	69	9	80	0.1125000
NODE_67770_length_419_cov_491.015625	116	196	72	6	80	0.0750000
NODE_67770_length_419_cov_491.015625	116	196	73	3	80	0.0375000
NODE_67770_length_419_cov_491.015625	116	196	60	4	80	0.0500000
NODE_67770_length_419_cov_491.015625	116	196	61	1	80	0.0125000
NODE_67770_length_419_cov_491.015625	116	196	62	3	80	0.0375000
NODE_67770_length_419_cov_491.015625	116	196	63	3	80	0.0375000
NODE_67770_length_419_cov_491.015625	116	196	64	5	80	0.0625000
NODE_67770_length_419_cov_491.015625	116	196	65	5	80	0.0625000
NODE_67770_length_419_cov_491.015625	116	196	66	28	80	0.3500000
NODE_67770_length_419_cov_491.015625	116	196	67	8	80	0.1000000
NODE_67770_length_419_cov_491.015625	116	196	68	5	80	0.0625000
NODE_67770_length_419_cov_491.015625	116	196	69	9	80	0.1125000
NODE_67770_length_419_cov_491.015625	116	196	72	6	80	0.0750000
NODE_67770_length_419_cov_491.015625	116	196	73	3	80	0.0375000
NODE_67770_length_419_cov_491.015625	116	196	60	4	80	0.0500000
NODE_67770_length_419_cov_491.015625	116	196	61	1	80	0.0125000
NODE_67770_length_419_cov_491.015625	116	196	62	3	80	0.0375000
NODE_67770_length_419_cov_491.015625	116	196	63	3	80	0.0375000
NODE_67770_length_419_cov_491.015625	116	196	64	5	80	0.0625000
NODE_67770_length_419_cov_491.015625	116	196	65	5	80	0.0625000
NODE_67770_length_419_cov_491.015625	116	196	66	28	80	0.3500000
NODE_67770_length_419_cov_491.015625	116	196	67	8	80	0.1000000
NODE_67770_length_419_cov_491.015625	116	196	68	5	80	0.0625000
NODE_67770_length_419_cov_491.015625	116	196	69	9	80	0.1125000
NODE_67770_length_419_cov_491.015625	116	196	72	6	80	0.0750000
NODE_67770_length_419_cov_491.015625	116	196	73	3	80	0.0375000
NODE_67770_length_419_cov_491.015625	116	196	60	4	80	0.0500000
NODE_67770_length_419_cov_491.015625	116	196	61	1	80	0.0125000
NODE_67770_length_419_cov_491.015625	116	196	62	3	80	0.0375000
NODE_67770_length_419_cov_491.015625	116	196	63	3	80	0.0375000
NODE_67770_length_419_cov_491.015625	116	196	64	5	80	0.0625000
NODE_67770_length_419_cov_491.015625	116	196	65	5	80	0.0625000
NODE_67770_length_419_cov_491.015625	116	196	66	28	80	0.3500000
NODE_67770_length_419_cov_491.015625	116	196	67	8	80	0.1000000
NODE_67770_length_419_cov_491.015625	116	196	68	5	80	0.0625000
NODE_67770_length_419_cov_491.015625	116	196	69	9	80	0.1125000
NODE_67770_length_419_cov_491.015625	116	196	72	6	80	0.0750000
NODE_67770_length_419_cov_491.015625	116	196	73	3	80	0.0375000
NODE_67770_length_419_cov_491.015625	116	196	60	4	80	0.0500000
NODE_67770_length_419_cov_491.015625	116	196	61	1	80	0.0125000
NODE_67770_length_419_cov_491.015625	116	196	62	3	80	0.0375000
NODE_67770_length_419_cov_491.015625	116	196	63	3	80	0.0375000
NODE_67770_length_419_cov_491.015625	116	196	64	5	80	0.0625000
NODE_67770_length_419_cov_491.015625	116	196	65	5	80	0.0625000
NODE_67770_length_419_cov_491.015625	116	196	66	28	80	0.3500000
NODE_67770_length_419_cov_491.015625	116	196	67	8	80	0.1000000
NODE_67770_length_419_cov_491.015625	116	196	68	5	80	0.0625000
NODE_67770_length_419_cov_491.015625	116	196	69	9	80	0.1125000
NODE_67770_length_419_cov_491.015625	116	196	72	6	80	0.0750000
NODE_67770_length_419_cov_491.015625	116	196	73	3	80	0.0375000
NODE_67772_length_419_cov_31.725000	12	92	0	80	80	1.0000000
NODE_67772_length_419_cov_31.725000	65	145	0	80	80	1.0000000
NODE_67789_length_419_cov_4.862500	47	103	0	56	56	1.0000000
NODE_67789_length_419_cov_4.862500	258	327	1	2	69	0.0289855
NODE_67789_length_419_cov_4.862500	258	327	2	67	69	0.9710145
NODE_67789_length_419_cov_4.862500	284	328	1	3	44	0.0681818
NODE_67789_length_419_cov_4.862500	284	328	2	41	44	0.9318182
NODE_67803_length_419_cov_4.193750	215	262	0	47	47	1.0000000
NODE_67803_length_419_cov_4.193750	235	275	0	40	40	1.0000000
NODE_67817_length_419_cov_3.696875	165	215	0	50	50	1.0000000
NODE_67854_length_419_cov_2.628125	234	314	0	80	80	1.0000000
NODE_67856_length_419_cov_2.603125	154	196	0	42	42	1.0000000
NODE_67878_length_419_cov_2.350000	156	220	2	2	64	0.0312500
NODE_67878_length_419_cov_2.350000	156	220	3	21	64	0.3281250
NODE_67878_length_419_cov_2.350000	156	220	4	21	64	0.3281250
NODE_67878_length_419_cov_2.350000	156	220	5	20	64	0.3125000
NODE_67961_length_419_cov_1.593750	339	358	0	19	19	1.0000000
NODE_68250_length_418_cov_63.059561	105	186	0	81	81	1.0000000
NODE_68250_length_418_cov_63.059561	159	239	0	80	80	1.0000000
NODE_68251_length_418_cov_49.796238	325	405	0	9	80	0.1125000
NODE_68251_length_418_cov_49.796238	325	405	1	14	80	0.1750000
NODE_68251_length_418_cov_49.796238	325	405	3	22	80	0.2750000
NODE_68251_length_418_cov_49.796238	325	405	4	32	80	0.4000000
NODE_68251_length_418_cov_49.796238	325	405	6	3	80	0.0375000
NODE_68251_length_418_cov_49.796238	378	415	0	19	37	0.5135135
NODE_68251_length_418_cov_49.796238	378	415	1	14	37	0.3783784
NODE_68251_length_418_cov_49.796238	378	415	3	4	37	0.1081081
NODE_68252_length_418_cov_42.764890	119	196	0	77	77	1.0000000
NODE_68252_length_418_cov_42.764890	172	250	0	78	78	1.0000000
NODE_68253_length_418_cov_23.830721	73	153	0	39	80	0.4875000
NODE_68253_length_418_cov_23.830721	73	153	2	41	80	0.5125000
NODE_68253_length_418_cov_23.830721	126	200	0	5	74	0.0675676
NODE_68253_length_418_cov_23.830721	126	200	2	69	74	0.9324324
NODE_68255_length_418_cov_7.216301	211	291	1	34	80	0.4250000
NODE_68255_length_418_cov_7.216301	211	291	2	46	80	0.5750000
NODE_68265_length_418_cov_5.382445	134	215	0	37	81	0.4567901
NODE_68265_length_418_cov_5.382445	134	215	2	44	81	0.5432099
NODE_68265_length_418_cov_5.382445	187	268	0	81	81	1.0000000
NODE_68275_length_418_cov_4.463950	191	272	0	81	81	1.0000000
NODE_68280_length_418_cov_4.216301	148	230	1	82	82	1.0000000
NODE_68281_length_418_cov_4.065831	211	280	2	69	69	1.0000000
NODE_68284_length_418_cov_3.909091	95	175	1	7	80	0.0875000
NODE_68284_length_418_cov_3.909091	95	175	2	11	80	0.1375000
NODE_68284_length_418_cov_3.909091	95	175	3	16	80	0.2000000
NODE_68284_length_418_cov_3.909091	95	175	5	2	80	0.0250000
NODE_68284_length_418_cov_3.909091	95	175	6	4	80	0.0500000
NODE_68284_length_418_cov_3.909091	95	175	7	24	80	0.3000000
NODE_68284_length_418_cov_3.909091	95	175	8	16	80	0.2000000
NODE_68284_length_418_cov_3.909091	148	224	1	7	76	0.0921053
NODE_68284_length_418_cov_3.909091	148	224	2	11	76	0.1447368
NODE_68284_length_418_cov_3.909091	148	224	3	23	76	0.3026316
NODE_68284_length_418_cov_3.909091	148	224	4	35	76	0.4605263
NODE_68288_length_418_cov_3.749216	181	247	0	66	66	1.0000000
NODE_68289_length_418_cov_3.711599	249	313	0	64	64	1.0000000
NODE_68307_length_418_cov_3.012539	101	181	0	80	80	1.0000000
NODE_68354_length_418_cov_2.376176	95	115	0	15	20	0.7500000
NODE_68354_length_418_cov_2.376176	95	115	1	5	20	0.2500000
NODE_68436_length_418_cov_1.623824	47	128	0	81	81	1.0000000
NODE_68436_length_418_cov_1.623824	239	268	0	29	29	1.0000000
NODE_68682_length_418_cov_0.626959	255	299	0	44	44	1.0000000
NODE_68708_length_417_cov_45.267296	212	292	0	27	80	0.3375000
NODE_68708_length_417_cov_45.267296	212	292	1	53	80	0.6625000
NODE_68708_length_417_cov_45.267296	265	345	1	80	80	1.0000000
NODE_68708_length_417_cov_45.267296	341	417	0	18	76	0.2368421
NODE_68708_length_417_cov_45.267296	341	417	1	58	76	0.7631579
NODE_68709_length_417_cov_36.006289	159	239	7	19	80	0.2375000
NODE_68709_length_417_cov_36.006289	159	239	8	4	80	0.0500000
NODE_68709_length_417_cov_36.006289	159	239	9	57	80	0.7125000
NODE_68711_length_417_cov_12.886792	193	273	2	80	80	1.0000000
NODE_68711_length_417_cov_12.886792	246	326	0	19	80	0.2375000
NODE_68711_length_417_cov_12.886792	246	326	2	61	80	0.7625000
NODE_68717_length_417_cov_7.056604	210	271	0	61	61	1.0000000
NODE_68717_length_417_cov_7.056604	263	315	0	52	52	1.0000000
NODE_68718_length_417_cov_6.669811	194	264	0	70	70	1.0000000
NODE_68779_length_417_cov_2.795597	20	91	0	71	71	1.0000000
NODE_69163_length_416_cov_115.782334	174	259	7	5	85	0.0588235
NODE_69163_length_416_cov_115.782334	174	259	8	11	85	0.1294118
NODE_69163_length_416_cov_115.782334	174	259	9	19	85	0.2235294
NODE_69163_length_416_cov_115.782334	174	259	10	26	85	0.3058824
NODE_69163_length_416_cov_115.782334	174	259	11	24	85	0.2823530
NODE_69164_length_416_cov_70.678233	180	244	7	9	64	0.1406250
NODE_69164_length_416_cov_70.678233	180	244	9	12	64	0.1875000
NODE_69164_length_416_cov_70.678233	180	244	10	1	64	0.0156250
NODE_69164_length_416_cov_70.678233	180	244	11	17	64	0.2656250
NODE_69164_length_416_cov_70.678233	180	244	12	10	64	0.1562500
NODE_69164_length_416_cov_70.678233	180	244	13	15	64	0.2343750
NODE_69166_length_416_cov_39.933754	288	368	0	80	80	1.0000000
NODE_69166_length_416_cov_39.933754	341	416	0	75	75	1.0000000
NODE_69167_length_416_cov_37.334385	158	238	0	35	80	0.4375000
NODE_69167_length_416_cov_37.334385	158	238	1	14	80	0.1750000
NODE_69167_length_416_cov_37.334385	158	238	2	31	80	0.3875000
NODE_69167_length_416_cov_37.334385	211	291	0	80	80	1.0000000
NODE_69167_length_416_cov_37.334385	287	367	0	80	80	1.0000000
NODE_69167_length_416_cov_37.334385	340	416	0	76	76	1.0000000
NODE_69179_length_416_cov_5.242902	89	169	0	80	80	1.0000000
NODE_69179_length_416_cov_5.242902	142	222	0	80	80	1.0000000
NODE_69184_length_416_cov_4.892744	79	145	0	66	66	1.0000000
NODE_69184_length_416_cov_4.892744	194	272	0	78	78	1.0000000
NODE_69184_length_416_cov_4.892744	247	272	0	25	25	1.0000000
NODE_69204_length_416_cov_3.886435	79	136	1	57	57	1.0000000
NODE_69279_length_416_cov_2.230284	10	90	0	80	80	1.0000000
NODE_69399_length_416_cov_1.520505	198	244	0	46	46	1.0000000
NODE_69399_length_416_cov_1.520505	261	328	0	67	67	1.0000000
NODE_69673_length_415_cov_35.924051	260	339	1	37	79	0.4683544
NODE_69673_length_415_cov_35.924051	260	339	2	42	79	0.5316456
NODE_69673_length_415_cov_35.924051	316	392	1	76	76	1.0000000
NODE_69679_length_415_cov_6.376582	117	197	0	43	80	0.5375000
NODE_69679_length_415_cov_6.376582	117	197	1	11	80	0.1375000
NODE_69679_length_415_cov_6.376582	117	197	2	26	80	0.3250000
NODE_69679_length_415_cov_6.376582	254	334	0	13	80	0.1625000
NODE_69679_length_415_cov_6.376582	254	334	1	11	80	0.1375000
NODE_69679_length_415_cov_6.376582	254	334	2	56	80	0.7000000
NODE_69774_length_415_cov_2.224684	144	224	0	80	80	1.0000000
NODE_69795_length_415_cov_2.069620	207	273	0	63	66	0.9545454
NODE_69795_length_415_cov_2.069620	207	273	2	3	66	0.0454545
NODE_69817_length_415_cov_1.832278	225	283	0	15	58	0.2586207
NODE_69817_length_415_cov_1.832278	225	283	2	43	58	0.7413793
NODE_69845_length_415_cov_1.610759	90	170	9	2	80	0.0250000
NODE_69845_length_415_cov_1.610759	90	170	10	19	80	0.2375000
NODE_69845_length_415_cov_1.610759	90	170	11	15	80	0.1875000
NODE_69845_length_415_cov_1.610759	90	170	12	39	80	0.4875000
NODE_69845_length_415_cov_1.610759	90	170	13	5	80	0.0625000
NODE_69845_length_415_cov_1.610759	335	376	0	41	41	1.0000000
NODE_70175_length_414_cov_46.263492	0	49	0	3	49	0.0612245
NODE_70175_length_414_cov_46.263492	0	49	2	12	49	0.2448980
NODE_70175_length_414_cov_46.263492	0	49	5	14	49	0.2857143
NODE_70175_length_414_cov_46.263492	0	49	6	10	49	0.2040816
NODE_70175_length_414_cov_46.263492	0	49	8	5	49	0.1020408
NODE_70175_length_414_cov_46.263492	0	49	10	2	49	0.0408163
NODE_70175_length_414_cov_46.263492	0	49	11	3	49	0.0612245
NODE_70175_length_414_cov_46.263492	22	102	5	7	80	0.0875000
NODE_70175_length_414_cov_46.263492	22	102	6	10	80	0.1250000
NODE_70175_length_414_cov_46.263492	22	102	8	5	80	0.0625000
NODE_70175_length_414_cov_46.263492	22	102	10	2	80	0.0250000
NODE_70175_length_414_cov_46.263492	22	102	11	7	80	0.0875000
NODE_70175_length_414_cov_46.263492	22	102	13	17	80	0.2125000
NODE_70175_length_414_cov_46.263492	22	102	14	32	80	0.4000000
NODE_70183_length_414_cov_7.460317	167	247	0	80	80	1.0000000
NODE_70183_length_414_cov_7.460317	220	300	0	80	80	1.0000000
NODE_70192_length_414_cov_5.676190	54	134	0	7	80	0.0875000
NODE_70192_length_414_cov_5.676190	54	134	2	73	80	0.9125000
NODE_70192_length_414_cov_5.676190	107	187	0	60	80	0.7500000
NODE_70192_length_414_cov_5.676190	107	187	2	20	80	0.2500000
NODE_70222_length_414_cov_4.130159	257	303	0	46	46	1.0000000
NODE_70222_length_414_cov_4.130159	276	356	0	80	80	1.0000000
NODE_70254_length_414_cov_2.996825	75	135	2	60	60	1.0000000
NODE_70271_length_414_cov_2.631746	68	145	0	77	77	1.0000000
NODE_70284_length_414_cov_2.473016	164	197	0	33	33	1.0000000
NODE_70284_length_414_cov_2.473016	170	255	0	85	85	1.0000000
NODE_70305_length_414_cov_2.222222	185	260	0	75	75	1.0000000
NODE_70305_length_414_cov_2.222222	233	304	0	71	71	1.0000000
NODE_70307_length_414_cov_2.206349	88	163	0	75	75	1.0000000
NODE_70326_length_414_cov_2.047619	298	349	0	51	51	1.0000000
NODE_70486_length_414_cov_1.177778	106	190	6	75	84	0.8928571
NODE_70486_length_414_cov_1.177778	106	190	8	9	84	0.1071429
NODE_70494_length_414_cov_1.155556	0	23	0	23	23	1.0000000
NODE_70690_length_413_cov_41.471338	35	115	1	30	80	0.3750000
NODE_70690_length_413_cov_41.471338	35	115	2	50	80	0.6250000
NODE_70690_length_413_cov_41.471338	35	115	1	30	80	0.3750000
NODE_70690_length_413_cov_41.471338	35	115	2	50	80	0.6250000
NODE_70690_length_413_cov_41.471338	88	168	2	80	80	1.0000000
NODE_70690_length_413_cov_41.471338	88	168	2	80	80	1.0000000
NODE_70691_length_413_cov_16.687898	222	302	3	80	80	1.0000000
NODE_70691_length_413_cov_16.687898	275	355	0	26	80	0.3250000
NODE_70691_length_413_cov_16.687898	275	355	1	7	80	0.0875000
NODE_70691_length_413_cov_16.687898	275	355	3	47	80	0.5875000
NODE_70699_length_413_cov_7.057325	170	250	0	80	80	1.0000000
NODE_70699_length_413_cov_7.057325	223	300	0	77	77	1.0000000
NODE_70703_length_413_cov_5.665605	125	182	0	57	57	1.0000000
NODE_70712_length_413_cov_4.754777	140	184	0	44	44	1.0000000
NODE_70743_length_413_cov_3.506369	113	193	0	80	80	1.0000000
NODE_70749_length_413_cov_3.235669	251	331	0	80	80	1.0000000
NODE_70749_length_413_cov_3.235669	304	356	0	52	52	1.0000000
NODE_70792_length_413_cov_2.484076	209	257	0	48	48	1.0000000
NODE_70835_length_413_cov_1.949045	224	296	2	72	72	1.0000000
NODE_71196_length_412_cov_9.996805	172	244	0	72	72	1.0000000
NODE_71218_length_412_cov_4.686901	112	167	0	55	55	1.0000000
NODE_71253_length_412_cov_3.204473	44	124	0	80	80	1.0000000
NODE_71276_length_412_cov_2.824281	225	305	0	80	80	1.0000000
NODE_71371_length_412_cov_1.782748	262	342	0	80	80	1.0000000
NODE_71398_length_412_cov_1.603834	143	182	4	31	39	0.7948718
NODE_71398_length_412_cov_1.603834	143	182	6	4	39	0.1025641
NODE_71398_length_412_cov_1.603834	143	182	8	4	39	0.1025641
NODE_71665_length_411_cov_44.701923	4	72	0	68	68	1.0000000
NODE_71665_length_411_cov_44.701923	35	116	0	81	81	1.0000000
NODE_71665_length_411_cov_44.701923	161	242	0	81	81	1.0000000
NODE_71665_length_411_cov_44.701923	293	374	0	81	81	1.0000000
NODE_71665_length_411_cov_44.701923	337	411	0	74	74	1.0000000
NODE_71666_length_411_cov_43.144231	102	183	0	29	81	0.3580247
NODE_71666_length_411_cov_43.144231	102	183	1	52	81	0.6419753
NODE_71666_length_411_cov_43.144231	156	236	1	33	80	0.4125000
NODE_71666_length_411_cov_43.144231	156	236	3	47	80	0.5875000
NODE_71666_length_411_cov_43.144231	232	312	3	15	80	0.1875000
NODE_71666_length_411_cov_43.144231	232	312	5	48	80	0.6000000
NODE_71666_length_411_cov_43.144231	232	312	6	17	80	0.2125000
NODE_71666_length_411_cov_43.144231	285	365	3	57	80	0.7125000
NODE_71666_length_411_cov_43.144231	285	365	5	23	80	0.2875000
NODE_71672_length_411_cov_8.471154	133	213	0	80	80	1.0000000
NODE_71672_length_411_cov_8.471154	186	266	0	31	80	0.3875000
NODE_71672_length_411_cov_8.471154	186	266	1	49	80	0.6125000
NODE_71673_length_411_cov_8.407051	133	220	0	87	87	1.0000000
NODE_71675_length_411_cov_6.455128	249	316	0	24	67	0.3582090
NODE_71675_length_411_cov_6.455128	249	316	3	17	67	0.2537313
NODE_71675_length_411_cov_6.455128	249	316	5	26	67	0.3880597
NODE_71675_length_411_cov_6.455128	292	344	0	52	52	1.0000000
NODE_71687_length_411_cov_4.782051	98	178	4	5	80	0.0625000
NODE_71687_length_411_cov_4.782051	98	178	6	38	80	0.4750000
NODE_71687_length_411_cov_4.782051	98	178	7	37	80	0.4625000
NODE_71687_length_411_cov_4.782051	151	228	6	41	77	0.5324675
NODE_71687_length_411_cov_4.782051	151	228	7	36	77	0.4675325
NODE_71705_length_411_cov_3.698718	282	347	0	65	65	1.0000000
NODE_71713_length_411_cov_3.378205	88	148	0	60	60	1.0000000
NODE_71714_length_411_cov_3.371795	145	225	0	28	80	0.3500000
NODE_71714_length_411_cov_3.371795	145	225	1	36	80	0.4500000
NODE_71714_length_411_cov_3.371795	145	225	2	2	80	0.0250000
NODE_71714_length_411_cov_3.371795	145	225	4	14	80	0.1750000
NODE_71714_length_411_cov_3.371795	198	274	1	11	76	0.1447368
NODE_71714_length_411_cov_3.371795	198	274	2	2	76	0.0263158
NODE_71714_length_411_cov_3.371795	198	274	4	28	76	0.3684210
NODE_71714_length_411_cov_3.371795	198	274	6	35	76	0.4605263
NODE_72163_length_410_cov_49.331190	320	400	0	80	80	1.0000000
NODE_72163_length_410_cov_49.331190	320	400	0	80	80	1.0000000
NODE_72163_length_410_cov_49.331190	320	400	0	80	80	1.0000000
NODE_72163_length_410_cov_49.331190	320	400	0	80	80	1.0000000
NODE_72163_length_410_cov_49.331190	320	400	0	80	80	1.0000000
NODE_72163_length_410_cov_49.331190	329	400	0	71	71	1.0000000
NODE_72169_length_410_cov_6.797428	179	259	3	50	80	0.6250000
NODE_72169_length_410_cov_6.797428	179	259	4	1	80	0.0125000
NODE_72169_length_410_cov_6.797428	179	259	5	29	80	0.3625000
NODE_72169_length_410_cov_6.797428	232	312	0	38	80	0.4750000
NODE_72169_length_410_cov_6.797428	232	312	3	42	80	0.5250000
NODE_72184_length_410_cov_5.102894	153	222	0	69	69	1.0000000
NODE_72186_length_410_cov_4.884244	101	179	3	63	78	0.8076923
NODE_72186_length_410_cov_4.884244	101	179	4	3	78	0.0384615
NODE_72186_length_410_cov_4.884244	101	179	5	12	78	0.1538462
NODE_72187_length_410_cov_4.787781	287	344	0	57	57	1.0000000
NODE_72187_length_410_cov_4.787781	340	397	0	57	57	1.0000000
NODE_72194_length_410_cov_4.591640	245	303	1	58	58	1.0000000
NODE_72194_length_410_cov_4.591640	298	356	0	28	58	0.4827586
NODE_72194_length_410_cov_4.591640	298	356	1	30	58	0.5172414
NODE_72230_length_410_cov_3.215434	32	112	0	80	80	1.0000000
NODE_72230_length_410_cov_3.215434	85	165	0	80	80	1.0000000
NODE_72327_length_410_cov_1.913183	227	285	0	58	58	1.0000000
NODE_72526_length_410_cov_1.038585	272	316	0	26	44	0.5909091
NODE_72526_length_410_cov_1.038585	272	316	1	18	44	0.4090909
NODE_72688_length_409_cov_11.506452	56	136	6	25	80	0.3125000
NODE_72688_length_409_cov_11.506452	56	136	8	55	80	0.6875000
NODE_72688_length_409_cov_11.506452	109	189	0	25	80	0.3125000
NODE_72688_length_409_cov_11.506452	109	189	2	1	80	0.0125000
NODE_72688_length_409_cov_11.506452	109	189	4	6	80	0.0750000
NODE_72688_length_409_cov_11.506452	109	189	6	15	80	0.1875000
NODE_72688_length_409_cov_11.506452	109	189	8	33	80	0.4125000
NODE_72689_length_409_cov_10.329032	131	186	0	55	55	1.0000000
NODE_72690_length_409_cov_9.625806	62	142	0	80	80	1.0000000
NODE_72690_length_409_cov_9.625806	115	195	0	80	80	1.0000000
NODE_72697_length_409_cov_6.867742	41	71	0	30	30	1.0000000
NODE_72730_length_409_cov_3.822581	103	158	0	1	55	0.0181818
NODE_72730_length_409_cov_3.822581	103	158	2	54	55	0.9818182
NODE_72730_length_409_cov_3.822581	151	232	0	28	81	0.3456790
NODE_72730_length_409_cov_3.822581	151	232	2	53	81	0.6543210
NODE_72754_length_409_cov_2.987097	240	287	1	47	47	1.0000000
NODE_72951_length_409_cov_1.319355	49	131	0	82	82	1.0000000
NODE_72951_length_409_cov_1.319355	104	161	0	57	57	1.0000000
NODE_73196_length_408_cov_8.585761	57	137	2	80	80	1.0000000
NODE_73196_length_408_cov_8.585761	110	190	0	14	80	0.1750000
NODE_73196_length_408_cov_8.585761	110	190	2	66	80	0.8250000
NODE_73198_length_408_cov_6.948220	71	151	0	80	80	1.0000000
NODE_73198_length_408_cov_6.948220	124	204	0	75	80	0.9375000
NODE_73198_length_408_cov_6.948220	124	204	2	5	80	0.0625000
NODE_73219_length_408_cov_3.957929	83	132	0	4	49	0.0816327
NODE_73219_length_408_cov_3.957929	83	132	2	45	49	0.9183673
NODE_73226_length_408_cov_3.511327	40	97	0	57	57	1.0000000
NODE_73226_length_408_cov_3.511327	357	398	0	41	41	1.0000000
NODE_73262_length_408_cov_2.724919	128	180	0	52	52	1.0000000
NODE_73269_length_408_cov_2.563107	164	241	0	76	77	0.9870130
NODE_73269_length_408_cov_2.563107	164	241	2	1	77	0.0129870
NODE_73271_length_408_cov_2.456311	314	379	0	65	65	1.0000000
NODE_73271_length_408_cov_2.456311	352	408	0	56	56	1.0000000
NODE_73690_length_407_cov_6.191558	144	208	0	64	64	1.0000000
NODE_73698_length_407_cov_4.961039	212	291	0	79	79	1.0000000
NODE_73719_length_407_cov_3.681818	314	375	0	61	61	1.0000000
NODE_73732_length_407_cov_3.344156	199	247	2	48	48	1.0000000
NODE_73736_length_407_cov_3.250000	142	223	2	3	81	0.0370370
NODE_73736_length_407_cov_3.250000	142	223	4	78	81	0.9629630
NODE_73762_length_407_cov_2.594156	194	257	0	63	63	1.0000000
NODE_73769_length_407_cov_2.538961	34	114	0	58	80	0.7250000
NODE_73769_length_407_cov_2.538961	34	114	2	22	80	0.2750000
NODE_73853_length_407_cov_1.737013	208	264	0	37	56	0.6607143
NODE_73853_length_407_cov_1.737013	208	264	1	19	56	0.3392857
NODE_74200_length_406_cov_176.856678	200	271	30	17	71	0.2394366
NODE_74200_length_406_cov_176.856678	200	271	31	12	71	0.1690141
NODE_74200_length_406_cov_176.856678	200	271	32	10	71	0.1408451
NODE_74200_length_406_cov_176.856678	200	271	33	19	71	0.2676056
NODE_74200_length_406_cov_176.856678	200	271	34	3	71	0.0422535
NODE_74200_length_406_cov_176.856678	200	271	36	1	71	0.0140845
NODE_74200_length_406_cov_176.856678	200	271	37	4	71	0.0563380
NODE_74200_length_406_cov_176.856678	200	271	38	4	71	0.0563380
NODE_74200_length_406_cov_176.856678	200	271	39	1	71	0.0140845
NODE_74200_length_406_cov_176.856678	244	321	20	3	77	0.0389610
NODE_74200_length_406_cov_176.856678	244	321	21	2	77	0.0259740
NODE_74200_length_406_cov_176.856678	244	321	23	11	77	0.1428571
NODE_74200_length_406_cov_176.856678	244	321	25	3	77	0.0389610
NODE_74200_length_406_cov_176.856678	244	321	26	2	77	0.0259740
NODE_74200_length_406_cov_176.856678	244	321	27	1	77	0.0129870
NODE_74200_length_406_cov_176.856678	244	321	29	8	77	0.1038961
NODE_74200_length_406_cov_176.856678	244	321	30	13	77	0.1688312
NODE_74200_length_406_cov_176.856678	244	321	31	11	77	0.1428571
NODE_74200_length_406_cov_176.856678	244	321	32	6	77	0.0779221
NODE_74200_length_406_cov_176.856678	244	321	33	5	77	0.0649351
NODE_74200_length_406_cov_176.856678	244	321	34	8	77	0.1038961
NODE_74200_length_406_cov_176.856678	244	321	35	4	77	0.0519481
NODE_74203_length_406_cov_37.723127	15	95	0	78	80	0.9750000
NODE_74203_length_406_cov_37.723127	15	95	4	1	80	0.0125000
NODE_74203_length_406_cov_37.723127	15	95	11	1	80	0.0125000
NODE_74219_length_406_cov_4.960912	268	327	0	59	59	1.0000000
NODE_74253_length_406_cov_3.087948	261	302	0	12	41	0.2926829
NODE_74253_length_406_cov_3.087948	261	302	2	29	41	0.7073171
NODE_74284_length_406_cov_2.475570	220	270	0	50	50	1.0000000
NODE_74332_length_406_cov_1.986971	238	276	0	38	38	1.0000000
NODE_74368_length_406_cov_1.778502	159	195	0	9	36	0.2500000
NODE_74368_length_406_cov_1.778502	159	195	1	27	36	0.7500000
NODE_74368_length_406_cov_1.778502	234	294	2	60	60	1.0000000
NODE_74368_length_406_cov_1.778502	267	347	1	29	80	0.3625000
NODE_74368_length_406_cov_1.778502	267	347	2	51	80	0.6375000
NODE_74427_length_406_cov_1.495114	173	212	0	39	39	1.0000000
NODE_74476_length_406_cov_1.325733	367	398	0	31	31	1.0000000
NODE_74588_length_406_cov_0.934853	1	32	0	31	31	1.0000000
NODE_74588_length_406_cov_0.934853	5	85	0	80	80	1.0000000
NODE_74696_length_405_cov_5.107843	332	380	2	48	48	1.0000000
NODE_74697_length_405_cov_4.915033	15	46	0	31	31	1.0000000
NODE_74727_length_405_cov_3.346405	195	240	2	45	45	1.0000000
NODE_74727_length_405_cov_3.346405	274	329	0	37	55	0.6727273
NODE_74727_length_405_cov_3.346405	274	329	1	9	55	0.1636364
NODE_74727_length_405_cov_3.346405	274	329	2	9	55	0.1636364
NODE_74737_length_405_cov_3.124183	210	260	0	50	50	1.0000000
NODE_74737_length_405_cov_3.124183	240	286	0	46	46	1.0000000
NODE_74737_length_405_cov_3.124183	260	339	0	79	79	1.0000000
NODE_74737_length_405_cov_3.124183	272	339	0	67	67	1.0000000
NODE_74780_length_405_cov_2.503268	352	399	0	47	47	1.0000000
NODE_74787_length_405_cov_2.460784	0	73	0	73	73	1.0000000
NODE_75145_length_405_cov_0.666667	207	268	0	61	61	1.0000000
NODE_75196_length_404_cov_40.937705	40	120	1	54	80	0.6750000
NODE_75196_length_404_cov_40.937705	40	120	2	26	80	0.3250000
NODE_75196_length_404_cov_40.937705	93	173	1	36	80	0.4500000
NODE_75196_length_404_cov_40.937705	93	173	2	44	80	0.5500000
NODE_75197_length_404_cov_32.940984	46	126	2	73	80	0.9125000
NODE_75197_length_404_cov_32.940984	46	126	4	7	80	0.0875000
NODE_75197_length_404_cov_32.940984	99	179	2	20	80	0.2500000
NODE_75197_length_404_cov_32.940984	99	179	4	44	80	0.5500000
NODE_75197_length_404_cov_32.940984	99	179	8	16	80	0.2000000
NODE_75197_length_404_cov_32.940984	175	255	4	4	80	0.0500000
NODE_75197_length_404_cov_32.940984	175	255	5	26	80	0.3250000
NODE_75197_length_404_cov_32.940984	175	255	6	44	80	0.5500000
NODE_75197_length_404_cov_32.940984	175	255	8	6	80	0.0750000
NODE_75197_length_404_cov_32.940984	228	308	2	33	80	0.4125000
NODE_75197_length_404_cov_32.940984	228	308	5	5	80	0.0625000
NODE_75197_length_404_cov_32.940984	228	308	6	42	80	0.5250000
NODE_75198_length_404_cov_11.731148	130	210	2	72	80	0.9000000
NODE_75198_length_404_cov_11.731148	130	210	3	8	80	0.1000000
NODE_75198_length_404_cov_11.731148	183	263	2	47	80	0.5875000
NODE_75198_length_404_cov_11.731148	183	263	3	33	80	0.4125000
NODE_75200_length_404_cov_9.170492	201	257	0	56	56	1.0000000
NODE_75236_length_404_cov_3.613115	323	385	0	62	62	1.0000000
NODE_75259_length_404_cov_2.914754	181	261	0	10	80	0.1250000
NODE_75259_length_404_cov_2.914754	181	261	2	11	80	0.1375000
NODE_75259_length_404_cov_2.914754	181	261	3	59	80	0.7375000
NODE_75345_length_404_cov_2.085246	245	325	0	80	80	1.0000000
NODE_75357_length_404_cov_1.993443	95	148	0	53	53	1.0000000
NODE_75399_length_404_cov_1.672131	32	106	0	74	74	1.0000000
NODE_75440_length_404_cov_1.498361	94	174	2	80	80	1.0000000
NODE_75446_length_404_cov_1.485246	234	282	0	48	48	1.0000000
NODE_75545_length_404_cov_1.121311	114	194	6	31	80	0.3875000
NODE_75545_length_404_cov_1.121311	114	194	7	21	80	0.2625000
NODE_75545_length_404_cov_1.121311	114	194	8	28	80	0.3500000
NODE_75750_length_403_cov_7.325658	80	146	0	66	66	1.0000000
NODE_75750_length_403_cov_7.325658	165	234	0	69	69	1.0000000
NODE_75750_length_403_cov_7.325658	215	255	0	40	40	1.0000000
NODE_75751_length_403_cov_7.217105	207	284	0	77	77	1.0000000
NODE_75751_length_403_cov_7.217105	257	334	0	77	77	1.0000000
NODE_75752_length_403_cov_6.776316	192	250	0	58	58	1.0000000
NODE_75788_length_403_cov_3.710526	327	373	0	44	46	0.9565217
NODE_75788_length_403_cov_3.710526	327	373	2	2	46	0.0434783
NODE_75788_length_403_cov_3.710526	346	403	0	57	57	1.0000000
NODE_75793_length_403_cov_3.611842	283	363	0	10	80	0.1250000
NODE_75793_length_403_cov_3.611842	283	363	2	70	80	0.8750000
NODE_75824_length_403_cov_2.822368	201	282	4	44	81	0.5432099
NODE_75824_length_403_cov_2.822368	201	282	6	37	81	0.4567901
NODE_75871_length_403_cov_2.082237	102	145	0	43	43	1.0000000
NODE_75908_length_403_cov_1.871711	130	166	0	36	36	1.0000000
NODE_75993_length_403_cov_1.398026	79	116	0	37	37	1.0000000
NODE_76029_length_403_cov_1.269737	82	111	1	29	29	1.0000000
NODE_76239_length_402_cov_6.293729	217	297	4	3	80	0.0375000
NODE_76239_length_402_cov_6.293729	217	297	6	10	80	0.1250000
NODE_76239_length_402_cov_6.293729	217	297	8	32	80	0.4000000
NODE_76239_length_402_cov_6.293729	217	297	10	35	80	0.4375000
NODE_76239_length_402_cov_6.293729	270	350	0	15	80	0.1875000
NODE_76239_length_402_cov_6.293729	270	350	1	7	80	0.0875000
NODE_76239_length_402_cov_6.293729	270	350	3	10	80	0.1250000
NODE_76239_length_402_cov_6.293729	270	350	4	24	80	0.3000000
NODE_76239_length_402_cov_6.293729	270	350	6	10	80	0.1250000
NODE_76239_length_402_cov_6.293729	270	350	8	14	80	0.1750000
NODE_76246_length_402_cov_5.227723	176	236	0	37	60	0.6166667
NODE_76246_length_402_cov_5.227723	176	236	1	23	60	0.3833333
NODE_76261_length_402_cov_4.356436	44	123	0	18	79	0.2278481
NODE_76261_length_402_cov_4.356436	44	123	2	61	79	0.7721519
NODE_76261_length_402_cov_4.356436	119	199	0	15	80	0.1875000
NODE_76261_length_402_cov_4.356436	119	199	2	50	80	0.6250000
NODE_76261_length_402_cov_4.356436	119	199	3	15	80	0.1875000
NODE_76261_length_402_cov_4.356436	172	252	2	12	80	0.1500000
NODE_76261_length_402_cov_4.356436	172	252	3	68	80	0.8500000
NODE_76276_length_402_cov_3.564356	197	257	0	60	60	1.0000000
NODE_76276_length_402_cov_3.564356	230	310	0	80	80	1.0000000
NODE_76328_length_402_cov_2.633663	335	402	0	67	67	1.0000000
NODE_76336_length_402_cov_2.514851	82	162	1	80	80	1.0000000
NODE_76336_length_402_cov_2.514851	135	200	0	8	65	0.1230769
NODE_76336_length_402_cov_2.514851	135	200	1	32	65	0.4923077
NODE_76336_length_402_cov_2.514851	135	200	2	25	65	0.3846154
NODE_76380_length_402_cov_2.102310	114	165	0	51	51	1.0000000
NODE_76380_length_402_cov_2.102310	138	195	0	57	57	1.0000000
NODE_76560_length_402_cov_1.214521	0	33	0	33	33	1.0000000
NODE_76646_length_402_cov_1.000000	119	188	0	69	69	1.0000000
NODE_76752_length_402_cov_0.663366	0	46	0	46	46	1.0000000
NODE_76780_length_401_cov_43.675497	285	343	0	58	58	1.0000000
NODE_76801_length_401_cov_4.377483	309	389	0	80	80	1.0000000
NODE_76804_length_401_cov_4.241722	125	180	0	55	55	1.0000000
NODE_76808_length_401_cov_4.132450	195	275	1	16	80	0.2000000
NODE_76808_length_401_cov_4.132450	195	275	2	64	80	0.8000000
NODE_76811_length_401_cov_3.973510	138	181	0	43	43	1.0000000
NODE_76828_length_401_cov_3.370861	141	221	0	80	80	1.0000000
NODE_76828_length_401_cov_3.370861	194	273	0	79	79	1.0000000
NODE_76830_length_401_cov_3.317881	67	147	0	80	80	1.0000000
NODE_76918_length_401_cov_1.937086	160	239	0	46	79	0.5822785
NODE_76918_length_401_cov_1.937086	160	239	1	33	79	0.4177215
NODE_76978_length_401_cov_1.615894	205	269	0	12	64	0.1875000
NODE_76978_length_401_cov_1.615894	205	269	3	2	64	0.0312500
NODE_76978_length_401_cov_1.615894	205	269	5	4	64	0.0625000
NODE_76978_length_401_cov_1.615894	205	269	6	4	64	0.0625000
NODE_76978_length_401_cov_1.615894	205	269	7	7	64	0.1093750
NODE_76978_length_401_cov_1.615894	205	269	8	13	64	0.2031250
NODE_76978_length_401_cov_1.615894	205	269	12	8	64	0.1250000
NODE_76978_length_401_cov_1.615894	205	269	14	14	64	0.2187500
NODE_77017_length_401_cov_1.407285	23	92	0	69	69	1.0000000
NODE_77017_length_401_cov_1.407285	76	122	0	46	46	1.0000000
NODE_77236_length_401_cov_0.675497	292	372	0	80	80	1.0000000
NODE_77236_length_401_cov_0.675497	345	401	0	56	56	1.0000000
NODE_77284_length_400_cov_40.584718	205	281	0	76	76	1.0000000
NODE_77284_length_400_cov_40.584718	254	334	0	80	80	1.0000000
NODE_77289_length_400_cov_8.631229	307	372	0	65	65	1.0000000
NODE_77292_length_400_cov_6.850498	281	329	0	48	48	1.0000000
NODE_77322_length_400_cov_4.000000	82	140	1	58	58	1.0000000
NODE_77358_length_400_cov_3.029900	204	284	2	80	80	1.0000000
NODE_77358_length_400_cov_3.029900	205	231	2	26	26	1.0000000
NODE_77362_length_400_cov_3.009967	146	220	5	17	74	0.2297297
NODE_77362_length_400_cov_3.009967	146	220	6	21	74	0.2837838
NODE_77362_length_400_cov_3.009967	146	220	9	10	74	0.1351351
NODE_77362_length_400_cov_3.009967	146	220	10	3	74	0.0405405
NODE_77362_length_400_cov_3.009967	146	220	11	8	74	0.1081081
NODE_77362_length_400_cov_3.009967	146	220	12	15	74	0.2027027
NODE_77362_length_400_cov_3.009967	195	261	9	2	66	0.0303030
NODE_77362_length_400_cov_3.009967	195	261	10	6	66	0.0909091
NODE_77362_length_400_cov_3.009967	195	261	11	28	66	0.4242424
NODE_77362_length_400_cov_3.009967	195	261	12	30	66	0.4545455
NODE_77363_length_400_cov_2.990033	253	332	4	40	79	0.5063291
NODE_77363_length_400_cov_2.990033	253	332	6	4	79	0.0506329
NODE_77363_length_400_cov_2.990033	253	332	8	22	79	0.2784810
NODE_77363_length_400_cov_2.990033	253	332	10	10	79	0.1265823
NODE_77363_length_400_cov_2.990033	253	332	12	3	79	0.0379747
NODE_77363_length_400_cov_2.990033	306	385	8	13	79	0.1645570
NODE_77363_length_400_cov_2.990033	306	385	10	32	79	0.4050633
NODE_77363_length_400_cov_2.990033	306	385	12	34	79	0.4303797
NODE_77368_length_400_cov_2.860465	365	400	0	3	35	0.0857143
NODE_77368_length_400_cov_2.860465	365	400	2	32	35	0.9142857
NODE_77371_length_400_cov_2.797342	324	372	0	48	48	1.0000000
NODE_77380_length_400_cov_2.581395	192	254	0	62	62	1.0000000
NODE_77460_length_400_cov_1.940199	225	268	0	43	43	1.0000000
NODE_77460_length_400_cov_1.940199	293	374	2	81	81	1.0000000
NODE_77821_length_399_cov_71.493333	215	295	0	16	80	0.2000000
NODE_77821_length_399_cov_71.493333	215	295	1	31	80	0.3875000
NODE_77821_length_399_cov_71.493333	215	295	2	33	80	0.4125000
NODE_77821_length_399_cov_71.493333	268	348	0	69	80	0.8625000
NODE_77821_length_399_cov_71.493333	268	348	1	11	80	0.1375000
NODE_77823_length_399_cov_7.510000	229	309	2	18	80	0.2250000
NODE_77823_length_399_cov_7.510000	229	309	5	8	80	0.1000000
NODE_77823_length_399_cov_7.510000	229	309	6	54	80	0.6750000
NODE_77823_length_399_cov_7.510000	282	362	1	16	80	0.2000000
NODE_77823_length_399_cov_7.510000	282	362	2	55	80	0.6875000
NODE_77823_length_399_cov_7.510000	282	362	6	9	80	0.1125000
NODE_77825_length_399_cov_7.310000	125	187	2	62	62	1.0000000
NODE_77854_length_399_cov_4.293333	86	164	0	78	78	1.0000000
NODE_77877_length_399_cov_3.406667	51	124	0	73	73	1.0000000
NODE_77933_length_399_cov_2.286667	310	390	0	18	80	0.2250000
NODE_77933_length_399_cov_2.286667	310	390	2	62	80	0.7750000
NODE_77966_length_399_cov_1.916667	76	136	0	17	60	0.2833333
NODE_77966_length_399_cov_1.916667	76	136	2	43	60	0.7166666
NODE_77966_length_399_cov_1.916667	123	189	2	38	66	0.5757576
NODE_77966_length_399_cov_1.916667	123	189	4	28	66	0.4242424
NODE_78276_length_399_cov_0.710000	313	392	0	5	79	0.0632911
NODE_78276_length_399_cov_0.710000	313	392	2	47	79	0.5949367
NODE_78276_length_399_cov_0.710000	313	392	4	27	79	0.3417721
NODE_78354_length_398_cov_9.688963	1	81	0	3	80	0.0375000
NODE_78354_length_398_cov_9.688963	1	81	1	1	80	0.0125000
NODE_78354_length_398_cov_9.688963	1	81	2	76	80	0.9500000
NODE_78354_length_398_cov_9.688963	247	327	0	2	80	0.0250000
NODE_78354_length_398_cov_9.688963	247	327	2	78	80	0.9750000
NODE_78354_length_398_cov_9.688963	300	380	0	17	80	0.2125000
NODE_78354_length_398_cov_9.688963	300	380	2	63	80	0.7875000
NODE_78360_length_398_cov_6.488294	130	210	0	80	80	1.0000000
NODE_78364_length_398_cov_5.765886	253	333	0	35	80	0.4375000
NODE_78364_length_398_cov_5.765886	253	333	2	45	80	0.5625000
NODE_78372_length_398_cov_5.244147	248	312	0	64	64	1.0000000
NODE_78376_length_398_cov_5.006689	116	196	0	80	80	1.0000000
NODE_78376_length_398_cov_5.006689	169	251	0	82	82	1.0000000
NODE_78383_length_398_cov_4.284281	63	117	0	54	54	1.0000000
NODE_78383_length_398_cov_4.284281	135	160	0	25	25	1.0000000
NODE_78420_length_398_cov_2.993311	229	309	0	41	80	0.5125000
NODE_78420_length_398_cov_2.993311	229	309	2	39	80	0.4875000
NODE_78429_length_398_cov_2.822742	236	271	0	35	35	1.0000000
NODE_78891_length_397_cov_52.855705	124	204	6	3	80	0.0375000
NODE_78891_length_397_cov_52.855705	124	204	7	2	80	0.0250000
NODE_78891_length_397_cov_52.855705	124	204	8	6	80	0.0750000
NODE_78891_length_397_cov_52.855705	124	204	10	1	80	0.0125000
NODE_78891_length_397_cov_52.855705	124	204	13	1	80	0.0125000
NODE_78891_length_397_cov_52.855705	124	204	14	3	80	0.0375000
NODE_78891_length_397_cov_52.855705	124	204	15	5	80	0.0625000
NODE_78891_length_397_cov_52.855705	124	204	16	44	80	0.5500000
NODE_78891_length_397_cov_52.855705	124	204	17	15	80	0.1875000
NODE_78891_length_397_cov_52.855705	177	257	11	4	80	0.0500000
NODE_78891_length_397_cov_52.855705	177	257	12	25	80	0.3125000
NODE_78891_length_397_cov_52.855705	177	257	14	14	80	0.1750000
NODE_78891_length_397_cov_52.855705	177	257	16	32	80	0.4000000
NODE_78891_length_397_cov_52.855705	177	257	17	5	80	0.0625000
NODE_78894_length_397_cov_35.036913	173	253	8	26	80	0.3250000
NODE_78894_length_397_cov_35.036913	173	253	9	18	80	0.2250000
NODE_78894_length_397_cov_35.036913	173	253	10	1	80	0.0125000
NODE_78894_length_397_cov_35.036913	173	253	11	35	80	0.4375000
NODE_78895_length_397_cov_13.667785	94	174	2	80	80	1.0000000
NODE_78895_length_397_cov_13.667785	147	227	0	9	80	0.1125000
NODE_78895_length_397_cov_13.667785	147	227	2	71	80	0.8875000
NODE_78897_length_397_cov_7.496644	192	272	2	80	80	1.0000000
NODE_78897_length_397_cov_7.496644	245	325	0	11	80	0.1375000
NODE_78897_length_397_cov_7.496644	245	325	2	69	80	0.8625000
NODE_78898_length_397_cov_6.828859	127	173	0	46	46	1.0000000
NODE_78913_length_397_cov_4.902685	293	364	0	71	71	1.0000000
NODE_78933_length_397_cov_3.765101	164	244	0	80	80	1.0000000
NODE_78951_length_397_cov_3.325503	107	187	4	80	80	1.0000000
NODE_78951_length_397_cov_3.325503	163	236	0	14	73	0.1917808
NODE_78951_length_397_cov_3.325503	163	236	2	4	73	0.0547945
NODE_78951_length_397_cov_3.325503	163	236	3	15	73	0.2054795
NODE_78951_length_397_cov_3.325503	163	236	4	40	73	0.5479452
NODE_78999_length_397_cov_2.530201	269	312	2	2	43	0.0465116
NODE_78999_length_397_cov_2.530201	269	312	3	41	43	0.9534883
NODE_79047_length_397_cov_1.959732	154	193	2	39	39	1.0000000
NODE_79072_length_397_cov_1.791946	218	283	0	26	65	0.4000000
NODE_79072_length_397_cov_1.791946	218	283	3	39	65	0.6000000
NODE_79127_length_397_cov_1.560403	183	240	0	57	57	1.0000000
NODE_79456_length_396_cov_11.632997	162	242	4	80	80	1.0000000
NODE_79456_length_396_cov_11.632997	215	295	0	13	80	0.1625000
NODE_79456_length_396_cov_11.632997	215	295	4	67	80	0.8375000
NODE_79460_length_396_cov_7.053872	71	101	0	30	30	1.0000000
NODE_79464_length_396_cov_6.097643	229	309	2	80	80	1.0000000
NODE_79464_length_396_cov_6.097643	282	362	0	27	80	0.3375000
NODE_79464_length_396_cov_6.097643	282	362	2	53	80	0.6625000
NODE_79471_length_396_cov_5.484848	125	205	2	80	80	1.0000000
NODE_79471_length_396_cov_5.484848	178	259	0	36	81	0.4444444
NODE_79471_length_396_cov_5.484848	178	259	2	45	81	0.5555556
NODE_79473_length_396_cov_5.434343	224	275	0	51	51	1.0000000
NODE_79473_length_396_cov_5.434343	272	331	0	59	59	1.0000000
NODE_79483_length_396_cov_4.414141	189	264	2	75	75	1.0000000
NODE_79483_length_396_cov_4.414141	241	317	0	39	76	0.5131579
NODE_79483_length_396_cov_4.414141	241	317	1	12	76	0.1578947
NODE_79483_length_396_cov_4.414141	241	317	2	25	76	0.3289474
NODE_79493_length_396_cov_4.010101	163	205	0	42	42	1.0000000
NODE_79522_length_396_cov_3.080808	95	161	0	66	66	1.0000000
NODE_79524_length_396_cov_3.067340	252	316	0	64	64	1.0000000
NODE_79535_length_396_cov_2.892256	136	217	0	41	81	0.5061728
NODE_79535_length_396_cov_2.892256	136	217	2	40	81	0.4938272
NODE_79557_length_396_cov_2.710438	88	168	0	1	80	0.0125000
NODE_79557_length_396_cov_2.710438	88	168	1	19	80	0.2375000
NODE_79557_length_396_cov_2.710438	88	168	2	27	80	0.3375000
NODE_79557_length_396_cov_2.710438	88	168	4	33	80	0.4125000
NODE_79561_length_396_cov_2.680135	297	335	0	38	38	1.0000000
NODE_79562_length_396_cov_2.659933	68	148	0	80	80	1.0000000
NODE_79562_length_396_cov_2.659933	121	168	0	47	47	1.0000000
NODE_79616_length_396_cov_2.060606	308	388	0	80	80	1.0000000
NODE_79643_length_396_cov_1.939394	63	142	0	11	79	0.1392405
NODE_79643_length_396_cov_1.939394	63	142	1	68	79	0.8607595
NODE_79643_length_396_cov_1.939394	115	164	1	49	49	1.0000000
NODE_79683_length_396_cov_1.811448	82	162	2	47	80	0.5875000
NODE_79683_length_396_cov_1.811448	82	162	3	33	80	0.4125000
NODE_79692_length_396_cov_1.734007	88	119	0	31	31	1.0000000
NODE_79930_length_396_cov_0.905724	101	151	14	1	50	0.0200000
NODE_79930_length_396_cov_0.905724	101	151	15	31	50	0.6200000
NODE_79930_length_396_cov_0.905724	101	151	16	18	50	0.3600000
NODE_80057_length_395_cov_449.327703	0	79	7	3	79	0.0379747
NODE_80057_length_395_cov_449.327703	0	79	8	1	79	0.0126582
NODE_80057_length_395_cov_449.327703	0	79	10	1	79	0.0126582
NODE_80057_length_395_cov_449.327703	0	79	11	1	79	0.0126582
NODE_80057_length_395_cov_449.327703	0	79	13	3	79	0.0379747
NODE_80057_length_395_cov_449.327703	0	79	14	1	79	0.0126582
NODE_80057_length_395_cov_449.327703	0	79	15	7	79	0.0886076
NODE_80057_length_395_cov_449.327703	0	79	16	1	79	0.0126582
NODE_80057_length_395_cov_449.327703	0	79	19	1	79	0.0126582
NODE_80057_length_395_cov_449.327703	0	79	20	1	79	0.0126582
NODE_80057_length_395_cov_449.327703	0	79	21	5	79	0.0632911
NODE_80057_length_395_cov_449.327703	0	79	22	1	79	0.0126582
NODE_80057_length_395_cov_449.327703	0	79	25	4	79	0.0506329
NODE_80057_length_395_cov_449.327703	0	79	27	3	79	0.0379747
NODE_80057_length_395_cov_449.327703	0	79	31	3	79	0.0379747
NODE_80057_length_395_cov_449.327703	0	79	32	5	79	0.0632911
NODE_80057_length_395_cov_449.327703	0	79	37	2	79	0.0253165
NODE_80057_length_395_cov_449.327703	0	79	38	1	79	0.0126582
NODE_80057_length_395_cov_449.327703	0	79	40	1	79	0.0126582
NODE_80057_length_395_cov_449.327703	0	79	42	1	79	0.0126582
NODE_80057_length_395_cov_449.327703	0	79	43	2	79	0.0253165
NODE_80057_length_395_cov_449.327703	0	79	46	5	79	0.0632911
NODE_80057_length_395_cov_449.327703	0	79	47	1	79	0.0126582
NODE_80057_length_395_cov_449.327703	0	79	48	1	79	0.0126582
NODE_80057_length_395_cov_449.327703	0	79	50	8	79	0.1012658
NODE_80057_length_395_cov_449.327703	0	79	51	2	79	0.0253165
NODE_80057_length_395_cov_449.327703	0	79	54	1	79	0.0126582
NODE_80057_length_395_cov_449.327703	0	79	55	1	79	0.0126582
NODE_80057_length_395_cov_449.327703	0	79	56	5	79	0.0632911
NODE_80057_length_395_cov_449.327703	0	79	57	3	79	0.0379747
NODE_80057_length_395_cov_449.327703	0	79	58	1	79	0.0126582
NODE_80057_length_395_cov_449.327703	0	79	60	3	79	0.0379747
NODE_80058_length_395_cov_13.695946	113	193	0	80	80	1.0000000
NODE_80058_length_395_cov_13.695946	166	246	0	80	80	1.0000000
NODE_80086_length_395_cov_4.179054	152	232	1	41	80	0.5125000
NODE_80086_length_395_cov_4.179054	152	232	2	39	80	0.4875000
NODE_80116_length_395_cov_2.962838	118	198	2	38	80	0.4750000
NODE_80116_length_395_cov_2.962838	118	198	4	42	80	0.5250000
NODE_80116_length_395_cov_2.962838	171	237	0	27	66	0.4090909
NODE_80116_length_395_cov_2.962838	171	237	2	36	66	0.5454546
NODE_80116_length_395_cov_2.962838	171	237	4	3	66	0.0454545
NODE_80121_length_395_cov_2.878378	261	301	0	7	40	0.1750000
NODE_80121_length_395_cov_2.878378	261	301	1	33	40	0.8250000
NODE_80139_length_395_cov_2.587838	111	188	0	15	77	0.1948052
NODE_80139_length_395_cov_2.587838	111	188	2	62	77	0.8051948
NODE_80139_length_395_cov_2.587838	232	301	1	22	69	0.3188406
NODE_80139_length_395_cov_2.587838	232	301	2	47	69	0.6811594
NODE_80139_length_395_cov_2.587838	258	302	2	44	44	1.0000000
NODE_80141_length_395_cov_2.560811	123	187	0	64	64	1.0000000
NODE_80146_length_395_cov_2.527027	194	274	0	80	80	1.0000000
NODE_80146_length_395_cov_2.527027	247	327	0	80	80	1.0000000
NODE_80439_length_395_cov_1.033784	103	151	0	48	48	1.0000000
NODE_80448_length_395_cov_1.010135	85	105	0	20	20	1.0000000
NODE_80639_length_394_cov_9.464407	211	291	2	80	80	1.0000000
NODE_80639_length_394_cov_9.464407	264	344	0	18	80	0.2250000
NODE_80639_length_394_cov_9.464407	264	344	1	21	80	0.2625000
NODE_80639_length_394_cov_9.464407	264	344	2	41	80	0.5125000
NODE_80643_length_394_cov_7.437288	221	301	3	2	80	0.0250000
NODE_80643_length_394_cov_7.437288	221	301	5	3	80	0.0375000
NODE_80643_length_394_cov_7.437288	221	301	7	6	80	0.0750000
NODE_80643_length_394_cov_7.437288	221	301	8	48	80	0.6000000
NODE_80643_length_394_cov_7.437288	221	301	10	21	80	0.2625000
NODE_80643_length_394_cov_7.437288	274	331	4	6	57	0.1052632
NODE_80643_length_394_cov_7.437288	274	331	6	9	57	0.1578947
NODE_80643_length_394_cov_7.437288	274	331	8	9	57	0.1578947
NODE_80643_length_394_cov_7.437288	274	331	10	33	57	0.5789474
NODE_80647_length_394_cov_6.444068	187	267	0	10	80	0.1250000
NODE_80647_length_394_cov_6.444068	187	267	1	70	80	0.8750000
NODE_80647_length_394_cov_6.444068	240	320	1	80	80	1.0000000
NODE_80709_length_394_cov_2.932203	119	140	2	21	21	1.0000000
NODE_80710_length_394_cov_2.894915	79	135	0	56	56	1.0000000
NODE_80710_length_394_cov_2.894915	166	202	0	6	36	0.1666667
NODE_80710_length_394_cov_2.894915	166	202	2	30	36	0.8333333
NODE_81216_length_393_cov_4.261905	201	267	0	66	66	1.0000000
NODE_81216_length_393_cov_4.261905	240	282	0	42	42	1.0000000
NODE_81240_length_393_cov_3.503401	121	201	0	80	80	1.0000000
NODE_81240_length_393_cov_3.503401	174	246	0	72	72	1.0000000
NODE_81277_length_393_cov_2.704082	198	271	0	73	73	1.0000000
NODE_81289_length_393_cov_2.493197	136	216	0	80	80	1.0000000
NODE_81289_length_393_cov_2.493197	189	269	0	80	80	1.0000000
NODE_81296_length_393_cov_2.360544	195	252	0	57	57	1.0000000
NODE_81416_length_393_cov_1.608844	207	270	0	63	63	1.0000000
NODE_81778_length_392_cov_7.873720	161	241	6	80	80	1.0000000
NODE_81778_length_392_cov_7.873720	214	294	2	12	80	0.1500000
NODE_81778_length_392_cov_7.873720	214	294	4	6	80	0.0750000
NODE_81778_length_392_cov_7.873720	214	294	6	62	80	0.7750000
NODE_81790_length_392_cov_5.262799	218	248	0	30	30	1.0000000
NODE_81805_length_392_cov_3.655290	109	157	1	48	48	1.0000000
NODE_81805_length_392_cov_3.655290	306	386	0	80	80	1.0000000
NODE_81823_length_392_cov_3.197952	102	171	0	69	69	1.0000000
NODE_81823_length_392_cov_3.197952	233	314	0	81	81	1.0000000
NODE_81857_length_392_cov_2.511945	67	133	19	4	66	0.0606061
NODE_81857_length_392_cov_2.511945	67	133	21	10	66	0.1515152
NODE_81857_length_392_cov_2.511945	67	133	22	3	66	0.0454545
NODE_81857_length_392_cov_2.511945	67	133	23	8	66	0.1212121
NODE_81857_length_392_cov_2.511945	67	133	24	5	66	0.0757576
NODE_81857_length_392_cov_2.511945	67	133	26	9	66	0.1363636
NODE_81857_length_392_cov_2.511945	67	133	27	7	66	0.1060606
NODE_81857_length_392_cov_2.511945	67	133	28	1	66	0.0151515
NODE_81857_length_392_cov_2.511945	67	133	30	19	66	0.2878788
NODE_81857_length_392_cov_2.511945	120	206	12	6	86	0.0697674
NODE_81857_length_392_cov_2.511945	120	206	13	6	86	0.0697674
NODE_81857_length_392_cov_2.511945	120	206	14	1	86	0.0116279
NODE_81857_length_392_cov_2.511945	120	206	16	13	86	0.1511628
NODE_81857_length_392_cov_2.511945	120	206	17	10	86	0.1162791
NODE_81857_length_392_cov_2.511945	120	206	19	5	86	0.0581395
NODE_81857_length_392_cov_2.511945	120	206	20	2	86	0.0232558
NODE_81857_length_392_cov_2.511945	120	206	22	5	86	0.0581395
NODE_81857_length_392_cov_2.511945	120	206	23	1	86	0.0116279
NODE_81857_length_392_cov_2.511945	120	206	24	2	86	0.0232558
NODE_81857_length_392_cov_2.511945	120	206	25	1	86	0.0116279
NODE_81857_length_392_cov_2.511945	120	206	28	7	86	0.0813954
NODE_81857_length_392_cov_2.511945	120	206	29	9	86	0.1046512
NODE_81857_length_392_cov_2.511945	120	206	30	18	86	0.2093023
NODE_81914_length_392_cov_2.075085	268	349	2	15	81	0.1851852
NODE_81914_length_392_cov_2.075085	268	349	4	66	81	0.8148148
NODE_81914_length_392_cov_2.075085	322	387	4	65	65	1.0000000
NODE_81928_length_392_cov_1.955631	11	56	0	44	45	0.9777778
NODE_81928_length_392_cov_1.955631	11	56	1	1	45	0.0222222
NODE_81929_length_392_cov_1.952218	40	59	0	19	19	1.0000000
NODE_81940_length_392_cov_1.911263	238	315	0	77	77	1.0000000
NODE_81994_length_392_cov_1.631399	114	139	5	4	25	0.1600000
NODE_81994_length_392_cov_1.631399	114	139	6	19	25	0.7600000
NODE_81994_length_392_cov_1.631399	114	139	8	2	25	0.0800000
NODE_82008_length_392_cov_1.559727	83	163	0	2	80	0.0250000
NODE_82008_length_392_cov_1.559727	83	163	2	78	80	0.9750000
NODE_82015_length_392_cov_1.552901	32	52	0	20	20	1.0000000
NODE_82390_length_391_cov_69.510274	9	89	7	3	80	0.0375000
NODE_82390_length_391_cov_69.510274	9	89	10	1	80	0.0125000
NODE_82390_length_391_cov_69.510274	9	89	11	2	80	0.0250000
NODE_82390_length_391_cov_69.510274	9	89	13	7	80	0.0875000
NODE_82390_length_391_cov_69.510274	9	89	18	2	80	0.0250000
NODE_82390_length_391_cov_69.510274	9	89	19	4	80	0.0500000
NODE_82390_length_391_cov_69.510274	9	89	21	1	80	0.0125000
NODE_82390_length_391_cov_69.510274	9	89	22	8	80	0.1000000
NODE_82390_length_391_cov_69.510274	9	89	24	2	80	0.0250000
NODE_82390_length_391_cov_69.510274	9	89	25	3	80	0.0375000
NODE_82390_length_391_cov_69.510274	9	89	26	2	80	0.0250000
NODE_82390_length_391_cov_69.510274	9	89	28	4	80	0.0500000
NODE_82390_length_391_cov_69.510274	9	89	29	3	80	0.0375000
NODE_82390_length_391_cov_69.510274	9	89	34	1	80	0.0125000
NODE_82390_length_391_cov_69.510274	9	89	35	4	80	0.0500000
NODE_82390_length_391_cov_69.510274	9	89	38	1	80	0.0125000
NODE_82390_length_391_cov_69.510274	9	89	39	1	80	0.0125000
NODE_82390_length_391_cov_69.510274	9	89	40	8	80	0.1000000
NODE_82390_length_391_cov_69.510274	9	89	41	3	80	0.0375000
NODE_82390_length_391_cov_69.510274	9	89	42	3	80	0.0375000
NODE_82390_length_391_cov_69.510274	9	89	44	1	80	0.0125000
NODE_82390_length_391_cov_69.510274	9	89	47	1	80	0.0125000
NODE_82390_length_391_cov_69.510274	9	89	48	3	80	0.0375000
NODE_82390_length_391_cov_69.510274	9	89	50	3	80	0.0375000
NODE_82390_length_391_cov_69.510274	9	89	52	2	80	0.0250000
NODE_82390_length_391_cov_69.510274	9	89	53	2	80	0.0250000
NODE_82390_length_391_cov_69.510274	9	89	54	1	80	0.0125000
NODE_82390_length_391_cov_69.510274	9	89	59	2	80	0.0250000
NODE_82390_length_391_cov_69.510274	9	89	61	2	80	0.0250000
NODE_82391_length_391_cov_39.414384	0	66	2	23	66	0.3484848
NODE_82391_length_391_cov_39.414384	0	66	3	15	66	0.2272727
NODE_82391_length_391_cov_39.414384	0	66	4	28	66	0.4242424
NODE_82391_length_391_cov_39.414384	0	71	2	23	71	0.3239437
NODE_82391_length_391_cov_39.414384	0	71	3	15	71	0.2112676
NODE_82391_length_391_cov_39.414384	0	71	4	33	71	0.4647887
NODE_82391_length_391_cov_39.414384	44	124	4	27	80	0.3375000
NODE_82391_length_391_cov_39.414384	44	124	5	42	80	0.5250000
NODE_82391_length_391_cov_39.414384	44	124	6	11	80	0.1375000
NODE_82394_length_391_cov_10.352740	156	235	0	79	79	1.0000000
NODE_82415_length_391_cov_5.030822	85	166	0	81	81	1.0000000
NODE_82498_length_391_cov_2.660959	267	343	0	76	76	1.0000000
NODE_82552_length_391_cov_2.089041	176	256	0	80	80	1.0000000
NODE_82552_length_391_cov_2.089041	229	280	0	51	51	1.0000000
NODE_82574_length_391_cov_1.907534	200	257	0	57	57	1.0000000
NODE_82597_length_391_cov_1.773973	160	190	0	30	30	1.0000000
NODE_82632_length_391_cov_1.647260	298	378	0	80	80	1.0000000
NODE_82662_length_391_cov_1.561644	241	261	2	20	20	1.0000000
NODE_83015_length_390_cov_29.030928	86	166	3	39	80	0.4875000
NODE_83015_length_390_cov_29.030928	86	166	4	15	80	0.1875000
NODE_83015_length_390_cov_29.030928	86	166	5	9	80	0.1125000
NODE_83015_length_390_cov_29.030928	86	166	6	1	80	0.0125000
NODE_83015_length_390_cov_29.030928	86	166	7	16	80	0.2000000
NODE_83015_length_390_cov_29.030928	139	219	4	1	80	0.0125000
NODE_83015_length_390_cov_29.030928	139	219	5	9	80	0.1125000
NODE_83015_length_390_cov_29.030928	139	219	6	15	80	0.1875000
NODE_83015_length_390_cov_29.030928	139	219	7	55	80	0.6875000
NODE_83016_length_390_cov_22.319588	118	198	3	36	80	0.4500000
NODE_83016_length_390_cov_22.319588	118	198	4	44	80	0.5500000
NODE_83016_length_390_cov_22.319588	171	251	1	2	80	0.0250000
NODE_83016_length_390_cov_22.319588	171	251	2	27	80	0.3375000
NODE_83016_length_390_cov_22.319588	171	251	3	43	80	0.5375000
NODE_83016_length_390_cov_22.319588	171	251	4	8	80	0.1000000
NODE_83044_length_390_cov_4.481100	208	277	0	69	69	1.0000000
NODE_83044_length_390_cov_4.481100	286	327	0	41	41	1.0000000
NODE_83045_length_390_cov_4.481100	93	171	0	78	78	1.0000000
NODE_83045_length_390_cov_4.481100	144	210	0	66	66	1.0000000
NODE_83060_length_390_cov_3.814433	66	99	0	33	33	1.0000000
NODE_83061_length_390_cov_3.783505	188	268	0	47	80	0.5875000
NODE_83061_length_390_cov_3.783505	188	268	2	33	80	0.4125000
NODE_83061_length_390_cov_3.783505	241	321	2	80	80	1.0000000
NODE_83066_length_390_cov_3.560137	304	367	0	63	63	1.0000000
NODE_83066_length_390_cov_3.560137	340	381	0	41	41	1.0000000
NODE_83169_length_390_cov_2.127148	242	322	0	13	80	0.1625000
NODE_83169_length_390_cov_2.127148	242	322	2	67	80	0.8375000
NODE_83171_length_390_cov_2.123711	133	177	0	34	44	0.7727273
NODE_83171_length_390_cov_2.123711	133	177	2	10	44	0.2272727
NODE_83171_length_390_cov_2.123711	157	237	0	10	80	0.1250000
NODE_83171_length_390_cov_2.123711	157	237	2	70	80	0.8750000
NODE_83288_length_390_cov_1.536082	223	276	0	53	53	1.0000000
NODE_83338_length_390_cov_1.398625	49	110	9	17	61	0.2786885
NODE_83338_length_390_cov_1.398625	49	110	11	18	61	0.2950820
NODE_83338_length_390_cov_1.398625	49	110	13	5	61	0.0819672
NODE_83338_length_390_cov_1.398625	49	110	15	21	61	0.3442623
NODE_83463_length_390_cov_1.034364	78	158	0	80	80	1.0000000
NODE_83633_length_389_cov_63.710345	32	112	0	80	80	1.0000000
NODE_83633_length_389_cov_63.710345	85	165	0	80	80	1.0000000
NODE_83633_length_389_cov_63.710345	161	241	0	80	80	1.0000000
NODE_83633_length_389_cov_63.710345	214	294	0	80	80	1.0000000
NODE_83650_length_389_cov_5.382759	154	234	0	80	80	1.0000000
NODE_83662_length_389_cov_4.468966	199	269	1	70	70	1.0000000
NODE_83663_length_389_cov_4.424138	68	148	8	2	80	0.0250000
NODE_83663_length_389_cov_4.424138	68	148	10	19	80	0.2375000
NODE_83663_length_389_cov_4.424138	68	148	12	59	80	0.7375000
NODE_83685_length_389_cov_3.782759	194	225	2	31	31	1.0000000
NODE_83689_length_389_cov_3.555172	107	153	0	46	46	1.0000000
NODE_83695_length_389_cov_3.251724	120	163	0	43	43	1.0000000
NODE_83695_length_389_cov_3.251724	136	206	0	70	70	1.0000000
NODE_83816_length_389_cov_1.951724	68	148	0	80	80	1.0000000
NODE_83819_length_389_cov_1.937931	53	82	0	29	29	1.0000000
NODE_83819_length_389_cov_1.937931	153	233	2	80	80	1.0000000
NODE_83829_length_389_cov_1.920690	296	365	0	69	69	1.0000000
NODE_84182_length_389_cov_0.720690	294	374	0	80	80	1.0000000
NODE_84267_length_388_cov_9.179931	47	127	0	80	80	1.0000000
NODE_84267_length_388_cov_9.179931	100	180	0	80	80	1.0000000
NODE_84270_length_388_cov_7.249135	171	251	4	5	80	0.0625000
NODE_84270_length_388_cov_7.249135	171	251	5	58	80	0.7250000
NODE_84270_length_388_cov_7.249135	171	251	6	4	80	0.0500000
NODE_84270_length_388_cov_7.249135	171	251	7	13	80	0.1625000
NODE_84270_length_388_cov_7.249135	224	304	1	9	80	0.1125000
NODE_84270_length_388_cov_7.249135	224	304	2	15	80	0.1875000
NODE_84270_length_388_cov_7.249135	224	304	3	6	80	0.0750000
NODE_84270_length_388_cov_7.249135	224	304	5	50	80	0.6250000
NODE_84305_length_388_cov_3.913495	151	231	0	80	80	1.0000000
NODE_84308_length_388_cov_3.809689	233	277	0	44	44	1.0000000
NODE_84332_length_388_cov_3.103806	101	166	0	65	65	1.0000000
NODE_84332_length_388_cov_3.103806	147	227	0	80	80	1.0000000
NODE_84334_length_388_cov_3.041522	48	128	0	80	80	1.0000000
NODE_84410_length_388_cov_2.114187	82	141	0	59	59	1.0000000
NODE_84410_length_388_cov_2.114187	135	194	0	59	59	1.0000000
NODE_84423_length_388_cov_2.017301	99	151	0	52	52	1.0000000
NODE_84427_length_388_cov_1.989619	0	76	0	14	76	0.1842105
NODE_84427_length_388_cov_1.989619	0	76	1	62	76	0.8157895
NODE_84427_length_388_cov_1.989619	49	114	1	65	65	1.0000000
NODE_84587_length_388_cov_1.352941	172	247	0	75	75	1.0000000
NODE_84631_length_388_cov_1.228374	308	339	0	31	31	1.0000000
NODE_84885_length_387_cov_33.052083	194	274	0	80	80	1.0000000
NODE_84885_length_387_cov_33.052083	247	327	0	80	80	1.0000000
NODE_84890_length_387_cov_6.871528	26	106	0	60	80	0.7500000
NODE_84890_length_387_cov_6.871528	26	106	1	20	80	0.2500000
NODE_84890_length_387_cov_6.871528	79	159	0	7	80	0.0875000
NODE_84890_length_387_cov_6.871528	79	159	1	35	80	0.4375000
NODE_84890_length_387_cov_6.871528	79	159	2	38	80	0.4750000
NODE_84902_length_387_cov_5.420139	286	341	0	55	55	1.0000000
NODE_84946_length_387_cov_3.364583	287	367	0	80	80	1.0000000
NODE_85007_length_387_cov_2.260417	140	210	1	70	70	1.0000000
NODE_85019_length_387_cov_2.128472	220	286	0	66	66	1.0000000
NODE_85019_length_387_cov_2.128472	273	329	0	56	56	1.0000000
NODE_85032_length_387_cov_2.090278	318	352	0	34	34	1.0000000
NODE_85037_length_387_cov_2.055556	23	45	0	22	22	1.0000000
NODE_85047_length_387_cov_1.979167	259	316	0	57	57	1.0000000
NODE_85047_length_387_cov_1.979167	312	369	0	57	57	1.0000000
NODE_85091_length_387_cov_1.770833	315	361	0	46	46	1.0000000
NODE_85528_length_386_cov_9.979094	38	118	1	80	80	1.0000000
NODE_85528_length_386_cov_9.979094	91	174	0	13	83	0.1566265
NODE_85528_length_386_cov_9.979094	91	174	1	70	83	0.8433735
NODE_85546_length_386_cov_4.428571	197	249	0	52	52	1.0000000
NODE_85570_length_386_cov_3.355401	151	231	0	80	80	1.0000000
NODE_85570_length_386_cov_3.355401	204	265	0	61	61	1.0000000
NODE_85602_length_386_cov_2.686411	293	325	0	32	32	1.0000000
NODE_85602_length_386_cov_2.686411	349	379	0	30	30	1.0000000
NODE_85629_length_386_cov_2.442509	55	135	1	80	80	1.0000000
NODE_85629_length_386_cov_2.442509	108	164	1	56	56	1.0000000
NODE_85793_length_386_cov_1.494774	79	121	0	42	42	1.0000000
NODE_85793_length_386_cov_1.494774	93	156	0	63	63	1.0000000
NODE_85816_length_386_cov_1.421603	160	236	1	9	76	0.1184211
NODE_85816_length_386_cov_1.421603	160	236	2	58	76	0.7631579
NODE_85816_length_386_cov_1.421603	160	236	3	9	76	0.1184211
NODE_85845_length_386_cov_1.372822	62	142	0	80	80	1.0000000
NODE_85845_length_386_cov_1.372822	115	195	0	80	80	1.0000000
NODE_85858_length_386_cov_1.317073	124	161	0	34	37	0.9189189
NODE_85858_length_386_cov_1.317073	124	161	2	3	37	0.0810811
NODE_85902_length_386_cov_1.170732	260	308	0	48	48	1.0000000
NODE_86143_length_385_cov_167.877622	103	164	47	3	61	0.0491803
NODE_86143_length_385_cov_167.877622	103	164	48	4	61	0.0655738
NODE_86143_length_385_cov_167.877622	103	164	49	12	61	0.1967213
NODE_86143_length_385_cov_167.877622	103	164	50	5	61	0.0819672
NODE_86143_length_385_cov_167.877622	103	164	51	14	61	0.2295082
NODE_86143_length_385_cov_167.877622	103	164	52	3	61	0.0491803
NODE_86143_length_385_cov_167.877622	103	164	53	2	61	0.0327869
NODE_86143_length_385_cov_167.877622	103	164	54	11	61	0.1803279
NODE_86143_length_385_cov_167.877622	103	164	56	5	61	0.0819672
NODE_86143_length_385_cov_167.877622	103	164	58	1	61	0.0163934
NODE_86143_length_385_cov_167.877622	103	164	60	1	61	0.0163934
NODE_86144_length_385_cov_38.695804	164	244	2	31	80	0.3875000
NODE_86144_length_385_cov_38.695804	164	244	4	49	80	0.6125000
NODE_86144_length_385_cov_38.695804	217	297	0	4	80	0.0500000
NODE_86144_length_385_cov_38.695804	217	297	2	47	80	0.5875000
NODE_86144_length_385_cov_38.695804	217	297	4	29	80	0.3625000
NODE_86169_length_385_cov_4.335664	173	250	0	64	77	0.8311688
NODE_86169_length_385_cov_4.335664	173	250	1	3	77	0.0389610
NODE_86169_length_385_cov_4.335664	173	250	3	5	77	0.0649351
NODE_86169_length_385_cov_4.335664	173	250	4	5	77	0.0649351
NODE_86185_length_385_cov_3.793706	215	297	3	4	82	0.0487805
NODE_86185_length_385_cov_3.793706	215	297	5	4	82	0.0487805
NODE_86185_length_385_cov_3.793706	215	297	6	74	82	0.9024390
NODE_86230_length_385_cov_2.786713	99	179	0	57	80	0.7125000
NODE_86230_length_385_cov_2.786713	99	179	2	23	80	0.2875000
NODE_86230_length_385_cov_2.786713	152	232	0	80	80	1.0000000
NODE_86230_length_385_cov_2.786713	281	362	0	81	81	1.0000000
NODE_86448_length_385_cov_1.381119	71	145	0	40	74	0.5405405
NODE_86448_length_385_cov_1.381119	71	145	1	30	74	0.4054054
NODE_86448_length_385_cov_1.381119	71	145	2	4	74	0.0540541
NODE_86448_length_385_cov_1.381119	118	198	1	23	80	0.2875000
NODE_86448_length_385_cov_1.381119	118	198	2	57	80	0.7125000
NODE_86798_length_384_cov_3.996491	135	217	0	82	82	1.0000000
NODE_86809_length_384_cov_3.729825	181	228	0	47	47	1.0000000
NODE_86812_length_384_cov_3.715789	145	221	0	76	76	1.0000000
NODE_86841_length_384_cov_2.996491	147	227	2	36	80	0.4500000
NODE_86841_length_384_cov_2.996491	147	227	3	20	80	0.2500000
NODE_86841_length_384_cov_2.996491	147	227	4	24	80	0.3000000
NODE_86847_length_384_cov_2.835088	65	145	3	59	80	0.7375000
NODE_86847_length_384_cov_2.835088	65	145	6	21	80	0.2625000
NODE_86866_length_384_cov_2.575439	151	224	0	13	73	0.1780822
NODE_86866_length_384_cov_2.575439	151	224	2	60	73	0.8219178
NODE_86866_length_384_cov_2.575439	197	281	0	70	84	0.8333333
NODE_86866_length_384_cov_2.575439	197	281	2	14	84	0.1666667
NODE_86907_length_384_cov_2.231579	78	153	0	75	75	1.0000000
NODE_86942_length_384_cov_1.940351	73	153	0	80	80	1.0000000
NODE_87431_length_383_cov_4.869718	117	197	0	80	80	1.0000000
NODE_87431_length_383_cov_4.869718	170	250	0	30	80	0.3750000
NODE_87431_length_383_cov_4.869718	170	250	1	16	80	0.2000000
NODE_87431_length_383_cov_4.869718	170	250	2	34	80	0.4250000
NODE_87432_length_383_cov_4.841549	121	180	0	59	59	1.0000000
NODE_87438_length_383_cov_4.559859	33	109	0	76	76	1.0000000
NODE_87487_length_383_cov_2.940141	185	265	0	2	80	0.0250000
NODE_87487_length_383_cov_2.940141	185	265	1	29	80	0.3625000
NODE_87487_length_383_cov_2.940141	185	265	2	49	80	0.6125000
NODE_87495_length_383_cov_2.760563	123	203	16	1	80	0.0125000
NODE_87495_length_383_cov_2.760563	123	203	18	22	80	0.2750000
NODE_87495_length_383_cov_2.760563	123	203	20	12	80	0.1500000
NODE_87495_length_383_cov_2.760563	123	203	21	16	80	0.2000000
NODE_87495_length_383_cov_2.760563	123	203	22	6	80	0.0750000
NODE_87495_length_383_cov_2.760563	123	203	23	11	80	0.1375000
NODE_87495_length_383_cov_2.760563	123	203	25	12	80	0.1500000
NODE_87495_length_383_cov_2.760563	169	249	14	5	80	0.0625000
NODE_87495_length_383_cov_2.760563	169	249	16	8	80	0.1000000
NODE_87495_length_383_cov_2.760563	169	249	18	22	80	0.2750000
NODE_87495_length_383_cov_2.760563	169	249	19	17	80	0.2125000
NODE_87495_length_383_cov_2.760563	169	249	20	4	80	0.0500000
NODE_87495_length_383_cov_2.760563	169	249	21	15	80	0.1875000
NODE_87495_length_383_cov_2.760563	169	249	23	3	80	0.0375000
NODE_87495_length_383_cov_2.760563	169	249	25	6	80	0.0750000
NODE_87495_length_383_cov_2.760563	222	302	0	33	80	0.4125000
NODE_87495_length_383_cov_2.760563	222	302	2	6	80	0.0750000
NODE_87495_length_383_cov_2.760563	222	302	5	3	80	0.0375000
NODE_87495_length_383_cov_2.760563	222	302	8	1	80	0.0125000
NODE_87495_length_383_cov_2.760563	222	302	10	4	80	0.0500000
NODE_87495_length_383_cov_2.760563	222	302	12	4	80	0.0500000
NODE_87495_length_383_cov_2.760563	222	302	14	7	80	0.0875000
NODE_87495_length_383_cov_2.760563	222	302	16	8	80	0.1000000
NODE_87495_length_383_cov_2.760563	222	302	18	12	80	0.1500000
NODE_87495_length_383_cov_2.760563	222	302	19	2	80	0.0250000
NODE_87566_length_383_cov_2.123239	29	94	0	65	65	1.0000000
NODE_87566_length_383_cov_2.123239	93	173	0	80	80	1.0000000
NODE_87566_length_383_cov_2.123239	146	193	0	47	47	1.0000000
NODE_87634_length_383_cov_1.728873	196	257	1	1	61	0.0163934
NODE_87634_length_383_cov_1.728873	196	257	2	7	61	0.1147541
NODE_87634_length_383_cov_1.728873	196	257	4	24	61	0.3934426
NODE_87634_length_383_cov_1.728873	196	257	5	2	61	0.0327869
NODE_87634_length_383_cov_1.728873	196	257	6	27	61	0.4426230
NODE_87634_length_383_cov_1.728873	239	310	6	71	71	1.0000000
NODE_88039_length_382_cov_43.724382	245	325	0	8	80	0.1000000
NODE_88039_length_382_cov_43.724382	245	325	1	60	80	0.7500000
NODE_88039_length_382_cov_43.724382	245	325	2	12	80	0.1500000
NODE_88039_length_382_cov_43.724382	298	378	0	61	80	0.7625000
NODE_88039_length_382_cov_43.724382	298	378	1	19	80	0.2375000
NODE_88040_length_382_cov_35.908127	163	243	1	16	80	0.2000000
NODE_88040_length_382_cov_35.908127	163	243	2	64	80	0.8000000
NODE_88040_length_382_cov_35.908127	216	296	0	46	80	0.5750000
NODE_88040_length_382_cov_35.908127	216	296	1	23	80	0.2875000
NODE_88040_length_382_cov_35.908127	216	296	2	11	80	0.1375000
NODE_88040_length_382_cov_35.908127	292	372	0	80	80	1.0000000
NODE_88041_length_382_cov_26.240283	57	137	2	4	80	0.0500000
NODE_88041_length_382_cov_26.240283	57	137	3	19	80	0.2375000
NODE_88041_length_382_cov_26.240283	57	137	4	57	80	0.7125000
NODE_88041_length_382_cov_26.240283	110	190	1	15	80	0.1875000
NODE_88041_length_382_cov_26.240283	110	190	2	42	80	0.5250000
NODE_88041_length_382_cov_26.240283	110	190	4	23	80	0.2875000
NODE_88054_length_382_cov_5.583039	63	143	4	19	80	0.2375000
NODE_88054_length_382_cov_5.583039	63	143	5	61	80	0.7625000
NODE_88054_length_382_cov_5.583039	116	196	1	23	80	0.2875000
NODE_88054_length_382_cov_5.583039	116	196	5	57	80	0.7125000
NODE_88063_length_382_cov_4.837456	19	78	0	59	59	1.0000000
NODE_88067_length_382_cov_4.618375	0	55	0	55	55	1.0000000
NODE_88067_length_382_cov_4.618375	104	184	0	37	80	0.4625000
NODE_88067_length_382_cov_4.618375	104	184	1	25	80	0.3125000
NODE_88067_length_382_cov_4.618375	104	184	3	18	80	0.2250000
NODE_88067_length_382_cov_4.618375	157	237	1	9	80	0.1125000
NODE_88067_length_382_cov_4.618375	157	237	3	71	80	0.8875000
NODE_88075_length_382_cov_4.268551	71	152	0	81	81	1.0000000
NODE_88075_length_382_cov_4.268551	124	205	0	81	81	1.0000000
NODE_88080_length_382_cov_4.091873	30	92	0	62	62	1.0000000
NODE_88121_length_382_cov_3.031802	173	253	0	80	80	1.0000000
NODE_88121_length_382_cov_3.031802	226	295	0	69	69	1.0000000
NODE_88135_length_382_cov_2.798587	231	293	0	61	62	0.9838710
NODE_88135_length_382_cov_2.798587	231	293	1	1	62	0.0161290
NODE_88136_length_382_cov_2.791519	195	244	0	49	49	1.0000000
NODE_88136_length_382_cov_2.791519	217	297	0	80	80	1.0000000
NODE_88164_length_382_cov_2.611307	301	368	0	67	67	1.0000000
NODE_88276_length_382_cov_1.802120	0	60	0	60	60	1.0000000
NODE_88660_length_382_cov_0.738516	48	95	1	47	47	1.0000000
NODE_88660_length_382_cov_0.738516	68	148	1	80	80	1.0000000
NODE_88758_length_381_cov_12.010638	195	274	0	79	79	1.0000000
NODE_88865_length_381_cov_2.606383	68	98	0	30	30	1.0000000
NODE_88867_length_381_cov_2.570922	115	175	0	60	60	1.0000000
NODE_88872_length_381_cov_2.514184	225	307	0	82	82	1.0000000
NODE_88900_length_381_cov_2.198582	193	276	0	83	83	1.0000000
NODE_88935_length_381_cov_1.989362	279	325	0	46	46	1.0000000
NODE_89009_length_381_cov_1.663121	51	128	0	77	77	1.0000000
NODE_89009_length_381_cov_1.663121	101	181	0	80	80	1.0000000
NODE_89090_length_381_cov_1.400709	254	334	0	80	80	1.0000000
NODE_89090_length_381_cov_1.400709	254	334	0	80	80	1.0000000
NODE_89090_length_381_cov_1.400709	309	373	0	64	64	1.0000000
NODE_89482_length_380_cov_57.604982	196	276	0	80	80	1.0000000
NODE_89482_length_380_cov_57.604982	249	329	0	80	80	1.0000000
NODE_89482_length_380_cov_57.604982	325	359	0	34	34	1.0000000
NODE_89483_length_380_cov_11.185053	79	161	2	12	82	0.1463415
NODE_89483_length_380_cov_11.185053	79	161	3	45	82	0.5487805
NODE_89483_length_380_cov_11.185053	79	161	4	25	82	0.3048781
NODE_89483_length_380_cov_11.185053	134	214	2	1	80	0.0125000
NODE_89483_length_380_cov_11.185053	134	214	3	45	80	0.5625000
NODE_89483_length_380_cov_11.185053	134	214	4	34	80	0.4250000
NODE_89491_length_380_cov_5.811388	100	156	0	56	56	1.0000000
NODE_89491_length_380_cov_5.811388	177	213	0	36	36	1.0000000
NODE_89495_length_380_cov_5.377224	242	271	8	11	29	0.3793103
NODE_89495_length_380_cov_5.377224	242	271	10	12	29	0.4137931
NODE_89495_length_380_cov_5.377224	242	271	12	6	29	0.2068966
NODE_89508_length_380_cov_4.185053	158	230	0	72	72	1.0000000
NODE_89508_length_380_cov_4.185053	159	229	0	70	70	1.0000000
NODE_89508_length_380_cov_4.185053	203	283	0	80	80	1.0000000
NODE_89508_length_380_cov_4.185053	203	283	0	80	80	1.0000000
NODE_89527_length_380_cov_3.423488	164	233	0	69	69	1.0000000
NODE_89540_length_380_cov_3.153025	188	260	0	72	72	1.0000000
NODE_89568_length_380_cov_2.718861	51	131	0	51	80	0.6375000
NODE_89568_length_380_cov_2.718861	51	131	2	9	80	0.1125000
NODE_89568_length_380_cov_2.718861	51	131	4	20	80	0.2500000
NODE_89568_length_380_cov_2.718861	104	184	2	7	80	0.0875000
NODE_89568_length_380_cov_2.718861	104	184	4	73	80	0.9125000
NODE_89658_length_380_cov_1.943060	22	56	0	34	34	1.0000000
NODE_89750_length_380_cov_1.601423	292	332	9	12	40	0.3000000
NODE_89750_length_380_cov_1.601423	292	332	10	6	40	0.1500000
NODE_89750_length_380_cov_1.601423	292	332	11	9	40	0.2250000
NODE_89750_length_380_cov_1.601423	292	332	13	9	40	0.2250000
NODE_89750_length_380_cov_1.601423	292	332	14	4	40	0.1000000
NODE_89911_length_380_cov_1.088968	312	353	0	41	41	1.0000000
NODE_89911_length_380_cov_1.088968	326	380	0	54	54	1.0000000
NODE_90152_length_379_cov_42.339286	10	90	0	80	80	1.0000000
NODE_90152_length_379_cov_42.339286	86	166	0	24	80	0.3000000
NODE_90152_length_379_cov_42.339286	86	166	2	23	80	0.2875000
NODE_90152_length_379_cov_42.339286	86	166	4	33	80	0.4125000
NODE_90152_length_379_cov_42.339286	139	219	2	7	80	0.0875000
NODE_90152_length_379_cov_42.339286	139	219	4	73	80	0.9125000
NODE_90153_length_379_cov_32.075000	0	62	0	62	62	1.0000000
NODE_90165_length_379_cov_5.607143	279	338	0	59	59	1.0000000
NODE_90180_length_379_cov_4.432143	219	243	0	24	24	1.0000000
NODE_90193_length_379_cov_3.778571	271	300	0	29	29	1.0000000
NODE_90198_length_379_cov_3.585714	128	152	0	24	24	1.0000000
NODE_90198_length_379_cov_3.585714	169	249	0	80	80	1.0000000
NODE_90203_length_379_cov_3.375000	19	43	1	17	24	0.7083333
NODE_90203_length_379_cov_3.375000	19	43	2	7	24	0.2916667
NODE_90247_length_379_cov_2.692857	121	201	2	80	80	1.0000000
NODE_90247_length_379_cov_2.692857	174	221	0	10	47	0.2127660
NODE_90247_length_379_cov_2.692857	174	221	2	37	47	0.7872341
NODE_90789_length_378_cov_53.039427	147	227	0	80	80	1.0000000
NODE_90789_length_378_cov_53.039427	200	280	0	80	80	1.0000000
NODE_90789_length_378_cov_53.039427	276	356	0	80	80	1.0000000
NODE_90789_length_378_cov_53.039427	329	378	0	49	49	1.0000000
NODE_90794_length_378_cov_6.569892	223	304	1	74	81	0.9135802
NODE_90794_length_378_cov_6.569892	223	304	2	7	81	0.0864198
NODE_90795_length_378_cov_6.444444	217	297	0	80	80	1.0000000
NODE_90795_length_378_cov_6.444444	270	350	0	80	80	1.0000000
NODE_90808_length_378_cov_4.899642	135	191	0	56	56	1.0000000
NODE_90855_length_378_cov_3.236559	143	212	4	69	69	1.0000000
NODE_90859_length_378_cov_3.132616	238	280	1	42	42	1.0000000
NODE_90898_length_378_cov_2.534050	203	243	0	40	40	1.0000000
NODE_90898_length_378_cov_2.534050	271	347	0	76	76	1.0000000
NODE_90898_length_378_cov_2.534050	331	360	0	29	29	1.0000000
NODE_90948_length_378_cov_2.093190	179	250	0	2	71	0.0281690
NODE_90948_length_378_cov_2.093190	179	250	2	69	71	0.9718310
NODE_90948_length_378_cov_2.093190	183	219	2	36	36	1.0000000
NODE_91002_length_378_cov_1.813620	36	89	0	49	53	0.9245283
NODE_91002_length_378_cov_1.813620	36	89	1	4	53	0.0754717
NODE_91475_length_377_cov_71.723022	19	99	2	80	80	1.0000000
NODE_91475_length_377_cov_71.723022	72	152	0	41	80	0.5125000
NODE_91475_length_377_cov_71.723022	72	152	2	39	80	0.4875000
NODE_91475_length_377_cov_71.723022	148	228	0	80	80	1.0000000
NODE_91475_length_377_cov_71.723022	201	281	0	32	80	0.4000000
NODE_91475_length_377_cov_71.723022	201	281	1	48	80	0.6000000
NODE_91477_length_377_cov_41.787770	210	290	0	18	80	0.2250000
NODE_91477_length_377_cov_41.787770	210	290	2	7	80	0.0875000
NODE_91477_length_377_cov_41.787770	210	290	4	55	80	0.6875000
NODE_91477_length_377_cov_41.787770	263	343	4	80	80	1.0000000
NODE_91478_length_377_cov_9.982014	32	83	0	29	51	0.5686275
NODE_91478_length_377_cov_9.982014	32	83	2	22	51	0.4313726
NODE_91486_length_377_cov_6.244604	101	177	4	25	76	0.3289474
NODE_91486_length_377_cov_6.244604	101	177	6	51	76	0.6710526
NODE_91494_length_377_cov_5.183453	169	224	0	55	55	1.0000000
NODE_91499_length_377_cov_4.586331	186	266	0	80	80	1.0000000
NODE_91499_length_377_cov_4.586331	239	319	0	30	80	0.3750000
NODE_91499_length_377_cov_4.586331	239	319	1	50	80	0.6250000
NODE_91500_length_377_cov_4.431655	139	216	5	39	77	0.5064935
NODE_91500_length_377_cov_4.431655	139	216	6	38	77	0.4935065
NODE_91502_length_377_cov_4.330935	134	214	0	80	80	1.0000000
NODE_91502_length_377_cov_4.330935	187	267	0	80	80	1.0000000
NODE_91506_length_377_cov_4.032374	124	181	0	57	57	1.0000000
NODE_91506_length_377_cov_4.032374	154	201	0	47	47	1.0000000
NODE_91526_length_377_cov_3.615108	82	140	0	58	58	1.0000000
NODE_91526_length_377_cov_3.615108	82	140	0	58	58	1.0000000
NODE_91526_length_377_cov_3.615108	113	193	0	80	80	1.0000000
NODE_91526_length_377_cov_3.615108	113	193	0	80	80	1.0000000
NODE_91526_length_377_cov_3.615108	189	258	0	69	69	1.0000000
NODE_91526_length_377_cov_3.615108	243	313	0	70	70	1.0000000
NODE_91553_length_377_cov_2.913669	38	61	0	23	23	1.0000000
NODE_91553_length_377_cov_2.913669	167	228	0	61	61	1.0000000
NODE_91619_length_377_cov_2.104317	137	188	0	51	51	1.0000000
NODE_91619_length_377_cov_2.104317	168	211	0	43	43	1.0000000
NODE_91619_length_377_cov_2.104317	190	241	0	51	51	1.0000000
NODE_91727_length_377_cov_1.622302	123	181	0	58	58	1.0000000
NODE_91727_length_377_cov_1.622302	176	234	0	58	58	1.0000000
NODE_91749_length_377_cov_1.539568	230	310	0	3	80	0.0375000
NODE_91749_length_377_cov_1.539568	230	310	1	77	80	0.9625000
NODE_91749_length_377_cov_1.539568	230	310	0	3	80	0.0375000
NODE_91749_length_377_cov_1.539568	230	310	1	77	80	0.9625000
NODE_91749_length_377_cov_1.539568	306	377	0	70	71	0.9859155
NODE_91749_length_377_cov_1.539568	306	377	1	1	71	0.0140845
NODE_91749_length_377_cov_1.539568	327	351	0	24	24	1.0000000
NODE_91765_length_377_cov_1.471223	118	198	3	66	80	0.8250000
NODE_91765_length_377_cov_1.471223	118	198	4	14	80	0.1750000
NODE_91790_length_377_cov_1.456835	177	257	0	80	80	1.0000000
NODE_91790_length_377_cov_1.456835	230	310	0	80	80	1.0000000
NODE_91817_length_377_cov_1.330935	0	44	0	44	44	1.0000000
NODE_91817_length_377_cov_1.330935	45	117	0	72	72	1.0000000
NODE_92046_length_377_cov_0.762590	299	330	0	31	31	1.0000000
NODE_92166_length_376_cov_6.938628	0	63	1	7	63	0.1111111
NODE_92166_length_376_cov_6.938628	0	63	2	8	63	0.1269841
NODE_92166_length_376_cov_6.938628	0	63	3	1	63	0.0158730
NODE_92166_length_376_cov_6.938628	0	63	5	11	63	0.1746032
NODE_92166_length_376_cov_6.938628	0	63	6	21	63	0.3333333
NODE_92166_length_376_cov_6.938628	0	63	8	2	63	0.0317460
NODE_92166_length_376_cov_6.938628	0	63	9	7	63	0.1111111
NODE_92166_length_376_cov_6.938628	0	63	12	6	63	0.0952381
NODE_92166_length_376_cov_6.938628	269	340	1	57	71	0.8028169
NODE_92166_length_376_cov_6.938628	269	340	2	14	71	0.1971831
NODE_92168_length_376_cov_6.415162	177	257	0	80	80	1.0000000
NODE_92168_length_376_cov_6.415162	230	310	0	80	80	1.0000000
NODE_92173_length_376_cov_5.722022	100	171	0	71	71	1.0000000
NODE_92173_length_376_cov_5.722022	155	192	0	37	37	1.0000000
NODE_92191_length_376_cov_4.148014	300	330	0	30	30	1.0000000
NODE_92196_length_376_cov_3.859206	168	236	0	68	68	1.0000000
NODE_92219_length_376_cov_3.140794	122	188	0	66	66	1.0000000
NODE_92442_length_376_cov_1.516245	57	106	0	2	49	0.0408163
NODE_92442_length_376_cov_1.516245	57	106	2	47	49	0.9591837
NODE_92879_length_375_cov_4.217391	321	350	0	5	29	0.1724138
NODE_92879_length_375_cov_4.217391	321	350	1	18	29	0.6206896
NODE_92879_length_375_cov_4.217391	321	350	2	6	29	0.2068966
NODE_92897_length_375_cov_3.699275	287	367	0	80	80	1.0000000
NODE_92911_length_375_cov_3.376812	70	136	2	66	66	1.0000000
NODE_93031_length_375_cov_2.032609	162	224	0	47	62	0.7580645
NODE_93031_length_375_cov_2.032609	162	224	2	15	62	0.2419355
NODE_93031_length_375_cov_2.032609	215	272	2	57	57	1.0000000
NODE_93050_length_375_cov_1.967391	131	190	0	59	59	1.0000000
NODE_93050_length_375_cov_1.967391	184	235	0	51	51	1.0000000
NODE_93081_length_375_cov_1.840580	195	276	0	81	81	1.0000000
NODE_93386_length_375_cov_1.000000	320	375	0	55	55	1.0000000
NODE_93609_length_374_cov_4.563636	93	160	0	67	67	1.0000000
NODE_93609_length_374_cov_4.563636	146	213	0	67	67	1.0000000
NODE_93612_length_374_cov_4.523636	23	101	0	78	78	1.0000000
NODE_93612_length_374_cov_4.523636	81	154	0	73	73	1.0000000
NODE_93628_length_374_cov_3.810909	130	189	0	59	59	1.0000000
NODE_93628_length_374_cov_3.810909	162	242	0	80	80	1.0000000
NODE_93630_length_374_cov_3.789091	236	271	0	35	35	1.0000000
NODE_93630_length_374_cov_3.789091	238	280	0	42	42	1.0000000
NODE_93637_length_374_cov_3.458182	190	248	0	58	58	1.0000000
NODE_93688_length_374_cov_2.600000	142	217	0	1	75	0.0133333
NODE_93688_length_374_cov_2.600000	142	217	3	16	75	0.2133333
NODE_93688_length_374_cov_2.600000	142	217	4	58	75	0.7733333
NODE_93688_length_374_cov_2.600000	190	270	1	9	80	0.1125000
NODE_93688_length_374_cov_2.600000	190	270	2	33	80	0.4125000
NODE_93688_length_374_cov_2.600000	190	270	4	38	80	0.4750000
NODE_93718_length_374_cov_2.330909	40	120	0	80	80	1.0000000
NODE_93769_length_374_cov_2.010909	40	105	0	65	65	1.0000000
NODE_93821_length_374_cov_1.796364	254	288	2	34	34	1.0000000
NODE_93852_length_374_cov_1.661818	95	157	0	2	62	0.0322581
NODE_93852_length_374_cov_1.661818	95	157	1	38	62	0.6129032
NODE_93852_length_374_cov_1.661818	95	157	2	22	62	0.3548387
NODE_93859_length_374_cov_1.621818	202	254	0	52	52	1.0000000
NODE_93936_length_374_cov_1.360000	211	291	0	80	80	1.0000000
NODE_93981_length_374_cov_1.236364	263	336	1	73	73	1.0000000
NODE_94321_length_373_cov_31.302920	0	53	0	6	53	0.1132075
NODE_94321_length_373_cov_31.302920	0	53	2	22	53	0.4150943
NODE_94321_length_373_cov_31.302920	0	53	3	25	53	0.4716981
NODE_94321_length_373_cov_31.302920	0	53	0	6	53	0.1132075
NODE_94321_length_373_cov_31.302920	0	53	2	22	53	0.4150943
NODE_94321_length_373_cov_31.302920	0	53	3	25	53	0.4716981
NODE_94321_length_373_cov_31.302920	0	53	0	6	53	0.1132075
NODE_94321_length_373_cov_31.302920	0	53	2	22	53	0.4150943
NODE_94321_length_373_cov_31.302920	0	53	3	25	53	0.4716981
NODE_94321_length_373_cov_31.302920	26	106	2	2	80	0.0250000
NODE_94321_length_373_cov_31.302920	26	106	3	78	80	0.9750000
NODE_94340_length_373_cov_4.671533	76	142	2	7	66	0.1060606
NODE_94340_length_373_cov_4.671533	76	142	3	59	66	0.8939394
NODE_94340_length_373_cov_4.671533	115	195	1	27	80	0.3375000
NODE_94340_length_373_cov_4.671533	115	195	3	53	80	0.6625000
NODE_94340_length_373_cov_4.671533	115	195	1	27	80	0.3375000
NODE_94340_length_373_cov_4.671533	115	195	3	53	80	0.6625000
NODE_94340_length_373_cov_4.671533	288	368	0	19	80	0.2375000
NODE_94340_length_373_cov_4.671533	288	368	1	61	80	0.7625000
NODE_94352_length_373_cov_4.080292	109	189	0	80	80	1.0000000
NODE_94352_length_373_cov_4.080292	162	220	0	58	58	1.0000000
NODE_94380_length_373_cov_3.167883	131	210	0	79	79	1.0000000
NODE_94414_length_373_cov_2.751825	80	151	0	71	71	1.0000000
NODE_94414_length_373_cov_2.751825	124	162	0	34	38	0.8947368
NODE_94414_length_373_cov_2.751825	124	162	1	4	38	0.1052632
NODE_94493_length_373_cov_2.036496	248	326	0	78	78	1.0000000
NODE_94493_length_373_cov_2.036496	299	359	0	60	60	1.0000000
NODE_94500_length_373_cov_2.003650	150	194	0	44	44	1.0000000
NODE_94937_length_373_cov_0.759124	62	114	0	52	52	1.0000000
NODE_95051_length_372_cov_30.135531	111	191	0	80	80	1.0000000
NODE_95051_length_372_cov_30.135531	159	222	0	63	63	1.0000000
NODE_95051_length_372_cov_30.135531	164	239	0	75	75	1.0000000
NODE_95051_length_372_cov_30.135531	182	253	0	71	71	1.0000000
NODE_95051_length_372_cov_30.135531	195	275	0	80	80	1.0000000
NODE_95051_length_372_cov_30.135531	213	276	0	63	63	1.0000000
NODE_95053_length_372_cov_9.091575	150	230	2	80	80	1.0000000
NODE_95053_length_372_cov_9.091575	203	283	0	30	80	0.3750000
NODE_95053_length_372_cov_9.091575	203	283	2	50	80	0.6250000
NODE_95063_length_372_cov_5.706960	168	208	0	40	40	1.0000000
NODE_95067_length_372_cov_5.124542	146	211	3	19	65	0.2923077
NODE_95067_length_372_cov_5.124542	146	211	4	46	65	0.7076923
NODE_95067_length_372_cov_5.124542	189	264	4	75	75	1.0000000
NODE_95090_length_372_cov_3.761905	177	221	0	44	44	1.0000000
NODE_95109_length_372_cov_3.186813	137	218	0	81	81	1.0000000
NODE_95159_length_372_cov_2.582418	167	239	0	34	72	0.4722222
NODE_95159_length_372_cov_2.582418	167	239	1	28	72	0.3888889
NODE_95159_length_372_cov_2.582418	167	239	2	10	72	0.1388889
NODE_95159_length_372_cov_2.582418	212	292	1	17	80	0.2125000
NODE_95159_length_372_cov_2.582418	212	292	2	63	80	0.7875000
NODE_95183_length_372_cov_2.347985	97	141	0	44	44	1.0000000
NODE_95183_length_372_cov_2.347985	98	133	0	35	35	1.0000000
NODE_95183_length_372_cov_2.347985	178	243	0	65	65	1.0000000
NODE_95303_length_372_cov_1.699634	195	276	0	81	81	1.0000000
NODE_95453_length_372_cov_1.223443	264	334	0	70	70	1.0000000
NODE_95784_length_371_cov_52.040441	104	184	1	75	80	0.9375000
NODE_95784_length_371_cov_52.040441	104	184	2	1	80	0.0125000
NODE_95784_length_371_cov_52.040441	104	184	4	1	80	0.0125000
NODE_95784_length_371_cov_52.040441	104	184	5	2	80	0.0250000
NODE_95784_length_371_cov_52.040441	104	184	6	1	80	0.0125000
NODE_95784_length_371_cov_52.040441	157	237	1	22	80	0.2750000
NODE_95784_length_371_cov_52.040441	157	237	2	1	80	0.0125000
NODE_95784_length_371_cov_52.040441	157	237	4	1	80	0.0125000
NODE_95784_length_371_cov_52.040441	157	237	5	2	80	0.0250000
NODE_95784_length_371_cov_52.040441	157	237	6	4	80	0.0500000
NODE_95784_length_371_cov_52.040441	157	237	7	2	80	0.0250000
NODE_95784_length_371_cov_52.040441	157	237	8	10	80	0.1250000
NODE_95784_length_371_cov_52.040441	157	237	9	6	80	0.0750000
NODE_95784_length_371_cov_52.040441	157	237	10	1	80	0.0125000
NODE_95784_length_371_cov_52.040441	157	237	11	1	80	0.0125000
NODE_95784_length_371_cov_52.040441	157	237	12	5	80	0.0625000
NODE_95784_length_371_cov_52.040441	157	237	13	6	80	0.0750000
NODE_95784_length_371_cov_52.040441	157	237	15	2	80	0.0250000
NODE_95784_length_371_cov_52.040441	157	237	16	1	80	0.0125000
NODE_95784_length_371_cov_52.040441	157	237	17	16	80	0.2000000
NODE_95784_length_371_cov_52.040441	180	232	4	1	52	0.0192308
NODE_95784_length_371_cov_52.040441	180	232	5	2	52	0.0384615
NODE_95784_length_371_cov_52.040441	180	232	6	4	52	0.0769231
NODE_95784_length_371_cov_52.040441	180	232	7	2	52	0.0384615
NODE_95784_length_371_cov_52.040441	180	232	8	10	52	0.1923077
NODE_95784_length_371_cov_52.040441	180	232	9	6	52	0.1153846
NODE_95784_length_371_cov_52.040441	180	232	10	1	52	0.0192308
NODE_95784_length_371_cov_52.040441	180	232	11	1	52	0.0192308
NODE_95784_length_371_cov_52.040441	180	232	12	5	52	0.0961538
NODE_95784_length_371_cov_52.040441	180	232	13	6	52	0.1153846
NODE_95784_length_371_cov_52.040441	180	232	15	2	52	0.0384615
NODE_95784_length_371_cov_52.040441	180	232	16	1	52	0.0192308
NODE_95784_length_371_cov_52.040441	180	232	17	11	52	0.2115385
NODE_95785_length_371_cov_24.878676	91	171	8	10	80	0.1250000
NODE_95785_length_371_cov_24.878676	91	171	10	21	80	0.2625000
NODE_95785_length_371_cov_24.878676	91	171	12	24	80	0.3000000
NODE_95785_length_371_cov_24.878676	91	171	14	25	80	0.3125000
NODE_95785_length_371_cov_24.878676	144	224	11	6	80	0.0750000
NODE_95785_length_371_cov_24.878676	144	224	12	14	80	0.1750000
NODE_95785_length_371_cov_24.878676	144	224	13	4	80	0.0500000
NODE_95785_length_371_cov_24.878676	144	224	14	56	80	0.7000000
NODE_95797_length_371_cov_5.738971	170	245	0	10	75	0.1333333
NODE_95797_length_371_cov_5.738971	170	245	1	65	75	0.8666667
NODE_95797_length_371_cov_5.738971	218	298	1	36	80	0.4500000
NODE_95797_length_371_cov_5.738971	218	298	3	44	80	0.5500000
NODE_95807_length_371_cov_4.452206	65	145	0	80	80	1.0000000
NODE_95807_length_371_cov_4.452206	118	198	0	80	80	1.0000000
NODE_95863_length_371_cov_2.841912	288	350	0	62	62	1.0000000
NODE_96013_length_371_cov_1.790441	188	235	0	47	47	1.0000000
NODE_96105_length_371_cov_1.422794	199	287	0	88	88	1.0000000
NODE_96500_length_370_cov_50.380074	144	224	3	45	80	0.5625000
NODE_96500_length_370_cov_50.380074	144	224	4	1	80	0.0125000
NODE_96500_length_370_cov_50.380074	144	224	5	4	80	0.0500000
NODE_96500_length_370_cov_50.380074	144	224	6	30	80	0.3750000
NODE_96500_length_370_cov_50.380074	197	277	1	14	80	0.1750000
NODE_96500_length_370_cov_50.380074	197	277	2	1	80	0.0125000
NODE_96500_length_370_cov_50.380074	197	277	3	65	80	0.8125000
NODE_96504_length_370_cov_7.553506	105	162	2	57	57	1.0000000
NODE_96510_length_370_cov_5.811808	153	221	0	68	68	1.0000000
NODE_96510_length_370_cov_5.811808	206	286	0	80	80	1.0000000
NODE_96522_length_370_cov_4.915129	157	207	0	11	50	0.2200000
NODE_96522_length_370_cov_4.915129	157	207	2	39	50	0.7800000
NODE_96528_length_370_cov_4.535055	141	221	0	12	80	0.1500000
NODE_96528_length_370_cov_4.535055	141	221	1	68	80	0.8500000
NODE_96528_length_370_cov_4.535055	194	274	1	80	80	1.0000000
NODE_96532_length_370_cov_4.199262	230	275	0	45	45	1.0000000
NODE_96533_length_370_cov_4.151292	142	209	0	20	67	0.2985075
NODE_96533_length_370_cov_4.151292	142	209	2	47	67	0.7014925
NODE_96542_length_370_cov_3.719557	214	251	6	21	37	0.5675676
NODE_96542_length_370_cov_3.719557	214	251	8	16	37	0.4324324
NODE_96581_length_370_cov_2.822878	126	173	2	40	47	0.8510638
NODE_96581_length_370_cov_2.822878	126	173	3	7	47	0.1489362
NODE_96668_length_370_cov_2.081181	0	52	0	1	52	0.0192308
NODE_96668_length_370_cov_2.081181	0	52	2	3	52	0.0576923
NODE_96668_length_370_cov_2.081181	0	52	4	31	52	0.5961539
NODE_96668_length_370_cov_2.081181	0	52	6	17	52	0.3269231
NODE_97207_length_369_cov_36.811111	273	358	0	7	85	0.0823529
NODE_97207_length_369_cov_36.811111	273	358	1	78	85	0.9176471
NODE_97207_length_369_cov_36.811111	273	358	0	7	85	0.0823529
NODE_97207_length_369_cov_36.811111	273	358	1	78	85	0.9176471
NODE_97207_length_369_cov_36.811111	273	358	0	7	85	0.0823529
NODE_97207_length_369_cov_36.811111	273	358	1	78	85	0.9176471
NODE_97211_length_369_cov_8.751852	107	187	0	80	80	1.0000000
NODE_97226_length_369_cov_6.677778	189	269	0	5	80	0.0625000
NODE_97226_length_369_cov_6.677778	189	269	1	75	80	0.9375000
NODE_97226_length_369_cov_6.677778	242	323	1	81	81	1.0000000
NODE_97236_length_369_cov_5.337037	199	264	0	6	65	0.0923077
NODE_97236_length_369_cov_5.337037	199	264	2	59	65	0.9076923
NODE_97249_length_369_cov_4.459259	89	157	0	68	68	1.0000000
NODE_97249_length_369_cov_4.459259	130	210	0	80	80	1.0000000
NODE_97255_length_369_cov_4.111111	216	279	0	63	63	1.0000000
NODE_97265_length_369_cov_3.837037	205	238	0	33	33	1.0000000
NODE_97265_length_369_cov_3.837037	211	291	0	80	80	1.0000000
NODE_97265_length_369_cov_3.837037	287	316	0	29	29	1.0000000
NODE_97346_length_369_cov_2.355556	62	142	0	80	80	1.0000000
NODE_97346_length_369_cov_2.355556	114	195	0	81	81	1.0000000
NODE_97440_length_369_cov_1.803704	170	235	0	65	65	1.0000000
NODE_97936_length_368_cov_42.208178	231	311	1	80	80	1.0000000
NODE_97936_length_368_cov_42.208178	284	364	0	47	80	0.5875000
NODE_97936_length_368_cov_42.208178	284	364	1	33	80	0.4125000
NODE_97939_length_368_cov_11.988848	47	127	2	10	80	0.1250000
NODE_97939_length_368_cov_11.988848	47	127	3	70	80	0.8750000
NODE_97939_length_368_cov_11.988848	100	180	2	5	80	0.0625000
NODE_97939_length_368_cov_11.988848	100	180	3	72	80	0.9000000
NODE_97939_length_368_cov_11.988848	100	180	4	3	80	0.0375000
NODE_97945_length_368_cov_6.267658	133	213	0	60	80	0.7500000
NODE_97945_length_368_cov_6.267658	133	213	2	20	80	0.2500000
NODE_97945_length_368_cov_6.267658	186	266	0	7	80	0.0875000
NODE_97945_length_368_cov_6.267658	186	266	2	73	80	0.9125000
NODE_97997_length_368_cov_3.486989	127	207	0	74	80	0.9250000
NODE_97997_length_368_cov_3.486989	127	207	2	6	80	0.0750000
NODE_98008_length_368_cov_3.282528	182	255	2	67	73	0.9178082
NODE_98008_length_368_cov_3.282528	182	255	4	6	73	0.0821918
NODE_98058_length_368_cov_2.605948	192	246	0	54	54	1.0000000
NODE_98123_length_368_cov_2.182156	85	145	0	60	60	1.0000000
NODE_98129_length_368_cov_2.137546	66	107	4	41	41	1.0000000
NODE_98157_length_368_cov_1.944238	192	272	0	80	80	1.0000000
NODE_98723_length_367_cov_7.156716	174	254	3	80	80	1.0000000
NODE_98723_length_367_cov_7.156716	227	307	0	27	80	0.3375000
NODE_98723_length_367_cov_7.156716	227	307	1	1	80	0.0125000
NODE_98723_length_367_cov_7.156716	227	307	2	23	80	0.2875000
NODE_98723_length_367_cov_7.156716	227	307	3	29	80	0.3625000
NODE_98734_length_367_cov_5.313433	148	206	0	44	58	0.7586207
NODE_98734_length_367_cov_5.313433	148	206	2	14	58	0.2413793
NODE_98737_length_367_cov_5.138060	58	138	1	20	80	0.2500000
NODE_98737_length_367_cov_5.138060	58	138	3	60	80	0.7500000
NODE_98737_length_367_cov_5.138060	111	191	3	80	80	1.0000000
NODE_98796_length_367_cov_3.059701	110	154	0	44	44	1.0000000
NODE_98796_length_367_cov_3.059701	111	146	0	35	35	1.0000000
NODE_98843_length_367_cov_2.384328	246	326	0	80	80	1.0000000
NODE_98843_length_367_cov_2.384328	299	367	0	68	68	1.0000000
NODE_98849_length_367_cov_2.332090	127	207	0	80	80	1.0000000
NODE_98909_length_367_cov_1.944030	91	156	1	29	65	0.4461538
NODE_98909_length_367_cov_1.944030	91	156	2	36	65	0.5538462
NODE_98980_length_367_cov_1.679104	173	252	1	33	79	0.4177215
NODE_98980_length_367_cov_1.679104	173	252	2	46	79	0.5822785
NODE_99005_length_367_cov_1.552239	148	200	1	1	52	0.0192308
NODE_99005_length_367_cov_1.552239	148	200	3	51	52	0.9807692
NODE_99138_length_367_cov_1.201493	79	159	0	80	80	1.0000000
NODE_99138_length_367_cov_1.201493	136	179	0	43	43	1.0000000
NODE_99318_length_367_cov_0.761194	288	357	0	69	69	1.0000000
NODE_99451_length_366_cov_5.239700	193	253	0	60	60	1.0000000
NODE_99472_length_366_cov_4.168539	302	355	0	53	53	1.0000000
NODE_99478_length_366_cov_3.913858	183	229	0	46	46	1.0000000
NODE_99478_length_366_cov_3.913858	203	282	0	79	79	1.0000000
NODE_99496_length_366_cov_3.168539	88	160	0	18	72	0.2500000
NODE_99496_length_366_cov_3.168539	88	160	1	1	72	0.0138889
NODE_99496_length_366_cov_3.168539	88	160	2	53	72	0.7361111
NODE_99496_length_366_cov_3.168539	133	193	2	60	60	1.0000000
NODE_100137_length_365_cov_140.101504	40	107	13	1	67	0.0149254
NODE_100137_length_365_cov_140.101504	40	107	15	1	67	0.0149254
NODE_100137_length_365_cov_140.101504	40	107	17	2	67	0.0298507
NODE_100137_length_365_cov_140.101504	40	107	19	9	67	0.1343284
NODE_100137_length_365_cov_140.101504	40	107	22	1	67	0.0149254
NODE_100137_length_365_cov_140.101504	40	107	24	2	67	0.0298507
NODE_100137_length_365_cov_140.101504	40	107	26	3	67	0.0447761
NODE_100137_length_365_cov_140.101504	40	107	27	1	67	0.0149254
NODE_100137_length_365_cov_140.101504	40	107	30	2	67	0.0298507
NODE_100137_length_365_cov_140.101504	40	107	32	9	67	0.1343284
NODE_100137_length_365_cov_140.101504	40	107	33	3	67	0.0447761
NODE_100137_length_365_cov_140.101504	40	107	34	7	67	0.1044776
NODE_100137_length_365_cov_140.101504	40	107	35	4	67	0.0597015
NODE_100137_length_365_cov_140.101504	40	107	36	2	67	0.0298507
NODE_100137_length_365_cov_140.101504	40	107	37	2	67	0.0298507
NODE_100137_length_365_cov_140.101504	40	107	39	1	67	0.0149254
NODE_100137_length_365_cov_140.101504	40	107	41	2	67	0.0298507
NODE_100137_length_365_cov_140.101504	40	107	42	3	67	0.0447761
NODE_100137_length_365_cov_140.101504	40	107	43	9	67	0.1343284
NODE_100137_length_365_cov_140.101504	40	107	45	1	67	0.0149254
NODE_100137_length_365_cov_140.101504	40	107	46	2	67	0.0298507
NODE_100138_length_365_cov_45.815789	0	38	0	11	38	0.2894737
NODE_100138_length_365_cov_45.815789	0	38	1	27	38	0.7105263
NODE_100138_length_365_cov_45.815789	11	91	1	80	80	1.0000000
NODE_100140_length_365_cov_8.169173	191	244	0	5	53	0.0943396
NODE_100140_length_365_cov_8.169173	191	244	2	48	53	0.9056604
NODE_100140_length_365_cov_8.169173	217	297	2	80	80	1.0000000
NODE_100145_length_365_cov_5.954887	136	216	0	80	80	1.0000000
NODE_100145_length_365_cov_5.954887	189	269	0	80	80	1.0000000
NODE_100147_length_365_cov_5.721805	37	78	0	41	41	1.0000000
NODE_100168_length_365_cov_4.195489	269	329	0	60	60	1.0000000
NODE_100172_length_365_cov_4.071429	106	186	0	80	80	1.0000000
NODE_100172_length_365_cov_4.071429	159	239	0	80	80	1.0000000
NODE_100180_length_365_cov_3.879699	131	187	0	56	56	1.0000000
NODE_100206_length_365_cov_3.270677	211	280	0	69	69	1.0000000
NODE_100253_length_365_cov_2.601504	189	265	2	27	76	0.3552631
NODE_100253_length_365_cov_2.601504	189	265	3	24	76	0.3157895
NODE_100253_length_365_cov_2.601504	189	265	4	25	76	0.3289474
NODE_100293_length_365_cov_2.289474	169	249	0	80	80	1.0000000
NODE_100407_length_365_cov_1.635338	156	235	0	19	79	0.2405063
NODE_100407_length_365_cov_1.635338	156	235	2	2	79	0.0253165
NODE_100407_length_365_cov_1.635338	156	235	4	4	79	0.0506329
NODE_100407_length_365_cov_1.635338	156	235	6	47	79	0.5949367
NODE_100407_length_365_cov_1.635338	156	235	7	7	79	0.0886076
NODE_100485_length_365_cov_1.421053	228	309	0	81	81	1.0000000
NODE_100570_length_365_cov_1.169173	57	137	1	79	80	0.9875000
NODE_100570_length_365_cov_1.169173	57	137	3	1	80	0.0125000
NODE_100570_length_365_cov_1.169173	65	145	1	71	80	0.8875000
NODE_100570_length_365_cov_1.169173	65	145	3	9	80	0.1125000
NODE_100570_length_365_cov_1.169173	194	274	4	9	80	0.1125000
NODE_100570_length_365_cov_1.169173	194	274	5	63	80	0.7875000
NODE_100570_length_365_cov_1.169173	194	274	7	8	80	0.1000000
NODE_100893_length_364_cov_24.600000	101	181	0	80	80	1.0000000
NODE_100893_length_364_cov_24.600000	154	234	0	80	80	1.0000000
NODE_100896_length_364_cov_7.377358	0	50	0	49	50	0.9800000
NODE_100896_length_364_cov_7.377358	0	50	1	1	50	0.0200000
NODE_100933_length_364_cov_3.988679	122	168	2	46	46	1.0000000
NODE_100935_length_364_cov_3.913208	151	208	1	25	57	0.4385965
NODE_100935_length_364_cov_3.913208	151	208	2	26	57	0.4561403
NODE_100935_length_364_cov_3.913208	151	208	4	6	57	0.1052632
NODE_100959_length_364_cov_3.305660	296	358	2	62	62	1.0000000
NODE_100966_length_364_cov_3.181132	78	138	0	60	60	1.0000000
NODE_100975_length_364_cov_3.041509	264	321	0	57	57	1.0000000
NODE_100975_length_364_cov_3.041509	294	359	0	65	65	1.0000000
NODE_100978_length_364_cov_3.015094	238	274	0	36	36	1.0000000
NODE_101087_length_364_cov_1.977358	126	201	0	75	75	1.0000000
NODE_101141_length_364_cov_1.811321	209	256	0	47	47	1.0000000
NODE_101148_length_364_cov_1.781132	130	203	0	5	73	0.0684932
NODE_101148_length_364_cov_1.781132	130	203	1	31	73	0.4246575
NODE_101148_length_364_cov_1.781132	130	203	2	37	73	0.5068493
NODE_101148_length_364_cov_1.781132	183	203	1	17	20	0.8500000
NODE_101148_length_364_cov_1.781132	183	203	2	3	20	0.1500000
NODE_101720_length_363_cov_7.791667	121	200	0	79	79	1.0000000
NODE_101725_length_363_cov_6.484848	33	90	0	57	57	1.0000000
NODE_101725_length_363_cov_6.484848	93	146	0	53	53	1.0000000
NODE_101734_length_363_cov_4.825758	154	215	2	30	61	0.4918033
NODE_101734_length_363_cov_4.825758	154	215	4	31	61	0.5081967
NODE_101760_length_363_cov_3.950758	112	183	2	71	71	1.0000000
NODE_101760_length_363_cov_3.950758	156	236	1	3	80	0.0375000
NODE_101760_length_363_cov_3.950758	156	236	2	77	80	0.9625000
NODE_101769_length_363_cov_3.617424	16	79	0	63	63	1.0000000
NODE_101774_length_363_cov_3.409091	241	267	0	26	26	1.0000000
NODE_101791_length_363_cov_3.087121	228	308	2	80	80	1.0000000
NODE_101809_length_363_cov_2.795455	240	320	2	14	80	0.1750000
NODE_101809_length_363_cov_2.795455	240	320	3	44	80	0.5500000
NODE_101809_length_363_cov_2.795455	240	320	5	16	80	0.2000000
NODE_101809_length_363_cov_2.795455	240	320	6	6	80	0.0750000
NODE_101822_length_363_cov_2.481061	86	166	0	80	80	1.0000000
NODE_101822_length_363_cov_2.481061	139	219	0	80	80	1.0000000
NODE_101879_length_363_cov_2.034091	46	126	0	80	80	1.0000000
NODE_101879_length_363_cov_2.034091	99	153	0	54	54	1.0000000
NODE_101992_length_363_cov_1.541667	235	315	0	4	80	0.0500000
NODE_101992_length_363_cov_1.541667	235	315	2	48	80	0.6000000
NODE_101992_length_363_cov_1.541667	235	315	3	14	80	0.1750000
NODE_101992_length_363_cov_1.541667	235	315	4	14	80	0.1750000
NODE_102022_length_363_cov_1.477273	141	202	2	3	61	0.0491803
NODE_102022_length_363_cov_1.477273	141	202	5	58	61	0.9508197
NODE_102022_length_363_cov_1.477273	153	210	5	57	57	1.0000000
NODE_102187_length_363_cov_1.113636	245	316	0	46	71	0.6478873
NODE_102187_length_363_cov_1.113636	245	316	1	25	71	0.3521127
NODE_102464_length_362_cov_54.927757	52	116	0	64	64	1.0000000
NODE_102465_length_362_cov_29.273764	86	166	0	80	80	1.0000000
NODE_102465_length_362_cov_29.273764	139	219	0	80	80	1.0000000
NODE_102467_length_362_cov_14.847909	130	210	4	70	80	0.8750000
NODE_102467_length_362_cov_14.847909	130	210	5	7	80	0.0875000
NODE_102467_length_362_cov_14.847909	130	210	6	3	80	0.0375000
NODE_102467_length_362_cov_14.847909	183	263	4	17	80	0.2125000
NODE_102467_length_362_cov_14.847909	183	263	5	60	80	0.7500000
NODE_102467_length_362_cov_14.847909	183	263	6	3	80	0.0375000
NODE_102633_length_362_cov_2.159696	133	216	0	83	83	1.0000000
NODE_103259_length_361_cov_4.641221	249	312	0	63	63	1.0000000
NODE_103280_length_361_cov_3.717557	185	265	1	16	80	0.2000000
NODE_103280_length_361_cov_3.717557	185	265	2	13	80	0.1625000
NODE_103280_length_361_cov_3.717557	185	265	3	51	80	0.6375000
NODE_103280_length_361_cov_3.717557	238	265	1	16	27	0.5925926
NODE_103280_length_361_cov_3.717557	238	265	3	11	27	0.4074074
NODE_103314_length_361_cov_2.988550	121	201	0	80	80	1.0000000
NODE_103314_length_361_cov_2.988550	174	216	0	42	42	1.0000000
NODE_103338_length_361_cov_2.641221	4	33	0	29	29	1.0000000
NODE_103338_length_361_cov_2.641221	101	182	0	81	81	1.0000000
NODE_103391_length_361_cov_2.137405	138	194	0	56	56	1.0000000
NODE_103396_length_361_cov_2.106870	192	256	0	64	64	1.0000000
NODE_103418_length_361_cov_1.969466	137	198	0	61	61	1.0000000
NODE_103632_length_361_cov_1.343511	171	250	0	10	79	0.1265823
NODE_103632_length_361_cov_1.343511	171	250	1	69	79	0.8734177
NODE_103802_length_361_cov_1.000000	60	123	0	63	63	1.0000000
NODE_104057_length_360_cov_8.191571	171	242	0	4	71	0.0563380
NODE_104057_length_360_cov_8.191571	171	242	2	67	71	0.9436620
NODE_104057_length_360_cov_8.191571	176	242	2	66	66	1.0000000
NODE_104057_length_360_cov_8.191571	215	279	2	64	64	1.0000000
NODE_104057_length_360_cov_8.191571	215	279	2	64	64	1.0000000
NODE_104079_length_360_cov_5.003831	86	166	0	80	80	1.0000000
NODE_104091_length_360_cov_4.111111	158	238	2	20	80	0.2500000
NODE_104091_length_360_cov_4.111111	158	238	4	60	80	0.7500000
NODE_104102_length_360_cov_3.613027	123	203	0	15	80	0.1875000
NODE_104102_length_360_cov_3.613027	123	203	2	65	80	0.8125000
NODE_104102_length_360_cov_3.613027	176	256	0	68	80	0.8500000
NODE_104102_length_360_cov_3.613027	176	256	2	12	80	0.1500000
NODE_104129_length_360_cov_3.080460	48	70	0	22	22	1.0000000
NODE_104162_length_360_cov_2.689655	118	198	1	1	80	0.0125000
NODE_104162_length_360_cov_2.689655	118	198	3	79	80	0.9875000
NODE_104261_length_360_cov_1.977011	235	286	0	12	51	0.2352941
NODE_104261_length_360_cov_1.977011	235	286	2	39	51	0.7647059
NODE_104572_length_360_cov_1.149425	273	353	0	67	80	0.8375000
NODE_104572_length_360_cov_1.149425	273	353	1	2	80	0.0250000
NODE_104572_length_360_cov_1.149425	273	353	2	11	80	0.1375000
NODE_104669_length_360_cov_0.965517	119	175	0	56	56	1.0000000
NODE_104671_length_360_cov_0.957854	140	186	0	46	46	1.0000000
NODE_104858_length_359_cov_45.519231	140	220	11	4	80	0.0500000
NODE_104858_length_359_cov_45.519231	140	220	12	15	80	0.1875000
NODE_104858_length_359_cov_45.519231	140	220	13	22	80	0.2750000
NODE_104858_length_359_cov_45.519231	140	220	14	20	80	0.2500000
NODE_104858_length_359_cov_45.519231	140	220	15	19	80	0.2375000
NODE_104858_length_359_cov_45.519231	193	273	10	8	80	0.1000000
NODE_104858_length_359_cov_45.519231	193	273	11	22	80	0.2750000
NODE_104858_length_359_cov_45.519231	193	273	12	4	80	0.0500000
NODE_104858_length_359_cov_45.519231	193	273	13	7	80	0.0875000
NODE_104858_length_359_cov_45.519231	193	273	14	17	80	0.2125000
NODE_104858_length_359_cov_45.519231	193	273	15	22	80	0.2750000
NODE_104932_length_359_cov_3.296154	67	147	0	24	80	0.3000000
NODE_104932_length_359_cov_3.296154	67	147	1	56	80	0.7000000
NODE_104932_length_359_cov_3.296154	120	177	1	49	57	0.8596491
NODE_104932_length_359_cov_3.296154	120	177	3	8	57	0.1403509
NODE_104932_length_359_cov_3.296154	201	256	3	16	55	0.2909091
NODE_104932_length_359_cov_3.296154	201	256	4	39	55	0.7090909
NODE_104936_length_359_cov_3.276923	5	95	0	90	90	1.0000000
NODE_104954_length_359_cov_3.007692	156	212	1	35	56	0.6250000
NODE_104954_length_359_cov_3.007692	156	212	2	21	56	0.3750000
NODE_104998_length_359_cov_2.523077	148	228	0	80	80	1.0000000
NODE_104998_length_359_cov_2.523077	201	278	0	77	77	1.0000000
NODE_105002_length_359_cov_2.419231	106	186	0	80	80	1.0000000
NODE_105002_length_359_cov_2.419231	159	211	0	50	52	0.9615384
NODE_105002_length_359_cov_2.419231	159	211	8	2	52	0.0384615
NODE_105006_length_359_cov_2.353846	172	243	2	71	71	1.0000000
NODE_105006_length_359_cov_2.353846	216	296	0	41	80	0.5125000
NODE_105006_length_359_cov_2.353846	216	296	2	39	80	0.4875000
NODE_105026_length_359_cov_2.257692	211	270	0	59	59	1.0000000
NODE_105063_length_359_cov_2.003846	8	88	0	80	80	1.0000000
NODE_105063_length_359_cov_2.003846	61	139	0	77	78	0.9871795
NODE_105063_length_359_cov_2.003846	61	139	1	1	78	0.0128205
NODE_105106_length_359_cov_1.815385	126	207	0	81	81	1.0000000
NODE_105106_length_359_cov_1.815385	180	227	0	47	47	1.0000000
NODE_105142_length_359_cov_1.692308	88	116	2	28	28	1.0000000
NODE_105373_length_359_cov_1.096154	64	89	1	25	25	1.0000000
NODE_105599_length_359_cov_0.711538	222	248	0	26	26	1.0000000
NODE_105600_length_359_cov_0.707692	10	90	0	80	80	1.0000000
NODE_105600_length_359_cov_0.707692	10	90	0	80	80	1.0000000
NODE_105600_length_359_cov_0.707692	63	143	0	80	80	1.0000000
NODE_105678_length_358_cov_19.760618	213	293	2	80	80	1.0000000
NODE_105678_length_358_cov_19.760618	266	346	1	43	80	0.5375000
NODE_105678_length_358_cov_19.760618	266	346	2	37	80	0.4625000
NODE_105679_length_358_cov_18.455598	303	358	0	55	55	1.0000000
NODE_105680_length_358_cov_17.023166	0	63	0	63	63	1.0000000
NODE_105680_length_358_cov_17.023166	0	63	0	63	63	1.0000000
NODE_105680_length_358_cov_17.023166	0	63	0	63	63	1.0000000
NODE_105680_length_358_cov_17.023166	36	116	0	80	80	1.0000000
NODE_105680_length_358_cov_17.023166	53	115	0	62	62	1.0000000
NODE_105686_length_358_cov_6.509653	109	155	0	46	46	1.0000000
NODE_105710_length_358_cov_4.239382	114	143	0	26	29	0.8965517
NODE_105710_length_358_cov_4.239382	114	143	2	3	29	0.1034483
NODE_105710_length_358_cov_4.239382	180	245	2	6	65	0.0923077
NODE_105710_length_358_cov_4.239382	180	245	3	47	65	0.7230769
NODE_105710_length_358_cov_4.239382	180	245	5	12	65	0.1846154
NODE_105710_length_358_cov_4.239382	218	298	3	24	80	0.3000000
NODE_105710_length_358_cov_4.239382	218	298	5	56	80	0.7000000
NODE_105846_length_358_cov_2.162162	229	305	0	76	76	1.0000000
NODE_105902_length_358_cov_1.926641	290	358	0	68	68	1.0000000
NODE_105910_length_358_cov_1.884170	250	317	0	67	67	1.0000000
NODE_105923_length_358_cov_1.841699	189	269	1	4	80	0.0500000
NODE_105923_length_358_cov_1.841699	189	269	2	43	80	0.5375000
NODE_105923_length_358_cov_1.841699	189	269	3	5	80	0.0625000
NODE_105923_length_358_cov_1.841699	189	269	4	28	80	0.3500000
NODE_106096_length_358_cov_1.235521	99	179	2	13	80	0.1625000
NODE_106096_length_358_cov_1.235521	99	179	4	67	80	0.8375000
NODE_106096_length_358_cov_1.235521	152	222	0	17	70	0.2428571
NODE_106096_length_358_cov_1.235521	152	222	1	10	70	0.1428571
NODE_106096_length_358_cov_1.235521	152	222	2	29	70	0.4142857
NODE_106096_length_358_cov_1.235521	152	222	4	14	70	0.2000000
NODE_106189_length_358_cov_1.096525	148	228	2	77	80	0.9625000
NODE_106189_length_358_cov_1.096525	148	228	4	3	80	0.0375000
NODE_106233_length_358_cov_0.984556	193	265	0	29	72	0.4027778
NODE_106233_length_358_cov_0.984556	193	265	2	43	72	0.5972222
NODE_106489_length_357_cov_381.833333	244	324	22	6	80	0.0750000
NODE_106489_length_357_cov_381.833333	244	324	24	6	80	0.0750000
NODE_106489_length_357_cov_381.833333	244	324	26	68	80	0.8500000
NODE_106493_length_357_cov_7.643411	45	125	0	4	80	0.0500000
NODE_106493_length_357_cov_7.643411	45	125	1	26	80	0.3250000
NODE_106493_length_357_cov_7.643411	45	125	2	50	80	0.6250000
NODE_106493_length_357_cov_7.643411	98	178	2	80	80	1.0000000
NODE_106495_length_357_cov_7.027132	157	237	6	61	80	0.7625000
NODE_106495_length_357_cov_7.027132	157	237	7	4	80	0.0500000
NODE_106495_length_357_cov_7.027132	157	237	8	7	80	0.0875000
NODE_106495_length_357_cov_7.027132	157	237	9	8	80	0.1000000
NODE_106495_length_357_cov_7.027132	210	252	5	3	42	0.0714286
NODE_106495_length_357_cov_7.027132	210	252	6	35	42	0.8333333
NODE_106495_length_357_cov_7.027132	210	252	7	4	42	0.0952381
NODE_106496_length_357_cov_6.732558	183	263	0	80	80	1.0000000
NODE_106529_length_357_cov_4.081395	145	225	0	41	80	0.5125000
NODE_106529_length_357_cov_4.081395	145	225	1	32	80	0.4000000
NODE_106529_length_357_cov_4.081395	145	225	2	7	80	0.0875000
NODE_106529_length_357_cov_4.081395	198	271	1	20	73	0.2739726
NODE_106529_length_357_cov_4.081395	198	271	2	53	73	0.7260274
NODE_106542_length_357_cov_3.724806	192	265	0	73	73	1.0000000
NODE_106558_length_357_cov_3.341085	205	285	0	46	80	0.5750000
NODE_106558_length_357_cov_3.341085	205	285	2	34	80	0.4250000
NODE_106558_length_357_cov_3.341085	258	338	0	24	80	0.3000000
NODE_106558_length_357_cov_3.341085	258	338	2	56	80	0.7000000
NODE_106625_length_357_cov_2.414729	245	302	0	57	57	1.0000000
NODE_106625_length_357_cov_2.414729	275	355	0	80	80	1.0000000
NODE_106661_length_357_cov_2.174419	250	330	0	80	80	1.0000000
NODE_106666_length_357_cov_2.166667	103	133	0	30	30	1.0000000
NODE_106666_length_357_cov_2.166667	112	133	0	21	21	1.0000000
NODE_106702_length_357_cov_1.961240	150	169	0	19	19	1.0000000
NODE_106708_length_357_cov_1.918605	173	253	0	46	80	0.5750000
NODE_106708_length_357_cov_1.918605	173	253	1	33	80	0.4125000
NODE_106708_length_357_cov_1.918605	173	253	2	1	80	0.0125000
NODE_106737_length_357_cov_1.782946	73	142	0	69	69	1.0000000
NODE_106737_length_357_cov_1.782946	115	195	0	80	80	1.0000000
NODE_107002_length_357_cov_1.127907	98	129	0	9	31	0.2903226
NODE_107002_length_357_cov_1.127907	98	129	2	22	31	0.7096774
NODE_107306_length_356_cov_5.299611	140	200	0	60	60	1.0000000
NODE_107347_length_356_cov_3.400778	255	317	0	62	62	1.0000000
NODE_107347_length_356_cov_3.400778	308	353	0	45	45	1.0000000
NODE_107402_length_356_cov_2.657588	256	298	6	42	42	1.0000000
NODE_107402_length_356_cov_2.657588	265	338	4	16	73	0.2191781
NODE_107402_length_356_cov_2.657588	265	338	6	57	73	0.7808219
NODE_107402_length_356_cov_2.657588	299	351	0	5	52	0.0961538
NODE_107402_length_356_cov_2.657588	299	351	4	24	52	0.4615385
NODE_107402_length_356_cov_2.657588	299	351	6	23	52	0.4423077
NODE_107452_length_356_cov_2.237354	90	135	3	21	45	0.4666667
NODE_107452_length_356_cov_2.237354	90	135	4	24	45	0.5333334
NODE_107475_length_356_cov_1.996109	127	194	0	67	67	1.0000000
NODE_107521_length_356_cov_1.813230	296	341	0	45	45	1.0000000
NODE_107606_length_356_cov_1.560311	192	272	0	50	80	0.6250000
NODE_107606_length_356_cov_1.560311	192	272	2	28	80	0.3500000
NODE_107606_length_356_cov_1.560311	192	272	6	2	80	0.0250000
NODE_107606_length_356_cov_1.560311	245	319	0	74	74	1.0000000
NODE_108122_length_355_cov_6.796875	127	173	0	46	46	1.0000000
NODE_108210_length_355_cov_2.734375	111	162	0	51	51	1.0000000
NODE_108210_length_355_cov_2.734375	142	222	0	80	80	1.0000000
NODE_108215_length_355_cov_2.707031	277	314	0	37	37	1.0000000
NODE_108215_length_355_cov_2.707031	287	353	0	66	66	1.0000000
NODE_108239_length_355_cov_2.500000	38	82	0	11	44	0.2500000
NODE_108239_length_355_cov_2.500000	38	82	1	33	44	0.7500000
NODE_108278_length_355_cov_2.207031	258	308	1	50	50	1.0000000
NODE_108284_length_355_cov_2.179688	153	233	0	1	80	0.0125000
NODE_108284_length_355_cov_2.179688	153	233	1	15	80	0.1875000
NODE_108284_length_355_cov_2.179688	153	233	2	64	80	0.8000000
NODE_108284_length_355_cov_2.179688	206	286	2	80	80	1.0000000
NODE_108291_length_355_cov_2.132812	261	334	0	73	73	1.0000000
NODE_108291_length_355_cov_2.132812	301	342	0	41	41	1.0000000
NODE_108315_length_355_cov_2.007812	281	347	0	66	66	1.0000000
NODE_108395_length_355_cov_1.765625	186	247	0	61	61	1.0000000
NODE_108395_length_355_cov_1.765625	220	300	0	80	80	1.0000000
NODE_109015_length_354_cov_6.843137	53	132	2	34	79	0.4303797
NODE_109015_length_354_cov_6.843137	53	132	4	45	79	0.5696203
NODE_109015_length_354_cov_6.843137	53	132	2	34	79	0.4303797
NODE_109015_length_354_cov_6.843137	53	132	4	45	79	0.5696203
NODE_109015_length_354_cov_6.843137	105	185	4	80	80	1.0000000
NODE_109015_length_354_cov_6.843137	105	185	4	80	80	1.0000000
NODE_109033_length_354_cov_4.823529	208	255	0	47	47	1.0000000
NODE_109054_length_354_cov_3.956863	145	208	0	63	63	1.0000000
NODE_109054_length_354_cov_3.956863	181	261	0	80	80	1.0000000
NODE_109057_length_354_cov_3.878431	198	244	1	46	46	1.0000000
NODE_109089_length_354_cov_3.207843	130	199	1	14	69	0.2028985
NODE_109089_length_354_cov_3.207843	130	199	2	55	69	0.7971014
NODE_109126_length_354_cov_2.725490	179	259	0	80	80	1.0000000
NODE_109126_length_354_cov_2.725490	235	312	0	77	77	1.0000000
NODE_109128_length_354_cov_2.713725	16	76	0	60	60	1.0000000
NODE_109128_length_354_cov_2.713725	90	149	0	59	59	1.0000000
NODE_109140_length_354_cov_2.580392	176	234	4	58	58	1.0000000
NODE_109140_length_354_cov_2.580392	207	251	4	44	44	1.0000000
NODE_109237_length_354_cov_1.996078	79	145	0	15	66	0.2272727
NODE_109237_length_354_cov_1.996078	79	145	1	51	66	0.7727273
NODE_109237_length_354_cov_1.996078	118	200	1	52	82	0.6341463
NODE_109237_length_354_cov_1.996078	118	200	2	30	82	0.3658537
NODE_109244_length_354_cov_1.988235	7	77	0	12	70	0.1714286
NODE_109244_length_354_cov_1.988235	7	77	1	58	70	0.8285714
NODE_109244_length_354_cov_1.988235	64	130	1	34	66	0.5151515
NODE_109244_length_354_cov_1.988235	64	130	2	32	66	0.4848485
NODE_109321_length_354_cov_1.682353	99	171	0	72	72	1.0000000
NODE_109321_length_354_cov_1.682353	144	224	0	80	80	1.0000000
NODE_109852_length_353_cov_11.169291	14	90	0	57	76	0.7500000
NODE_109852_length_353_cov_11.169291	14	90	2	19	76	0.2500000
NODE_109852_length_353_cov_11.169291	67	143	0	4	76	0.0526316
NODE_109852_length_353_cov_11.169291	67	143	2	72	76	0.9473684
NODE_109911_length_353_cov_3.874016	220	256	0	36	36	1.0000000
NODE_109911_length_353_cov_3.874016	265	334	0	69	69	1.0000000
NODE_109928_length_353_cov_3.488189	200	282	2	82	82	1.0000000
NODE_109976_length_353_cov_2.826772	8	88	0	33	80	0.4125000
NODE_109976_length_353_cov_2.826772	8	88	2	47	80	0.5875000
NODE_109976_length_353_cov_2.826772	61	120	2	59	59	1.0000000
NODE_110022_length_353_cov_2.417323	260	336	0	76	76	1.0000000
NODE_110610_length_353_cov_0.744094	299	318	0	19	19	1.0000000
NODE_110708_length_352_cov_34.691700	110	203	1	18	93	0.1935484
NODE_110708_length_352_cov_34.691700	110	203	2	1	93	0.0107527
NODE_110708_length_352_cov_34.691700	110	203	3	32	93	0.3440860
NODE_110708_length_352_cov_34.691700	110	203	4	9	93	0.0967742
NODE_110708_length_352_cov_34.691700	110	203	5	33	93	0.3548387
NODE_110710_length_352_cov_17.944664	20	100	0	80	80	1.0000000
NODE_110710_length_352_cov_17.944664	73	153	0	80	80	1.0000000
NODE_110710_length_352_cov_17.944664	273	352	0	79	79	1.0000000
NODE_110735_length_352_cov_4.707510	157	237	0	80	80	1.0000000
NODE_110749_length_352_cov_4.221344	144	205	0	61	61	1.0000000
NODE_110749_length_352_cov_4.221344	178	259	0	81	81	1.0000000
NODE_110754_length_352_cov_4.011858	98	143	0	45	45	1.0000000
NODE_110754_length_352_cov_4.011858	151	228	1	34	77	0.4415585
NODE_110754_length_352_cov_4.011858	151	228	2	43	77	0.5584416
NODE_110798_length_352_cov_2.849802	74	154	2	18	80	0.2250000
NODE_110798_length_352_cov_2.849802	74	154	4	62	80	0.7750000
NODE_110798_length_352_cov_2.849802	127	198	0	29	71	0.4084507
NODE_110798_length_352_cov_2.849802	127	198	2	11	71	0.1549296
NODE_110798_length_352_cov_2.849802	127	198	4	31	71	0.4366197
NODE_110820_length_352_cov_2.683794	0	77	0	77	77	1.0000000
NODE_110820_length_352_cov_2.683794	50	130	0	80	80	1.0000000
NODE_110832_length_352_cov_2.608696	90	136	0	46	46	1.0000000
NODE_110832_length_352_cov_2.608696	144	189	0	45	45	1.0000000
NODE_110838_length_352_cov_2.577075	111	191	3	18	80	0.2250000
NODE_110838_length_352_cov_2.577075	111	191	4	62	80	0.7750000
NODE_110876_length_352_cov_2.264822	171	251	0	80	80	1.0000000
NODE_110938_length_352_cov_2.007905	277	326	0	49	49	1.0000000
NODE_111439_length_352_cov_0.806324	165	238	9	3	73	0.0410959
NODE_111439_length_352_cov_0.806324	165	238	11	7	73	0.0958904
NODE_111439_length_352_cov_0.806324	165	238	13	17	73	0.2328767
NODE_111439_length_352_cov_0.806324	165	238	15	2	73	0.0273973
NODE_111439_length_352_cov_0.806324	165	238	16	30	73	0.4109589
NODE_111439_length_352_cov_0.806324	165	238	17	14	73	0.1917808
NODE_111593_length_351_cov_5.003968	115	195	0	80	80	1.0000000
NODE_111662_length_351_cov_2.900794	289	320	0	31	31	1.0000000
NODE_111738_length_351_cov_2.376984	79	159	8	33	80	0.4125000
NODE_111738_length_351_cov_2.376984	79	159	10	3	80	0.0375000
NODE_111738_length_351_cov_2.376984	79	159	12	11	80	0.1375000
NODE_111738_length_351_cov_2.376984	79	159	14	14	80	0.1750000
NODE_111738_length_351_cov_2.376984	79	159	16	8	80	0.1000000
NODE_111738_length_351_cov_2.376984	79	159	17	3	80	0.0375000
NODE_111738_length_351_cov_2.376984	79	159	19	8	80	0.1000000
NODE_111759_length_351_cov_2.226190	116	170	3	1	54	0.0185185
NODE_111759_length_351_cov_2.226190	116	170	4	53	54	0.9814815
NODE_111769_length_351_cov_2.186508	198	277	0	79	79	1.0000000
NODE_111861_length_351_cov_1.809524	276	309	0	33	33	1.0000000
NODE_111969_length_351_cov_1.515873	228	299	0	71	71	1.0000000
NODE_112493_length_350_cov_232.529880	25	92	14	2	67	0.0298507
NODE_112493_length_350_cov_232.529880	25	92	16	3	67	0.0447761
NODE_112493_length_350_cov_232.529880	25	92	17	4	67	0.0597015
NODE_112493_length_350_cov_232.529880	25	92	19	1	67	0.0149254
NODE_112493_length_350_cov_232.529880	25	92	21	5	67	0.0746269
NODE_112493_length_350_cov_232.529880	25	92	23	1	67	0.0149254
NODE_112493_length_350_cov_232.529880	25	92	24	2	67	0.0298507
NODE_112493_length_350_cov_232.529880	25	92	25	4	67	0.0597015
NODE_112493_length_350_cov_232.529880	25	92	26	6	67	0.0895522
NODE_112493_length_350_cov_232.529880	25	92	28	2	67	0.0298507
NODE_112493_length_350_cov_232.529880	25	92	29	2	67	0.0298507
NODE_112493_length_350_cov_232.529880	25	92	31	2	67	0.0298507
NODE_112493_length_350_cov_232.529880	25	92	32	5	67	0.0746269
NODE_112493_length_350_cov_232.529880	25	92	34	11	67	0.1641791
NODE_112493_length_350_cov_232.529880	25	92	35	17	67	0.2537313
NODE_112494_length_350_cov_40.677291	181	246	44	1	65	0.0153846
NODE_112494_length_350_cov_40.677291	181	246	45	27	65	0.4153846
NODE_112494_length_350_cov_40.677291	181	246	46	7	65	0.1076923
NODE_112494_length_350_cov_40.677291	181	246	47	14	65	0.2153846
NODE_112494_length_350_cov_40.677291	181	246	48	10	65	0.1538462
NODE_112494_length_350_cov_40.677291	181	246	49	6	65	0.0923077
NODE_112535_length_350_cov_4.179283	114	194	0	80	80	1.0000000
NODE_112535_length_350_cov_4.179283	167	244	0	77	77	1.0000000
NODE_112554_length_350_cov_3.573705	128	202	10	8	74	0.1081081
NODE_112554_length_350_cov_3.573705	128	202	11	29	74	0.3918919
NODE_112554_length_350_cov_3.573705	128	202	12	33	74	0.4459459
NODE_112554_length_350_cov_3.573705	128	202	14	4	74	0.0540541
NODE_112554_length_350_cov_3.573705	178	241	9	38	63	0.6031746
NODE_112554_length_350_cov_3.573705	178	241	10	1	63	0.0158730
NODE_112554_length_350_cov_3.573705	178	241	11	24	63	0.3809524
NODE_112627_length_350_cov_2.478088	266	297	0	31	31	1.0000000
NODE_112647_length_350_cov_2.346614	97	148	20	12	51	0.2352941
NODE_112647_length_350_cov_2.346614	97	148	21	5	51	0.0980392
NODE_112647_length_350_cov_2.346614	97	148	22	1	51	0.0196078
NODE_112647_length_350_cov_2.346614	97	148	24	11	51	0.2156863
NODE_112647_length_350_cov_2.346614	97	148	25	15	51	0.2941177
NODE_112647_length_350_cov_2.346614	97	148	26	1	51	0.0196078
NODE_112647_length_350_cov_2.346614	97	148	27	6	51	0.1176471
NODE_112714_length_350_cov_2.031873	181	238	5	57	57	1.0000000
NODE_112997_length_350_cov_1.223108	202	275	0	73	73	1.0000000
NODE_113450_length_349_cov_4.268000	83	163	0	80	80	1.0000000
NODE_113450_length_349_cov_4.268000	83	163	0	80	80	1.0000000
NODE_113450_length_349_cov_4.268000	136	216	0	80	80	1.0000000
NODE_113450_length_349_cov_4.268000	145	180	0	35	35	1.0000000
NODE_113473_length_349_cov_3.648000	219	300	1	3	81	0.0370370
NODE_113473_length_349_cov_3.648000	219	300	5	3	81	0.0370370
NODE_113473_length_349_cov_3.648000	219	300	7	30	81	0.3703704
NODE_113473_length_349_cov_3.648000	219	300	9	10	81	0.1234568
NODE_113473_length_349_cov_3.648000	219	300	10	35	81	0.4320988
NODE_113480_length_349_cov_3.484000	196	276	0	23	80	0.2875000
NODE_113480_length_349_cov_3.484000	196	276	1	25	80	0.3125000
NODE_113480_length_349_cov_3.484000	196	276	2	2	80	0.0250000
NODE_113480_length_349_cov_3.484000	196	276	4	10	80	0.1250000
NODE_113480_length_349_cov_3.484000	196	276	5	20	80	0.2500000
NODE_113486_length_349_cov_3.364000	219	284	0	18	65	0.2769231
NODE_113486_length_349_cov_3.364000	219	284	1	47	65	0.7230769
NODE_113511_length_349_cov_2.916000	94	189	0	95	95	1.0000000
NODE_113571_length_349_cov_2.420000	35	54	0	19	19	1.0000000
NODE_113647_length_349_cov_1.964000	32	63	0	31	31	1.0000000
NODE_113654_length_349_cov_1.928000	9	77	0	16	68	0.2352941
NODE_113654_length_349_cov_1.928000	9	77	1	52	68	0.7647059
NODE_113654_length_349_cov_1.928000	62	115	1	53	53	1.0000000
NODE_113710_length_349_cov_1.684000	225	265	2	40	40	1.0000000
NODE_113825_length_349_cov_1.392000	32	95	0	63	63	1.0000000
NODE_113961_length_349_cov_1.056000	316	339	1	23	23	1.0000000
NODE_114002_length_349_cov_1.020000	177	257	0	80	80	1.0000000
NODE_114263_length_348_cov_34.867470	156	236	2	80	80	1.0000000
NODE_114263_length_348_cov_34.867470	209	289	0	43	80	0.5375000
NODE_114263_length_348_cov_34.867470	209	289	2	37	80	0.4625000
NODE_114296_length_348_cov_4.180723	106	186	0	80	80	1.0000000
NODE_114296_length_348_cov_4.180723	159	239	0	80	80	1.0000000
NODE_114330_length_348_cov_3.277108	83	137	0	54	54	1.0000000
NODE_114330_length_348_cov_3.277108	145	197	0	52	52	1.0000000
NODE_114424_length_348_cov_2.305221	204	273	0	69	69	1.0000000
NODE_114448_length_348_cov_2.216867	103	152	0	49	49	1.0000000
NODE_114505_length_348_cov_1.995984	170	239	2	69	69	1.0000000
NODE_114591_length_348_cov_1.638554	309	346	0	37	37	1.0000000
NODE_114643_length_348_cov_1.485944	9	60	2	8	51	0.1568628
NODE_114643_length_348_cov_1.485944	9	60	4	43	51	0.8431373
NODE_115147_length_347_cov_15.100806	57	137	0	80	80	1.0000000
NODE_115147_length_347_cov_15.100806	110	152	0	42	42	1.0000000
NODE_115147_length_347_cov_15.100806	182	209	0	27	27	1.0000000
NODE_115147_length_347_cov_15.100806	290	317	0	27	27	1.0000000
NODE_115161_length_347_cov_5.967742	110	173	0	63	63	1.0000000
NODE_115195_length_347_cov_4.028226	260	329	0	69	69	1.0000000
NODE_115321_length_347_cov_2.463710	99	141	1	2	42	0.0476190
NODE_115321_length_347_cov_2.463710	99	141	2	40	42	0.9523810
NODE_115321_length_347_cov_2.463710	108	143	2	35	35	1.0000000
NODE_115331_length_347_cov_2.391129	35	70	0	35	35	1.0000000
NODE_115331_length_347_cov_2.391129	37	79	0	42	42	1.0000000
NODE_115331_length_347_cov_2.391129	77	105	0	28	28	1.0000000
NODE_115397_length_347_cov_2.048387	15	34	0	19	19	1.0000000
NODE_115417_length_347_cov_1.967742	205	268	0	63	63	1.0000000
NODE_115450_length_347_cov_1.818548	109	156	0	47	47	1.0000000
NODE_115771_length_347_cov_1.028226	230	255	2	25	25	1.0000000
NODE_116114_length_346_cov_74.433198	10	90	0	32	80	0.4000000
NODE_116114_length_346_cov_74.433198	10	90	1	22	80	0.2750000
NODE_116114_length_346_cov_74.433198	10	90	3	26	80	0.3250000
NODE_116114_length_346_cov_74.433198	19	90	0	23	71	0.3239437
NODE_116114_length_346_cov_74.433198	19	90	1	22	71	0.3098592
NODE_116114_length_346_cov_74.433198	19	90	3	26	71	0.3661972
NODE_116114_length_346_cov_74.433198	192	272	3	55	80	0.6875000
NODE_116114_length_346_cov_74.433198	192	272	5	25	80	0.3125000
NODE_116115_length_346_cov_67.834008	133	213	3	48	80	0.6000000
NODE_116115_length_346_cov_67.834008	133	213	4	30	80	0.3750000
NODE_116115_length_346_cov_67.834008	133	213	5	2	80	0.0250000
NODE_116115_length_346_cov_67.834008	186	266	4	80	80	1.0000000
NODE_116117_length_346_cov_10.299595	190	270	4	80	80	1.0000000
NODE_116117_length_346_cov_10.299595	243	323	0	45	80	0.5625000
NODE_116117_length_346_cov_10.299595	243	323	1	1	80	0.0125000
NODE_116117_length_346_cov_10.299595	243	323	2	6	80	0.0750000
NODE_116117_length_346_cov_10.299595	243	323	4	28	80	0.3500000
NODE_116119_length_346_cov_9.566802	159	239	1	25	80	0.3125000
NODE_116119_length_346_cov_9.566802	159	239	2	33	80	0.4125000
NODE_116119_length_346_cov_9.566802	159	239	3	22	80	0.2750000
NODE_116119_length_346_cov_9.566802	212	292	2	80	80	1.0000000
NODE_116134_length_346_cov_5.506073	157	238	1	13	81	0.1604938
NODE_116134_length_346_cov_5.506073	157	238	2	68	81	0.8395061
NODE_116155_length_346_cov_4.368421	205	264	0	59	59	1.0000000
NODE_116159_length_346_cov_4.032389	121	141	0	20	20	1.0000000
NODE_116184_length_346_cov_3.400810	194	253	0	59	59	1.0000000
NODE_116212_length_346_cov_3.008097	183	263	0	80	80	1.0000000
NODE_116257_length_346_cov_2.538462	47	102	0	55	55	1.0000000
NODE_116257_length_346_cov_2.538462	118	173	0	55	55	1.0000000
NODE_116439_length_346_cov_1.700405	71	107	0	36	36	1.0000000
NODE_117035_length_345_cov_47.699187	0	66	0	35	66	0.5303030
NODE_117035_length_345_cov_47.699187	0	66	1	31	66	0.4696970
NODE_117035_length_345_cov_47.699187	39	119	1	29	80	0.3625000
NODE_117035_length_345_cov_47.699187	39	119	4	21	80	0.2625000
NODE_117035_length_345_cov_47.699187	39	119	5	30	80	0.3750000
NODE_117035_length_345_cov_47.699187	115	182	5	13	67	0.1940299
NODE_117035_length_345_cov_47.699187	115	182	7	14	67	0.2089552
NODE_117035_length_345_cov_47.699187	115	182	8	26	67	0.3880597
NODE_117035_length_345_cov_47.699187	115	182	10	10	67	0.1492537
NODE_117035_length_345_cov_47.699187	115	182	11	1	67	0.0149254
NODE_117035_length_345_cov_47.699187	115	182	13	3	67	0.0447761
NODE_117035_length_345_cov_47.699187	246	311	7	20	65	0.3076923
NODE_117035_length_345_cov_47.699187	246	311	8	13	65	0.2000000
NODE_117035_length_345_cov_47.699187	246	311	10	32	65	0.4923077
NODE_117036_length_345_cov_13.439024	28	108	0	80	80	1.0000000
NODE_117036_length_345_cov_13.439024	81	161	0	80	80	1.0000000
NODE_117037_length_345_cov_9.906504	224	283	4	16	59	0.2711864
NODE_117037_length_345_cov_9.906504	224	283	6	43	59	0.7288136
NODE_117051_length_345_cov_5.475610	52	132	0	23	80	0.2875000
NODE_117051_length_345_cov_5.475610	52	132	1	54	80	0.6750000
NODE_117051_length_345_cov_5.475610	52	132	2	3	80	0.0375000
NODE_117051_length_345_cov_5.475610	105	185	1	24	80	0.3000000
NODE_117051_length_345_cov_5.475610	105	185	2	56	80	0.7000000
NODE_117055_length_345_cov_5.321138	104	152	0	48	48	1.0000000
NODE_117065_length_345_cov_4.524390	205	269	0	64	64	1.0000000
NODE_117075_length_345_cov_4.109756	95	157	0	62	62	1.0000000
NODE_117075_length_345_cov_4.109756	162	204	0	42	42	1.0000000
NODE_117076_length_345_cov_4.073171	251	326	0	75	75	1.0000000
NODE_117084_length_345_cov_3.776423	199	273	0	74	74	1.0000000
NODE_117084_length_345_cov_3.776423	246	326	0	80	80	1.0000000
NODE_117148_length_345_cov_2.821138	61	141	0	80	80	1.0000000
NODE_117205_length_345_cov_2.333333	47	90	0	14	43	0.3255814
NODE_117205_length_345_cov_2.333333	47	90	2	29	43	0.6744186
NODE_117205_length_345_cov_2.333333	63	147	0	8	84	0.0952381
NODE_117205_length_345_cov_2.333333	63	147	2	76	84	0.9047619
NODE_117219_length_345_cov_2.239837	0	81	0	18	81	0.2222222
NODE_117219_length_345_cov_2.239837	0	81	2	63	81	0.7777778
NODE_117669_length_345_cov_1.040650	6	73	0	8	67	0.1194030
NODE_117669_length_345_cov_1.040650	6	73	2	49	67	0.7313433
NODE_117669_length_345_cov_1.040650	6	73	4	10	67	0.1492537
NODE_117989_length_344_cov_54.020408	6	55	0	49	49	1.0000000
NODE_117989_length_344_cov_54.020408	28	105	0	77	77	1.0000000
NODE_117989_length_344_cov_54.020408	28	105	0	77	77	1.0000000
NODE_117989_length_344_cov_54.020408	112	178	0	66	66	1.0000000
NODE_118009_length_344_cov_5.016327	72	125	5	8	53	0.1509434
NODE_118009_length_344_cov_5.016327	72	125	6	17	53	0.3207547
NODE_118009_length_344_cov_5.016327	72	125	7	28	53	0.5283019
NODE_118009_length_344_cov_5.016327	136	203	2	12	67	0.1791045
NODE_118009_length_344_cov_5.016327	136	203	6	11	67	0.1641791
NODE_118009_length_344_cov_5.016327	136	203	7	44	67	0.6567164
NODE_118017_length_344_cov_4.579592	172	254	0	82	82	1.0000000
NODE_118045_length_344_cov_3.840816	197	240	1	43	43	1.0000000
NODE_118074_length_344_cov_3.293878	149	189	1	1	40	0.0250000
NODE_118074_length_344_cov_3.293878	149	189	2	39	40	0.9750000
NODE_118074_length_344_cov_3.293878	162	229	2	67	67	1.0000000
NODE_118111_length_344_cov_2.751020	24	87	0	63	63	1.0000000
NODE_118179_length_344_cov_2.126531	274	305	0	31	31	1.0000000
NODE_118243_length_344_cov_1.914286	114	194	0	80	80	1.0000000
NODE_118243_length_344_cov_1.914286	167	247	0	80	80	1.0000000
NODE_118297_length_344_cov_1.685714	180	220	0	40	40	1.0000000
NODE_118393_length_344_cov_1.457143	160	240	0	17	80	0.2125000
NODE_118393_length_344_cov_1.457143	160	240	2	63	80	0.7875000
NODE_118393_length_344_cov_1.457143	213	273	0	50	60	0.8333333
NODE_118393_length_344_cov_1.457143	213	273	2	10	60	0.1666667
NODE_118743_length_344_cov_0.800000	123	163	2	40	40	1.0000000
NODE_118899_length_343_cov_3.770492	2	60	0	58	58	1.0000000
NODE_118905_length_343_cov_3.598361	97	170	0	73	73	1.0000000
NODE_118905_length_343_cov_3.598361	150	223	0	73	73	1.0000000
NODE_118911_length_343_cov_3.401639	48	128	4	2	80	0.0250000
NODE_118911_length_343_cov_3.401639	48	128	5	9	80	0.1125000
NODE_118911_length_343_cov_3.401639	48	128	6	22	80	0.2750000
NODE_118911_length_343_cov_3.401639	48	128	7	8	80	0.1000000
NODE_118911_length_343_cov_3.401639	48	128	8	5	80	0.0625000
NODE_118911_length_343_cov_3.401639	48	128	9	23	80	0.2875000
NODE_118911_length_343_cov_3.401639	48	128	10	11	80	0.1375000
NODE_118941_length_343_cov_3.049180	12	62	0	50	50	1.0000000
NODE_118941_length_343_cov_3.049180	82	111	0	4	29	0.1379310
NODE_118941_length_343_cov_3.049180	82	111	1	25	29	0.8620690
NODE_118941_length_343_cov_3.049180	133	205	1	31	72	0.4305556
NODE_118941_length_343_cov_3.049180	133	205	3	41	72	0.5694444
NODE_118957_length_343_cov_2.770492	236	316	3	6	80	0.0750000
NODE_118957_length_343_cov_2.770492	236	316	4	7	80	0.0875000
NODE_118957_length_343_cov_2.770492	236	316	6	1	80	0.0125000
NODE_118957_length_343_cov_2.770492	236	316	7	14	80	0.1750000
NODE_118957_length_343_cov_2.770492	236	316	11	1	80	0.0125000
NODE_118957_length_343_cov_2.770492	236	316	13	5	80	0.0625000
NODE_118957_length_343_cov_2.770492	236	316	16	5	80	0.0625000
NODE_118957_length_343_cov_2.770492	236	316	17	15	80	0.1875000
NODE_118957_length_343_cov_2.770492	236	316	18	4	80	0.0500000
NODE_118957_length_343_cov_2.770492	236	316	19	3	80	0.0375000
NODE_118957_length_343_cov_2.770492	236	316	21	19	80	0.2375000
NODE_118978_length_343_cov_2.590164	167	225	0	58	58	1.0000000
NODE_118998_length_343_cov_2.430328	208	274	3	66	66	1.0000000
NODE_119040_length_343_cov_2.209016	32	111	0	79	79	1.0000000
NODE_119067_length_343_cov_2.081967	95	177	0	82	82	1.0000000
NODE_119067_length_343_cov_2.081967	150	199	0	41	49	0.8367347
NODE_119067_length_343_cov_2.081967	150	199	2	8	49	0.1632653
NODE_119202_length_343_cov_1.635246	0	52	0	52	52	1.0000000
NODE_119439_length_343_cov_1.143443	60	120	0	60	60	1.0000000
NODE_119834_length_342_cov_3.872428	136	216	4	80	80	1.0000000
NODE_119834_length_342_cov_3.872428	189	259	2	31	70	0.4428571
NODE_119834_length_342_cov_3.872428	189	259	3	1	70	0.0142857
NODE_119834_length_342_cov_3.872428	189	259	4	38	70	0.5428572
NODE_119840_length_342_cov_3.769547	146	212	0	66	66	1.0000000
NODE_119841_length_342_cov_3.740741	113	146	0	33	33	1.0000000
NODE_119846_length_342_cov_3.674897	20	100	0	80	80	1.0000000
NODE_119846_length_342_cov_3.674897	73	153	0	80	80	1.0000000
NODE_119847_length_342_cov_3.588477	117	197	1	80	80	1.0000000
NODE_119849_length_342_cov_3.530864	72	151	0	79	79	1.0000000
NODE_119852_length_342_cov_3.423868	172	252	0	80	80	1.0000000
NODE_119852_length_342_cov_3.423868	225	283	0	58	58	1.0000000
NODE_119922_length_342_cov_2.432099	16	81	0	65	65	1.0000000
NODE_119993_length_342_cov_2.049383	249	317	0	68	68	1.0000000
NODE_120047_length_342_cov_1.864198	138	190	0	52	52	1.0000000
NODE_120047_length_342_cov_1.864198	183	243	0	60	60	1.0000000
NODE_120073_length_342_cov_1.720165	91	147	0	56	56	1.0000000
NODE_120284_length_342_cov_1.271605	201	240	0	39	39	1.0000000
NODE_120755_length_341_cov_15.896694	50	130	3	17	80	0.2125000
NODE_120755_length_341_cov_15.896694	50	130	5	22	80	0.2750000
NODE_120755_length_341_cov_15.896694	50	130	6	35	80	0.4375000
NODE_120755_length_341_cov_15.896694	50	130	8	6	80	0.0750000
NODE_120755_length_341_cov_15.896694	103	183	6	74	80	0.9250000
NODE_120755_length_341_cov_15.896694	103	183	8	6	80	0.0750000
NODE_120757_length_341_cov_9.756198	117	196	0	79	79	1.0000000
NODE_120770_length_341_cov_5.404959	141	220	0	27	79	0.3417721
NODE_120770_length_341_cov_5.404959	141	220	1	35	79	0.4430380
NODE_120770_length_341_cov_5.404959	141	220	3	17	79	0.2151899
NODE_120780_length_341_cov_4.669421	301	320	0	19	19	1.0000000
NODE_120783_length_341_cov_4.438017	57	132	0	75	75	1.0000000
NODE_120783_length_341_cov_4.438017	110	185	0	75	75	1.0000000
NODE_120785_length_341_cov_4.400826	164	244	0	80	80	1.0000000
NODE_120785_length_341_cov_4.400826	224	297	0	73	73	1.0000000
NODE_120797_length_341_cov_3.896694	58	122	0	10	64	0.1562500
NODE_120797_length_341_cov_3.896694	58	122	1	16	64	0.2500000
NODE_120797_length_341_cov_3.896694	58	122	2	11	64	0.1718750
NODE_120797_length_341_cov_3.896694	58	122	4	5	64	0.0781250
NODE_120797_length_341_cov_3.896694	58	122	5	5	64	0.0781250
NODE_120797_length_341_cov_3.896694	58	122	6	6	64	0.0937500
NODE_120797_length_341_cov_3.896694	58	122	7	5	64	0.0781250
NODE_120797_length_341_cov_3.896694	58	122	8	2	64	0.0312500
NODE_120797_length_341_cov_3.896694	58	122	9	3	64	0.0468750
NODE_120797_length_341_cov_3.896694	58	122	10	1	64	0.0156250
NODE_120805_length_341_cov_3.727273	191	273	0	61	82	0.7439024
NODE_120805_length_341_cov_3.727273	191	273	1	13	82	0.1585366
NODE_120805_length_341_cov_3.727273	191	273	2	8	82	0.0975610
NODE_120805_length_341_cov_3.727273	253	326	0	73	73	1.0000000
NODE_120839_length_341_cov_3.000000	91	161	0	70	70	1.0000000
NODE_120839_length_341_cov_3.000000	146	215	0	69	69	1.0000000
NODE_120840_length_341_cov_3.000000	127	207	0	24	80	0.3000000
NODE_120840_length_341_cov_3.000000	127	207	2	8	80	0.1000000
NODE_120840_length_341_cov_3.000000	127	207	4	48	80	0.6000000
NODE_120892_length_341_cov_2.533058	92	172	1	1	80	0.0125000
NODE_120892_length_341_cov_2.533058	92	172	2	79	80	0.9875000
NODE_120901_length_341_cov_2.495868	8	89	0	11	81	0.1358025
NODE_120901_length_341_cov_2.495868	8	89	2	62	81	0.7654321
NODE_120901_length_341_cov_2.495868	8	89	3	8	81	0.0987654
NODE_120946_length_341_cov_2.235537	10	90	0	1	80	0.0125000
NODE_120946_length_341_cov_2.235537	10	90	2	79	80	0.9875000
NODE_120972_length_341_cov_2.103306	46	125	0	79	79	1.0000000
NODE_120994_length_341_cov_2.066116	147	184	3	37	37	1.0000000
NODE_121052_length_341_cov_1.772727	179	250	0	71	71	1.0000000
NODE_121064_length_341_cov_1.727273	105	185	0	80	80	1.0000000
NODE_121160_length_341_cov_1.475207	120	185	2	65	65	1.0000000
NODE_121160_length_341_cov_1.475207	158	238	0	2	80	0.0250000
NODE_121160_length_341_cov_1.475207	158	238	2	78	80	0.9750000
NODE_121173_length_341_cov_1.471074	186	266	7	15	80	0.1875000
NODE_121173_length_341_cov_1.471074	186	266	8	27	80	0.3375000
NODE_121173_length_341_cov_1.471074	186	266	9	19	80	0.2375000
NODE_121173_length_341_cov_1.471074	186	266	10	15	80	0.1875000
NODE_121173_length_341_cov_1.471074	186	266	11	4	80	0.0500000
NODE_121173_length_341_cov_1.471074	239	319	5	3	80	0.0375000
NODE_121173_length_341_cov_1.471074	239	319	7	34	80	0.4250000
NODE_121173_length_341_cov_1.471074	239	319	8	22	80	0.2750000
NODE_121173_length_341_cov_1.471074	239	319	9	18	80	0.2250000
NODE_121173_length_341_cov_1.471074	239	319	10	3	80	0.0375000
NODE_121211_length_341_cov_1.342975	284	322	0	38	38	1.0000000
NODE_121431_length_341_cov_0.991736	36	89	0	53	53	1.0000000
NODE_121693_length_340_cov_541.348548	86	144	125	2	58	0.0344828
NODE_121693_length_340_cov_541.348548	86	144	127	1	58	0.0172414
NODE_121693_length_340_cov_541.348548	86	144	128	2	58	0.0344828
NODE_121693_length_340_cov_541.348548	86	144	129	1	58	0.0172414
NODE_121693_length_340_cov_541.348548	86	144	130	1	58	0.0172414
NODE_121693_length_340_cov_541.348548	86	144	131	1	58	0.0172414
NODE_121693_length_340_cov_541.348548	86	144	132	1	58	0.0172414
NODE_121693_length_340_cov_541.348548	86	144	138	1	58	0.0172414
NODE_121693_length_340_cov_541.348548	86	144	141	3	58	0.0517241
NODE_121693_length_340_cov_541.348548	86	144	144	2	58	0.0344828
NODE_121693_length_340_cov_541.348548	86	144	148	1	58	0.0172414
NODE_121693_length_340_cov_541.348548	86	144	149	1	58	0.0172414
NODE_121693_length_340_cov_541.348548	86	144	150	2	58	0.0344828
NODE_121693_length_340_cov_541.348548	86	144	152	1	58	0.0172414
NODE_121693_length_340_cov_541.348548	86	144	154	2	58	0.0344828
NODE_121693_length_340_cov_541.348548	86	144	155	1	58	0.0172414
NODE_121693_length_340_cov_541.348548	86	144	158	1	58	0.0172414
NODE_121693_length_340_cov_541.348548	86	144	159	1	58	0.0172414
NODE_121693_length_340_cov_541.348548	86	144	160	3	58	0.0517241
NODE_121693_length_340_cov_541.348548	86	144	162	4	58	0.0689655
NODE_121693_length_340_cov_541.348548	86	144	164	2	58	0.0344828
NODE_121693_length_340_cov_541.348548	86	144	165	3	58	0.0517241
NODE_121693_length_340_cov_541.348548	86	144	166	2	58	0.0344828
NODE_121693_length_340_cov_541.348548	86	144	168	1	58	0.0172414
NODE_121693_length_340_cov_541.348548	86	144	169	1	58	0.0172414
NODE_121693_length_340_cov_541.348548	86	144	173	1	58	0.0172414
NODE_121693_length_340_cov_541.348548	86	144	174	1	58	0.0172414
NODE_121693_length_340_cov_541.348548	86	144	182	2	58	0.0344828
NODE_121693_length_340_cov_541.348548	86	144	184	1	58	0.0172414
NODE_121693_length_340_cov_541.348548	86	144	185	2	58	0.0344828
NODE_121693_length_340_cov_541.348548	86	144	186	2	58	0.0344828
NODE_121693_length_340_cov_541.348548	86	144	189	1	58	0.0172414
NODE_121693_length_340_cov_541.348548	86	144	191	1	58	0.0172414
NODE_121693_length_340_cov_541.348548	86	144	195	2	58	0.0344828
NODE_121693_length_340_cov_541.348548	86	144	197	2	58	0.0344828
NODE_121693_length_340_cov_541.348548	86	144	198	1	58	0.0172414
NODE_121693_length_340_cov_541.348548	86	144	201	1	58	0.0172414
NODE_121693_length_340_cov_541.348548	86	154	125	2	68	0.0294118
NODE_121693_length_340_cov_541.348548	86	154	127	1	68	0.0147059
NODE_121693_length_340_cov_541.348548	86	154	128	2	68	0.0294118
NODE_121693_length_340_cov_541.348548	86	154	129	1	68	0.0147059
NODE_121693_length_340_cov_541.348548	86	154	130	1	68	0.0147059
NODE_121693_length_340_cov_541.348548	86	154	131	1	68	0.0147059
NODE_121693_length_340_cov_541.348548	86	154	132	1	68	0.0147059
NODE_121693_length_340_cov_541.348548	86	154	138	1	68	0.0147059
NODE_121693_length_340_cov_541.348548	86	154	141	3	68	0.0441176
NODE_121693_length_340_cov_541.348548	86	154	144	2	68	0.0294118
NODE_121693_length_340_cov_541.348548	86	154	148	1	68	0.0147059
NODE_121693_length_340_cov_541.348548	86	154	149	1	68	0.0147059
NODE_121693_length_340_cov_541.348548	86	154	150	2	68	0.0294118
NODE_121693_length_340_cov_541.348548	86	154	152	1	68	0.0147059
NODE_121693_length_340_cov_541.348548	86	154	154	2	68	0.0294118
NODE_121693_length_340_cov_541.348548	86	154	155	1	68	0.0147059
NODE_121693_length_340_cov_541.348548	86	154	158	1	68	0.0147059
NODE_121693_length_340_cov_541.348548	86	154	159	1	68	0.0147059
NODE_121693_length_340_cov_541.348548	86	154	160	3	68	0.0441176
NODE_121693_length_340_cov_541.348548	86	154	162	4	68	0.0588235
NODE_121693_length_340_cov_541.348548	86	154	164	2	68	0.0294118
NODE_121693_length_340_cov_541.348548	86	154	165	3	68	0.0441176
NODE_121693_length_340_cov_541.348548	86	154	166	2	68	0.0294118
NODE_121693_length_340_cov_541.348548	86	154	168	1	68	0.0147059
NODE_121693_length_340_cov_541.348548	86	154	169	1	68	0.0147059
NODE_121693_length_340_cov_541.348548	86	154	173	1	68	0.0147059
NODE_121693_length_340_cov_541.348548	86	154	174	1	68	0.0147059
NODE_121693_length_340_cov_541.348548	86	154	182	2	68	0.0294118
NODE_121693_length_340_cov_541.348548	86	154	184	1	68	0.0147059
NODE_121693_length_340_cov_541.348548	86	154	185	2	68	0.0294118
NODE_121693_length_340_cov_541.348548	86	154	186	2	68	0.0294118
NODE_121693_length_340_cov_541.348548	86	154	189	1	68	0.0147059
NODE_121693_length_340_cov_541.348548	86	154	191	1	68	0.0147059
NODE_121693_length_340_cov_541.348548	86	154	194	2	68	0.0294118
NODE_121693_length_340_cov_541.348548	86	154	195	3	68	0.0441176
NODE_121693_length_340_cov_541.348548	86	154	196	2	68	0.0294118
NODE_121693_length_340_cov_541.348548	86	154	197	4	68	0.0588235
NODE_121693_length_340_cov_541.348548	86	154	198	1	68	0.0147059
NODE_121693_length_340_cov_541.348548	86	154	200	2	68	0.0294118
NODE_121693_length_340_cov_541.348548	86	154	201	1	68	0.0147059
NODE_121693_length_340_cov_541.348548	86	154	202	1	68	0.0147059
NODE_121693_length_340_cov_541.348548	86	107	125	2	21	0.0952381
NODE_121693_length_340_cov_541.348548	86	107	127	1	21	0.0476190
NODE_121693_length_340_cov_541.348548	86	107	128	2	21	0.0952381
NODE_121693_length_340_cov_541.348548	86	107	129	1	21	0.0476190
NODE_121693_length_340_cov_541.348548	86	107	130	1	21	0.0476190
NODE_121693_length_340_cov_541.348548	86	107	131	1	21	0.0476190
NODE_121693_length_340_cov_541.348548	86	107	132	1	21	0.0476190
NODE_121693_length_340_cov_541.348548	86	107	138	1	21	0.0476190
NODE_121693_length_340_cov_541.348548	86	107	141	3	21	0.1428571
NODE_121693_length_340_cov_541.348548	86	107	144	2	21	0.0952381
NODE_121693_length_340_cov_541.348548	86	107	148	1	21	0.0476190
NODE_121693_length_340_cov_541.348548	86	107	149	1	21	0.0476190
NODE_121693_length_340_cov_541.348548	86	107	150	2	21	0.0952381
NODE_121693_length_340_cov_541.348548	86	107	152	1	21	0.0476190
NODE_121693_length_340_cov_541.348548	86	107	154	1	21	0.0476190
NODE_121694_length_340_cov_50.755187	196	266	12	4	70	0.0571429
NODE_121694_length_340_cov_50.755187	196	266	14	37	70	0.5285714
NODE_121694_length_340_cov_50.755187	196	266	15	14	70	0.2000000
NODE_121694_length_340_cov_50.755187	196	266	16	15	70	0.2142857
NODE_121696_length_340_cov_8.917012	240	270	0	30	30	1.0000000
NODE_121696_length_340_cov_8.917012	243	315	0	72	72	1.0000000
NODE_121702_length_340_cov_6.439834	175	255	0	80	80	1.0000000
NODE_121702_length_340_cov_6.439834	228	310	0	82	82	1.0000000
NODE_121708_length_340_cov_5.883817	72	121	0	49	49	1.0000000
NODE_121708_length_340_cov_5.883817	82	113	0	31	31	1.0000000
NODE_121714_length_340_cov_5.228216	116	186	0	70	70	1.0000000
NODE_121714_length_340_cov_5.228216	159	201	0	42	42	1.0000000
NODE_121730_length_340_cov_4.497925	136	184	0	48	48	1.0000000
NODE_121752_length_340_cov_3.759336	88	169	0	81	81	1.0000000
NODE_121849_length_340_cov_2.506224	68	114	0	46	46	1.0000000
NODE_121951_length_340_cov_1.995851	29	101	0	28	72	0.3888889
NODE_121951_length_340_cov_1.995851	29	101	2	44	72	0.6111111
NODE_121951_length_340_cov_1.995851	96	143	0	2	47	0.0425532
NODE_121951_length_340_cov_1.995851	96	143	2	45	47	0.9574468
NODE_122154_length_340_cov_1.427386	244	274	0	1	30	0.0333333
NODE_122154_length_340_cov_1.427386	244	274	2	29	30	0.9666666
NODE_122218_length_340_cov_1.282158	71	135	0	64	64	1.0000000
NODE_122218_length_340_cov_1.282158	128	188	0	60	60	1.0000000
NODE_122218_length_340_cov_1.282158	142	189	0	47	47	1.0000000
NODE_122220_length_340_cov_1.278008	51	102	0	24	51	0.4705882
NODE_122220_length_340_cov_1.278008	51	102	2	27	51	0.5294118
NODE_122321_length_340_cov_1.199170	98	160	0	62	62	1.0000000
NODE_122381_length_340_cov_1.070539	32	65	0	33	33	1.0000000
NODE_122429_length_340_cov_1.020747	209	228	0	6	19	0.3157895
NODE_122429_length_340_cov_1.020747	209	228	2	13	19	0.6842105
NODE_122686_length_339_cov_87.841667	149	227	34	2	78	0.0256410
NODE_122686_length_339_cov_87.841667	149	227	36	2	78	0.0256410
NODE_122686_length_339_cov_87.841667	149	227	37	4	78	0.0512821
NODE_122686_length_339_cov_87.841667	149	227	38	17	78	0.2179487
NODE_122686_length_339_cov_87.841667	149	227	39	8	78	0.1025641
NODE_122686_length_339_cov_87.841667	149	227	40	15	78	0.1923077
NODE_122686_length_339_cov_87.841667	149	227	41	11	78	0.1410256
NODE_122686_length_339_cov_87.841667	149	227	42	6	78	0.0769231
NODE_122686_length_339_cov_87.841667	149	227	43	2	78	0.0256410
NODE_122686_length_339_cov_87.841667	149	227	44	2	78	0.0256410
NODE_122686_length_339_cov_87.841667	149	227	45	4	78	0.0512821
NODE_122686_length_339_cov_87.841667	149	227	46	5	78	0.0641026
NODE_122687_length_339_cov_14.304167	69	138	1	10	69	0.1449275
NODE_122687_length_339_cov_14.304167	69	138	2	36	69	0.5217391
NODE_122687_length_339_cov_14.304167	69	138	3	23	69	0.3333333
NODE_122687_length_339_cov_14.304167	69	138	1	10	69	0.1449275
NODE_122687_length_339_cov_14.304167	69	138	2	36	69	0.5217391
NODE_122687_length_339_cov_14.304167	69	138	3	23	69	0.3333333
NODE_122687_length_339_cov_14.304167	69	138	1	10	69	0.1449275
NODE_122687_length_339_cov_14.304167	69	138	2	36	69	0.5217391
NODE_122687_length_339_cov_14.304167	69	138	3	23	69	0.3333333
NODE_122687_length_339_cov_14.304167	88	138	1	10	50	0.2000000
NODE_122687_length_339_cov_14.304167	88	138	2	17	50	0.3400000
NODE_122687_length_339_cov_14.304167	88	138	3	23	50	0.4600000
NODE_122687_length_339_cov_14.304167	111	160	1	32	49	0.6530612
NODE_122687_length_339_cov_14.304167	111	160	3	17	49	0.3469388
NODE_122727_length_339_cov_4.320833	187	267	0	80	80	1.0000000
NODE_122804_length_339_cov_2.754167	45	125	0	80	80	1.0000000
NODE_122971_length_339_cov_1.841667	265	312	0	47	47	1.0000000
NODE_123041_length_339_cov_1.662500	10	57	0	2	47	0.0425532
NODE_123041_length_339_cov_1.662500	10	57	1	45	47	0.9574468
NODE_123182_length_339_cov_1.275000	247	312	0	65	65	1.0000000
NODE_123285_length_339_cov_1.070833	147	169	3	22	22	1.0000000
NODE_123633_length_338_cov_57.163180	59	120	0	47	61	0.7704918
NODE_123633_length_338_cov_57.163180	59	120	2	14	61	0.2295082
NODE_123633_length_338_cov_57.163180	102	176	0	10	74	0.1351351
NODE_123633_length_338_cov_57.163180	102	176	2	64	74	0.8648649
NODE_123674_length_338_cov_4.263598	113	165	2	52	52	1.0000000
NODE_123679_length_338_cov_4.079498	96	151	0	55	55	1.0000000
NODE_123689_length_338_cov_3.841004	122	149	2	27	27	1.0000000
NODE_123793_length_338_cov_2.393305	216	288	0	72	72	1.0000000
NODE_123795_length_338_cov_2.380753	29	93	0	64	64	1.0000000
NODE_123919_length_338_cov_1.878661	146	232	8	33	86	0.3837209
NODE_123919_length_338_cov_1.878661	146	232	9	2	86	0.0232558
NODE_123919_length_338_cov_1.878661	146	232	10	8	86	0.0930233
NODE_123919_length_338_cov_1.878661	146	232	11	32	86	0.3720930
NODE_123919_length_338_cov_1.878661	146	232	12	8	86	0.0930233
NODE_123919_length_338_cov_1.878661	146	232	13	3	86	0.0348837
NODE_123944_length_338_cov_1.740586	79	159	0	80	80	1.0000000
NODE_123946_length_338_cov_1.732218	216	257	0	41	41	1.0000000
NODE_124046_length_338_cov_1.493724	14	90	0	76	76	1.0000000
NODE_124247_length_338_cov_1.100418	265	333	0	68	68	1.0000000
NODE_124456_length_338_cov_0.849372	281	338	0	57	57	1.0000000
NODE_124533_length_338_cov_0.711297	188	263	0	17	75	0.2266667
NODE_124533_length_338_cov_0.711297	188	263	2	58	75	0.7733333
NODE_124625_length_337_cov_468.180672	107	187	12	36	80	0.4500000
NODE_124625_length_337_cov_468.180672	107	187	13	9	80	0.1125000
NODE_124625_length_337_cov_468.180672	107	187	14	9	80	0.1125000
NODE_124625_length_337_cov_468.180672	107	187	15	20	80	0.2500000
NODE_124625_length_337_cov_468.180672	107	187	16	5	80	0.0625000
NODE_124625_length_337_cov_468.180672	107	187	17	1	80	0.0125000
NODE_124625_length_337_cov_468.180672	160	230	12	16	70	0.2285714
NODE_124625_length_337_cov_468.180672	160	230	13	10	70	0.1428571
NODE_124625_length_337_cov_468.180672	160	230	14	15	70	0.2142857
NODE_124625_length_337_cov_468.180672	160	230	15	5	70	0.0714286
NODE_124625_length_337_cov_468.180672	160	230	16	9	70	0.1285714
NODE_124625_length_337_cov_468.180672	160	230	18	15	70	0.2142857
NODE_124625_length_337_cov_468.180672	226	306	12	14	80	0.1750000
NODE_124625_length_337_cov_468.180672	226	306	13	13	80	0.1625000
NODE_124625_length_337_cov_468.180672	226	306	17	2	80	0.0250000
NODE_124625_length_337_cov_468.180672	226	306	18	8	80	0.1000000
NODE_124625_length_337_cov_468.180672	226	306	20	43	80	0.5375000
NODE_124625_length_337_cov_468.180672	279	337	5	6	58	0.1034483
NODE_124625_length_337_cov_468.180672	279	337	6	1	58	0.0172414
NODE_124625_length_337_cov_468.180672	279	337	8	4	58	0.0689655
NODE_124625_length_337_cov_468.180672	279	337	10	14	58	0.2413793
NODE_124625_length_337_cov_468.180672	279	337	12	20	58	0.3448276
NODE_124625_length_337_cov_468.180672	279	337	13	13	58	0.2241379
NODE_124626_length_337_cov_91.344538	1	50	0	20	49	0.4081633
NODE_124626_length_337_cov_91.344538	1	50	1	11	49	0.2244898
NODE_124626_length_337_cov_91.344538	1	50	3	2	49	0.0408163
NODE_124626_length_337_cov_91.344538	1	50	5	6	49	0.1224490
NODE_124626_length_337_cov_91.344538	1	50	9	8	49	0.1632653
NODE_124626_length_337_cov_91.344538	1	50	10	2	49	0.0408163
NODE_124626_length_337_cov_91.344538	23	103	1	9	80	0.1125000
NODE_124626_length_337_cov_91.344538	23	103	3	2	80	0.0250000
NODE_124626_length_337_cov_91.344538	23	103	5	6	80	0.0750000
NODE_124626_length_337_cov_91.344538	23	103	9	8	80	0.1000000
NODE_124626_length_337_cov_91.344538	23	103	10	3	80	0.0375000
NODE_124626_length_337_cov_91.344538	23	103	12	4	80	0.0500000
NODE_124626_length_337_cov_91.344538	23	103	14	3	80	0.0375000
NODE_124626_length_337_cov_91.344538	23	103	15	2	80	0.0250000
NODE_124626_length_337_cov_91.344538	23	103	16	5	80	0.0625000
NODE_124626_length_337_cov_91.344538	23	103	17	20	80	0.2500000
NODE_124626_length_337_cov_91.344538	23	103	18	10	80	0.1250000
NODE_124626_length_337_cov_91.344538	23	103	19	1	80	0.0125000
NODE_124626_length_337_cov_91.344538	23	103	20	3	80	0.0375000
NODE_124626_length_337_cov_91.344538	23	103	22	4	80	0.0500000
NODE_124627_length_337_cov_73.352941	71	151	1	35	80	0.4375000
NODE_124627_length_337_cov_73.352941	71	151	2	45	80	0.5625000
NODE_124627_length_337_cov_73.352941	124	204	1	21	80	0.2625000
NODE_124627_length_337_cov_73.352941	124	204	2	59	80	0.7375000
NODE_124629_length_337_cov_46.978992	220	305	3	6	85	0.0705882
NODE_124629_length_337_cov_46.978992	220	305	5	1	85	0.0117647
NODE_124629_length_337_cov_46.978992	220	305	7	78	85	0.9176471
NODE_124629_length_337_cov_46.978992	220	305	3	6	85	0.0705882
NODE_124629_length_337_cov_46.978992	220	305	5	1	85	0.0117647
NODE_124629_length_337_cov_46.978992	220	305	7	78	85	0.9176471
NODE_124629_length_337_cov_46.978992	220	305	3	6	85	0.0705882
NODE_124629_length_337_cov_46.978992	220	305	5	1	85	0.0117647
NODE_124629_length_337_cov_46.978992	220	305	7	78	85	0.9176471
NODE_124629_length_337_cov_46.978992	278	327	5	13	49	0.2653061
NODE_124629_length_337_cov_46.978992	278	327	7	36	49	0.7346939
NODE_124629_length_337_cov_46.978992	278	337	5	23	59	0.3898305
NODE_124629_length_337_cov_46.978992	278	337	7	36	59	0.6101695
NODE_124629_length_337_cov_46.978992	283	337	5	23	54	0.4259259
NODE_124629_length_337_cov_46.978992	283	337	7	31	54	0.5740741
NODE_124640_length_337_cov_6.214286	52	95	0	43	43	1.0000000
NODE_124669_length_337_cov_4.298319	5	58	0	53	53	1.0000000
NODE_124703_length_337_cov_3.478992	179	259	8	9	80	0.1125000
NODE_124703_length_337_cov_3.478992	179	259	9	6	80	0.0750000
NODE_124703_length_337_cov_3.478992	179	259	10	20	80	0.2500000
NODE_124703_length_337_cov_3.478992	179	259	12	9	80	0.1125000
NODE_124703_length_337_cov_3.478992	179	259	13	4	80	0.0500000
NODE_124703_length_337_cov_3.478992	179	259	14	32	80	0.4000000
NODE_124703_length_337_cov_3.478992	232	307	4	1	75	0.0133333
NODE_124703_length_337_cov_3.478992	232	307	6	2	75	0.0266667
NODE_124703_length_337_cov_3.478992	232	307	7	31	75	0.4133333
NODE_124703_length_337_cov_3.478992	232	307	8	14	75	0.1866667
NODE_124703_length_337_cov_3.478992	232	307	10	1	75	0.0133333
NODE_124703_length_337_cov_3.478992	232	307	12	8	75	0.1066667
NODE_124703_length_337_cov_3.478992	232	307	14	18	75	0.2400000
NODE_124759_length_337_cov_2.647059	80	146	0	66	66	1.0000000
NODE_124858_length_337_cov_2.121849	23	103	2	15	80	0.1875000
NODE_124858_length_337_cov_2.121849	23	103	4	65	80	0.8125000
NODE_124858_length_337_cov_2.121849	76	141	4	64	65	0.9846154
NODE_124858_length_337_cov_2.121849	76	141	5	1	65	0.0153846
NODE_125001_length_337_cov_1.689076	138	218	0	80	80	1.0000000
NODE_125024_length_337_cov_1.592437	109	151	0	42	42	1.0000000
NODE_125024_length_337_cov_1.592437	126	204	0	78	78	1.0000000
NODE_125074_length_337_cov_1.466387	266	332	0	66	66	1.0000000
NODE_125271_length_337_cov_1.071429	279	319	0	40	40	1.0000000
NODE_125332_length_337_cov_0.978992	227	272	0	45	45	1.0000000
NODE_125633_length_336_cov_7.843882	151	231	0	52	80	0.6500000
NODE_125633_length_336_cov_7.843882	151	231	1	28	80	0.3500000
NODE_125645_length_336_cov_5.578059	159	220	0	61	61	1.0000000
NODE_125645_length_336_cov_5.578059	212	273	0	61	61	1.0000000
NODE_125663_length_336_cov_4.481013	129	207	0	78	78	1.0000000
NODE_125752_length_336_cov_2.755274	83	112	2	29	29	1.0000000
NODE_125752_length_336_cov_2.755274	187	268	0	35	81	0.4320988
NODE_125752_length_336_cov_2.755274	187	268	2	46	81	0.5679013
NODE_125806_length_336_cov_2.358650	60	133	1	55	73	0.7534246
NODE_125806_length_336_cov_2.358650	60	133	3	18	73	0.2465753
NODE_125811_length_336_cov_2.337553	93	173	0	80	80	1.0000000
NODE_125965_length_336_cov_1.729958	78	141	0	63	63	1.0000000
NODE_125965_length_336_cov_1.729958	131	194	0	63	63	1.0000000
NODE_126134_length_336_cov_1.333333	34	114	0	80	80	1.0000000
NODE_126134_length_336_cov_1.333333	87	124	0	37	37	1.0000000
NODE_126134_length_336_cov_1.333333	182	213	0	31	31	1.0000000
NODE_126216_length_336_cov_1.244726	222	276	0	54	54	1.0000000
NODE_126216_length_336_cov_1.244726	288	312	0	24	24	1.0000000
NODE_126260_length_336_cov_1.143460	129	154	0	25	25	1.0000000
NODE_126545_length_336_cov_0.670886	259	288	0	29	29	1.0000000
NODE_126606_length_335_cov_16.114407	162	242	0	80	80	1.0000000
NODE_126606_length_335_cov_16.114407	215	295	0	80	80	1.0000000
NODE_126609_length_335_cov_9.258475	177	250	3	25	73	0.3424658
NODE_126609_length_335_cov_9.258475	177	250	4	48	73	0.6575342
NODE_126614_length_335_cov_7.207627	29	109	3	40	80	0.5000000
NODE_126614_length_335_cov_7.207627	29	109	5	40	80	0.5000000
NODE_126614_length_335_cov_7.207627	82	162	0	1	80	0.0125000
NODE_126614_length_335_cov_7.207627	82	162	2	13	80	0.1625000
NODE_126614_length_335_cov_7.207627	82	162	3	28	80	0.3500000
NODE_126614_length_335_cov_7.207627	82	162	5	38	80	0.4750000
NODE_126636_length_335_cov_5.046610	182	263	0	81	81	1.0000000
NODE_126639_length_335_cov_4.995763	144	215	0	71	71	1.0000000
NODE_126665_length_335_cov_3.923729	163	231	0	68	68	1.0000000
NODE_126787_length_335_cov_2.411017	230	294	0	64	64	1.0000000
NODE_126791_length_335_cov_2.402542	164	240	1	28	76	0.3684210
NODE_126791_length_335_cov_2.402542	164	240	2	29	76	0.3815790
NODE_126791_length_335_cov_2.402542	164	240	3	16	76	0.2105263
NODE_126791_length_335_cov_2.402542	164	240	5	3	76	0.0394737
NODE_126792_length_335_cov_2.398305	116	179	0	63	63	1.0000000
NODE_126826_length_335_cov_2.161017	82	141	1	35	59	0.5932204
NODE_126826_length_335_cov_2.161017	82	141	2	24	59	0.4067796
NODE_126835_length_335_cov_2.152542	61	134	0	54	73	0.7397260
NODE_126835_length_335_cov_2.152542	61	134	2	19	73	0.2602740
NODE_126835_length_335_cov_2.152542	114	134	0	1	20	0.0500000
NODE_126835_length_335_cov_2.152542	114	134	2	19	20	0.9500000
NODE_126920_length_335_cov_1.766949	257	330	2	25	73	0.3424658
NODE_126920_length_335_cov_1.766949	257	330	4	48	73	0.6575342
NODE_126920_length_335_cov_1.766949	297	335	0	1	38	0.0263158
NODE_126920_length_335_cov_1.766949	297	335	2	29	38	0.7631579
NODE_126920_length_335_cov_1.766949	297	335	4	8	38	0.2105263
NODE_127022_length_335_cov_1.529661	255	320	0	65	65	1.0000000
NODE_127023_length_335_cov_1.525424	222	266	1	44	44	1.0000000
NODE_127062_length_335_cov_1.457627	38	87	0	49	49	1.0000000
NODE_127130_length_335_cov_1.296610	291	311	0	20	20	1.0000000
NODE_127130_length_335_cov_1.296610	291	311	0	20	20	1.0000000
NODE_127143_length_335_cov_1.292373	202	232	1	26	30	0.8666667
NODE_127143_length_335_cov_1.292373	202	232	2	4	30	0.1333333
NODE_127200_length_335_cov_1.194915	75	156	3	3	81	0.0370370
NODE_127200_length_335_cov_1.194915	75	156	5	78	81	0.9629630
NODE_127200_length_335_cov_1.194915	129	195	2	3	66	0.0454545
NODE_127200_length_335_cov_1.194915	129	195	3	26	66	0.3939394
NODE_127200_length_335_cov_1.194915	129	195	5	37	66	0.5606061
NODE_127310_length_335_cov_0.983051	96	117	0	21	21	1.0000000
NODE_127585_length_334_cov_275.425532	135	215	28	4	80	0.0500000
NODE_127585_length_334_cov_275.425532	135	215	29	2	80	0.0250000
NODE_127585_length_334_cov_275.425532	135	215	30	13	80	0.1625000
NODE_127585_length_334_cov_275.425532	135	215	31	5	80	0.0625000
NODE_127585_length_334_cov_275.425532	135	215	32	5	80	0.0625000
NODE_127585_length_334_cov_275.425532	135	215	33	1	80	0.0125000
NODE_127585_length_334_cov_275.425532	135	215	34	13	80	0.1625000
NODE_127585_length_334_cov_275.425532	135	215	35	4	80	0.0500000
NODE_127585_length_334_cov_275.425532	135	215	36	18	80	0.2250000
NODE_127585_length_334_cov_275.425532	135	215	37	13	80	0.1625000
NODE_127585_length_334_cov_275.425532	135	215	38	2	80	0.0250000
NODE_127585_length_334_cov_275.425532	188	269	20	2	81	0.0246914
NODE_127585_length_334_cov_275.425532	188	269	21	26	81	0.3209876
NODE_127585_length_334_cov_275.425532	188	269	22	1	81	0.0123457
NODE_127585_length_334_cov_275.425532	188	269	24	15	81	0.1851852
NODE_127585_length_334_cov_275.425532	188	269	25	3	81	0.0370370
NODE_127585_length_334_cov_275.425532	188	269	27	2	81	0.0246914
NODE_127585_length_334_cov_275.425532	188	269	28	1	81	0.0123457
NODE_127585_length_334_cov_275.425532	188	269	30	11	81	0.1358025
NODE_127585_length_334_cov_275.425532	188	269	31	4	81	0.0493827
NODE_127585_length_334_cov_275.425532	188	269	32	5	81	0.0617284
NODE_127585_length_334_cov_275.425532	188	269	34	9	81	0.1111111
NODE_127585_length_334_cov_275.425532	188	269	35	2	81	0.0246914
NODE_127586_length_334_cov_14.753191	135	215	2	1	80	0.0125000
NODE_127586_length_334_cov_14.753191	135	215	3	18	80	0.2250000
NODE_127586_length_334_cov_14.753191	135	215	4	61	80	0.7625000
NODE_127586_length_334_cov_14.753191	188	268	2	30	80	0.3750000
NODE_127586_length_334_cov_14.753191	188	268	3	2	80	0.0250000
NODE_127586_length_334_cov_14.753191	188	268	4	48	80	0.6000000
NODE_127610_length_334_cov_4.829787	92	174	1	54	82	0.6585366
NODE_127610_length_334_cov_4.829787	92	174	2	28	82	0.3414634
NODE_127610_length_334_cov_4.829787	151	237	1	10	86	0.1162791
NODE_127610_length_334_cov_4.829787	151	237	2	35	86	0.4069767
NODE_127610_length_334_cov_4.829787	151	237	3	41	86	0.4767442
NODE_127612_length_334_cov_4.817021	179	231	0	52	52	1.0000000
NODE_127626_length_334_cov_4.438298	121	201	0	5	80	0.0625000
NODE_127626_length_334_cov_4.438298	121	201	1	75	80	0.9375000
NODE_127672_length_334_cov_3.604255	248	314	0	66	66	1.0000000
NODE_127672_length_334_cov_3.604255	287	334	0	47	47	1.0000000
NODE_127844_length_334_cov_2.165957	0	48	0	48	48	1.0000000
NODE_128026_length_334_cov_1.595745	253	328	0	75	75	1.0000000
NODE_128258_length_334_cov_1.157447	146	177	0	25	31	0.8064516
NODE_128258_length_334_cov_1.157447	146	177	2	6	31	0.1935484
NODE_128665_length_333_cov_5.423077	172	242	0	70	70	1.0000000
NODE_128673_length_333_cov_4.867521	122	172	0	50	50	1.0000000
NODE_128673_length_333_cov_4.867521	175	255	0	80	80	1.0000000
NODE_128673_length_333_cov_4.867521	194	219	0	25	25	1.0000000
NODE_128717_length_333_cov_3.717949	49	129	0	28	80	0.3500000
NODE_128717_length_333_cov_3.717949	49	129	2	52	80	0.6500000
NODE_128717_length_333_cov_3.717949	102	182	2	80	80	1.0000000
NODE_128767_length_333_cov_2.897436	59	139	1	6	80	0.0750000
NODE_128767_length_333_cov_2.897436	59	139	2	24	80	0.3000000
NODE_128767_length_333_cov_2.897436	59	139	4	11	80	0.1375000
NODE_128767_length_333_cov_2.897436	59	139	5	39	80	0.4875000
NODE_128850_length_333_cov_2.307692	68	148	0	19	80	0.2375000
NODE_128850_length_333_cov_2.307692	68	148	1	61	80	0.7625000
NODE_128933_length_333_cov_1.940171	135	215	0	80	80	1.0000000
NODE_129252_length_333_cov_1.200855	0	80	0	80	80	1.0000000
NODE_129263_length_333_cov_1.170940	146	193	0	10	47	0.2127660
NODE_129263_length_333_cov_1.170940	146	193	2	37	47	0.7872341
NODE_129263_length_333_cov_1.170940	203	243	0	16	40	0.4000000
NODE_129263_length_333_cov_1.170940	203	243	2	24	40	0.6000000
NODE_129303_length_333_cov_1.089744	241	306	0	65	65	1.0000000
NODE_129310_length_333_cov_1.089744	206	226	0	20	20	1.0000000
NODE_129665_length_332_cov_5.386266	101	167	0	66	66	1.0000000
NODE_129680_length_332_cov_4.768240	221	250	0	29	29	1.0000000
NODE_129695_length_332_cov_4.343348	130	179	0	49	49	1.0000000
NODE_129698_length_332_cov_4.201717	191	237	0	46	46	1.0000000
NODE_129698_length_332_cov_4.201717	211	290	0	79	79	1.0000000
NODE_129879_length_332_cov_2.274678	187	227	0	12	40	0.3000000
NODE_129879_length_332_cov_2.274678	187	227	2	10	40	0.2500000
NODE_129879_length_332_cov_2.274678	187	227	4	2	40	0.0500000
NODE_129879_length_332_cov_2.274678	187	227	6	10	40	0.2500000
NODE_129879_length_332_cov_2.274678	187	227	8	1	40	0.0250000
NODE_129879_length_332_cov_2.274678	187	227	10	5	40	0.1250000
NODE_129901_length_332_cov_2.184549	194	258	2	64	64	1.0000000
NODE_130053_length_332_cov_1.682403	241	316	0	75	75	1.0000000
NODE_130055_length_332_cov_1.673820	157	220	0	63	63	1.0000000
NODE_130183_length_332_cov_1.364807	132	212	0	80	80	1.0000000
NODE_130187_length_332_cov_1.356223	276	332	0	1	56	0.0178571
NODE_130187_length_332_cov_1.356223	276	332	1	15	56	0.2678571
NODE_130187_length_332_cov_1.356223	276	332	2	40	56	0.7142857
NODE_130312_length_332_cov_1.210300	120	176	2	56	56	1.0000000
NODE_130757_length_331_cov_5.254310	141	221	2	2	80	0.0250000
NODE_130757_length_331_cov_5.254310	141	221	4	12	80	0.1500000
NODE_130757_length_331_cov_5.254310	141	221	6	3	80	0.0375000
NODE_130757_length_331_cov_5.254310	141	221	8	63	80	0.7875000
NODE_130757_length_331_cov_5.254310	194	274	5	13	80	0.1625000
NODE_130757_length_331_cov_5.254310	194	274	6	10	80	0.1250000
NODE_130757_length_331_cov_5.254310	194	274	8	57	80	0.7125000
NODE_130781_length_331_cov_4.323276	26	108	0	9	82	0.1097561
NODE_130781_length_331_cov_4.323276	26	108	1	7	82	0.0853659
NODE_130781_length_331_cov_4.323276	26	108	3	6	82	0.0731707
NODE_130781_length_331_cov_4.323276	26	108	4	3	82	0.0365854
NODE_130781_length_331_cov_4.323276	26	108	5	36	82	0.4390244
NODE_130781_length_331_cov_4.323276	26	108	7	8	82	0.0975610
NODE_130781_length_331_cov_4.323276	26	108	9	11	82	0.1341463
NODE_130781_length_331_cov_4.323276	26	108	10	2	82	0.0243902
NODE_130902_length_331_cov_2.603448	128	181	0	53	53	1.0000000
NODE_131036_length_331_cov_1.965517	183	216	0	33	33	1.0000000
NODE_131054_length_331_cov_1.896552	266	331	0	65	65	1.0000000
NODE_131817_length_330_cov_14.731602	209	280	2	71	71	1.0000000
NODE_131840_length_330_cov_4.935065	16	97	0	28	81	0.3456790
NODE_131840_length_330_cov_4.935065	16	97	2	53	81	0.6543210
NODE_131840_length_330_cov_4.935065	81	149	0	25	68	0.3676471
NODE_131840_length_330_cov_4.935065	81	149	2	43	68	0.6323529
NODE_131841_length_330_cov_4.891775	177	255	0	78	78	1.0000000
NODE_131845_length_330_cov_4.740260	134	209	0	23	75	0.3066667
NODE_131845_length_330_cov_4.740260	134	209	1	52	75	0.6933333
NODE_131892_length_330_cov_3.467532	161	225	2	64	64	1.0000000
NODE_131969_length_330_cov_2.601732	8	88	0	80	80	1.0000000
NODE_132188_length_330_cov_1.623377	154	200	0	46	46	1.0000000
NODE_132238_length_330_cov_1.541126	98	156	2	51	58	0.8793104
NODE_132238_length_330_cov_1.541126	98	156	3	7	58	0.1206897
NODE_132268_length_330_cov_1.467532	234	287	0	1	53	0.0188679
NODE_132268_length_330_cov_1.467532	234	287	1	51	53	0.9622642
NODE_132268_length_330_cov_1.467532	234	287	2	1	53	0.0188679
NODE_132268_length_330_cov_1.467532	242	283	1	41	41	1.0000000
NODE_132306_length_330_cov_1.346320	230	296	0	66	66	1.0000000
NODE_132306_length_330_cov_1.346320	230	257	0	27	27	1.0000000
NODE_132410_length_330_cov_1.220779	249	272	0	23	23	1.0000000
NODE_132478_length_330_cov_1.103896	189	227	0	38	38	1.0000000
NODE_132542_length_330_cov_1.038961	219	297	8	4	78	0.0512821
NODE_132542_length_330_cov_1.038961	219	297	9	4	78	0.0512821
NODE_132542_length_330_cov_1.038961	219	297	10	4	78	0.0512821
NODE_132542_length_330_cov_1.038961	219	297	11	13	78	0.1666667
NODE_132542_length_330_cov_1.038961	219	297	13	14	78	0.1794872
NODE_132542_length_330_cov_1.038961	219	297	16	5	78	0.0641026
NODE_132542_length_330_cov_1.038961	219	297	17	9	78	0.1153846
NODE_132542_length_330_cov_1.038961	219	297	18	5	78	0.0641026
NODE_132542_length_330_cov_1.038961	219	297	19	1	78	0.0128205
NODE_132542_length_330_cov_1.038961	219	297	20	13	78	0.1666667
NODE_132542_length_330_cov_1.038961	219	297	21	6	78	0.0769231
NODE_132688_length_330_cov_0.883117	284	330	0	46	46	1.0000000
NODE_132873_length_329_cov_110.178261	138	167	11	4	29	0.1379310
NODE_132873_length_329_cov_110.178261	138	167	12	6	29	0.2068966
NODE_132873_length_329_cov_110.178261	138	167	13	12	29	0.4137931
NODE_132873_length_329_cov_110.178261	138	167	14	7	29	0.2413793
NODE_132873_length_329_cov_110.178261	189	269	15	3	80	0.0375000
NODE_132873_length_329_cov_110.178261	189	269	16	11	80	0.1375000
NODE_132873_length_329_cov_110.178261	189	269	17	3	80	0.0375000
NODE_132873_length_329_cov_110.178261	189	269	18	11	80	0.1375000
NODE_132873_length_329_cov_110.178261	189	269	19	14	80	0.1750000
NODE_132873_length_329_cov_110.178261	189	269	20	2	80	0.0250000
NODE_132873_length_329_cov_110.178261	189	269	21	36	80	0.4500000
NODE_132873_length_329_cov_110.178261	242	322	2	4	80	0.0500000
NODE_132873_length_329_cov_110.178261	242	322	4	19	80	0.2375000
NODE_132873_length_329_cov_110.178261	242	322	6	1	80	0.0125000
NODE_132873_length_329_cov_110.178261	242	322	7	12	80	0.1500000
NODE_132873_length_329_cov_110.178261	242	322	8	12	80	0.1500000
NODE_132873_length_329_cov_110.178261	242	322	10	1	80	0.0125000
NODE_132873_length_329_cov_110.178261	242	322	11	1	80	0.0125000
NODE_132873_length_329_cov_110.178261	242	322	13	1	80	0.0125000
NODE_132873_length_329_cov_110.178261	242	322	14	1	80	0.0125000
NODE_132873_length_329_cov_110.178261	242	322	15	4	80	0.0500000
NODE_132873_length_329_cov_110.178261	242	322	16	11	80	0.1375000
NODE_132873_length_329_cov_110.178261	242	322	18	9	80	0.1125000
NODE_132873_length_329_cov_110.178261	242	322	19	4	80	0.0500000
NODE_132879_length_329_cov_8.882609	61	141	0	80	80	1.0000000
NODE_132879_length_329_cov_8.882609	114	194	0	36	80	0.4500000
NODE_132879_length_329_cov_8.882609	114	194	2	44	80	0.5500000
NODE_132885_length_329_cov_6.586957	166	207	0	41	41	1.0000000
NODE_132908_length_329_cov_4.617391	175	229	0	36	54	0.6666667
NODE_132908_length_329_cov_4.617391	175	229	2	18	54	0.3333333
NODE_132970_length_329_cov_3.160870	59	139	0	80	80	1.0000000
NODE_133003_length_329_cov_2.821739	164	209	1	45	45	1.0000000
NODE_133003_length_329_cov_2.821739	184	262	0	25	78	0.3205128
NODE_133003_length_329_cov_2.821739	184	262	1	53	78	0.6794872
NODE_133033_length_329_cov_2.560870	139	201	0	62	62	1.0000000
NODE_133036_length_329_cov_2.543478	145	206	2	61	61	1.0000000
NODE_133123_length_329_cov_2.143478	39	119	3	21	80	0.2625000
NODE_133123_length_329_cov_2.143478	39	119	4	22	80	0.2750000
NODE_133123_length_329_cov_2.143478	39	119	6	2	80	0.0250000
NODE_133123_length_329_cov_2.143478	39	119	7	35	80	0.4375000
NODE_133123_length_329_cov_2.143478	92	158	4	17	66	0.2575758
NODE_133123_length_329_cov_2.143478	92	158	7	49	66	0.7424242
NODE_133184_length_329_cov_1.865217	182	252	0	1	70	0.0142857
NODE_133184_length_329_cov_1.865217	182	252	2	5	70	0.0714286
NODE_133184_length_329_cov_1.865217	182	252	3	24	70	0.3428572
NODE_133184_length_329_cov_1.865217	182	252	4	6	70	0.0857143
NODE_133184_length_329_cov_1.865217	182	252	5	16	70	0.2285714
NODE_133184_length_329_cov_1.865217	182	252	6	18	70	0.2571429
NODE_133200_length_329_cov_1.791304	50	84	0	34	34	1.0000000
NODE_133200_length_329_cov_1.791304	92	149	0	27	57	0.4736842
NODE_133200_length_329_cov_1.791304	92	149	2	30	57	0.5263158
NODE_133200_length_329_cov_1.791304	145	203	2	58	58	1.0000000
NODE_133332_length_329_cov_1.508696	261	323	2	62	62	1.0000000
NODE_133348_length_329_cov_1.469565	168	237	0	69	69	1.0000000
NODE_133376_length_329_cov_1.391304	275	307	4	32	32	1.0000000
NODE_133547_length_329_cov_1.165217	199	242	0	43	43	1.0000000
NODE_133768_length_329_cov_0.878261	221	296	0	75	75	1.0000000
NODE_133970_length_328_cov_4.484716	95	175	0	1	80	0.0125000
NODE_133970_length_328_cov_4.484716	95	175	2	79	80	0.9875000
NODE_133989_length_328_cov_4.087336	79	159	0	13	80	0.1625000
NODE_133989_length_328_cov_4.087336	79	159	1	8	80	0.1000000
NODE_133989_length_328_cov_4.087336	79	159	2	59	80	0.7375000
NODE_133989_length_328_cov_4.087336	132	207	0	2	75	0.0266667
NODE_133989_length_328_cov_4.087336	132	207	2	73	75	0.9733334
NODE_133993_length_328_cov_3.895197	110	190	0	37	80	0.4625000
NODE_133993_length_328_cov_3.895197	110	190	1	43	80	0.5375000
NODE_134019_length_328_cov_3.393013	30	78	0	48	48	1.0000000
NODE_134144_length_328_cov_2.161572	103	134	0	31	31	1.0000000
NODE_134247_length_328_cov_1.781659	16	44	1	28	28	1.0000000
NODE_134335_length_328_cov_1.567686	0	76	0	76	76	1.0000000
NODE_134335_length_328_cov_1.567686	49	94	0	45	45	1.0000000
NODE_134452_length_328_cov_1.336245	0	73	0	73	73	1.0000000
NODE_134508_length_328_cov_1.266376	78	158	0	80	80	1.0000000
NODE_135002_length_327_cov_4.934211	170	250	0	80	80	1.0000000
NODE_135009_length_327_cov_4.701754	225	305	0	37	80	0.4625000
NODE_135009_length_327_cov_4.701754	225	305	2	43	80	0.5375000
NODE_135018_length_327_cov_4.241228	97	173	2	76	76	1.0000000
NODE_135037_length_327_cov_3.719298	70	150	1	8	80	0.1000000
NODE_135037_length_327_cov_3.719298	70	150	2	72	80	0.9000000
NODE_135063_length_327_cov_3.350877	156	227	1	2	71	0.0281690
NODE_135063_length_327_cov_3.350877	156	227	2	69	71	0.9718310
NODE_135328_length_327_cov_1.780702	191	271	2	21	80	0.2625000
NODE_135328_length_327_cov_1.780702	191	271	4	59	80	0.7375000
NODE_136081_length_326_cov_3.964758	178	228	0	50	50	1.0000000
NODE_136100_length_326_cov_3.502203	211	253	4	42	42	1.0000000
NODE_136100_length_326_cov_3.502203	220	255	4	35	35	1.0000000
NODE_136116_length_326_cov_3.202643	149	203	0	5	54	0.0925926
NODE_136116_length_326_cov_3.202643	149	203	1	1	54	0.0185185
NODE_136116_length_326_cov_3.202643	149	203	2	48	54	0.8888889
NODE_136130_length_326_cov_3.057269	107	126	0	19	19	1.0000000
NODE_136176_length_326_cov_2.594714	125	196	0	71	71	1.0000000
NODE_136283_length_326_cov_2.123348	184	244	0	60	60	1.0000000
NODE_136496_length_326_cov_1.515419	86	166	0	78	80	0.9750000
NODE_136496_length_326_cov_1.515419	86	166	1	2	80	0.0250000
NODE_137182_length_325_cov_4.893805	142	222	5	80	80	1.0000000
NODE_137182_length_325_cov_4.893805	195	275	0	2	80	0.0250000
NODE_137182_length_325_cov_4.893805	195	275	1	10	80	0.1250000
NODE_137182_length_325_cov_4.893805	195	275	2	20	80	0.2500000
NODE_137182_length_325_cov_4.893805	195	275	4	2	80	0.0250000
NODE_137182_length_325_cov_4.893805	195	275	5	46	80	0.5750000
NODE_137199_length_325_cov_4.000000	134	198	0	64	64	1.0000000
NODE_137221_length_325_cov_3.513274	191	266	0	75	75	1.0000000
NODE_137221_length_325_cov_3.513274	240	319	0	79	79	1.0000000
NODE_137223_length_325_cov_3.469027	216	278	0	62	62	1.0000000
NODE_137224_length_325_cov_3.429204	178	224	0	46	46	1.0000000
NODE_137243_length_325_cov_3.168142	188	274	0	86	86	1.0000000
NODE_137268_length_325_cov_2.880531	72	152	0	20	80	0.2500000
NODE_137268_length_325_cov_2.880531	72	152	2	60	80	0.7500000
NODE_137268_length_325_cov_2.880531	125	205	0	2	80	0.0250000
NODE_137268_length_325_cov_2.880531	125	205	1	1	80	0.0125000
NODE_137268_length_325_cov_2.880531	125	205	2	71	80	0.8875000
NODE_137268_length_325_cov_2.880531	125	205	3	6	80	0.0750000
NODE_137291_length_325_cov_2.707965	203	261	0	58	58	1.0000000
NODE_137296_length_325_cov_2.703540	68	148	0	80	80	1.0000000
NODE_137330_length_325_cov_2.500000	0	42	0	42	42	1.0000000
NODE_137407_length_325_cov_2.048673	122	202	4	1	80	0.0125000
NODE_137407_length_325_cov_2.048673	122	202	6	79	80	0.9875000
NODE_137409_length_325_cov_2.035398	83	154	0	71	71	1.0000000
NODE_137642_length_325_cov_1.464602	153	224	0	71	71	1.0000000
NODE_137939_length_325_cov_1.017699	103	134	0	31	31	1.0000000
NODE_138113_length_325_cov_0.827434	258	308	2	50	50	1.0000000
NODE_138309_length_324_cov_4.737778	113	160	0	47	47	1.0000000
NODE_138309_length_324_cov_4.737778	142	213	0	71	71	1.0000000
NODE_138358_length_324_cov_3.626667	218	273	0	55	55	1.0000000
NODE_138396_length_324_cov_3.124444	101	181	0	80	80	1.0000000
NODE_138396_length_324_cov_3.124444	256	285	0	29	29	1.0000000
NODE_138416_length_324_cov_2.924444	114	198	0	25	84	0.2976190
NODE_138416_length_324_cov_2.924444	114	198	2	13	84	0.1547619
NODE_138416_length_324_cov_2.924444	114	198	3	23	84	0.2738095
NODE_138416_length_324_cov_2.924444	114	198	4	23	84	0.2738095
NODE_138416_length_324_cov_2.924444	178	237	4	59	59	1.0000000
NODE_138418_length_324_cov_2.915556	141	221	0	80	80	1.0000000
NODE_138434_length_324_cov_2.715556	4	51	1	42	47	0.8936170
NODE_138434_length_324_cov_2.715556	4	51	2	5	47	0.1063830
NODE_138434_length_324_cov_2.715556	24	104	1	30	80	0.3750000
NODE_138434_length_324_cov_2.715556	24	104	2	50	80	0.6250000
NODE_138463_length_324_cov_2.506667	270	306	0	36	36	1.0000000
NODE_138483_length_324_cov_2.448889	187	238	0	51	51	1.0000000
NODE_138527_length_324_cov_2.248889	30	96	0	66	66	1.0000000
NODE_138778_length_324_cov_1.502222	10	90	0	80	80	1.0000000
NODE_138792_length_324_cov_1.457778	0	45	0	45	45	1.0000000
NODE_138792_length_324_cov_1.457778	18	75	0	57	57	1.0000000
NODE_138808_length_324_cov_1.382222	263	304	0	41	41	1.0000000
NODE_139129_length_324_cov_1.017778	0	59	0	59	59	1.0000000
NODE_139497_length_323_cov_6.669643	215	286	0	71	71	1.0000000
NODE_139497_length_323_cov_6.669643	268	315	0	47	47	1.0000000
NODE_139511_length_323_cov_5.089286	224	290	0	66	66	1.0000000
NODE_139511_length_323_cov_5.089286	263	319	0	56	56	1.0000000
NODE_139572_length_323_cov_3.276786	189	269	2	10	80	0.1250000
NODE_139572_length_323_cov_3.276786	189	269	3	4	80	0.0500000
NODE_139572_length_323_cov_3.276786	189	269	4	18	80	0.2250000
NODE_139572_length_323_cov_3.276786	189	269	5	44	80	0.5500000
NODE_139572_length_323_cov_3.276786	189	269	6	4	80	0.0500000
NODE_139575_length_323_cov_3.263393	101	181	0	80	80	1.0000000
NODE_139591_length_323_cov_3.089286	128	208	1	15	80	0.1875000
NODE_139591_length_323_cov_3.089286	128	208	2	65	80	0.8125000
NODE_139591_length_323_cov_3.089286	166	208	1	15	42	0.3571429
NODE_139591_length_323_cov_3.089286	166	208	2	27	42	0.6428571
NODE_139591_length_323_cov_3.089286	181	261	0	30	80	0.3750000
NODE_139591_length_323_cov_3.089286	181	261	1	38	80	0.4750000
NODE_139591_length_323_cov_3.089286	181	261	2	12	80	0.1500000
NODE_139591_length_323_cov_3.089286	181	261	0	30	80	0.3750000
NODE_139591_length_323_cov_3.089286	181	261	1	38	80	0.4750000
NODE_139591_length_323_cov_3.089286	181	261	2	12	80	0.1500000
NODE_139629_length_323_cov_2.683036	144	215	0	71	71	1.0000000
NODE_139746_length_323_cov_2.089286	64	144	0	80	80	1.0000000
NODE_139797_length_323_cov_1.888393	148	207	0	59	59	1.0000000
NODE_139901_length_323_cov_1.705357	195	262	0	67	67	1.0000000
NODE_139901_length_323_cov_1.705357	235	315	0	80	80	1.0000000
NODE_140651_length_322_cov_5.475336	56	136	0	80	80	1.0000000
NODE_140651_length_322_cov_5.475336	113	189	0	76	76	1.0000000
NODE_140692_length_322_cov_3.753363	63	133	1	70	70	1.0000000
NODE_140692_length_322_cov_3.753363	116	190	0	5	74	0.0675676
NODE_140692_length_322_cov_3.753363	116	190	1	69	74	0.9324324
NODE_140693_length_322_cov_3.735426	60	86	0	26	26	1.0000000
NODE_140693_length_322_cov_3.735426	99	139	0	40	40	1.0000000
NODE_140701_length_322_cov_3.605381	73	116	2	43	43	1.0000000
NODE_140702_length_322_cov_3.600897	75	145	0	70	70	1.0000000
NODE_140820_length_322_cov_2.304933	182	213	0	31	31	1.0000000
NODE_141738_length_321_cov_8.527027	176	240	0	64	64	1.0000000
NODE_141786_length_321_cov_4.094595	196	266	0	40	70	0.5714286
NODE_141786_length_321_cov_4.094595	196	266	1	30	70	0.4285714
NODE_141811_length_321_cov_3.563063	59	131	2	44	72	0.6111111
NODE_141811_length_321_cov_3.563063	59	131	4	28	72	0.3888889
NODE_141811_length_321_cov_3.563063	112	183	0	46	71	0.6478873
NODE_141811_length_321_cov_3.563063	112	183	2	25	71	0.3521127
NODE_141813_length_321_cov_3.540541	112	141	2	1	29	0.0344828
NODE_141813_length_321_cov_3.540541	112	141	4	28	29	0.9655172
NODE_141833_length_321_cov_3.049550	65	115	4	50	50	1.0000000
NODE_141833_length_321_cov_3.049550	95	138	4	43	43	1.0000000
NODE_141833_length_321_cov_3.049550	118	168	0	3	50	0.0600000
NODE_141833_length_321_cov_3.049550	118	168	2	11	50	0.2200000
NODE_141833_length_321_cov_3.049550	118	168	4	36	50	0.7200000
NODE_141837_length_321_cov_2.995495	146	220	0	74	74	1.0000000
NODE_141842_length_321_cov_2.981982	251	304	0	53	53	1.0000000
NODE_141876_length_321_cov_2.734234	239	306	0	67	67	1.0000000
NODE_141910_length_321_cov_2.427928	221	265	1	19	44	0.4318182
NODE_141910_length_321_cov_2.427928	221	265	2	25	44	0.5681818
NODE_141922_length_321_cov_2.315315	22	65	2	43	43	1.0000000
NODE_141951_length_321_cov_2.270270	43	105	0	62	62	1.0000000
NODE_141951_length_321_cov_2.270270	120	203	0	83	83	1.0000000
NODE_141951_length_321_cov_2.270270	127	208	0	81	81	1.0000000
NODE_142200_length_321_cov_1.576577	241	321	0	80	80	1.0000000
NODE_142363_length_321_cov_1.319820	253	304	0	51	51	1.0000000
NODE_142484_length_321_cov_1.130631	0	43	0	43	43	1.0000000
NODE_142700_length_321_cov_0.869369	248	294	0	46	46	1.0000000
NODE_142885_length_320_cov_200.484163	264	320	1	18	56	0.3214286
NODE_142885_length_320_cov_200.484163	264	320	3	3	56	0.0535714
NODE_142885_length_320_cov_200.484163	264	320	4	5	56	0.0892857
NODE_142885_length_320_cov_200.484163	264	320	6	28	56	0.5000000
NODE_142885_length_320_cov_200.484163	264	320	7	2	56	0.0357143
NODE_142886_length_320_cov_73.357466	51	97	0	46	46	1.0000000
NODE_142886_length_320_cov_73.357466	108	154	1	31	46	0.6739131
NODE_142886_length_320_cov_73.357466	108	154	3	4	46	0.0869565
NODE_142886_length_320_cov_73.357466	108	154	4	11	46	0.2391304
NODE_142886_length_320_cov_73.357466	165	245	9	6	80	0.0750000
NODE_142886_length_320_cov_73.357466	165	245	11	22	80	0.2750000
NODE_142886_length_320_cov_73.357466	165	245	12	52	80	0.6500000
NODE_142886_length_320_cov_73.357466	218	296	4	4	78	0.0512821
NODE_142886_length_320_cov_73.357466	218	296	5	8	78	0.1025641
NODE_142886_length_320_cov_73.357466	218	296	7	3	78	0.0384615
NODE_142886_length_320_cov_73.357466	218	296	9	12	78	0.1538462
NODE_142886_length_320_cov_73.357466	218	296	11	17	78	0.2179487
NODE_142886_length_320_cov_73.357466	218	296	12	34	78	0.4358974
NODE_142887_length_320_cov_35.787330	212	292	1	2	80	0.0250000
NODE_142887_length_320_cov_35.787330	212	292	3	8	80	0.1000000
NODE_142887_length_320_cov_35.787330	212	292	4	4	80	0.0500000
NODE_142887_length_320_cov_35.787330	212	292	5	12	80	0.1500000
NODE_142887_length_320_cov_35.787330	212	292	6	2	80	0.0250000
NODE_142887_length_320_cov_35.787330	212	292	7	25	80	0.3125000
NODE_142887_length_320_cov_35.787330	212	292	8	27	80	0.3375000
NODE_142887_length_320_cov_35.787330	212	292	1	2	80	0.0250000
NODE_142887_length_320_cov_35.787330	212	292	3	8	80	0.1000000
NODE_142887_length_320_cov_35.787330	212	292	4	4	80	0.0500000
NODE_142887_length_320_cov_35.787330	212	292	5	12	80	0.1500000
NODE_142887_length_320_cov_35.787330	212	292	6	2	80	0.0250000
NODE_142887_length_320_cov_35.787330	212	292	7	25	80	0.3125000
NODE_142887_length_320_cov_35.787330	212	292	8	27	80	0.3375000
NODE_142887_length_320_cov_35.787330	212	292	1	2	80	0.0250000
NODE_142887_length_320_cov_35.787330	212	292	3	8	80	0.1000000
NODE_142887_length_320_cov_35.787330	212	292	4	4	80	0.0500000
NODE_142887_length_320_cov_35.787330	212	292	5	12	80	0.1500000
NODE_142887_length_320_cov_35.787330	212	292	6	2	80	0.0250000
NODE_142887_length_320_cov_35.787330	212	292	7	25	80	0.3125000
NODE_142887_length_320_cov_35.787330	212	292	8	27	80	0.3375000
NODE_142887_length_320_cov_35.787330	212	292	1	2	80	0.0250000
NODE_142887_length_320_cov_35.787330	212	292	3	8	80	0.1000000
NODE_142887_length_320_cov_35.787330	212	292	4	4	80	0.0500000
NODE_142887_length_320_cov_35.787330	212	292	5	12	80	0.1500000
NODE_142887_length_320_cov_35.787330	212	292	6	2	80	0.0250000
NODE_142887_length_320_cov_35.787330	212	292	7	25	80	0.3125000
NODE_142887_length_320_cov_35.787330	212	292	8	27	80	0.3375000
NODE_142887_length_320_cov_35.787330	212	292	1	2	80	0.0250000
NODE_142887_length_320_cov_35.787330	212	292	3	8	80	0.1000000
NODE_142887_length_320_cov_35.787330	212	292	4	4	80	0.0500000
NODE_142887_length_320_cov_35.787330	212	292	5	12	80	0.1500000
NODE_142887_length_320_cov_35.787330	212	292	6	2	80	0.0250000
NODE_142887_length_320_cov_35.787330	212	292	7	25	80	0.3125000
NODE_142887_length_320_cov_35.787330	212	292	8	27	80	0.3375000
NODE_142887_length_320_cov_35.787330	265	314	0	11	49	0.2244898
NODE_142887_length_320_cov_35.787330	265	314	1	13	49	0.2653061
NODE_142887_length_320_cov_35.787330	265	314	3	8	49	0.1632653
NODE_142887_length_320_cov_35.787330	265	314	4	4	49	0.0816327
NODE_142887_length_320_cov_35.787330	265	314	5	12	49	0.2448980
NODE_142887_length_320_cov_35.787330	265	314	6	1	49	0.0204082
NODE_142887_length_320_cov_35.787330	265	320	0	17	55	0.3090909
NODE_142887_length_320_cov_35.787330	265	320	1	13	55	0.2363636
NODE_142887_length_320_cov_35.787330	265	320	3	8	55	0.1454545
NODE_142887_length_320_cov_35.787330	265	320	4	4	55	0.0727273
NODE_142887_length_320_cov_35.787330	265	320	5	12	55	0.2181818
NODE_142887_length_320_cov_35.787330	265	320	6	1	55	0.0181818
NODE_142887_length_320_cov_35.787330	265	320	0	17	55	0.3090909
NODE_142887_length_320_cov_35.787330	265	320	1	13	55	0.2363636
NODE_142887_length_320_cov_35.787330	265	320	3	8	55	0.1454545
NODE_142887_length_320_cov_35.787330	265	320	4	4	55	0.0727273
NODE_142887_length_320_cov_35.787330	265	320	5	12	55	0.2181818
NODE_142887_length_320_cov_35.787330	265	320	6	1	55	0.0181818
NODE_142887_length_320_cov_35.787330	268	320	0	17	52	0.3269231
NODE_142887_length_320_cov_35.787330	268	320	1	13	52	0.2500000
NODE_142887_length_320_cov_35.787330	268	320	3	8	52	0.1538462
NODE_142887_length_320_cov_35.787330	268	320	4	4	52	0.0769231
NODE_142887_length_320_cov_35.787330	268	320	5	10	52	0.1923077
NODE_142887_length_320_cov_35.787330	270	320	0	17	50	0.3400000
NODE_142887_length_320_cov_35.787330	270	320	1	13	50	0.2600000
NODE_142887_length_320_cov_35.787330	270	320	3	8	50	0.1600000
NODE_142887_length_320_cov_35.787330	270	320	4	4	50	0.0800000
NODE_142887_length_320_cov_35.787330	270	320	5	8	50	0.1600000
NODE_142900_length_320_cov_5.841629	115	172	0	57	57	1.0000000
NODE_142900_length_320_cov_5.841629	168	225	0	57	57	1.0000000
NODE_142934_length_320_cov_4.153846	134	200	0	66	66	1.0000000
NODE_142958_length_320_cov_3.733032	5	40	2	35	35	1.0000000
NODE_142985_length_320_cov_3.402715	142	222	0	80	80	1.0000000
NODE_143076_length_320_cov_2.475113	120	187	0	62	67	0.9253731
NODE_143076_length_320_cov_2.475113	120	187	2	3	67	0.0447761
NODE_143076_length_320_cov_2.475113	120	187	4	2	67	0.0298507
NODE_143142_length_320_cov_2.171946	16	96	0	5	80	0.0625000
NODE_143142_length_320_cov_2.171946	16	96	2	22	80	0.2750000
NODE_143142_length_320_cov_2.171946	16	96	4	53	80	0.6625000
NODE_143142_length_320_cov_2.171946	69	149	4	80	80	1.0000000
NODE_143207_length_320_cov_1.900452	37	117	2	80	80	1.0000000
NODE_143207_length_320_cov_1.900452	90	164	0	36	74	0.4864865
NODE_143207_length_320_cov_1.900452	90	164	2	38	74	0.5135135
NODE_143230_length_320_cov_1.846154	188	220	0	32	32	1.0000000
NODE_143309_length_320_cov_1.665158	144	198	0	54	54	1.0000000
NODE_143309_length_320_cov_1.665158	198	251	0	53	53	1.0000000
NODE_143351_length_320_cov_1.601810	157	181	1	24	24	1.0000000
NODE_143351_length_320_cov_1.601810	231	290	0	46	59	0.7796610
NODE_143351_length_320_cov_1.601810	231	290	1	13	59	0.2203390
NODE_143366_length_320_cov_1.556561	0	39	0	3	39	0.0769231
NODE_143366_length_320_cov_1.556561	0	39	1	8	39	0.2051282
NODE_143366_length_320_cov_1.556561	0	39	2	28	39	0.7179487
NODE_143442_length_320_cov_1.384615	18	98	0	6	80	0.0750000
NODE_143442_length_320_cov_1.384615	18	98	2	74	80	0.9250000
NODE_143442_length_320_cov_1.384615	71	145	2	74	74	1.0000000
NODE_143521_length_320_cov_1.312217	117	170	0	20	53	0.3773585
NODE_143521_length_320_cov_1.312217	117	170	2	33	53	0.6226415
NODE_143670_length_320_cov_1.117647	58	109	0	51	51	1.0000000
NODE_144091_length_319_cov_5.940909	122	202	0	16	80	0.2000000
NODE_144091_length_319_cov_5.940909	122	202	1	25	80	0.3125000
NODE_144091_length_319_cov_5.940909	122	202	2	24	80	0.3000000
NODE_144091_length_319_cov_5.940909	122	202	4	15	80	0.1875000
NODE_144107_length_319_cov_4.700000	16	47	0	31	31	1.0000000
NODE_144137_length_319_cov_4.068182	5	36	0	31	31	1.0000000
NODE_144162_length_319_cov_3.568182	149	229	0	80	80	1.0000000
NODE_144206_length_319_cov_3.036364	112	174	1	62	62	1.0000000
NODE_144226_length_319_cov_2.800000	25	106	1	3	81	0.0370370
NODE_144226_length_319_cov_2.800000	25	106	2	2	81	0.0246914
NODE_144226_length_319_cov_2.800000	25	106	3	2	81	0.0246914
NODE_144226_length_319_cov_2.800000	25	106	5	9	81	0.1111111
NODE_144226_length_319_cov_2.800000	25	106	7	5	81	0.0617284
NODE_144226_length_319_cov_2.800000	25	106	8	3	81	0.0370370
NODE_144226_length_319_cov_2.800000	25	106	9	1	81	0.0123457
NODE_144226_length_319_cov_2.800000	25	106	13	12	81	0.1481481
NODE_144226_length_319_cov_2.800000	25	106	14	9	81	0.1111111
NODE_144226_length_319_cov_2.800000	25	106	15	10	81	0.1234568
NODE_144226_length_319_cov_2.800000	25	106	17	1	81	0.0123457
NODE_144226_length_319_cov_2.800000	25	106	19	4	81	0.0493827
NODE_144226_length_319_cov_2.800000	25	106	20	4	81	0.0493827
NODE_144226_length_319_cov_2.800000	25	106	22	16	81	0.1975309
NODE_144226_length_319_cov_2.800000	79	158	15	2	79	0.0253165
NODE_144226_length_319_cov_2.800000	79	158	17	1	79	0.0126582
NODE_144226_length_319_cov_2.800000	79	158	19	12	79	0.1518987
NODE_144226_length_319_cov_2.800000	79	158	20	17	79	0.2151899
NODE_144226_length_319_cov_2.800000	79	158	21	14	79	0.1772152
NODE_144226_length_319_cov_2.800000	79	158	22	22	79	0.2784810
NODE_144226_length_319_cov_2.800000	79	158	23	11	79	0.1392405
NODE_144237_length_319_cov_2.740909	67	147	0	78	80	0.9750000
NODE_144237_length_319_cov_2.740909	67	147	2	2	80	0.0250000
NODE_144252_length_319_cov_2.586364	247	319	0	72	72	1.0000000
NODE_144272_length_319_cov_2.463636	90	153	0	15	63	0.2380952
NODE_144272_length_319_cov_2.463636	90	153	2	48	63	0.7619048
NODE_144272_length_319_cov_2.463636	163	216	0	53	53	1.0000000
NODE_144316_length_319_cov_2.259091	146	212	0	18	66	0.2727273
NODE_144316_length_319_cov_2.259091	146	212	2	48	66	0.7272727
NODE_144340_length_319_cov_2.163636	213	275	0	62	62	1.0000000
NODE_144390_length_319_cov_1.968182	120	200	1	20	80	0.2500000
NODE_144390_length_319_cov_1.968182	120	200	2	60	80	0.7500000
NODE_144616_length_319_cov_1.431818	111	157	0	46	46	1.0000000
NODE_144629_length_319_cov_1.395455	129	179	0	50	50	1.0000000
NODE_144788_length_319_cov_1.190909	119	182	0	63	63	1.0000000
NODE_144788_length_319_cov_1.190909	197	232	0	35	35	1.0000000
NODE_145289_length_318_cov_232.639269	169	198	55	5	29	0.1724138
NODE_145289_length_318_cov_232.639269	169	198	57	2	29	0.0689655
NODE_145289_length_318_cov_232.639269	169	198	58	13	29	0.4482759
NODE_145289_length_318_cov_232.639269	169	198	60	9	29	0.3103448
NODE_145289_length_318_cov_232.639269	171	246	47	2	75	0.0266667
NODE_145289_length_318_cov_232.639269	171	246	49	8	75	0.1066667
NODE_145289_length_318_cov_232.639269	171	246	51	11	75	0.1466667
NODE_145289_length_318_cov_232.639269	171	246	52	2	75	0.0266667
NODE_145289_length_318_cov_232.639269	171	246	54	13	75	0.1733333
NODE_145289_length_318_cov_232.639269	171	246	55	4	75	0.0533333
NODE_145289_length_318_cov_232.639269	171	246	56	2	75	0.0266667
NODE_145289_length_318_cov_232.639269	171	246	57	9	75	0.1200000
NODE_145289_length_318_cov_232.639269	171	246	58	13	75	0.1733333
NODE_145289_length_318_cov_232.639269	171	246	59	2	75	0.0266667
NODE_145289_length_318_cov_232.639269	171	246	60	9	75	0.1200000
NODE_145333_length_318_cov_4.237443	222	294	2	72	72	1.0000000
NODE_145348_length_318_cov_3.721461	98	148	0	50	50	1.0000000
NODE_145362_length_318_cov_3.515982	60	129	0	69	69	1.0000000
NODE_145362_length_318_cov_3.515982	60	140	0	80	80	1.0000000
NODE_145362_length_318_cov_3.515982	60	140	0	80	80	1.0000000
NODE_145362_length_318_cov_3.515982	113	153	0	40	40	1.0000000
NODE_145362_length_318_cov_3.515982	122	153	0	31	31	1.0000000
NODE_145465_length_318_cov_2.557078	205	247	0	42	42	1.0000000
NODE_145551_length_318_cov_2.109589	70	150	0	80	80	1.0000000
NODE_145619_length_318_cov_1.945205	229	286	0	57	57	1.0000000
NODE_145709_length_318_cov_1.739726	242	308	0	35	66	0.5303030
NODE_145709_length_318_cov_1.739726	242	308	1	31	66	0.4696970
NODE_145725_length_318_cov_1.684932	49	80	0	31	31	1.0000000
NODE_145787_length_318_cov_1.561644	99	158	0	1	59	0.0169492
NODE_145787_length_318_cov_1.561644	99	158	1	58	59	0.9830508
NODE_145807_length_318_cov_1.493151	151	195	0	12	44	0.2727273
NODE_145807_length_318_cov_1.493151	151	195	1	32	44	0.7272727
NODE_145807_length_318_cov_1.493151	199	258	2	59	59	1.0000000
NODE_145968_length_318_cov_1.301370	91	141	0	50	50	1.0000000
NODE_146017_length_318_cov_1.173516	83	150	4	15	67	0.2238806
NODE_146017_length_318_cov_1.173516	83	150	5	52	67	0.7761194
NODE_146065_length_318_cov_1.127854	24	51	0	27	27	1.0000000
NODE_146065_length_318_cov_1.127854	24	60	0	36	36	1.0000000
NODE_146467_length_317_cov_55.467890	172	243	5	26	71	0.3661972
NODE_146467_length_317_cov_55.467890	172	243	6	15	71	0.2112676
NODE_146467_length_317_cov_55.467890	172	243	8	30	71	0.4225352
NODE_146487_length_317_cov_5.252294	247	307	0	60	60	1.0000000
NODE_146503_length_317_cov_4.467890	105	185	0	49	80	0.6125000
NODE_146503_length_317_cov_4.467890	105	185	2	31	80	0.3875000
NODE_146503_length_317_cov_4.467890	113	193	0	41	80	0.5125000
NODE_146503_length_317_cov_4.467890	113	193	2	39	80	0.4875000
NODE_146554_length_317_cov_3.298165	146	206	0	18	60	0.3000000
NODE_146554_length_317_cov_3.298165	146	206	2	42	60	0.7000000
NODE_146562_length_317_cov_3.266055	111	191	0	80	80	1.0000000
NODE_146562_length_317_cov_3.266055	164	244	0	80	80	1.0000000
NODE_146585_length_317_cov_3.036697	3	79	0	76	76	1.0000000
NODE_146601_length_317_cov_2.825688	14	94	0	80	80	1.0000000
NODE_146601_length_317_cov_2.825688	67	147	0	80	80	1.0000000
NODE_146602_length_317_cov_2.821101	142	208	0	57	66	0.8636364
NODE_146602_length_317_cov_2.821101	142	208	2	9	66	0.1363636
NODE_146604_length_317_cov_2.816514	121	201	0	6	80	0.0750000
NODE_146604_length_317_cov_2.816514	121	201	2	74	80	0.9250000
NODE_146612_length_317_cov_2.779817	67	138	0	71	71	1.0000000
NODE_147046_length_317_cov_1.353211	166	239	0	73	73	1.0000000
NODE_147046_length_317_cov_1.353211	212	292	0	80	80	1.0000000
NODE_147172_length_317_cov_1.160550	58	117	0	59	59	1.0000000
NODE_147172_length_317_cov_1.160550	90	170	0	80	80	1.0000000
NODE_147187_length_317_cov_1.137615	245	313	0	68	68	1.0000000
NODE_147259_length_317_cov_0.967890	170	211	0	41	41	1.0000000
NODE_147373_length_317_cov_0.926606	194	232	0	38	38	1.0000000
NODE_147383_length_317_cov_0.912844	186	244	0	58	58	1.0000000
NODE_147595_length_316_cov_31.502304	96	174	2	4	78	0.0512821
NODE_147595_length_316_cov_31.502304	96	174	4	23	78	0.2948718
NODE_147595_length_316_cov_31.502304	96	174	5	14	78	0.1794872
NODE_147595_length_316_cov_31.502304	96	174	7	1	78	0.0128205
NODE_147595_length_316_cov_31.502304	96	174	9	9	78	0.1153846
NODE_147595_length_316_cov_31.502304	96	174	10	19	78	0.2435897
NODE_147595_length_316_cov_31.502304	96	174	12	8	78	0.1025641
NODE_147595_length_316_cov_31.502304	96	121	2	4	25	0.1600000
NODE_147595_length_316_cov_31.502304	96	121	4	21	25	0.8400000
NODE_147609_length_316_cov_6.179724	225	278	0	53	53	1.0000000
NODE_147623_length_316_cov_5.539171	91	171	0	27	80	0.3375000
NODE_147623_length_316_cov_5.539171	91	171	2	53	80	0.6625000
NODE_147668_length_316_cov_3.732719	128	208	0	80	80	1.0000000
NODE_147668_length_316_cov_3.732719	181	257	0	76	76	1.0000000
NODE_147680_length_316_cov_3.589862	185	247	0	62	62	1.0000000
NODE_147684_length_316_cov_3.520737	101	143	0	42	42	1.0000000
NODE_147702_length_316_cov_3.221198	108	184	0	16	76	0.2105263
NODE_147702_length_316_cov_3.221198	108	184	1	60	76	0.7894737
NODE_147734_length_316_cov_2.824885	274	311	0	37	37	1.0000000
NODE_147736_length_316_cov_2.820276	200	280	0	80	80	1.0000000
NODE_147757_length_316_cov_2.672811	23	80	0	57	57	1.0000000
NODE_147796_length_316_cov_2.456221	104	144	0	40	40	1.0000000
NODE_147985_length_316_cov_1.751152	73	122	2	49	49	1.0000000
NODE_148030_length_316_cov_1.640553	218	300	0	82	82	1.0000000
NODE_148042_length_316_cov_1.631336	180	233	0	24	53	0.4528302
NODE_148042_length_316_cov_1.631336	180	233	2	29	53	0.5471698
NODE_148042_length_316_cov_1.631336	180	215	0	6	35	0.1714286
NODE_148042_length_316_cov_1.631336	180	215	2	29	35	0.8285714
NODE_148080_length_316_cov_1.520737	194	275	0	81	81	1.0000000
NODE_148080_length_316_cov_1.520737	248	302	0	54	54	1.0000000
NODE_148086_length_316_cov_1.493088	64	144	0	7	80	0.0875000
NODE_148086_length_316_cov_1.493088	64	144	2	73	80	0.9125000
NODE_148193_length_316_cov_1.377880	22	64	0	42	42	1.0000000
NODE_148204_length_316_cov_1.350230	74	117	0	43	43	1.0000000
NODE_148204_length_316_cov_1.350230	90	140	0	50	50	1.0000000
NODE_148533_length_316_cov_0.940092	104	180	0	76	76	1.0000000
NODE_148533_length_316_cov_0.940092	155	234	0	79	79	1.0000000
NODE_148693_length_316_cov_0.695853	232	267	0	35	35	1.0000000
NODE_148778_length_315_cov_6.967593	127	191	0	64	64	1.0000000
NODE_148786_length_315_cov_6.300926	67	147	0	44	80	0.5500000
NODE_148786_length_315_cov_6.300926	67	147	2	36	80	0.4500000
NODE_148786_length_315_cov_6.300926	120	200	2	80	80	1.0000000
NODE_148812_length_315_cov_4.449074	125	205	2	80	80	1.0000000
NODE_148812_length_315_cov_4.449074	178	225	2	47	47	1.0000000
NODE_148834_length_315_cov_4.009259	0	61	0	61	61	1.0000000
NODE_148834_length_315_cov_4.009259	42	61	0	19	19	1.0000000
NODE_148872_length_315_cov_3.421296	37	120	0	83	83	1.0000000
NODE_148915_length_315_cov_2.847222	0	74	0	74	74	1.0000000
NODE_148915_length_315_cov_2.847222	47	127	0	80	80	1.0000000
NODE_148921_length_315_cov_2.833333	186	253	0	14	67	0.2089552
NODE_148921_length_315_cov_2.833333	186	253	2	53	67	0.7910448
NODE_148921_length_315_cov_2.833333	186	253	0	14	67	0.2089552
NODE_148921_length_315_cov_2.833333	186	253	2	53	67	0.7910448
NODE_148991_length_315_cov_2.416667	44	117	6	3	73	0.0410959
NODE_148991_length_315_cov_2.416667	44	117	8	2	73	0.0273973
NODE_148991_length_315_cov_2.416667	44	117	9	4	73	0.0547945
NODE_148991_length_315_cov_2.416667	44	117	13	1	73	0.0136986
NODE_148991_length_315_cov_2.416667	44	117	15	4	73	0.0547945
NODE_148991_length_315_cov_2.416667	44	117	17	1	73	0.0136986
NODE_148991_length_315_cov_2.416667	44	117	22	2	73	0.0273973
NODE_148991_length_315_cov_2.416667	44	117	24	3	73	0.0410959
NODE_148991_length_315_cov_2.416667	44	117	26	1	73	0.0136986
NODE_148991_length_315_cov_2.416667	44	117	27	2	73	0.0273973
NODE_148991_length_315_cov_2.416667	44	117	28	20	73	0.2739726
NODE_148991_length_315_cov_2.416667	44	117	32	11	73	0.1506849
NODE_148991_length_315_cov_2.416667	44	117	34	19	73	0.2602740
NODE_149074_length_315_cov_2.115741	128	193	0	65	65	1.0000000
NODE_149095_length_315_cov_2.004630	270	315	0	45	45	1.0000000
NODE_149201_length_315_cov_1.731481	125	202	0	77	77	1.0000000
NODE_149391_length_315_cov_1.384259	183	233	2	50	50	1.0000000
NODE_149935_length_315_cov_0.430556	125	145	2	20	20	1.0000000
NODE_149943_length_314_cov_108.139535	151	213	1	13	62	0.2096774
NODE_149943_length_314_cov_108.139535	151	213	2	9	62	0.1451613
NODE_149943_length_314_cov_108.139535	151	213	5	40	62	0.6451613
NODE_149943_length_314_cov_108.139535	160	213	1	4	53	0.0754717
NODE_149943_length_314_cov_108.139535	160	213	2	9	53	0.1698113
NODE_149943_length_314_cov_108.139535	160	213	5	40	53	0.7547170
NODE_149944_length_314_cov_48.134884	245	314	0	69	69	1.0000000
NODE_149946_length_314_cov_9.097674	149	206	0	5	57	0.0877193
NODE_149946_length_314_cov_9.097674	149	206	2	52	57	0.9122807
NODE_149967_length_314_cov_4.897674	109	189	2	80	80	1.0000000
NODE_150004_length_314_cov_3.823256	119	199	0	80	80	1.0000000
NODE_150020_length_314_cov_3.558140	32	92	2	60	60	1.0000000
NODE_150035_length_314_cov_3.316279	84	126	1	42	42	1.0000000
NODE_150035_length_314_cov_3.316279	127	180	1	53	53	1.0000000
NODE_150035_length_314_cov_3.316279	128	148	1	20	20	1.0000000
NODE_150066_length_314_cov_3.032558	252	308	1	14	56	0.2500000
NODE_150066_length_314_cov_3.032558	252	308	2	42	56	0.7500000
NODE_150141_length_314_cov_2.520930	0	61	0	61	61	1.0000000
NODE_150141_length_314_cov_2.520930	34	93	0	59	59	1.0000000
NODE_150153_length_314_cov_2.441860	48	84	0	36	36	1.0000000
NODE_150159_length_314_cov_2.395349	62	112	0	50	50	1.0000000
NODE_150200_length_314_cov_2.265116	7	53	0	21	46	0.4565217
NODE_150200_length_314_cov_2.265116	7	53	1	25	46	0.5434783
NODE_150220_length_314_cov_2.144186	224	264	0	40	40	1.0000000
NODE_150257_length_314_cov_2.004651	68	148	0	80	80	1.0000000
NODE_150257_length_314_cov_2.004651	121	201	0	80	80	1.0000000
NODE_150385_length_314_cov_1.665116	204	242	0	38	38	1.0000000
NODE_150385_length_314_cov_1.665116	215	295	0	80	80	1.0000000
NODE_150647_length_314_cov_1.223256	7	87	0	80	80	1.0000000
NODE_150709_length_314_cov_1.167442	1	69	0	68	68	1.0000000
NODE_151193_length_313_cov_156.051402	177	254	0	77	77	1.0000000
NODE_151193_length_313_cov_156.051402	177	254	0	77	77	1.0000000
NODE_151214_length_313_cov_5.359813	135	196	0	4	61	0.0655738
NODE_151214_length_313_cov_5.359813	135	196	1	16	61	0.2622951
NODE_151214_length_313_cov_5.359813	135	196	2	41	61	0.6721311
NODE_151214_length_313_cov_5.359813	169	241	2	72	72	1.0000000
NODE_151230_length_313_cov_4.794393	126	206	0	80	80	1.0000000
NODE_151230_length_313_cov_4.794393	179	259	0	80	80	1.0000000
NODE_151232_length_313_cov_4.761682	104	162	0	58	58	1.0000000
NODE_151232_length_313_cov_4.761682	135	215	0	80	80	1.0000000
NODE_151277_length_313_cov_3.560748	106	186	0	80	80	1.0000000
NODE_151331_length_313_cov_2.953271	92	153	2	61	61	1.0000000
NODE_151364_length_313_cov_2.640187	110	182	0	72	72	1.0000000
NODE_151364_length_313_cov_2.640187	113	184	0	71	71	1.0000000
NODE_151409_length_313_cov_2.383178	58	137	0	79	79	1.0000000
NODE_151409_length_313_cov_2.383178	110	190	0	72	80	0.9000000
NODE_151409_length_313_cov_2.383178	110	190	2	8	80	0.1000000
NODE_151474_length_313_cov_2.107477	153	221	0	16	68	0.2352941
NODE_151474_length_313_cov_2.107477	153	221	2	52	68	0.7647059
NODE_151510_length_313_cov_1.934579	107	187	0	28	80	0.3500000
NODE_151510_length_313_cov_1.934579	107	187	1	3	80	0.0375000
NODE_151510_length_313_cov_1.934579	107	187	3	1	80	0.0125000
NODE_151510_length_313_cov_1.934579	107	187	5	2	80	0.0250000
NODE_151510_length_313_cov_1.934579	107	187	6	5	80	0.0625000
NODE_151510_length_313_cov_1.934579	107	187	11	2	80	0.0250000
NODE_151510_length_313_cov_1.934579	107	187	12	2	80	0.0250000
NODE_151510_length_313_cov_1.934579	107	187	13	6	80	0.0750000
NODE_151510_length_313_cov_1.934579	107	187	14	7	80	0.0875000
NODE_151510_length_313_cov_1.934579	107	187	15	1	80	0.0125000
NODE_151510_length_313_cov_1.934579	107	187	16	1	80	0.0125000
NODE_151510_length_313_cov_1.934579	107	187	18	22	80	0.2750000
NODE_151510_length_313_cov_1.934579	160	240	14	3	80	0.0375000
NODE_151510_length_313_cov_1.934579	160	240	15	1	80	0.0125000
NODE_151510_length_313_cov_1.934579	160	240	16	1	80	0.0125000
NODE_151510_length_313_cov_1.934579	160	240	18	75	80	0.9375000
NODE_151576_length_313_cov_1.780374	236	296	0	60	60	1.0000000
NODE_151623_length_313_cov_1.663551	58	135	1	28	77	0.3636364
NODE_151623_length_313_cov_1.663551	58	135	2	27	77	0.3506494
NODE_151623_length_313_cov_1.663551	58	135	3	22	77	0.2857143
NODE_151703_length_313_cov_1.439252	0	64	0	64	64	1.0000000
NODE_151703_length_313_cov_1.439252	37	82	0	45	45	1.0000000
NODE_151753_length_313_cov_1.429907	74	111	0	37	37	1.0000000
NODE_151753_length_313_cov_1.429907	109	172	0	63	63	1.0000000
NODE_151953_length_313_cov_1.172897	106	161	0	55	55	1.0000000
NODE_151953_length_313_cov_1.172897	149	214	0	51	65	0.7846154
NODE_151953_length_313_cov_1.172897	149	214	2	14	65	0.2153846
NODE_152525_length_312_cov_3.723005	178	238	0	60	60	1.0000000
NODE_152525_length_312_cov_3.723005	231	291	0	60	60	1.0000000
NODE_152609_length_312_cov_2.723005	34	96	0	62	62	1.0000000
NODE_152609_length_312_cov_2.723005	87	149	0	62	62	1.0000000
NODE_152680_length_312_cov_2.333333	6	70	0	64	64	1.0000000
NODE_152680_length_312_cov_2.333333	43	123	0	80	80	1.0000000
NODE_152686_length_312_cov_2.267606	176	208	0	32	32	1.0000000
NODE_152697_length_312_cov_2.234742	108	169	2	61	61	1.0000000
NODE_152751_length_312_cov_2.014085	141	205	3	2	64	0.0312500
NODE_152751_length_312_cov_2.014085	141	205	4	18	64	0.2812500
NODE_152751_length_312_cov_2.014085	141	205	5	15	64	0.2343750
NODE_152751_length_312_cov_2.014085	141	205	6	29	64	0.4531250
NODE_152751_length_312_cov_2.014085	178	258	4	26	80	0.3250000
NODE_152751_length_312_cov_2.014085	178	258	5	21	80	0.2625000
NODE_152751_length_312_cov_2.014085	178	258	6	33	80	0.4125000
NODE_152827_length_312_cov_1.835681	176	221	0	45	45	1.0000000
NODE_152827_length_312_cov_1.835681	194	269	0	75	75	1.0000000
NODE_153222_length_312_cov_1.173709	87	133	0	17	46	0.3695652
NODE_153222_length_312_cov_1.173709	87	133	2	8	46	0.1739130
NODE_153222_length_312_cov_1.173709	87	133	3	12	46	0.2608696
NODE_153222_length_312_cov_1.173709	87	133	4	2	46	0.0434783
NODE_153222_length_312_cov_1.173709	87	133	5	7	46	0.1521739
NODE_153222_length_312_cov_1.173709	150	217	10	7	67	0.1044776
NODE_153222_length_312_cov_1.173709	150	217	11	6	67	0.0895522
NODE_153222_length_312_cov_1.173709	150	217	12	54	67	0.8059701
NODE_153532_length_312_cov_0.788732	49	110	0	61	61	1.0000000
NODE_153532_length_312_cov_0.788732	102	163	0	61	61	1.0000000
NODE_153708_length_311_cov_5.179245	155	235	0	80	80	1.0000000
NODE_153721_length_311_cov_4.589623	133	200	0	67	67	1.0000000
NODE_153730_length_311_cov_4.358491	199	263	0	17	64	0.2656250
NODE_153730_length_311_cov_4.358491	199	263	1	47	64	0.7343750
NODE_153743_length_311_cov_3.929245	91	127	1	36	36	1.0000000
NODE_153755_length_311_cov_3.825472	224	304	0	80	80	1.0000000
NODE_153773_length_311_cov_3.466981	106	186	0	80	80	1.0000000
NODE_153796_length_311_cov_3.188679	39	96	0	57	57	1.0000000
NODE_153846_length_311_cov_2.702830	144	193	0	49	49	1.0000000
NODE_153850_length_311_cov_2.665094	43	113	0	70	70	1.0000000
NODE_153859_length_311_cov_2.617925	206	284	0	78	78	1.0000000
NODE_153859_length_311_cov_2.617925	257	301	0	44	44	1.0000000
NODE_153913_length_311_cov_2.349057	177	204	0	27	27	1.0000000
NODE_153919_length_311_cov_2.325472	74	138	0	64	64	1.0000000
NODE_153947_length_311_cov_2.188679	21	92	0	71	71	1.0000000
NODE_154014_length_311_cov_1.924528	46	65	0	19	19	1.0000000
NODE_154056_length_311_cov_1.891509	122	180	0	58	58	1.0000000
NODE_154188_length_311_cov_1.594340	0	35	0	35	35	1.0000000
NODE_154190_length_311_cov_1.589623	96	151	0	55	55	1.0000000
NODE_154194_length_311_cov_1.570755	125	145	2	20	20	1.0000000
NODE_154957_length_311_cov_0.613208	136	216	0	80	80	1.0000000
NODE_154957_length_311_cov_0.613208	189	264	0	75	75	1.0000000
NODE_154996_length_310_cov_96.995261	211	249	2	3	38	0.0789474
NODE_154996_length_310_cov_96.995261	211	249	4	11	38	0.2894737
NODE_154996_length_310_cov_96.995261	211	249	6	1	38	0.0263158
NODE_154996_length_310_cov_96.995261	211	249	8	3	38	0.0789474
NODE_154996_length_310_cov_96.995261	211	249	9	6	38	0.1578947
NODE_154996_length_310_cov_96.995261	211	249	10	14	38	0.3684210
NODE_155001_length_310_cov_7.767773	80	151	0	71	71	1.0000000
NODE_155001_length_310_cov_7.767773	134	189	0	55	55	1.0000000
NODE_155017_length_310_cov_5.914692	84	134	0	37	50	0.7400000
NODE_155017_length_310_cov_5.914692	84	134	1	13	50	0.2600000
NODE_155017_length_310_cov_5.914692	113	134	0	8	21	0.3809524
NODE_155017_length_310_cov_5.914692	113	134	1	13	21	0.6190476
NODE_155017_length_310_cov_5.914692	113	188	0	8	75	0.1066667
NODE_155017_length_310_cov_5.914692	113	188	1	67	75	0.8933333
NODE_155066_length_310_cov_3.777251	146	226	0	80	80	1.0000000
NODE_155115_length_310_cov_3.180095	137	211	1	56	74	0.7567568
NODE_155115_length_310_cov_3.180095	137	211	2	18	74	0.2432432
NODE_155179_length_310_cov_2.630332	122	174	0	52	52	1.0000000
NODE_155179_length_310_cov_2.630332	175	222	0	47	47	1.0000000
NODE_155180_length_310_cov_2.625592	258	301	0	43	43	1.0000000
NODE_155195_length_310_cov_2.563981	149	196	0	47	47	1.0000000
NODE_155195_length_310_cov_2.563981	169	249	0	80	80	1.0000000
NODE_155261_length_310_cov_2.298578	213	259	0	46	46	1.0000000
NODE_155334_length_310_cov_2.009479	223	303	0	80	80	1.0000000
NODE_155439_length_310_cov_1.729858	53	91	0	38	38	1.0000000
NODE_155768_length_310_cov_1.222749	181	244	0	63	63	1.0000000
NODE_155864_length_310_cov_1.142180	65	135	1	54	70	0.7714286
NODE_155864_length_310_cov_1.142180	65	135	2	16	70	0.2285714
NODE_155937_length_310_cov_0.966825	131	212	0	81	81	1.0000000
NODE_155937_length_310_cov_0.966825	193	256	0	63	63	1.0000000
NODE_156078_length_310_cov_0.924171	180	222	1	42	42	1.0000000
NODE_156174_length_310_cov_0.739336	208	288	0	80	80	1.0000000
NODE_156332_length_309_cov_8.552381	154	234	2	80	80	1.0000000
NODE_156340_length_309_cov_6.147619	20	83	0	63	63	1.0000000
NODE_156349_length_309_cov_5.147619	213	291	0	78	78	1.0000000
NODE_156364_length_309_cov_4.585714	15	95	0	80	80	1.0000000
NODE_156472_length_309_cov_3.028571	0	47	1	47	47	1.0000000
NODE_156472_length_309_cov_3.028571	20	101	1	81	81	1.0000000
NODE_156563_length_309_cov_2.304762	179	218	0	39	39	1.0000000
NODE_156615_length_309_cov_2.095238	55	85	2	30	30	1.0000000
NODE_156678_length_309_cov_1.938095	2	73	0	71	71	1.0000000
NODE_156950_length_309_cov_1.414286	189	231	0	42	42	1.0000000
NODE_156978_length_309_cov_1.376190	94	168	0	74	74	1.0000000
NODE_157334_length_309_cov_0.966667	134	153	0	19	19	1.0000000
NODE_157469_length_309_cov_0.738095	150	215	0	65	65	1.0000000
NODE_157661_length_308_cov_4.775120	137	174	0	37	37	1.0000000
NODE_157690_length_308_cov_3.966507	126	206	0	80	80	1.0000000
NODE_157705_length_308_cov_3.665072	11	75	0	64	64	1.0000000
NODE_157819_length_308_cov_2.593301	137	193	0	56	56	1.0000000
NODE_157852_length_308_cov_2.435407	14	58	0	44	44	1.0000000
NODE_157852_length_308_cov_2.435407	31	111	0	80	80	1.0000000
NODE_157898_length_308_cov_2.191388	14	80	0	66	66	1.0000000
NODE_157903_length_308_cov_2.191388	236	296	0	60	60	1.0000000
NODE_157969_length_308_cov_1.952153	251	296	0	45	45	1.0000000
NODE_158083_length_308_cov_1.708134	102	148	0	46	46	1.0000000
NODE_158276_length_308_cov_1.435407	196	276	0	80	80	1.0000000
NODE_158439_length_308_cov_1.162679	260	300	0	40	40	1.0000000
NODE_158439_length_308_cov_1.162679	273	307	0	34	34	1.0000000
NODE_158447_length_308_cov_1.148325	35	83	0	48	48	1.0000000
NODE_158448_length_308_cov_1.148325	253	308	0	55	55	1.0000000
NODE_158510_length_308_cov_1.038278	147	202	1	55	55	1.0000000
NODE_158811_length_308_cov_0.684211	196	275	0	79	79	1.0000000
NODE_158821_length_308_cov_0.660287	109	157	0	48	48	1.0000000
NODE_158821_length_308_cov_0.660287	130	210	0	80	80	1.0000000
NODE_158905_length_307_cov_30.725962	0	73	0	31	73	0.4246575
NODE_158905_length_307_cov_30.725962	0	73	1	42	73	0.5753425
NODE_158905_length_307_cov_30.725962	46	99	1	53	53	1.0000000
NODE_158906_length_307_cov_25.096154	84	164	6	11	80	0.1375000
NODE_158906_length_307_cov_25.096154	84	164	8	67	80	0.8375000
NODE_158906_length_307_cov_25.096154	84	164	10	2	80	0.0250000
NODE_158906_length_307_cov_25.096154	137	217	4	1	80	0.0125000
NODE_158906_length_307_cov_25.096154	137	217	6	60	80	0.7500000
NODE_158906_length_307_cov_25.096154	137	217	8	17	80	0.2125000
NODE_158906_length_307_cov_25.096154	137	217	10	2	80	0.0250000
NODE_158933_length_307_cov_5.524038	150	221	0	71	71	1.0000000
NODE_158983_length_307_cov_3.730769	172	252	0	80	80	1.0000000
NODE_158983_length_307_cov_3.730769	225	305	0	80	80	1.0000000
NODE_158999_length_307_cov_3.322115	20	100	1	76	80	0.9500000
NODE_158999_length_307_cov_3.322115	20	100	2	4	80	0.0500000
NODE_158999_length_307_cov_3.322115	78	153	1	18	75	0.2400000
NODE_158999_length_307_cov_3.322115	78	153	2	8	75	0.1066667
NODE_158999_length_307_cov_3.322115	78	153	3	49	75	0.6533333
NODE_159000_length_307_cov_3.317308	12	94	0	82	82	1.0000000
NODE_159000_length_307_cov_3.317308	76	134	0	58	58	1.0000000
NODE_159053_length_307_cov_2.870192	43	108	0	65	65	1.0000000
NODE_159084_length_307_cov_2.653846	117	177	4	60	60	1.0000000
NODE_159142_length_307_cov_2.346154	54	105	0	51	51	1.0000000
NODE_159351_length_307_cov_1.716346	124	165	0	41	41	1.0000000
NODE_159362_length_307_cov_1.716346	30	93	0	63	63	1.0000000
NODE_159407_length_307_cov_1.600962	221	269	0	48	48	1.0000000
NODE_159407_length_307_cov_1.600962	242	307	0	65	65	1.0000000
NODE_159447_length_307_cov_1.475962	252	307	0	55	55	1.0000000
NODE_159585_length_307_cov_1.326923	96	142	0	46	46	1.0000000
NODE_159585_length_307_cov_1.326923	115	195	0	80	80	1.0000000
NODE_159618_length_307_cov_1.264423	13	61	0	48	48	1.0000000
NODE_159618_length_307_cov_1.264423	23	54	0	31	31	1.0000000
NODE_159696_length_307_cov_1.197115	92	121	0	29	29	1.0000000
NODE_159787_length_307_cov_1.000000	132	168	0	36	36	1.0000000
NODE_160213_length_306_cov_74.526570	68	136	2	68	68	1.0000000
NODE_160213_length_306_cov_74.526570	68	148	2	80	80	1.0000000
NODE_160213_length_306_cov_74.526570	121	201	0	28	80	0.3500000
NODE_160213_length_306_cov_74.526570	121	201	2	52	80	0.6500000
NODE_160213_length_306_cov_74.526570	121	201	0	28	80	0.3500000
NODE_160213_length_306_cov_74.526570	121	201	2	52	80	0.6500000
NODE_160213_length_306_cov_74.526570	197	277	0	80	80	1.0000000
NODE_160213_length_306_cov_74.526570	197	277	0	80	80	1.0000000
NODE_160213_length_306_cov_74.526570	197	277	0	80	80	1.0000000
NODE_160213_length_306_cov_74.526570	250	299	0	49	49	1.0000000
NODE_160213_length_306_cov_74.526570	250	306	0	56	56	1.0000000
NODE_160213_length_306_cov_74.526570	255	306	0	51	51	1.0000000
NODE_160217_length_306_cov_7.396135	23	117	0	94	94	1.0000000
NODE_160217_length_306_cov_7.396135	90	170	0	80	80	1.0000000
NODE_160261_length_306_cov_4.275362	67	147	0	80	80	1.0000000
NODE_160275_length_306_cov_3.937198	104	176	0	72	72	1.0000000
NODE_160300_length_306_cov_3.444444	130	206	0	76	76	1.0000000
NODE_160323_length_306_cov_3.217391	198	278	0	80	80	1.0000000
NODE_160333_length_306_cov_3.043478	90	171	2	81	81	1.0000000
NODE_160333_length_306_cov_3.043478	144	202	0	22	58	0.3793103
NODE_160333_length_306_cov_3.043478	144	202	2	36	58	0.6206896
NODE_160340_length_306_cov_2.956522	242	273	0	31	31	1.0000000
NODE_160355_length_306_cov_2.884058	173	243	0	47	70	0.6714286
NODE_160355_length_306_cov_2.884058	173	243	2	23	70	0.3285714
NODE_160403_length_306_cov_2.574879	122	203	0	81	81	1.0000000
NODE_160403_length_306_cov_2.574879	176	254	0	78	78	1.0000000
NODE_160475_length_306_cov_2.265700	223	278	0	55	55	1.0000000
NODE_160512_length_306_cov_2.106280	73	149	0	76	76	1.0000000
NODE_160512_length_306_cov_2.106280	125	205	0	80	80	1.0000000
NODE_160608_length_306_cov_1.879227	165	196	0	31	31	1.0000000
NODE_160752_length_306_cov_1.478261	206	237	0	31	31	1.0000000
NODE_160761_length_306_cov_1.478261	157	220	0	63	63	1.0000000
NODE_160833_length_306_cov_1.434783	40	88	0	48	48	1.0000000
NODE_160875_length_306_cov_1.357488	128	171	0	43	43	1.0000000
NODE_160992_length_306_cov_1.222222	216	252	0	36	36	1.0000000
NODE_160992_length_306_cov_1.222222	230	305	0	75	75	1.0000000
NODE_161018_length_306_cov_1.188406	79	159	0	80	80	1.0000000
NODE_161042_length_306_cov_1.130435	122	202	0	80	80	1.0000000
NODE_161042_length_306_cov_1.130435	175	255	0	80	80	1.0000000
NODE_161078_length_306_cov_1.067633	156	188	0	32	32	1.0000000
NODE_161234_length_306_cov_0.975845	219	247	0	28	28	1.0000000
NODE_161246_length_306_cov_0.956522	206	284	1	14	78	0.1794872
NODE_161246_length_306_cov_0.956522	206	284	2	64	78	0.8205128
NODE_161550_length_305_cov_5.718447	177	243	0	66	66	1.0000000
NODE_161566_length_305_cov_4.854369	55	135	0	80	80	1.0000000
NODE_161584_length_305_cov_4.266990	186	266	0	80	80	1.0000000
NODE_161723_length_305_cov_2.616505	220	263	0	43	43	1.0000000
NODE_161723_length_305_cov_2.616505	236	305	0	69	69	1.0000000
NODE_161726_length_305_cov_2.597087	171	256	22	21	85	0.2470588
NODE_161726_length_305_cov_2.597087	171	256	24	1	85	0.0117647
NODE_161726_length_305_cov_2.597087	171	256	26	4	85	0.0470588
NODE_161726_length_305_cov_2.597087	171	256	27	2	85	0.0235294
NODE_161726_length_305_cov_2.597087	171	256	28	4	85	0.0470588
NODE_161726_length_305_cov_2.597087	171	256	32	1	85	0.0117647
NODE_161726_length_305_cov_2.597087	171	256	33	2	85	0.0235294
NODE_161726_length_305_cov_2.597087	171	256	35	3	85	0.0352941
NODE_161726_length_305_cov_2.597087	171	256	36	3	85	0.0352941
NODE_161726_length_305_cov_2.597087	171	256	37	2	85	0.0235294
NODE_161726_length_305_cov_2.597087	171	256	38	2	85	0.0235294
NODE_161726_length_305_cov_2.597087	171	256	39	3	85	0.0352941
NODE_161726_length_305_cov_2.597087	171	256	40	1	85	0.0117647
NODE_161726_length_305_cov_2.597087	171	256	43	2	85	0.0235294
NODE_161726_length_305_cov_2.597087	171	256	45	2	85	0.0235294
NODE_161726_length_305_cov_2.597087	171	256	46	32	85	0.3764706
NODE_161732_length_305_cov_2.533981	3	57	0	54	54	1.0000000
NODE_161775_length_305_cov_2.339806	149	237	6	3	88	0.0340909
NODE_161775_length_305_cov_2.339806	149	237	7	11	88	0.1250000
NODE_161775_length_305_cov_2.339806	149	237	8	29	88	0.3295455
NODE_161775_length_305_cov_2.339806	149	237	10	45	88	0.5113636
NODE_161795_length_305_cov_2.228155	194	274	2	80	80	1.0000000
NODE_161795_length_305_cov_2.228155	247	300	0	7	53	0.1320755
NODE_161795_length_305_cov_2.228155	247	300	2	46	53	0.8679245
NODE_161877_length_305_cov_1.975728	44	116	2	6	72	0.0833333
NODE_161877_length_305_cov_1.975728	44	116	4	66	72	0.9166667
NODE_161908_length_305_cov_1.883495	135	172	8	3	37	0.0810811
NODE_161908_length_305_cov_1.883495	135	172	9	7	37	0.1891892
NODE_161908_length_305_cov_1.883495	135	172	10	27	37	0.7297297
NODE_161990_length_305_cov_1.674757	14	80	3	1	66	0.0151515
NODE_161990_length_305_cov_1.674757	14	80	5	11	66	0.1666667
NODE_161990_length_305_cov_1.674757	14	80	6	54	66	0.8181818
NODE_161990_length_305_cov_1.674757	53	133	6	74	80	0.9250000
NODE_161990_length_305_cov_1.674757	53	133	7	2	80	0.0250000
NODE_161990_length_305_cov_1.674757	53	133	8	4	80	0.0500000
NODE_161996_length_305_cov_1.655340	110	179	0	69	69	1.0000000
NODE_162123_length_305_cov_1.466019	153	238	0	22	85	0.2588235
NODE_162123_length_305_cov_1.466019	153	238	2	63	85	0.7411765
NODE_162123_length_305_cov_1.466019	222	284	2	62	62	1.0000000
NODE_162169_length_305_cov_1.398058	28	75	3	21	47	0.4468085
NODE_162169_length_305_cov_1.398058	28	75	4	26	47	0.5531915
NODE_162198_length_305_cov_1.330097	212	292	0	56	80	0.7000000
NODE_162198_length_305_cov_1.330097	212	292	2	24	80	0.3000000
NODE_162198_length_305_cov_1.330097	265	305	0	40	40	1.0000000
NODE_162359_length_305_cov_1.111650	245	275	0	30	30	1.0000000
NODE_162411_length_305_cov_0.990291	46	126	0	80	80	1.0000000
NODE_162593_length_305_cov_0.873786	73	109	0	36	36	1.0000000
NODE_162782_length_305_cov_0.631068	86	166	0	80	80	1.0000000
NODE_162782_length_305_cov_0.631068	139	186	0	47	47	1.0000000
NODE_162854_length_304_cov_44.482927	61	102	9	13	41	0.3170732
NODE_162854_length_304_cov_44.482927	61	102	10	13	41	0.3170732
NODE_162854_length_304_cov_44.482927	61	102	11	7	41	0.1707317
NODE_162854_length_304_cov_44.482927	61	102	13	2	41	0.0487805
NODE_162854_length_304_cov_44.482927	61	102	14	1	41	0.0243902
NODE_162854_length_304_cov_44.482927	61	102	16	5	41	0.1219512
NODE_162855_length_304_cov_30.678049	205	281	0	76	76	1.0000000
NODE_162855_length_304_cov_30.678049	254	304	0	50	50	1.0000000
NODE_162886_length_304_cov_4.956098	72	152	0	15	80	0.1875000
NODE_162886_length_304_cov_4.956098	72	152	2	25	80	0.3125000
NODE_162886_length_304_cov_4.956098	72	152	4	40	80	0.5000000
NODE_162919_length_304_cov_3.980488	46	126	0	80	80	1.0000000
NODE_162919_length_304_cov_3.980488	99	179	0	80	80	1.0000000
NODE_162932_length_304_cov_3.809756	108	156	0	48	48	1.0000000
NODE_162955_length_304_cov_3.424390	67	129	0	26	62	0.4193548
NODE_162955_length_304_cov_3.424390	67	129	1	36	62	0.5806451
NODE_162955_length_304_cov_3.424390	120	182	1	62	62	1.0000000
NODE_162997_length_304_cov_2.980488	105	126	0	21	21	1.0000000
NODE_163048_length_304_cov_2.629268	106	186	0	80	80	1.0000000
NODE_163048_length_304_cov_2.629268	159	209	0	50	50	1.0000000
NODE_163116_length_304_cov_2.239024	57	137	0	80	80	1.0000000
NODE_163116_length_304_cov_2.239024	110	152	0	42	42	1.0000000
NODE_163148_length_304_cov_2.170732	112	145	0	33	33	1.0000000
NODE_163148_length_304_cov_2.170732	146	198	0	52	52	1.0000000
NODE_163333_length_304_cov_1.687805	219	288	0	69	69	1.0000000
NODE_163432_length_304_cov_1.492683	190	238	2	48	48	1.0000000
NODE_163559_length_304_cov_1.287805	99	165	2	20	66	0.3030303
NODE_163559_length_304_cov_1.287805	99	165	4	46	66	0.6969697
NODE_163670_length_304_cov_1.175610	0	30	0	30	30	1.0000000
NODE_163895_length_304_cov_0.951220	70	150	0	80	80	1.0000000
NODE_164171_length_303_cov_30.843137	46	97	0	51	51	1.0000000
NODE_164194_length_303_cov_5.401961	33	79	0	46	46	1.0000000
NODE_164224_length_303_cov_4.210784	136	205	0	11	69	0.1594203
NODE_164224_length_303_cov_4.210784	136	205	2	45	69	0.6521739
NODE_164224_length_303_cov_4.210784	136	205	4	13	69	0.1884058
NODE_164224_length_303_cov_4.210784	178	259	0	65	81	0.8024691
NODE_164224_length_303_cov_4.210784	178	259	2	16	81	0.1975309
NODE_164251_length_303_cov_3.671569	9	75	3	8	66	0.1212121
NODE_164251_length_303_cov_3.671569	9	75	4	58	66	0.8787879
NODE_164251_length_303_cov_3.671569	48	128	4	80	80	1.0000000
NODE_164251_length_303_cov_3.671569	48	128	4	80	80	1.0000000
NODE_164251_length_303_cov_3.671569	220	300	0	5	80	0.0625000
NODE_164251_length_303_cov_3.671569	220	300	2	75	80	0.9375000
NODE_164267_length_303_cov_3.500000	55	123	0	68	68	1.0000000
NODE_164272_length_303_cov_3.460784	0	67	0	62	67	0.9253731
NODE_164272_length_303_cov_3.460784	0	67	1	5	67	0.0746269
NODE_164272_length_303_cov_3.460784	98	178	9	13	80	0.1625000
NODE_164272_length_303_cov_3.460784	98	178	10	2	80	0.0250000
NODE_164272_length_303_cov_3.460784	98	178	11	13	80	0.1625000
NODE_164272_length_303_cov_3.460784	98	178	12	1	80	0.0125000
NODE_164272_length_303_cov_3.460784	98	178	13	2	80	0.0250000
NODE_164272_length_303_cov_3.460784	98	178	16	1	80	0.0125000
NODE_164272_length_303_cov_3.460784	98	178	17	7	80	0.0875000
NODE_164272_length_303_cov_3.460784	98	178	19	2	80	0.0250000
NODE_164272_length_303_cov_3.460784	98	178	20	1	80	0.0125000
NODE_164272_length_303_cov_3.460784	98	178	21	31	80	0.3875000
NODE_164272_length_303_cov_3.460784	98	178	23	7	80	0.0875000
NODE_164272_length_303_cov_3.460784	151	191	21	21	40	0.5250000
NODE_164272_length_303_cov_3.460784	151	191	23	19	40	0.4750000
NODE_164283_length_303_cov_3.352941	77	146	0	69	69	1.0000000
NODE_164433_length_303_cov_2.284314	78	158	1	80	80	1.0000000
NODE_164433_length_303_cov_2.284314	215	295	1	80	80	1.0000000
NODE_164581_length_303_cov_1.848039	90	170	0	80	80	1.0000000
NODE_164581_length_303_cov_1.848039	143	223	0	80	80	1.0000000
NODE_164581_length_303_cov_1.848039	212	235	0	23	23	1.0000000
NODE_164668_length_303_cov_1.686275	62	88	0	26	26	1.0000000
NODE_164695_length_303_cov_1.583333	206	270	0	64	64	1.0000000
NODE_164800_length_303_cov_1.475490	155	221	0	66	66	1.0000000
NODE_164846_length_303_cov_1.392157	135	213	0	78	78	1.0000000
NODE_164878_length_303_cov_1.318627	0	75	0	75	75	1.0000000
NODE_164974_length_303_cov_1.215686	278	297	0	19	19	1.0000000
NODE_165498_length_302_cov_10.852217	266	300	0	34	34	1.0000000
NODE_165502_length_302_cov_7.896552	46	131	0	85	85	1.0000000
NODE_165502_length_302_cov_7.896552	104	160	0	56	56	1.0000000
NODE_165505_length_302_cov_7.266010	135	191	0	56	56	1.0000000
NODE_165507_length_302_cov_7.216749	93	149	0	56	56	1.0000000
NODE_165507_length_302_cov_7.216749	155	226	0	13	71	0.1830986
NODE_165507_length_302_cov_7.216749	155	226	2	58	71	0.8169014
NODE_165517_length_302_cov_6.172414	179	243	0	64	64	1.0000000
NODE_165517_length_302_cov_6.172414	232	287	0	55	55	1.0000000
NODE_165528_length_302_cov_5.586207	221	293	0	20	72	0.2777778
NODE_165528_length_302_cov_5.586207	221	293	4	32	72	0.4444444
NODE_165528_length_302_cov_5.586207	221	293	6	20	72	0.2777778
NODE_165641_length_302_cov_2.985222	104	186	0	14	82	0.1707317
NODE_165641_length_302_cov_2.985222	104	186	2	68	82	0.8292683
NODE_165848_length_302_cov_2.009852	12	34	0	22	22	1.0000000
NODE_165934_length_302_cov_1.758621	98	152	2	45	54	0.8333333
NODE_165934_length_302_cov_1.758621	98	152	3	9	54	0.1666667
NODE_165945_length_302_cov_1.758621	230	294	0	64	64	1.0000000
NODE_166007_length_302_cov_1.620690	172	232	1	22	60	0.3666667
NODE_166007_length_302_cov_1.620690	172	232	2	7	60	0.1166667
NODE_166007_length_302_cov_1.620690	172	232	4	31	60	0.5166667
NODE_166007_length_302_cov_1.620690	225	277	0	36	52	0.6923077
NODE_166007_length_302_cov_1.620690	225	277	1	16	52	0.3076923
NODE_166320_length_302_cov_1.172414	34	103	0	69	69	1.0000000
NODE_166381_length_302_cov_1.044335	54	130	0	29	76	0.3815790
NODE_166381_length_302_cov_1.044335	54	130	2	47	76	0.6184211
NODE_166617_length_302_cov_0.847291	94	172	3	4	78	0.0512821
NODE_166617_length_302_cov_0.847291	94	172	5	28	78	0.3589744
NODE_166617_length_302_cov_0.847291	94	172	6	46	78	0.5897436
NODE_166617_length_302_cov_0.847291	94	172	3	4	78	0.0512821
NODE_166617_length_302_cov_0.847291	94	172	5	28	78	0.3589744
NODE_166617_length_302_cov_0.847291	94	172	6	46	78	0.5897436
NODE_166617_length_302_cov_0.847291	103	172	5	23	69	0.3333333
NODE_166617_length_302_cov_0.847291	103	172	6	46	69	0.6666667
NODE_166638_length_302_cov_0.807882	97	177	0	80	80	1.0000000
NODE_166819_length_301_cov_6.960396	268	299	0	31	31	1.0000000
NODE_166827_length_301_cov_6.148515	214	283	0	69	69	1.0000000
NODE_166889_length_301_cov_3.747525	116	196	0	80	80	1.0000000
NODE_166904_length_301_cov_3.509901	217	277	0	6	60	0.1000000
NODE_166904_length_301_cov_3.509901	217	277	2	14	60	0.2333333
NODE_166904_length_301_cov_3.509901	217	277	4	7	60	0.1166667
NODE_166904_length_301_cov_3.509901	217	277	5	1	60	0.0166667
NODE_166904_length_301_cov_3.509901	217	277	7	6	60	0.1000000
NODE_166904_length_301_cov_3.509901	217	277	8	24	60	0.4000000
NODE_166904_length_301_cov_3.509901	217	277	10	2	60	0.0333333
NODE_166993_length_301_cov_2.653465	133	213	0	5	80	0.0625000
NODE_166993_length_301_cov_2.653465	133	213	2	75	80	0.9375000
NODE_167126_length_301_cov_2.084158	178	258	1	23	80	0.2875000
NODE_167126_length_301_cov_2.084158	178	258	2	57	80	0.7125000
NODE_167215_length_301_cov_1.831683	111	175	0	64	64	1.0000000
NODE_167215_length_301_cov_1.831683	164	228	0	64	64	1.0000000
NODE_167308_length_301_cov_1.603960	173	233	0	60	60	1.0000000
NODE_167313_length_301_cov_1.584158	30	108	0	78	78	1.0000000
NODE_167434_length_301_cov_1.470297	90	165	0	75	75	1.0000000
NODE_167508_length_301_cov_1.326733	175	247	0	72	72	1.0000000
NODE_167612_length_301_cov_1.247525	29	73	0	44	44	1.0000000
NODE_167642_length_301_cov_1.183168	123	203	0	80	80	1.0000000
NODE_167659_length_301_cov_1.163366	10	83	0	73	73	1.0000000
NODE_167659_length_301_cov_1.163366	91	121	0	30	30	1.0000000
NODE_167668_length_301_cov_1.148515	161	209	1	48	48	1.0000000
NODE_167880_length_301_cov_0.980198	242	297	0	55	55	1.0000000
NODE_167891_length_301_cov_0.960396	22	63	0	41	41	1.0000000
NODE_168253_length_300_cov_3.402985	44	124	0	80	80	1.0000000
NODE_168253_length_300_cov_3.402985	97	177	0	80	80	1.0000000
NODE_168253_length_300_cov_3.402985	173	254	0	81	81	1.0000000
NODE_168253_length_300_cov_3.402985	233	300	0	67	67	1.0000000
NODE_168265_length_300_cov_3.298507	18	98	0	80	80	1.0000000
NODE_168360_length_300_cov_2.597015	110	182	12	1	72	0.0138889
NODE_168360_length_300_cov_2.597015	110	182	16	71	72	0.9861111
NODE_168363_length_300_cov_2.572139	28	102	0	55	74	0.7432432
NODE_168363_length_300_cov_2.572139	28	102	2	19	74	0.2567568
NODE_168363_length_300_cov_2.572139	75	141	0	8	66	0.1212121
NODE_168363_length_300_cov_2.572139	75	141	2	58	66	0.8787879
NODE_168402_length_300_cov_2.417910	0	44	0	44	44	1.0000000
NODE_168459_length_300_cov_2.174129	117	197	1	28	80	0.3500000
NODE_168459_length_300_cov_2.174129	117	197	2	52	80	0.6500000
NODE_168459_length_300_cov_2.174129	170	250	0	46	80	0.5750000
NODE_168459_length_300_cov_2.174129	170	250	1	34	80	0.4250000
NODE_168459_length_300_cov_2.174129	216	296	0	80	80	1.0000000
NODE_168462_length_300_cov_2.164179	122	141	2	1	19	0.0526316
NODE_168462_length_300_cov_2.164179	122	141	4	18	19	0.9473684
NODE_168479_length_300_cov_2.079602	127	207	0	80	80	1.0000000
NODE_168479_length_300_cov_2.079602	203	273	0	70	70	1.0000000
NODE_168541_length_300_cov_1.965174	15	86	0	71	71	1.0000000
NODE_168656_length_300_cov_1.731343	31	88	0	57	57	1.0000000
NODE_168906_length_300_cov_1.268657	62	98	0	36	36	1.0000000
NODE_168906_length_300_cov_1.268657	151	186	0	35	35	1.0000000
NODE_169014_length_300_cov_1.104478	86	165	0	7	79	0.0886076
NODE_169014_length_300_cov_1.104478	86	165	2	72	79	0.9113924
NODE_169053_length_300_cov_1.029851	110	177	0	67	67	1.0000000
NODE_169053_length_300_cov_1.029851	120	177	0	57	57	1.0000000
NODE_169378_length_300_cov_0.716418	191	210	0	19	19	1.0000000
NODE_169528_length_299_cov_4.435000	48	128	0	80	80	1.0000000
NODE_169528_length_299_cov_4.435000	101	167	0	66	66	1.0000000
NODE_169567_length_299_cov_3.780000	114	181	0	67	67	1.0000000
NODE_169631_length_299_cov_3.095000	0	73	0	73	73	1.0000000
NODE_169631_length_299_cov_3.095000	0	20	0	20	20	1.0000000
NODE_169725_length_299_cov_2.495000	46	126	0	80	80	1.0000000
NODE_169725_length_299_cov_2.495000	99	179	0	80	80	1.0000000
NODE_169769_length_299_cov_2.275000	127	192	3	17	65	0.2615385
NODE_169769_length_299_cov_2.275000	127	192	4	48	65	0.7384616
NODE_169781_length_299_cov_2.250000	72	135	0	63	63	1.0000000
NODE_169781_length_299_cov_2.250000	108	188	0	80	80	1.0000000
NODE_169811_length_299_cov_2.090000	25	105	0	80	80	1.0000000
NODE_169888_length_299_cov_1.955000	173	214	0	37	41	0.9024390
NODE_169888_length_299_cov_1.955000	173	214	2	4	41	0.0975610
NODE_169888_length_299_cov_1.955000	187	227	0	40	40	1.0000000
NODE_169916_length_299_cov_1.885000	29	109	0	80	80	1.0000000
NODE_169920_length_299_cov_1.880000	204	236	1	32	32	1.0000000
NODE_169938_length_299_cov_1.840000	154	190	0	36	36	1.0000000
NODE_169995_length_299_cov_1.710000	211	291	1	80	80	1.0000000
NODE_170048_length_299_cov_1.550000	174	205	0	31	31	1.0000000
NODE_170501_length_299_cov_1.020000	42	115	3	32	73	0.4383562
NODE_170501_length_299_cov_1.020000	42	115	4	41	73	0.5616438
NODE_170546_length_299_cov_1.020000	132	175	0	43	43	1.0000000
NODE_170620_length_299_cov_0.935000	173	216	0	43	43	1.0000000
NODE_170691_length_299_cov_0.765000	86	128	0	13	42	0.3095238
NODE_170691_length_299_cov_0.765000	86	128	1	25	42	0.5952381
NODE_170691_length_299_cov_0.765000	86	128	2	4	42	0.0952381
NODE_170887_length_298_cov_20.894472	70	150	0	15	80	0.1875000
NODE_170887_length_298_cov_20.894472	70	150	2	16	80	0.2000000
NODE_170887_length_298_cov_20.894472	70	150	3	1	80	0.0125000
NODE_170887_length_298_cov_20.894472	70	150	4	48	80	0.6000000
NODE_170887_length_298_cov_20.894472	123	203	4	80	80	1.0000000
NODE_170888_length_298_cov_13.859296	228	298	4	1	70	0.0142857
NODE_170888_length_298_cov_13.859296	228	298	5	1	70	0.0142857
NODE_170888_length_298_cov_13.859296	228	298	6	10	70	0.1428571
NODE_170888_length_298_cov_13.859296	228	298	7	3	70	0.0428571
NODE_170888_length_298_cov_13.859296	228	298	9	6	70	0.0857143
NODE_170888_length_298_cov_13.859296	228	298	10	5	70	0.0714286
NODE_170888_length_298_cov_13.859296	228	298	11	1	70	0.0142857
NODE_170888_length_298_cov_13.859296	228	298	12	4	70	0.0571429
NODE_170888_length_298_cov_13.859296	228	298	13	33	70	0.4714286
NODE_170888_length_298_cov_13.859296	228	298	14	6	70	0.0857143
NODE_170909_length_298_cov_5.859296	1	65	0	36	64	0.5625000
NODE_170909_length_298_cov_5.859296	1	65	2	28	64	0.4375000
NODE_170909_length_298_cov_5.859296	38	118	2	80	80	1.0000000
NODE_170909_length_298_cov_5.859296	114	194	2	67	80	0.8375000
NODE_170909_length_298_cov_5.859296	114	194	4	13	80	0.1625000
NODE_170909_length_298_cov_5.859296	167	238	2	14	71	0.1971831
NODE_170909_length_298_cov_5.859296	167	238	4	57	71	0.8028169
NODE_170964_length_298_cov_3.829146	80	160	10	18	80	0.2250000
NODE_170964_length_298_cov_3.829146	80	160	12	10	80	0.1250000
NODE_170964_length_298_cov_3.829146	80	160	14	29	80	0.3625000
NODE_170964_length_298_cov_3.829146	80	160	15	9	80	0.1125000
NODE_170964_length_298_cov_3.829146	80	160	16	14	80	0.1750000
NODE_170964_length_298_cov_3.829146	133	213	7	5	80	0.0625000
NODE_170964_length_298_cov_3.829146	133	213	8	3	80	0.0375000
NODE_170964_length_298_cov_3.829146	133	213	9	11	80	0.1375000
NODE_170964_length_298_cov_3.829146	133	213	10	5	80	0.0625000
NODE_170964_length_298_cov_3.829146	133	213	14	12	80	0.1500000
NODE_170964_length_298_cov_3.829146	133	213	15	6	80	0.0750000
NODE_170964_length_298_cov_3.829146	133	213	16	24	80	0.3000000
NODE_170964_length_298_cov_3.829146	133	213	17	14	80	0.1750000
NODE_170968_length_298_cov_3.733668	203	283	0	80	80	1.0000000
NODE_170972_length_298_cov_3.673367	117	175	0	58	58	1.0000000
NODE_171043_length_298_cov_2.924623	159	239	0	41	80	0.5125000
NODE_171043_length_298_cov_2.924623	159	239	2	37	80	0.4625000
NODE_171043_length_298_cov_2.924623	159	239	4	2	80	0.0250000
NODE_171043_length_298_cov_2.924623	212	265	0	53	53	1.0000000
NODE_171047_length_298_cov_2.854271	50	120	0	70	70	1.0000000
NODE_171082_length_298_cov_2.663317	87	167	0	80	80	1.0000000
NODE_171082_length_298_cov_2.663317	140	192	0	52	52	1.0000000
NODE_171191_length_298_cov_2.201005	112	166	0	54	54	1.0000000
NODE_171210_length_298_cov_2.120603	135	166	0	31	31	1.0000000
NODE_171226_length_298_cov_2.055276	69	132	0	63	63	1.0000000
NODE_171286_length_298_cov_2.025126	21	92	0	71	71	1.0000000
NODE_171356_length_298_cov_1.798995	0	67	0	67	67	1.0000000
NODE_171356_length_298_cov_1.798995	40	106	0	66	66	1.0000000
NODE_171391_length_298_cov_1.788945	140	197	0	20	57	0.3508772
NODE_171391_length_298_cov_1.788945	140	197	1	37	57	0.6491228
NODE_171415_length_298_cov_1.733668	56	91	2	13	35	0.3714286
NODE_171415_length_298_cov_1.733668	56	91	4	22	35	0.6285715
NODE_171415_length_298_cov_1.733668	118	172	4	54	54	1.0000000
NODE_171505_length_298_cov_1.537688	101	154	0	53	53	1.0000000
NODE_172083_length_298_cov_0.829146	34	96	0	62	62	1.0000000
NODE_172330_length_297_cov_6.525253	100	122	2	22	22	1.0000000
NODE_172352_length_297_cov_4.888889	150	218	0	68	68	1.0000000
NODE_172356_length_297_cov_4.671717	56	120	0	64	64	1.0000000
NODE_172422_length_297_cov_3.338384	96	176	1	80	80	1.0000000
NODE_172422_length_297_cov_3.338384	149	198	0	10	49	0.2040816
NODE_172422_length_297_cov_3.338384	149	198	1	39	49	0.7959183
NODE_172447_length_297_cov_3.040404	0	55	0	55	55	1.0000000
NODE_172447_length_297_cov_3.040404	14	55	0	41	41	1.0000000
NODE_172447_length_297_cov_3.040404	65	119	0	54	54	1.0000000
NODE_172574_length_297_cov_2.308081	8	70	0	62	62	1.0000000
NODE_172606_length_297_cov_2.196970	219	259	10	2	40	0.0500000
NODE_172606_length_297_cov_2.196970	219	259	11	5	40	0.1250000
NODE_172606_length_297_cov_2.196970	219	259	13	3	40	0.0750000
NODE_172606_length_297_cov_2.196970	219	259	14	4	40	0.1000000
NODE_172606_length_297_cov_2.196970	219	259	16	4	40	0.1000000
NODE_172606_length_297_cov_2.196970	219	259	18	4	40	0.1000000
NODE_172606_length_297_cov_2.196970	219	259	20	18	40	0.4500000
NODE_172629_length_297_cov_2.106061	81	161	0	39	80	0.4875000
NODE_172629_length_297_cov_2.106061	81	161	2	41	80	0.5125000
NODE_172629_length_297_cov_2.106061	134	178	0	44	44	1.0000000
NODE_172668_length_297_cov_2.060606	46	76	0	30	30	1.0000000
NODE_172697_length_297_cov_2.010101	9	85	0	7	76	0.0921053
NODE_172697_length_297_cov_2.010101	9	85	2	2	76	0.0263158
NODE_172697_length_297_cov_2.010101	9	85	4	67	76	0.8815789
NODE_172783_length_297_cov_1.777778	168	208	2	40	40	1.0000000
NODE_172855_length_297_cov_1.595960	175	255	4	10	80	0.1250000
NODE_172855_length_297_cov_1.595960	175	255	6	7	80	0.0875000
NODE_172855_length_297_cov_1.595960	175	255	7	26	80	0.3250000
NODE_172855_length_297_cov_1.595960	175	255	9	2	80	0.0250000
NODE_172855_length_297_cov_1.595960	175	255	11	10	80	0.1250000
NODE_172855_length_297_cov_1.595960	175	255	12	25	80	0.3125000
NODE_172862_length_297_cov_1.570707	100	177	0	77	77	1.0000000
NODE_172863_length_297_cov_1.570707	194	275	2	17	81	0.2098765
NODE_172863_length_297_cov_1.570707	194	275	3	64	81	0.7901235
NODE_173063_length_297_cov_1.338384	140	199	0	59	59	1.0000000
NODE_173136_length_297_cov_1.277778	39	115	0	61	76	0.8026316
NODE_173136_length_297_cov_1.277778	39	115	2	15	76	0.1973684
NODE_173176_length_297_cov_1.196970	7	87	0	80	80	1.0000000
NODE_173176_length_297_cov_1.196970	60	116	0	56	56	1.0000000
NODE_173345_length_297_cov_1.030303	0	33	0	13	33	0.3939394
NODE_173345_length_297_cov_1.030303	0	33	1	20	33	0.6060606
NODE_173467_length_297_cov_0.888889	109	172	0	21	63	0.3333333
NODE_173467_length_297_cov_0.888889	109	172	2	42	63	0.6666667
NODE_173520_length_297_cov_0.782828	24	104	0	80	80	1.0000000
NODE_173708_length_296_cov_41.390863	189	260	4	26	71	0.3661972
NODE_173708_length_296_cov_41.390863	189	260	5	16	71	0.2253521
NODE_173708_length_296_cov_41.390863	189	260	7	4	71	0.0563380
NODE_173708_length_296_cov_41.390863	189	260	9	25	71	0.3521127
NODE_173709_length_296_cov_34.776650	214	294	0	80	80	1.0000000
NODE_173758_length_296_cov_4.243655	14	54	1	14	40	0.3500000
NODE_173758_length_296_cov_4.243655	14	54	2	26	40	0.6500000
NODE_173773_length_296_cov_3.954315	120	200	0	80	80	1.0000000
NODE_173787_length_296_cov_3.736041	6	46	0	40	40	1.0000000
NODE_173797_length_296_cov_3.619289	193	251	0	58	58	1.0000000
NODE_173797_length_296_cov_3.619289	246	296	0	50	50	1.0000000
NODE_173859_length_296_cov_3.015228	177	257	0	80	80	1.0000000
NODE_173992_length_296_cov_2.309645	5	77	0	5	72	0.0694444
NODE_173992_length_296_cov_2.309645	5	77	2	67	72	0.9305556
NODE_173992_length_296_cov_2.309645	50	130	2	80	80	1.0000000
NODE_174040_length_296_cov_2.081218	90	139	0	5	49	0.1020408
NODE_174040_length_296_cov_2.081218	90	139	1	44	49	0.8979592
NODE_174167_length_296_cov_1.807107	199	246	0	47	47	1.0000000
NODE_174167_length_296_cov_1.807107	219	296	0	77	77	1.0000000
NODE_174213_length_296_cov_1.670051	28	103	1	75	75	1.0000000
NODE_174274_length_296_cov_1.553299	102	179	0	71	77	0.9220779
NODE_174274_length_296_cov_1.553299	102	179	1	6	77	0.0779221
NODE_174274_length_296_cov_1.553299	160	179	0	13	19	0.6842105
NODE_174274_length_296_cov_1.553299	160	179	1	6	19	0.3157895
NODE_174438_length_296_cov_1.319797	82	162	0	55	80	0.6875000
NODE_174438_length_296_cov_1.319797	82	162	2	19	80	0.2375000
NODE_174438_length_296_cov_1.319797	82	162	4	6	80	0.0750000
NODE_174438_length_296_cov_1.319797	135	205	0	2	70	0.0285714
NODE_174438_length_296_cov_1.319797	135	205	2	19	70	0.2714286
NODE_174438_length_296_cov_1.319797	135	205	4	49	70	0.7000000
NODE_174545_length_296_cov_1.258883	222	280	0	58	58	1.0000000
NODE_174554_length_296_cov_1.238579	90	147	0	57	57	1.0000000
NODE_174614_length_296_cov_1.116751	130	169	2	1	39	0.0256410
NODE_174614_length_296_cov_1.116751	130	169	3	10	39	0.2564103
NODE_174614_length_296_cov_1.116751	130	169	5	28	39	0.7179487
NODE_175210_length_295_cov_4.290816	2	70	0	68	68	1.0000000
NODE_175210_length_295_cov_4.290816	55	123	0	68	68	1.0000000
NODE_175220_length_295_cov_4.040816	119	165	0	46	46	1.0000000
NODE_175258_length_295_cov_3.576531	130	198	0	68	68	1.0000000
NODE_175324_length_295_cov_2.918367	0	77	0	77	77	1.0000000
NODE_175416_length_295_cov_2.454082	216	277	3	61	61	1.0000000
NODE_175475_length_295_cov_2.224490	11	91	0	5	80	0.0625000
NODE_175475_length_295_cov_2.224490	11	91	2	5	80	0.0625000
NODE_175475_length_295_cov_2.224490	11	91	4	15	80	0.1875000
NODE_175475_length_295_cov_2.224490	11	91	6	55	80	0.6875000
NODE_175483_length_295_cov_2.183673	93	151	2	14	58	0.2413793
NODE_175483_length_295_cov_2.183673	93	151	3	9	58	0.1551724
NODE_175483_length_295_cov_2.183673	93	151	5	35	58	0.6034483
NODE_175483_length_295_cov_2.183673	124	204	3	57	80	0.7125000
NODE_175483_length_295_cov_2.183673	124	204	5	23	80	0.2875000
NODE_175597_length_295_cov_1.867347	191	239	2	48	48	1.0000000
NODE_175598_length_295_cov_1.862245	225	285	0	60	60	1.0000000
NODE_175721_length_295_cov_1.596939	173	254	0	81	81	1.0000000
NODE_175804_length_295_cov_1.520408	217	282	0	65	65	1.0000000
NODE_175930_length_295_cov_1.301020	99	121	0	22	22	1.0000000
NODE_176250_length_295_cov_0.938776	200	247	0	47	47	1.0000000
NODE_176367_length_295_cov_0.780612	24	44	0	20	20	1.0000000
NODE_176436_length_295_cov_0.724490	6	87	0	38	81	0.4691358
NODE_176436_length_295_cov_0.724490	6	87	1	22	81	0.2716049
NODE_176436_length_295_cov_0.724490	6	87	2	16	81	0.1975309
NODE_176436_length_295_cov_0.724490	6	87	3	5	81	0.0617284
NODE_176436_length_295_cov_0.724490	83	163	3	80	80	1.0000000
NODE_176436_length_295_cov_0.724490	136	216	2	21	80	0.2625000
NODE_176436_length_295_cov_0.724490	136	216	3	59	80	0.7375000
NODE_176547_length_294_cov_83.882051	143	173	0	30	30	1.0000000
NODE_176547_length_294_cov_83.882051	209	239	0	30	30	1.0000000
NODE_176549_length_294_cov_50.589744	187	258	8	4	71	0.0563380
NODE_176549_length_294_cov_50.589744	187	258	9	11	71	0.1549296
NODE_176549_length_294_cov_50.589744	187	258	12	2	71	0.0281690
NODE_176549_length_294_cov_50.589744	187	258	13	2	71	0.0281690
NODE_176549_length_294_cov_50.589744	187	258	15	2	71	0.0281690
NODE_176549_length_294_cov_50.589744	187	258	17	2	71	0.0281690
NODE_176549_length_294_cov_50.589744	187	258	18	4	71	0.0563380
NODE_176549_length_294_cov_50.589744	187	258	19	3	71	0.0422535
NODE_176549_length_294_cov_50.589744	187	258	20	8	71	0.1126761
NODE_176549_length_294_cov_50.589744	187	258	21	4	71	0.0563380
NODE_176549_length_294_cov_50.589744	187	258	23	1	71	0.0140845
NODE_176549_length_294_cov_50.589744	187	258	24	9	71	0.1267606
NODE_176549_length_294_cov_50.589744	187	258	25	10	71	0.1408451
NODE_176549_length_294_cov_50.589744	187	258	26	6	71	0.0845070
NODE_176549_length_294_cov_50.589744	187	258	28	1	71	0.0140845
NODE_176549_length_294_cov_50.589744	187	258	30	1	71	0.0140845
NODE_176549_length_294_cov_50.589744	187	258	32	1	71	0.0140845
NODE_176561_length_294_cov_6.676923	61	138	0	77	77	1.0000000
NODE_176596_length_294_cov_4.538462	127	214	0	17	87	0.1954023
NODE_176596_length_294_cov_4.538462	127	214	2	70	87	0.8045977
NODE_176598_length_294_cov_4.512821	218	248	0	30	30	1.0000000
NODE_176600_length_294_cov_4.497436	159	200	0	41	41	1.0000000
NODE_176697_length_294_cov_2.953846	114	194	0	80	80	1.0000000
NODE_176727_length_294_cov_2.764103	103	183	2	80	80	1.0000000
NODE_176727_length_294_cov_2.764103	156	236	1	9	80	0.1125000
NODE_176727_length_294_cov_2.764103	156	236	2	71	80	0.8875000
NODE_176728_length_294_cov_2.764103	224	282	2	58	58	1.0000000
NODE_176728_length_294_cov_2.764103	225	277	2	52	52	1.0000000
NODE_176735_length_294_cov_2.697436	204	261	0	57	57	1.0000000
NODE_176735_length_294_cov_2.697436	234	294	0	60	60	1.0000000
NODE_176779_length_294_cov_2.517949	23	85	0	62	62	1.0000000
NODE_176816_length_294_cov_2.353846	129	167	0	38	38	1.0000000
NODE_176833_length_294_cov_2.338462	133	213	0	80	80	1.0000000
NODE_176943_length_294_cov_2.046154	219	269	0	50	50	1.0000000
NODE_176957_length_294_cov_2.010256	191	235	0	44	44	1.0000000
NODE_176999_length_294_cov_1.902564	52	83	0	31	31	1.0000000
NODE_177102_length_294_cov_1.692308	46	112	1	66	66	1.0000000
NODE_177187_length_294_cov_1.569231	49	95	3	46	46	1.0000000
NODE_177252_length_294_cov_1.482051	28	108	0	80	80	1.0000000
NODE_177252_length_294_cov_1.482051	201	281	0	80	80	1.0000000
NODE_177252_length_294_cov_1.482051	201	281	0	80	80	1.0000000
NODE_177298_length_294_cov_1.420513	216	262	0	46	46	1.0000000
NODE_177298_length_294_cov_1.420513	235	294	0	59	59	1.0000000
NODE_177972_length_294_cov_0.666667	245	293	0	48	48	1.0000000
NODE_178066_length_293_cov_6.257732	167	247	0	80	80	1.0000000
NODE_178161_length_293_cov_3.567010	50	130	0	80	80	1.0000000
NODE_178226_length_293_cov_2.907216	218	281	0	63	63	1.0000000
NODE_178246_length_293_cov_2.768041	95	175	0	20	80	0.2500000
NODE_178246_length_293_cov_2.768041	95	175	2	60	80	0.7500000
NODE_178246_length_293_cov_2.768041	148	228	2	80	80	1.0000000
NODE_178268_length_293_cov_2.628866	207	266	0	9	59	0.1525424
NODE_178268_length_293_cov_2.628866	207	266	2	50	59	0.8474576
NODE_178277_length_293_cov_2.623711	182	223	1	41	41	1.0000000
NODE_178299_length_293_cov_2.561856	139	192	0	53	53	1.0000000
NODE_178299_length_293_cov_2.561856	177	223	0	46	46	1.0000000
NODE_178317_length_293_cov_2.448454	98	158	4	3	60	0.0500000
NODE_178317_length_293_cov_2.448454	98	158	5	57	60	0.9500000
NODE_178351_length_293_cov_2.335052	62	91	0	29	29	1.0000000
NODE_178357_length_293_cov_2.314433	35	89	0	54	54	1.0000000
NODE_178523_length_293_cov_1.840206	27	107	0	80	80	1.0000000
NODE_178523_length_293_cov_1.840206	80	160	0	80	80	1.0000000
NODE_178560_length_293_cov_1.804124	144	173	7	1	29	0.0344828
NODE_178560_length_293_cov_1.804124	144	173	8	28	29	0.9655172
NODE_178570_length_293_cov_1.778351	224	258	0	34	34	1.0000000
NODE_178646_length_293_cov_1.577320	158	177	0	19	19	1.0000000
NODE_178692_length_293_cov_1.577320	161	225	0	64	64	1.0000000
NODE_178693_length_293_cov_1.577320	15	55	0	40	40	1.0000000
NODE_178788_length_293_cov_1.402062	3	72	0	69	69	1.0000000
NODE_178822_length_293_cov_1.319588	202	268	0	66	66	1.0000000
NODE_178927_length_293_cov_1.226804	84	141	0	57	57	1.0000000
NODE_179542_length_292_cov_4.523316	240	290	0	50	50	1.0000000
NODE_179552_length_292_cov_4.145078	106	186	0	22	80	0.2750000
NODE_179552_length_292_cov_4.145078	106	186	2	58	80	0.7250000
NODE_179604_length_292_cov_3.502591	129	205	0	12	76	0.1578947
NODE_179604_length_292_cov_3.502591	129	205	2	33	76	0.4342105
NODE_179604_length_292_cov_3.502591	129	205	4	31	76	0.4078947
NODE_179613_length_292_cov_3.435233	176	200	0	24	24	1.0000000
NODE_179621_length_292_cov_3.341969	70	150	0	80	80	1.0000000
NODE_179621_length_292_cov_3.341969	118	175	0	57	57	1.0000000
NODE_179627_length_292_cov_3.222798	47	127	0	80	80	1.0000000
NODE_179627_length_292_cov_3.222798	100	129	0	29	29	1.0000000
NODE_179819_length_292_cov_2.238342	211	290	0	79	79	1.0000000
NODE_179943_length_292_cov_1.865285	34	114	1	1	80	0.0125000
NODE_179943_length_292_cov_1.865285	34	114	2	5	80	0.0625000
NODE_179943_length_292_cov_1.865285	34	114	3	9	80	0.1125000
NODE_179943_length_292_cov_1.865285	34	114	4	64	80	0.8000000
NODE_179943_length_292_cov_1.865285	34	114	5	1	80	0.0125000
NODE_179943_length_292_cov_1.865285	87	167	3	8	80	0.1000000
NODE_179943_length_292_cov_1.865285	87	167	4	18	80	0.2250000
NODE_179943_length_292_cov_1.865285	87	167	5	54	80	0.6750000
NODE_180013_length_292_cov_1.761658	174	254	0	80	80	1.0000000
NODE_180029_length_292_cov_1.699482	0	80	0	80	80	1.0000000
NODE_180068_length_292_cov_1.611399	89	157	0	68	68	1.0000000
NODE_180210_length_292_cov_1.455959	72	115	2	3	43	0.0697674
NODE_180210_length_292_cov_1.455959	72	115	4	40	43	0.9302326
NODE_180210_length_292_cov_1.455959	203	265	0	62	62	1.0000000
NODE_180302_length_292_cov_1.321244	102	182	0	80	80	1.0000000
NODE_180302_length_292_cov_1.321244	155	217	0	62	62	1.0000000
NODE_180968_length_291_cov_45.031250	71	145	3	74	74	1.0000000
NODE_180968_length_291_cov_45.031250	71	145	3	74	74	1.0000000
NODE_180968_length_291_cov_45.031250	118	184	0	20	66	0.3030303
NODE_180968_length_291_cov_45.031250	118	184	1	9	66	0.1363636
NODE_180968_length_291_cov_45.031250	118	184	3	37	66	0.5606061
NODE_180969_length_291_cov_14.791667	125	205	0	19	80	0.2375000
NODE_180969_length_291_cov_14.791667	125	205	1	2	80	0.0250000
NODE_180969_length_291_cov_14.791667	125	205	2	5	80	0.0625000
NODE_180969_length_291_cov_14.791667	125	205	4	54	80	0.6750000
NODE_180969_length_291_cov_14.791667	178	258	0	72	80	0.9000000
NODE_180969_length_291_cov_14.791667	178	258	1	2	80	0.0250000
NODE_180969_length_291_cov_14.791667	178	258	2	5	80	0.0625000
NODE_180969_length_291_cov_14.791667	178	258	4	1	80	0.0125000
NODE_180983_length_291_cov_5.536458	97	169	0	72	72	1.0000000
NODE_180986_length_291_cov_5.401042	77	130	0	20	53	0.3773585
NODE_180986_length_291_cov_5.401042	77	130	2	33	53	0.6226415
NODE_180998_length_291_cov_4.859375	185	257	0	72	72	1.0000000
NODE_181043_length_291_cov_3.723958	196	276	0	5	80	0.0625000
NODE_181043_length_291_cov_3.723958	196	276	1	1	80	0.0125000
NODE_181043_length_291_cov_3.723958	196	276	2	74	80	0.9250000
NODE_181057_length_291_cov_3.531250	129	152	0	23	23	1.0000000
NODE_181191_length_291_cov_2.390625	18	80	0	62	62	1.0000000
NODE_181272_length_291_cov_2.125000	70	117	0	47	47	1.0000000
NODE_181391_length_291_cov_1.859375	197	228	0	31	31	1.0000000
NODE_181497_length_291_cov_1.593750	144	175	0	31	31	1.0000000
NODE_181530_length_291_cov_1.593750	206	281	0	75	75	1.0000000
NODE_181599_length_291_cov_1.552083	189	269	0	80	80	1.0000000
NODE_181615_length_291_cov_1.520833	180	258	0	78	78	1.0000000
NODE_181623_length_291_cov_1.510417	245	291	0	46	46	1.0000000
NODE_181696_length_291_cov_1.385417	80	120	0	40	40	1.0000000
NODE_181791_length_291_cov_1.322917	70	96	0	7	26	0.2692308
NODE_181791_length_291_cov_1.322917	70	96	1	19	26	0.7307692
NODE_181799_length_291_cov_1.307292	108	188	0	29	80	0.3625000
NODE_181799_length_291_cov_1.307292	108	188	1	51	80	0.6375000
NODE_181907_length_291_cov_1.114583	79	174	2	11	95	0.1157895
NODE_181907_length_291_cov_1.114583	79	174	3	23	95	0.2421053
NODE_181907_length_291_cov_1.114583	79	174	5	23	95	0.2421053
NODE_181907_length_291_cov_1.114583	79	174	6	38	95	0.4000000
NODE_181930_length_291_cov_1.078125	4	85	0	34	81	0.4197531
NODE_181930_length_291_cov_1.078125	4	85	1	9	81	0.1111111
NODE_181930_length_291_cov_1.078125	4	85	2	22	81	0.2716049
NODE_181930_length_291_cov_1.078125	4	85	3	16	81	0.1975309
NODE_182112_length_291_cov_1.031250	5	50	0	45	45	1.0000000
NODE_182205_length_291_cov_0.890625	0	55	0	55	55	1.0000000
NODE_182252_length_291_cov_0.802083	80	160	0	8	80	0.1000000
NODE_182252_length_291_cov_0.802083	80	160	1	24	80	0.3000000
NODE_182252_length_291_cov_0.802083	80	160	2	48	80	0.6000000
NODE_182491_length_290_cov_96.963351	44	124	4	16	80	0.2000000
NODE_182491_length_290_cov_96.963351	44	124	6	64	80	0.8000000
NODE_182491_length_290_cov_96.963351	97	177	2	6	80	0.0750000
NODE_182491_length_290_cov_96.963351	97	177	4	1	80	0.0125000
NODE_182491_length_290_cov_96.963351	97	177	6	73	80	0.9125000
NODE_182512_length_290_cov_5.968586	89	150	0	61	61	1.0000000
NODE_182512_length_290_cov_5.968586	142	203	0	61	61	1.0000000
NODE_182535_length_290_cov_4.968586	32	52	0	20	20	1.0000000
NODE_182535_length_290_cov_4.968586	73	93	0	20	20	1.0000000
NODE_182547_length_290_cov_4.670157	63	139	0	76	76	1.0000000
NODE_182550_length_290_cov_4.575916	110	153	0	43	43	1.0000000
NODE_182589_length_290_cov_3.816754	113	186	0	73	73	1.0000000
NODE_182607_length_290_cov_3.612565	114	181	2	67	67	1.0000000
NODE_182622_length_290_cov_3.445026	91	150	1	33	59	0.5593221
NODE_182622_length_290_cov_3.445026	91	150	2	4	59	0.0677966
NODE_182622_length_290_cov_3.445026	91	150	3	22	59	0.3728814
NODE_182772_length_290_cov_2.596859	189	218	1	7	29	0.2413793
NODE_182772_length_290_cov_2.596859	189	218	2	22	29	0.7586207
NODE_182844_length_290_cov_2.319372	45	74	0	29	29	1.0000000
NODE_182973_length_290_cov_2.041885	59	139	0	5	80	0.0625000
NODE_182973_length_290_cov_2.041885	59	139	2	75	80	0.9375000
NODE_182995_length_290_cov_1.979058	229	271	6	42	42	1.0000000
NODE_183288_length_290_cov_1.602094	16	68	0	52	52	1.0000000
NODE_183347_length_290_cov_1.575916	173	250	0	77	77	1.0000000
NODE_183373_length_290_cov_1.544503	151	203	0	52	52	1.0000000
NODE_183403_length_290_cov_1.513089	22	107	0	30	85	0.3529412
NODE_183403_length_290_cov_1.513089	22	107	2	55	85	0.6470588
NODE_183436_length_290_cov_1.460733	11	91	0	80	80	1.0000000
NODE_183546_length_290_cov_1.335079	91	163	0	72	72	1.0000000
NODE_183546_length_290_cov_1.335079	144	216	0	72	72	1.0000000
NODE_183642_length_290_cov_1.314136	0	80	0	80	80	1.0000000
NODE_183663_length_290_cov_1.287958	17	97	0	80	80	1.0000000
NODE_183946_length_290_cov_1.068063	0	60	0	60	60	1.0000000
NODE_183946_length_290_cov_1.068063	33	113	0	80	80	1.0000000
NODE_184119_length_290_cov_1.000000	198	254	16	2	56	0.0357143
NODE_184119_length_290_cov_1.000000	198	254	18	1	56	0.0178571
NODE_184119_length_290_cov_1.000000	198	254	21	53	56	0.9464286
NODE_184326_length_290_cov_0.832461	154	236	0	82	82	1.0000000
NODE_184585_length_290_cov_0.701571	201	281	0	80	80	1.0000000
NODE_184716_length_289_cov_554.947368	45	125	28	1	80	0.0125000
NODE_184716_length_289_cov_554.947368	45	125	31	5	80	0.0625000
NODE_184716_length_289_cov_554.947368	45	125	32	3	80	0.0375000
NODE_184716_length_289_cov_554.947368	45	125	33	16	80	0.2000000
NODE_184716_length_289_cov_554.947368	45	125	35	55	80	0.6875000
NODE_184729_length_289_cov_7.436842	181	229	0	48	48	1.0000000
NODE_184745_length_289_cov_5.789474	35	100	0	65	65	1.0000000
NODE_184745_length_289_cov_5.789474	85	153	0	68	68	1.0000000
NODE_184745_length_289_cov_5.789474	146	181	0	35	35	1.0000000
NODE_184781_length_289_cov_4.515789	192	254	0	62	62	1.0000000
NODE_184806_length_289_cov_4.136842	101	148	0	47	47	1.0000000
NODE_184892_length_289_cov_2.973684	38	83	0	45	45	1.0000000
NODE_184960_length_289_cov_2.678947	105	168	0	63	63	1.0000000
NODE_184960_length_289_cov_2.678947	158	204	0	46	46	1.0000000
NODE_184963_length_289_cov_2.673684	216	263	0	47	47	1.0000000
NODE_185036_length_289_cov_2.378947	233	289	0	56	56	1.0000000
NODE_185152_length_289_cov_2.089474	26	91	0	65	65	1.0000000
NODE_185213_length_289_cov_1.921053	0	54	0	54	54	1.0000000
NODE_185383_length_289_cov_1.642105	58	123	0	65	65	1.0000000
NODE_185570_length_289_cov_1.547368	81	124	0	43	43	1.0000000
NODE_185617_length_289_cov_1.489474	192	274	0	82	82	1.0000000
NODE_185622_length_289_cov_1.484211	50	69	2	19	19	1.0000000
NODE_185708_length_289_cov_1.357895	31	74	0	43	43	1.0000000
NODE_185852_length_289_cov_1.278947	239	270	0	31	31	1.0000000
NODE_185864_length_289_cov_1.252632	23	66	0	43	43	1.0000000
NODE_185926_length_289_cov_1.168421	40	100	0	60	60	1.0000000
NODE_185937_length_289_cov_1.152632	0	50	0	50	50	1.0000000
NODE_185937_length_289_cov_1.152632	41	103	0	62	62	1.0000000
NODE_186095_length_289_cov_1.073684	152	198	0	46	46	1.0000000
NODE_186491_length_289_cov_0.878947	113	193	0	9	80	0.1125000
NODE_186491_length_289_cov_0.878947	113	193	2	9	80	0.1125000
NODE_186491_length_289_cov_0.878947	113	193	4	62	80	0.7750000
NODE_186491_length_289_cov_0.878947	166	246	0	4	80	0.0500000
NODE_186491_length_289_cov_0.878947	166	246	2	12	80	0.1500000
NODE_186491_length_289_cov_0.878947	166	246	4	64	80	0.8000000
NODE_186507_length_289_cov_0.863158	116	211	0	11	95	0.1157895
NODE_186507_length_289_cov_0.863158	116	211	2	38	95	0.4000000
NODE_186507_length_289_cov_0.863158	116	211	4	46	95	0.4842105
NODE_186515_length_289_cov_0.857895	6	75	0	69	69	1.0000000
NODE_186547_length_289_cov_0.831579	230	289	0	59	59	1.0000000
NODE_186631_length_289_cov_0.805263	98	159	2	57	61	0.9344262
NODE_186631_length_289_cov_0.805263	98	159	3	4	61	0.0655738
NODE_186865_length_289_cov_0.568421	141	213	0	72	72	1.0000000
NODE_186934_length_288_cov_11.089947	135	195	0	42	60	0.7000000
NODE_186934_length_288_cov_11.089947	135	195	1	18	60	0.3000000
NODE_187025_length_288_cov_3.587302	108	188	0	80	80	1.0000000
NODE_187049_length_288_cov_3.296296	61	125	0	64	64	1.0000000
NODE_187049_length_288_cov_3.296296	102	178	0	76	76	1.0000000
NODE_187062_length_288_cov_3.206349	149	202	0	53	53	1.0000000
NODE_187170_length_288_cov_2.539683	4	68	4	2	64	0.0312500
NODE_187170_length_288_cov_2.539683	4	68	6	1	64	0.0156250
NODE_187170_length_288_cov_2.539683	4	68	8	61	64	0.9531250
NODE_187187_length_288_cov_2.465608	137	182	1	45	45	1.0000000
NODE_187191_length_288_cov_2.449735	216	278	0	62	62	1.0000000
NODE_187191_length_288_cov_2.449735	237	273	0	36	36	1.0000000
NODE_187248_length_288_cov_2.275132	10	46	0	36	36	1.0000000
NODE_187248_length_288_cov_2.275132	13	86	0	73	73	1.0000000
NODE_187248_length_288_cov_2.275132	47	100	0	53	53	1.0000000
NODE_187318_length_288_cov_2.153439	50	81	0	31	31	1.0000000
NODE_187431_length_288_cov_1.915344	0	75	0	75	75	1.0000000
NODE_187443_length_288_cov_1.888889	49	125	0	71	76	0.9342105
NODE_187443_length_288_cov_1.888889	49	125	2	5	76	0.0657895
NODE_187484_length_288_cov_1.878307	0	42	0	42	42	1.0000000
NODE_187484_length_288_cov_1.878307	15	63	0	48	48	1.0000000
NODE_187810_length_288_cov_1.492063	0	42	0	42	42	1.0000000
NODE_188135_length_288_cov_1.158730	213	288	0	75	75	1.0000000
NODE_188161_length_288_cov_1.100529	256	288	0	2	32	0.0625000
NODE_188161_length_288_cov_1.100529	256	288	2	30	32	0.9375000
NODE_188169_length_288_cov_1.079365	10	74	0	64	64	1.0000000
NODE_188169_length_288_cov_1.079365	65	110	0	45	45	1.0000000
NODE_188760_length_288_cov_0.809524	141	170	1	29	29	1.0000000
NODE_189068_length_287_cov_7.632979	117	184	4	31	67	0.4626866
NODE_189068_length_287_cov_7.632979	117	184	6	23	67	0.3432836
NODE_189068_length_287_cov_7.632979	117	184	7	13	67	0.1940299
NODE_189079_length_287_cov_6.510638	20	100	0	80	80	1.0000000
NODE_189097_length_287_cov_5.781915	164	246	0	6	82	0.0731707
NODE_189097_length_287_cov_5.781915	164	246	2	76	82	0.9268293
NODE_189182_length_287_cov_3.590426	114	194	0	80	80	1.0000000
NODE_189192_length_287_cov_3.452128	0	52	0	52	52	1.0000000
NODE_189208_length_287_cov_3.281915	263	286	0	3	23	0.1304348
NODE_189208_length_287_cov_3.281915	263	286	2	8	23	0.3478261
NODE_189208_length_287_cov_3.281915	263	286	3	12	23	0.5217391
NODE_189266_length_287_cov_2.936170	41	110	0	69	69	1.0000000
NODE_189266_length_287_cov_2.936170	41	111	0	70	70	1.0000000
NODE_189266_length_287_cov_2.936170	94	167	0	19	73	0.2602740
NODE_189266_length_287_cov_2.936170	94	167	2	54	73	0.7397260
NODE_189266_length_287_cov_2.936170	156	179	2	23	23	1.0000000
NODE_189330_length_287_cov_2.638298	22	86	0	64	64	1.0000000
NODE_189381_length_287_cov_2.436170	182	262	0	28	80	0.3500000
NODE_189381_length_287_cov_2.436170	182	262	2	52	80	0.6500000
NODE_189582_length_287_cov_1.984043	137	166	1	29	29	1.0000000
NODE_189594_length_287_cov_1.941489	56	123	0	65	67	0.9701493
NODE_189594_length_287_cov_1.941489	56	123	2	2	67	0.0298507
NODE_189614_length_287_cov_1.904255	8	51	0	43	43	1.0000000
NODE_189710_length_287_cov_1.803191	146	217	0	71	71	1.0000000
NODE_189843_length_287_cov_1.627660	113	175	2	17	62	0.2741936
NODE_189843_length_287_cov_1.627660	113	175	4	45	62	0.7258065
NODE_189843_length_287_cov_1.627660	148	228	2	56	80	0.7000000
NODE_189843_length_287_cov_1.627660	148	228	4	24	80	0.3000000
NODE_189864_length_287_cov_1.627660	14	59	0	45	45	1.0000000
NODE_189864_length_287_cov_1.627660	41	112	0	71	71	1.0000000
NODE_189949_length_287_cov_1.574468	150	220	0	70	70	1.0000000
NODE_189985_length_287_cov_1.531915	123	154	1	31	31	1.0000000
NODE_190122_length_287_cov_1.356383	93	147	0	54	54	1.0000000
NODE_190142_length_287_cov_1.356383	135	199	0	64	64	1.0000000
NODE_190189_length_287_cov_1.335106	149	201	0	52	52	1.0000000
NODE_190654_length_287_cov_1.037234	23	44	0	21	21	1.0000000
NODE_190701_length_287_cov_0.994681	206	225	0	19	19	1.0000000
NODE_190802_length_287_cov_0.898936	0	57	0	9	57	0.1578947
NODE_190802_length_287_cov_0.898936	0	57	2	4	57	0.0701754
NODE_190802_length_287_cov_0.898936	0	57	3	3	57	0.0526316
NODE_190802_length_287_cov_0.898936	0	57	4	12	57	0.2105263
NODE_190802_length_287_cov_0.898936	0	57	5	9	57	0.1578947
NODE_190802_length_287_cov_0.898936	0	57	7	4	57	0.0701754
NODE_190802_length_287_cov_0.898936	0	57	9	1	57	0.0175439
NODE_190802_length_287_cov_0.898936	0	57	10	15	57	0.2631579
NODE_190873_length_287_cov_0.840426	46	121	0	75	75	1.0000000
NODE_191306_length_286_cov_141.540107	4	63	0	59	59	1.0000000
NODE_191389_length_286_cov_3.935829	79	123	0	44	44	1.0000000
NODE_191391_length_286_cov_3.871658	45	121	0	76	76	1.0000000
NODE_191391_length_286_cov_3.871658	102	169	0	67	67	1.0000000
NODE_191393_length_286_cov_3.812834	62	142	0	80	80	1.0000000
NODE_191430_length_286_cov_3.352941	63	143	2	80	80	1.0000000
NODE_191430_length_286_cov_3.352941	116	196	0	21	80	0.2625000
NODE_191430_length_286_cov_3.352941	116	196	2	59	80	0.7375000
NODE_191466_length_286_cov_3.101604	217	271	0	54	54	1.0000000
NODE_191509_length_286_cov_2.823529	56	122	1	17	66	0.2575758
NODE_191509_length_286_cov_2.823529	56	122	3	5	66	0.0757576
NODE_191509_length_286_cov_2.823529	56	122	5	2	66	0.0303030
NODE_191509_length_286_cov_2.823529	56	122	6	17	66	0.2575758
NODE_191509_length_286_cov_2.823529	56	122	7	3	66	0.0454545
NODE_191509_length_286_cov_2.823529	56	122	9	10	66	0.1515152
NODE_191509_length_286_cov_2.823529	56	122	10	12	66	0.1818182
NODE_191598_length_286_cov_2.438503	151	218	0	67	67	1.0000000
NODE_191754_length_286_cov_2.037433	57	138	1	11	81	0.1358025
NODE_191754_length_286_cov_2.037433	57	138	2	70	81	0.8641976
NODE_191892_length_286_cov_1.807487	186	232	0	46	46	1.0000000
NODE_191892_length_286_cov_1.807487	239	285	0	46	46	1.0000000
NODE_192100_length_286_cov_1.566845	112	160	2	48	48	1.0000000
NODE_192100_length_286_cov_1.566845	165	213	2	48	48	1.0000000
NODE_192150_length_286_cov_1.497326	107	160	2	53	53	1.0000000
NODE_192233_length_286_cov_1.363636	20	87	0	67	67	1.0000000
NODE_192302_length_286_cov_1.358289	218	262	0	44	44	1.0000000
NODE_192357_length_286_cov_1.304813	147	205	2	14	58	0.2413793
NODE_192357_length_286_cov_1.304813	147	205	3	44	58	0.7586207
NODE_192427_length_286_cov_1.203209	30	76	0	46	46	1.0000000
NODE_192427_length_286_cov_1.203209	49	129	0	80	80	1.0000000
NODE_192757_length_286_cov_1.074866	160	220	0	60	60	1.0000000
NODE_193023_length_286_cov_0.871658	218	279	0	61	61	1.0000000
NODE_193038_length_286_cov_0.855615	224	281	0	35	57	0.6140351
NODE_193038_length_286_cov_0.855615	224	281	2	22	57	0.3859649
NODE_193362_length_286_cov_0.625668	110	190	0	80	80	1.0000000
NODE_193362_length_286_cov_0.625668	163	240	0	77	77	1.0000000
NODE_193481_length_285_cov_7.392473	91	152	0	46	61	0.7540984
NODE_193481_length_285_cov_7.392473	91	152	2	13	61	0.2131148
NODE_193481_length_285_cov_7.392473	91	152	4	2	61	0.0327869
NODE_193481_length_285_cov_7.392473	150	184	4	34	34	1.0000000
NODE_193513_length_285_cov_4.650538	0	74	0	74	74	1.0000000
NODE_193513_length_285_cov_4.650538	47	127	0	80	80	1.0000000
NODE_193513_length_285_cov_4.650538	123	203	0	80	80	1.0000000
NODE_193513_length_285_cov_4.650538	176	256	0	80	80	1.0000000
NODE_193532_length_285_cov_4.091398	91	154	0	63	63	1.0000000
NODE_193538_length_285_cov_4.010753	120	201	1	81	81	1.0000000
NODE_193547_length_285_cov_3.854839	97	151	0	54	54	1.0000000
NODE_193547_length_285_cov_3.854839	106	153	0	47	47	1.0000000
NODE_193566_length_285_cov_3.607527	197	258	0	12	61	0.1967213
NODE_193566_length_285_cov_3.607527	197	258	1	34	61	0.5573770
NODE_193566_length_285_cov_3.607527	197	258	3	15	61	0.2459016
NODE_193624_length_285_cov_3.037634	190	272	0	82	82	1.0000000
NODE_193660_length_285_cov_2.806452	215	279	0	64	64	1.0000000
NODE_193688_length_285_cov_2.736559	106	173	0	67	67	1.0000000
NODE_193784_length_285_cov_2.311828	220	262	0	42	42	1.0000000
NODE_193883_length_285_cov_2.043011	77	150	0	73	73	1.0000000
NODE_193883_length_285_cov_2.043011	155	197	0	42	42	1.0000000
NODE_193978_length_285_cov_1.876344	67	110	0	19	43	0.4418605
NODE_193978_length_285_cov_1.876344	67	110	1	16	43	0.3720930
NODE_193978_length_285_cov_1.876344	67	110	2	1	43	0.0232558
NODE_193978_length_285_cov_1.876344	67	110	3	7	43	0.1627907
NODE_194150_length_285_cov_1.645161	112	160	0	48	48	1.0000000
NODE_194260_length_285_cov_1.548387	124	172	0	48	48	1.0000000
NODE_194332_length_285_cov_1.456989	210	277	0	67	67	1.0000000
NODE_194499_length_285_cov_1.327957	114	191	0	77	77	1.0000000
NODE_194865_length_285_cov_1.096774	175	229	0	54	54	1.0000000
NODE_194865_length_285_cov_1.096774	230	271	0	41	41	1.0000000
NODE_195109_length_285_cov_0.924731	128	208	0	80	80	1.0000000
NODE_195115_length_285_cov_0.919355	5	65	0	60	60	1.0000000
NODE_195124_length_285_cov_0.913978	6	80	0	74	74	1.0000000
NODE_195124_length_285_cov_0.913978	58	133	0	75	75	1.0000000
NODE_195642_length_284_cov_7.967568	143	207	0	64	64	1.0000000
NODE_195667_length_284_cov_5.016216	115	169	0	4	54	0.0740741
NODE_195667_length_284_cov_5.016216	115	169	2	50	54	0.9259259
NODE_195715_length_284_cov_3.913514	26	82	0	56	56	1.0000000
NODE_195760_length_284_cov_3.405405	209	283	0	74	74	1.0000000
NODE_195863_length_284_cov_2.718919	138	162	0	14	24	0.5833333
NODE_195863_length_284_cov_2.718919	138	162	2	10	24	0.4166667
NODE_195863_length_284_cov_2.718919	138	215	0	14	77	0.1818182
NODE_195863_length_284_cov_2.718919	138	215	2	63	77	0.8181818
NODE_196090_length_284_cov_2.097297	46	122	0	76	76	1.0000000
NODE_196253_length_284_cov_1.756757	27	100	0	3	73	0.0410959
NODE_196253_length_284_cov_1.756757	27	100	2	70	73	0.9589041
NODE_196253_length_284_cov_1.756757	97	153	0	18	56	0.3214286
NODE_196253_length_284_cov_1.756757	97	153	2	38	56	0.6785714
NODE_196273_length_284_cov_1.713514	24	59	0	35	35	1.0000000
NODE_196372_length_284_cov_1.654054	207	251	0	44	44	1.0000000
NODE_196426_length_284_cov_1.643243	180	239	0	59	59	1.0000000
NODE_196505_length_284_cov_1.540541	148	186	4	4	38	0.1052632
NODE_196505_length_284_cov_1.540541	148	186	6	1	38	0.0263158
NODE_196505_length_284_cov_1.540541	148	186	8	3	38	0.0789474
NODE_196505_length_284_cov_1.540541	148	186	10	16	38	0.4210526
NODE_196505_length_284_cov_1.540541	148	186	11	5	38	0.1315790
NODE_196505_length_284_cov_1.540541	148	186	13	1	38	0.0263158
NODE_196505_length_284_cov_1.540541	148	186	15	8	38	0.2105263
NODE_196670_length_284_cov_1.378378	65	145	1	22	80	0.2750000
NODE_196670_length_284_cov_1.378378	65	145	4	44	80	0.5500000
NODE_196670_length_284_cov_1.378378	65	145	5	14	80	0.1750000
NODE_196670_length_284_cov_1.378378	118	165	4	13	47	0.2765957
NODE_196670_length_284_cov_1.378378	118	165	5	34	47	0.7234042
NODE_196733_length_284_cov_1.329730	114	170	0	56	56	1.0000000
NODE_197755_length_284_cov_0.686486	13	94	0	81	81	1.0000000
NODE_197755_length_284_cov_0.686486	13	94	0	81	81	1.0000000
NODE_197755_length_284_cov_0.686486	13	94	0	81	81	1.0000000
NODE_197835_length_284_cov_0.551351	167	219	0	52	52	1.0000000
NODE_197936_length_283_cov_4.434783	81	137	8	12	56	0.2142857
NODE_197936_length_283_cov_4.434783	81	137	9	36	56	0.6428571
NODE_197936_length_283_cov_4.434783	81	137	11	8	56	0.1428571
NODE_197936_length_283_cov_4.434783	114	190	0	4	76	0.0526316
NODE_197936_length_283_cov_4.434783	114	190	1	9	76	0.1184211
NODE_197936_length_283_cov_4.434783	114	190	2	6	76	0.0789474
NODE_197936_length_283_cov_4.434783	114	190	3	20	76	0.2631579
NODE_197936_length_283_cov_4.434783	114	190	5	1	76	0.0131579
NODE_197936_length_283_cov_4.434783	114	190	6	9	76	0.1184211
NODE_197936_length_283_cov_4.434783	114	190	8	16	76	0.2105263
NODE_197936_length_283_cov_4.434783	114	190	9	11	76	0.1447368
NODE_197936_length_283_cov_4.434783	190	270	0	80	80	1.0000000
NODE_197937_length_283_cov_4.429348	104	168	2	64	64	1.0000000
NODE_197937_length_283_cov_4.429348	104	168	2	64	64	1.0000000
NODE_197937_length_283_cov_4.429348	141	207	1	2	66	0.0303030
NODE_197937_length_283_cov_4.429348	141	207	2	64	66	0.9696970
NODE_197937_length_283_cov_4.429348	141	221	0	9	80	0.1125000
NODE_197937_length_283_cov_4.429348	141	221	1	7	80	0.0875000
NODE_197937_length_283_cov_4.429348	141	221	2	64	80	0.8000000
NODE_198007_length_283_cov_3.369565	0	35	0	35	35	1.0000000
NODE_198022_length_283_cov_3.309783	47	91	0	44	44	1.0000000
NODE_198081_length_283_cov_2.923913	95	137	0	42	42	1.0000000
NODE_198081_length_283_cov_2.923913	110	190	0	80	80	1.0000000
NODE_198098_length_283_cov_2.782609	120	200	0	59	80	0.7375000
NODE_198098_length_283_cov_2.782609	120	200	1	21	80	0.2625000
NODE_198109_length_283_cov_2.771739	29	72	0	43	43	1.0000000
NODE_198171_length_283_cov_2.494565	186	229	0	43	43	1.0000000
NODE_198176_length_283_cov_2.494565	181	238	0	57	57	1.0000000
NODE_198271_length_283_cov_2.217391	222	281	0	59	59	1.0000000
NODE_198518_length_283_cov_1.777174	40	120	0	80	80	1.0000000
NODE_198745_length_283_cov_1.543478	125	161	0	4	36	0.1111111
NODE_198745_length_283_cov_1.543478	125	161	2	11	36	0.3055556
NODE_198745_length_283_cov_1.543478	125	161	4	21	36	0.5833333
NODE_198751_length_283_cov_1.538043	182	203	0	21	21	1.0000000
NODE_198986_length_283_cov_1.304348	208	270	2	62	62	1.0000000
NODE_199042_length_283_cov_1.211957	157	234	0	71	77	0.9220779
NODE_199042_length_283_cov_1.211957	157	234	1	6	77	0.0779221
NODE_199070_length_283_cov_1.168478	183	250	0	32	67	0.4776119
NODE_199070_length_283_cov_1.168478	183	250	2	35	67	0.5223880
NODE_199606_length_283_cov_0.918478	146	226	2	80	80	1.0000000
NODE_199606_length_283_cov_0.918478	199	279	2	80	80	1.0000000
NODE_199641_length_283_cov_0.885870	143	205	0	62	62	1.0000000
NODE_199958_length_283_cov_0.706522	119	159	0	40	40	1.0000000
NODE_200085_length_282_cov_51.027322	219	280	0	25	61	0.4098361
NODE_200085_length_282_cov_51.027322	219	280	1	36	61	0.5901639
NODE_200085_length_282_cov_51.027322	219	282	0	27	63	0.4285714
NODE_200085_length_282_cov_51.027322	219	282	1	36	63	0.5714286
NODE_200166_length_282_cov_3.901639	38	118	0	80	80	1.0000000
NODE_200166_length_282_cov_3.901639	91	171	0	80	80	1.0000000
NODE_200171_length_282_cov_3.874317	96	116	0	20	20	1.0000000
NODE_200201_length_282_cov_3.562842	224	279	0	55	55	1.0000000
NODE_200270_length_282_cov_2.890710	41	123	0	82	82	1.0000000
NODE_200276_length_282_cov_2.846995	26	47	0	21	21	1.0000000
NODE_200304_length_282_cov_2.770492	145	225	0	80	80	1.0000000
NODE_200304_length_282_cov_2.770492	198	278	0	80	80	1.0000000
NODE_200329_length_282_cov_2.655738	46	119	0	73	73	1.0000000
NODE_200329_length_282_cov_2.655738	100	159	0	59	59	1.0000000
NODE_200335_length_282_cov_2.622951	0	36	0	7	36	0.1944444
NODE_200335_length_282_cov_2.622951	0	36	1	29	36	0.8055556
NODE_200335_length_282_cov_2.622951	9	89	1	80	80	1.0000000
NODE_200336_length_282_cov_2.622951	38	111	0	73	73	1.0000000
NODE_200336_length_282_cov_2.622951	98	144	0	46	46	1.0000000
NODE_200367_length_282_cov_2.508197	138	186	0	48	48	1.0000000
NODE_200367_length_282_cov_2.508197	191	234	0	43	43	1.0000000
NODE_200425_length_282_cov_2.289617	68	137	0	69	69	1.0000000
NODE_200443_length_282_cov_2.229508	169	249	0	80	80	1.0000000
NODE_200501_length_282_cov_2.163934	138	192	0	54	54	1.0000000
NODE_200634_length_282_cov_1.901639	149	216	1	12	67	0.1791045
NODE_200634_length_282_cov_1.901639	149	216	3	55	67	0.8208955
NODE_200924_length_282_cov_1.612022	123	162	0	39	39	1.0000000
NODE_201084_length_282_cov_1.393443	158	225	0	67	67	1.0000000
NODE_201219_length_282_cov_1.273224	91	140	0	17	49	0.3469388
NODE_201219_length_282_cov_1.273224	91	140	1	12	49	0.2448980
NODE_201219_length_282_cov_1.273224	91	140	2	20	49	0.4081633
NODE_201413_length_282_cov_1.114754	5	53	0	48	48	1.0000000
NODE_202284_length_281_cov_7.895604	165	210	0	41	45	0.9111111
NODE_202284_length_281_cov_7.895604	165	210	2	4	45	0.0888889
NODE_202284_length_281_cov_7.895604	183	263	0	80	80	1.0000000
NODE_202294_length_281_cov_6.379121	151	231	0	80	80	1.0000000
NODE_202333_length_281_cov_4.565934	71	127	0	56	56	1.0000000
NODE_202337_length_281_cov_4.494505	211	261	0	50	50	1.0000000
NODE_202356_length_281_cov_4.219780	85	135	0	50	50	1.0000000
NODE_202356_length_281_cov_4.219780	145	188	0	43	43	1.0000000
NODE_202401_length_281_cov_3.620879	245	281	0	4	36	0.1111111
NODE_202401_length_281_cov_3.620879	245	281	2	32	36	0.8888889
NODE_202421_length_281_cov_3.324176	104	161	0	7	57	0.1228070
NODE_202421_length_281_cov_3.324176	104	161	1	18	57	0.3157895
NODE_202421_length_281_cov_3.324176	104	161	2	32	57	0.5614035
NODE_202421_length_281_cov_3.324176	112	192	1	17	80	0.2125000
NODE_202421_length_281_cov_3.324176	112	192	2	63	80	0.7875000
NODE_202436_length_281_cov_3.197802	6	80	0	74	74	1.0000000
NODE_202473_length_281_cov_2.923077	92	150	0	58	58	1.0000000
NODE_202650_length_281_cov_2.241758	5	58	0	53	53	1.0000000
NODE_202712_length_281_cov_2.120879	56	136	0	80	80	1.0000000
NODE_202788_length_281_cov_1.961538	199	270	0	71	71	1.0000000
NODE_203008_length_281_cov_1.675824	147	199	2	52	52	1.0000000
NODE_203008_length_281_cov_1.675824	178	198	2	20	20	1.0000000
NODE_203008_length_281_cov_1.675824	200	241	0	34	41	0.8292683
NODE_203008_length_281_cov_1.675824	200	241	1	1	41	0.0243902
NODE_203008_length_281_cov_1.675824	200	241	2	6	41	0.1463415
NODE_203065_length_281_cov_1.653846	29	65	0	36	36	1.0000000
NODE_203168_length_281_cov_1.483516	85	135	0	50	50	1.0000000
NODE_203168_length_281_cov_1.483516	86	166	0	80	80	1.0000000
NODE_203168_length_281_cov_1.483516	139	184	0	45	45	1.0000000
NODE_203183_length_281_cov_1.461538	223	276	0	53	53	1.0000000
NODE_203262_length_281_cov_1.401099	237	281	0	44	44	1.0000000
NODE_203281_length_281_cov_1.401099	150	214	0	6	64	0.0937500
NODE_203281_length_281_cov_1.401099	150	214	1	14	64	0.2187500
NODE_203281_length_281_cov_1.401099	150	214	2	44	64	0.6875000
NODE_203281_length_281_cov_1.401099	187	267	0	59	80	0.7375000
NODE_203281_length_281_cov_1.401099	187	267	1	14	80	0.1750000
NODE_203281_length_281_cov_1.401099	187	267	2	7	80	0.0875000
NODE_203292_length_281_cov_1.401099	31	111	0	80	80	1.0000000
NODE_203440_length_281_cov_1.186813	0	79	0	48	79	0.6075949
NODE_203440_length_281_cov_1.186813	0	79	2	31	79	0.3924051
NODE_203440_length_281_cov_1.186813	52	132	2	80	80	1.0000000
NODE_203516_length_281_cov_1.120879	47	82	0	35	35	1.0000000
NODE_203534_length_281_cov_1.120879	243	276	2	33	33	1.0000000
NODE_203544_length_281_cov_1.120879	216	281	0	65	65	1.0000000
NODE_203785_length_281_cov_1.060440	139	179	0	40	40	1.0000000
NODE_204094_length_281_cov_0.840659	72	138	0	66	66	1.0000000
NODE_204094_length_281_cov_0.840659	111	191	0	80	80	1.0000000
NODE_204467_length_280_cov_39.320442	118	198	5	35	80	0.4375000
NODE_204467_length_280_cov_39.320442	118	198	7	36	80	0.4500000
NODE_204467_length_280_cov_39.320442	118	198	8	3	80	0.0375000
NODE_204467_length_280_cov_39.320442	118	198	9	6	80	0.0750000
NODE_204467_length_280_cov_39.320442	181	251	3	27	70	0.3857143
NODE_204467_length_280_cov_39.320442	181	251	4	15	70	0.2142857
NODE_204467_length_280_cov_39.320442	181	251	5	28	70	0.4000000
NODE_204468_length_280_cov_34.259669	97	137	1	1	40	0.0250000
NODE_204468_length_280_cov_34.259669	97	137	3	15	40	0.3750000
NODE_204468_length_280_cov_34.259669	97	137	5	15	40	0.3750000
NODE_204468_length_280_cov_34.259669	97	137	7	8	40	0.2000000
NODE_204468_length_280_cov_34.259669	97	137	9	1	40	0.0250000
NODE_204532_length_280_cov_4.287293	53	100	0	47	47	1.0000000
NODE_204532_length_280_cov_4.287293	129	186	0	57	57	1.0000000
NODE_204596_length_280_cov_3.436464	34	103	2	28	69	0.4057971
NODE_204596_length_280_cov_3.436464	34	103	4	41	69	0.5942029
NODE_204597_length_280_cov_3.430939	17	97	0	35	80	0.4375000
NODE_204597_length_280_cov_3.430939	17	97	2	45	80	0.5625000
NODE_204597_length_280_cov_3.430939	27	97	0	25	70	0.3571429
NODE_204597_length_280_cov_3.430939	27	97	2	45	70	0.6428571
NODE_204674_length_280_cov_2.988950	118	164	2	46	46	1.0000000
NODE_204938_length_280_cov_2.165746	2	48	0	46	46	1.0000000
NODE_204938_length_280_cov_2.165746	6	48	0	42	42	1.0000000
NODE_204938_length_280_cov_2.165746	21	101	0	80	80	1.0000000
NODE_204938_length_280_cov_2.165746	22	101	0	79	79	1.0000000
NODE_204938_length_280_cov_2.165746	32	101	0	69	69	1.0000000
NODE_204976_length_280_cov_2.022099	105	148	0	43	43	1.0000000
NODE_204976_length_280_cov_2.022099	121	148	0	27	27	1.0000000
NODE_205044_length_280_cov_1.889503	50	132	0	13	82	0.1585366
NODE_205044_length_280_cov_1.889503	50	132	2	69	82	0.8414634
NODE_205062_length_280_cov_1.828729	45	75	8	30	30	1.0000000
NODE_205410_length_280_cov_1.425414	17	50	0	33	33	1.0000000
NODE_205410_length_280_cov_1.425414	70	112	0	42	42	1.0000000
NODE_205416_length_280_cov_1.414365	37	97	0	60	60	1.0000000
NODE_205633_length_280_cov_1.187845	56	136	0	80	80	1.0000000
NODE_205635_length_280_cov_1.182320	154	234	0	80	80	1.0000000
NODE_205635_length_280_cov_1.182320	207	280	0	73	73	1.0000000
NODE_205701_length_280_cov_1.127072	204	265	0	61	61	1.0000000
NODE_205794_length_280_cov_1.127072	0	39	0	39	39	1.0000000
NODE_205801_length_280_cov_1.127072	218	253	0	4	35	0.1142857
NODE_205801_length_280_cov_1.127072	218	253	1	31	35	0.8857143
NODE_205894_length_280_cov_1.127072	0	59	0	59	59	1.0000000
NODE_206211_length_280_cov_0.911602	176	256	0	80	80	1.0000000
NODE_206211_length_280_cov_0.911602	229	280	0	51	51	1.0000000
NODE_206319_length_280_cov_0.845304	211	268	0	57	57	1.0000000
NODE_206531_length_280_cov_0.779006	129	203	2	74	74	1.0000000
NODE_206721_length_279_cov_50.005556	51	130	0	8	79	0.1012658
NODE_206721_length_279_cov_50.005556	51	130	2	14	79	0.1772152
NODE_206721_length_279_cov_50.005556	51	130	4	6	79	0.0759494
NODE_206721_length_279_cov_50.005556	51	130	6	51	79	0.6455696
NODE_206721_length_279_cov_50.005556	103	179	2	25	76	0.3289474
NODE_206721_length_279_cov_50.005556	103	179	4	19	76	0.2500000
NODE_206721_length_279_cov_50.005556	103	179	6	32	76	0.4210526
NODE_206744_length_279_cov_6.055556	196	228	0	32	32	1.0000000
NODE_206762_length_279_cov_5.166667	197	277	0	80	80	1.0000000
NODE_206788_length_279_cov_4.427778	107	187	0	80	80	1.0000000
NODE_206879_length_279_cov_3.200000	205	225	0	20	20	1.0000000
NODE_206886_length_279_cov_3.116667	115	195	0	80	80	1.0000000
NODE_206886_length_279_cov_3.116667	168	248	0	80	80	1.0000000
NODE_206972_length_279_cov_2.600000	67	147	0	80	80	1.0000000
NODE_206972_length_279_cov_2.600000	120	199	0	79	79	1.0000000
NODE_207023_length_279_cov_2.427778	155	199	0	44	44	1.0000000
NODE_207052_length_279_cov_2.283333	168	240	0	72	72	1.0000000
NODE_207054_length_279_cov_2.277778	190	265	0	75	75	1.0000000
NODE_207086_length_279_cov_2.266667	66	109	0	43	43	1.0000000
NODE_207115_length_279_cov_2.255556	115	176	2	61	61	1.0000000
NODE_207115_length_279_cov_2.255556	168	222	1	42	54	0.7777778
NODE_207115_length_279_cov_2.255556	168	222	2	12	54	0.2222222
NODE_207155_length_279_cov_2.200000	57	104	0	47	47	1.0000000
NODE_207269_length_279_cov_1.977778	0	62	0	62	62	1.0000000
NODE_207293_length_279_cov_1.944444	63	105	0	42	42	1.0000000
NODE_207306_length_279_cov_1.916667	182	262	0	80	80	1.0000000
NODE_207318_length_279_cov_1.866667	63	143	0	80	80	1.0000000
NODE_207387_length_279_cov_1.700000	8	37	0	8	29	0.2758621
NODE_207387_length_279_cov_1.700000	8	37	2	21	29	0.7241379
NODE_207389_length_279_cov_1.700000	10	42	0	32	32	1.0000000
NODE_207534_length_279_cov_1.672222	103	183	0	80	80	1.0000000
NODE_207641_length_279_cov_1.433333	51	110	0	14	59	0.2372881
NODE_207641_length_279_cov_1.433333	51	110	1	45	59	0.7627119
NODE_207641_length_279_cov_1.433333	83	119	0	23	36	0.6388889
NODE_207641_length_279_cov_1.433333	83	119	1	13	36	0.3611111
NODE_207929_length_279_cov_1.144444	146	211	0	65	65	1.0000000
NODE_207929_length_279_cov_1.144444	184	266	0	82	82	1.0000000
NODE_207931_length_279_cov_1.138889	125	188	0	63	63	1.0000000
NODE_207932_length_279_cov_1.138889	111	191	0	80	80	1.0000000
NODE_207948_length_279_cov_1.133333	231	271	0	40	40	1.0000000
NODE_208183_length_279_cov_1.116667	15	92	0	77	77	1.0000000
NODE_208334_length_279_cov_0.988889	181	261	0	80	80	1.0000000
NODE_208410_length_279_cov_0.927778	50	69	0	19	19	1.0000000
NODE_208410_length_279_cov_0.927778	50	69	0	19	19	1.0000000
NODE_208664_length_279_cov_0.844444	35	70	0	35	35	1.0000000
NODE_209293_length_278_cov_44.882682	158	210	5	24	52	0.4615385
NODE_209293_length_278_cov_44.882682	158	210	6	8	52	0.1538462
NODE_209293_length_278_cov_44.882682	158	210	8	6	52	0.1153846
NODE_209293_length_278_cov_44.882682	158	210	9	6	52	0.1153846
NODE_209293_length_278_cov_44.882682	158	210	11	3	52	0.0576923
NODE_209293_length_278_cov_44.882682	158	210	12	1	52	0.0192308
NODE_209293_length_278_cov_44.882682	158	210	13	1	52	0.0192308
NODE_209293_length_278_cov_44.882682	158	210	14	3	52	0.0576923
NODE_209293_length_278_cov_44.882682	206	232	3	13	26	0.5000000
NODE_209293_length_278_cov_44.882682	206	232	5	13	26	0.5000000
NODE_209293_length_278_cov_44.882682	206	265	0	6	59	0.1016949
NODE_209293_length_278_cov_44.882682	206	265	2	5	59	0.0847458
NODE_209293_length_278_cov_44.882682	206	265	3	35	59	0.5932204
NODE_209293_length_278_cov_44.882682	206	265	5	13	59	0.2203390
NODE_209294_length_278_cov_37.474860	0	52	0	29	52	0.5576923
NODE_209294_length_278_cov_37.474860	0	52	1	5	52	0.0961538
NODE_209294_length_278_cov_37.474860	0	52	2	2	52	0.0384615
NODE_209294_length_278_cov_37.474860	0	52	4	2	52	0.0384615
NODE_209294_length_278_cov_37.474860	0	52	5	14	52	0.2692308
NODE_209294_length_278_cov_37.474860	48	128	5	12	80	0.1500000
NODE_209294_length_278_cov_37.474860	48	128	6	14	80	0.1750000
NODE_209294_length_278_cov_37.474860	48	128	7	2	80	0.0250000
NODE_209294_length_278_cov_37.474860	48	128	8	9	80	0.1125000
NODE_209294_length_278_cov_37.474860	48	128	9	22	80	0.2750000
NODE_209294_length_278_cov_37.474860	48	128	10	2	80	0.0250000
NODE_209294_length_278_cov_37.474860	48	128	11	9	80	0.1125000
NODE_209294_length_278_cov_37.474860	48	128	12	10	80	0.1250000
NODE_209294_length_278_cov_37.474860	101	181	8	2	80	0.0250000
NODE_209294_length_278_cov_37.474860	101	181	9	11	80	0.1375000
NODE_209294_length_278_cov_37.474860	101	181	10	2	80	0.0250000
NODE_209294_length_278_cov_37.474860	101	181	11	9	80	0.1125000
NODE_209294_length_278_cov_37.474860	101	181	12	56	80	0.7000000
NODE_209295_length_278_cov_21.340782	84	164	4	17	80	0.2125000
NODE_209295_length_278_cov_21.340782	84	164	6	63	80	0.7875000
NODE_209295_length_278_cov_21.340782	137	217	5	12	80	0.1500000
NODE_209295_length_278_cov_21.340782	137	217	6	68	80	0.8500000
NODE_209360_length_278_cov_4.156425	132	210	2	78	78	1.0000000
NODE_209360_length_278_cov_4.156425	193	263	1	14	70	0.2000000
NODE_209360_length_278_cov_4.156425	193	263	2	56	70	0.8000000
NODE_209372_length_278_cov_3.977654	142	221	0	47	79	0.5949367
NODE_209372_length_278_cov_3.977654	142	221	2	32	79	0.4050633
NODE_209378_length_278_cov_3.865922	168	210	0	3	42	0.0714286
NODE_209378_length_278_cov_3.865922	168	210	1	39	42	0.9285714
NODE_209552_length_278_cov_2.558659	93	123	0	30	30	1.0000000
NODE_209565_length_278_cov_2.513966	54	106	0	52	52	1.0000000
NODE_209565_length_278_cov_2.513966	79	158	0	79	79	1.0000000
NODE_209605_length_278_cov_2.296089	127	207	2	80	80	1.0000000
NODE_209883_length_278_cov_1.731844	145	194	3	13	49	0.2653061
NODE_209883_length_278_cov_1.731844	145	194	5	12	49	0.2448980
NODE_209883_length_278_cov_1.731844	145	194	7	24	49	0.4897959
NODE_210038_length_278_cov_1.681564	129	184	0	55	55	1.0000000
NODE_210068_length_278_cov_1.636872	13	41	0	28	28	1.0000000
NODE_210373_length_278_cov_1.290503	3	67	0	7	64	0.1093750
NODE_210373_length_278_cov_1.290503	3	67	1	6	64	0.0937500
NODE_210373_length_278_cov_1.290503	3	67	3	4	64	0.0625000
NODE_210373_length_278_cov_1.290503	3	67	4	18	64	0.2812500
NODE_210373_length_278_cov_1.290503	3	67	5	5	64	0.0781250
NODE_210373_length_278_cov_1.290503	3	67	6	24	64	0.3750000
NODE_210373_length_278_cov_1.290503	3	67	0	7	64	0.1093750
NODE_210373_length_278_cov_1.290503	3	67	1	6	64	0.0937500
NODE_210373_length_278_cov_1.290503	3	67	3	4	64	0.0625000
NODE_210373_length_278_cov_1.290503	3	67	4	18	64	0.2812500
NODE_210373_length_278_cov_1.290503	3	67	5	5	64	0.0781250
NODE_210373_length_278_cov_1.290503	3	67	6	24	64	0.3750000
NODE_210373_length_278_cov_1.290503	3	67	0	7	64	0.1093750
NODE_210373_length_278_cov_1.290503	3	67	1	6	64	0.0937500
NODE_210373_length_278_cov_1.290503	3	67	3	4	64	0.0625000
NODE_210373_length_278_cov_1.290503	3	67	4	18	64	0.2812500
NODE_210373_length_278_cov_1.290503	3	67	5	5	64	0.0781250
NODE_210373_length_278_cov_1.290503	3	67	6	24	64	0.3750000
NODE_210463_length_278_cov_1.150838	52	76	0	24	24	1.0000000
NODE_210463_length_278_cov_1.150838	58	84	0	26	26	1.0000000
NODE_210559_length_278_cov_1.139665	108	187	0	79	79	1.0000000
NODE_210612_length_278_cov_1.139665	232	278	0	46	46	1.0000000
NODE_210691_length_278_cov_1.139665	210	278	0	68	68	1.0000000
NODE_212166_length_277_cov_2.691011	0	60	0	60	60	1.0000000
NODE_212166_length_277_cov_2.691011	33	113	0	80	80	1.0000000
NODE_212175_length_277_cov_2.617978	85	127	0	42	42	1.0000000
NODE_212233_length_277_cov_2.438202	137	218	0	81	81	1.0000000
NODE_212357_length_277_cov_2.140449	234	276	0	42	42	1.0000000
NODE_212377_length_277_cov_2.095506	41	114	0	73	73	1.0000000
NODE_212377_length_277_cov_2.095506	41	114	0	73	73	1.0000000
NODE_212377_length_277_cov_2.095506	94	161	0	67	67	1.0000000
NODE_212525_length_277_cov_1.837079	92	172	1	8	80	0.1000000
NODE_212525_length_277_cov_1.837079	92	172	3	21	80	0.2625000
NODE_212525_length_277_cov_1.837079	92	172	4	31	80	0.3875000
NODE_212525_length_277_cov_1.837079	92	172	5	1	80	0.0125000
NODE_212525_length_277_cov_1.837079	92	172	6	8	80	0.1000000
NODE_212525_length_277_cov_1.837079	92	172	8	11	80	0.1375000
NODE_212558_length_277_cov_1.764045	115	155	0	40	40	1.0000000
NODE_212605_length_277_cov_1.719101	150	215	2	65	65	1.0000000
NODE_212845_length_277_cov_1.505618	0	47	0	47	47	1.0000000
NODE_212845_length_277_cov_1.505618	20	100	0	80	80	1.0000000
NODE_212970_length_277_cov_1.426966	113	191	2	2	78	0.0256410
NODE_212970_length_277_cov_1.426966	113	191	3	27	78	0.3461539
NODE_212970_length_277_cov_1.426966	113	191	5	49	78	0.6282051
NODE_213057_length_277_cov_1.314607	127	176	2	49	49	1.0000000
NODE_213091_length_277_cov_1.258427	141	222	0	81	81	1.0000000
NODE_213223_length_277_cov_1.146067	19	95	0	2	76	0.0263158
NODE_213223_length_277_cov_1.146067	19	95	1	61	76	0.8026316
NODE_213223_length_277_cov_1.146067	19	95	2	3	76	0.0394737
NODE_213223_length_277_cov_1.146067	19	95	3	10	76	0.1315790
NODE_213490_length_277_cov_1.061798	67	105	0	38	38	1.0000000
NODE_213505_length_277_cov_1.044944	19	77	0	58	58	1.0000000
NODE_214572_length_276_cov_31.774011	91	153	4	14	62	0.2258064
NODE_214572_length_276_cov_31.774011	91	153	5	2	62	0.0322581
NODE_214572_length_276_cov_31.774011	91	153	7	1	62	0.0161290
NODE_214572_length_276_cov_31.774011	91	153	8	4	62	0.0645161
NODE_214572_length_276_cov_31.774011	91	153	9	3	62	0.0483871
NODE_214572_length_276_cov_31.774011	91	153	10	4	62	0.0645161
NODE_214572_length_276_cov_31.774011	91	153	11	1	62	0.0161290
NODE_214572_length_276_cov_31.774011	91	153	12	8	62	0.1290323
NODE_214572_length_276_cov_31.774011	91	153	16	4	62	0.0645161
NODE_214572_length_276_cov_31.774011	91	153	17	9	62	0.1451613
NODE_214572_length_276_cov_31.774011	91	153	19	4	62	0.0645161
NODE_214572_length_276_cov_31.774011	91	153	20	8	62	0.1290323
NODE_214576_length_276_cov_10.056497	66	146	2	80	80	1.0000000
NODE_214698_length_276_cov_3.564972	176	256	0	80	80	1.0000000
NODE_214785_length_276_cov_2.920904	203	260	0	57	57	1.0000000
NODE_214785_length_276_cov_2.920904	233	276	0	43	43	1.0000000
NODE_214883_length_276_cov_2.542373	164	204	4	28	40	0.7000000
NODE_214883_length_276_cov_2.542373	164	204	5	7	40	0.1750000
NODE_214883_length_276_cov_2.542373	164	204	6	5	40	0.1250000
NODE_215016_length_276_cov_2.197740	64	144	0	80	80	1.0000000
NODE_215086_length_276_cov_2.022599	136	193	0	57	57	1.0000000
NODE_215105_length_276_cov_2.016949	97	138	0	41	41	1.0000000
NODE_215139_length_276_cov_2.005650	82	153	0	71	71	1.0000000
NODE_215234_length_276_cov_1.734463	102	182	0	1	80	0.0125000
NODE_215234_length_276_cov_1.734463	102	182	2	51	80	0.6375000
NODE_215234_length_276_cov_1.734463	102	182	4	5	80	0.0625000
NODE_215234_length_276_cov_1.734463	102	182	6	23	80	0.2875000
NODE_215516_length_276_cov_1.525424	70	116	0	46	46	1.0000000
NODE_215516_length_276_cov_1.525424	123	169	0	46	46	1.0000000
NODE_215519_length_276_cov_1.514124	115	155	0	40	40	1.0000000
NODE_215748_length_276_cov_1.288136	114	154	0	19	40	0.4750000
NODE_215748_length_276_cov_1.288136	114	154	2	21	40	0.5250000
NODE_216141_length_276_cov_1.124294	122	170	0	48	48	1.0000000
NODE_216141_length_276_cov_1.124294	132	163	0	31	31	1.0000000
NODE_216220_length_276_cov_1.039548	7	68	0	61	61	1.0000000
NODE_216220_length_276_cov_1.039548	7	70	0	63	63	1.0000000
NODE_216220_length_276_cov_1.039548	7	70	0	63	63	1.0000000
NODE_216220_length_276_cov_1.039548	7	70	0	63	63	1.0000000
NODE_216269_length_276_cov_1.000000	48	89	0	30	41	0.7317073
NODE_216269_length_276_cov_1.000000	48	89	1	6	41	0.1463415
NODE_216269_length_276_cov_1.000000	48	89	2	5	41	0.1219512
NODE_216269_length_276_cov_1.000000	62	106	0	16	44	0.3636364
NODE_216269_length_276_cov_1.000000	62	106	1	6	44	0.1363636
NODE_216269_length_276_cov_1.000000	62	106	2	22	44	0.5000000
NODE_216414_length_276_cov_0.898305	54	105	0	51	51	1.0000000
NODE_217265_length_275_cov_85.085227	94	174	9	5	80	0.0625000
NODE_217265_length_275_cov_85.085227	94	174	11	42	80	0.5250000
NODE_217265_length_275_cov_85.085227	94	174	12	33	80	0.4125000
NODE_217265_length_275_cov_85.085227	147	227	2	8	80	0.1000000
NODE_217265_length_275_cov_85.085227	147	227	3	4	80	0.0500000
NODE_217265_length_275_cov_85.085227	147	227	4	22	80	0.2750000
NODE_217265_length_275_cov_85.085227	147	227	6	14	80	0.1750000
NODE_217265_length_275_cov_85.085227	147	227	8	3	80	0.0375000
NODE_217265_length_275_cov_85.085227	147	227	9	7	80	0.0875000
NODE_217265_length_275_cov_85.085227	147	227	11	22	80	0.2750000
NODE_217287_length_275_cov_5.818182	0	44	0	44	44	1.0000000
NODE_217355_length_275_cov_3.857955	0	67	0	67	67	1.0000000
NODE_217396_length_275_cov_3.306818	199	275	0	76	76	1.0000000
NODE_217402_length_275_cov_3.284091	127	175	0	48	48	1.0000000
NODE_217433_length_275_cov_2.977273	95	145	0	50	50	1.0000000
NODE_217531_length_275_cov_2.585227	85	122	10	20	37	0.5405405
NODE_217531_length_275_cov_2.585227	85	122	12	17	37	0.4594595
NODE_217714_length_275_cov_2.090909	0	47	0	47	47	1.0000000
NODE_217714_length_275_cov_2.090909	20	91	0	71	71	1.0000000
NODE_217801_length_275_cov_1.960227	198	251	0	53	53	1.0000000
NODE_217835_length_275_cov_1.875000	190	247	0	57	57	1.0000000
NODE_217839_length_275_cov_1.857955	52	119	0	67	67	1.0000000
NODE_217839_length_275_cov_1.857955	136	182	0	46	46	1.0000000
NODE_217885_length_275_cov_1.755682	21	76	0	55	55	1.0000000
NODE_217912_length_275_cov_1.738636	225	256	0	31	31	1.0000000
NODE_217967_length_275_cov_1.738636	161	241	0	80	80	1.0000000
NODE_218257_length_275_cov_1.448864	123	155	2	32	32	1.0000000
NODE_218402_length_275_cov_1.301136	132	196	0	64	64	1.0000000
NODE_218706_length_275_cov_1.159091	13	93	0	80	80	1.0000000
NODE_218734_length_275_cov_1.153409	11	91	0	63	80	0.7875000
NODE_218734_length_275_cov_1.153409	11	91	2	17	80	0.2125000
NODE_219031_length_275_cov_0.937500	13	49	3	10	36	0.2777778
NODE_219031_length_275_cov_0.937500	13	49	4	9	36	0.2500000
NODE_219031_length_275_cov_0.937500	13	49	5	2	36	0.0555556
NODE_219031_length_275_cov_0.937500	13	49	6	2	36	0.0555556
NODE_219031_length_275_cov_0.937500	13	49	8	1	36	0.0277778
NODE_219031_length_275_cov_0.937500	13	49	10	3	36	0.0833333
NODE_219031_length_275_cov_0.937500	13	49	11	6	36	0.1666667
NODE_219031_length_275_cov_0.937500	13	49	12	3	36	0.0833333
NODE_219031_length_275_cov_0.937500	22	86	3	1	64	0.0156250
NODE_219031_length_275_cov_0.937500	22	86	4	9	64	0.1406250
NODE_219031_length_275_cov_0.937500	22	86	5	2	64	0.0312500
NODE_219031_length_275_cov_0.937500	22	86	6	2	64	0.0312500
NODE_219031_length_275_cov_0.937500	22	86	8	1	64	0.0156250
NODE_219031_length_275_cov_0.937500	22	86	10	3	64	0.0468750
NODE_219031_length_275_cov_0.937500	22	86	11	6	64	0.0937500
NODE_219031_length_275_cov_0.937500	22	86	12	6	64	0.0937500
NODE_219031_length_275_cov_0.937500	22	86	13	1	64	0.0156250
NODE_219031_length_275_cov_0.937500	22	86	15	1	64	0.0156250
NODE_219031_length_275_cov_0.937500	22	86	16	6	64	0.0937500
NODE_219031_length_275_cov_0.937500	22	86	17	2	64	0.0312500
NODE_219031_length_275_cov_0.937500	22	86	18	18	64	0.2812500
NODE_219031_length_275_cov_0.937500	22	86	20	1	64	0.0156250
NODE_219031_length_275_cov_0.937500	22	86	21	2	64	0.0312500
NODE_219031_length_275_cov_0.937500	22	86	22	3	64	0.0468750
NODE_219220_length_275_cov_0.869318	67	126	0	59	59	1.0000000
NODE_219655_length_275_cov_0.579545	40	70	0	30	30	1.0000000
NODE_220021_length_274_cov_6.074286	141	175	0	34	34	1.0000000
NODE_220047_length_274_cov_4.845714	48	105	2	57	57	1.0000000
NODE_220047_length_274_cov_4.845714	113	175	2	3	62	0.0483871
NODE_220047_length_274_cov_4.845714	113	175	3	59	62	0.9516129
NODE_220078_length_274_cov_4.080000	210	274	0	64	64	1.0000000
NODE_220215_length_274_cov_2.988571	104	161	0	57	57	1.0000000
NODE_220221_length_274_cov_2.937143	199	234	0	35	35	1.0000000
NODE_220293_length_274_cov_2.622857	29	76	0	14	47	0.2978723
NODE_220293_length_274_cov_2.622857	29	76	2	33	47	0.7021276
NODE_220293_length_274_cov_2.622857	82	157	0	75	75	1.0000000
NODE_220413_length_274_cov_2.308571	51	130	1	16	79	0.2025317
NODE_220413_length_274_cov_2.308571	51	130	2	1	79	0.0126582
NODE_220413_length_274_cov_2.308571	51	130	4	5	79	0.0632911
NODE_220413_length_274_cov_2.308571	51	130	5	2	79	0.0253165
NODE_220413_length_274_cov_2.308571	51	130	6	2	79	0.0253165
NODE_220413_length_274_cov_2.308571	51	130	7	23	79	0.2911392
NODE_220413_length_274_cov_2.308571	51	130	11	16	79	0.2025317
NODE_220413_length_274_cov_2.308571	51	130	12	14	79	0.1772152
NODE_220504_length_274_cov_2.062857	172	242	0	70	70	1.0000000
NODE_220504_length_274_cov_2.062857	215	256	0	41	41	1.0000000
NODE_220662_length_274_cov_1.754286	219	259	0	40	40	1.0000000
NODE_220681_length_274_cov_1.748571	168	231	0	63	63	1.0000000
NODE_220806_length_274_cov_1.737143	134	172	0	38	38	1.0000000
NODE_220847_length_274_cov_1.685714	132	189	0	2	57	0.0350877
NODE_220847_length_274_cov_1.685714	132	189	2	3	57	0.0526316
NODE_220847_length_274_cov_1.685714	132	189	4	52	57	0.9122807
NODE_220847_length_274_cov_1.685714	141	199	0	12	58	0.2068966
NODE_220847_length_274_cov_1.685714	141	199	2	3	58	0.0517241
NODE_220847_length_274_cov_1.685714	141	199	4	43	58	0.7413793
NODE_220966_length_274_cov_1.502857	170	232	0	62	62	1.0000000
NODE_220966_length_274_cov_1.502857	223	274	0	51	51	1.0000000
NODE_221005_length_274_cov_1.457143	118	147	0	29	29	1.0000000
NODE_221101_length_274_cov_1.434286	25	69	0	44	44	1.0000000
NODE_221211_length_274_cov_1.285714	84	156	0	72	72	1.0000000
NODE_221612_length_274_cov_1.131429	205	251	0	46	46	1.0000000
NODE_221764_length_274_cov_0.994286	219	260	0	41	41	1.0000000
NODE_222849_length_273_cov_4.948276	204	262	0	58	58	1.0000000
NODE_222849_length_273_cov_4.948276	204	258	0	54	54	1.0000000
NODE_222914_length_273_cov_3.712644	103	183	0	1	80	0.0125000
NODE_222914_length_273_cov_3.712644	103	183	3	14	80	0.1750000
NODE_222914_length_273_cov_3.712644	103	183	4	7	80	0.0875000
NODE_222914_length_273_cov_3.712644	103	183	5	7	80	0.0875000
NODE_222914_length_273_cov_3.712644	103	183	7	15	80	0.1875000
NODE_222914_length_273_cov_3.712644	103	183	8	36	80	0.4500000
NODE_222955_length_273_cov_3.298851	69	100	0	31	31	1.0000000
NODE_222955_length_273_cov_3.298851	73	153	0	80	80	1.0000000
NODE_222974_length_273_cov_3.195402	122	189	0	67	67	1.0000000
NODE_222991_length_273_cov_3.063218	76	151	0	33	75	0.4400000
NODE_222991_length_273_cov_3.063218	76	151	2	42	75	0.5600000
NODE_222991_length_273_cov_3.063218	135	191	0	56	56	1.0000000
NODE_223066_length_273_cov_2.706897	11	45	0	34	34	1.0000000
NODE_223203_length_273_cov_2.339080	69	145	3	76	76	1.0000000
NODE_223353_length_273_cov_2.051724	31	74	0	43	43	1.0000000
NODE_223377_length_273_cov_2.034483	81	161	0	80	80	1.0000000
NODE_223377_length_273_cov_2.034483	213	263	0	50	50	1.0000000
NODE_223680_length_273_cov_1.706897	181	238	0	57	57	1.0000000
NODE_223913_length_273_cov_1.442529	5	47	2	42	42	1.0000000
NODE_224023_length_273_cov_1.281609	167	247	0	80	80	1.0000000
NODE_224082_length_273_cov_1.189655	120	156	0	36	36	1.0000000
NODE_224082_length_273_cov_1.189655	129	160	0	31	31	1.0000000
NODE_224165_length_273_cov_1.172414	94	130	0	25	36	0.6944444
NODE_224165_length_273_cov_1.172414	94	130	2	11	36	0.3055556
NODE_224254_length_273_cov_1.172414	8	58	0	50	50	1.0000000
NODE_224367_length_273_cov_1.166667	74	93	4	19	19	1.0000000
NODE_224441_length_273_cov_1.091954	6	42	0	4	36	0.1111111
NODE_224441_length_273_cov_1.091954	6	42	2	32	36	0.8888889
NODE_224441_length_273_cov_1.091954	43	95	2	52	52	1.0000000
NODE_224587_length_273_cov_0.971264	188	235	0	47	47	1.0000000
NODE_225303_length_273_cov_0.586207	27	88	0	61	61	1.0000000
NODE_225344_length_273_cov_0.586207	24	79	0	55	55	1.0000000
NODE_225344_length_273_cov_0.586207	81	113	0	32	32	1.0000000
NODE_225592_length_272_cov_6.190751	172	236	0	8	64	0.1250000
NODE_225592_length_272_cov_6.190751	172	236	1	56	64	0.8750000
NODE_225607_length_272_cov_5.335260	193	272	0	79	79	1.0000000
NODE_225633_length_272_cov_4.716763	228	257	0	29	29	1.0000000
NODE_225656_length_272_cov_4.219653	93	166	1	2	73	0.0273973
NODE_225656_length_272_cov_4.219653	93	166	2	71	73	0.9726027
NODE_225656_length_272_cov_4.219653	146	219	1	17	73	0.2328767
NODE_225656_length_272_cov_4.219653	146	219	2	56	73	0.7671233
NODE_225658_length_272_cov_4.184971	75	128	0	53	53	1.0000000
NODE_225739_length_272_cov_3.352601	154	199	0	45	45	1.0000000
NODE_225872_length_272_cov_2.664740	106	186	0	80	80	1.0000000
NODE_226010_length_272_cov_2.335260	33	103	0	70	70	1.0000000
NODE_226029_length_272_cov_2.277457	219	256	0	37	37	1.0000000
NODE_226045_length_272_cov_2.236994	104	184	0	80	80	1.0000000
NODE_226169_length_272_cov_1.982659	172	252	2	59	80	0.7375000
NODE_226169_length_272_cov_1.982659	172	252	4	21	80	0.2625000
NODE_226245_length_272_cov_1.780347	37	99	0	62	62	1.0000000
NODE_226245_length_272_cov_1.780347	90	152	0	48	62	0.7741935
NODE_226245_length_272_cov_1.780347	90	152	2	14	62	0.2258064
NODE_226248_length_272_cov_1.768786	12	45	0	33	33	1.0000000
NODE_226461_length_272_cov_1.618497	97	160	0	63	63	1.0000000
NODE_226508_length_272_cov_1.543353	69	137	2	68	68	1.0000000
NODE_227037_length_272_cov_1.173410	147	203	0	56	56	1.0000000
NODE_227265_length_272_cov_0.988439	169	215	0	46	46	1.0000000
NODE_227444_length_272_cov_0.884393	126	163	0	37	37	1.0000000
NODE_228332_length_271_cov_5.238372	103	183	0	80	80	1.0000000
NODE_228423_length_271_cov_3.546512	102	165	0	42	63	0.6666667
NODE_228423_length_271_cov_3.546512	102	165	1	21	63	0.3333333
NODE_228429_length_271_cov_3.476744	62	93	0	31	31	1.0000000
NODE_228494_length_271_cov_2.959302	96	176	0	80	80	1.0000000
NODE_228494_length_271_cov_2.959302	149	229	0	80	80	1.0000000
NODE_228554_length_271_cov_2.715116	160	241	0	81	81	1.0000000
NODE_228593_length_271_cov_2.622093	180	253	0	73	73	1.0000000
NODE_228623_length_271_cov_2.465116	45	75	0	30	30	1.0000000
NODE_228731_length_271_cov_2.284884	95	158	2	8	63	0.1269841
NODE_228731_length_271_cov_2.284884	95	158	4	55	63	0.8730159
NODE_228731_length_271_cov_2.284884	131	211	0	43	80	0.5375000
NODE_228731_length_271_cov_2.284884	131	211	2	18	80	0.2250000
NODE_228731_length_271_cov_2.284884	131	211	4	19	80	0.2375000
NODE_228737_length_271_cov_2.273256	163	219	0	56	56	1.0000000
NODE_228830_length_271_cov_2.069767	130	212	2	9	82	0.1097561
NODE_228830_length_271_cov_2.069767	130	212	3	9	82	0.1097561
NODE_228830_length_271_cov_2.069767	130	212	4	64	82	0.7804878
NODE_228932_length_271_cov_1.784884	135	183	0	48	48	1.0000000
NODE_228937_length_271_cov_1.779070	204	268	0	64	64	1.0000000
NODE_229085_length_271_cov_1.755814	119	199	0	80	80	1.0000000
NODE_229242_length_271_cov_1.523256	122	183	0	61	61	1.0000000
NODE_229254_length_271_cov_1.511628	106	186	8	1	80	0.0125000
NODE_229254_length_271_cov_1.511628	106	186	10	22	80	0.2750000
NODE_229254_length_271_cov_1.511628	106	186	12	28	80	0.3500000
NODE_229254_length_271_cov_1.511628	106	186	13	3	80	0.0375000
NODE_229254_length_271_cov_1.511628	106	186	15	14	80	0.1750000
NODE_229254_length_271_cov_1.511628	106	186	17	12	80	0.1500000
NODE_229525_length_271_cov_1.226744	119	184	1	40	65	0.6153846
NODE_229525_length_271_cov_1.226744	119	184	2	25	65	0.3846154
NODE_229541_length_271_cov_1.197674	88	145	0	57	57	1.0000000
NODE_229541_length_271_cov_1.197674	118	192	0	74	74	1.0000000
NODE_230154_length_271_cov_0.918605	155	227	1	35	72	0.4861111
NODE_230154_length_271_cov_0.918605	155	227	2	37	72	0.5138889
NODE_230255_length_271_cov_0.889535	101	148	0	46	47	0.9787234
NODE_230255_length_271_cov_0.889535	101	148	2	1	47	0.0212766
NODE_230318_length_271_cov_0.889535	127	188	0	6	61	0.0983607
NODE_230318_length_271_cov_0.889535	127	188	2	55	61	0.9016393
NODE_231165_length_270_cov_4.818713	72	118	0	46	46	1.0000000
NODE_231187_length_270_cov_4.327485	5	82	0	77	77	1.0000000
NODE_231240_length_270_cov_3.666667	87	154	0	67	67	1.0000000
NODE_231240_length_270_cov_3.666667	140	207	0	67	67	1.0000000
NODE_231263_length_270_cov_3.491228	186	270	0	84	84	1.0000000
NODE_231310_length_270_cov_3.105263	43	90	1	47	47	1.0000000
NODE_231316_length_270_cov_3.046784	64	135	0	71	71	1.0000000
NODE_231439_length_270_cov_2.649123	210	270	0	60	60	1.0000000
NODE_231655_length_270_cov_2.087719	16	55	0	39	39	1.0000000
NODE_231655_length_270_cov_2.087719	78	108	0	30	30	1.0000000
NODE_231714_length_270_cov_2.040936	103	159	0	1	56	0.0178571
NODE_231714_length_270_cov_2.040936	103	159	2	3	56	0.0535714
NODE_231714_length_270_cov_2.040936	103	159	4	19	56	0.3392857
NODE_231714_length_270_cov_2.040936	103	159	6	7	56	0.1250000
NODE_231714_length_270_cov_2.040936	103	159	8	1	56	0.0178571
NODE_231714_length_270_cov_2.040936	103	159	10	11	56	0.1964286
NODE_231714_length_270_cov_2.040936	103	159	12	14	56	0.2500000
NODE_231726_length_270_cov_2.017544	1	48	0	47	47	1.0000000
NODE_231820_length_270_cov_1.789474	146	228	0	82	82	1.0000000
NODE_232008_length_270_cov_1.678363	178	246	0	68	68	1.0000000
NODE_232021_length_270_cov_1.666667	127	191	1	2	64	0.0312500
NODE_232021_length_270_cov_1.666667	127	191	2	62	64	0.9687500
NODE_232021_length_270_cov_1.666667	180	227	1	38	47	0.8085107
NODE_232021_length_270_cov_1.666667	180	227	2	9	47	0.1914894
NODE_232087_length_270_cov_1.555556	138	218	0	2	80	0.0250000
NODE_232087_length_270_cov_1.555556	138	218	2	53	80	0.6625000
NODE_232087_length_270_cov_1.555556	138	218	4	25	80	0.3125000
NODE_232331_length_270_cov_1.280702	4	75	0	71	71	1.0000000
NODE_232331_length_270_cov_1.280702	57	137	0	73	80	0.9125000
NODE_232331_length_270_cov_1.280702	57	137	2	7	80	0.0875000
NODE_232331_length_270_cov_1.280702	65	120	0	55	55	1.0000000
NODE_232331_length_270_cov_1.280702	125	198	0	5	73	0.0684932
NODE_232331_length_270_cov_1.280702	125	198	2	68	73	0.9315069
NODE_232440_length_270_cov_1.192982	146	194	0	48	48	1.0000000
NODE_232583_length_270_cov_1.192982	61	141	2	59	80	0.7375000
NODE_232583_length_270_cov_1.192982	61	141	4	21	80	0.2625000
NODE_233290_length_270_cov_0.847953	53	128	0	2	75	0.0266667
NODE_233290_length_270_cov_0.847953	53	128	3	3	75	0.0400000
NODE_233290_length_270_cov_0.847953	53	128	4	70	75	0.9333333
NODE_234072_length_269_cov_3.894118	30	110	0	80	80	1.0000000
NODE_234072_length_269_cov_3.894118	83	163	0	80	80	1.0000000
NODE_234100_length_269_cov_3.605882	175	205	0	30	30	1.0000000
NODE_234116_length_269_cov_3.523529	192	233	1	3	41	0.0731707
NODE_234116_length_269_cov_3.523529	192	233	2	23	41	0.5609756
NODE_234116_length_269_cov_3.523529	192	233	3	11	41	0.2682927
NODE_234116_length_269_cov_3.523529	192	233	4	4	41	0.0975610
NODE_234116_length_269_cov_3.523529	206	268	0	9	62	0.1451613
NODE_234116_length_269_cov_3.523529	206	268	1	29	62	0.4677419
NODE_234116_length_269_cov_3.523529	206	268	2	23	62	0.3709677
NODE_234116_length_269_cov_3.523529	206	268	3	1	62	0.0161290
NODE_234118_length_269_cov_3.505882	13	93	0	80	80	1.0000000
NODE_234118_length_269_cov_3.505882	66	145	0	79	79	1.0000000
NODE_234162_length_269_cov_3.147059	134	174	0	40	40	1.0000000
NODE_234167_length_269_cov_3.111765	39	119	0	80	80	1.0000000
NODE_234167_length_269_cov_3.111765	92	169	0	77	77	1.0000000
NODE_234178_length_269_cov_3.000000	166	233	0	67	67	1.0000000
NODE_234205_length_269_cov_2.947059	55	123	0	68	68	1.0000000
NODE_234224_length_269_cov_2.858824	9	89	0	80	80	1.0000000
NODE_234224_length_269_cov_2.858824	62	91	0	29	29	1.0000000
NODE_234228_length_269_cov_2.823529	0	73	0	3	73	0.0410959
NODE_234228_length_269_cov_2.823529	0	73	2	26	73	0.3561644
NODE_234228_length_269_cov_2.823529	0	73	4	40	73	0.5479452
NODE_234228_length_269_cov_2.823529	0	73	6	4	73	0.0547945
NODE_234228_length_269_cov_2.823529	46	77	4	23	31	0.7419355
NODE_234228_length_269_cov_2.823529	46	77	6	4	31	0.1290323
NODE_234228_length_269_cov_2.823529	46	77	7	4	31	0.1290323
NODE_234431_length_269_cov_2.311765	111	157	0	46	46	1.0000000
NODE_234431_length_269_cov_2.311765	130	209	0	79	79	1.0000000
NODE_234606_length_269_cov_1.958824	176	248	0	72	72	1.0000000
NODE_234647_length_269_cov_1.847059	72	99	0	27	27	1.0000000
NODE_234657_length_269_cov_1.823529	30	81	0	51	51	1.0000000
NODE_234758_length_269_cov_1.800000	0	42	0	42	42	1.0000000
NODE_234978_length_269_cov_1.552941	90	170	0	10	80	0.1250000
NODE_234978_length_269_cov_1.552941	90	170	1	70	80	0.8750000
NODE_235157_length_269_cov_1.400000	139	219	2	57	80	0.7125000
NODE_235157_length_269_cov_1.400000	139	219	4	23	80	0.2875000
NODE_235168_length_269_cov_1.388235	185	252	0	67	67	1.0000000
NODE_235239_length_269_cov_1.288235	150	179	0	29	29	1.0000000
NODE_235292_length_269_cov_1.217647	141	221	0	80	80	1.0000000
NODE_235561_length_269_cov_1.194118	107	170	0	63	63	1.0000000
NODE_235561_length_269_cov_1.194118	143	221	0	78	78	1.0000000
NODE_235714_length_269_cov_1.094118	38	72	0	34	34	1.0000000
NODE_235780_length_269_cov_1.035294	6	36	0	30	30	1.0000000
NODE_235780_length_269_cov_1.035294	96	150	0	54	54	1.0000000
NODE_235930_length_269_cov_0.917647	4	79	0	75	75	1.0000000
NODE_235930_length_269_cov_0.917647	57	93	0	36	36	1.0000000
NODE_236243_length_269_cov_0.782353	2	52	0	17	50	0.3400000
NODE_236243_length_269_cov_0.782353	2	52	2	33	50	0.6600000
NODE_236243_length_269_cov_0.782353	76	132	4	31	56	0.5535714
NODE_236243_length_269_cov_0.782353	76	132	6	25	56	0.4464286
NODE_236856_length_268_cov_223.165680	161	188	2	27	27	1.0000000
NODE_236856_length_268_cov_223.165680	161	241	2	80	80	1.0000000
NODE_236878_length_268_cov_6.266272	29	111	0	82	82	1.0000000
NODE_236909_length_268_cov_5.053254	137	217	0	80	80	1.0000000
NODE_236909_length_268_cov_5.053254	190	253	0	63	63	1.0000000
NODE_236911_length_268_cov_4.994083	92	168	0	55	76	0.7236842
NODE_236911_length_268_cov_4.994083	92	168	2	21	76	0.2763158
NODE_236972_length_268_cov_3.905325	1	61	1	20	60	0.3333333
NODE_236972_length_268_cov_3.905325	1	61	2	40	60	0.6666667
NODE_237107_length_268_cov_2.982249	95	175	0	80	80	1.0000000
NODE_237115_length_268_cov_2.940828	28	97	0	69	69	1.0000000
NODE_237185_length_268_cov_2.668639	57	110	0	53	53	1.0000000
NODE_237190_length_268_cov_2.621302	149	176	0	27	27	1.0000000
NODE_237325_length_268_cov_2.289941	87	127	2	40	40	1.0000000
NODE_237345_length_268_cov_2.224852	96	176	0	80	80	1.0000000
NODE_237345_length_268_cov_2.224852	149	229	0	80	80	1.0000000
NODE_237457_length_268_cov_2.005917	97	162	0	65	65	1.0000000
NODE_237502_length_268_cov_1.840237	80	155	0	75	75	1.0000000
NODE_237572_length_268_cov_1.810651	8	84	0	76	76	1.0000000
NODE_237831_length_268_cov_1.532544	186	257	0	18	71	0.2535211
NODE_237831_length_268_cov_1.532544	186	257	1	4	71	0.0563380
NODE_237831_length_268_cov_1.532544	186	257	2	1	71	0.0140845
NODE_237831_length_268_cov_1.532544	186	257	3	6	71	0.0845070
NODE_237831_length_268_cov_1.532544	186	257	4	32	71	0.4507042
NODE_237831_length_268_cov_1.532544	186	257	6	10	71	0.1408451
NODE_237906_length_268_cov_1.508876	52	131	0	66	79	0.8354430
NODE_237906_length_268_cov_1.508876	52	131	2	13	79	0.1645570
NODE_238009_length_268_cov_1.384615	0	46	2	46	46	1.0000000
NODE_238070_length_268_cov_1.278107	100	175	0	75	75	1.0000000
NODE_238153_length_268_cov_1.207101	187	209	0	22	22	1.0000000
NODE_238478_length_268_cov_1.153846	135	195	0	60	60	1.0000000
NODE_239018_length_268_cov_0.852071	59	119	2	56	60	0.9333333
NODE_239018_length_268_cov_0.852071	59	119	3	4	60	0.0666667
NODE_239805_length_267_cov_4.297619	0	52	0	52	52	1.0000000
NODE_239817_length_267_cov_4.119048	41	87	0	15	46	0.3260870
NODE_239817_length_267_cov_4.119048	41	87	2	31	46	0.6739131
NODE_239845_length_267_cov_3.785714	96	163	0	67	67	1.0000000
NODE_239845_length_267_cov_3.785714	136	178	0	42	42	1.0000000
NODE_239873_length_267_cov_3.535714	40	101	0	12	61	0.1967213
NODE_239873_length_267_cov_3.535714	40	101	1	49	61	0.8032787
NODE_239873_length_267_cov_3.535714	74	154	1	80	80	1.0000000
NODE_239958_length_267_cov_3.005952	216	267	0	51	51	1.0000000
NODE_239959_length_267_cov_3.000000	87	144	1	1	57	0.0175439
NODE_239959_length_267_cov_3.000000	87	144	2	1	57	0.0175439
NODE_239959_length_267_cov_3.000000	87	144	4	1	57	0.0175439
NODE_239959_length_267_cov_3.000000	87	144	5	19	57	0.3333333
NODE_239959_length_267_cov_3.000000	87	144	7	7	57	0.1228070
NODE_239959_length_267_cov_3.000000	87	144	9	28	57	0.4912281
NODE_240007_length_267_cov_2.726190	177	220	0	43	43	1.0000000
NODE_240024_length_267_cov_2.690476	117	170	3	2	53	0.0377358
NODE_240024_length_267_cov_2.690476	117	170	5	16	53	0.3018868
NODE_240024_length_267_cov_2.690476	117	170	6	10	53	0.1886792
NODE_240024_length_267_cov_2.690476	117	170	8	25	53	0.4716981
NODE_240029_length_267_cov_2.666667	198	267	0	69	69	1.0000000
NODE_240114_length_267_cov_2.428571	189	254	0	62	65	0.9538462
NODE_240114_length_267_cov_2.428571	189	254	2	1	65	0.0153846
NODE_240114_length_267_cov_2.428571	189	254	6	2	65	0.0307692
NODE_240207_length_267_cov_2.208333	45	103	0	58	58	1.0000000
NODE_240246_length_267_cov_2.125000	124	175	0	51	51	1.0000000
NODE_240303_length_267_cov_2.077381	65	146	0	81	81	1.0000000
NODE_240303_length_267_cov_2.077381	229	264	0	35	35	1.0000000
NODE_240331_length_267_cov_2.005952	147	228	0	66	81	0.8148148
NODE_240331_length_267_cov_2.005952	147	228	2	15	81	0.1851852
NODE_240331_length_267_cov_2.005952	201	267	0	66	66	1.0000000
NODE_240336_length_267_cov_1.988095	77	157	0	80	80	1.0000000
NODE_240336_length_267_cov_1.988095	130	210	0	80	80	1.0000000
NODE_240620_length_267_cov_1.755952	119	199	0	80	80	1.0000000
NODE_240624_length_267_cov_1.750000	23	104	2	42	81	0.5185185
NODE_240624_length_267_cov_1.750000	23	104	4	35	81	0.4320988
NODE_240624_length_267_cov_1.750000	23	104	6	4	81	0.0493827
NODE_240624_length_267_cov_1.750000	179	208	0	17	29	0.5862069
NODE_240624_length_267_cov_1.750000	179	208	2	12	29	0.4137931
NODE_240653_length_267_cov_1.690476	18	90	0	27	72	0.3750000
NODE_240653_length_267_cov_1.690476	18	90	2	45	72	0.6250000
NODE_240790_length_267_cov_1.517857	6	43	0	37	37	1.0000000
NODE_241075_length_267_cov_1.214286	37	91	0	54	54	1.0000000
NODE_241240_length_267_cov_1.214286	89	126	0	37	37	1.0000000
NODE_241352_length_267_cov_1.208333	124	164	0	40	40	1.0000000
NODE_241484_length_267_cov_1.125000	57	103	0	46	46	1.0000000
NODE_241512_length_267_cov_1.089286	119	196	0	77	77	1.0000000
NODE_241512_length_267_cov_1.089286	169	249	0	80	80	1.0000000
NODE_241517_length_267_cov_1.083333	133	152	4	19	19	1.0000000
NODE_241517_length_267_cov_1.083333	183	264	0	3	81	0.0370370
NODE_241517_length_267_cov_1.083333	183	264	2	57	81	0.7037037
NODE_241517_length_267_cov_1.083333	183	264	4	21	81	0.2592593
NODE_241588_length_267_cov_1.017857	205	267	0	62	62	1.0000000
NODE_241633_length_267_cov_0.982143	4	75	0	71	71	1.0000000
NODE_242999_length_266_cov_5.706587	120	199	0	79	79	1.0000000
NODE_242999_length_266_cov_5.706587	172	239	0	67	67	1.0000000
NODE_243010_length_266_cov_5.107784	68	150	0	82	82	1.0000000
NODE_243064_length_266_cov_4.125749	99	168	1	6	69	0.0869565
NODE_243064_length_266_cov_4.125749	99	168	3	3	69	0.0434783
NODE_243064_length_266_cov_4.125749	99	168	5	26	69	0.3768116
NODE_243064_length_266_cov_4.125749	99	168	7	34	69	0.4927536
NODE_243079_length_266_cov_3.958084	40	120	0	80	80	1.0000000
NODE_243079_length_266_cov_3.958084	93	159	0	66	66	1.0000000
NODE_243136_length_266_cov_3.419162	68	130	0	62	62	1.0000000
NODE_243136_length_266_cov_3.419162	116	183	0	67	67	1.0000000
NODE_243168_length_266_cov_3.137725	6	86	0	80	80	1.0000000
NODE_243168_length_266_cov_3.137725	59	120	0	61	61	1.0000000
NODE_243174_length_266_cov_3.107784	166	232	0	24	66	0.3636364
NODE_243174_length_266_cov_3.107784	166	232	2	42	66	0.6363636
NODE_243475_length_266_cov_2.179641	110	191	0	1	81	0.0123457
NODE_243475_length_266_cov_2.179641	110	191	2	80	81	0.9876543
NODE_243497_length_266_cov_2.137725	156	236	1	19	80	0.2375000
NODE_243497_length_266_cov_2.137725	156	236	2	61	80	0.7625000
NODE_243570_length_266_cov_2.023952	47	123	0	76	76	1.0000000
NODE_243972_length_266_cov_1.532934	155	235	0	32	80	0.4000000
NODE_243972_length_266_cov_1.532934	155	235	1	10	80	0.1250000
NODE_243972_length_266_cov_1.532934	155	235	2	38	80	0.4750000
NODE_244681_length_266_cov_1.113772	70	97	0	3	27	0.1111111
NODE_244681_length_266_cov_1.113772	70	97	1	24	27	0.8888889
NODE_244760_length_266_cov_1.023952	144	201	2	57	57	1.0000000
NODE_244760_length_266_cov_1.023952	199	265	0	6	66	0.0909091
NODE_244760_length_266_cov_1.023952	199	265	2	60	66	0.9090909
NODE_245049_length_266_cov_0.916168	51	122	0	71	71	1.0000000
NODE_245280_length_266_cov_0.730539	132	158	0	26	26	1.0000000
NODE_245538_length_266_cov_0.610778	99	139	0	40	40	1.0000000
NODE_245538_length_266_cov_0.610778	112	156	0	44	44	1.0000000
NODE_246087_length_265_cov_7.843373	128	208	0	49	80	0.6125000
NODE_246087_length_265_cov_7.843373	128	208	2	31	80	0.3875000
NODE_246192_length_265_cov_4.054217	65	145	0	80	80	1.0000000
NODE_246192_length_265_cov_4.054217	118	198	0	80	80	1.0000000
NODE_246198_length_265_cov_3.993976	195	231	0	36	36	1.0000000
NODE_246284_length_265_cov_3.150602	183	263	0	77	80	0.9625000
NODE_246284_length_265_cov_3.150602	183	263	2	3	80	0.0375000
NODE_246374_length_265_cov_2.789157	177	238	0	61	61	1.0000000
NODE_246409_length_265_cov_2.734940	167	247	0	80	80	1.0000000
NODE_246432_length_265_cov_2.608434	188	259	0	71	71	1.0000000
NODE_246606_length_265_cov_2.156627	197	237	0	12	40	0.3000000
NODE_246606_length_265_cov_2.156627	197	237	2	28	40	0.7000000
NODE_246624_length_265_cov_2.150602	169	218	0	49	49	1.0000000
NODE_246692_length_265_cov_1.975904	15	44	0	29	29	1.0000000
NODE_246811_length_265_cov_1.843373	195	265	0	70	70	1.0000000
NODE_247028_length_265_cov_1.620482	115	186	0	3	71	0.0422535
NODE_247028_length_265_cov_1.620482	115	186	2	68	71	0.9577465
NODE_247028_length_265_cov_1.620482	117	171	0	1	54	0.0185185
NODE_247028_length_265_cov_1.620482	117	171	2	53	54	0.9814815
NODE_247031_length_265_cov_1.614458	53	113	3	41	60	0.6833333
NODE_247031_length_265_cov_1.614458	53	113	4	19	60	0.3166667
NODE_247031_length_265_cov_1.614458	86	166	3	8	80	0.1000000
NODE_247031_length_265_cov_1.614458	86	166	4	19	80	0.2375000
NODE_247031_length_265_cov_1.614458	86	166	5	2	80	0.0250000
NODE_247031_length_265_cov_1.614458	86	166	6	51	80	0.6375000
NODE_247314_length_265_cov_1.337349	107	168	0	61	61	1.0000000
NODE_247952_length_265_cov_1.000000	187	251	0	64	64	1.0000000
NODE_247972_length_265_cov_0.987952	44	63	0	19	19	1.0000000
NODE_249395_length_264_cov_4.018182	141	178	3	37	37	1.0000000
NODE_249404_length_264_cov_3.957576	59	132	0	73	73	1.0000000
NODE_249404_length_264_cov_3.957576	112	192	0	80	80	1.0000000
NODE_249415_length_264_cov_3.824242	178	220	0	42	42	1.0000000
NODE_249452_length_264_cov_3.400000	73	125	0	52	52	1.0000000
NODE_249452_length_264_cov_3.400000	124	165	0	41	41	1.0000000
NODE_249485_length_264_cov_3.133333	119	186	0	67	67	1.0000000
NODE_249530_length_264_cov_3.012121	122	198	0	56	76	0.7368421
NODE_249530_length_264_cov_3.012121	122	198	2	20	76	0.2631579
NODE_249904_length_264_cov_2.048485	32	98	0	66	66	1.0000000
NODE_249905_length_264_cov_2.048485	133	176	0	43	43	1.0000000
NODE_249912_length_264_cov_2.012121	20	84	0	64	64	1.0000000
NODE_249931_length_264_cov_1.951515	178	211	0	33	33	1.0000000
NODE_249982_length_264_cov_1.854545	130	161	0	31	31	1.0000000
NODE_250202_length_264_cov_1.745455	26	81	0	55	55	1.0000000
NODE_250202_length_264_cov_1.745455	86	153	0	67	67	1.0000000
NODE_250203_length_264_cov_1.745455	90	169	0	63	79	0.7974684
NODE_250203_length_264_cov_1.745455	90	169	1	16	79	0.2025317
NODE_250203_length_264_cov_1.745455	143	207	0	10	64	0.1562500
NODE_250203_length_264_cov_1.745455	143	207	1	54	64	0.8437500
NODE_250297_length_264_cov_1.569697	173	236	0	31	63	0.4920635
NODE_250297_length_264_cov_1.569697	173	236	2	32	63	0.5079365
NODE_250314_length_264_cov_1.545455	206	255	0	49	49	1.0000000
NODE_250381_length_264_cov_1.545455	35	66	0	31	31	1.0000000
NODE_250446_length_264_cov_1.503030	0	63	0	63	63	1.0000000
NODE_250513_length_264_cov_1.406061	149	230	0	81	81	1.0000000
NODE_250513_length_264_cov_1.406061	225	260	0	35	35	1.0000000
NODE_250635_length_264_cov_1.236364	2	63	0	61	61	1.0000000
NODE_251015_length_264_cov_1.151515	11	68	0	57	57	1.0000000
NODE_251529_length_264_cov_0.921212	49	85	0	36	36	1.0000000
NODE_251703_length_264_cov_0.721212	233	252	0	19	19	1.0000000
NODE_252559_length_263_cov_5.115854	132	219	6	5	87	0.0574713
NODE_252559_length_263_cov_5.115854	132	219	8	82	87	0.9425287
NODE_252563_length_263_cov_4.914634	45	117	0	72	72	1.0000000
NODE_252595_length_263_cov_4.225610	67	124	2	57	57	1.0000000
NODE_252663_length_263_cov_3.518293	104	176	0	72	72	1.0000000
NODE_252766_length_263_cov_2.908537	7	93	0	74	86	0.8604651
NODE_252766_length_263_cov_2.908537	7	93	2	12	86	0.1395349
NODE_252778_length_263_cov_2.798780	67	146	0	79	79	1.0000000
NODE_252932_length_263_cov_2.396341	207	238	0	31	31	1.0000000
NODE_253261_length_263_cov_1.865854	51	81	1	1	30	0.0333333
NODE_253261_length_263_cov_1.865854	51	81	3	11	30	0.3666667
NODE_253261_length_263_cov_1.865854	51	81	4	18	30	0.6000000
NODE_253310_length_263_cov_1.847561	113	189	3	12	76	0.1578947
NODE_253310_length_263_cov_1.847561	113	189	4	64	76	0.8421053
NODE_253379_length_263_cov_1.750000	151	231	0	80	80	1.0000000
NODE_253468_length_263_cov_1.579268	32	95	8	2	63	0.0317460
NODE_253468_length_263_cov_1.579268	32	95	12	61	63	0.9682540
NODE_253477_length_263_cov_1.567073	98	155	0	57	57	1.0000000
NODE_253619_length_263_cov_1.506098	157	217	0	60	60	1.0000000
NODE_253620_length_263_cov_1.506098	84	113	0	29	29	1.0000000
NODE_253753_length_263_cov_1.286585	143	223	1	21	80	0.2625000
NODE_253753_length_263_cov_1.286585	143	223	3	2	80	0.0250000
NODE_253753_length_263_cov_1.286585	143	223	5	14	80	0.1750000
NODE_253753_length_263_cov_1.286585	143	223	7	20	80	0.2500000
NODE_253753_length_263_cov_1.286585	143	223	9	9	80	0.1125000
NODE_253753_length_263_cov_1.286585	143	223	11	14	80	0.1750000
NODE_253788_length_263_cov_1.243902	206	263	0	57	57	1.0000000
NODE_254174_length_263_cov_1.170732	12	66	0	54	54	1.0000000
NODE_254174_length_263_cov_1.170732	39	119	0	80	80	1.0000000
NODE_254301_length_263_cov_1.067073	137	202	0	65	65	1.0000000
NODE_254301_length_263_cov_1.067073	175	255	0	80	80	1.0000000
NODE_254783_length_263_cov_0.810976	163	245	20	1	82	0.0121951
NODE_254783_length_263_cov_0.810976	163	245	25	2	82	0.0243902
NODE_254783_length_263_cov_0.810976	163	245	27	1	82	0.0121951
NODE_254783_length_263_cov_0.810976	163	245	28	1	82	0.0121951
NODE_254783_length_263_cov_0.810976	163	245	31	2	82	0.0243902
NODE_254783_length_263_cov_0.810976	163	245	33	2	82	0.0243902
NODE_254783_length_263_cov_0.810976	163	245	38	2	82	0.0243902
NODE_254783_length_263_cov_0.810976	163	245	41	2	82	0.0243902
NODE_254783_length_263_cov_0.810976	163	245	42	5	82	0.0609756
NODE_254783_length_263_cov_0.810976	163	245	44	4	82	0.0487805
NODE_254783_length_263_cov_0.810976	163	245	45	1	82	0.0121951
NODE_254783_length_263_cov_0.810976	163	245	47	1	82	0.0121951
NODE_254783_length_263_cov_0.810976	163	245	48	9	82	0.1097561
NODE_254783_length_263_cov_0.810976	163	245	50	6	82	0.0731707
NODE_254783_length_263_cov_0.810976	163	245	52	2	82	0.0243902
NODE_254783_length_263_cov_0.810976	163	245	55	2	82	0.0243902
NODE_254783_length_263_cov_0.810976	163	245	56	2	82	0.0243902
NODE_254783_length_263_cov_0.810976	163	245	58	1	82	0.0121951
NODE_254783_length_263_cov_0.810976	163	245	60	5	82	0.0609756
NODE_254783_length_263_cov_0.810976	163	245	62	7	82	0.0853659
NODE_254783_length_263_cov_0.810976	163	245	65	2	82	0.0243902
NODE_254783_length_263_cov_0.810976	163	245	66	8	82	0.0975610
NODE_254783_length_263_cov_0.810976	163	245	68	5	82	0.0609756
NODE_254783_length_263_cov_0.810976	163	245	70	3	82	0.0365854
NODE_254783_length_263_cov_0.810976	163	245	73	6	82	0.0731707
NODE_255446_length_263_cov_0.621951	212	258	0	46	46	1.0000000
NODE_255524_length_263_cov_0.621951	131	151	0	20	20	1.0000000
NODE_255559_length_263_cov_0.621951	67	86	0	19	19	1.0000000
NODE_255727_length_262_cov_5.312883	20	82	0	62	62	1.0000000
NODE_255769_length_262_cov_4.447853	102	155	0	53	53	1.0000000
NODE_255821_length_262_cov_3.766871	48	89	0	41	41	1.0000000
NODE_255860_length_262_cov_3.435583	158	235	0	77	77	1.0000000
NODE_255945_length_262_cov_2.938650	142	222	0	80	80	1.0000000
NODE_256009_length_262_cov_2.723926	103	183	0	80	80	1.0000000
NODE_256049_length_262_cov_2.509202	88	148	0	60	60	1.0000000
NODE_256050_length_262_cov_2.509202	0	61	0	61	61	1.0000000
NODE_256050_length_262_cov_2.509202	107	171	0	64	64	1.0000000
NODE_256050_length_262_cov_2.509202	144	224	0	80	80	1.0000000
NODE_256129_length_262_cov_2.429448	14	87	0	73	73	1.0000000
NODE_256129_length_262_cov_2.429448	62	149	0	87	87	1.0000000
NODE_256176_length_262_cov_2.226994	2	79	0	77	77	1.0000000
NODE_256187_length_262_cov_2.202454	61	81	0	20	20	1.0000000
NODE_256199_length_262_cov_2.190184	172	235	2	63	63	1.0000000
NODE_256239_length_262_cov_2.177914	133	189	0	56	56	1.0000000
NODE_256265_length_262_cov_2.122699	96	157	0	61	61	1.0000000
NODE_256386_length_262_cov_1.877301	0	77	0	77	77	1.0000000
NODE_256390_length_262_cov_1.877301	77	124	0	47	47	1.0000000
NODE_256481_length_262_cov_1.871166	192	252	0	60	60	1.0000000
NODE_256596_length_262_cov_1.736196	149	208	0	59	59	1.0000000
NODE_256630_length_262_cov_1.680982	2	82	0	80	80	1.0000000
NODE_256650_length_262_cov_1.656442	135	166	0	31	31	1.0000000
NODE_256659_length_262_cov_1.638037	111	142	2	31	31	1.0000000
NODE_256704_length_262_cov_1.576687	102	182	0	13	80	0.1625000
NODE_256704_length_262_cov_1.576687	102	182	1	67	80	0.8375000
NODE_256704_length_262_cov_1.576687	155	221	0	52	66	0.7878788
NODE_256704_length_262_cov_1.576687	155	221	1	14	66	0.2121212
NODE_256742_length_262_cov_1.564417	69	124	0	48	55	0.8727273
NODE_256742_length_262_cov_1.564417	69	124	2	7	55	0.1272727
NODE_256742_length_262_cov_1.564417	106	177	0	11	71	0.1549296
NODE_256742_length_262_cov_1.564417	106	177	2	60	71	0.8450704
NODE_256933_length_262_cov_1.349693	52	102	0	50	50	1.0000000
NODE_256933_length_262_cov_1.349693	83	149	0	66	66	1.0000000
NODE_257199_length_262_cov_1.251534	44	124	0	80	80	1.0000000
NODE_257199_length_262_cov_1.251534	97	171	0	74	74	1.0000000
NODE_258876_length_261_cov_31.913580	32	112	9	59	80	0.7375000
NODE_258876_length_261_cov_31.913580	32	112	11	8	80	0.1000000
NODE_258876_length_261_cov_31.913580	32	112	12	13	80	0.1625000
NODE_258876_length_261_cov_31.913580	85	171	7	39	86	0.4534884
NODE_258876_length_261_cov_31.913580	85	171	9	7	86	0.0813954
NODE_258876_length_261_cov_31.913580	85	171	10	11	86	0.1279070
NODE_258876_length_261_cov_31.913580	85	171	11	12	86	0.1395349
NODE_258876_length_261_cov_31.913580	85	171	12	17	86	0.1976744
NODE_258901_length_261_cov_6.376543	126	201	0	75	75	1.0000000
NODE_258901_length_261_cov_6.376543	179	254	0	75	75	1.0000000
NODE_258929_length_261_cov_5.469136	56	132	0	50	76	0.6578947
NODE_258929_length_261_cov_5.469136	56	132	2	26	76	0.3421053
NODE_259329_length_261_cov_2.425926	53	134	0	81	81	1.0000000
NODE_259361_length_261_cov_2.333333	41	136	0	95	95	1.0000000
NODE_259435_length_261_cov_2.191358	86	122	0	36	36	1.0000000
NODE_259495_length_261_cov_1.993827	134	214	1	9	80	0.1125000
NODE_259495_length_261_cov_1.993827	134	214	2	71	80	0.8875000
NODE_259672_length_261_cov_1.882716	51	105	0	18	54	0.3333333
NODE_259672_length_261_cov_1.882716	51	105	1	36	54	0.6666667
NODE_259740_length_261_cov_1.839506	118	197	0	72	79	0.9113924
NODE_259740_length_261_cov_1.839506	118	197	6	7	79	0.0886076
NODE_259769_length_261_cov_1.783951	69	141	0	72	72	1.0000000
NODE_260089_length_261_cov_1.388889	202	247	0	44	45	0.9777778
NODE_260089_length_261_cov_1.388889	202	247	1	1	45	0.0222222
NODE_260090_length_261_cov_1.382716	14	61	0	47	47	1.0000000
NODE_260428_length_261_cov_1.253086	100	138	0	38	38	1.0000000
NODE_260738_length_261_cov_1.030864	122	205	1	83	83	1.0000000
NODE_260738_length_261_cov_1.030864	129	210	1	81	81	1.0000000
NODE_260738_length_261_cov_1.030864	129	184	1	55	55	1.0000000
NODE_260738_length_261_cov_1.030864	187	248	1	61	61	1.0000000
NODE_260767_length_261_cov_1.006173	3	45	0	42	42	1.0000000
NODE_260767_length_261_cov_1.006173	46	98	0	52	52	1.0000000
NODE_262062_length_261_cov_0.580247	11	31	0	20	20	1.0000000
NODE_262121_length_260_cov_8.844720	74	138	0	64	64	1.0000000
NODE_262123_length_260_cov_8.447205	30	110	0	80	80	1.0000000
NODE_262123_length_260_cov_8.447205	83	167	0	84	84	1.0000000
NODE_262123_length_260_cov_8.447205	163	243	0	80	80	1.0000000
NODE_262149_length_260_cov_5.807453	38	118	0	80	80	1.0000000
NODE_262149_length_260_cov_5.807453	91	171	0	80	80	1.0000000
NODE_262264_length_260_cov_3.645963	5	57	0	52	52	1.0000000
NODE_262329_length_260_cov_3.167702	91	163	0	72	72	1.0000000
NODE_262378_length_260_cov_2.981366	58	127	0	69	69	1.0000000
NODE_262384_length_260_cov_2.913043	10	90	0	80	80	1.0000000
NODE_262708_length_260_cov_2.161491	174	251	0	77	77	1.0000000
NODE_262733_length_260_cov_2.080745	188	258	0	70	70	1.0000000
NODE_262788_length_260_cov_1.950311	27	85	4	39	58	0.6724138
NODE_262788_length_260_cov_1.950311	27	85	5	8	58	0.1379310
NODE_262788_length_260_cov_1.950311	27	85	6	11	58	0.1896552
NODE_262930_length_260_cov_1.900621	14	50	0	36	36	1.0000000
NODE_263117_length_260_cov_1.683230	50	130	0	80	80	1.0000000
NODE_263428_length_260_cov_1.347826	38	118	0	80	80	1.0000000
NODE_263533_length_260_cov_1.267081	114	199	0	85	85	1.0000000
NODE_263556_length_260_cov_1.267081	198	244	0	46	46	1.0000000
NODE_263568_length_260_cov_1.267081	145	189	0	44	44	1.0000000
NODE_265483_length_259_cov_4.800000	35	95	0	60	60	1.0000000
NODE_265584_length_259_cov_3.675000	119	161	1	42	42	1.0000000
NODE_265584_length_259_cov_3.675000	134	214	0	26	80	0.3250000
NODE_265584_length_259_cov_3.675000	134	214	1	54	80	0.6750000
NODE_265592_length_259_cov_3.593750	100	143	0	43	43	1.0000000
NODE_265611_length_259_cov_3.475000	198	259	0	61	61	1.0000000
NODE_265625_length_259_cov_3.331250	72	118	0	46	46	1.0000000
NODE_265636_length_259_cov_3.237500	103	160	0	57	57	1.0000000
NODE_265704_length_259_cov_2.937500	209	233	0	24	24	1.0000000
NODE_265735_length_259_cov_2.850000	0	41	0	36	41	0.8780488
NODE_265735_length_259_cov_2.850000	0	41	2	5	41	0.1219512
NODE_265735_length_259_cov_2.850000	14	94	0	22	80	0.2750000
NODE_265735_length_259_cov_2.850000	14	94	2	58	80	0.7250000
NODE_265818_length_259_cov_2.550000	9	82	0	6	73	0.0821918
NODE_265818_length_259_cov_2.550000	9	82	2	67	73	0.9178082
NODE_265942_length_259_cov_2.287500	147	225	0	78	78	1.0000000
NODE_265942_length_259_cov_2.287500	198	241	0	43	43	1.0000000
NODE_266032_length_259_cov_2.156250	0	72	0	72	72	1.0000000
NODE_266080_length_259_cov_2.012500	8	73	0	65	65	1.0000000
NODE_266080_length_259_cov_2.012500	53	126	0	73	73	1.0000000
NODE_266101_length_259_cov_1.962500	108	189	0	6	81	0.0740741
NODE_266101_length_259_cov_1.962500	108	189	2	75	81	0.9259259
NODE_266117_length_259_cov_1.918750	49	120	0	71	71	1.0000000
NODE_266183_length_259_cov_1.912500	114	177	0	63	63	1.0000000
NODE_266365_length_259_cov_1.837500	180	252	0	72	72	1.0000000
NODE_266609_length_259_cov_1.593750	27	67	0	26	40	0.6500000
NODE_266609_length_259_cov_1.593750	27	67	2	14	40	0.3500000
NODE_266746_length_259_cov_1.400000	117	164	0	47	47	1.0000000
NODE_266746_length_259_cov_1.400000	137	217	0	80	80	1.0000000
NODE_268816_length_258_cov_6.415094	129	209	0	80	80	1.0000000
NODE_268816_length_258_cov_6.415094	182	258	0	76	76	1.0000000
NODE_268823_length_258_cov_6.157233	1	81	0	80	80	1.0000000
NODE_268823_length_258_cov_6.157233	9	64	0	55	55	1.0000000
NODE_268852_length_258_cov_4.798742	83	163	0	80	80	1.0000000
NODE_268870_length_258_cov_4.396226	0	44	2	44	44	1.0000000
NODE_268870_length_258_cov_4.396226	24	97	2	73	73	1.0000000
NODE_268880_length_258_cov_4.301887	0	54	0	54	54	1.0000000
NODE_268942_length_258_cov_3.616352	29	58	0	29	29	1.0000000
NODE_268982_length_258_cov_3.352201	47	127	0	80	80	1.0000000
NODE_269086_length_258_cov_2.886792	102	121	0	19	19	1.0000000
NODE_269091_length_258_cov_2.880503	92	172	0	80	80	1.0000000
NODE_269102_length_258_cov_2.855346	96	138	8	42	42	1.0000000
NODE_269102_length_258_cov_2.855346	148	191	4	28	43	0.6511628
NODE_269102_length_258_cov_2.855346	148	191	6	15	43	0.3488372
NODE_269113_length_258_cov_2.817610	10	58	0	48	48	1.0000000
NODE_269264_length_258_cov_2.383648	48	128	0	25	80	0.3125000
NODE_269264_length_258_cov_2.383648	48	128	2	55	80	0.6875000
NODE_269264_length_258_cov_2.383648	101	182	2	81	81	1.0000000
NODE_269338_length_258_cov_2.238994	61	141	0	80	80	1.0000000
NODE_269615_length_258_cov_1.918239	0	51	0	51	51	1.0000000
NODE_269682_length_258_cov_1.855346	26	47	0	13	21	0.6190476
NODE_269682_length_258_cov_1.855346	26	47	2	8	21	0.3809524
NODE_269682_length_258_cov_1.855346	71	104	2	33	33	1.0000000
NODE_269682_length_258_cov_1.855346	81	156	2	75	75	1.0000000
NODE_269749_length_258_cov_1.735849	105	176	1	15	71	0.2112676
NODE_269749_length_258_cov_1.735849	105	176	2	44	71	0.6197183
NODE_269749_length_258_cov_1.735849	105	176	4	12	71	0.1690141
NODE_269767_length_258_cov_1.710692	8	49	0	41	41	1.0000000
NODE_270191_length_258_cov_1.283019	127	191	3	51	64	0.7968750
NODE_270191_length_258_cov_1.283019	127	191	4	13	64	0.2031250
NODE_270191_length_258_cov_1.283019	164	227	3	63	63	1.0000000
NODE_270465_length_258_cov_1.270440	4	55	0	51	51	1.0000000
NODE_270504_length_258_cov_1.232704	90	166	0	76	76	1.0000000
NODE_270547_length_258_cov_1.201258	49	98	1	49	49	1.0000000
NODE_270876_length_258_cov_0.962264	186	258	0	72	72	1.0000000
NODE_270970_length_258_cov_0.962264	69	124	0	55	55	1.0000000
NODE_272169_length_257_cov_71.158228	81	165	15	2	84	0.0238095
NODE_272169_length_257_cov_71.158228	81	165	17	2	84	0.0238095
NODE_272169_length_257_cov_71.158228	81	165	18	17	84	0.2023810
NODE_272169_length_257_cov_71.158228	81	165	20	1	84	0.0119048
NODE_272169_length_257_cov_71.158228	81	165	21	3	84	0.0357143
NODE_272169_length_257_cov_71.158228	81	165	22	3	84	0.0357143
NODE_272169_length_257_cov_71.158228	81	165	23	4	84	0.0476190
NODE_272169_length_257_cov_71.158228	81	165	25	1	84	0.0119048
NODE_272169_length_257_cov_71.158228	81	165	26	3	84	0.0357143
NODE_272169_length_257_cov_71.158228	81	165	27	17	84	0.2023810
NODE_272169_length_257_cov_71.158228	81	165	28	12	84	0.1428571
NODE_272169_length_257_cov_71.158228	81	165	29	8	84	0.0952381
NODE_272169_length_257_cov_71.158228	81	165	30	11	84	0.1309524
NODE_272169_length_257_cov_71.158228	145	218	10	8	73	0.1095890
NODE_272169_length_257_cov_71.158228	145	218	12	2	73	0.0273973
NODE_272169_length_257_cov_71.158228	145	218	13	18	73	0.2465753
NODE_272169_length_257_cov_71.158228	145	218	15	27	73	0.3698630
NODE_272169_length_257_cov_71.158228	145	218	17	2	73	0.0273973
NODE_272169_length_257_cov_71.158228	145	218	18	16	73	0.2191781
NODE_272194_length_257_cov_6.329114	15	93	0	78	78	1.0000000
NODE_272275_length_257_cov_4.177215	25	86	0	61	61	1.0000000
NODE_272291_length_257_cov_3.987342	55	107	0	52	52	1.0000000
NODE_272304_length_257_cov_3.873418	145	225	0	80	80	1.0000000
NODE_272304_length_257_cov_3.873418	198	254	0	56	56	1.0000000
NODE_272322_length_257_cov_3.740506	133	199	0	8	66	0.1212121
NODE_272322_length_257_cov_3.740506	133	199	1	38	66	0.5757576
NODE_272322_length_257_cov_3.740506	133	199	2	7	66	0.1060606
NODE_272322_length_257_cov_3.740506	133	199	4	8	66	0.1212121
NODE_272322_length_257_cov_3.740506	133	199	6	5	66	0.0757576
NODE_272322_length_257_cov_3.740506	177	256	0	65	79	0.8227848
NODE_272322_length_257_cov_3.740506	177	256	1	14	79	0.1772152
NODE_272486_length_257_cov_2.734177	1	65	0	64	64	1.0000000
NODE_272491_length_257_cov_2.677215	170	250	0	41	80	0.5125000
NODE_272491_length_257_cov_2.677215	170	250	4	15	80	0.1875000
NODE_272491_length_257_cov_2.677215	170	250	5	13	80	0.1625000
NODE_272491_length_257_cov_2.677215	170	250	7	8	80	0.1000000
NODE_272491_length_257_cov_2.677215	170	250	9	3	80	0.0375000
NODE_272580_length_257_cov_2.537975	60	137	2	77	77	1.0000000
NODE_272596_length_257_cov_2.487342	95	172	0	77	77	1.0000000
NODE_272625_length_257_cov_2.379747	106	186	0	80	80	1.0000000
NODE_272625_length_257_cov_2.379747	159	207	0	48	48	1.0000000
NODE_272724_length_257_cov_2.221519	163	240	0	77	77	1.0000000
NODE_272729_length_257_cov_2.202532	16	97	2	81	81	1.0000000
NODE_273151_length_257_cov_1.664557	220	239	0	19	19	1.0000000
NODE_273357_length_257_cov_1.500000	85	166	0	81	81	1.0000000
NODE_273462_length_257_cov_1.329114	120	186	0	66	66	1.0000000
NODE_273533_length_257_cov_1.291139	13	53	3	5	40	0.1250000
NODE_273533_length_257_cov_1.291139	13	53	4	35	40	0.8750000
NODE_273697_length_257_cov_1.291139	205	257	0	52	52	1.0000000
NODE_273894_length_257_cov_1.221519	10	74	0	64	64	1.0000000
NODE_273917_length_257_cov_1.196203	70	150	0	70	80	0.8750000
NODE_273917_length_257_cov_1.196203	70	150	2	10	80	0.1250000
NODE_273917_length_257_cov_1.196203	123	204	0	17	81	0.2098765
NODE_273917_length_257_cov_1.196203	123	204	2	64	81	0.7901235
NODE_275399_length_257_cov_0.645570	138	158	0	20	20	1.0000000
NODE_275419_length_257_cov_0.645570	181	241	0	60	60	1.0000000
NODE_275598_length_256_cov_5.235669	30	77	0	47	47	1.0000000
NODE_275624_length_256_cov_4.598726	100	180	0	80	80	1.0000000
NODE_275624_length_256_cov_4.598726	160	211	0	51	51	1.0000000
NODE_275682_length_256_cov_3.866242	112	166	0	54	54	1.0000000
NODE_275840_length_256_cov_2.878981	79	159	1	13	80	0.1625000
NODE_275840_length_256_cov_2.878981	79	159	2	4	80	0.0500000
NODE_275840_length_256_cov_2.878981	79	159	4	5	80	0.0625000
NODE_275840_length_256_cov_2.878981	79	159	6	58	80	0.7250000
NODE_275840_length_256_cov_2.878981	132	212	5	32	80	0.4000000
NODE_275840_length_256_cov_2.878981	132	212	6	48	80	0.6000000
NODE_275909_length_256_cov_2.598726	157	222	0	65	65	1.0000000
NODE_275909_length_256_cov_2.598726	195	249	0	54	54	1.0000000
NODE_275981_length_256_cov_2.445860	104	183	0	3	79	0.0379747
NODE_275981_length_256_cov_2.445860	104	183	2	76	79	0.9620253
NODE_276082_length_256_cov_2.229299	0	58	0	58	58	1.0000000
NODE_276082_length_256_cov_2.229299	17	68	0	51	51	1.0000000
NODE_276082_length_256_cov_2.229299	41	88	0	47	47	1.0000000
NODE_276082_length_256_cov_2.229299	42	122	0	80	80	1.0000000
NODE_276098_length_256_cov_2.184713	192	246	0	54	54	1.0000000
NODE_276119_length_256_cov_2.121019	150	236	0	33	86	0.3837209
NODE_276119_length_256_cov_2.121019	150	236	2	53	86	0.6162791
NODE_276174_length_256_cov_1.974522	130	174	0	36	44	0.8181818
NODE_276174_length_256_cov_1.974522	130	174	1	8	44	0.1818182
NODE_276471_length_256_cov_1.707006	39	92	0	48	53	0.9056604
NODE_276471_length_256_cov_1.707006	39	92	1	1	53	0.0188679
NODE_276471_length_256_cov_1.707006	39	92	2	4	53	0.0754717
NODE_276471_length_256_cov_1.707006	93	135	2	15	42	0.3571429
NODE_276471_length_256_cov_1.707006	93	135	4	27	42	0.6428571
NODE_276484_length_256_cov_1.700637	107	129	0	22	22	1.0000000
NODE_276495_length_256_cov_1.675159	52	98	0	46	46	1.0000000
NODE_276654_length_256_cov_1.598726	125	202	0	77	77	1.0000000
NODE_276654_length_256_cov_1.598726	178	256	0	78	78	1.0000000
NODE_276672_length_256_cov_1.579618	110	172	0	62	62	1.0000000
NODE_276672_length_256_cov_1.579618	194	239	0	45	45	1.0000000
NODE_276742_length_256_cov_1.464968	112	135	0	23	23	1.0000000
NODE_276826_length_256_cov_1.331210	138	209	2	14	71	0.1971831
NODE_276826_length_256_cov_1.331210	138	209	4	57	71	0.8028169
NODE_276826_length_256_cov_1.331210	182	240	1	9	58	0.1551724
NODE_276826_length_256_cov_1.331210	182	240	2	36	58	0.6206896
NODE_276826_length_256_cov_1.331210	182	240	4	13	58	0.2241379
NODE_277113_length_256_cov_1.299363	88	160	0	72	72	1.0000000
NODE_277305_length_256_cov_1.203822	3	43	0	15	40	0.3750000
NODE_277305_length_256_cov_1.203822	3	43	2	25	40	0.6250000
NODE_277305_length_256_cov_1.203822	16	96	0	2	80	0.0250000
NODE_277305_length_256_cov_1.203822	16	96	2	78	80	0.9750000
NODE_278934_length_255_cov_73.756410	52	99	2	2	47	0.0425532
NODE_278934_length_255_cov_73.756410	52	99	3	1	47	0.0212766
NODE_278934_length_255_cov_73.756410	52	99	4	4	47	0.0851064
NODE_278934_length_255_cov_73.756410	52	99	5	4	47	0.0851064
NODE_278934_length_255_cov_73.756410	52	99	6	11	47	0.2340426
NODE_278934_length_255_cov_73.756410	52	99	8	25	47	0.5319149
NODE_278934_length_255_cov_73.756410	133	184	10	1	51	0.0196078
NODE_278934_length_255_cov_73.756410	133	184	13	27	51	0.5294118
NODE_278934_length_255_cov_73.756410	133	184	14	23	51	0.4509804
NODE_278934_length_255_cov_73.756410	157	237	4	17	80	0.2125000
NODE_278934_length_255_cov_73.756410	157	237	6	7	80	0.0875000
NODE_278934_length_255_cov_73.756410	157	237	7	4	80	0.0500000
NODE_278934_length_255_cov_73.756410	157	237	8	5	80	0.0625000
NODE_278934_length_255_cov_73.756410	157	237	11	2	80	0.0250000
NODE_278934_length_255_cov_73.756410	157	237	12	17	80	0.2125000
NODE_278934_length_255_cov_73.756410	157	237	13	28	80	0.3500000
NODE_278937_length_255_cov_15.538462	219	255	0	36	36	1.0000000
NODE_279003_length_255_cov_4.884615	157	230	0	71	73	0.9726027
NODE_279003_length_255_cov_4.884615	157	230	1	2	73	0.0273973
NODE_279003_length_255_cov_4.884615	203	248	0	45	45	1.0000000
NODE_279058_length_255_cov_4.012821	68	148	2	80	80	1.0000000
NODE_279075_length_255_cov_3.826923	16	80	2	18	64	0.2812500
NODE_279075_length_255_cov_3.826923	16	80	4	46	64	0.7187500
NODE_279102_length_255_cov_3.596154	30	60	0	30	30	1.0000000
NODE_279134_length_255_cov_3.423077	64	109	2	45	45	1.0000000
NODE_279166_length_255_cov_3.262821	0	48	0	48	48	1.0000000
NODE_279166_length_255_cov_3.262821	66	113	0	47	47	1.0000000
NODE_279241_length_255_cov_2.942308	157	176	0	19	19	1.0000000
NODE_279320_length_255_cov_2.621795	227	254	0	27	27	1.0000000
NODE_279379_length_255_cov_2.602564	131	185	0	54	54	1.0000000
NODE_279427_length_255_cov_2.487179	43	119	0	76	76	1.0000000
NODE_279447_length_255_cov_2.435897	0	58	0	20	58	0.3448276
NODE_279447_length_255_cov_2.435897	0	58	1	38	58	0.6551724
NODE_279462_length_255_cov_2.391026	189	255	0	66	66	1.0000000
NODE_279507_length_255_cov_2.288462	0	60	2	17	60	0.2833333
NODE_279507_length_255_cov_2.288462	0	60	4	43	60	0.7166666
NODE_279510_length_255_cov_2.288462	0	74	0	74	74	1.0000000
NODE_279620_length_255_cov_2.089744	105	145	0	40	40	1.0000000
NODE_279649_length_255_cov_1.987179	0	72	0	72	72	1.0000000
NODE_279842_length_255_cov_1.910256	198	255	0	54	57	0.9473684
NODE_279842_length_255_cov_1.910256	198	255	2	3	57	0.0526316
NODE_279871_length_255_cov_1.871795	16	68	0	47	52	0.9038461
NODE_279871_length_255_cov_1.871795	16	68	2	5	52	0.0961538
NODE_279892_length_255_cov_1.826923	146	218	0	72	72	1.0000000
NODE_279956_length_255_cov_1.705128	0	45	0	45	45	1.0000000
NODE_279956_length_255_cov_1.705128	41	121	0	15	80	0.1875000
NODE_279956_length_255_cov_1.705128	41	121	1	65	80	0.8125000
NODE_279956_length_255_cov_1.705128	94	174	1	80	80	1.0000000
NODE_280153_length_255_cov_1.576923	43	117	0	24	74	0.3243243
NODE_280153_length_255_cov_1.576923	43	117	1	1	74	0.0135135
NODE_280153_length_255_cov_1.576923	43	117	2	49	74	0.6621622
NODE_280153_length_255_cov_1.576923	90	175	0	5	85	0.0588235
NODE_280153_length_255_cov_1.576923	90	175	1	1	85	0.0117647
NODE_280153_length_255_cov_1.576923	90	175	2	79	85	0.9294118
NODE_280168_length_255_cov_1.557692	62	125	0	63	63	1.0000000
NODE_280297_length_255_cov_1.358974	178	246	0	68	68	1.0000000
NODE_280904_length_255_cov_1.128205	183	219	0	36	36	1.0000000
NODE_281094_length_255_cov_0.987179	220	241	0	14	21	0.6666667
NODE_281094_length_255_cov_0.987179	220	241	1	7	21	0.3333333
NODE_281380_length_255_cov_0.955128	119	171	0	52	52	1.0000000
NODE_281384_length_255_cov_0.955128	12	92	0	80	80	1.0000000
NODE_282137_length_255_cov_0.653846	87	106	0	19	19	1.0000000
NODE_282534_length_254_cov_4.935484	144	189	2	45	45	1.0000000
NODE_282534_length_254_cov_4.935484	164	242	2	78	78	1.0000000
NODE_282548_length_254_cov_4.722581	44	85	0	41	41	1.0000000
NODE_282576_length_254_cov_4.296774	149	174	0	25	25	1.0000000
NODE_282576_length_254_cov_4.296774	149	223	0	74	74	1.0000000
NODE_282590_length_254_cov_4.206452	57	86	0	29	29	1.0000000
NODE_282626_length_254_cov_3.677419	7	64	0	21	57	0.3684210
NODE_282626_length_254_cov_3.677419	7	64	2	36	57	0.6315789
NODE_282626_length_254_cov_3.677419	60	117	2	57	57	1.0000000
NODE_282642_length_254_cov_3.593548	154	197	2	43	43	1.0000000
NODE_282659_length_254_cov_3.438710	82	129	0	47	47	1.0000000
NODE_282659_length_254_cov_3.438710	102	182	0	80	80	1.0000000
NODE_282736_length_254_cov_2.961290	5	79	0	74	74	1.0000000
NODE_282736_length_254_cov_2.961290	52	118	0	66	66	1.0000000
NODE_282771_length_254_cov_2.780645	169	252	2	39	83	0.4698795
NODE_282771_length_254_cov_2.780645	169	252	4	26	83	0.3132530
NODE_282771_length_254_cov_2.780645	169	252	6	18	83	0.2168675
NODE_282947_length_254_cov_2.341935	167	201	0	34	34	1.0000000
NODE_283082_length_254_cov_2.161290	14	74	0	60	60	1.0000000
NODE_283244_length_254_cov_1.974194	156	204	0	48	48	1.0000000
NODE_283440_length_254_cov_1.780645	79	126	0	8	47	0.1702128
NODE_283440_length_254_cov_1.780645	79	126	2	39	47	0.8297873
NODE_283952_length_254_cov_1.316129	23	87	0	64	64	1.0000000
NODE_284013_length_254_cov_1.316129	193	215	0	22	22	1.0000000
NODE_284256_length_254_cov_1.258065	181	249	0	68	68	1.0000000
NODE_284275_length_254_cov_1.238710	9	82	0	73	73	1.0000000
NODE_284275_length_254_cov_1.238710	62	82	0	20	20	1.0000000
NODE_284277_length_254_cov_1.238710	54	73	0	19	19	1.0000000
NODE_284301_length_254_cov_1.219355	98	157	0	56	59	0.9491525
NODE_284301_length_254_cov_1.219355	98	157	2	3	59	0.0508475
NODE_284638_length_254_cov_0.987097	139	193	0	54	54	1.0000000
NODE_284638_length_254_cov_0.987097	205	254	0	49	49	1.0000000
NODE_284796_length_254_cov_0.987097	121	152	0	31	31	1.0000000
NODE_285963_length_253_cov_60.311688	137	202	2	1	65	0.0153846
NODE_285963_length_253_cov_60.311688	137	202	8	5	65	0.0769231
NODE_285963_length_253_cov_60.311688	137	202	10	59	65	0.9076923
NODE_285963_length_253_cov_60.311688	175	253	0	4	78	0.0512821
NODE_285963_length_253_cov_60.311688	175	253	1	3	78	0.0384615
NODE_285963_length_253_cov_60.311688	175	253	3	1	78	0.0128205
NODE_285963_length_253_cov_60.311688	175	253	7	1	78	0.0128205
NODE_285963_length_253_cov_60.311688	175	253	8	4	78	0.0512821
NODE_285963_length_253_cov_60.311688	175	253	10	65	78	0.8333333
NODE_285965_length_253_cov_41.519481	0	68	0	15	68	0.2205882
NODE_285965_length_253_cov_41.519481	0	68	1	3	68	0.0441176
NODE_285965_length_253_cov_41.519481	0	68	3	35	68	0.5147059
NODE_285965_length_253_cov_41.519481	0	68	4	1	68	0.0147059
NODE_285965_length_253_cov_41.519481	0	68	5	3	68	0.0441176
NODE_285965_length_253_cov_41.519481	0	68	6	11	68	0.1617647
NODE_285965_length_253_cov_41.519481	0	70	0	15	70	0.2142857
NODE_285965_length_253_cov_41.519481	0	70	1	3	70	0.0428571
NODE_285965_length_253_cov_41.519481	0	70	3	35	70	0.5000000
NODE_285965_length_253_cov_41.519481	0	70	4	1	70	0.0142857
NODE_285965_length_253_cov_41.519481	0	70	5	3	70	0.0428571
NODE_285965_length_253_cov_41.519481	0	70	6	13	70	0.1857143
NODE_285965_length_253_cov_41.519481	2	73	0	13	71	0.1830986
NODE_285965_length_253_cov_41.519481	2	73	1	3	71	0.0422535
NODE_285965_length_253_cov_41.519481	2	73	3	35	71	0.4929577
NODE_285965_length_253_cov_41.519481	2	73	4	1	71	0.0140845
NODE_285965_length_253_cov_41.519481	2	73	5	3	71	0.0422535
NODE_285965_length_253_cov_41.519481	2	73	6	16	71	0.2253521
NODE_285965_length_253_cov_41.519481	7	73	0	8	66	0.1212121
NODE_285965_length_253_cov_41.519481	7	73	1	3	66	0.0454545
NODE_285965_length_253_cov_41.519481	7	73	3	35	66	0.5303030
NODE_285965_length_253_cov_41.519481	7	73	4	1	66	0.0151515
NODE_285965_length_253_cov_41.519481	7	73	5	3	66	0.0454545
NODE_285965_length_253_cov_41.519481	7	73	6	16	66	0.2424242
NODE_285965_length_253_cov_41.519481	46	123	3	7	77	0.0909091
NODE_285965_length_253_cov_41.519481	46	123	4	1	77	0.0129870
NODE_285965_length_253_cov_41.519481	46	123	5	3	77	0.0389610
NODE_285965_length_253_cov_41.519481	46	123	6	66	77	0.8571429
NODE_285965_length_253_cov_41.519481	46	123	3	7	77	0.0909091
NODE_285965_length_253_cov_41.519481	46	123	4	1	77	0.0129870
NODE_285965_length_253_cov_41.519481	46	123	5	3	77	0.0389610
NODE_285965_length_253_cov_41.519481	46	123	6	66	77	0.8571429
NODE_285965_length_253_cov_41.519481	46	123	3	7	77	0.0909091
NODE_285965_length_253_cov_41.519481	46	123	4	1	77	0.0129870
NODE_285965_length_253_cov_41.519481	46	123	5	3	77	0.0389610
NODE_285965_length_253_cov_41.519481	46	123	6	66	77	0.8571429
NODE_285967_length_253_cov_13.967532	25	105	2	58	80	0.7250000
NODE_285967_length_253_cov_13.967532	25	105	4	22	80	0.2750000
NODE_285967_length_253_cov_13.967532	78	158	2	64	80	0.8000000
NODE_285967_length_253_cov_13.967532	78	158	4	16	80	0.2000000
NODE_285969_length_253_cov_12.259740	0	54	0	54	54	1.0000000
NODE_285969_length_253_cov_12.259740	27	62	0	35	35	1.0000000
NODE_285969_length_253_cov_12.259740	51	131	0	80	80	1.0000000
NODE_285969_length_253_cov_12.259740	104	139	0	35	35	1.0000000
NODE_285969_length_253_cov_12.259740	128	208	0	80	80	1.0000000
NODE_285969_length_253_cov_12.259740	181	216	0	35	35	1.0000000
NODE_285987_length_253_cov_7.279221	184	250	0	47	66	0.7121212
NODE_285987_length_253_cov_7.279221	184	250	1	19	66	0.2878788
NODE_286022_length_253_cov_5.376623	66	147	0	81	81	1.0000000
NODE_286022_length_253_cov_5.376623	120	185	0	65	65	1.0000000
NODE_286042_length_253_cov_4.896104	102	182	4	32	80	0.4000000
NODE_286042_length_253_cov_4.896104	102	182	5	2	80	0.0250000
NODE_286042_length_253_cov_4.896104	102	182	6	46	80	0.5750000
NODE_286046_length_253_cov_4.798701	199	253	0	54	54	1.0000000
NODE_286069_length_253_cov_4.487013	85	126	0	41	41	1.0000000
NODE_286151_length_253_cov_3.500000	44	105	0	61	61	1.0000000
NODE_286151_length_253_cov_3.500000	90	158	0	68	68	1.0000000
NODE_286259_length_253_cov_2.987013	85	165	0	80	80	1.0000000
NODE_286259_length_253_cov_2.987013	138	169	0	31	31	1.0000000
NODE_286275_length_253_cov_2.954545	100	148	0	48	48	1.0000000
NODE_286281_length_253_cov_2.909091	34	99	0	3	65	0.0461538
NODE_286281_length_253_cov_2.909091	34	99	2	29	65	0.4461538
NODE_286281_length_253_cov_2.909091	34	99	4	33	65	0.5076923
NODE_286288_length_253_cov_2.889610	129	200	3	6	71	0.0845070
NODE_286288_length_253_cov_2.889610	129	200	4	65	71	0.9154930
NODE_286288_length_253_cov_2.889610	173	253	0	7	80	0.0875000
NODE_286288_length_253_cov_2.889610	173	253	1	4	80	0.0500000
NODE_286288_length_253_cov_2.889610	173	253	2	11	80	0.1375000
NODE_286288_length_253_cov_2.889610	173	253	3	37	80	0.4625000
NODE_286288_length_253_cov_2.889610	173	253	4	21	80	0.2625000
NODE_286289_length_253_cov_2.889610	21	76	0	55	55	1.0000000
NODE_286289_length_253_cov_2.889610	149	229	0	80	80	1.0000000
NODE_286379_length_253_cov_2.610390	113	193	0	80	80	1.0000000
NODE_286386_length_253_cov_2.584416	97	154	0	57	57	1.0000000
NODE_286545_length_253_cov_2.240260	185	250	0	65	65	1.0000000
NODE_286667_length_253_cov_1.987013	157	237	0	80	80	1.0000000
NODE_286667_length_253_cov_1.987013	210	253	0	43	43	1.0000000
NODE_286685_length_253_cov_1.987013	18	60	0	42	42	1.0000000
NODE_286829_length_253_cov_1.961039	186	232	2	46	46	1.0000000
NODE_286837_length_253_cov_1.948052	68	120	0	52	52	1.0000000
NODE_286838_length_253_cov_1.948052	63	114	0	51	51	1.0000000
NODE_286947_length_253_cov_1.746753	164	193	0	29	29	1.0000000
NODE_287031_length_253_cov_1.655844	40	120	0	80	80	1.0000000
NODE_287031_length_253_cov_1.655844	93	152	0	59	59	1.0000000
NODE_287133_length_253_cov_1.590909	102	148	0	46	46	1.0000000
NODE_287156_length_253_cov_1.558442	67	149	1	82	82	1.0000000
NODE_287230_length_253_cov_1.441558	49	113	0	64	64	1.0000000
NODE_287230_length_253_cov_1.441558	102	166	0	64	64	1.0000000
NODE_287232_length_253_cov_1.441558	121	185	0	64	64	1.0000000
NODE_287234_length_253_cov_1.435065	50	81	0	31	31	1.0000000
NODE_287584_length_253_cov_1.324675	193	239	0	46	46	1.0000000
NODE_287599_length_253_cov_1.324675	90	132	4	42	42	1.0000000
NODE_287599_length_253_cov_1.324675	133	185	0	34	52	0.6538461
NODE_287599_length_253_cov_1.324675	133	185	2	13	52	0.2500000
NODE_287599_length_253_cov_1.324675	133	185	4	5	52	0.0961538
NODE_287721_length_253_cov_1.285714	87	125	0	38	38	1.0000000
NODE_287794_length_253_cov_1.214286	99	148	0	49	49	1.0000000
NODE_287845_length_253_cov_1.181818	185	247	0	62	62	1.0000000
NODE_287845_length_253_cov_1.181818	185	247	0	62	62	1.0000000
NODE_287989_length_253_cov_1.064935	83	159	0	29	76	0.3815790
NODE_287989_length_253_cov_1.064935	83	159	2	47	76	0.6184211
NODE_288099_length_253_cov_0.993506	0	44	0	44	44	1.0000000
NODE_288465_length_253_cov_0.870130	17	46	0	29	29	1.0000000
NODE_288478_length_253_cov_0.850649	0	89	0	89	89	1.0000000
NODE_289563_length_252_cov_4.771242	94	148	0	54	54	1.0000000
NODE_289574_length_252_cov_4.614379	16	37	0	21	21	1.0000000
NODE_289624_length_252_cov_3.960784	7	85	0	78	78	1.0000000
NODE_289624_length_252_cov_3.960784	63	136	0	73	73	1.0000000
NODE_289663_length_252_cov_3.549020	89	157	0	68	68	1.0000000
NODE_289672_length_252_cov_3.405229	26	107	0	81	81	1.0000000
NODE_289705_length_252_cov_3.307190	91	141	0	50	50	1.0000000
NODE_289742_length_252_cov_3.032680	135	212	0	77	77	1.0000000
NODE_289775_length_252_cov_2.928105	0	57	0	57	57	1.0000000
NODE_289799_length_252_cov_2.803922	41	121	0	80	80	1.0000000
NODE_290032_length_252_cov_2.320261	0	64	0	59	64	0.9218750
NODE_290032_length_252_cov_2.320261	0	64	1	5	64	0.0781250
NODE_290046_length_252_cov_2.281046	120	170	0	50	50	1.0000000
NODE_290066_length_252_cov_2.215686	137	175	14	5	38	0.1315790
NODE_290066_length_252_cov_2.215686	137	175	16	33	38	0.8684211
NODE_290103_length_252_cov_2.052288	18	39	0	21	21	1.0000000
NODE_290238_length_252_cov_1.993464	80	139	0	59	59	1.0000000
NODE_290385_length_252_cov_1.810458	3	49	0	46	46	1.0000000
NODE_290623_length_252_cov_1.594771	103	156	0	53	53	1.0000000
NODE_290623_length_252_cov_1.594771	152	192	0	40	40	1.0000000
NODE_290638_length_252_cov_1.568627	1	68	0	67	67	1.0000000
NODE_290767_length_252_cov_1.359477	26	93	0	67	67	1.0000000
NODE_290790_length_252_cov_1.333333	179	232	0	53	53	1.0000000
NODE_290850_length_252_cov_1.333333	187	222	0	35	35	1.0000000
NODE_291072_length_252_cov_1.333333	31	111	0	72	80	0.9000000
NODE_291072_length_252_cov_1.333333	31	111	1	8	80	0.1000000
NODE_291076_length_252_cov_1.333333	90	140	0	50	50	1.0000000
NODE_291118_length_252_cov_1.326797	112	143	0	31	31	1.0000000
NODE_291351_length_252_cov_1.156863	1	32	0	31	31	1.0000000
NODE_291650_length_252_cov_1.000000	49	79	0	30	30	1.0000000
NODE_291911_length_252_cov_0.836601	125	172	0	47	47	1.0000000
NODE_293004_length_251_cov_5.032895	0	62	0	62	62	1.0000000
NODE_293005_length_251_cov_5.026316	84	164	0	80	80	1.0000000
NODE_293165_length_251_cov_3.302632	187	249	0	7	62	0.1129032
NODE_293165_length_251_cov_3.302632	187	249	2	55	62	0.8870968
NODE_293195_length_251_cov_3.131579	96	148	0	52	52	1.0000000
NODE_293238_length_251_cov_2.980263	11	38	0	18	27	0.6666667
NODE_293238_length_251_cov_2.980263	11	38	2	9	27	0.3333333
NODE_293238_length_251_cov_2.980263	11	91	0	18	80	0.2250000
NODE_293238_length_251_cov_2.980263	11	91	2	62	80	0.7750000
NODE_293259_length_251_cov_2.842105	170	198	0	28	28	1.0000000
NODE_293279_length_251_cov_2.743421	181	232	0	51	51	1.0000000
NODE_293335_length_251_cov_2.677632	35	54	0	19	19	1.0000000
NODE_293454_length_251_cov_2.348684	196	251	0	55	55	1.0000000
NODE_293502_length_251_cov_2.328947	86	149	0	63	63	1.0000000
NODE_293516_length_251_cov_2.296053	91	171	0	80	80	1.0000000
NODE_293516_length_251_cov_2.296053	144	224	0	80	80	1.0000000
NODE_293591_length_251_cov_2.065789	7	52	0	43	45	0.9555556
NODE_293591_length_251_cov_2.065789	7	52	1	2	45	0.0444444
NODE_293698_length_251_cov_2.013158	96	179	0	83	83	1.0000000
NODE_293698_length_251_cov_2.013158	96	179	0	83	83	1.0000000
NODE_293698_length_251_cov_2.013158	152	203	0	51	51	1.0000000
NODE_293698_length_251_cov_2.013158	152	201	0	49	49	1.0000000
NODE_293919_length_251_cov_1.710526	135	194	0	59	59	1.0000000
NODE_294028_length_251_cov_1.671053	94	127	0	33	33	1.0000000
NODE_294063_length_251_cov_1.644737	135	164	0	29	29	1.0000000
NODE_294147_length_251_cov_1.473684	137	202	1	64	65	0.9846154
NODE_294147_length_251_cov_1.473684	137	202	2	1	65	0.0153846
NODE_294153_length_251_cov_1.460526	17	78	0	61	61	1.0000000
NODE_294190_length_251_cov_1.407895	182	246	0	64	64	1.0000000
NODE_294393_length_251_cov_1.342105	9	89	0	80	80	1.0000000
NODE_294393_length_251_cov_1.342105	62	91	0	29	29	1.0000000
NODE_294624_length_251_cov_1.296053	7	47	0	40	40	1.0000000
NODE_294624_length_251_cov_1.296053	24	47	0	23	23	1.0000000
NODE_295165_length_251_cov_1.006579	4	50	0	46	46	1.0000000
NODE_296033_length_251_cov_0.671053	184	204	0	20	20	1.0000000
NODE_296386_length_251_cov_0.572368	54	74	0	20	20	1.0000000
NODE_296437_length_250_cov_35.662252	33	99	0	66	66	1.0000000
NODE_296437_length_250_cov_35.662252	143	223	0	80	80	1.0000000
NODE_296456_length_250_cov_6.503311	186	250	0	64	64	1.0000000
NODE_296467_length_250_cov_5.867550	99	120	2	21	21	1.0000000
NODE_296520_length_250_cov_4.662252	143	187	0	44	44	1.0000000
NODE_296520_length_250_cov_4.662252	160	227	0	67	67	1.0000000
NODE_296598_length_250_cov_3.715232	37	90	0	53	53	1.0000000
NODE_296633_length_250_cov_3.417219	113	193	0	80	80	1.0000000
NODE_296633_length_250_cov_3.417219	166	246	0	80	80	1.0000000
NODE_296653_length_250_cov_3.364238	0	61	0	7	61	0.1147541
NODE_296653_length_250_cov_3.364238	0	61	1	22	61	0.3606557
NODE_296653_length_250_cov_3.364238	0	61	2	32	61	0.5245901
NODE_296653_length_250_cov_3.364238	34	94	2	60	60	1.0000000
NODE_296680_length_250_cov_3.225166	157	209	2	52	52	1.0000000
NODE_296680_length_250_cov_3.225166	182	250	0	6	68	0.0882353
NODE_296680_length_250_cov_3.225166	182	250	2	62	68	0.9117647
NODE_296699_length_250_cov_3.086093	33	67	0	34	34	1.0000000
NODE_296703_length_250_cov_3.052980	29	94	3	5	65	0.0769231
NODE_296703_length_250_cov_3.052980	29	94	5	60	65	0.9230769
NODE_296707_length_250_cov_3.039735	51	106	0	55	55	1.0000000
NODE_296737_length_250_cov_2.986755	124	185	0	61	61	1.0000000
NODE_296737_length_250_cov_2.986755	172	243	0	71	71	1.0000000
NODE_296885_length_250_cov_2.516556	0	49	0	49	49	1.0000000
NODE_296893_length_250_cov_2.476821	94	174	0	80	80	1.0000000
NODE_296893_length_250_cov_2.476821	147	227	0	80	80	1.0000000
NODE_296897_length_250_cov_2.470199	166	212	0	46	46	1.0000000
NODE_297070_length_250_cov_2.059603	150	207	0	57	57	1.0000000
NODE_297211_length_250_cov_2.019868	74	141	0	15	67	0.2238806
NODE_297211_length_250_cov_2.019868	74	141	2	3	67	0.0447761
NODE_297211_length_250_cov_2.019868	74	141	4	49	67	0.7313433
NODE_297211_length_250_cov_2.019868	158	204	0	46	46	1.0000000
NODE_297550_length_250_cov_1.688742	6	42	1	11	36	0.3055556
NODE_297550_length_250_cov_1.688742	6	42	2	25	36	0.6944444
NODE_297624_length_250_cov_1.635762	150	191	0	25	41	0.6097561
NODE_297624_length_250_cov_1.635762	150	191	1	16	41	0.3902439
NODE_297679_length_250_cov_1.529801	59	108	0	49	49	1.0000000
NODE_297679_length_250_cov_1.529801	81	161	0	80	80	1.0000000
NODE_297693_length_250_cov_1.516556	124	184	0	60	60	1.0000000
NODE_297693_length_250_cov_1.516556	166	237	0	71	71	1.0000000
NODE_297762_length_250_cov_1.377483	0	80	0	80	80	1.0000000
NODE_297963_length_250_cov_1.350993	40	98	0	58	58	1.0000000
NODE_298213_length_250_cov_1.291391	116	196	0	80	80	1.0000000
NODE_298719_length_250_cov_1.013245	126	163	1	3	37	0.0810811
NODE_298719_length_250_cov_1.013245	126	163	3	34	37	0.9189189
NODE_298794_length_250_cov_1.006623	129	148	0	19	19	1.0000000
NODE_298900_length_250_cov_0.920530	126	178	6	10	52	0.1923077
NODE_298900_length_250_cov_0.920530	126	178	8	42	52	0.8076923
NODE_299979_length_249_cov_55.413333	97	172	0	75	75	1.0000000
NODE_299979_length_249_cov_55.413333	150	225	0	75	75	1.0000000
NODE_300012_length_247_cov_51.243243	172	247	0	75	75	1.0000000
NODE_300014_length_247_cov_37.614865	156	239	0	83	83	1.0000000
NODE_300056_length_245_cov_40.876712	138	202	2	14	64	0.2187500
NODE_300056_length_245_cov_40.876712	138	202	3	48	64	0.7500000
NODE_300056_length_245_cov_40.876712	138	202	5	2	64	0.0312500
NODE_300056_length_245_cov_40.876712	138	202	2	14	64	0.2187500
NODE_300056_length_245_cov_40.876712	138	202	3	48	64	0.7500000
NODE_300056_length_245_cov_40.876712	138	202	5	2	64	0.0312500
NODE_300056_length_245_cov_40.876712	138	202	2	14	64	0.2187500
NODE_300056_length_245_cov_40.876712	138	202	3	48	64	0.7500000
NODE_300056_length_245_cov_40.876712	138	202	5	2	64	0.0312500
NODE_300056_length_245_cov_40.876712	175	241	0	5	66	0.0757576
NODE_300056_length_245_cov_40.876712	175	241	1	21	66	0.3181818
NODE_300056_length_245_cov_40.876712	175	241	2	27	66	0.4090909
NODE_300056_length_245_cov_40.876712	175	241	3	13	66	0.1969697
NODE_300147_length_240_cov_80.744681	167	238	0	71	71	1.0000000
NODE_300148_length_240_cov_38.035461	31	82	0	37	51	0.7254902
NODE_300148_length_240_cov_38.035461	31	82	2	14	51	0.2745098
NODE_300165_length_239_cov_72.878571	0	48	1	42	48	0.8750000
NODE_300165_length_239_cov_72.878571	0	48	2	6	48	0.1250000
NODE_300165_length_239_cov_72.878571	21	101	1	21	80	0.2625000
NODE_300165_length_239_cov_72.878571	21	101	2	28	80	0.3500000
NODE_300165_length_239_cov_72.878571	21	101	3	23	80	0.2875000
NODE_300165_length_239_cov_72.878571	21	101	5	8	80	0.1000000
NODE_300165_length_239_cov_72.878571	150	230	0	9	80	0.1125000
NODE_300165_length_239_cov_72.878571	150	230	1	6	80	0.0750000
NODE_300165_length_239_cov_72.878571	150	230	3	22	80	0.2750000
NODE_300165_length_239_cov_72.878571	150	230	4	43	80	0.5375000
NODE_300165_length_239_cov_72.878571	150	230	0	9	80	0.1125000
NODE_300165_length_239_cov_72.878571	150	230	1	6	80	0.0750000
NODE_300165_length_239_cov_72.878571	150	230	3	22	80	0.2750000
NODE_300165_length_239_cov_72.878571	150	230	4	43	80	0.5375000
NODE_300165_length_239_cov_72.878571	150	212	3	19	62	0.3064516
NODE_300165_length_239_cov_72.878571	150	212	4	43	62	0.6935484
NODE_300165_length_239_cov_72.878571	150	221	1	6	71	0.0845070
NODE_300165_length_239_cov_72.878571	150	221	3	22	71	0.3098592
NODE_300165_length_239_cov_72.878571	150	221	4	43	71	0.6056338
NODE_300208_length_238_cov_385.683453	35	104	24	10	69	0.1449275
NODE_300208_length_238_cov_385.683453	35	104	25	1	69	0.0144928
NODE_300208_length_238_cov_385.683453	35	104	26	15	69	0.2173913
NODE_300208_length_238_cov_385.683453	35	104	28	2	69	0.0289855
NODE_300208_length_238_cov_385.683453	35	104	29	3	69	0.0434783
NODE_300208_length_238_cov_385.683453	35	104	30	1	69	0.0144928
NODE_300208_length_238_cov_385.683453	35	104	32	8	69	0.1159420
NODE_300208_length_238_cov_385.683453	35	104	34	4	69	0.0579710
NODE_300208_length_238_cov_385.683453	35	104	35	4	69	0.0579710
NODE_300208_length_238_cov_385.683453	35	104	37	8	69	0.1159420
NODE_300208_length_238_cov_385.683453	35	104	38	1	69	0.0144928
NODE_300208_length_238_cov_385.683453	35	104	39	6	69	0.0869565
NODE_300208_length_238_cov_385.683453	35	104	40	1	69	0.0144928
NODE_300208_length_238_cov_385.683453	35	104	41	5	69	0.0724638
NODE_300225_length_237_cov_101.543478	83	163	3	1	80	0.0125000
NODE_300225_length_237_cov_101.543478	83	163	4	8	80	0.1000000
NODE_300225_length_237_cov_101.543478	83	163	6	8	80	0.1000000
NODE_300225_length_237_cov_101.543478	83	163	8	27	80	0.3375000
NODE_300225_length_237_cov_101.543478	83	163	10	36	80	0.4500000
NODE_300225_length_237_cov_101.543478	83	163	3	1	80	0.0125000
NODE_300225_length_237_cov_101.543478	83	163	4	8	80	0.1000000
NODE_300225_length_237_cov_101.543478	83	163	6	8	80	0.1000000
NODE_300225_length_237_cov_101.543478	83	163	8	27	80	0.3375000
NODE_300225_length_237_cov_101.543478	83	163	10	36	80	0.4500000
NODE_300225_length_237_cov_101.543478	83	163	3	1	80	0.0125000
NODE_300225_length_237_cov_101.543478	83	163	4	8	80	0.1000000
NODE_300225_length_237_cov_101.543478	83	163	6	8	80	0.1000000
NODE_300225_length_237_cov_101.543478	83	163	8	27	80	0.3375000
NODE_300225_length_237_cov_101.543478	83	163	10	36	80	0.4500000
NODE_300225_length_237_cov_101.543478	83	163	3	1	80	0.0125000
NODE_300225_length_237_cov_101.543478	83	163	4	8	80	0.1000000
NODE_300225_length_237_cov_101.543478	83	163	6	8	80	0.1000000
NODE_300225_length_237_cov_101.543478	83	163	8	27	80	0.3375000
NODE_300225_length_237_cov_101.543478	83	163	10	36	80	0.4500000
NODE_300225_length_237_cov_101.543478	136	216	5	16	80	0.2000000
NODE_300225_length_237_cov_101.543478	136	216	6	24	80	0.3000000
NODE_300225_length_237_cov_101.543478	136	216	7	4	80	0.0500000
NODE_300225_length_237_cov_101.543478	136	216	8	7	80	0.0875000
NODE_300225_length_237_cov_101.543478	136	216	10	29	80	0.3625000
NODE_300225_length_237_cov_101.543478	136	216	5	16	80	0.2000000
NODE_300225_length_237_cov_101.543478	136	216	6	24	80	0.3000000
NODE_300225_length_237_cov_101.543478	136	216	7	4	80	0.0500000
NODE_300225_length_237_cov_101.543478	136	216	8	7	80	0.0875000
NODE_300225_length_237_cov_101.543478	136	216	10	29	80	0.3625000
NODE_300225_length_237_cov_101.543478	136	216	5	16	80	0.2000000
NODE_300225_length_237_cov_101.543478	136	216	6	24	80	0.3000000
NODE_300225_length_237_cov_101.543478	136	216	7	4	80	0.0500000
NODE_300225_length_237_cov_101.543478	136	216	8	7	80	0.0875000
NODE_300225_length_237_cov_101.543478	136	216	10	29	80	0.3625000
NODE_300225_length_237_cov_101.543478	138	216	5	16	78	0.2051282
NODE_300225_length_237_cov_101.543478	138	216	6	24	78	0.3076923
NODE_300225_length_237_cov_101.543478	138	216	7	4	78	0.0512821
NODE_300225_length_237_cov_101.543478	138	216	8	7	78	0.0897436
NODE_300225_length_237_cov_101.543478	138	216	10	27	78	0.3461539
NODE_300225_length_237_cov_101.543478	138	216	5	16	78	0.2051282
NODE_300225_length_237_cov_101.543478	138	216	6	24	78	0.3076923
NODE_300225_length_237_cov_101.543478	138	216	7	4	78	0.0512821
NODE_300225_length_237_cov_101.543478	138	216	8	7	78	0.0897436
NODE_300225_length_237_cov_101.543478	138	216	10	27	78	0.3461539
NODE_300227_length_237_cov_49.623188	13	88	0	75	75	1.0000000
NODE_300227_length_237_cov_49.623188	73	153	0	80	80	1.0000000
NODE_300227_length_237_cov_49.623188	126	206	0	80	80	1.0000000
NODE_300289_length_235_cov_67.904412	0	62	0	62	62	1.0000000
NODE_300289_length_235_cov_67.904412	25	111	0	38	86	0.4418605
NODE_300289_length_235_cov_67.904412	25	111	1	48	86	0.5581396
NODE_300289_length_235_cov_67.904412	69	150	1	81	81	1.0000000
NODE_300289_length_235_cov_67.904412	113	194	1	81	81	1.0000000
NODE_300289_length_235_cov_67.904412	157	235	0	24	78	0.3076923
NODE_300289_length_235_cov_67.904412	157	235	1	54	78	0.6923077
NODE_300322_length_234_cov_76.496296	0	76	1	41	76	0.5394737
NODE_300322_length_234_cov_76.496296	0	76	2	35	76	0.4605263
NODE_300322_length_234_cov_76.496296	0	76	1	41	76	0.5394737
NODE_300322_length_234_cov_76.496296	0	76	2	35	76	0.4605263
NODE_300322_length_234_cov_76.496296	0	76	1	41	76	0.5394737
NODE_300322_length_234_cov_76.496296	0	76	2	35	76	0.4605263
NODE_300322_length_234_cov_76.496296	0	76	1	41	76	0.5394737
NODE_300322_length_234_cov_76.496296	0	76	2	35	76	0.4605263
NODE_300322_length_234_cov_76.496296	49	128	2	79	79	1.0000000
NODE_300322_length_234_cov_76.496296	49	128	2	79	79	1.0000000
NODE_300322_length_234_cov_76.496296	124	204	0	10	80	0.1250000
NODE_300322_length_234_cov_76.496296	124	204	1	45	80	0.5625000
NODE_300322_length_234_cov_76.496296	124	204	2	25	80	0.3125000
NODE_300322_length_234_cov_76.496296	124	204	0	10	80	0.1250000
NODE_300322_length_234_cov_76.496296	124	204	1	45	80	0.5625000
NODE_300322_length_234_cov_76.496296	124	204	2	25	80	0.3125000
NODE_300322_length_234_cov_76.496296	124	204	0	10	80	0.1250000
NODE_300322_length_234_cov_76.496296	124	204	1	45	80	0.5625000
NODE_300322_length_234_cov_76.496296	124	204	2	25	80	0.3125000
NODE_300322_length_234_cov_76.496296	177	226	0	32	49	0.6530612
NODE_300322_length_234_cov_76.496296	177	226	1	17	49	0.3469388
NODE_300322_length_234_cov_76.496296	177	234	0	40	57	0.7017544
NODE_300322_length_234_cov_76.496296	177	234	1	17	57	0.2982456
NODE_300322_length_234_cov_76.496296	182	234	0	40	52	0.7692308
NODE_300322_length_234_cov_76.496296	182	234	1	12	52	0.2307692
NODE_300323_length_234_cov_71.548148	90	162	5	11	72	0.1527778
NODE_300323_length_234_cov_71.548148	90	162	6	4	72	0.0555556
NODE_300323_length_234_cov_71.548148	90	162	7	57	72	0.7916667
NODE_300323_length_234_cov_71.548148	90	162	5	11	72	0.1527778
NODE_300323_length_234_cov_71.548148	90	162	6	4	72	0.0555556
NODE_300323_length_234_cov_71.548148	90	162	7	57	72	0.7916667
NODE_300323_length_234_cov_71.548148	135	215	3	9	80	0.1125000
NODE_300323_length_234_cov_71.548148	135	215	5	47	80	0.5875000
NODE_300323_length_234_cov_71.548148	135	215	6	4	80	0.0500000
NODE_300323_length_234_cov_71.548148	135	215	7	20	80	0.2500000
NODE_300323_length_234_cov_71.548148	135	215	3	9	80	0.1125000
NODE_300323_length_234_cov_71.548148	135	215	5	47	80	0.5875000
NODE_300323_length_234_cov_71.548148	135	215	6	4	80	0.0500000
NODE_300323_length_234_cov_71.548148	135	215	7	20	80	0.2500000
NODE_300357_length_233_cov_180.701493	0	65	0	24	65	0.3692308
NODE_300357_length_233_cov_180.701493	0	65	2	5	65	0.0769231
NODE_300357_length_233_cov_180.701493	0	65	3	36	65	0.5538462
NODE_300357_length_233_cov_180.701493	38	118	3	80	80	1.0000000
NODE_300392_length_232_cov_132.045113	53	133	6	1	80	0.0125000
NODE_300392_length_232_cov_132.045113	53	133	7	4	80	0.0500000
NODE_300392_length_232_cov_132.045113	53	133	8	51	80	0.6375000
NODE_300392_length_232_cov_132.045113	53	133	10	1	80	0.0125000
NODE_300392_length_232_cov_132.045113	53	133	11	23	80	0.2875000
NODE_300392_length_232_cov_132.045113	106	186	5	8	80	0.1000000
NODE_300392_length_232_cov_132.045113	106	186	6	27	80	0.3375000
NODE_300392_length_232_cov_132.045113	106	186	7	2	80	0.0250000
NODE_300392_length_232_cov_132.045113	106	186	8	5	80	0.0625000
NODE_300392_length_232_cov_132.045113	106	186	9	1	80	0.0125000
NODE_300392_length_232_cov_132.045113	106	186	10	1	80	0.0125000
NODE_300392_length_232_cov_132.045113	106	186	11	36	80	0.4500000
NODE_300471_length_230_cov_34.427481	0	59	0	59	59	1.0000000
NODE_300471_length_230_cov_34.427481	0	59	0	59	59	1.0000000
NODE_300471_length_230_cov_34.427481	10	59	0	49	49	1.0000000
NODE_300487_length_229_cov_76.907692	94	176	6	6	82	0.0731707
NODE_300487_length_229_cov_76.907692	94	176	7	1	82	0.0121951
NODE_300487_length_229_cov_76.907692	94	176	8	30	82	0.3658537
NODE_300487_length_229_cov_76.907692	94	176	10	12	82	0.1463415
NODE_300487_length_229_cov_76.907692	94	176	12	33	82	0.4024390
NODE_300523_length_228_cov_127.131783	0	76	0	57	76	0.7500000
NODE_300523_length_228_cov_127.131783	0	76	2	19	76	0.2500000
NODE_300523_length_228_cov_127.131783	5	76	0	52	71	0.7323943
NODE_300523_length_228_cov_127.131783	5	76	2	19	71	0.2676056
NODE_300523_length_228_cov_127.131783	10	76	0	47	66	0.7121212
NODE_300523_length_228_cov_127.131783	10	76	2	19	66	0.2878788
NODE_300523_length_228_cov_127.131783	49	129	0	8	80	0.1000000
NODE_300523_length_228_cov_127.131783	49	129	2	72	80	0.9000000
NODE_300523_length_228_cov_127.131783	49	129	0	8	80	0.1000000
NODE_300523_length_228_cov_127.131783	49	129	2	72	80	0.9000000
NODE_300523_length_228_cov_127.131783	49	129	0	8	80	0.1000000
NODE_300523_length_228_cov_127.131783	49	129	2	72	80	0.9000000
NODE_300523_length_228_cov_127.131783	125	205	0	29	80	0.3625000
NODE_300523_length_228_cov_127.131783	125	205	2	51	80	0.6375000
NODE_300523_length_228_cov_127.131783	125	205	0	29	80	0.3625000
NODE_300523_length_228_cov_127.131783	125	205	2	51	80	0.6375000
NODE_300523_length_228_cov_127.131783	125	205	0	29	80	0.3625000
NODE_300523_length_228_cov_127.131783	125	205	2	51	80	0.6375000
NODE_300523_length_228_cov_127.131783	178	228	0	50	50	1.0000000
NODE_300523_length_228_cov_127.131783	178	228	0	50	50	1.0000000
NODE_300523_length_228_cov_127.131783	178	228	0	50	50	1.0000000
NODE_300524_length_228_cov_94.255814	34	99	1	26	65	0.4000000
NODE_300524_length_228_cov_94.255814	34	99	2	39	65	0.6000000
NODE_300524_length_228_cov_94.255814	34	114	1	26	80	0.3250000
NODE_300524_length_228_cov_94.255814	34	114	2	54	80	0.6750000
NODE_300524_length_228_cov_94.255814	41	111	1	19	70	0.2714286
NODE_300524_length_228_cov_94.255814	41	111	2	51	70	0.7285714
NODE_300524_length_228_cov_94.255814	43	114	1	17	71	0.2394366
NODE_300524_length_228_cov_94.255814	43	114	2	54	71	0.7605634
NODE_300524_length_228_cov_94.255814	87	167	2	80	80	1.0000000
NODE_300524_length_228_cov_94.255814	87	167	2	80	80	1.0000000
NODE_300524_length_228_cov_94.255814	87	167	2	80	80	1.0000000
NODE_300524_length_228_cov_94.255814	87	167	2	80	80	1.0000000
NODE_300547_length_228_cov_0.395349	27	107	0	80	80	1.0000000
NODE_300547_length_228_cov_0.395349	70	150	0	80	80	1.0000000
NODE_300556_length_227_cov_37.429688	40	111	0	71	71	1.0000000
NODE_300556_length_227_cov_37.429688	49	112	0	63	63	1.0000000
NODE_300556_length_227_cov_37.429688	93	172	0	79	79	1.0000000
NODE_300556_length_227_cov_37.429688	168	227	0	59	59	1.0000000
NODE_300556_length_227_cov_37.429688	168	227	0	59	59	1.0000000
NODE_300595_length_226_cov_547.629921	82	162	85	2	80	0.0250000
NODE_300595_length_226_cov_547.629921	82	162	86	3	80	0.0375000
NODE_300595_length_226_cov_547.629921	82	162	88	2	80	0.0250000
NODE_300595_length_226_cov_547.629921	82	162	90	1	80	0.0125000
NODE_300595_length_226_cov_547.629921	82	162	97	2	80	0.0250000
NODE_300595_length_226_cov_547.629921	82	162	98	5	80	0.0625000
NODE_300595_length_226_cov_547.629921	82	162	99	3	80	0.0375000
NODE_300595_length_226_cov_547.629921	82	162	100	4	80	0.0500000
NODE_300595_length_226_cov_547.629921	82	162	101	1	80	0.0125000
NODE_300595_length_226_cov_547.629921	82	162	103	4	80	0.0500000
NODE_300595_length_226_cov_547.629921	82	162	104	3	80	0.0375000
NODE_300595_length_226_cov_547.629921	82	162	105	1	80	0.0125000
NODE_300595_length_226_cov_547.629921	82	162	106	2	80	0.0250000
NODE_300595_length_226_cov_547.629921	82	162	107	1	80	0.0125000
NODE_300595_length_226_cov_547.629921	82	162	108	12	80	0.1500000
NODE_300595_length_226_cov_547.629921	82	162	109	7	80	0.0875000
NODE_300595_length_226_cov_547.629921	82	162	111	2	80	0.0250000
NODE_300595_length_226_cov_547.629921	82	162	113	5	80	0.0625000
NODE_300595_length_226_cov_547.629921	82	162	115	20	80	0.2500000
NODE_300617_length_225_cov_41.269841	81	165	2	21	84	0.2500000
NODE_300617_length_225_cov_41.269841	81	165	4	63	84	0.7500000
NODE_300617_length_225_cov_41.269841	134	218	0	8	84	0.0952381
NODE_300617_length_225_cov_41.269841	134	218	2	66	84	0.7857143
NODE_300617_length_225_cov_41.269841	134	218	4	10	84	0.1190476
NODE_300661_length_224_cov_209.528000	12	84	3	6	72	0.0833333
NODE_300661_length_224_cov_209.528000	12	84	4	54	72	0.7500000
NODE_300661_length_224_cov_209.528000	12	84	6	12	72	0.1666667
NODE_300663_length_224_cov_146.568000	13	72	7	2	59	0.0338983
NODE_300663_length_224_cov_146.568000	13	72	11	27	59	0.4576271
NODE_300663_length_224_cov_146.568000	13	72	13	19	59	0.3220339
NODE_300663_length_224_cov_146.568000	13	72	14	6	59	0.1016949
NODE_300663_length_224_cov_146.568000	13	72	15	5	59	0.0847458
NODE_300663_length_224_cov_146.568000	46	72	13	15	26	0.5769231
NODE_300663_length_224_cov_146.568000	46	72	14	6	26	0.2307692
NODE_300663_length_224_cov_146.568000	46	72	15	5	26	0.1923077
NODE_300663_length_224_cov_146.568000	68	120	15	4	52	0.0769231
NODE_300663_length_224_cov_146.568000	68	120	17	2	52	0.0384615
NODE_300663_length_224_cov_146.568000	68	120	18	8	52	0.1538462
NODE_300663_length_224_cov_146.568000	68	120	20	1	52	0.0192308
NODE_300663_length_224_cov_146.568000	68	120	22	16	52	0.3076923
NODE_300663_length_224_cov_146.568000	68	120	24	17	52	0.3269231
NODE_300663_length_224_cov_146.568000	68	120	26	4	52	0.0769231
NODE_300665_length_224_cov_59.088000	98	178	3	55	80	0.6875000
NODE_300665_length_224_cov_59.088000	98	178	4	25	80	0.3125000
NODE_300665_length_224_cov_59.088000	98	178	3	55	80	0.6875000
NODE_300665_length_224_cov_59.088000	98	178	4	25	80	0.3125000
NODE_300665_length_224_cov_59.088000	98	178	3	55	80	0.6875000
NODE_300665_length_224_cov_59.088000	98	178	4	25	80	0.3125000
NODE_300665_length_224_cov_59.088000	151	217	0	3	66	0.0454545
NODE_300665_length_224_cov_59.088000	151	217	3	63	66	0.9545454
NODE_300665_length_224_cov_59.088000	151	224	0	10	73	0.1369863
NODE_300665_length_224_cov_59.088000	151	224	3	63	73	0.8630137
NODE_300667_length_224_cov_43.640000	98	157	0	59	59	1.0000000
NODE_300667_length_224_cov_43.640000	98	157	0	59	59	1.0000000
NODE_300667_length_224_cov_43.640000	106	157	0	51	51	1.0000000
NODE_300669_length_224_cov_36.224000	100	171	2	71	71	1.0000000
NODE_300669_length_224_cov_36.224000	151	224	1	17	73	0.2328767
NODE_300669_length_224_cov_36.224000	151	224	2	56	73	0.7671233
NODE_300696_length_223_cov_35.814516	0	54	0	19	54	0.3518519
NODE_300696_length_223_cov_35.814516	0	54	1	13	54	0.2407407
NODE_300696_length_223_cov_35.814516	0	54	2	9	54	0.1666667
NODE_300696_length_223_cov_35.814516	0	54	4	13	54	0.2407407
NODE_300696_length_223_cov_35.814516	30	107	1	2	77	0.0259740
NODE_300696_length_223_cov_35.814516	30	107	2	9	77	0.1168831
NODE_300696_length_223_cov_35.814516	30	107	4	66	77	0.8571429
NODE_300768_length_221_cov_71.319672	14	94	1	5	80	0.0625000
NODE_300768_length_221_cov_71.319672	14	94	3	23	80	0.2875000
NODE_300768_length_221_cov_71.319672	14	94	5	1	80	0.0125000
NODE_300768_length_221_cov_71.319672	14	94	6	51	80	0.6375000
NODE_300800_length_220_cov_42.206612	3	74	0	9	71	0.1267606
NODE_300800_length_220_cov_42.206612	3	74	1	16	71	0.2253521
NODE_300800_length_220_cov_42.206612	3	74	3	19	71	0.2676056
NODE_300800_length_220_cov_42.206612	3	74	5	27	71	0.3802817
NODE_300800_length_220_cov_42.206612	8	74	0	4	66	0.0606061
NODE_300800_length_220_cov_42.206612	8	74	1	16	66	0.2424242
NODE_300800_length_220_cov_42.206612	8	74	3	19	66	0.2878788
NODE_300800_length_220_cov_42.206612	8	74	5	27	66	0.4090909
NODE_300800_length_220_cov_42.206612	47	98	5	51	51	1.0000000
NODE_300800_length_220_cov_42.206612	47	98	5	51	51	1.0000000
NODE_300800_length_220_cov_42.206612	47	98	5	51	51	1.0000000
NODE_300874_length_218_cov_244.773109	128	203	6	2	75	0.0266667
NODE_300874_length_218_cov_244.773109	128	203	7	24	75	0.3200000
NODE_300874_length_218_cov_244.773109	128	203	8	9	75	0.1200000
NODE_300874_length_218_cov_244.773109	128	203	9	5	75	0.0666667
NODE_300874_length_218_cov_244.773109	128	203	10	6	75	0.0800000
NODE_300874_length_218_cov_244.773109	128	203	11	1	75	0.0133333
NODE_300874_length_218_cov_244.773109	128	203	13	9	75	0.1200000
NODE_300874_length_218_cov_244.773109	128	203	15	19	75	0.2533333
NODE_300874_length_218_cov_244.773109	176	218	3	1	42	0.0238095
NODE_300874_length_218_cov_244.773109	176	218	4	3	42	0.0714286
NODE_300874_length_218_cov_244.773109	176	218	5	9	42	0.2142857
NODE_300874_length_218_cov_244.773109	176	218	6	4	42	0.0952381
NODE_300874_length_218_cov_244.773109	176	218	7	24	42	0.5714286
NODE_300874_length_218_cov_244.773109	176	218	8	1	42	0.0238095
NODE_300915_length_217_cov_2.144068	14	49	0	35	35	1.0000000
NODE_300915_length_217_cov_2.144068	132	167	0	35	35	1.0000000
NODE_300924_length_216_cov_215.410256	0	63	1	41	63	0.6507937
NODE_300924_length_216_cov_215.410256	0	63	2	22	63	0.3492064
NODE_300924_length_216_cov_215.410256	36	102	1	5	66	0.0757576
NODE_300924_length_216_cov_215.410256	36	102	2	61	66	0.9242424
NODE_300925_length_216_cov_51.940171	164	216	2	14	52	0.2692308
NODE_300925_length_216_cov_51.940171	164	216	4	38	52	0.7307692
NODE_300953_length_215_cov_14.784483	0	50	0	50	50	1.0000000
NODE_300953_length_215_cov_14.784483	23	103	0	80	80	1.0000000
NODE_300984_length_214_cov_144.165217	0	62	0	43	62	0.6935484
NODE_300984_length_214_cov_144.165217	0	62	1	19	62	0.3064516
NODE_300984_length_214_cov_144.165217	0	62	0	43	62	0.6935484
NODE_300984_length_214_cov_144.165217	0	62	1	19	62	0.3064516
NODE_300984_length_214_cov_144.165217	35	115	0	8	80	0.1000000
NODE_300984_length_214_cov_144.165217	35	115	1	32	80	0.4000000
NODE_300984_length_214_cov_144.165217	35	115	2	40	80	0.5000000
NODE_300984_length_214_cov_144.165217	35	115	0	8	80	0.1000000
NODE_300984_length_214_cov_144.165217	35	115	1	32	80	0.4000000
NODE_300984_length_214_cov_144.165217	35	115	2	40	80	0.5000000
NODE_300984_length_214_cov_144.165217	35	115	0	8	80	0.1000000
NODE_300984_length_214_cov_144.165217	35	115	1	32	80	0.4000000
NODE_300984_length_214_cov_144.165217	35	115	2	40	80	0.5000000
NODE_300984_length_214_cov_144.165217	111	191	2	80	80	1.0000000
NODE_300984_length_214_cov_144.165217	111	191	2	80	80	1.0000000
NODE_300984_length_214_cov_144.165217	111	191	2	80	80	1.0000000
NODE_300984_length_214_cov_144.165217	164	214	1	21	50	0.4200000
NODE_300984_length_214_cov_144.165217	164	214	2	29	50	0.5800000
NODE_300984_length_214_cov_144.165217	164	214	1	21	50	0.4200000
NODE_300984_length_214_cov_144.165217	164	214	2	29	50	0.5800000
NODE_300984_length_214_cov_144.165217	164	214	1	21	50	0.4200000
NODE_300984_length_214_cov_144.165217	164	214	2	29	50	0.5800000
NODE_301068_length_211_cov_39.571429	4	84	0	80	80	1.0000000
NODE_301169_length_208_cov_45.238532	3	59	0	56	56	1.0000000
NODE_301169_length_208_cov_45.238532	35	112	0	77	77	1.0000000
NODE_301170_length_208_cov_35.229358	76	156	0	80	80	1.0000000
NODE_301179_length_207_cov_341.324074	33	113	0	80	80	1.0000000
NODE_301179_length_207_cov_341.324074	86	166	0	80	80	1.0000000
NODE_301248_length_205_cov_64.179245	6	77	0	23	71	0.3239437
NODE_301248_length_205_cov_64.179245	6	77	2	48	71	0.6760563
NODE_301248_length_205_cov_64.179245	11	77	0	18	66	0.2727273
NODE_301248_length_205_cov_64.179245	11	77	2	48	66	0.7272727
NODE_301248_length_205_cov_64.179245	50	98	2	48	48	1.0000000
NODE_301248_length_205_cov_64.179245	50	98	2	48	48	1.0000000
NODE_301248_length_205_cov_64.179245	50	98	2	48	48	1.0000000
NODE_301281_length_204_cov_183.390476	119	199	0	14	80	0.1750000
NODE_301281_length_204_cov_183.390476	119	199	1	25	80	0.3125000
NODE_301281_length_204_cov_183.390476	119	199	2	17	80	0.2125000
NODE_301281_length_204_cov_183.390476	119	199	4	16	80	0.2000000
NODE_301281_length_204_cov_183.390476	119	199	6	8	80	0.1000000
NODE_301281_length_204_cov_183.390476	172	194	0	9	22	0.4090909
NODE_301281_length_204_cov_183.390476	172	194	1	13	22	0.5909091
NODE_301283_length_204_cov_80.095238	10	90	0	4	80	0.0500000
NODE_301283_length_204_cov_80.095238	10	90	1	8	80	0.1000000
NODE_301283_length_204_cov_80.095238	10	90	4	7	80	0.0875000
NODE_301283_length_204_cov_80.095238	10	90	6	34	80	0.4250000
NODE_301283_length_204_cov_80.095238	10	90	11	2	80	0.0250000
NODE_301283_length_204_cov_80.095238	10	90	13	2	80	0.0250000
NODE_301283_length_204_cov_80.095238	10	90	15	2	80	0.0250000
NODE_301283_length_204_cov_80.095238	10	90	16	21	80	0.2625000
NODE_301283_length_204_cov_80.095238	63	143	5	2	80	0.0250000
NODE_301283_length_204_cov_80.095238	63	143	11	2	80	0.0250000
NODE_301283_length_204_cov_80.095238	63	143	13	2	80	0.0250000
NODE_301283_length_204_cov_80.095238	63	143	14	11	80	0.1375000
NODE_301283_length_204_cov_80.095238	63	143	15	2	80	0.0250000
NODE_301283_length_204_cov_80.095238	63	143	16	61	80	0.7625000
NODE_301345_length_202_cov_123.184466	0	64	2	23	64	0.3593750
NODE_301345_length_202_cov_123.184466	0	64	3	19	64	0.2968750
NODE_301345_length_202_cov_123.184466	0	64	5	2	64	0.0312500
NODE_301345_length_202_cov_123.184466	0	64	7	2	64	0.0312500
NODE_301345_length_202_cov_123.184466	0	64	11	2	64	0.0312500
NODE_301345_length_202_cov_123.184466	0	64	13	2	64	0.0312500
NODE_301345_length_202_cov_123.184466	0	64	15	2	64	0.0312500
NODE_301345_length_202_cov_123.184466	0	64	17	6	64	0.0937500
NODE_301345_length_202_cov_123.184466	0	64	18	1	64	0.0156250
NODE_301345_length_202_cov_123.184466	0	64	20	5	64	0.0781250
NODE_301345_length_202_cov_123.184466	31	72	3	11	41	0.2682927
NODE_301345_length_202_cov_123.184466	31	72	5	2	41	0.0487805
NODE_301345_length_202_cov_123.184466	31	72	7	2	41	0.0487805
NODE_301345_length_202_cov_123.184466	31	72	11	2	41	0.0487805
NODE_301345_length_202_cov_123.184466	31	72	13	2	41	0.0487805
NODE_301345_length_202_cov_123.184466	31	72	15	2	41	0.0487805
NODE_301345_length_202_cov_123.184466	31	72	17	6	41	0.1463415
NODE_301345_length_202_cov_123.184466	31	72	18	1	41	0.0243902
NODE_301345_length_202_cov_123.184466	31	72	20	13	41	0.3170732
NODE_301370_length_201_cov_56.323529	133	201	5	17	68	0.2500000
NODE_301370_length_201_cov_56.323529	133	201	6	34	68	0.5000000
NODE_301370_length_201_cov_56.323529	133	201	7	17	68	0.2500000
NODE_301371_length_201_cov_50.647059	44	99	2	6	55	0.1090909
NODE_301371_length_201_cov_50.647059	44	99	3	49	55	0.8909091
NODE_301371_length_201_cov_50.647059	136	201	0	10	65	0.1538462
NODE_301371_length_201_cov_50.647059	136	201	1	55	65	0.8461539
NODE_301371_length_201_cov_50.647059	136	201	0	10	65	0.1538462
NODE_301371_length_201_cov_50.647059	136	201	1	55	65	0.8461539
NODE_301371_length_201_cov_50.647059	136	201	0	10	65	0.1538462
NODE_301371_length_201_cov_50.647059	136	201	1	55	65	0.8461539
NODE_301371_length_201_cov_50.647059	136	201	0	10	65	0.1538462
NODE_301371_length_201_cov_50.647059	136	201	1	55	65	0.8461539
NODE_301405_length_200_cov_29.118812	0	73	3	6	73	0.0821918
NODE_301405_length_200_cov_29.118812	0	73	4	3	73	0.0410959
NODE_301405_length_200_cov_29.118812	0	73	6	3	73	0.0410959
NODE_301405_length_200_cov_29.118812	0	73	8	31	73	0.4246575
NODE_301405_length_200_cov_29.118812	0	73	10	3	73	0.0410959
NODE_301405_length_200_cov_29.118812	0	73	11	7	73	0.0958904
NODE_301405_length_200_cov_29.118812	0	73	12	4	73	0.0547945
NODE_301405_length_200_cov_29.118812	0	73	14	2	73	0.0273973
NODE_301405_length_200_cov_29.118812	0	73	16	10	73	0.1369863
NODE_301405_length_200_cov_29.118812	0	73	18	4	73	0.0547945
NODE_301419_length_199_cov_768.700000	94	142	30	6	48	0.1250000
NODE_301419_length_199_cov_768.700000	94	142	32	42	48	0.8750000
NODE_301419_length_199_cov_768.700000	115	186	10	2	71	0.0281690
NODE_301419_length_199_cov_768.700000	115	186	11	4	71	0.0563380
NODE_301419_length_199_cov_768.700000	115	186	12	1	71	0.0140845
NODE_301419_length_199_cov_768.700000	115	186	14	2	71	0.0281690
NODE_301419_length_199_cov_768.700000	115	186	16	1	71	0.0140845
NODE_301419_length_199_cov_768.700000	115	186	17	5	71	0.0704225
NODE_301419_length_199_cov_768.700000	115	186	18	1	71	0.0140845
NODE_301419_length_199_cov_768.700000	115	186	22	2	71	0.0281690
NODE_301419_length_199_cov_768.700000	115	186	24	9	71	0.1267606
NODE_301419_length_199_cov_768.700000	115	186	26	6	71	0.0845070
NODE_301419_length_199_cov_768.700000	115	186	28	10	71	0.1408451
NODE_301419_length_199_cov_768.700000	115	186	30	7	71	0.0985916
NODE_301419_length_199_cov_768.700000	115	186	32	21	71	0.2957746
NODE_301420_length_199_cov_702.860000	3	78	2	3	75	0.0400000
NODE_301420_length_199_cov_702.860000	3	78	4	1	75	0.0133333
NODE_301420_length_199_cov_702.860000	3	78	6	4	75	0.0533333
NODE_301420_length_199_cov_702.860000	3	78	8	3	75	0.0400000
NODE_301420_length_199_cov_702.860000	3	78	11	1	75	0.0133333
NODE_301420_length_199_cov_702.860000	3	78	15	2	75	0.0266667
NODE_301420_length_199_cov_702.860000	3	78	17	1	75	0.0133333
NODE_301420_length_199_cov_702.860000	3	78	19	4	75	0.0533333
NODE_301420_length_199_cov_702.860000	3	78	20	1	75	0.0133333
NODE_301420_length_199_cov_702.860000	3	78	24	1	75	0.0133333
NODE_301420_length_199_cov_702.860000	3	78	25	2	75	0.0266667
NODE_301420_length_199_cov_702.860000	3	78	26	3	75	0.0400000
NODE_301420_length_199_cov_702.860000	3	78	27	1	75	0.0133333
NODE_301420_length_199_cov_702.860000	3	78	33	8	75	0.1066667
NODE_301420_length_199_cov_702.860000	3	78	34	2	75	0.0266667
NODE_301420_length_199_cov_702.860000	3	78	38	3	75	0.0400000
NODE_301420_length_199_cov_702.860000	3	78	40	2	75	0.0266667
NODE_301420_length_199_cov_702.860000	3	78	44	8	75	0.1066667
NODE_301420_length_199_cov_702.860000	3	78	46	1	75	0.0133333
NODE_301420_length_199_cov_702.860000	3	78	48	2	75	0.0266667
NODE_301420_length_199_cov_702.860000	3	78	50	1	75	0.0133333
NODE_301420_length_199_cov_702.860000	3	78	52	2	75	0.0266667
NODE_301420_length_199_cov_702.860000	3	78	54	3	75	0.0400000
NODE_301420_length_199_cov_702.860000	3	78	60	1	75	0.0133333
NODE_301420_length_199_cov_702.860000	3	78	62	3	75	0.0400000
NODE_301420_length_199_cov_702.860000	3	78	64	3	75	0.0400000
NODE_301420_length_199_cov_702.860000	3	78	66	2	75	0.0266667
NODE_301420_length_199_cov_702.860000	3	78	70	2	75	0.0266667
NODE_301420_length_199_cov_702.860000	3	78	72	5	75	0.0666667
NODE_301420_length_199_cov_702.860000	51	131	44	2	80	0.0250000
NODE_301420_length_199_cov_702.860000	51	131	46	1	80	0.0125000
NODE_301420_length_199_cov_702.860000	51	131	48	2	80	0.0250000
NODE_301420_length_199_cov_702.860000	51	131	50	1	80	0.0125000
NODE_301420_length_199_cov_702.860000	51	131	52	2	80	0.0250000
NODE_301420_length_199_cov_702.860000	51	131	54	3	80	0.0375000
NODE_301420_length_199_cov_702.860000	51	131	60	1	80	0.0125000
NODE_301420_length_199_cov_702.860000	51	131	62	3	80	0.0375000
NODE_301420_length_199_cov_702.860000	51	131	64	3	80	0.0375000
NODE_301420_length_199_cov_702.860000	51	131	66	2	80	0.0250000
NODE_301420_length_199_cov_702.860000	51	131	70	15	80	0.1875000
NODE_301420_length_199_cov_702.860000	51	131	72	15	80	0.1875000
NODE_301420_length_199_cov_702.860000	51	131	74	2	80	0.0250000
NODE_301420_length_199_cov_702.860000	51	131	76	7	80	0.0875000
NODE_301420_length_199_cov_702.860000	51	131	78	21	80	0.2625000
NODE_301421_length_199_cov_670.570000	22	52	19	3	30	0.1000000
NODE_301421_length_199_cov_670.570000	22	52	21	4	30	0.1333333
NODE_301421_length_199_cov_670.570000	22	52	22	4	30	0.1333333
NODE_301421_length_199_cov_670.570000	22	52	23	3	30	0.1000000
NODE_301421_length_199_cov_670.570000	22	52	24	6	30	0.2000000
NODE_301421_length_199_cov_670.570000	22	52	26	2	30	0.0666667
NODE_301421_length_199_cov_670.570000	22	52	27	3	30	0.1000000
NODE_301421_length_199_cov_670.570000	22	52	29	1	30	0.0333333
NODE_301421_length_199_cov_670.570000	22	52	30	3	30	0.1000000
NODE_301421_length_199_cov_670.570000	22	52	32	1	30	0.0333333
NODE_301421_length_199_cov_670.570000	25	105	21	4	80	0.0500000
NODE_301421_length_199_cov_670.570000	25	105	22	4	80	0.0500000
NODE_301421_length_199_cov_670.570000	25	105	23	3	80	0.0375000
NODE_301421_length_199_cov_670.570000	25	105	24	6	80	0.0750000
NODE_301421_length_199_cov_670.570000	25	105	26	2	80	0.0250000
NODE_301421_length_199_cov_670.570000	25	105	27	3	80	0.0375000
NODE_301421_length_199_cov_670.570000	25	105	29	1	80	0.0125000
NODE_301421_length_199_cov_670.570000	25	105	30	3	80	0.0375000
NODE_301421_length_199_cov_670.570000	25	105	32	3	80	0.0375000
NODE_301421_length_199_cov_670.570000	25	105	33	1	80	0.0125000
NODE_301421_length_199_cov_670.570000	25	105	36	1	80	0.0125000
NODE_301421_length_199_cov_670.570000	25	105	37	5	80	0.0625000
NODE_301421_length_199_cov_670.570000	25	105	38	1	80	0.0125000
NODE_301421_length_199_cov_670.570000	25	105	40	20	80	0.2500000
NODE_301421_length_199_cov_670.570000	25	105	42	6	80	0.0750000
NODE_301421_length_199_cov_670.570000	25	105	44	17	80	0.2125000
NODE_301430_length_199_cov_215.860000	3	75	5	9	72	0.1250000
NODE_301430_length_199_cov_215.860000	3	75	7	7	72	0.0972222
NODE_301430_length_199_cov_215.860000	3	75	9	8	72	0.1111111
NODE_301430_length_199_cov_215.860000	3	75	10	2	72	0.0277778
NODE_301430_length_199_cov_215.860000	3	75	12	4	72	0.0555556
NODE_301430_length_199_cov_215.860000	3	75	13	2	72	0.0277778
NODE_301430_length_199_cov_215.860000	3	75	14	16	72	0.2222222
NODE_301430_length_199_cov_215.860000	3	75	16	13	72	0.1805556
NODE_301430_length_199_cov_215.860000	3	75	18	11	72	0.1527778
NODE_301430_length_199_cov_215.860000	48	128	14	3	80	0.0375000
NODE_301430_length_199_cov_215.860000	48	128	16	20	80	0.2500000
NODE_301430_length_199_cov_215.860000	48	128	18	57	80	0.7125000
NODE_301432_length_199_cov_206.800000	120	199	0	21	79	0.2658228
NODE_301432_length_199_cov_206.800000	120	199	2	58	79	0.7341772
NODE_301441_length_199_cov_131.120000	97	177	0	80	80	1.0000000
NODE_301448_length_199_cov_97.490000	4	77	0	5	73	0.0684932
NODE_301448_length_199_cov_97.490000	4	77	1	15	73	0.2054795
NODE_301448_length_199_cov_97.490000	4	77	3	22	73	0.3013699
NODE_301448_length_199_cov_97.490000	4	77	4	31	73	0.4246575
NODE_301449_length_199_cov_96.090000	91	171	4	80	80	1.0000000
NODE_301455_length_199_cov_84.060000	44	75	3	25	31	0.8064516
NODE_301455_length_199_cov_84.060000	44	75	4	6	31	0.1935484
NODE_301456_length_199_cov_83.220000	0	64	2	64	64	1.0000000
NODE_301459_length_199_cov_80.390000	15	98	0	39	83	0.4698795
NODE_301459_length_199_cov_80.390000	15	98	2	44	83	0.5301205
NODE_301469_length_199_cov_63.420000	128	194	3	28	66	0.4242424
NODE_301469_length_199_cov_63.420000	128	194	5	28	66	0.4242424
NODE_301469_length_199_cov_63.420000	128	194	6	1	66	0.0151515
NODE_301469_length_199_cov_63.420000	128	194	8	6	66	0.0909091
NODE_301469_length_199_cov_63.420000	128	194	10	2	66	0.0303030
NODE_301469_length_199_cov_63.420000	128	194	12	1	66	0.0151515
NODE_301477_length_199_cov_58.660000	18	85	0	67	67	1.0000000
NODE_301484_length_199_cov_50.350000	102	183	0	81	81	1.0000000
NODE_301485_length_199_cov_49.630000	5	47	0	41	42	0.9761904
NODE_301485_length_199_cov_49.630000	5	47	2	1	42	0.0238095
NODE_301485_length_199_cov_49.630000	100	163	0	10	63	0.1587302
NODE_301485_length_199_cov_49.630000	100	163	2	53	63	0.8412699
NODE_301485_length_199_cov_49.630000	100	163	0	10	63	0.1587302
NODE_301485_length_199_cov_49.630000	100	163	2	53	63	0.8412699
NODE_301485_length_199_cov_49.630000	100	163	0	10	63	0.1587302
NODE_301485_length_199_cov_49.630000	100	163	2	53	63	0.8412699
NODE_301485_length_199_cov_49.630000	136	185	0	32	49	0.6530612
NODE_301485_length_199_cov_49.630000	136	185	2	17	49	0.3469388
NODE_301485_length_199_cov_49.630000	153	199	0	46	46	1.0000000
NODE_301491_length_199_cov_40.000000	0	66	0	25	66	0.3787879
NODE_301491_length_199_cov_40.000000	0	66	2	41	66	0.6212121
NODE_301491_length_199_cov_40.000000	34	114	2	80	80	1.0000000
NODE_301491_length_199_cov_40.000000	39	61	2	22	22	1.0000000
NODE_301498_length_199_cov_31.400000	3	77	0	74	74	1.0000000
NODE_301498_length_199_cov_31.400000	76	153	0	13	77	0.1688312
NODE_301498_length_199_cov_31.400000	76	153	2	64	77	0.8311688
NODE_301498_length_199_cov_31.400000	76	153	0	13	77	0.1688312
NODE_301498_length_199_cov_31.400000	76	153	2	64	77	0.8311688
NODE_301498_length_199_cov_31.400000	76	153	0	13	77	0.1688312
NODE_301498_length_199_cov_31.400000	76	153	2	64	77	0.8311688
NODE_301498_length_199_cov_31.400000	126	192	0	37	66	0.5606061
NODE_301498_length_199_cov_31.400000	126	192	2	29	66	0.4393939
NODE_301498_length_199_cov_31.400000	129	199	0	44	70	0.6285715
NODE_301498_length_199_cov_31.400000	129	199	2	26	70	0.3714286
NODE_301498_length_199_cov_31.400000	131	199	0	44	68	0.6470588
NODE_301498_length_199_cov_31.400000	131	199	2	24	68	0.3529412
NODE_301500_length_199_cov_30.140000	118	198	1	13	80	0.1625000
NODE_301500_length_199_cov_30.140000	118	198	3	67	80	0.8375000
NODE_301500_length_199_cov_30.140000	118	198	1	13	80	0.1625000
NODE_301500_length_199_cov_30.140000	118	198	3	67	80	0.8375000
NODE_301500_length_199_cov_30.140000	118	198	1	13	80	0.1625000
NODE_301500_length_199_cov_30.140000	118	198	3	67	80	0.8375000
NODE_301500_length_199_cov_30.140000	118	198	1	13	80	0.1625000
NODE_301500_length_199_cov_30.140000	118	198	3	67	80	0.8375000
NODE_301500_length_199_cov_30.140000	118	198	1	13	80	0.1625000
NODE_301500_length_199_cov_30.140000	118	198	3	67	80	0.8375000
NODE_301500_length_199_cov_30.140000	127	198	1	13	71	0.1830986
NODE_301500_length_199_cov_30.140000	127	198	3	58	71	0.8169014
NODE_301581_length_197_cov_41.265306	0	70	0	70	70	1.0000000
NODE_301611_length_196_cov_101.855670	72	136	8	64	64	1.0000000
NODE_301611_length_196_cov_101.855670	72	136	8	64	64	1.0000000
NODE_301611_length_196_cov_101.855670	109	169	4	15	60	0.2500000
NODE_301611_length_196_cov_101.855670	109	169	6	14	60	0.2333333
NODE_301611_length_196_cov_101.855670	109	169	8	31	60	0.5166667
NODE_301613_length_196_cov_100.618557	129	196	0	29	67	0.4328358
NODE_301613_length_196_cov_100.618557	129	196	2	8	67	0.1194030
NODE_301613_length_196_cov_100.618557	129	196	4	6	67	0.0895522
NODE_301613_length_196_cov_100.618557	129	196	5	2	67	0.0298507
NODE_301613_length_196_cov_100.618557	129	196	6	4	67	0.0597015
NODE_301613_length_196_cov_100.618557	129	196	8	18	67	0.2686567
NODE_301618_length_196_cov_67.268041	8	88	0	41	80	0.5125000
NODE_301618_length_196_cov_67.268041	8	88	2	39	80	0.4875000
NODE_301618_length_196_cov_67.268041	61	124	2	63	63	1.0000000
NODE_301629_length_196_cov_40.195876	101	184	0	32	83	0.3855422
NODE_301629_length_196_cov_40.195876	101	184	1	2	83	0.0240964
NODE_301629_length_196_cov_40.195876	101	184	2	6	83	0.0722892
NODE_301629_length_196_cov_40.195876	101	184	3	27	83	0.3253012
NODE_301629_length_196_cov_40.195876	101	184	4	16	83	0.1927711
NODE_301704_length_194_cov_63.252632	12	78	0	19	66	0.2878788
NODE_301704_length_194_cov_63.252632	12	78	2	14	66	0.2121212
NODE_301704_length_194_cov_63.252632	12	78	4	33	66	0.5000000
NODE_301704_length_194_cov_63.252632	51	112	4	61	61	1.0000000
NODE_301704_length_194_cov_63.252632	51	99	4	48	48	1.0000000
NODE_301704_length_194_cov_63.252632	51	112	4	61	61	1.0000000
NODE_301708_length_194_cov_35.010526	95	162	0	67	67	1.0000000
NODE_301708_length_194_cov_35.010526	95	162	0	67	67	1.0000000
NODE_301708_length_194_cov_35.010526	135	184	0	49	49	1.0000000
NODE_301714_length_194_cov_9.978947	153	194	0	41	41	1.0000000
NODE_301727_length_193_cov_117.170213	21	93	0	72	72	1.0000000
NODE_301727_length_193_cov_117.170213	41	121	0	80	80	1.0000000
NODE_301729_length_193_cov_54.734043	108	188	0	80	80	1.0000000
NODE_301729_length_193_cov_54.734043	161	183	0	22	22	1.0000000
NODE_301735_length_193_cov_30.638298	108	188	2	7	80	0.0875000
NODE_301735_length_193_cov_30.638298	108	188	6	5	80	0.0625000
NODE_301735_length_193_cov_30.638298	108	188	8	68	80	0.8500000
NODE_301735_length_193_cov_30.638298	161	183	2	2	22	0.0909091
NODE_301735_length_193_cov_30.638298	161	183	6	5	22	0.2272727
NODE_301735_length_193_cov_30.638298	161	183	8	15	22	0.6818182
NODE_301737_length_193_cov_29.968085	0	45	1	36	45	0.8000000
NODE_301737_length_193_cov_29.968085	0	45	3	9	45	0.2000000
NODE_301737_length_193_cov_29.968085	8	57	1	28	49	0.5714286
NODE_301737_length_193_cov_29.968085	8	57	3	21	49	0.4285714
NODE_301737_length_193_cov_29.968085	30	98	1	6	68	0.0882353
NODE_301737_length_193_cov_29.968085	30	98	3	62	68	0.9117647
NODE_301737_length_193_cov_29.968085	30	98	1	6	68	0.0882353
NODE_301737_length_193_cov_29.968085	30	98	3	62	68	0.9117647
NODE_301737_length_193_cov_29.968085	30	98	1	6	68	0.0882353
NODE_301737_length_193_cov_29.968085	30	98	3	62	68	0.9117647
NODE_301737_length_193_cov_29.968085	146	188	0	19	42	0.4523810
NODE_301737_length_193_cov_29.968085	146	188	2	23	42	0.5476190
NODE_301776_length_192_cov_160.258065	0	76	2	1	76	0.0131579
NODE_301776_length_192_cov_160.258065	0	76	5	6	76	0.0789474
NODE_301776_length_192_cov_160.258065	0	76	7	2	76	0.0263158
NODE_301776_length_192_cov_160.258065	0	76	8	1	76	0.0131579
NODE_301776_length_192_cov_160.258065	0	76	14	1	76	0.0131579
NODE_301776_length_192_cov_160.258065	0	76	16	1	76	0.0131579
NODE_301776_length_192_cov_160.258065	0	76	18	1	76	0.0131579
NODE_301776_length_192_cov_160.258065	0	76	19	2	76	0.0263158
NODE_301776_length_192_cov_160.258065	0	76	20	1	76	0.0131579
NODE_301776_length_192_cov_160.258065	0	76	21	1	76	0.0131579
NODE_301776_length_192_cov_160.258065	0	76	22	1	76	0.0131579
NODE_301776_length_192_cov_160.258065	0	76	23	3	76	0.0394737
NODE_301776_length_192_cov_160.258065	0	76	24	5	76	0.0657895
NODE_301776_length_192_cov_160.258065	0	76	25	5	76	0.0657895
NODE_301776_length_192_cov_160.258065	0	76	26	8	76	0.1052632
NODE_301776_length_192_cov_160.258065	0	76	27	1	76	0.0131579
NODE_301776_length_192_cov_160.258065	0	76	29	2	76	0.0263158
NODE_301776_length_192_cov_160.258065	0	76	31	1	76	0.0131579
NODE_301776_length_192_cov_160.258065	0	76	33	3	76	0.0394737
NODE_301776_length_192_cov_160.258065	0	76	35	1	76	0.0131579
NODE_301776_length_192_cov_160.258065	0	76	38	5	76	0.0657895
NODE_301776_length_192_cov_160.258065	0	76	40	1	76	0.0131579
NODE_301776_length_192_cov_160.258065	0	76	42	2	76	0.0263158
NODE_301776_length_192_cov_160.258065	0	76	43	6	76	0.0789474
NODE_301776_length_192_cov_160.258065	0	76	45	1	76	0.0131579
NODE_301776_length_192_cov_160.258065	0	76	47	4	76	0.0526316
NODE_301776_length_192_cov_160.258065	0	76	49	1	76	0.0131579
NODE_301776_length_192_cov_160.258065	0	76	51	9	76	0.1184211
NODE_301825_length_191_cov_92.913043	81	144	0	8	63	0.1269841
NODE_301825_length_191_cov_92.913043	81	144	2	55	63	0.8730159
NODE_301855_length_190_cov_112.285714	8	91	0	83	83	1.0000000
NODE_301859_length_190_cov_41.373626	92	172	4	80	80	1.0000000
NODE_301859_length_190_cov_41.373626	145	190	0	8	45	0.1777778
NODE_301859_length_190_cov_41.373626	145	190	2	5	45	0.1111111
NODE_301859_length_190_cov_41.373626	145	190	4	32	45	0.7111111
NODE_301880_length_189_cov_234.500000	19	88	0	69	69	1.0000000
NODE_301882_length_189_cov_192.211111	134	186	2	4	52	0.0769231
NODE_301882_length_189_cov_192.211111	134	186	3	8	52	0.1538462
NODE_301882_length_189_cov_192.211111	134	186	4	3	52	0.0576923
NODE_301882_length_189_cov_192.211111	134	186	6	4	52	0.0769231
NODE_301882_length_189_cov_192.211111	134	186	7	18	52	0.3461539
NODE_301882_length_189_cov_192.211111	134	186	8	13	52	0.2500000
NODE_301882_length_189_cov_192.211111	134	186	9	2	52	0.0384615
NODE_301885_length_189_cov_70.600000	19	88	0	69	69	1.0000000
NODE_301885_length_189_cov_70.600000	72	156	0	84	84	1.0000000
NODE_301886_length_189_cov_63.455556	70	150	4	4	80	0.0500000
NODE_301886_length_189_cov_63.455556	70	150	6	29	80	0.3625000
NODE_301886_length_189_cov_63.455556	70	150	8	2	80	0.0250000
NODE_301886_length_189_cov_63.455556	70	150	10	3	80	0.0375000
NODE_301886_length_189_cov_63.455556	70	150	12	42	80	0.5250000
NODE_301886_length_189_cov_63.455556	70	141	6	24	71	0.3380282
NODE_301886_length_189_cov_63.455556	70	141	8	2	71	0.0281690
NODE_301886_length_189_cov_63.455556	70	141	10	3	71	0.0422535
NODE_301886_length_189_cov_63.455556	70	141	12	42	71	0.5915493
NODE_301891_length_189_cov_43.600000	0	73	0	4	73	0.0547945
NODE_301891_length_189_cov_43.600000	0	73	1	11	73	0.1506849
NODE_301891_length_189_cov_43.600000	0	73	4	2	73	0.0273973
NODE_301891_length_189_cov_43.600000	0	73	6	1	73	0.0136986
NODE_301891_length_189_cov_43.600000	0	73	8	5	73	0.0684932
NODE_301891_length_189_cov_43.600000	0	73	9	18	73	0.2465753
NODE_301891_length_189_cov_43.600000	0	73	10	18	73	0.2465753
NODE_301891_length_189_cov_43.600000	0	73	11	1	73	0.0136986
NODE_301891_length_189_cov_43.600000	0	73	12	13	73	0.1780822
NODE_301940_length_188_cov_2021.561798	108	188	1	5	80	0.0625000
NODE_301940_length_188_cov_2021.561798	108	188	5	1	80	0.0125000
NODE_301940_length_188_cov_2021.561798	108	188	7	7	80	0.0875000
NODE_301940_length_188_cov_2021.561798	108	188	9	11	80	0.1375000
NODE_301940_length_188_cov_2021.561798	108	188	13	7	80	0.0875000
NODE_301940_length_188_cov_2021.561798	108	188	15	1	80	0.0125000
NODE_301940_length_188_cov_2021.561798	108	188	17	5	80	0.0625000
NODE_301940_length_188_cov_2021.561798	108	188	18	3	80	0.0375000
NODE_301940_length_188_cov_2021.561798	108	188	20	1	80	0.0125000
NODE_301940_length_188_cov_2021.561798	108	188	22	4	80	0.0500000
NODE_301940_length_188_cov_2021.561798	108	188	24	6	80	0.0750000
NODE_301940_length_188_cov_2021.561798	108	188	26	29	80	0.3625000
NODE_301940_length_188_cov_2021.561798	161	183	5	1	22	0.0454545
NODE_301940_length_188_cov_2021.561798	161	183	7	7	22	0.3181818
NODE_301940_length_188_cov_2021.561798	161	183	9	11	22	0.5000000
NODE_301940_length_188_cov_2021.561798	161	183	13	3	22	0.1363636
NODE_301952_length_188_cov_37.988764	0	50	0	23	50	0.4600000
NODE_301952_length_188_cov_37.988764	0	50	2	1	50	0.0200000
NODE_301952_length_188_cov_37.988764	0	50	4	1	50	0.0200000
NODE_301952_length_188_cov_37.988764	0	50	5	25	50	0.5000000
NODE_301980_length_187_cov_71.170455	124	155	0	31	31	1.0000000
NODE_301981_length_187_cov_56.000000	72	136	8	64	64	1.0000000
NODE_301981_length_187_cov_56.000000	72	136	8	64	64	1.0000000
NODE_301981_length_187_cov_56.000000	109	175	7	9	66	0.1363636
NODE_301981_length_187_cov_56.000000	109	175	8	57	66	0.8636364
NODE_301981_length_187_cov_56.000000	109	180	7	14	71	0.1971831
NODE_301981_length_187_cov_56.000000	109	180	8	57	71	0.8028169
NODE_301986_length_187_cov_37.397727	4	57	0	16	53	0.3018868
NODE_301986_length_187_cov_37.397727	4	57	4	18	53	0.3396226
NODE_301986_length_187_cov_37.397727	4	57	6	12	53	0.2264151
NODE_301986_length_187_cov_37.397727	4	57	8	7	53	0.1320755
NODE_301986_length_187_cov_37.397727	12	78	0	8	66	0.1212121
NODE_301986_length_187_cov_37.397727	12	78	4	18	66	0.2727273
NODE_301986_length_187_cov_37.397727	12	78	6	12	66	0.1818182
NODE_301986_length_187_cov_37.397727	12	78	8	7	66	0.1060606
NODE_301986_length_187_cov_37.397727	12	78	10	21	66	0.3181818
NODE_301986_length_187_cov_37.397727	51	112	6	3	61	0.0491803
NODE_301986_length_187_cov_37.397727	51	112	8	6	61	0.0983607
NODE_301986_length_187_cov_37.397727	51	112	10	52	61	0.8524590
NODE_301986_length_187_cov_37.397727	51	114	6	5	63	0.0793651
NODE_301986_length_187_cov_37.397727	51	114	8	6	63	0.0952381
NODE_301986_length_187_cov_37.397727	51	114	10	52	63	0.8253968
NODE_302020_length_186_cov_309.620690	20	104	0	84	84	1.0000000
NODE_302021_length_186_cov_295.505747	57	115	26	58	58	1.0000000
NODE_302021_length_186_cov_295.505747	101	168	7	2	67	0.0298507
NODE_302021_length_186_cov_295.505747	101	168	8	3	67	0.0447761
NODE_302021_length_186_cov_295.505747	101	168	10	6	67	0.0895522
NODE_302021_length_186_cov_295.505747	101	168	11	1	67	0.0149254
NODE_302021_length_186_cov_295.505747	101	168	12	4	67	0.0597015
NODE_302021_length_186_cov_295.505747	101	168	14	5	67	0.0746269
NODE_302021_length_186_cov_295.505747	101	168	16	2	67	0.0298507
NODE_302021_length_186_cov_295.505747	101	168	17	1	67	0.0149254
NODE_302021_length_186_cov_295.505747	101	168	18	3	67	0.0447761
NODE_302021_length_186_cov_295.505747	101	168	21	7	67	0.1044776
NODE_302021_length_186_cov_295.505747	101	168	23	3	67	0.0447761
NODE_302021_length_186_cov_295.505747	101	168	24	10	67	0.1492537
NODE_302021_length_186_cov_295.505747	101	168	26	20	67	0.2985075
NODE_302025_length_186_cov_61.344828	38	118	4	80	80	1.0000000
NODE_302025_length_186_cov_61.344828	91	171	2	6	80	0.0750000
NODE_302025_length_186_cov_61.344828	91	171	4	74	80	0.9250000
NODE_302201_length_182_cov_127.759036	6	52	9	5	46	0.1086956
NODE_302201_length_182_cov_127.759036	6	52	11	1	46	0.0217391
NODE_302201_length_182_cov_127.759036	6	52	13	1	46	0.0217391
NODE_302201_length_182_cov_127.759036	6	52	14	4	46	0.0869565
NODE_302201_length_182_cov_127.759036	6	52	15	2	46	0.0434783
NODE_302201_length_182_cov_127.759036	6	52	17	1	46	0.0217391
NODE_302201_length_182_cov_127.759036	6	52	18	3	46	0.0652174
NODE_302201_length_182_cov_127.759036	6	52	19	6	46	0.1304348
NODE_302201_length_182_cov_127.759036	6	52	20	1	46	0.0217391
NODE_302201_length_182_cov_127.759036	6	52	21	2	46	0.0434783
NODE_302201_length_182_cov_127.759036	6	52	26	1	46	0.0217391
NODE_302201_length_182_cov_127.759036	6	52	27	1	46	0.0217391
NODE_302201_length_182_cov_127.759036	6	52	28	17	46	0.3695652
NODE_302201_length_182_cov_127.759036	6	52	30	1	46	0.0217391
NODE_302201_length_182_cov_127.759036	59	105	29	1	46	0.0217391
NODE_302201_length_182_cov_127.759036	59	105	30	4	46	0.0869565
NODE_302201_length_182_cov_127.759036	59	105	31	1	46	0.0217391
NODE_302201_length_182_cov_127.759036	59	105	32	40	46	0.8695652
NODE_302214_length_182_cov_29.421687	5	35	0	30	30	1.0000000
NODE_302214_length_182_cov_29.421687	8	88	0	80	80	1.0000000
NODE_302236_length_181_cov_141.195122	1	60	0	6	59	0.1016949
NODE_302236_length_181_cov_141.195122	1	60	1	16	59	0.2711864
NODE_302236_length_181_cov_141.195122	1	60	2	37	59	0.6271186
NODE_302236_length_181_cov_141.195122	34	60	2	26	26	1.0000000
NODE_302236_length_181_cov_141.195122	114	145	2	31	31	1.0000000
NODE_302285_length_180_cov_102.567901	6	75	4	25	69	0.3623188
NODE_302285_length_180_cov_102.567901	6	75	6	12	69	0.1739130
NODE_302285_length_180_cov_102.567901	6	75	8	17	69	0.2463768
NODE_302285_length_180_cov_102.567901	6	75	10	15	69	0.2173913
NODE_302363_length_178_cov_93.620253	81	112	2	31	31	1.0000000
NODE_302365_length_178_cov_62.696203	0	78	0	5	78	0.0641026
NODE_302365_length_178_cov_62.696203	0	78	2	13	78	0.1666667
NODE_302365_length_178_cov_62.696203	0	78	3	8	78	0.1025641
NODE_302365_length_178_cov_62.696203	0	78	4	1	78	0.0128205
NODE_302365_length_178_cov_62.696203	0	78	6	8	78	0.1025641
NODE_302365_length_178_cov_62.696203	0	78	8	43	78	0.5512820
NODE_302365_length_178_cov_62.696203	51	131	4	13	80	0.1625000
NODE_302365_length_178_cov_62.696203	51	131	6	12	80	0.1500000
NODE_302365_length_178_cov_62.696203	51	131	8	55	80	0.6875000
NODE_302477_length_175_cov_116.684211	42	122	4	9	80	0.1125000
NODE_302477_length_175_cov_116.684211	42	122	6	4	80	0.0500000
NODE_302477_length_175_cov_116.684211	42	122	8	67	80	0.8375000
NODE_302477_length_175_cov_116.684211	95	175	0	11	80	0.1375000
NODE_302477_length_175_cov_116.684211	95	175	4	17	80	0.2125000
NODE_302477_length_175_cov_116.684211	95	175	6	1	80	0.0125000
NODE_302477_length_175_cov_116.684211	95	175	8	51	80	0.6375000
NODE_302482_length_175_cov_61.000000	81	121	24	3	40	0.0750000
NODE_302482_length_175_cov_61.000000	81	121	26	37	40	0.9250000
NODE_302538_length_174_cov_173.893333	53	93	28	11	40	0.2750000
NODE_302538_length_174_cov_173.893333	53	93	30	6	40	0.1500000
NODE_302538_length_174_cov_173.893333	53	93	32	23	40	0.5750000
NODE_302543_length_174_cov_50.346667	91	161	1	27	70	0.3857143
NODE_302543_length_174_cov_50.346667	91	161	3	17	70	0.2428571
NODE_302543_length_174_cov_50.346667	91	161	5	9	70	0.1285714
NODE_302543_length_174_cov_50.346667	91	161	6	17	70	0.2428571
NODE_302590_length_173_cov_184.351351	62	126	15	6	64	0.0937500
NODE_302590_length_173_cov_184.351351	62	126	17	58	64	0.9062500
NODE_302590_length_173_cov_184.351351	62	126	15	6	64	0.0937500
NODE_302590_length_173_cov_184.351351	62	126	17	58	64	0.9062500
NODE_302590_length_173_cov_184.351351	62	126	15	6	64	0.0937500
NODE_302590_length_173_cov_184.351351	62	126	17	58	64	0.9062500
NODE_302590_length_173_cov_184.351351	62	126	15	6	64	0.0937500
NODE_302590_length_173_cov_184.351351	62	126	17	58	64	0.9062500
NODE_302590_length_173_cov_184.351351	99	165	6	3	66	0.0454545
NODE_302590_length_173_cov_184.351351	99	165	8	12	66	0.1818182
NODE_302590_length_173_cov_184.351351	99	165	10	4	66	0.0606061
NODE_302590_length_173_cov_184.351351	99	165	11	5	66	0.0757576
NODE_302590_length_173_cov_184.351351	99	165	13	12	66	0.1818182
NODE_302590_length_173_cov_184.351351	99	165	17	30	66	0.4545455
NODE_302590_length_173_cov_184.351351	99	170	4	4	71	0.0563380
NODE_302590_length_173_cov_184.351351	99	170	6	4	71	0.0563380
NODE_302590_length_173_cov_184.351351	99	170	8	12	71	0.1690141
NODE_302590_length_173_cov_184.351351	99	170	10	4	71	0.0563380
NODE_302590_length_173_cov_184.351351	99	170	11	5	71	0.0704225
NODE_302590_length_173_cov_184.351351	99	170	13	12	71	0.1690141
NODE_302590_length_173_cov_184.351351	99	170	17	30	71	0.4225352
NODE_302590_length_173_cov_184.351351	115	173	2	2	58	0.0344828
NODE_302590_length_173_cov_184.351351	115	173	4	5	58	0.0862069
NODE_302590_length_173_cov_184.351351	115	173	6	4	58	0.0689655
NODE_302590_length_173_cov_184.351351	115	173	8	12	58	0.2068966
NODE_302590_length_173_cov_184.351351	115	173	10	4	58	0.0689655
NODE_302590_length_173_cov_184.351351	115	173	11	5	58	0.0862069
NODE_302590_length_173_cov_184.351351	115	173	13	12	58	0.2068966
NODE_302590_length_173_cov_184.351351	115	173	17	14	58	0.2413793
NODE_302596_length_173_cov_58.472973	0	78	0	2	78	0.0256410
NODE_302596_length_173_cov_58.472973	0	78	1	9	78	0.1153846
NODE_302596_length_173_cov_58.472973	0	78	3	9	78	0.1153846
NODE_302596_length_173_cov_58.472973	0	78	5	23	78	0.2948718
NODE_302596_length_173_cov_58.472973	0	78	6	16	78	0.2051282
NODE_302596_length_173_cov_58.472973	0	78	8	19	78	0.2435897
NODE_302597_length_173_cov_57.148649	101	142	14	1	41	0.0243902
NODE_302597_length_173_cov_57.148649	101	142	15	16	41	0.3902439
NODE_302597_length_173_cov_57.148649	101	142	16	18	41	0.4390244
NODE_302597_length_173_cov_57.148649	101	142	18	2	41	0.0487805
NODE_302597_length_173_cov_57.148649	101	142	20	4	41	0.0975610
NODE_302597_length_173_cov_57.148649	109	173	2	1	64	0.0156250
NODE_302597_length_173_cov_57.148649	109	173	3	13	64	0.2031250
NODE_302597_length_173_cov_57.148649	109	173	7	4	64	0.0625000
NODE_302597_length_173_cov_57.148649	109	173	8	2	64	0.0312500
NODE_302597_length_173_cov_57.148649	109	173	9	3	64	0.0468750
NODE_302597_length_173_cov_57.148649	109	173	11	2	64	0.0312500
NODE_302597_length_173_cov_57.148649	109	173	13	2	64	0.0312500
NODE_302597_length_173_cov_57.148649	109	173	14	5	64	0.0781250
NODE_302597_length_173_cov_57.148649	109	173	15	16	64	0.2500000
NODE_302597_length_173_cov_57.148649	109	173	16	16	64	0.2500000
NODE_302686_length_171_cov_218.666667	12	90	2	78	78	1.0000000
NODE_302686_length_171_cov_218.666667	12	90	2	78	78	1.0000000
NODE_302686_length_171_cov_218.666667	21	90	2	69	69	1.0000000
NODE_302689_length_171_cov_110.194444	81	161	0	23	80	0.2875000
NODE_302689_length_171_cov_110.194444	81	161	2	8	80	0.1000000
NODE_302689_length_171_cov_110.194444	81	161	4	49	80	0.6125000
NODE_302689_length_171_cov_110.194444	81	152	0	14	71	0.1971831
NODE_302689_length_171_cov_110.194444	81	152	2	8	71	0.1126761
NODE_302689_length_171_cov_110.194444	81	152	4	49	71	0.6901408
NODE_302691_length_171_cov_86.013889	106	171	0	65	65	1.0000000
NODE_302697_length_171_cov_46.430556	0	59	0	2	59	0.0338983
NODE_302697_length_171_cov_46.430556	0	59	1	1	59	0.0169492
NODE_302697_length_171_cov_46.430556	0	59	2	2	59	0.0338983
NODE_302697_length_171_cov_46.430556	0	59	4	5	59	0.0847458
NODE_302697_length_171_cov_46.430556	0	59	5	1	59	0.0169492
NODE_302697_length_171_cov_46.430556	0	59	6	21	59	0.3559322
NODE_302697_length_171_cov_46.430556	0	59	8	4	59	0.0677966
NODE_302697_length_171_cov_46.430556	0	59	10	8	59	0.1355932
NODE_302697_length_171_cov_46.430556	0	59	12	10	59	0.1694915
NODE_302697_length_171_cov_46.430556	0	59	14	5	59	0.0847458
NODE_302697_length_171_cov_46.430556	32	98	8	4	66	0.0606061
NODE_302697_length_171_cov_46.430556	32	98	10	8	66	0.1212121
NODE_302697_length_171_cov_46.430556	32	98	12	10	66	0.1515152
NODE_302697_length_171_cov_46.430556	32	98	14	5	66	0.0757576
NODE_302697_length_171_cov_46.430556	32	98	16	39	66	0.5909091
NODE_302700_length_171_cov_40.069444	13	87	0	74	74	1.0000000
NODE_302702_length_171_cov_33.319444	84	158	0	38	74	0.5135135
NODE_302702_length_171_cov_33.319444	84	158	2	10	74	0.1351351
NODE_302702_length_171_cov_33.319444	84	158	4	26	74	0.3513514
NODE_302764_length_170_cov_217.422535	10	90	5	4	80	0.0500000
NODE_302764_length_170_cov_217.422535	10	90	7	13	80	0.1625000
NODE_302764_length_170_cov_217.422535	10	90	8	63	80	0.7875000
NODE_302764_length_170_cov_217.422535	10	90	5	4	80	0.0500000
NODE_302764_length_170_cov_217.422535	10	90	7	13	80	0.1625000
NODE_302764_length_170_cov_217.422535	10	90	8	63	80	0.7875000
NODE_302764_length_170_cov_217.422535	10	90	5	4	80	0.0500000
NODE_302764_length_170_cov_217.422535	10	90	7	13	80	0.1625000
NODE_302764_length_170_cov_217.422535	10	90	8	63	80	0.7875000
NODE_302764_length_170_cov_217.422535	10	90	5	4	80	0.0500000
NODE_302764_length_170_cov_217.422535	10	90	7	13	80	0.1625000
NODE_302764_length_170_cov_217.422535	10	90	8	63	80	0.7875000
NODE_302764_length_170_cov_217.422535	10	90	5	4	80	0.0500000
NODE_302764_length_170_cov_217.422535	10	90	7	13	80	0.1625000
NODE_302764_length_170_cov_217.422535	10	90	8	63	80	0.7875000
NODE_302764_length_170_cov_217.422535	19	90	7	8	71	0.1126761
NODE_302764_length_170_cov_217.422535	19	90	8	63	71	0.8873239
NODE_302764_length_170_cov_217.422535	63	126	6	12	63	0.1904762
NODE_302764_length_170_cov_217.422535	63	126	8	51	63	0.8095238
NODE_302764_length_170_cov_217.422535	63	126	6	12	63	0.1904762
NODE_302764_length_170_cov_217.422535	63	126	8	51	63	0.8095238
NODE_302768_length_170_cov_102.816901	23	86	1	27	63	0.4285714
NODE_302768_length_170_cov_102.816901	23	86	3	36	63	0.5714286
NODE_302806_length_169_cov_47.757143	70	150	11	3	80	0.0375000
NODE_302806_length_169_cov_47.757143	70	150	13	1	80	0.0125000
NODE_302806_length_169_cov_47.757143	70	150	14	2	80	0.0250000
NODE_302806_length_169_cov_47.757143	70	150	15	3	80	0.0375000
NODE_302806_length_169_cov_47.757143	70	150	16	71	80	0.8875000
NODE_302869_length_168_cov_10.391304	66	99	0	33	33	1.0000000
NODE_302869_length_168_cov_10.391304	135	168	0	33	33	1.0000000
NODE_302966_length_166_cov_401.149254	31	109	9	7	78	0.0897436
NODE_302966_length_166_cov_401.149254	31	109	11	5	78	0.0641026
NODE_302966_length_166_cov_401.149254	31	109	13	2	78	0.0256410
NODE_302966_length_166_cov_401.149254	31	109	16	9	78	0.1153846
NODE_302966_length_166_cov_401.149254	31	109	18	55	78	0.7051282
NODE_302966_length_166_cov_401.149254	82	157	4	2	75	0.0266667
NODE_302966_length_166_cov_401.149254	82	157	6	8	75	0.1066667
NODE_302966_length_166_cov_401.149254	82	157	8	9	75	0.1200000
NODE_302966_length_166_cov_401.149254	82	157	10	8	75	0.1066667
NODE_302966_length_166_cov_401.149254	82	157	12	4	75	0.0533333
NODE_302966_length_166_cov_401.149254	82	157	16	9	75	0.1200000
NODE_302966_length_166_cov_401.149254	82	157	18	35	75	0.4666667
NODE_302974_length_166_cov_123.223881	46	97	2	51	51	1.0000000
NODE_303071_length_164_cov_154.076923	0	75	0	75	75	1.0000000
NODE_303071_length_164_cov_154.076923	48	128	0	80	80	1.0000000
NODE_303074_length_164_cov_69.369231	0	64	0	64	64	1.0000000
NODE_303079_length_164_cov_43.923077	36	100	10	64	64	1.0000000
NODE_303079_length_164_cov_43.923077	36	100	10	64	64	1.0000000
NODE_303079_length_164_cov_43.923077	73	153	9	16	80	0.2000000
NODE_303079_length_164_cov_43.923077	73	153	10	64	80	0.8000000
NODE_303079_length_164_cov_43.923077	73	153	9	16	80	0.2000000
NODE_303079_length_164_cov_43.923077	73	153	10	64	80	0.8000000
NODE_303079_length_164_cov_43.923077	73	153	9	16	80	0.2000000
NODE_303079_length_164_cov_43.923077	73	153	10	64	80	0.8000000
NODE_303079_length_164_cov_43.923077	73	153	9	16	80	0.2000000
NODE_303079_length_164_cov_43.923077	73	153	10	64	80	0.8000000
NODE_303079_length_164_cov_43.923077	73	153	9	16	80	0.2000000
NODE_303079_length_164_cov_43.923077	73	153	10	64	80	0.8000000
NODE_303079_length_164_cov_43.923077	73	144	9	7	71	0.0985916
NODE_303079_length_164_cov_43.923077	73	144	10	64	71	0.9014084
NODE_303135_length_163_cov_480.593750	0	40	5	1	40	0.0250000
NODE_303135_length_163_cov_480.593750	0	40	6	4	40	0.1000000
NODE_303135_length_163_cov_480.593750	0	40	7	2	40	0.0500000
NODE_303135_length_163_cov_480.593750	0	40	9	3	40	0.0750000
NODE_303135_length_163_cov_480.593750	0	40	10	23	40	0.5750000
NODE_303135_length_163_cov_480.593750	0	40	12	7	40	0.1750000
NODE_303136_length_163_cov_368.000000	24	96	2	28	72	0.3888889
NODE_303136_length_163_cov_368.000000	24	96	4	44	72	0.6111111
NODE_303138_length_163_cov_319.843750	0	68	2	2	68	0.0294118
NODE_303138_length_163_cov_319.843750	0	68	4	22	68	0.3235294
NODE_303138_length_163_cov_319.843750	0	68	6	44	68	0.6470588
NODE_303139_length_163_cov_198.078125	34	109	0	20	75	0.2666667
NODE_303139_length_163_cov_198.078125	34	109	2	55	75	0.7333333
NODE_303139_length_163_cov_198.078125	34	114	0	20	80	0.2500000
NODE_303139_length_163_cov_198.078125	34	114	2	60	80	0.7500000
NODE_303139_length_163_cov_198.078125	35	110	0	19	75	0.2533333
NODE_303139_length_163_cov_198.078125	35	110	2	56	75	0.7466667
NODE_303139_length_163_cov_198.078125	87	163	0	5	76	0.0657895
NODE_303139_length_163_cov_198.078125	87	163	2	71	76	0.9342105
NODE_303139_length_163_cov_198.078125	87	163	0	5	76	0.0657895
NODE_303139_length_163_cov_198.078125	87	163	2	71	76	0.9342105
NODE_303139_length_163_cov_198.078125	87	163	0	5	76	0.0657895
NODE_303139_length_163_cov_198.078125	87	163	2	71	76	0.9342105
NODE_303231_length_162_cov_421.047619	7	56	1	15	49	0.3061225
NODE_303231_length_162_cov_421.047619	7	56	5	1	49	0.0204082
NODE_303231_length_162_cov_421.047619	7	56	7	1	49	0.0204082
NODE_303231_length_162_cov_421.047619	7	56	9	5	49	0.1020408
NODE_303231_length_162_cov_421.047619	7	56	11	6	49	0.1224490
NODE_303231_length_162_cov_421.047619	7	56	13	19	49	0.3877551
NODE_303231_length_162_cov_421.047619	7	56	15	2	49	0.0408163
NODE_303231_length_162_cov_421.047619	29	90	11	6	61	0.0983607
NODE_303231_length_162_cov_421.047619	29	90	13	19	61	0.3114754
NODE_303231_length_162_cov_421.047619	29	90	15	2	61	0.0327869
NODE_303231_length_162_cov_421.047619	29	90	17	34	61	0.5573770
NODE_303231_length_162_cov_421.047619	29	92	11	6	63	0.0952381
NODE_303231_length_162_cov_421.047619	29	92	13	19	63	0.3015873
NODE_303231_length_162_cov_421.047619	29	92	15	2	63	0.0317460
NODE_303231_length_162_cov_421.047619	29	92	17	36	63	0.5714286
NODE_303231_length_162_cov_421.047619	29	92	11	6	63	0.0952381
NODE_303231_length_162_cov_421.047619	29	92	13	19	63	0.3015873
NODE_303231_length_162_cov_421.047619	29	92	15	2	63	0.0317460
NODE_303231_length_162_cov_421.047619	29	92	17	36	63	0.5714286
NODE_303231_length_162_cov_421.047619	29	92	11	6	63	0.0952381
NODE_303231_length_162_cov_421.047619	29	92	13	19	63	0.3015873
NODE_303231_length_162_cov_421.047619	29	92	15	2	63	0.0317460
NODE_303231_length_162_cov_421.047619	29	92	17	36	63	0.5714286
NODE_303250_length_162_cov_45.380952	63	127	4	64	64	1.0000000
NODE_303250_length_162_cov_45.380952	63	127	4	64	64	1.0000000
NODE_303250_length_162_cov_45.380952	100	162	0	4	62	0.0645161
NODE_303250_length_162_cov_45.380952	100	162	1	20	62	0.3225806
NODE_303250_length_162_cov_45.380952	100	162	2	11	62	0.1774193
NODE_303250_length_162_cov_45.380952	100	162	4	27	62	0.4354839
NODE_303301_length_161_cov_1483.177419	51	131	26	8	80	0.1000000
NODE_303301_length_161_cov_1483.177419	51	131	28	11	80	0.1375000
NODE_303301_length_161_cov_1483.177419	51	131	30	61	80	0.7625000
NODE_303301_length_161_cov_1483.177419	104	161	5	2	57	0.0350877
NODE_303301_length_161_cov_1483.177419	104	161	9	2	57	0.0350877
NODE_303301_length_161_cov_1483.177419	104	161	13	2	57	0.0350877
NODE_303301_length_161_cov_1483.177419	104	161	14	10	57	0.1754386
NODE_303301_length_161_cov_1483.177419	104	161	16	2	57	0.0350877
NODE_303301_length_161_cov_1483.177419	104	161	18	5	57	0.0877193
NODE_303301_length_161_cov_1483.177419	104	161	20	2	57	0.0350877
NODE_303301_length_161_cov_1483.177419	104	161	24	2	57	0.0350877
NODE_303301_length_161_cov_1483.177419	104	161	26	11	57	0.1929825
NODE_303301_length_161_cov_1483.177419	104	161	28	4	57	0.0701754
NODE_303301_length_161_cov_1483.177419	104	161	30	15	57	0.2631579
NODE_303312_length_161_cov_71.500000	33	110	0	77	77	1.0000000
NODE_303312_length_161_cov_71.500000	33	110	0	77	77	1.0000000
NODE_303312_length_161_cov_71.500000	33	110	0	77	77	1.0000000
NODE_303312_length_161_cov_71.500000	33	110	0	77	77	1.0000000
NODE_303312_length_161_cov_71.500000	83	149	0	66	66	1.0000000
NODE_303312_length_161_cov_71.500000	83	161	0	78	78	1.0000000
NODE_303312_length_161_cov_71.500000	86	161	0	75	75	1.0000000
NODE_303312_length_161_cov_71.500000	86	161	0	75	75	1.0000000
NODE_303312_length_161_cov_71.500000	88	161	0	73	73	1.0000000
NODE_303321_length_161_cov_29.758065	0	80	0	2	80	0.0250000
NODE_303321_length_161_cov_29.758065	0	80	1	1	80	0.0125000
NODE_303321_length_161_cov_29.758065	0	80	2	2	80	0.0250000
NODE_303321_length_161_cov_29.758065	0	80	3	5	80	0.0625000
NODE_303321_length_161_cov_29.758065	0	80	5	4	80	0.0500000
NODE_303321_length_161_cov_29.758065	0	80	7	1	80	0.0125000
NODE_303321_length_161_cov_29.758065	0	80	8	65	80	0.8125000
NODE_303381_length_160_cov_143.573770	45	125	0	80	80	1.0000000
NODE_303381_length_160_cov_143.573770	93	160	0	67	67	1.0000000
NODE_303381_length_160_cov_143.573770	98	120	0	22	22	1.0000000
NODE_303388_length_160_cov_58.245902	0	45	0	39	45	0.8666667
NODE_303388_length_160_cov_58.245902	0	45	2	6	45	0.1333333
NODE_303431_length_159_cov_182.016667	71	156	0	85	85	1.0000000
NODE_303431_length_159_cov_182.016667	71	156	0	85	85	1.0000000
NODE_303431_length_159_cov_182.016667	71	156	0	85	85	1.0000000
NODE_303440_length_159_cov_85.750000	0	43	0	1	43	0.0232558
NODE_303440_length_159_cov_85.750000	0	43	2	3	43	0.0697674
NODE_303440_length_159_cov_85.750000	0	43	4	33	43	0.7674419
NODE_303440_length_159_cov_85.750000	0	43	6	6	43	0.1395349
NODE_303440_length_159_cov_85.750000	16	97	4	21	81	0.2592593
NODE_303440_length_159_cov_85.750000	16	97	6	60	81	0.7407407
NODE_303440_length_159_cov_85.750000	65	145	4	34	80	0.4250000
NODE_303440_length_159_cov_85.750000	65	145	6	46	80	0.5750000
NODE_303440_length_159_cov_85.750000	70	92	6	22	22	1.0000000
NODE_303546_length_158_cov_119.813559	34	77	3	43	43	1.0000000
NODE_303546_length_158_cov_119.813559	78	113	3	35	35	1.0000000
NODE_303546_length_158_cov_119.813559	123	158	1	20	35	0.5714286
NODE_303546_length_158_cov_119.813559	123	158	3	15	35	0.4285714
NODE_303552_length_158_cov_70.135593	5	82	0	77	77	1.0000000
NODE_303552_length_158_cov_70.135593	5	82	0	77	77	1.0000000
NODE_303552_length_158_cov_70.135593	81	155	0	74	74	1.0000000
NODE_303555_length_158_cov_63.559322	80	151	0	71	71	1.0000000
NODE_303556_length_158_cov_61.203390	2	66	0	18	64	0.2812500
NODE_303556_length_158_cov_61.203390	2	66	2	7	64	0.1093750
NODE_303556_length_158_cov_61.203390	2	66	4	39	64	0.6093750
NODE_303556_length_158_cov_61.203390	2	66	0	18	64	0.2812500
NODE_303556_length_158_cov_61.203390	2	66	2	7	64	0.1093750
NODE_303556_length_158_cov_61.203390	2	66	4	39	64	0.6093750
NODE_303556_length_158_cov_61.203390	2	66	0	18	64	0.2812500
NODE_303556_length_158_cov_61.203390	2	66	2	7	64	0.1093750
NODE_303556_length_158_cov_61.203390	2	66	4	39	64	0.6093750
NODE_303556_length_158_cov_61.203390	39	119	4	80	80	1.0000000
NODE_303563_length_158_cov_40.271186	43	107	4	64	64	1.0000000
NODE_303563_length_158_cov_40.271186	80	151	2	13	71	0.1830986
NODE_303563_length_158_cov_40.271186	80	151	4	58	71	0.8169014
NODE_303566_length_158_cov_29.661017	0	61	0	61	61	1.0000000
NODE_303566_length_158_cov_29.661017	34	64	0	30	30	1.0000000
NODE_303605_length_157_cov_1488.586207	57	138	6	6	81	0.0740741
NODE_303605_length_157_cov_1488.586207	57	138	7	1	81	0.0123457
NODE_303605_length_157_cov_1488.586207	57	138	8	74	81	0.9135802
NODE_303605_length_157_cov_1488.586207	111	157	0	1	46	0.0217391
NODE_303605_length_157_cov_1488.586207	111	157	2	2	46	0.0434783
NODE_303605_length_157_cov_1488.586207	111	157	4	13	46	0.2826087
NODE_303605_length_157_cov_1488.586207	111	157	6	9	46	0.1956522
NODE_303605_length_157_cov_1488.586207	111	157	7	1	46	0.0217391
NODE_303605_length_157_cov_1488.586207	111	157	8	20	46	0.4347826
NODE_303606_length_157_cov_295.896552	32	78	4	6	46	0.1304348
NODE_303606_length_157_cov_295.896552	32	78	6	5	46	0.1086956
NODE_303606_length_157_cov_295.896552	32	78	10	6	46	0.1304348
NODE_303606_length_157_cov_295.896552	32	78	12	29	46	0.6304348
NODE_303608_length_157_cov_161.689655	0	59	0	59	59	1.0000000
NODE_303608_length_157_cov_161.689655	0	59	0	59	59	1.0000000
NODE_303608_length_157_cov_161.689655	55	135	0	80	80	1.0000000
NODE_303608_length_157_cov_161.689655	55	135	0	80	80	1.0000000
NODE_303608_length_157_cov_161.689655	108	157	0	49	49	1.0000000
NODE_303608_length_157_cov_161.689655	113	157	0	44	44	1.0000000
NODE_303677_length_156_cov_100.491228	0	41	0	14	41	0.3414634
NODE_303677_length_156_cov_100.491228	0	41	2	27	41	0.6585366
NODE_303677_length_156_cov_100.491228	21	94	2	73	73	1.0000000
NODE_303688_length_156_cov_37.368421	24	81	0	5	57	0.0877193
NODE_303688_length_156_cov_37.368421	24	81	3	15	57	0.2631579
NODE_303688_length_156_cov_37.368421	24	81	5	37	57	0.6491228
NODE_303688_length_156_cov_37.368421	54	134	5	80	80	1.0000000
NODE_303700_length_156_cov_9.543860	2	48	0	25	46	0.5434783
NODE_303700_length_156_cov_9.543860	2	48	2	21	46	0.4565217
NODE_303700_length_156_cov_9.543860	59	105	2	46	46	1.0000000
NODE_303752_length_155_cov_56.750000	27	102	0	75	75	1.0000000
NODE_303752_length_155_cov_56.750000	80	155	0	75	75	1.0000000
NODE_304022_length_153_cov_0.944444	5	48	0	43	43	1.0000000
NODE_304022_length_153_cov_0.944444	37	86	0	49	49	1.0000000
NODE_304022_length_153_cov_0.944444	59	102	0	43	43	1.0000000
NODE_304022_length_153_cov_0.944444	91	140	0	49	49	1.0000000
NODE_304022_length_153_cov_0.944444	113	153	0	40	40	1.0000000
NODE_304027_length_152_cov_195.396226	9	89	0	80	80	1.0000000
NODE_304027_length_152_cov_195.396226	9	89	0	80	80	1.0000000
NODE_304027_length_152_cov_195.396226	85	149	0	64	64	1.0000000
NODE_304027_length_152_cov_195.396226	85	152	0	67	67	1.0000000
NODE_304027_length_152_cov_195.396226	85	152	0	67	67	1.0000000
NODE_304027_length_152_cov_195.396226	85	152	0	67	67	1.0000000
NODE_304030_length_152_cov_68.094340	99	150	0	51	51	1.0000000
NODE_304112_length_151_cov_541.615385	19	88	6	69	69	1.0000000
NODE_304112_length_151_cov_541.615385	72	149	0	8	77	0.1038961
NODE_304112_length_151_cov_541.615385	72	149	4	4	77	0.0519481
NODE_304112_length_151_cov_541.615385	72	149	6	65	77	0.8441558
NODE_304229_length_150_cov_88.647059	51	102	0	51	51	1.0000000
NODE_304472_length_148_cov_34.183673	23	99	15	14	76	0.1842105
NODE_304472_length_148_cov_34.183673	23	99	17	62	76	0.8157895
NODE_304570_length_147_cov_472.354167	0	55	0	55	55	1.0000000
NODE_304570_length_147_cov_472.354167	12	89	0	77	77	1.0000000
NODE_304570_length_147_cov_472.354167	65	137	0	72	72	1.0000000
NODE_304572_length_147_cov_229.729167	7	56	0	13	49	0.2653061
NODE_304572_length_147_cov_229.729167	7	56	2	9	49	0.1836735
NODE_304572_length_147_cov_229.729167	7	56	4	2	49	0.0408163
NODE_304572_length_147_cov_229.729167	7	56	6	13	49	0.2653061
NODE_304572_length_147_cov_229.729167	7	56	8	12	49	0.2448980
NODE_304572_length_147_cov_229.729167	29	93	4	2	64	0.0312500
NODE_304572_length_147_cov_229.729167	29	93	6	13	64	0.2031250
NODE_304572_length_147_cov_229.729167	29	93	8	49	64	0.7656250
NODE_304572_length_147_cov_229.729167	29	93	4	2	64	0.0312500
NODE_304572_length_147_cov_229.729167	29	93	6	13	64	0.2031250
NODE_304572_length_147_cov_229.729167	29	93	8	49	64	0.7656250
NODE_304572_length_147_cov_229.729167	29	93	4	2	64	0.0312500
NODE_304572_length_147_cov_229.729167	29	93	6	13	64	0.2031250
NODE_304572_length_147_cov_229.729167	29	93	8	49	64	0.7656250
NODE_304573_length_147_cov_213.770833	37	117	0	80	80	1.0000000
NODE_304573_length_147_cov_213.770833	90	146	0	56	56	1.0000000
NODE_304697_length_146_cov_182.893617	1	60	0	59	59	1.0000000
NODE_304697_length_146_cov_182.893617	34	60	0	26	26	1.0000000
NODE_304697_length_146_cov_182.893617	113	144	0	31	31	1.0000000
NODE_304698_length_146_cov_152.808511	0	69	0	69	69	1.0000000
NODE_304698_length_146_cov_152.808511	42	122	0	80	80	1.0000000
NODE_304703_length_146_cov_89.808511	0	53	0	53	53	1.0000000
NODE_304703_length_146_cov_89.808511	26	106	0	80	80	1.0000000
NODE_304703_length_146_cov_89.808511	74	146	0	72	72	1.0000000
NODE_304703_length_146_cov_89.808511	79	101	0	22	22	1.0000000
NODE_304707_length_146_cov_57.446809	44	124	0	80	80	1.0000000
NODE_304708_length_146_cov_54.106383	0	69	0	69	69	1.0000000
NODE_304708_length_146_cov_54.106383	42	122	0	80	80	1.0000000
NODE_304710_length_146_cov_46.765957	3	83	0	40	80	0.5000000
NODE_304710_length_146_cov_46.765957	3	83	2	40	80	0.5000000
NODE_304710_length_146_cov_46.765957	3	83	0	40	80	0.5000000
NODE_304710_length_146_cov_46.765957	3	83	2	40	80	0.5000000
NODE_304710_length_146_cov_46.765957	3	83	0	40	80	0.5000000
NODE_304710_length_146_cov_46.765957	3	83	2	40	80	0.5000000
NODE_304710_length_146_cov_46.765957	3	83	0	40	80	0.5000000
NODE_304710_length_146_cov_46.765957	3	83	2	40	80	0.5000000
NODE_304710_length_146_cov_46.765957	3	83	0	40	80	0.5000000
NODE_304710_length_146_cov_46.765957	3	83	2	40	80	0.5000000
NODE_304710_length_146_cov_46.765957	12	83	0	31	71	0.4366197
NODE_304710_length_146_cov_46.765957	12	83	2	40	71	0.5633803
NODE_304710_length_146_cov_46.765957	56	136	0	2	80	0.0250000
NODE_304710_length_146_cov_46.765957	56	136	2	78	80	0.9750000
NODE_304710_length_146_cov_46.765957	56	136	0	2	80	0.0250000
NODE_304710_length_146_cov_46.765957	56	136	2	78	80	0.9750000
NODE_304711_length_146_cov_44.021277	0	69	0	69	69	1.0000000
NODE_304711_length_146_cov_44.021277	42	122	0	80	80	1.0000000
NODE_304798_length_145_cov_1385.413043	0	69	0	4	69	0.0579710
NODE_304798_length_145_cov_1385.413043	0	69	2	3	69	0.0434783
NODE_304798_length_145_cov_1385.413043	0	69	4	1	69	0.0144928
NODE_304798_length_145_cov_1385.413043	0	69	6	2	69	0.0289855
NODE_304798_length_145_cov_1385.413043	0	69	10	1	69	0.0144928
NODE_304798_length_145_cov_1385.413043	0	69	12	1	69	0.0144928
NODE_304798_length_145_cov_1385.413043	0	69	14	17	69	0.2463768
NODE_304798_length_145_cov_1385.413043	0	69	16	9	69	0.1304348
NODE_304798_length_145_cov_1385.413043	0	69	18	31	69	0.4492754
NODE_304798_length_145_cov_1385.413043	42	122	12	1	80	0.0125000
NODE_304798_length_145_cov_1385.413043	42	122	14	5	80	0.0625000
NODE_304798_length_145_cov_1385.413043	42	122	16	5	80	0.0625000
NODE_304798_length_145_cov_1385.413043	42	122	18	69	80	0.8625000
NODE_304799_length_145_cov_880.369565	56	120	2	5	64	0.0781250
NODE_304799_length_145_cov_880.369565	56	120	4	4	64	0.0625000
NODE_304799_length_145_cov_880.369565	56	120	6	3	64	0.0468750
NODE_304799_length_145_cov_880.369565	56	120	8	52	64	0.8125000
NODE_304799_length_145_cov_880.369565	56	120	2	5	64	0.0781250
NODE_304799_length_145_cov_880.369565	56	120	4	4	64	0.0625000
NODE_304799_length_145_cov_880.369565	56	120	6	3	64	0.0468750
NODE_304799_length_145_cov_880.369565	56	120	8	52	64	0.8125000
NODE_304799_length_145_cov_880.369565	56	120	2	5	64	0.0781250
NODE_304799_length_145_cov_880.369565	56	120	4	4	64	0.0625000
NODE_304799_length_145_cov_880.369565	56	120	6	3	64	0.0468750
NODE_304799_length_145_cov_880.369565	56	120	8	52	64	0.8125000
NODE_304799_length_145_cov_880.369565	93	142	0	15	49	0.3061225
NODE_304799_length_145_cov_880.369565	93	142	2	12	49	0.2448980
NODE_304799_length_145_cov_880.369565	93	142	4	4	49	0.0816327
NODE_304799_length_145_cov_880.369565	93	142	6	3	49	0.0612245
NODE_304799_length_145_cov_880.369565	93	142	8	15	49	0.3061225
NODE_304923_length_144_cov_46.155556	1	81	0	14	80	0.1750000
NODE_304923_length_144_cov_46.155556	1	81	2	66	80	0.8250000
NODE_305208_length_142_cov_244.488372	0	52	0	1	52	0.0192308
NODE_305208_length_142_cov_244.488372	0	52	2	1	52	0.0192308
NODE_305208_length_142_cov_244.488372	0	52	4	50	52	0.9615384
NODE_305229_length_142_cov_46.976744	1	65	0	13	64	0.2031250
NODE_305229_length_142_cov_46.976744	1	65	2	6	64	0.0937500
NODE_305229_length_142_cov_46.976744	1	65	4	20	64	0.3125000
NODE_305229_length_142_cov_46.976744	1	65	6	25	64	0.3906250
NODE_305229_length_142_cov_46.976744	1	65	0	13	64	0.2031250
NODE_305229_length_142_cov_46.976744	1	65	2	6	64	0.0937500
NODE_305229_length_142_cov_46.976744	1	65	4	20	64	0.3125000
NODE_305229_length_142_cov_46.976744	1	65	6	25	64	0.3906250
NODE_305229_length_142_cov_46.976744	1	65	0	13	64	0.2031250
NODE_305229_length_142_cov_46.976744	1	65	2	6	64	0.0937500
NODE_305229_length_142_cov_46.976744	1	65	4	20	64	0.3125000
NODE_305229_length_142_cov_46.976744	1	65	6	25	64	0.3906250
NODE_305230_length_142_cov_45.000000	0	69	0	69	69	1.0000000
NODE_305385_length_141_cov_178.785714	58	118	8	3	60	0.0500000
NODE_305385_length_141_cov_178.785714	58	118	10	57	60	0.9500000
NODE_305398_length_141_cov_62.285714	26	106	0	80	80	1.0000000
NODE_305398_length_141_cov_62.285714	26	106	0	80	80	1.0000000
NODE_305398_length_141_cov_62.285714	26	97	0	71	71	1.0000000
NODE_305402_length_141_cov_41.142857	26	97	0	71	71	1.0000000
NODE_305600_length_140_cov_60.439024	8	88	0	80	80	1.0000000
NODE_305600_length_140_cov_60.439024	8	88	0	80	80	1.0000000
NODE_305600_length_140_cov_60.439024	8	88	0	80	80	1.0000000
NODE_305600_length_140_cov_60.439024	8	88	0	80	80	1.0000000
NODE_305600_length_140_cov_60.439024	8	88	0	80	80	1.0000000
NODE_305616_length_140_cov_35.146341	22	102	0	80	80	1.0000000
NODE_305616_length_140_cov_35.146341	75	105	0	30	30	1.0000000
NODE_305618_length_140_cov_34.048780	0	77	0	77	77	1.0000000
NODE_305618_length_140_cov_34.048780	0	77	0	77	77	1.0000000
NODE_305618_length_140_cov_34.048780	50	130	0	80	80	1.0000000
NODE_305618_length_140_cov_34.048780	50	130	0	80	80	1.0000000
NODE_305618_length_140_cov_34.048780	55	130	0	75	75	1.0000000
NODE_305619_length_140_cov_19.926829	44	118	0	74	74	1.0000000
NODE_305783_length_139_cov_29.700000	0	40	0	40	40	1.0000000
NODE_305783_length_139_cov_29.700000	0	40	0	40	40	1.0000000
NODE_305783_length_139_cov_29.700000	13	93	0	80	80	1.0000000
NODE_305783_length_139_cov_29.700000	13	93	0	80	80	1.0000000
NODE_305783_length_139_cov_29.700000	13	93	0	80	80	1.0000000
NODE_305783_length_139_cov_29.700000	13	93	0	80	80	1.0000000
NODE_305783_length_139_cov_29.700000	13	93	0	80	80	1.0000000
NODE_305783_length_139_cov_29.700000	13	84	0	71	71	1.0000000
NODE_305936_length_138_cov_1475.615385	30	97	5	67	67	1.0000000
NODE_305936_length_138_cov_1475.615385	70	138	5	68	68	1.0000000
NODE_305963_length_138_cov_29.564103	11	91	0	7	80	0.0875000
NODE_305963_length_138_cov_29.564103	11	91	2	73	80	0.9125000
NODE_305963_length_138_cov_29.564103	11	91	0	7	80	0.0875000
NODE_305963_length_138_cov_29.564103	11	91	2	73	80	0.9125000
NODE_305963_length_138_cov_29.564103	64	128	0	16	64	0.2500000
NODE_305963_length_138_cov_29.564103	64	128	2	48	64	0.7500000
NODE_305963_length_138_cov_29.564103	64	128	0	16	64	0.2500000
NODE_305963_length_138_cov_29.564103	64	128	2	48	64	0.7500000
NODE_306081_length_137_cov_185.684211	20	104	2	84	84	1.0000000
NODE_306092_length_137_cov_58.289474	76	106	0	30	30	1.0000000
NODE_306099_length_137_cov_36.473684	31	111	0	80	80	1.0000000
NODE_306208_length_136_cov_1257.621622	27	107	2	80	80	1.0000000
NODE_306209_length_136_cov_769.594595	0	69	0	8	69	0.1159420
NODE_306209_length_136_cov_769.594595	0	69	2	61	69	0.8840580
NODE_306222_length_136_cov_128.324324	39	119	0	80	80	1.0000000
NODE_306227_length_136_cov_90.783784	10	86	0	13	76	0.1710526
NODE_306227_length_136_cov_90.783784	10	86	2	63	76	0.8289474
NODE_306227_length_136_cov_90.783784	59	136	0	16	77	0.2077922
NODE_306227_length_136_cov_90.783784	59	136	2	61	77	0.7922078
NODE_306368_length_135_cov_2144.166667	0	73	0	7	73	0.0958904
NODE_306368_length_135_cov_2144.166667	0	73	2	5	73	0.0684932
NODE_306368_length_135_cov_2144.166667	0	73	4	14	73	0.1917808
NODE_306368_length_135_cov_2144.166667	0	73	6	3	73	0.0410959
NODE_306368_length_135_cov_2144.166667	0	73	8	44	73	0.6027398
NODE_306368_length_135_cov_2144.166667	46	126	0	14	80	0.1750000
NODE_306368_length_135_cov_2144.166667	46	126	4	1	80	0.0125000
NODE_306368_length_135_cov_2144.166667	46	126	6	8	80	0.1000000
NODE_306368_length_135_cov_2144.166667	46	126	8	57	80	0.7125000
NODE_306368_length_135_cov_2144.166667	83	135	0	23	52	0.4423077
NODE_306368_length_135_cov_2144.166667	83	135	4	1	52	0.0192308
NODE_306368_length_135_cov_2144.166667	83	135	6	8	52	0.1538462
NODE_306368_length_135_cov_2144.166667	83	135	8	20	52	0.3846154
NODE_306370_length_135_cov_630.194444	0	76	2	21	76	0.2763158
NODE_306370_length_135_cov_630.194444	0	76	4	5	76	0.0657895
NODE_306370_length_135_cov_630.194444	0	76	6	50	76	0.6578947
NODE_306371_length_135_cov_540.611111	0	76	0	13	76	0.1710526
NODE_306371_length_135_cov_540.611111	0	76	4	12	76	0.1578947
NODE_306371_length_135_cov_540.611111	0	76	6	51	76	0.6710526
NODE_306373_length_135_cov_257.416667	36	88	2	52	52	1.0000000
NODE_306374_length_135_cov_239.638889	97	135	0	9	38	0.2368421
NODE_306374_length_135_cov_239.638889	97	135	2	7	38	0.1842105
NODE_306374_length_135_cov_239.638889	97	135	6	22	38	0.5789474
NODE_306400_length_135_cov_35.055556	8	88	0	80	80	1.0000000
NODE_306400_length_135_cov_35.055556	61	125	0	64	64	1.0000000
NODE_306400_length_135_cov_35.055556	61	125	0	64	64	1.0000000
NODE_306402_length_135_cov_31.805556	0	76	0	76	76	1.0000000
NODE_306658_length_133_cov_140.411765	8	43	1	35	35	1.0000000
NODE_306658_length_133_cov_140.411765	53	88	1	35	35	1.0000000
NODE_306658_length_133_cov_140.411765	98	133	1	35	35	1.0000000
NODE_306661_length_133_cov_109.441176	63	129	2	4	66	0.0606061
NODE_306661_length_133_cov_109.441176	63	129	4	62	66	0.9393939
NODE_306812_length_132_cov_114.151515	2	44	0	42	42	1.0000000
NODE_306812_length_132_cov_114.151515	4	44	0	40	40	1.0000000
NODE_306812_length_132_cov_114.151515	17	83	0	66	66	1.0000000
NODE_306812_length_132_cov_114.151515	17	88	0	71	71	1.0000000
NODE_306824_length_132_cov_61.636364	3	76	0	4	73	0.0547945
NODE_306824_length_132_cov_61.636364	3	76	2	69	73	0.9452055
NODE_306824_length_132_cov_61.636364	49	130	0	18	81	0.2222222
NODE_306824_length_132_cov_61.636364	49	130	2	63	81	0.7777778
NODE_306824_length_132_cov_61.636364	103	125	0	13	22	0.5909091
NODE_306824_length_132_cov_61.636364	103	125	2	9	22	0.4090909
NODE_306834_length_132_cov_33.393939	2	83	0	81	81	1.0000000
NODE_306834_length_132_cov_33.393939	7	29	0	22	22	1.0000000
NODE_306834_length_132_cov_33.393939	56	129	0	73	73	1.0000000
NODE_306965_length_131_cov_810.000000	0	60	0	14	60	0.2333333
NODE_306965_length_131_cov_810.000000	0	60	2	11	60	0.1833333
NODE_306965_length_131_cov_810.000000	0	60	4	35	60	0.5833333
NODE_306965_length_131_cov_810.000000	33	97	4	64	64	1.0000000
NODE_306965_length_131_cov_810.000000	33	97	4	64	64	1.0000000
NODE_306965_length_131_cov_810.000000	33	97	4	64	64	1.0000000
NODE_306985_length_131_cov_149.187500	25	105	2	3	80	0.0375000
NODE_306985_length_131_cov_149.187500	25	105	4	77	80	0.9625000
NODE_306985_length_131_cov_149.187500	78	131	0	6	53	0.1132075
NODE_306985_length_131_cov_149.187500	78	131	2	4	53	0.0754717
NODE_306985_length_131_cov_149.187500	78	131	4	43	53	0.8113208
NODE_307121_length_130_cov_319.806452	54	126	6	72	72	1.0000000
NODE_307132_length_130_cov_153.516129	82	113	0	31	31	1.0000000
NODE_307140_length_130_cov_79.064516	0	53	0	20	53	0.3773585
NODE_307140_length_130_cov_79.064516	0	53	2	33	53	0.6226415
NODE_307140_length_130_cov_79.064516	26	56	2	30	30	1.0000000
NODE_307270_length_129_cov_1851.133333	0	45	0	13	45	0.2888889
NODE_307270_length_129_cov_1851.133333	0	45	1	2	45	0.0444444
NODE_307270_length_129_cov_1851.133333	0	45	2	30	45	0.6666667
NODE_307270_length_129_cov_1851.133333	18	98	2	80	80	1.0000000
NODE_307285_length_129_cov_186.500000	0	78	0	78	78	1.0000000
NODE_307285_length_129_cov_186.500000	53	129	0	76	76	1.0000000
NODE_307287_length_129_cov_165.466667	36	111	4	2	75	0.0266667
NODE_307287_length_129_cov_165.466667	36	111	6	73	75	0.9733334
NODE_307287_length_129_cov_165.466667	84	113	4	4	29	0.1379310
NODE_307287_length_129_cov_165.466667	84	113	6	25	29	0.8620690
NODE_307292_length_129_cov_90.366667	0	48	0	48	48	1.0000000
NODE_307292_length_129_cov_90.366667	0	48	0	48	48	1.0000000
NODE_307292_length_129_cov_90.366667	0	48	0	48	48	1.0000000
NODE_307292_length_129_cov_90.366667	21	101	0	80	80	1.0000000
NODE_307442_length_128_cov_2621.517241	3	83	2	1	80	0.0125000
NODE_307442_length_128_cov_2621.517241	3	83	4	2	80	0.0250000
NODE_307442_length_128_cov_2621.517241	3	83	6	1	80	0.0125000
NODE_307442_length_128_cov_2621.517241	3	83	8	76	80	0.9500000
NODE_307442_length_128_cov_2621.517241	8	30	8	22	22	1.0000000
NODE_307442_length_128_cov_2621.517241	56	128	2	14	72	0.1944444
NODE_307442_length_128_cov_2621.517241	56	128	4	6	72	0.0833333
NODE_307442_length_128_cov_2621.517241	56	128	6	1	72	0.0138889
NODE_307442_length_128_cov_2621.517241	56	128	8	51	72	0.7083333
NODE_307443_length_128_cov_1604.275862	58	127	2	69	69	1.0000000
NODE_307458_length_128_cov_79.034483	43	123	0	1	80	0.0125000
NODE_307458_length_128_cov_79.034483	43	123	2	79	80	0.9875000
NODE_307464_length_128_cov_61.793103	5	85	0	80	80	1.0000000
NODE_307549_length_127_cov_1879.785714	21	101	8	2	80	0.0250000
NODE_307549_length_127_cov_1879.785714	21	101	10	78	80	0.9750000
NODE_307549_length_127_cov_1879.785714	74	127	4	13	53	0.2452830
NODE_307549_length_127_cov_1879.785714	74	127	6	1	53	0.0188679
NODE_307549_length_127_cov_1879.785714	74	127	8	6	53	0.1132075
NODE_307549_length_127_cov_1879.785714	74	127	10	33	53	0.6226415
NODE_307583_length_127_cov_66.142857	38	118	0	80	80	1.0000000
NODE_307583_length_127_cov_66.142857	47	118	0	71	71	1.0000000
NODE_307590_length_127_cov_38.285714	12	86	0	74	74	1.0000000
NODE_307596_length_127_cov_30.607143	21	93	0	72	72	1.0000000
NODE_307662_length_126_cov_936.777778	24	96	0	72	72	1.0000000
NODE_307675_length_126_cov_147.185185	2	66	0	64	64	1.0000000
NODE_307675_length_126_cov_147.185185	2	66	0	64	64	1.0000000
NODE_307675_length_126_cov_147.185185	2	66	0	64	64	1.0000000
NODE_307675_length_126_cov_147.185185	39	99	0	60	60	1.0000000
NODE_307675_length_126_cov_147.185185	55	99	0	44	44	1.0000000
NODE_307684_length_126_cov_82.518519	44	75	2	31	31	1.0000000
NODE_307793_length_125_cov_656.807692	19	99	8	80	80	1.0000000
NODE_307806_length_125_cov_143.615385	52	125	0	73	73	1.0000000
NODE_307810_length_125_cov_131.923077	3	52	0	49	49	1.0000000
NODE_307810_length_125_cov_131.923077	25	89	0	64	64	1.0000000
NODE_307810_length_125_cov_131.923077	25	89	0	64	64	1.0000000
NODE_307816_length_125_cov_102.500000	0	56	0	8	56	0.1428571
NODE_307816_length_125_cov_102.500000	0	56	2	48	56	0.8571429
NODE_307816_length_125_cov_102.500000	7	56	0	1	49	0.0204082
NODE_307816_length_125_cov_102.500000	7	56	2	48	49	0.9795918
NODE_307816_length_125_cov_102.500000	29	114	0	4	85	0.0470588
NODE_307816_length_125_cov_102.500000	29	114	2	81	85	0.9529412
NODE_307816_length_125_cov_102.500000	29	114	0	4	85	0.0470588
NODE_307816_length_125_cov_102.500000	29	114	2	81	85	0.9529412
NODE_307816_length_125_cov_102.500000	29	114	0	4	85	0.0470588
NODE_307816_length_125_cov_102.500000	29	114	2	81	85	0.9529412
NODE_307839_length_125_cov_28.115385	17	90	2	1	73	0.0136986
NODE_307839_length_125_cov_28.115385	17	90	4	5	73	0.0684932
NODE_307839_length_125_cov_28.115385	17	90	6	67	73	0.9178082
NODE_307839_length_125_cov_28.115385	57	98	6	41	41	1.0000000
NODE_307906_length_124_cov_945.680000	0	73	0	73	73	1.0000000
NODE_307906_length_124_cov_945.680000	53	124	0	71	71	1.0000000
NODE_308023_length_123_cov_1186.083333	0	76	0	4	76	0.0526316
NODE_308023_length_123_cov_1186.083333	0	76	2	12	76	0.1578947
NODE_308023_length_123_cov_1186.083333	0	76	4	60	76	0.7894737
NODE_308023_length_123_cov_1186.083333	0	76	0	4	76	0.0526316
NODE_308023_length_123_cov_1186.083333	0	76	2	12	76	0.1578947
NODE_308023_length_123_cov_1186.083333	0	76	4	60	76	0.7894737
NODE_308023_length_123_cov_1186.083333	0	76	0	4	76	0.0526316
NODE_308023_length_123_cov_1186.083333	0	76	2	12	76	0.1578947
NODE_308023_length_123_cov_1186.083333	0	76	4	60	76	0.7894737
NODE_308023_length_123_cov_1186.083333	0	76	0	4	76	0.0526316
NODE_308023_length_123_cov_1186.083333	0	76	2	12	76	0.1578947
NODE_308023_length_123_cov_1186.083333	0	76	4	60	76	0.7894737
NODE_308023_length_123_cov_1186.083333	49	123	2	1	74	0.0135135
NODE_308023_length_123_cov_1186.083333	49	123	3	1	74	0.0135135
NODE_308023_length_123_cov_1186.083333	49	123	4	72	74	0.9729730
NODE_308023_length_123_cov_1186.083333	49	123	2	1	74	0.0135135
NODE_308023_length_123_cov_1186.083333	49	123	3	1	74	0.0135135
NODE_308023_length_123_cov_1186.083333	49	123	4	72	74	0.9729730
NODE_308023_length_123_cov_1186.083333	49	123	2	1	74	0.0135135
NODE_308023_length_123_cov_1186.083333	49	123	3	1	74	0.0135135
NODE_308023_length_123_cov_1186.083333	49	123	4	72	74	0.9729730
NODE_308024_length_123_cov_963.500000	19	88	0	69	69	1.0000000
NODE_308037_length_123_cov_181.291667	0	47	2	47	47	1.0000000
NODE_308037_length_123_cov_181.291667	24	100	2	76	76	1.0000000
NODE_308057_length_123_cov_55.375000	52	123	0	2	71	0.0281690
NODE_308057_length_123_cov_55.375000	52	123	2	69	71	0.9718310
NODE_308057_length_123_cov_55.375000	52	123	0	2	71	0.0281690
NODE_308057_length_123_cov_55.375000	52	123	2	69	71	0.9718310
NODE_308057_length_123_cov_55.375000	61	123	0	2	62	0.0322581
NODE_308057_length_123_cov_55.375000	61	123	2	60	62	0.9677419
NODE_308068_length_123_cov_40.958333	9	89	0	80	80	1.0000000
NODE_308068_length_123_cov_40.958333	9	89	0	80	80	1.0000000
NODE_308068_length_123_cov_40.958333	9	89	0	80	80	1.0000000
NODE_308068_length_123_cov_40.958333	9	89	0	80	80	1.0000000
NODE_308068_length_123_cov_40.958333	9	89	0	80	80	1.0000000
NODE_308068_length_123_cov_40.958333	9	80	0	71	71	1.0000000
NODE_308180_length_122_cov_111.043478	8	88	2	80	80	1.0000000
NODE_308180_length_122_cov_111.043478	8	88	2	80	80	1.0000000
NODE_308184_length_122_cov_67.565217	0	50	0	50	50	1.0000000
NODE_308184_length_122_cov_67.565217	0	50	0	50	50	1.0000000
NODE_308184_length_122_cov_67.565217	23	103	0	80	80	1.0000000
NODE_308184_length_122_cov_67.565217	23	103	0	80	80	1.0000000
NODE_308184_length_122_cov_67.565217	23	103	0	80	80	1.0000000
NODE_308184_length_122_cov_67.565217	23	103	0	80	80	1.0000000
NODE_308184_length_122_cov_67.565217	23	103	0	80	80	1.0000000
NODE_308184_length_122_cov_67.565217	23	94	0	71	71	1.0000000
NODE_308188_length_122_cov_58.826087	28	99	0	71	71	1.0000000
NODE_308188_length_122_cov_58.826087	33	99	0	66	66	1.0000000
NODE_308188_length_122_cov_58.826087	72	122	0	50	50	1.0000000
NODE_308188_length_122_cov_58.826087	72	122	0	50	50	1.0000000
NODE_308198_length_122_cov_38.173913	12	93	0	81	81	1.0000000
NODE_308257_length_121_cov_159.318182	24	55	0	31	31	1.0000000
NODE_308260_length_121_cov_120.181818	20	100	0	80	80	1.0000000
NODE_308260_length_121_cov_120.181818	20	95	0	75	75	1.0000000
NODE_308260_length_121_cov_120.181818	20	100	0	80	80	1.0000000
NODE_308260_length_121_cov_120.181818	29	100	0	71	71	1.0000000
NODE_308273_length_121_cov_54.181818	7	70	0	63	63	1.0000000
NODE_308273_length_121_cov_54.181818	7	70	0	63	63	1.0000000
NODE_308273_length_121_cov_54.181818	7	70	0	63	63	1.0000000
NODE_308273_length_121_cov_54.181818	9	70	0	61	61	1.0000000
NODE_308273_length_121_cov_54.181818	43	109	0	66	66	1.0000000
NODE_308273_length_121_cov_54.181818	43	121	0	78	78	1.0000000
NODE_308273_length_121_cov_54.181818	64	117	0	53	53	1.0000000
NODE_308317_length_120_cov_1404.619048	0	64	0	2	64	0.0312500
NODE_308317_length_120_cov_1404.619048	0	64	2	5	64	0.0781250
NODE_308317_length_120_cov_1404.619048	0	64	4	57	64	0.8906250
NODE_308317_length_120_cov_1404.619048	45	117	0	8	72	0.1111111
NODE_308317_length_120_cov_1404.619048	45	117	2	3	72	0.0416667
NODE_308317_length_120_cov_1404.619048	45	117	4	61	72	0.8472222
NODE_308318_length_120_cov_1138.428571	19	99	2	80	80	1.0000000
NODE_308318_length_120_cov_1138.428571	72	120	0	9	48	0.1875000
NODE_308318_length_120_cov_1138.428571	72	120	2	39	48	0.8125000
NODE_308357_length_120_cov_54.666667	0	69	0	69	69	1.0000000
NODE_308357_length_120_cov_54.666667	0	69	0	69	69	1.0000000
NODE_308357_length_120_cov_54.666667	0	69	0	69	69	1.0000000
NODE_308357_length_120_cov_54.666667	42	108	0	66	66	1.0000000
NODE_308357_length_120_cov_54.666667	53	120	0	67	67	1.0000000
NODE_308357_length_120_cov_54.666667	53	120	0	67	67	1.0000000
NODE_308487_length_118_cov_1211.578947	49	116	0	67	67	1.0000000
NODE_308488_length_118_cov_1157.157895	4	70	0	66	66	1.0000000
NODE_308500_length_118_cov_218.210526	0	63	0	63	63	1.0000000
NODE_308500_length_118_cov_218.210526	35	115	0	80	80	1.0000000
NODE_308504_length_118_cov_161.052632	4	70	0	66	66	1.0000000
NODE_308572_length_117_cov_338.555556	7	70	2	63	63	1.0000000
NODE_308572_length_117_cov_338.555556	7	70	2	63	63	1.0000000
NODE_308572_length_117_cov_338.555556	7	70	2	63	63	1.0000000
NODE_308572_length_117_cov_338.555556	9	70	2	61	61	1.0000000
NODE_308572_length_117_cov_338.555556	43	109	0	8	66	0.1212121
NODE_308572_length_117_cov_338.555556	43	109	2	58	66	0.8787879
NODE_308572_length_117_cov_338.555556	43	114	0	13	71	0.1830986
NODE_308572_length_117_cov_338.555556	43	114	2	58	71	0.8169014
NODE_308572_length_117_cov_338.555556	64	117	0	16	53	0.3018868
NODE_308572_length_117_cov_338.555556	64	117	2	37	53	0.6981132
NODE_308654_length_116_cov_1897.470588	0	77	0	7	77	0.0909091
NODE_308654_length_116_cov_1897.470588	0	77	2	70	77	0.9090909
NODE_308654_length_116_cov_1897.470588	34	111	2	77	77	1.0000000
NODE_308668_length_116_cov_438.529412	15	95	0	80	80	1.0000000
NODE_308668_length_116_cov_438.529412	68	116	0	48	48	1.0000000
NODE_308701_length_116_cov_93.235294	52	116	0	64	64	1.0000000
NODE_308722_length_116_cov_46.882353	6	66	2	4	60	0.0666667
NODE_308722_length_116_cov_46.882353	6	66	4	3	60	0.0500000
NODE_308722_length_116_cov_46.882353	6	66	6	53	60	0.8833333
NODE_308727_length_116_cov_38.352941	20	100	0	80	80	1.0000000
NODE_308746_length_115_cov_1012.625000	31	114	0	83	83	1.0000000
NODE_308750_length_115_cov_776.625000	9	92	0	83	83	1.0000000
NODE_308752_length_115_cov_623.937500	0	74	0	74	74	1.0000000
NODE_308782_length_115_cov_144.812500	4	73	0	69	69	1.0000000
NODE_308806_length_115_cov_65.187500	16	76	0	60	60	1.0000000
NODE_308846_length_114_cov_819.466667	40	114	0	9	74	0.1216216
NODE_308846_length_114_cov_819.466667	40	114	2	65	74	0.8783784
NODE_308846_length_114_cov_819.466667	40	114	0	9	74	0.1216216
NODE_308846_length_114_cov_819.466667	40	114	2	65	74	0.8783784
NODE_308846_length_114_cov_819.466667	49	114	0	9	65	0.1384615
NODE_308846_length_114_cov_819.466667	49	114	2	56	65	0.8615385
NODE_308866_length_114_cov_285.666667	0	78	0	78	78	1.0000000
NODE_308866_length_114_cov_285.666667	51	114	0	63	63	1.0000000
NODE_308886_length_114_cov_83.600000	51	82	0	31	31	1.0000000
NODE_308891_length_114_cov_67.666667	40	90	0	50	50	1.0000000
NODE_308939_length_113_cov_446.214286	5	82	0	77	77	1.0000000
NODE_308939_length_113_cov_446.214286	5	82	0	77	77	1.0000000
NODE_308967_length_113_cov_160.071429	0	64	0	64	64	1.0000000
NODE_308967_length_113_cov_160.071429	0	64	0	64	64	1.0000000
NODE_308967_length_113_cov_160.071429	37	103	0	66	66	1.0000000
NODE_308967_length_113_cov_160.071429	37	108	0	71	71	1.0000000
NODE_309037_length_112_cov_963.384615	43	112	0	69	69	1.0000000
NODE_309044_length_112_cov_653.615385	7	78	0	71	71	1.0000000
NODE_309044_length_112_cov_653.615385	12	78	0	66	66	1.0000000
NODE_309044_length_112_cov_653.615385	51	112	0	61	61	1.0000000
NODE_309044_length_112_cov_653.615385	51	112	0	61	61	1.0000000
NODE_309067_length_112_cov_219.538462	0	62	0	62	62	1.0000000
NODE_309067_length_112_cov_219.538462	0	57	0	57	57	1.0000000
NODE_309067_length_112_cov_219.538462	0	62	0	62	62	1.0000000
NODE_309067_length_112_cov_219.538462	0	59	0	59	59	1.0000000
NODE_309067_length_112_cov_219.538462	35	112	0	77	77	1.0000000
NODE_309067_length_112_cov_219.538462	35	112	0	77	77	1.0000000
NODE_309067_length_112_cov_219.538462	35	112	0	77	77	1.0000000
NODE_309078_length_112_cov_160.307692	0	69	0	69	69	1.0000000
NODE_309079_length_112_cov_134.846154	11	91	0	80	80	1.0000000
NODE_309079_length_112_cov_134.846154	11	91	0	80	80	1.0000000
NODE_309079_length_112_cov_134.846154	64	112	0	48	48	1.0000000
NODE_309079_length_112_cov_134.846154	64	112	0	48	48	1.0000000
NODE_309079_length_112_cov_134.846154	64	112	0	48	48	1.0000000
NODE_309092_length_112_cov_84.384615	10	90	0	80	80	1.0000000
NODE_309097_length_112_cov_72.769231	36	100	0	64	64	1.0000000
NODE_309106_length_112_cov_35.307692	13	76	0	63	63	1.0000000
NODE_309123_length_111_cov_1107.833333	0	52	0	52	52	1.0000000
NODE_309123_length_111_cov_1107.833333	0	52	0	52	52	1.0000000
NODE_309123_length_111_cov_1107.833333	0	52	0	52	52	1.0000000
NODE_309123_length_111_cov_1107.833333	0	52	0	52	52	1.0000000
NODE_309123_length_111_cov_1107.833333	25	105	0	80	80	1.0000000
NODE_309123_length_111_cov_1107.833333	25	105	0	80	80	1.0000000
NODE_309123_length_111_cov_1107.833333	25	105	0	80	80	1.0000000
NODE_309123_length_111_cov_1107.833333	25	105	0	80	80	1.0000000
NODE_309123_length_111_cov_1107.833333	25	105	0	80	80	1.0000000
NODE_309123_length_111_cov_1107.833333	25	105	0	80	80	1.0000000
NODE_309126_length_111_cov_827.500000	3	74	0	71	71	1.0000000
NODE_309126_length_111_cov_827.500000	8	74	0	66	66	1.0000000
NODE_309126_length_111_cov_827.500000	47	111	0	64	64	1.0000000
NODE_309126_length_111_cov_827.500000	47	111	0	64	64	1.0000000
NODE_309126_length_111_cov_827.500000	47	111	0	64	64	1.0000000
NODE_309129_length_111_cov_726.833333	12	89	0	77	77	1.0000000
NODE_309129_length_111_cov_726.833333	12	89	0	77	77	1.0000000
NODE_309129_length_111_cov_726.833333	62	111	0	49	49	1.0000000
NODE_309129_length_111_cov_726.833333	67	111	0	44	44	1.0000000
NODE_309131_length_111_cov_692.416667	31	111	2	80	80	1.0000000
NODE_309149_length_111_cov_241.750000	30	97	0	67	67	1.0000000
NODE_309160_length_111_cov_169.416667	21	102	0	81	81	1.0000000
NODE_309200_length_110_cov_554.909091	1	28	0	27	27	1.0000000
NODE_309200_length_110_cov_554.909091	1	81	0	80	80	1.0000000
NODE_309202_length_110_cov_537.545455	0	75	0	75	75	1.0000000
NODE_309202_length_110_cov_537.545455	53	107	0	54	54	1.0000000
NODE_309235_length_110_cov_91.636364	19	54	0	35	35	1.0000000
NODE_309235_length_110_cov_91.636364	64	107	0	43	43	1.0000000
NODE_309239_length_110_cov_80.272727	19	54	0	35	35	1.0000000
NODE_309239_length_110_cov_80.272727	64	99	0	35	35	1.0000000
NODE_309241_length_110_cov_78.363636	19	54	0	35	35	1.0000000
NODE_309241_length_110_cov_78.363636	64	107	0	43	43	1.0000000
NODE_309245_length_110_cov_68.727273	11	46	0	35	35	1.0000000
NODE_309245_length_110_cov_68.727273	56	91	0	35	35	1.0000000
NODE_309252_length_110_cov_44.545455	5	57	0	52	52	1.0000000
NODE_309263_length_109_cov_1364.100000	29	98	0	69	69	1.0000000
NODE_309275_length_109_cov_689.800000	12	86	0	74	74	1.0000000
NODE_309309_length_109_cov_250.800000	4	66	0	62	62	1.0000000
NODE_309311_length_109_cov_242.000000	29	98	0	69	69	1.0000000
NODE_309326_length_109_cov_139.000000	26	106	0	80	80	1.0000000
NODE_309345_length_109_cov_84.500000	33	93	0	60	60	1.0000000
NODE_309349_length_109_cov_75.300000	0	65	0	4	65	0.0615385
NODE_309349_length_109_cov_75.300000	0	65	2	61	65	0.9384615
NODE_309384_length_108_cov_1542.666667	28	108	0	80	80	1.0000000
NODE_309391_length_108_cov_987.666667	5	85	0	80	80	1.0000000
NODE_309391_length_108_cov_987.666667	5	85	0	80	80	1.0000000
NODE_309391_length_108_cov_987.666667	5	85	0	80	80	1.0000000
NODE_309391_length_108_cov_987.666667	5	85	0	80	80	1.0000000
NODE_309391_length_108_cov_987.666667	5	85	0	80	80	1.0000000
NODE_309391_length_108_cov_987.666667	58	108	0	50	50	1.0000000
NODE_309391_length_108_cov_987.666667	58	108	0	50	50	1.0000000
NODE_309395_length_108_cov_841.666667	1	65	0	64	64	1.0000000
NODE_309395_length_108_cov_841.666667	1	65	0	64	64	1.0000000
NODE_309395_length_108_cov_841.666667	1	65	0	64	64	1.0000000
NODE_309433_length_108_cov_213.333333	22	81	2	59	59	1.0000000
NODE_309433_length_108_cov_213.333333	55	81	2	26	26	1.0000000
NODE_309464_length_108_cov_107.888889	11	82	2	71	71	1.0000000
NODE_309464_length_108_cov_107.888889	16	82	2	66	66	1.0000000
NODE_309464_length_108_cov_107.888889	55	108	0	4	53	0.0754717
NODE_309464_length_108_cov_107.888889	55	108	2	49	53	0.9245283
NODE_309464_length_108_cov_107.888889	55	108	0	4	53	0.0754717
NODE_309464_length_108_cov_107.888889	55	108	2	49	53	0.9245283
NODE_309464_length_108_cov_107.888889	55	108	0	4	53	0.0754717
NODE_309464_length_108_cov_107.888889	55	108	2	49	53	0.9245283
NODE_309472_length_108_cov_76.444444	13	76	0	63	63	1.0000000
NODE_309479_length_108_cov_51.000000	0	53	0	53	53	1.0000000
NODE_309479_length_108_cov_51.000000	0	53	0	53	53	1.0000000
NODE_309479_length_108_cov_51.000000	0	53	0	53	53	1.0000000
NODE_309479_length_108_cov_51.000000	26	106	0	80	80	1.0000000
NODE_309479_length_108_cov_51.000000	26	106	0	80	80	1.0000000
NODE_309479_length_108_cov_51.000000	26	106	0	80	80	1.0000000
NODE_309479_length_108_cov_51.000000	26	106	0	80	80	1.0000000
NODE_309479_length_108_cov_51.000000	26	106	0	80	80	1.0000000
NODE_309479_length_108_cov_51.000000	26	97	0	71	71	1.0000000
NODE_309490_length_108_cov_31.111111	11	82	0	71	71	1.0000000
NODE_309490_length_108_cov_31.111111	16	82	0	66	66	1.0000000
NODE_309490_length_108_cov_31.111111	55	108	0	53	53	1.0000000
NODE_309490_length_108_cov_31.111111	55	108	0	53	53	1.0000000
NODE_309490_length_108_cov_31.111111	55	108	0	53	53	1.0000000
NODE_309530_length_107_cov_608.250000	0	64	0	64	64	1.0000000
NODE_309530_length_107_cov_608.250000	53	103	0	50	50	1.0000000
NODE_309551_length_107_cov_303.250000	0	56	0	56	56	1.0000000
NODE_309551_length_107_cov_303.250000	29	99	0	70	70	1.0000000
NODE_309657_length_106_cov_522.571429	10	90	0	80	80	1.0000000
NODE_309657_length_106_cov_522.571429	10	90	0	80	80	1.0000000
NODE_309657_length_106_cov_522.571429	10	90	0	80	80	1.0000000
NODE_309657_length_106_cov_522.571429	10	90	0	80	80	1.0000000
NODE_309657_length_106_cov_522.571429	10	90	0	80	80	1.0000000
NODE_309657_length_106_cov_522.571429	19	90	0	71	71	1.0000000
NODE_309696_length_106_cov_161.857143	7	78	0	71	71	1.0000000
NODE_309696_length_106_cov_161.857143	51	106	0	55	55	1.0000000
NODE_309707_length_106_cov_130.714286	0	76	0	76	76	1.0000000
NODE_309714_length_106_cov_108.000000	0	76	0	76	76	1.0000000
NODE_309717_length_106_cov_102.142857	0	62	0	62	62	1.0000000
NODE_309717_length_106_cov_102.142857	35	106	0	71	71	1.0000000
NODE_309717_length_106_cov_102.142857	35	106	0	71	71	1.0000000
NODE_309747_length_106_cov_39.428571	0	76	0	76	76	1.0000000
NODE_309761_length_106_cov_30.857143	0	70	0	70	70	1.0000000
NODE_309761_length_106_cov_30.857143	0	70	0	70	70	1.0000000
NODE_309761_length_106_cov_30.857143	0	70	0	70	70	1.0000000
NODE_309761_length_106_cov_30.857143	43	92	0	49	49	1.0000000
NODE_309761_length_106_cov_30.857143	53	106	0	53	53	1.0000000
NODE_309761_length_106_cov_30.857143	53	106	0	53	53	1.0000000
NODE_309775_length_105_cov_2054.666667	31	105	0	74	74	1.0000000
NODE_309775_length_105_cov_2054.666667	31	105	0	74	74	1.0000000
NODE_309775_length_105_cov_2054.666667	31	105	0	74	74	1.0000000
NODE_309775_length_105_cov_2054.666667	31	105	0	74	74	1.0000000
NODE_309788_length_105_cov_830.833333	30	105	0	75	75	1.0000000
NODE_309789_length_105_cov_825.500000	0	77	0	77	77	1.0000000
NODE_309789_length_105_cov_825.500000	0	77	0	77	77	1.0000000
NODE_309789_length_105_cov_825.500000	50	99	0	49	49	1.0000000
NODE_309789_length_105_cov_825.500000	55	105	0	50	50	1.0000000
NODE_309815_length_105_cov_231.333333	0	54	0	54	54	1.0000000
NODE_309815_length_105_cov_231.333333	27	99	0	72	72	1.0000000
NODE_309842_length_105_cov_85.333333	14	94	0	80	80	1.0000000
NODE_309842_length_105_cov_85.333333	67	89	0	22	22	1.0000000
NODE_309855_length_105_cov_61.833333	23	103	0	80	80	1.0000000
NODE_309867_length_105_cov_40.666667	6	66	0	60	60	1.0000000
NODE_309925_length_104_cov_1016.000000	0	78	0	78	78	1.0000000
NODE_309925_length_104_cov_1016.000000	53	99	0	46	46	1.0000000
NODE_309935_length_104_cov_791.200000	0	67	0	67	67	1.0000000
NODE_309935_length_104_cov_791.200000	0	67	0	67	67	1.0000000
NODE_309935_length_104_cov_791.200000	40	104	0	64	64	1.0000000
NODE_309938_length_104_cov_574.200000	21	101	0	80	80	1.0000000
NODE_309938_length_104_cov_574.200000	21	101	0	80	80	1.0000000
NODE_309938_length_104_cov_574.200000	21	101	0	80	80	1.0000000
NODE_309938_length_104_cov_574.200000	21	101	0	80	80	1.0000000
NODE_309938_length_104_cov_574.200000	21	101	0	80	80	1.0000000
NODE_309938_length_104_cov_574.200000	21	92	0	71	71	1.0000000
NODE_309940_length_104_cov_547.400000	10	87	0	77	77	1.0000000
NODE_309940_length_104_cov_547.400000	10	87	0	77	77	1.0000000
NODE_310020_length_104_cov_46.800000	42	104	0	62	62	1.0000000
NODE_310054_length_103_cov_2267.000000	0	54	0	54	54	1.0000000
NODE_310054_length_103_cov_2267.000000	27	100	0	73	73	1.0000000
NODE_310082_length_103_cov_890.000000	6	70	0	64	64	1.0000000
NODE_310082_length_103_cov_890.000000	6	70	0	64	64	1.0000000
NODE_310082_length_103_cov_890.000000	6	70	0	64	64	1.0000000
NODE_310082_length_103_cov_890.000000	43	103	0	60	60	1.0000000
NODE_310082_length_103_cov_890.000000	59	103	0	44	44	1.0000000
NODE_310090_length_103_cov_768.500000	7	78	0	71	71	1.0000000
NODE_310090_length_103_cov_768.500000	12	78	0	66	66	1.0000000
NODE_310090_length_103_cov_768.500000	51	99	0	48	48	1.0000000
NODE_310090_length_103_cov_768.500000	51	99	0	48	48	1.0000000
NODE_310090_length_103_cov_768.500000	51	99	0	48	48	1.0000000
NODE_310091_length_103_cov_751.000000	0	71	0	71	71	1.0000000
NODE_310091_length_103_cov_751.000000	0	71	0	71	71	1.0000000
NODE_310091_length_103_cov_751.000000	44	93	0	49	49	1.0000000
NODE_310094_length_103_cov_678.000000	10	74	0	64	64	1.0000000
NODE_310094_length_103_cov_678.000000	10	74	0	64	64	1.0000000
NODE_310094_length_103_cov_678.000000	10	74	0	64	64	1.0000000
NODE_310094_length_103_cov_678.000000	47	96	0	49	49	1.0000000
NODE_310103_length_103_cov_462.750000	19	99	0	80	80	1.0000000
NODE_310116_length_103_cov_300.250000	0	63	0	63	63	1.0000000
NODE_310147_length_103_cov_103.250000	4	47	0	43	43	1.0000000
NODE_310152_length_103_cov_80.250000	36	99	0	63	63	1.0000000
NODE_310153_length_103_cov_76.500000	4	63	0	59	59	1.0000000
NODE_310160_length_103_cov_42.000000	0	78	0	78	78	1.0000000
NODE_310160_length_103_cov_42.000000	7	78	0	71	71	1.0000000
NODE_310160_length_103_cov_42.000000	12	78	0	66	66	1.0000000
NODE_310160_length_103_cov_42.000000	51	99	0	48	48	1.0000000
NODE_310160_length_103_cov_42.000000	51	99	0	48	48	1.0000000
NODE_310160_length_103_cov_42.000000	51	99	0	48	48	1.0000000
NODE_310211_length_102_cov_2033.666667	0	48	0	48	48	1.0000000
NODE_310211_length_102_cov_2033.666667	21	101	0	80	80	1.0000000
NODE_310227_length_102_cov_1028.333333	52	102	0	50	50	1.0000000
NODE_310230_length_102_cov_987.666667	15	98	0	83	83	1.0000000
NODE_310231_length_102_cov_934.000000	12	95	0	83	83	1.0000000
NODE_310246_length_102_cov_685.666667	0	73	0	73	73	1.0000000
NODE_310247_length_102_cov_646.666667	15	89	0	74	74	1.0000000
NODE_310269_length_102_cov_250.000000	12	72	0	60	60	1.0000000
NODE_310273_length_102_cov_216.333333	4	70	0	66	66	1.0000000
NODE_310273_length_102_cov_216.333333	4	70	0	66	66	1.0000000
NODE_310273_length_102_cov_216.333333	4	70	0	66	66	1.0000000
NODE_310273_length_102_cov_216.333333	43	92	0	49	49	1.0000000
NODE_310273_length_102_cov_216.333333	57	102	0	45	45	1.0000000
NODE_310287_length_102_cov_152.333333	0	63	0	63	63	1.0000000
NODE_310295_length_102_cov_124.333333	0	70	0	70	70	1.0000000
NODE_310302_length_102_cov_106.333333	0	78	0	78	78	1.0000000
NODE_310302_length_102_cov_106.333333	7	78	0	71	71	1.0000000
NODE_310302_length_102_cov_106.333333	12	78	0	66	66	1.0000000
NODE_310302_length_102_cov_106.333333	51	102	0	51	51	1.0000000
NODE_310302_length_102_cov_106.333333	51	102	0	51	51	1.0000000
NODE_310302_length_102_cov_106.333333	51	102	0	51	51	1.0000000
NODE_310316_length_102_cov_74.333333	31	99	0	68	68	1.0000000
NODE_310321_length_102_cov_71.000000	11	91	0	80	80	1.0000000
NODE_310336_length_102_cov_32.666667	0	65	0	65	65	1.0000000
NODE_310336_length_102_cov_32.666667	38	99	0	61	61	1.0000000
NODE_310405_length_101_cov_2217.000000	0	43	0	43	43	1.0000000
NODE_310405_length_101_cov_2217.000000	23	96	0	73	73	1.0000000
NODE_310464_length_101_cov_740.500000	2	66	0	64	64	1.0000000
NODE_310464_length_101_cov_740.500000	2	66	0	64	64	1.0000000
NODE_310464_length_101_cov_740.500000	2	66	0	64	64	1.0000000
NODE_310464_length_101_cov_740.500000	39	101	0	62	62	1.0000000
NODE_310464_length_101_cov_740.500000	55	101	0	46	46	1.0000000
NODE_310469_length_101_cov_701.000000	0	62	0	62	62	1.0000000
NODE_310469_length_101_cov_701.000000	35	99	0	64	64	1.0000000
NODE_310469_length_101_cov_701.000000	35	99	0	64	64	1.0000000
NODE_310469_length_101_cov_701.000000	35	99	0	64	64	1.0000000
NODE_310471_length_101_cov_679.000000	2	76	0	74	74	1.0000000
NODE_310500_length_101_cov_374.500000	2	50	0	48	48	1.0000000
NODE_310500_length_101_cov_374.500000	2	50	0	48	48	1.0000000
NODE_310500_length_101_cov_374.500000	2	50	0	48	48	1.0000000
NODE_310500_length_101_cov_374.500000	23	89	0	66	66	1.0000000
NODE_310500_length_101_cov_374.500000	23	94	0	71	71	1.0000000
NODE_310516_length_101_cov_294.000000	4	52	0	48	48	1.0000000
NODE_310516_length_101_cov_294.000000	4	52	0	48	48	1.0000000
NODE_310516_length_101_cov_294.000000	4	52	0	48	48	1.0000000
NODE_310516_length_101_cov_294.000000	25	91	0	66	66	1.0000000
NODE_310516_length_101_cov_294.000000	25	96	0	71	71	1.0000000
NODE_310529_length_101_cov_230.500000	2	76	0	74	74	1.0000000
NODE_310529_length_101_cov_230.500000	2	76	0	74	74	1.0000000
NODE_310529_length_101_cov_230.500000	2	76	0	74	74	1.0000000
NODE_310529_length_101_cov_230.500000	49	101	0	52	52	1.0000000
NODE_310529_length_101_cov_230.500000	55	101	0	46	46	1.0000000
NODE_310550_length_101_cov_157.000000	13	72	0	59	59	1.0000000
NODE_310550_length_101_cov_157.000000	46	72	0	26	26	1.0000000
NODE_310565_length_101_cov_134.500000	2	37	0	35	35	1.0000000
NODE_310685_length_100_cov_1883.000000	32	100	0	68	68	1.0000000
NODE_310685_length_100_cov_1883.000000	32	100	0	68	68	1.0000000
NODE_310685_length_100_cov_1883.000000	32	99	0	67	67	1.0000000
NODE_310685_length_100_cov_1883.000000	32	100	0	68	68	1.0000000
NODE_310704_length_100_cov_1310.000000	0	42	0	42	42	1.0000000
NODE_310704_length_100_cov_1310.000000	1	42	0	41	41	1.0000000
NODE_310704_length_100_cov_1310.000000	38	100	0	62	62	1.0000000
NODE_310704_length_100_cov_1310.000000	38	95	0	57	57	1.0000000
NODE_310704_length_100_cov_1310.000000	38	100	0	62	62	1.0000000
NODE_310704_length_100_cov_1310.000000	38	100	0	62	62	1.0000000
NODE_310708_length_100_cov_1239.000000	1	48	0	47	47	1.0000000
NODE_310740_length_100_cov_694.000000	0	62	0	62	62	1.0000000
NODE_310740_length_100_cov_694.000000	0	62	0	62	62	1.0000000
NODE_310740_length_100_cov_694.000000	35	100	0	65	65	1.0000000
NODE_310748_length_100_cov_602.000000	0	57	0	57	57	1.0000000
NODE_310750_length_100_cov_590.000000	0	58	0	58	58	1.0000000
NODE_310798_length_100_cov_274.000000	1	67	0	66	66	1.0000000
NODE_310798_length_100_cov_274.000000	1	67	0	66	66	1.0000000
NODE_310798_length_100_cov_274.000000	1	67	0	66	66	1.0000000
NODE_310798_length_100_cov_274.000000	40	100	0	60	60	1.0000000
NODE_310798_length_100_cov_274.000000	54	100	0	46	46	1.0000000
NODE_310808_length_100_cov_217.000000	4	75	0	71	71	1.0000000
NODE_310808_length_100_cov_217.000000	9	75	0	66	66	1.0000000
NODE_310808_length_100_cov_217.000000	48	99	0	51	51	1.0000000
NODE_310808_length_100_cov_217.000000	48	99	0	51	51	1.0000000
NODE_310808_length_100_cov_217.000000	48	99	0	51	51	1.0000000
NODE_310810_length_100_cov_209.000000	1	44	0	43	43	1.0000000
NODE_310810_length_100_cov_209.000000	40	100	0	60	60	1.0000000
NODE_310810_length_100_cov_209.000000	40	100	0	60	60	1.0000000
NODE_310819_length_100_cov_185.000000	0	46	0	46	46	1.0000000
NODE_310819_length_100_cov_185.000000	9	58	0	49	49	1.0000000
NODE_310819_length_100_cov_185.000000	31	99	0	68	68	1.0000000
NODE_310819_length_100_cov_185.000000	31	99	0	68	68	1.0000000
NODE_310819_length_100_cov_185.000000	31	99	0	68	68	1.0000000
NODE_310828_length_100_cov_164.000000	9	92	0	83	83	1.0000000
NODE_310837_length_100_cov_152.000000	11	91	0	80	80	1.0000000
NODE_310837_length_100_cov_152.000000	11	91	0	80	80	1.0000000
NODE_310837_length_100_cov_152.000000	11	91	0	80	80	1.0000000
NODE_310837_length_100_cov_152.000000	11	91	0	80	80	1.0000000
NODE_310837_length_100_cov_152.000000	11	91	0	80	80	1.0000000
NODE_310839_length_100_cov_150.000000	0	54	0	54	54	1.0000000
NODE_310839_length_100_cov_150.000000	0	54	0	54	54	1.0000000
NODE_310839_length_100_cov_150.000000	27	100	0	73	73	1.0000000
NODE_310839_length_100_cov_150.000000	27	100	0	73	73	1.0000000
NODE_310840_length_100_cov_148.000000	2	82	0	80	80	1.0000000
NODE_310841_length_100_cov_148.000000	0	71	0	71	71	1.0000000
NODE_310841_length_100_cov_148.000000	0	71	0	71	71	1.0000000
NODE_310841_length_100_cov_148.000000	0	62	0	62	62	1.0000000
NODE_310876_length_100_cov_71.000000	0	75	0	75	75	1.0000000
NODE_310876_length_100_cov_71.000000	4	75	0	71	71	1.0000000
NODE_310876_length_100_cov_71.000000	9	75	0	66	66	1.0000000
NODE_310876_length_100_cov_71.000000	48	100	0	52	52	1.0000000
NODE_310876_length_100_cov_71.000000	48	100	0	52	52	1.0000000
NODE_310876_length_100_cov_71.000000	48	100	0	52	52	1.0000000
NODE_310896_length_100_cov_41.000000	0	75	0	75	75	1.0000000
NODE_310896_length_100_cov_41.000000	4	75	0	71	71	1.0000000
NODE_310896_length_100_cov_41.000000	9	75	0	66	66	1.0000000
NODE_310896_length_100_cov_41.000000	48	99	0	51	51	1.0000000
NODE_310896_length_100_cov_41.000000	48	99	0	51	51	1.0000000
NODE_310896_length_100_cov_41.000000	48	99	0	51	51	1.0000000
NODE_310904_length_100_cov_30.000000	1	42	0	41	41	1.0000000
