NODE_1_length_25698_cov_36.651041	315	395	0	80	80	1.0000000
NODE_1_length_25698_cov_36.651041	368	403	0	27	35	0.7714286
NODE_1_length_25698_cov_36.651041	368	403	1	4	35	0.1142857
NODE_1_length_25698_cov_36.651041	368	403	2	2	35	0.0571429
NODE_1_length_25698_cov_36.651041	368	403	6	1	35	0.0285714
NODE_1_length_25698_cov_36.651041	368	403	35	1	35	0.0285714
NODE_1_length_25698_cov_36.651041	24448	24494	0	46	46	1.0000000
NODE_2_length_24307_cov_15.119712	2613	2689	2	54	76	0.7105263
NODE_2_length_24307_cov_15.119712	2613	2689	4	22	76	0.2894737
NODE_2_length_24307_cov_15.119712	2662	2716	0	12	54	0.2222222
NODE_2_length_24307_cov_15.119712	2662	2716	2	42	54	0.7777778
NODE_2_length_24307_cov_15.119712	11257	11320	0	63	63	1.0000000
NODE_2_length_24307_cov_15.119712	20621	20701	0	80	80	1.0000000
NODE_2_length_24307_cov_15.119712	20674	20754	0	68	80	0.8500000
NODE_2_length_24307_cov_15.119712	20674	20754	2	12	80	0.1500000
NODE_7_length_12349_cov_28.144571	12251	12310	4	32	59	0.5423729
NODE_7_length_12349_cov_28.144571	12251	12310	5	2	59	0.0338983
NODE_7_length_12349_cov_28.144571	12251	12310	7	1	59	0.0169492
NODE_7_length_12349_cov_28.144571	12251	12310	9	3	59	0.0508475
NODE_7_length_12349_cov_28.144571	12251	12310	13	6	59	0.1016949
NODE_7_length_12349_cov_28.144571	12251	12310	15	7	59	0.1186441
NODE_7_length_12349_cov_28.144571	12251	12310	17	8	59	0.1355932
NODE_7_length_12349_cov_28.144571	12284	12310	4	26	26	1.0000000
NODE_10_length_11096_cov_14.154679	6455	6535	4	80	80	1.0000000
NODE_10_length_11096_cov_14.154679	6508	6588	0	44	80	0.5500000
NODE_10_length_11096_cov_14.154679	6508	6588	4	36	80	0.4500000
NODE_10_length_11096_cov_14.154679	6584	6664	0	22	80	0.2750000
NODE_10_length_11096_cov_14.154679	6584	6664	2	58	80	0.7250000
NODE_10_length_11096_cov_14.154679	6637	6717	0	7	80	0.0875000
NODE_10_length_11096_cov_14.154679	6637	6717	2	73	80	0.9125000
NODE_10_length_11096_cov_14.154679	7182	7229	165	1	47	0.0212766
NODE_10_length_11096_cov_14.154679	7182	7229	171	1	47	0.0212766
NODE_10_length_11096_cov_14.154679	7182	7229	173	1	47	0.0212766
NODE_10_length_11096_cov_14.154679	7182	7229	175	1	47	0.0212766
NODE_10_length_11096_cov_14.154679	7182	7229	181	2	47	0.0425532
NODE_10_length_11096_cov_14.154679	7182	7229	182	4	47	0.0851064
NODE_10_length_11096_cov_14.154679	7182	7229	183	5	47	0.1063830
NODE_10_length_11096_cov_14.154679	7182	7229	184	1	47	0.0212766
NODE_10_length_11096_cov_14.154679	7182	7229	185	2	47	0.0425532
NODE_10_length_11096_cov_14.154679	7182	7229	186	1	47	0.0212766
NODE_10_length_11096_cov_14.154679	7182	7229	191	1	47	0.0212766
NODE_10_length_11096_cov_14.154679	7182	7229	193	2	47	0.0425532
NODE_10_length_11096_cov_14.154679	7182	7229	194	1	47	0.0212766
NODE_10_length_11096_cov_14.154679	7182	7229	197	1	47	0.0212766
NODE_10_length_11096_cov_14.154679	7182	7229	202	2	47	0.0425532
NODE_10_length_11096_cov_14.154679	7182	7229	203	1	47	0.0212766
NODE_10_length_11096_cov_14.154679	7182	7229	208	1	47	0.0212766
NODE_10_length_11096_cov_14.154679	7182	7229	212	1	47	0.0212766
NODE_10_length_11096_cov_14.154679	7182	7229	213	3	47	0.0638298
NODE_10_length_11096_cov_14.154679	7182	7229	214	1	47	0.0212766
NODE_10_length_11096_cov_14.154679	7182	7229	215	1	47	0.0212766
NODE_10_length_11096_cov_14.154679	7182	7229	217	1	47	0.0212766
NODE_10_length_11096_cov_14.154679	7182	7229	219	1	47	0.0212766
NODE_10_length_11096_cov_14.154679	7182	7229	221	1	47	0.0212766
NODE_10_length_11096_cov_14.154679	7182	7229	225	2	47	0.0425532
NODE_10_length_11096_cov_14.154679	7182	7229	227	2	47	0.0425532
NODE_10_length_11096_cov_14.154679	7182	7229	229	5	47	0.1063830
NODE_10_length_11096_cov_14.154679	7182	7229	231	1	47	0.0212766
NODE_10_length_11096_cov_14.154679	7218	7282	117	3	64	0.0468750
NODE_10_length_11096_cov_14.154679	7218	7282	119	1	64	0.0156250
NODE_10_length_11096_cov_14.154679	7218	7282	121	2	64	0.0312500
NODE_10_length_11096_cov_14.154679	7218	7282	123	2	64	0.0312500
NODE_10_length_11096_cov_14.154679	7218	7282	125	2	64	0.0312500
NODE_10_length_11096_cov_14.154679	7218	7282	127	1	64	0.0156250
NODE_10_length_11096_cov_14.154679	7218	7282	129	2	64	0.0312500
NODE_10_length_11096_cov_14.154679	7218	7282	131	3	64	0.0468750
NODE_10_length_11096_cov_14.154679	7218	7282	132	1	64	0.0156250
NODE_10_length_11096_cov_14.154679	7218	7282	133	2	64	0.0312500
NODE_10_length_11096_cov_14.154679	7218	7282	134	2	64	0.0312500
NODE_10_length_11096_cov_14.154679	7218	7282	136	6	64	0.0937500
NODE_10_length_11096_cov_14.154679	7218	7282	138	1	64	0.0156250
NODE_10_length_11096_cov_14.154679	7218	7282	140	1	64	0.0156250
NODE_10_length_11096_cov_14.154679	7218	7282	141	2	64	0.0312500
NODE_10_length_11096_cov_14.154679	7218	7282	143	1	64	0.0156250
NODE_10_length_11096_cov_14.154679	7218	7282	145	1	64	0.0156250
NODE_10_length_11096_cov_14.154679	7218	7282	149	1	64	0.0156250
NODE_10_length_11096_cov_14.154679	7218	7282	151	1	64	0.0156250
NODE_10_length_11096_cov_14.154679	7218	7282	153	4	64	0.0625000
NODE_10_length_11096_cov_14.154679	7218	7282	155	2	64	0.0312500
NODE_10_length_11096_cov_14.154679	7218	7282	157	4	64	0.0625000
NODE_10_length_11096_cov_14.154679	7218	7282	159	3	64	0.0468750
NODE_10_length_11096_cov_14.154679	7218	7282	161	2	64	0.0312500
NODE_10_length_11096_cov_14.154679	7218	7282	163	3	64	0.0468750
NODE_10_length_11096_cov_14.154679	7218	7282	165	1	64	0.0156250
NODE_10_length_11096_cov_14.154679	7218	7282	171	1	64	0.0156250
NODE_10_length_11096_cov_14.154679	7218	7282	173	1	64	0.0156250
NODE_10_length_11096_cov_14.154679	7218	7282	175	1	64	0.0156250
NODE_10_length_11096_cov_14.154679	7218	7282	181	1	64	0.0156250
NODE_10_length_11096_cov_14.154679	7218	7282	183	5	64	0.0781250
NODE_10_length_11096_cov_14.154679	7218	7282	185	1	64	0.0156250
NODE_13_length_10749_cov_34.330235	3589	3669	0	80	80	1.0000000
NODE_13_length_10749_cov_34.330235	3642	3722	0	80	80	1.0000000
NODE_13_length_10749_cov_34.330235	3718	3798	0	80	80	1.0000000
NODE_13_length_10749_cov_34.330235	3771	3851	0	79	80	0.9875000
NODE_13_length_10749_cov_34.330235	3771	3851	1	1	80	0.0125000
NODE_14_length_10557_cov_50.055938	423	503	0	80	80	1.0000000
NODE_14_length_10557_cov_50.055938	476	556	0	80	80	1.0000000
NODE_14_length_10557_cov_50.055938	1625	1696	6	2	71	0.0281690
NODE_14_length_10557_cov_50.055938	1625	1696	8	7	71	0.0985916
NODE_14_length_10557_cov_50.055938	1625	1696	10	62	71	0.8732395
NODE_14_length_10557_cov_50.055938	1678	1733	4	30	55	0.5454546
NODE_14_length_10557_cov_50.055938	1678	1733	6	7	55	0.1272727
NODE_14_length_10557_cov_50.055938	1678	1733	8	7	55	0.1272727
NODE_14_length_10557_cov_50.055938	1678	1733	10	11	55	0.2000000
NODE_14_length_10557_cov_50.055938	2428	2488	0	40	60	0.6666667
NODE_14_length_10557_cov_50.055938	2428	2488	2	17	60	0.2833333
NODE_14_length_10557_cov_50.055938	2428	2488	4	3	60	0.0500000
NODE_17_length_10101_cov_12.236253	923	966	0	6	43	0.1395349
NODE_17_length_10101_cov_12.236253	923	966	4	37	43	0.8604651
NODE_17_length_10101_cov_12.236253	943	1007	4	64	64	1.0000000
NODE_17_length_10101_cov_12.236253	1715	1795	0	80	80	1.0000000
NODE_17_length_10101_cov_12.236253	1768	1820	0	50	52	0.9615384
NODE_17_length_10101_cov_12.236253	1768	1820	1	1	52	0.0192308
NODE_17_length_10101_cov_12.236253	1768	1820	3	1	52	0.0192308
NODE_20_length_9442_cov_109.961147	2108	2188	2	2	80	0.0250000
NODE_20_length_9442_cov_109.961147	2108	2188	6	78	80	0.9750000
NODE_20_length_9442_cov_109.961147	2161	2241	0	28	80	0.3500000
NODE_20_length_9442_cov_109.961147	2161	2241	4	13	80	0.1625000
NODE_20_length_9442_cov_109.961147	2161	2241	6	39	80	0.4875000
NODE_21_length_9414_cov_34.165217	2363	2443	48	3	80	0.0375000
NODE_21_length_9414_cov_34.165217	2363	2443	49	5	80	0.0625000
NODE_21_length_9414_cov_34.165217	2363	2443	51	9	80	0.1125000
NODE_21_length_9414_cov_34.165217	2363	2443	52	5	80	0.0625000
NODE_21_length_9414_cov_34.165217	2363	2443	53	1	80	0.0125000
NODE_21_length_9414_cov_34.165217	2363	2443	54	4	80	0.0500000
NODE_21_length_9414_cov_34.165217	2363	2443	55	24	80	0.3000000
NODE_21_length_9414_cov_34.165217	2363	2443	58	23	80	0.2875000
NODE_21_length_9414_cov_34.165217	2363	2443	59	6	80	0.0750000
NODE_21_length_9414_cov_34.165217	2416	2484	8	7	68	0.1029412
NODE_21_length_9414_cov_34.165217	2416	2484	9	1	68	0.0147059
NODE_21_length_9414_cov_34.165217	2416	2484	10	1	68	0.0147059
NODE_21_length_9414_cov_34.165217	2416	2484	14	3	68	0.0441176
NODE_21_length_9414_cov_34.165217	2416	2484	22	9	68	0.1323529
NODE_21_length_9414_cov_34.165217	2416	2484	24	5	68	0.0735294
NODE_21_length_9414_cov_34.165217	2416	2484	26	1	68	0.0147059
NODE_21_length_9414_cov_34.165217	2416	2484	34	2	68	0.0294118
NODE_21_length_9414_cov_34.165217	2416	2484	36	4	68	0.0588235
NODE_21_length_9414_cov_34.165217	2416	2484	40	5	68	0.0735294
NODE_21_length_9414_cov_34.165217	2416	2484	48	5	68	0.0735294
NODE_21_length_9414_cov_34.165217	2416	2484	52	5	68	0.0735294
NODE_21_length_9414_cov_34.165217	2416	2484	53	1	68	0.0147059
NODE_21_length_9414_cov_34.165217	2416	2484	55	19	68	0.2794118
NODE_21_length_9414_cov_34.165217	5899	5975	44	5	76	0.0657895
NODE_21_length_9414_cov_34.165217	5899	5975	48	1	76	0.0131579
NODE_21_length_9414_cov_34.165217	5899	5975	52	2	76	0.0263158
NODE_21_length_9414_cov_34.165217	5899	5975	54	5	76	0.0657895
NODE_21_length_9414_cov_34.165217	5899	5975	55	8	76	0.1052632
NODE_21_length_9414_cov_34.165217	5899	5975	56	13	76	0.1710526
NODE_21_length_9414_cov_34.165217	5899	5975	57	3	76	0.0394737
NODE_21_length_9414_cov_34.165217	5899	5975	58	6	76	0.0789474
NODE_21_length_9414_cov_34.165217	5899	5975	60	6	76	0.0789474
NODE_21_length_9414_cov_34.165217	5899	5975	62	2	76	0.0263158
NODE_21_length_9414_cov_34.165217	5899	5975	63	3	76	0.0394737
NODE_21_length_9414_cov_34.165217	5899	5975	64	17	76	0.2236842
NODE_21_length_9414_cov_34.165217	5899	5975	65	2	76	0.0263158
NODE_21_length_9414_cov_34.165217	5899	5975	66	1	76	0.0131579
NODE_21_length_9414_cov_34.165217	5899	5975	67	2	76	0.0263158
NODE_24_length_9168_cov_47.407542	470	550	26	1	80	0.0125000
NODE_24_length_9168_cov_47.407542	470	550	28	15	80	0.1875000
NODE_24_length_9168_cov_47.407542	470	550	32	1	80	0.0125000
NODE_24_length_9168_cov_47.407542	470	550	36	5	80	0.0625000
NODE_24_length_9168_cov_47.407542	470	550	38	5	80	0.0625000
NODE_24_length_9168_cov_47.407542	470	550	40	6	80	0.0750000
NODE_24_length_9168_cov_47.407542	470	550	42	20	80	0.2500000
NODE_24_length_9168_cov_47.407542	470	550	44	14	80	0.1750000
NODE_24_length_9168_cov_47.407542	470	550	48	4	80	0.0500000
NODE_24_length_9168_cov_47.407542	470	550	50	3	80	0.0375000
NODE_24_length_9168_cov_47.407542	470	550	52	6	80	0.0750000
NODE_24_length_9168_cov_47.407542	523	603	14	25	80	0.3125000
NODE_24_length_9168_cov_47.407542	523	603	16	15	80	0.1875000
NODE_24_length_9168_cov_47.407542	523	603	22	12	80	0.1500000
NODE_24_length_9168_cov_47.407542	523	603	24	1	80	0.0125000
NODE_24_length_9168_cov_47.407542	523	603	26	1	80	0.0125000
NODE_24_length_9168_cov_47.407542	523	603	28	15	80	0.1875000
NODE_24_length_9168_cov_47.407542	523	603	32	1	80	0.0125000
NODE_24_length_9168_cov_47.407542	523	603	36	5	80	0.0625000
NODE_24_length_9168_cov_47.407542	523	603	38	5	80	0.0625000
NODE_27_length_9108_cov_47.430347	4786	4866	167	1	80	0.0125000
NODE_27_length_9108_cov_47.430347	4786	4866	170	2	80	0.0250000
NODE_27_length_9108_cov_47.430347	4786	4866	172	2	80	0.0250000
NODE_27_length_9108_cov_47.430347	4786	4866	177	2	80	0.0250000
NODE_27_length_9108_cov_47.430347	4786	4866	178	1	80	0.0125000
NODE_27_length_9108_cov_47.430347	4786	4866	179	6	80	0.0750000
NODE_27_length_9108_cov_47.430347	4786	4866	180	1	80	0.0125000
NODE_27_length_9108_cov_47.430347	4786	4866	181	1	80	0.0125000
NODE_27_length_9108_cov_47.430347	4786	4866	183	1	80	0.0125000
NODE_27_length_9108_cov_47.430347	4786	4866	184	5	80	0.0625000
NODE_27_length_9108_cov_47.430347	4786	4866	185	1	80	0.0125000
NODE_27_length_9108_cov_47.430347	4786	4866	187	2	80	0.0250000
NODE_27_length_9108_cov_47.430347	4786	4866	191	1	80	0.0125000
NODE_27_length_9108_cov_47.430347	4786	4866	195	1	80	0.0125000
NODE_27_length_9108_cov_47.430347	4786	4866	199	1	80	0.0125000
NODE_27_length_9108_cov_47.430347	4786	4866	201	3	80	0.0375000
NODE_27_length_9108_cov_47.430347	4786	4866	203	1	80	0.0125000
NODE_27_length_9108_cov_47.430347	4786	4866	214	1	80	0.0125000
NODE_27_length_9108_cov_47.430347	4786	4866	215	1	80	0.0125000
NODE_27_length_9108_cov_47.430347	4786	4866	217	3	80	0.0375000
NODE_27_length_9108_cov_47.430347	4786	4866	218	2	80	0.0250000
NODE_27_length_9108_cov_47.430347	4786	4866	220	2	80	0.0250000
NODE_27_length_9108_cov_47.430347	4786	4866	221	4	80	0.0500000
NODE_27_length_9108_cov_47.430347	4786	4866	222	2	80	0.0250000
NODE_27_length_9108_cov_47.430347	4786	4866	223	2	80	0.0250000
NODE_27_length_9108_cov_47.430347	4786	4866	224	1	80	0.0125000
NODE_27_length_9108_cov_47.430347	4786	4866	225	1	80	0.0125000
NODE_27_length_9108_cov_47.430347	4786	4866	226	2	80	0.0250000
NODE_27_length_9108_cov_47.430347	4786	4866	227	2	80	0.0250000
NODE_27_length_9108_cov_47.430347	4786	4866	229	7	80	0.0875000
NODE_27_length_9108_cov_47.430347	4786	4866	230	4	80	0.0500000
NODE_27_length_9108_cov_47.430347	4786	4866	231	2	80	0.0250000
NODE_27_length_9108_cov_47.430347	4786	4866	232	6	80	0.0750000
NODE_27_length_9108_cov_47.430347	4786	4866	234	1	80	0.0125000
NODE_27_length_9108_cov_47.430347	4786	4866	235	3	80	0.0375000
NODE_27_length_9108_cov_47.430347	4786	4866	236	2	80	0.0250000
NODE_27_length_9108_cov_47.430347	4839	4902	213	1	63	0.0158730
NODE_27_length_9108_cov_47.430347	4839	4902	215	1	63	0.0158730
NODE_27_length_9108_cov_47.430347	4839	4902	217	3	63	0.0476190
NODE_27_length_9108_cov_47.430347	4839	4902	218	1	63	0.0158730
NODE_27_length_9108_cov_47.430347	4839	4902	219	1	63	0.0158730
NODE_27_length_9108_cov_47.430347	4839	4902	220	2	63	0.0317460
NODE_27_length_9108_cov_47.430347	4839	4902	221	7	63	0.1111111
NODE_27_length_9108_cov_47.430347	4839	4902	222	2	63	0.0317460
NODE_27_length_9108_cov_47.430347	4839	4902	223	2	63	0.0317460
NODE_27_length_9108_cov_47.430347	4839	4902	224	1	63	0.0158730
NODE_27_length_9108_cov_47.430347	4839	4902	225	1	63	0.0158730
NODE_27_length_9108_cov_47.430347	4839	4902	226	2	63	0.0317460
NODE_27_length_9108_cov_47.430347	4839	4902	229	3	63	0.0476190
NODE_27_length_9108_cov_47.430347	4839	4902	230	4	63	0.0634921
NODE_27_length_9108_cov_47.430347	4839	4902	232	4	63	0.0634921
NODE_27_length_9108_cov_47.430347	4839	4902	234	1	63	0.0158730
NODE_27_length_9108_cov_47.430347	4839	4902	237	1	63	0.0158730
NODE_27_length_9108_cov_47.430347	4839	4902	238	1	63	0.0158730
NODE_27_length_9108_cov_47.430347	4839	4902	242	1	63	0.0158730
NODE_27_length_9108_cov_47.430347	4839	4902	244	1	63	0.0158730
NODE_27_length_9108_cov_47.430347	4839	4902	254	1	63	0.0158730
NODE_27_length_9108_cov_47.430347	4839	4902	255	1	63	0.0158730
NODE_27_length_9108_cov_47.430347	4839	4902	256	1	63	0.0158730
NODE_27_length_9108_cov_47.430347	4839	4902	259	1	63	0.0158730
NODE_27_length_9108_cov_47.430347	4839	4902	260	1	63	0.0158730
NODE_27_length_9108_cov_47.430347	4839	4902	262	2	63	0.0317460
NODE_27_length_9108_cov_47.430347	4839	4902	264	4	63	0.0634921
NODE_27_length_9108_cov_47.430347	4839	4902	266	5	63	0.0793651
NODE_27_length_9108_cov_47.430347	4839	4902	268	5	63	0.0793651
NODE_27_length_9108_cov_47.430347	4839	4902	272	2	63	0.0317460
NODE_27_length_9108_cov_47.430347	4895	4963	177	1	68	0.0147059
NODE_27_length_9108_cov_47.430347	4895	4963	181	1	68	0.0147059
NODE_27_length_9108_cov_47.430347	4895	4963	185	6	68	0.0882353
NODE_27_length_9108_cov_47.430347	4895	4963	201	1	68	0.0147059
NODE_27_length_9108_cov_47.430347	4895	4963	203	4	68	0.0588235
NODE_27_length_9108_cov_47.430347	4895	4963	209	4	68	0.0588235
NODE_27_length_9108_cov_47.430347	4895	4963	214	2	68	0.0294118
NODE_27_length_9108_cov_47.430347	4895	4963	216	1	68	0.0147059
NODE_27_length_9108_cov_47.430347	4895	4963	218	2	68	0.0294118
NODE_27_length_9108_cov_47.430347	4895	4963	222	2	68	0.0294118
NODE_27_length_9108_cov_47.430347	4895	4963	224	2	68	0.0294118
NODE_27_length_9108_cov_47.430347	4895	4963	227	1	68	0.0147059
NODE_27_length_9108_cov_47.430347	4895	4963	229	4	68	0.0588235
NODE_27_length_9108_cov_47.430347	4895	4963	233	5	68	0.0735294
NODE_27_length_9108_cov_47.430347	4895	4963	237	1	68	0.0147059
NODE_27_length_9108_cov_47.430347	4895	4963	239	3	68	0.0441176
NODE_27_length_9108_cov_47.430347	4895	4963	240	2	68	0.0294118
NODE_27_length_9108_cov_47.430347	4895	4963	241	1	68	0.0147059
NODE_27_length_9108_cov_47.430347	4895	4963	242	1	68	0.0147059
NODE_27_length_9108_cov_47.430347	4895	4963	246	2	68	0.0294118
NODE_27_length_9108_cov_47.430347	4895	4963	248	2	68	0.0294118
NODE_27_length_9108_cov_47.430347	4895	4963	249	2	68	0.0294118
NODE_27_length_9108_cov_47.430347	4895	4963	253	1	68	0.0147059
NODE_27_length_9108_cov_47.430347	4895	4963	255	1	68	0.0147059
NODE_27_length_9108_cov_47.430347	4895	4963	266	3	68	0.0441176
NODE_27_length_9108_cov_47.430347	4895	4963	268	5	68	0.0735294
NODE_27_length_9108_cov_47.430347	4895	4963	270	1	68	0.0147059
NODE_27_length_9108_cov_47.430347	4895	4963	272	4	68	0.0588235
NODE_27_length_9108_cov_47.430347	4895	4963	276	3	68	0.0441176
NODE_27_length_9108_cov_47.430347	4936	5016	45	2	80	0.0250000
NODE_27_length_9108_cov_47.430347	4936	5016	51	1	80	0.0125000
NODE_27_length_9108_cov_47.430347	4936	5016	58	2	80	0.0250000
NODE_27_length_9108_cov_47.430347	4936	5016	70	1	80	0.0125000
NODE_27_length_9108_cov_47.430347	4936	5016	72	1	80	0.0125000
NODE_27_length_9108_cov_47.430347	4936	5016	74	2	80	0.0250000
NODE_27_length_9108_cov_47.430347	4936	5016	76	1	80	0.0125000
NODE_27_length_9108_cov_47.430347	4936	5016	78	1	80	0.0125000
NODE_27_length_9108_cov_47.430347	4936	5016	80	1	80	0.0125000
NODE_27_length_9108_cov_47.430347	4936	5016	87	4	80	0.0500000
NODE_27_length_9108_cov_47.430347	4936	5016	89	1	80	0.0125000
NODE_27_length_9108_cov_47.430347	4936	5016	96	1	80	0.0125000
NODE_27_length_9108_cov_47.430347	4936	5016	105	1	80	0.0125000
NODE_27_length_9108_cov_47.430347	4936	5016	107	1	80	0.0125000
NODE_27_length_9108_cov_47.430347	4936	5016	115	1	80	0.0125000
NODE_27_length_9108_cov_47.430347	4936	5016	117	1	80	0.0125000
NODE_27_length_9108_cov_47.430347	4936	5016	121	8	80	0.1000000
NODE_27_length_9108_cov_47.430347	4936	5016	123	3	80	0.0375000
NODE_27_length_9108_cov_47.430347	4936	5016	129	1	80	0.0125000
NODE_27_length_9108_cov_47.430347	4936	5016	131	1	80	0.0125000
NODE_27_length_9108_cov_47.430347	4936	5016	139	1	80	0.0125000
NODE_27_length_9108_cov_47.430347	4936	5016	145	1	80	0.0125000
NODE_27_length_9108_cov_47.430347	4936	5016	147	1	80	0.0125000
NODE_27_length_9108_cov_47.430347	4936	5016	151	1	80	0.0125000
NODE_27_length_9108_cov_47.430347	4936	5016	155	1	80	0.0125000
NODE_27_length_9108_cov_47.430347	4936	5016	156	2	80	0.0250000
NODE_27_length_9108_cov_47.430347	4936	5016	158	1	80	0.0125000
NODE_27_length_9108_cov_47.430347	4936	5016	159	4	80	0.0500000
NODE_27_length_9108_cov_47.430347	4936	5016	167	1	80	0.0125000
NODE_27_length_9108_cov_47.430347	4936	5016	171	3	80	0.0375000
NODE_27_length_9108_cov_47.430347	4936	5016	175	1	80	0.0125000
NODE_27_length_9108_cov_47.430347	4936	5016	177	2	80	0.0250000
NODE_27_length_9108_cov_47.430347	4936	5016	181	1	80	0.0125000
NODE_27_length_9108_cov_47.430347	4936	5016	185	6	80	0.0750000
NODE_27_length_9108_cov_47.430347	4936	5016	201	1	80	0.0125000
NODE_27_length_9108_cov_47.430347	4936	5016	203	4	80	0.0500000
NODE_27_length_9108_cov_47.430347	4936	5016	209	4	80	0.0500000
NODE_27_length_9108_cov_47.430347	4936	5016	214	2	80	0.0250000
NODE_27_length_9108_cov_47.430347	4936	5016	216	1	80	0.0125000
NODE_27_length_9108_cov_47.430347	4936	5016	218	2	80	0.0250000
NODE_27_length_9108_cov_47.430347	4936	5016	222	2	80	0.0250000
NODE_27_length_9108_cov_47.430347	4936	5016	224	2	80	0.0250000
NODE_27_length_9108_cov_47.430347	4936	5016	227	1	80	0.0125000
NODE_28_length_9108_cov_26.469974	44	120	0	76	76	1.0000000
NODE_28_length_9108_cov_26.469974	7711	7791	5	1	80	0.0125000
NODE_28_length_9108_cov_26.469974	7711	7791	10	2	80	0.0250000
NODE_28_length_9108_cov_26.469974	7711	7791	12	10	80	0.1250000
NODE_28_length_9108_cov_26.469974	7711	7791	13	3	80	0.0375000
NODE_28_length_9108_cov_26.469974	7711	7791	15	2	80	0.0250000
NODE_28_length_9108_cov_26.469974	7711	7791	17	2	80	0.0250000
NODE_28_length_9108_cov_26.469974	7711	7791	20	10	80	0.1250000
NODE_28_length_9108_cov_26.469974	7711	7791	22	9	80	0.1125000
NODE_28_length_9108_cov_26.469974	7711	7791	23	6	80	0.0750000
NODE_28_length_9108_cov_26.469974	7711	7791	25	1	80	0.0125000
NODE_28_length_9108_cov_26.469974	7711	7791	26	1	80	0.0125000
NODE_28_length_9108_cov_26.469974	7711	7791	30	4	80	0.0500000
NODE_28_length_9108_cov_26.469974	7711	7791	31	3	80	0.0375000
NODE_28_length_9108_cov_26.469974	7711	7791	33	3	80	0.0375000
NODE_28_length_9108_cov_26.469974	7711	7791	37	2	80	0.0250000
NODE_28_length_9108_cov_26.469974	7711	7791	45	1	80	0.0125000
NODE_28_length_9108_cov_26.469974	7711	7791	47	1	80	0.0125000
NODE_28_length_9108_cov_26.469974	7711	7791	50	2	80	0.0250000
NODE_28_length_9108_cov_26.469974	7711	7791	54	1	80	0.0125000
NODE_28_length_9108_cov_26.469974	7711	7791	56	2	80	0.0250000
NODE_28_length_9108_cov_26.469974	7711	7791	59	2	80	0.0250000
NODE_28_length_9108_cov_26.469974	7711	7791	61	4	80	0.0500000
NODE_28_length_9108_cov_26.469974	7711	7791	65	1	80	0.0125000
NODE_28_length_9108_cov_26.469974	7711	7791	66	4	80	0.0500000
NODE_28_length_9108_cov_26.469974	7711	7791	77	1	80	0.0125000
NODE_28_length_9108_cov_26.469974	7711	7791	81	2	80	0.0250000
NODE_28_length_9108_cov_26.469974	8144	8224	11	1	80	0.0125000
NODE_28_length_9108_cov_26.469974	8144	8224	21	2	80	0.0250000
NODE_28_length_9108_cov_26.469974	8144	8224	24	1	80	0.0125000
NODE_28_length_9108_cov_26.469974	8144	8224	28	15	80	0.1875000
NODE_28_length_9108_cov_26.469974	8144	8224	30	4	80	0.0500000
NODE_28_length_9108_cov_26.469974	8144	8224	34	1	80	0.0125000
NODE_28_length_9108_cov_26.469974	8144	8224	36	2	80	0.0250000
NODE_28_length_9108_cov_26.469974	8144	8224	41	3	80	0.0375000
NODE_28_length_9108_cov_26.469974	8144	8224	48	1	80	0.0125000
NODE_28_length_9108_cov_26.469974	8144	8224	50	5	80	0.0625000
NODE_28_length_9108_cov_26.469974	8144	8224	51	4	80	0.0500000
NODE_28_length_9108_cov_26.469974	8144	8224	52	1	80	0.0125000
NODE_28_length_9108_cov_26.469974	8144	8224	54	1	80	0.0125000
NODE_28_length_9108_cov_26.469974	8144	8224	57	1	80	0.0125000
NODE_28_length_9108_cov_26.469974	8144	8224	59	3	80	0.0375000
NODE_28_length_9108_cov_26.469974	8144	8224	61	1	80	0.0125000
NODE_28_length_9108_cov_26.469974	8144	8224	63	7	80	0.0875000
NODE_28_length_9108_cov_26.469974	8144	8224	65	3	80	0.0375000
NODE_28_length_9108_cov_26.469974	8144	8224	68	3	80	0.0375000
NODE_28_length_9108_cov_26.469974	8144	8224	72	1	80	0.0125000
NODE_28_length_9108_cov_26.469974	8144	8224	76	1	80	0.0125000
NODE_28_length_9108_cov_26.469974	8144	8224	78	3	80	0.0375000
NODE_28_length_9108_cov_26.469974	8144	8224	82	1	80	0.0125000
NODE_28_length_9108_cov_26.469974	8144	8224	84	4	80	0.0500000
NODE_28_length_9108_cov_26.469974	8144	8224	86	10	80	0.1250000
NODE_28_length_9108_cov_26.469974	8144	8224	88	1	80	0.0125000
NODE_28_length_9108_cov_26.469974	8568	8648	0	18	80	0.2250000
NODE_28_length_9108_cov_26.469974	8568	8648	2	62	80	0.7750000
NODE_28_length_9108_cov_26.469974	8621	8701	0	71	80	0.8875000
NODE_28_length_9108_cov_26.469974	8621	8701	2	9	80	0.1125000
NODE_30_length_8743_cov_14.172721	7849	7929	84	3	80	0.0375000
NODE_30_length_8743_cov_14.172721	7849	7929	89	1	80	0.0125000
NODE_30_length_8743_cov_14.172721	7849	7929	91	2	80	0.0250000
NODE_30_length_8743_cov_14.172721	7849	7929	97	1	80	0.0125000
NODE_30_length_8743_cov_14.172721	7849	7929	105	1	80	0.0125000
NODE_30_length_8743_cov_14.172721	7849	7929	110	1	80	0.0125000
NODE_30_length_8743_cov_14.172721	7849	7929	112	2	80	0.0250000
NODE_30_length_8743_cov_14.172721	7849	7929	120	1	80	0.0125000
NODE_30_length_8743_cov_14.172721	7849	7929	122	4	80	0.0500000
NODE_30_length_8743_cov_14.172721	7849	7929	126	1	80	0.0125000
NODE_30_length_8743_cov_14.172721	7849	7929	128	2	80	0.0250000
NODE_30_length_8743_cov_14.172721	7849	7929	130	3	80	0.0375000
NODE_30_length_8743_cov_14.172721	7849	7929	132	1	80	0.0125000
NODE_30_length_8743_cov_14.172721	7849	7929	134	4	80	0.0500000
NODE_30_length_8743_cov_14.172721	7849	7929	136	9	80	0.1125000
NODE_30_length_8743_cov_14.172721	7849	7929	138	3	80	0.0375000
NODE_30_length_8743_cov_14.172721	7849	7929	140	1	80	0.0125000
NODE_30_length_8743_cov_14.172721	7849	7929	142	1	80	0.0125000
NODE_30_length_8743_cov_14.172721	7849	7929	144	5	80	0.0625000
NODE_30_length_8743_cov_14.172721	7849	7929	146	8	80	0.1000000
NODE_30_length_8743_cov_14.172721	7849	7929	148	6	80	0.0750000
NODE_30_length_8743_cov_14.172721	7849	7929	150	2	80	0.0250000
NODE_30_length_8743_cov_14.172721	7849	7929	152	1	80	0.0125000
NODE_30_length_8743_cov_14.172721	7849	7929	154	4	80	0.0500000
NODE_30_length_8743_cov_14.172721	7849	7929	155	1	80	0.0125000
NODE_30_length_8743_cov_14.172721	7849	7929	156	2	80	0.0250000
NODE_30_length_8743_cov_14.172721	7849	7929	157	1	80	0.0125000
NODE_30_length_8743_cov_14.172721	7849	7929	158	6	80	0.0750000
NODE_30_length_8743_cov_14.172721	7849	7929	159	1	80	0.0125000
NODE_30_length_8743_cov_14.172721	7849	7929	161	2	80	0.0250000
NODE_30_length_8743_cov_14.172721	7902	7964	40	1	62	0.0161290
NODE_30_length_8743_cov_14.172721	7902	7964	46	1	62	0.0161290
NODE_30_length_8743_cov_14.172721	7902	7964	48	3	62	0.0483871
NODE_30_length_8743_cov_14.172721	7902	7964	50	4	62	0.0645161
NODE_30_length_8743_cov_14.172721	7902	7964	53	1	62	0.0161290
NODE_30_length_8743_cov_14.172721	7902	7964	56	1	62	0.0161290
NODE_30_length_8743_cov_14.172721	7902	7964	59	1	62	0.0161290
NODE_30_length_8743_cov_14.172721	7902	7964	61	1	62	0.0161290
NODE_30_length_8743_cov_14.172721	7902	7964	63	2	62	0.0322581
NODE_30_length_8743_cov_14.172721	7902	7964	65	5	62	0.0806452
NODE_30_length_8743_cov_14.172721	7902	7964	68	2	62	0.0322581
NODE_30_length_8743_cov_14.172721	7902	7964	72	3	62	0.0483871
NODE_30_length_8743_cov_14.172721	7902	7964	74	1	62	0.0161290
NODE_30_length_8743_cov_14.172721	7902	7964	76	2	62	0.0322581
NODE_30_length_8743_cov_14.172721	7902	7964	78	6	62	0.0967742
NODE_30_length_8743_cov_14.172721	7902	7964	84	4	62	0.0645161
NODE_30_length_8743_cov_14.172721	7902	7964	89	1	62	0.0161290
NODE_30_length_8743_cov_14.172721	7902	7964	91	2	62	0.0322581
NODE_30_length_8743_cov_14.172721	7902	7964	97	1	62	0.0161290
NODE_30_length_8743_cov_14.172721	7902	7964	105	1	62	0.0161290
NODE_30_length_8743_cov_14.172721	7902	7964	110	1	62	0.0161290
NODE_30_length_8743_cov_14.172721	7902	7964	112	2	62	0.0322581
NODE_30_length_8743_cov_14.172721	7902	7964	120	1	62	0.0161290
NODE_30_length_8743_cov_14.172721	7902	7964	122	4	62	0.0645161
NODE_30_length_8743_cov_14.172721	7902	7964	126	1	62	0.0161290
NODE_30_length_8743_cov_14.172721	7902	7964	128	2	62	0.0322581
NODE_30_length_8743_cov_14.172721	7902	7964	130	3	62	0.0483871
NODE_30_length_8743_cov_14.172721	7902	7964	132	1	62	0.0161290
NODE_30_length_8743_cov_14.172721	7902	7964	134	4	62	0.0645161
NODE_32_length_8707_cov_6.353044	8541	8621	9	15	80	0.1875000
NODE_32_length_8707_cov_6.353044	8541	8621	15	1	80	0.0125000
NODE_32_length_8707_cov_6.353044	8541	8621	17	2	80	0.0250000
NODE_32_length_8707_cov_6.353044	8541	8621	20	1	80	0.0125000
NODE_32_length_8707_cov_6.353044	8541	8621	24	2	80	0.0250000
NODE_32_length_8707_cov_6.353044	8541	8621	28	14	80	0.1750000
NODE_32_length_8707_cov_6.353044	8541	8621	30	9	80	0.1125000
NODE_32_length_8707_cov_6.353044	8541	8621	34	15	80	0.1875000
NODE_32_length_8707_cov_6.353044	8541	8621	38	15	80	0.1875000
NODE_32_length_8707_cov_6.353044	8541	8621	40	6	80	0.0750000
NODE_32_length_8707_cov_6.353044	8541	8621	9	15	80	0.1875000
NODE_32_length_8707_cov_6.353044	8541	8621	15	1	80	0.0125000
NODE_32_length_8707_cov_6.353044	8541	8621	17	2	80	0.0250000
NODE_32_length_8707_cov_6.353044	8541	8621	20	1	80	0.0125000
NODE_32_length_8707_cov_6.353044	8541	8621	24	2	80	0.0250000
NODE_32_length_8707_cov_6.353044	8541	8621	28	14	80	0.1750000
NODE_32_length_8707_cov_6.353044	8541	8621	30	9	80	0.1125000
NODE_32_length_8707_cov_6.353044	8541	8621	34	15	80	0.1875000
NODE_32_length_8707_cov_6.353044	8541	8621	38	15	80	0.1875000
NODE_32_length_8707_cov_6.353044	8541	8621	40	6	80	0.0750000
NODE_32_length_8707_cov_6.353044	8541	8621	9	15	80	0.1875000
NODE_32_length_8707_cov_6.353044	8541	8621	15	1	80	0.0125000
NODE_32_length_8707_cov_6.353044	8541	8621	17	2	80	0.0250000
NODE_32_length_8707_cov_6.353044	8541	8621	20	1	80	0.0125000
NODE_32_length_8707_cov_6.353044	8541	8621	24	2	80	0.0250000
NODE_32_length_8707_cov_6.353044	8541	8621	28	14	80	0.1750000
NODE_32_length_8707_cov_6.353044	8541	8621	30	9	80	0.1125000
NODE_32_length_8707_cov_6.353044	8541	8621	34	15	80	0.1875000
NODE_32_length_8707_cov_6.353044	8541	8621	38	15	80	0.1875000
NODE_32_length_8707_cov_6.353044	8541	8621	40	6	80	0.0750000
NODE_32_length_8707_cov_6.353044	8594	8674	31	34	80	0.4250000
NODE_32_length_8707_cov_6.353044	8594	8674	32	12	80	0.1500000
NODE_32_length_8707_cov_6.353044	8594	8674	34	22	80	0.2750000
NODE_32_length_8707_cov_6.353044	8594	8674	38	6	80	0.0750000
NODE_32_length_8707_cov_6.353044	8594	8674	40	6	80	0.0750000
NODE_32_length_8707_cov_6.353044	8594	8674	31	34	80	0.4250000
NODE_32_length_8707_cov_6.353044	8594	8674	32	12	80	0.1500000
NODE_32_length_8707_cov_6.353044	8594	8674	34	22	80	0.2750000
NODE_32_length_8707_cov_6.353044	8594	8674	38	6	80	0.0750000
NODE_32_length_8707_cov_6.353044	8594	8674	40	6	80	0.0750000
NODE_32_length_8707_cov_6.353044	8594	8673	31	33	79	0.4177215
NODE_32_length_8707_cov_6.353044	8594	8673	32	12	79	0.1518987
NODE_32_length_8707_cov_6.353044	8594	8673	34	22	79	0.2784810
NODE_32_length_8707_cov_6.353044	8594	8673	38	6	79	0.0759494
NODE_32_length_8707_cov_6.353044	8594	8673	40	6	79	0.0759494
NODE_32_length_8707_cov_6.353044	8599	8674	31	34	75	0.4533333
NODE_32_length_8707_cov_6.353044	8599	8674	32	12	75	0.1600000
NODE_32_length_8707_cov_6.353044	8599	8674	34	22	75	0.2933333
NODE_32_length_8707_cov_6.353044	8599	8674	38	1	75	0.0133333
NODE_32_length_8707_cov_6.353044	8599	8674	40	6	75	0.0800000
NODE_38_length_8281_cov_13.025177	7108	7188	0	80	80	1.0000000
NODE_38_length_8281_cov_13.025177	7161	7199	0	38	38	1.0000000
NODE_38_length_8281_cov_13.025177	7175	7255	0	80	80	1.0000000
NODE_38_length_8281_cov_13.025177	7228	7308	0	80	80	1.0000000
NODE_38_length_8281_cov_13.025177	7749	7829	0	80	80	1.0000000
NODE_38_length_8281_cov_13.025177	7802	7882	0	34	80	0.4250000
NODE_38_length_8281_cov_13.025177	7802	7882	2	46	80	0.5750000
NODE_38_length_8281_cov_13.025177	7878	7958	0	42	80	0.5250000
NODE_38_length_8281_cov_13.025177	7878	7958	2	38	80	0.4750000
NODE_38_length_8281_cov_13.025177	7931	8011	0	80	80	1.0000000
NODE_39_length_8259_cov_60.011152	1424	1504	2	80	80	1.0000000
NODE_39_length_8259_cov_60.011152	1477	1549	2	72	72	1.0000000
NODE_40_length_8228_cov_17.079592	314	394	2	4	80	0.0500000
NODE_40_length_8228_cov_17.079592	314	394	6	73	80	0.9125000
NODE_40_length_8228_cov_17.079592	314	394	8	3	80	0.0375000
NODE_40_length_8228_cov_17.079592	367	447	2	57	80	0.7125000
NODE_40_length_8228_cov_17.079592	367	447	6	20	80	0.2500000
NODE_40_length_8228_cov_17.079592	367	447	8	3	80	0.0375000
NODE_40_length_8228_cov_17.079592	443	523	2	43	80	0.5375000
NODE_40_length_8228_cov_17.079592	443	523	6	8	80	0.1000000
NODE_40_length_8228_cov_17.079592	443	523	8	1	80	0.0125000
NODE_40_length_8228_cov_17.079592	443	523	10	15	80	0.1875000
NODE_40_length_8228_cov_17.079592	443	523	12	13	80	0.1625000
NODE_40_length_8228_cov_17.079592	496	576	10	68	80	0.8500000
NODE_40_length_8228_cov_17.079592	496	576	12	12	80	0.1500000
NODE_40_length_8228_cov_17.079592	3154	3217	52	1	63	0.0158730
NODE_40_length_8228_cov_17.079592	3154	3217	149	1	63	0.0158730
NODE_40_length_8228_cov_17.079592	3154	3217	164	1	63	0.0158730
NODE_40_length_8228_cov_17.079592	3154	3217	171	1	63	0.0158730
NODE_40_length_8228_cov_17.079592	3154	3217	175	1	63	0.0158730
NODE_40_length_8228_cov_17.079592	3154	3217	187	1	63	0.0158730
NODE_40_length_8228_cov_17.079592	3154	3217	198	1	63	0.0158730
NODE_40_length_8228_cov_17.079592	3154	3217	214	1	63	0.0158730
NODE_40_length_8228_cov_17.079592	3154	3217	222	1	63	0.0158730
NODE_40_length_8228_cov_17.079592	3154	3217	230	1	63	0.0158730
NODE_40_length_8228_cov_17.079592	3154	3217	236	1	63	0.0158730
NODE_40_length_8228_cov_17.079592	3154	3217	238	1	63	0.0158730
NODE_40_length_8228_cov_17.079592	3154	3217	246	2	63	0.0317460
NODE_40_length_8228_cov_17.079592	3154	3217	249	1	63	0.0158730
NODE_40_length_8228_cov_17.079592	3154	3217	261	1	63	0.0158730
NODE_40_length_8228_cov_17.079592	3154	3217	262	1	63	0.0158730
NODE_40_length_8228_cov_17.079592	3154	3217	270	1	63	0.0158730
NODE_40_length_8228_cov_17.079592	3154	3217	273	1	63	0.0158730
NODE_40_length_8228_cov_17.079592	3154	3217	279	1	63	0.0158730
NODE_40_length_8228_cov_17.079592	3154	3217	283	1	63	0.0158730
NODE_40_length_8228_cov_17.079592	3154	3217	285	1	63	0.0158730
NODE_40_length_8228_cov_17.079592	3154	3217	287	2	63	0.0317460
NODE_40_length_8228_cov_17.079592	3154	3217	297	1	63	0.0158730
NODE_40_length_8228_cov_17.079592	3154	3217	303	1	63	0.0158730
NODE_40_length_8228_cov_17.079592	3154	3217	305	1	63	0.0158730
NODE_40_length_8228_cov_17.079592	3154	3217	309	1	63	0.0158730
NODE_40_length_8228_cov_17.079592	3154	3217	313	1	63	0.0158730
NODE_40_length_8228_cov_17.079592	3154	3217	316	1	63	0.0158730
NODE_40_length_8228_cov_17.079592	3154	3217	340	1	63	0.0158730
NODE_40_length_8228_cov_17.079592	3154	3217	344	1	63	0.0158730
NODE_40_length_8228_cov_17.079592	3154	3217	348	1	63	0.0158730
NODE_40_length_8228_cov_17.079592	3154	3217	364	1	63	0.0158730
NODE_40_length_8228_cov_17.079592	3154	3217	376	1	63	0.0158730
NODE_40_length_8228_cov_17.079592	3154	3217	384	1	63	0.0158730
NODE_40_length_8228_cov_17.079592	3154	3217	388	1	63	0.0158730
NODE_40_length_8228_cov_17.079592	3154	3217	401	1	63	0.0158730
NODE_40_length_8228_cov_17.079592	3154	3217	405	3	63	0.0476190
NODE_40_length_8228_cov_17.079592	3154	3217	407	4	63	0.0634921
NODE_40_length_8228_cov_17.079592	3154	3217	415	3	63	0.0476190
NODE_40_length_8228_cov_17.079592	3154	3217	417	1	63	0.0158730
NODE_40_length_8228_cov_17.079592	3154	3217	419	1	63	0.0158730
NODE_40_length_8228_cov_17.079592	3154	3217	421	5	63	0.0793651
NODE_40_length_8228_cov_17.079592	3154	3217	423	8	63	0.1269841
NODE_43_length_8100_cov_32.115236	501	581	3	7	80	0.0875000
NODE_43_length_8100_cov_32.115236	501	581	4	1	80	0.0125000
NODE_43_length_8100_cov_32.115236	501	581	5	48	80	0.6000000
NODE_43_length_8100_cov_32.115236	501	581	6	5	80	0.0625000
NODE_43_length_8100_cov_32.115236	501	581	7	5	80	0.0625000
NODE_43_length_8100_cov_32.115236	501	581	8	14	80	0.1750000
NODE_43_length_8100_cov_32.115236	554	634	3	7	80	0.0875000
NODE_43_length_8100_cov_32.115236	554	634	4	1	80	0.0125000
NODE_43_length_8100_cov_32.115236	554	634	5	55	80	0.6875000
NODE_43_length_8100_cov_32.115236	554	634	6	2	80	0.0250000
NODE_43_length_8100_cov_32.115236	554	634	7	1	80	0.0125000
NODE_43_length_8100_cov_32.115236	554	634	8	14	80	0.1750000
NODE_43_length_8100_cov_32.115236	1383	1463	0	59	80	0.7375000
NODE_43_length_8100_cov_32.115236	1383	1463	2	21	80	0.2625000
NODE_43_length_8100_cov_32.115236	1436	1516	0	6	80	0.0750000
NODE_43_length_8100_cov_32.115236	1436	1516	2	32	80	0.4000000
NODE_43_length_8100_cov_32.115236	1436	1516	6	42	80	0.5250000
NODE_43_length_8100_cov_32.115236	3391	3462	159	1	71	0.0140845
NODE_43_length_8100_cov_32.115236	3391	3462	173	1	71	0.0140845
NODE_43_length_8100_cov_32.115236	3391	3462	174	1	71	0.0140845
NODE_43_length_8100_cov_32.115236	3391	3462	178	1	71	0.0140845
NODE_43_length_8100_cov_32.115236	3391	3462	179	1	71	0.0140845
NODE_43_length_8100_cov_32.115236	3391	3462	191	1	71	0.0140845
NODE_43_length_8100_cov_32.115236	3391	3462	193	1	71	0.0140845
NODE_43_length_8100_cov_32.115236	3391	3462	199	1	71	0.0140845
NODE_43_length_8100_cov_32.115236	3391	3462	201	1	71	0.0140845
NODE_43_length_8100_cov_32.115236	3391	3462	209	1	71	0.0140845
NODE_43_length_8100_cov_32.115236	3391	3462	214	1	71	0.0140845
NODE_43_length_8100_cov_32.115236	3391	3462	218	1	71	0.0140845
NODE_43_length_8100_cov_32.115236	3391	3462	221	1	71	0.0140845
NODE_43_length_8100_cov_32.115236	3391	3462	231	1	71	0.0140845
NODE_43_length_8100_cov_32.115236	3391	3462	238	2	71	0.0281690
NODE_43_length_8100_cov_32.115236	3391	3462	240	1	71	0.0140845
NODE_43_length_8100_cov_32.115236	3391	3462	259	1	71	0.0140845
NODE_43_length_8100_cov_32.115236	3391	3462	269	1	71	0.0140845
NODE_43_length_8100_cov_32.115236	3391	3462	282	1	71	0.0140845
NODE_43_length_8100_cov_32.115236	3391	3462	290	1	71	0.0140845
NODE_43_length_8100_cov_32.115236	3391	3462	299	1	71	0.0140845
NODE_43_length_8100_cov_32.115236	3391	3462	307	1	71	0.0140845
NODE_43_length_8100_cov_32.115236	3391	3462	312	1	71	0.0140845
NODE_43_length_8100_cov_32.115236	3391	3462	313	1	71	0.0140845
NODE_43_length_8100_cov_32.115236	3391	3462	316	4	71	0.0563380
NODE_43_length_8100_cov_32.115236	3391	3462	321	3	71	0.0422535
NODE_43_length_8100_cov_32.115236	3391	3462	327	1	71	0.0140845
NODE_43_length_8100_cov_32.115236	3391	3462	331	1	71	0.0140845
NODE_43_length_8100_cov_32.115236	3391	3462	333	1	71	0.0140845
NODE_43_length_8100_cov_32.115236	3391	3462	335	1	71	0.0140845
NODE_43_length_8100_cov_32.115236	3391	3462	337	1	71	0.0140845
NODE_43_length_8100_cov_32.115236	3391	3462	339	2	71	0.0281690
NODE_43_length_8100_cov_32.115236	3391	3462	346	1	71	0.0140845
NODE_43_length_8100_cov_32.115236	3391	3462	347	1	71	0.0140845
NODE_43_length_8100_cov_32.115236	3391	3462	349	1	71	0.0140845
NODE_43_length_8100_cov_32.115236	3391	3462	351	1	71	0.0140845
NODE_43_length_8100_cov_32.115236	3391	3462	353	1	71	0.0140845
NODE_43_length_8100_cov_32.115236	3391	3462	355	1	71	0.0140845
NODE_43_length_8100_cov_32.115236	3391	3462	357	1	71	0.0140845
NODE_43_length_8100_cov_32.115236	3391	3462	361	1	71	0.0140845
NODE_43_length_8100_cov_32.115236	3391	3462	362	1	71	0.0140845
NODE_43_length_8100_cov_32.115236	3391	3462	363	1	71	0.0140845
NODE_43_length_8100_cov_32.115236	3391	3462	366	1	71	0.0140845
NODE_43_length_8100_cov_32.115236	3391	3462	368	9	71	0.1267606
NODE_43_length_8100_cov_32.115236	3391	3462	369	3	71	0.0422535
NODE_43_length_8100_cov_32.115236	3391	3462	370	4	71	0.0563380
NODE_43_length_8100_cov_32.115236	3391	3462	372	4	71	0.0563380
NODE_43_length_8100_cov_32.115236	3391	3462	374	1	71	0.0140845
NODE_43_length_8100_cov_32.115236	3435	3483	72	1	48	0.0208333
NODE_43_length_8100_cov_32.115236	3435	3483	73	1	48	0.0208333
NODE_43_length_8100_cov_32.115236	3435	3483	75	1	48	0.0208333
NODE_43_length_8100_cov_32.115236	3435	3483	78	1	48	0.0208333
NODE_43_length_8100_cov_32.115236	3435	3483	80	1	48	0.0208333
NODE_43_length_8100_cov_32.115236	3435	3483	82	1	48	0.0208333
NODE_43_length_8100_cov_32.115236	3435	3483	92	1	48	0.0208333
NODE_43_length_8100_cov_32.115236	3435	3483	107	1	48	0.0208333
NODE_43_length_8100_cov_32.115236	3435	3483	109	1	48	0.0208333
NODE_43_length_8100_cov_32.115236	3435	3483	117	2	48	0.0416667
NODE_43_length_8100_cov_32.115236	3435	3483	119	2	48	0.0416667
NODE_43_length_8100_cov_32.115236	3435	3483	123	1	48	0.0208333
NODE_43_length_8100_cov_32.115236	3435	3483	127	1	48	0.0208333
NODE_43_length_8100_cov_32.115236	3435	3483	129	1	48	0.0208333
NODE_43_length_8100_cov_32.115236	3435	3483	135	1	48	0.0208333
NODE_43_length_8100_cov_32.115236	3435	3483	138	1	48	0.0208333
NODE_43_length_8100_cov_32.115236	3435	3483	146	1	48	0.0208333
NODE_43_length_8100_cov_32.115236	3435	3483	157	1	48	0.0208333
NODE_43_length_8100_cov_32.115236	3435	3483	158	1	48	0.0208333
NODE_43_length_8100_cov_32.115236	3435	3483	159	1	48	0.0208333
NODE_43_length_8100_cov_32.115236	3435	3483	173	1	48	0.0208333
NODE_43_length_8100_cov_32.115236	3435	3483	174	1	48	0.0208333
NODE_43_length_8100_cov_32.115236	3435	3483	178	1	48	0.0208333
NODE_43_length_8100_cov_32.115236	3435	3483	179	1	48	0.0208333
NODE_43_length_8100_cov_32.115236	3435	3483	191	1	48	0.0208333
NODE_43_length_8100_cov_32.115236	3435	3483	193	1	48	0.0208333
NODE_43_length_8100_cov_32.115236	3435	3483	199	1	48	0.0208333
NODE_43_length_8100_cov_32.115236	3435	3483	201	1	48	0.0208333
NODE_43_length_8100_cov_32.115236	3435	3483	209	1	48	0.0208333
NODE_43_length_8100_cov_32.115236	3435	3483	214	1	48	0.0208333
NODE_43_length_8100_cov_32.115236	3435	3483	218	1	48	0.0208333
NODE_43_length_8100_cov_32.115236	3435	3483	221	1	48	0.0208333
NODE_43_length_8100_cov_32.115236	3435	3483	231	1	48	0.0208333
NODE_43_length_8100_cov_32.115236	3435	3483	238	2	48	0.0416667
NODE_43_length_8100_cov_32.115236	3435	3483	240	1	48	0.0208333
NODE_43_length_8100_cov_32.115236	3435	3483	259	1	48	0.0208333
NODE_43_length_8100_cov_32.115236	3435	3483	269	1	48	0.0208333
NODE_43_length_8100_cov_32.115236	3435	3483	282	1	48	0.0208333
NODE_43_length_8100_cov_32.115236	3435	3483	290	1	48	0.0208333
NODE_43_length_8100_cov_32.115236	3435	3483	299	1	48	0.0208333
NODE_43_length_8100_cov_32.115236	3435	3483	307	1	48	0.0208333
NODE_43_length_8100_cov_32.115236	3435	3483	312	1	48	0.0208333
NODE_43_length_8100_cov_32.115236	3435	3483	316	3	48	0.0625000
NODE_46_length_7962_cov_31.622790	6281	6363	206	1	82	0.0121951
NODE_46_length_7962_cov_31.622790	6281	6363	208	2	82	0.0243902
NODE_46_length_7962_cov_31.622790	6281	6363	209	1	82	0.0121951
NODE_46_length_7962_cov_31.622790	6281	6363	212	1	82	0.0121951
NODE_46_length_7962_cov_31.622790	6281	6363	215	1	82	0.0121951
NODE_46_length_7962_cov_31.622790	6281	6363	224	2	82	0.0243902
NODE_46_length_7962_cov_31.622790	6281	6363	225	1	82	0.0121951
NODE_46_length_7962_cov_31.622790	6281	6363	232	1	82	0.0121951
NODE_46_length_7962_cov_31.622790	6281	6363	233	2	82	0.0243902
NODE_46_length_7962_cov_31.622790	6281	6363	235	2	82	0.0243902
NODE_46_length_7962_cov_31.622790	6281	6363	239	3	82	0.0365854
NODE_46_length_7962_cov_31.622790	6281	6363	242	1	82	0.0121951
NODE_46_length_7962_cov_31.622790	6281	6363	244	3	82	0.0365854
NODE_46_length_7962_cov_31.622790	6281	6363	253	1	82	0.0121951
NODE_46_length_7962_cov_31.622790	6281	6363	255	1	82	0.0121951
NODE_46_length_7962_cov_31.622790	6281	6363	266	1	82	0.0121951
NODE_46_length_7962_cov_31.622790	6281	6363	274	1	82	0.0121951
NODE_46_length_7962_cov_31.622790	6281	6363	280	1	82	0.0121951
NODE_46_length_7962_cov_31.622790	6281	6363	281	1	82	0.0121951
NODE_46_length_7962_cov_31.622790	6281	6363	286	2	82	0.0243902
NODE_46_length_7962_cov_31.622790	6281	6363	296	1	82	0.0121951
NODE_46_length_7962_cov_31.622790	6281	6363	304	1	82	0.0121951
NODE_46_length_7962_cov_31.622790	6281	6363	306	2	82	0.0243902
NODE_46_length_7962_cov_31.622790	6281	6363	308	1	82	0.0121951
NODE_46_length_7962_cov_31.622790	6281	6363	309	4	82	0.0487805
NODE_46_length_7962_cov_31.622790	6281	6363	310	1	82	0.0121951
NODE_46_length_7962_cov_31.622790	6281	6363	313	1	82	0.0121951
NODE_46_length_7962_cov_31.622790	6281	6363	314	1	82	0.0121951
NODE_46_length_7962_cov_31.622790	6281	6363	318	2	82	0.0243902
NODE_46_length_7962_cov_31.622790	6281	6363	319	5	82	0.0609756
NODE_46_length_7962_cov_31.622790	6281	6363	320	1	82	0.0121951
NODE_46_length_7962_cov_31.622790	6281	6363	321	1	82	0.0121951
NODE_46_length_7962_cov_31.622790	6281	6363	323	1	82	0.0121951
NODE_46_length_7962_cov_31.622790	6281	6363	324	3	82	0.0365854
NODE_46_length_7962_cov_31.622790	6281	6363	332	2	82	0.0243902
NODE_46_length_7962_cov_31.622790	6281	6363	334	1	82	0.0121951
NODE_46_length_7962_cov_31.622790	6281	6363	336	1	82	0.0121951
NODE_46_length_7962_cov_31.622790	6281	6363	338	1	82	0.0121951
NODE_46_length_7962_cov_31.622790	6281	6363	339	2	82	0.0243902
NODE_46_length_7962_cov_31.622790	6281	6363	340	2	82	0.0243902
NODE_46_length_7962_cov_31.622790	6281	6363	341	4	82	0.0487805
NODE_46_length_7962_cov_31.622790	6281	6363	344	1	82	0.0121951
NODE_46_length_7962_cov_31.622790	6281	6363	345	1	82	0.0121951
NODE_46_length_7962_cov_31.622790	6281	6363	346	1	82	0.0121951
NODE_46_length_7962_cov_31.622790	6281	6363	350	1	82	0.0121951
NODE_46_length_7962_cov_31.622790	6281	6363	351	1	82	0.0121951
NODE_46_length_7962_cov_31.622790	6281	6363	354	6	82	0.0731707
NODE_46_length_7962_cov_31.622790	6281	6363	356	3	82	0.0365854
NODE_46_length_7962_cov_31.622790	6281	6363	357	1	82	0.0121951
NODE_47_length_7944_cov_12.238496	348	419	2	8	71	0.1126761
NODE_47_length_7944_cov_12.238496	348	419	6	31	71	0.4366197
NODE_47_length_7944_cov_12.238496	348	419	8	5	71	0.0704225
NODE_47_length_7944_cov_12.238496	348	419	9	1	71	0.0140845
NODE_47_length_7944_cov_12.238496	348	419	10	5	71	0.0704225
NODE_47_length_7944_cov_12.238496	348	419	12	4	71	0.0563380
NODE_47_length_7944_cov_12.238496	348	419	16	7	71	0.0985916
NODE_47_length_7944_cov_12.238496	348	419	18	10	71	0.1408451
NODE_48_length_7919_cov_14.554859	2380	2460	0	80	80	1.0000000
NODE_50_length_7830_cov_4.211098	0	52	0	16	52	0.3076923
NODE_50_length_7830_cov_4.211098	0	52	2	4	52	0.0769231
NODE_50_length_7830_cov_4.211098	0	52	4	32	52	0.6153846
NODE_50_length_7830_cov_4.211098	30	105	4	75	75	1.0000000
NODE_52_length_7779_cov_20.230859	7691	7771	0	80	80	1.0000000
NODE_52_length_7779_cov_20.230859	7691	7771	0	80	80	1.0000000
NODE_52_length_7779_cov_20.230859	7691	7761	0	70	70	1.0000000
NODE_52_length_7779_cov_20.230859	7744	7779	0	35	35	1.0000000
NODE_53_length_7765_cov_18.871119	254	322	42	4	68	0.0588235
NODE_53_length_7765_cov_18.871119	254	322	44	7	68	0.1029412
NODE_53_length_7765_cov_18.871119	254	322	45	2	68	0.0294118
NODE_53_length_7765_cov_18.871119	254	322	46	4	68	0.0588235
NODE_53_length_7765_cov_18.871119	254	322	48	1	68	0.0147059
NODE_53_length_7765_cov_18.871119	254	322	50	1	68	0.0147059
NODE_53_length_7765_cov_18.871119	254	322	52	2	68	0.0294118
NODE_53_length_7765_cov_18.871119	254	322	54	2	68	0.0294118
NODE_53_length_7765_cov_18.871119	254	322	57	3	68	0.0441176
NODE_53_length_7765_cov_18.871119	254	322	59	3	68	0.0441176
NODE_53_length_7765_cov_18.871119	254	322	60	1	68	0.0147059
NODE_53_length_7765_cov_18.871119	254	322	61	3	68	0.0441176
NODE_53_length_7765_cov_18.871119	254	322	67	1	68	0.0147059
NODE_53_length_7765_cov_18.871119	254	322	69	1	68	0.0147059
NODE_53_length_7765_cov_18.871119	254	322	71	1	68	0.0147059
NODE_53_length_7765_cov_18.871119	254	322	72	1	68	0.0147059
NODE_53_length_7765_cov_18.871119	254	322	73	3	68	0.0441176
NODE_53_length_7765_cov_18.871119	254	322	77	2	68	0.0294118
NODE_53_length_7765_cov_18.871119	254	322	78	2	68	0.0294118
NODE_53_length_7765_cov_18.871119	254	322	79	1	68	0.0147059
NODE_53_length_7765_cov_18.871119	254	322	82	1	68	0.0147059
NODE_53_length_7765_cov_18.871119	254	322	83	2	68	0.0294118
NODE_53_length_7765_cov_18.871119	254	322	85	8	68	0.1176471
NODE_53_length_7765_cov_18.871119	254	322	86	1	68	0.0147059
NODE_53_length_7765_cov_18.871119	254	322	90	1	68	0.0147059
NODE_53_length_7765_cov_18.871119	254	322	91	2	68	0.0294118
NODE_53_length_7765_cov_18.871119	254	322	102	1	68	0.0147059
NODE_53_length_7765_cov_18.871119	254	322	103	1	68	0.0147059
NODE_53_length_7765_cov_18.871119	254	322	109	1	68	0.0147059
NODE_53_length_7765_cov_18.871119	254	322	110	1	68	0.0147059
NODE_53_length_7765_cov_18.871119	254	322	112	1	68	0.0147059
NODE_53_length_7765_cov_18.871119	254	322	119	2	68	0.0294118
NODE_53_length_7765_cov_18.871119	254	322	123	1	68	0.0147059
NODE_53_length_7765_cov_18.871119	353	433	53	1	80	0.0125000
NODE_53_length_7765_cov_18.871119	353	433	57	1	80	0.0125000
NODE_53_length_7765_cov_18.871119	353	433	63	2	80	0.0250000
NODE_53_length_7765_cov_18.871119	353	433	65	7	80	0.0875000
NODE_53_length_7765_cov_18.871119	353	433	72	3	80	0.0375000
NODE_53_length_7765_cov_18.871119	353	433	76	2	80	0.0250000
NODE_53_length_7765_cov_18.871119	353	433	78	1	80	0.0125000
NODE_53_length_7765_cov_18.871119	353	433	82	5	80	0.0625000
NODE_53_length_7765_cov_18.871119	353	433	86	1	80	0.0125000
NODE_53_length_7765_cov_18.871119	353	433	93	1	80	0.0125000
NODE_53_length_7765_cov_18.871119	353	433	95	2	80	0.0250000
NODE_53_length_7765_cov_18.871119	353	433	97	2	80	0.0250000
NODE_53_length_7765_cov_18.871119	353	433	99	1	80	0.0125000
NODE_53_length_7765_cov_18.871119	353	433	107	1	80	0.0125000
NODE_53_length_7765_cov_18.871119	353	433	111	1	80	0.0125000
NODE_53_length_7765_cov_18.871119	353	433	113	4	80	0.0500000
NODE_53_length_7765_cov_18.871119	353	433	117	2	80	0.0250000
NODE_53_length_7765_cov_18.871119	353	433	120	1	80	0.0125000
NODE_53_length_7765_cov_18.871119	353	433	121	1	80	0.0125000
NODE_53_length_7765_cov_18.871119	353	433	122	2	80	0.0250000
NODE_53_length_7765_cov_18.871119	353	433	123	3	80	0.0375000
NODE_53_length_7765_cov_18.871119	353	433	124	2	80	0.0250000
NODE_53_length_7765_cov_18.871119	353	433	125	3	80	0.0375000
NODE_53_length_7765_cov_18.871119	353	433	126	4	80	0.0500000
NODE_53_length_7765_cov_18.871119	353	433	127	7	80	0.0875000
NODE_53_length_7765_cov_18.871119	353	433	130	6	80	0.0750000
NODE_53_length_7765_cov_18.871119	353	433	131	1	80	0.0125000
NODE_53_length_7765_cov_18.871119	353	433	133	2	80	0.0250000
NODE_53_length_7765_cov_18.871119	353	433	134	5	80	0.0625000
NODE_53_length_7765_cov_18.871119	353	433	135	1	80	0.0125000
NODE_53_length_7765_cov_18.871119	353	433	138	2	80	0.0250000
NODE_53_length_7765_cov_18.871119	353	433	139	2	80	0.0250000
NODE_53_length_7765_cov_18.871119	353	433	140	1	80	0.0125000
NODE_61_length_7411_cov_74.967314	2283	2347	0	64	64	1.0000000
NODE_61_length_7411_cov_74.967314	4725	4789	0	64	64	1.0000000
NODE_64_length_7305_cov_3.696087	971	1019	4	48	48	1.0000000
NODE_64_length_7305_cov_3.696087	7142	7190	2	48	48	1.0000000
NODE_66_length_7261_cov_12.433398	2313	2395	117	2	82	0.0243902
NODE_66_length_7261_cov_12.433398	2313	2395	119	3	82	0.0365854
NODE_66_length_7261_cov_12.433398	2313	2395	120	5	82	0.0609756
NODE_66_length_7261_cov_12.433398	2313	2395	121	7	82	0.0853659
NODE_66_length_7261_cov_12.433398	2313	2395	122	3	82	0.0365854
NODE_66_length_7261_cov_12.433398	2313	2395	123	2	82	0.0243902
NODE_66_length_7261_cov_12.433398	2313	2395	124	2	82	0.0243902
NODE_66_length_7261_cov_12.433398	2313	2395	126	3	82	0.0365854
NODE_66_length_7261_cov_12.433398	2313	2395	127	1	82	0.0121951
NODE_66_length_7261_cov_12.433398	2313	2395	128	2	82	0.0243902
NODE_66_length_7261_cov_12.433398	2313	2395	130	7	82	0.0853659
NODE_66_length_7261_cov_12.433398	2313	2395	132	1	82	0.0121951
NODE_66_length_7261_cov_12.433398	2313	2395	133	1	82	0.0121951
NODE_66_length_7261_cov_12.433398	2313	2395	134	3	82	0.0365854
NODE_66_length_7261_cov_12.433398	2313	2395	138	1	82	0.0121951
NODE_66_length_7261_cov_12.433398	2313	2395	140	2	82	0.0243902
NODE_66_length_7261_cov_12.433398	2313	2395	144	1	82	0.0121951
NODE_66_length_7261_cov_12.433398	2313	2395	146	1	82	0.0121951
NODE_66_length_7261_cov_12.433398	2313	2395	147	1	82	0.0121951
NODE_66_length_7261_cov_12.433398	2313	2395	148	2	82	0.0243902
NODE_66_length_7261_cov_12.433398	2313	2395	149	1	82	0.0121951
NODE_66_length_7261_cov_12.433398	2313	2395	151	2	82	0.0243902
NODE_66_length_7261_cov_12.433398	2313	2395	153	1	82	0.0121951
NODE_66_length_7261_cov_12.433398	2313	2395	155	2	82	0.0243902
NODE_66_length_7261_cov_12.433398	2313	2395	156	1	82	0.0121951
NODE_66_length_7261_cov_12.433398	2313	2395	157	3	82	0.0365854
NODE_66_length_7261_cov_12.433398	2313	2395	158	1	82	0.0121951
NODE_66_length_7261_cov_12.433398	2313	2395	159	1	82	0.0121951
NODE_66_length_7261_cov_12.433398	2313	2395	162	1	82	0.0121951
NODE_66_length_7261_cov_12.433398	2313	2395	164	1	82	0.0121951
NODE_66_length_7261_cov_12.433398	2313	2395	165	4	82	0.0487805
NODE_66_length_7261_cov_12.433398	2313	2395	166	2	82	0.0243902
NODE_66_length_7261_cov_12.433398	2313	2395	169	1	82	0.0121951
NODE_66_length_7261_cov_12.433398	2313	2395	170	1	82	0.0121951
NODE_66_length_7261_cov_12.433398	2313	2395	174	2	82	0.0243902
NODE_66_length_7261_cov_12.433398	2313	2395	175	1	82	0.0121951
NODE_66_length_7261_cov_12.433398	2313	2395	176	1	82	0.0121951
NODE_66_length_7261_cov_12.433398	2313	2395	177	2	82	0.0243902
NODE_66_length_7261_cov_12.433398	2313	2395	183	2	82	0.0243902
NODE_66_length_7261_cov_12.433398	2313	2395	187	1	82	0.0121951
NODE_66_length_7261_cov_12.433398	2313	2395	193	1	82	0.0121951
NODE_73_length_7036_cov_65.961943	4375	4455	4	3	80	0.0375000
NODE_73_length_7036_cov_65.961943	4375	4455	6	3	80	0.0375000
NODE_73_length_7036_cov_65.961943	4375	4455	8	66	80	0.8250000
NODE_73_length_7036_cov_65.961943	4375	4455	10	8	80	0.1000000
NODE_73_length_7036_cov_65.961943	5538	5618	222	1	80	0.0125000
NODE_73_length_7036_cov_65.961943	5538	5618	223	1	80	0.0125000
NODE_73_length_7036_cov_65.961943	5538	5618	229	3	80	0.0375000
NODE_73_length_7036_cov_65.961943	5538	5618	233	1	80	0.0125000
NODE_73_length_7036_cov_65.961943	5538	5618	234	1	80	0.0125000
NODE_73_length_7036_cov_65.961943	5538	5618	251	1	80	0.0125000
NODE_73_length_7036_cov_65.961943	5538	5618	261	1	80	0.0125000
NODE_73_length_7036_cov_65.961943	5538	5618	263	1	80	0.0125000
NODE_73_length_7036_cov_65.961943	5538	5618	271	1	80	0.0125000
NODE_73_length_7036_cov_65.961943	5538	5618	272	1	80	0.0125000
NODE_73_length_7036_cov_65.961943	5538	5618	284	1	80	0.0125000
NODE_73_length_7036_cov_65.961943	5538	5618	293	1	80	0.0125000
NODE_73_length_7036_cov_65.961943	5538	5618	296	1	80	0.0125000
NODE_73_length_7036_cov_65.961943	5538	5618	301	1	80	0.0125000
NODE_73_length_7036_cov_65.961943	5538	5618	307	1	80	0.0125000
NODE_73_length_7036_cov_65.961943	5538	5618	308	1	80	0.0125000
NODE_73_length_7036_cov_65.961943	5538	5618	312	1	80	0.0125000
NODE_73_length_7036_cov_65.961943	5538	5618	332	1	80	0.0125000
NODE_73_length_7036_cov_65.961943	5538	5618	338	1	80	0.0125000
NODE_73_length_7036_cov_65.961943	5538	5618	339	1	80	0.0125000
NODE_73_length_7036_cov_65.961943	5538	5618	345	1	80	0.0125000
NODE_73_length_7036_cov_65.961943	5538	5618	351	1	80	0.0125000
NODE_73_length_7036_cov_65.961943	5538	5618	355	1	80	0.0125000
NODE_73_length_7036_cov_65.961943	5538	5618	357	1	80	0.0125000
NODE_73_length_7036_cov_65.961943	5538	5618	359	2	80	0.0250000
NODE_73_length_7036_cov_65.961943	5538	5618	361	1	80	0.0125000
NODE_73_length_7036_cov_65.961943	5538	5618	365	1	80	0.0125000
NODE_73_length_7036_cov_65.961943	5538	5618	371	1	80	0.0125000
NODE_73_length_7036_cov_65.961943	5538	5618	374	1	80	0.0125000
NODE_73_length_7036_cov_65.961943	5538	5618	390	1	80	0.0125000
NODE_73_length_7036_cov_65.961943	5538	5618	408	1	80	0.0125000
NODE_73_length_7036_cov_65.961943	5538	5618	421	1	80	0.0125000
NODE_73_length_7036_cov_65.961943	5538	5618	431	1	80	0.0125000
NODE_73_length_7036_cov_65.961943	5538	5618	436	2	80	0.0250000
NODE_73_length_7036_cov_65.961943	5538	5618	441	1	80	0.0125000
NODE_73_length_7036_cov_65.961943	5538	5618	447	1	80	0.0125000
NODE_73_length_7036_cov_65.961943	5538	5618	467	1	80	0.0125000
NODE_73_length_7036_cov_65.961943	5538	5618	472	1	80	0.0125000
NODE_73_length_7036_cov_65.961943	5538	5618	473	1	80	0.0125000
NODE_73_length_7036_cov_65.961943	5538	5618	479	1	80	0.0125000
NODE_73_length_7036_cov_65.961943	5538	5618	485	1	80	0.0125000
NODE_73_length_7036_cov_65.961943	5538	5618	496	1	80	0.0125000
NODE_73_length_7036_cov_65.961943	5538	5618	500	1	80	0.0125000
NODE_73_length_7036_cov_65.961943	5538	5618	502	1	80	0.0125000
NODE_73_length_7036_cov_65.961943	5538	5618	513	1	80	0.0125000
NODE_73_length_7036_cov_65.961943	5538	5618	519	1	80	0.0125000
NODE_73_length_7036_cov_65.961943	5538	5618	522	1	80	0.0125000
NODE_73_length_7036_cov_65.961943	5538	5618	528	1	80	0.0125000
NODE_73_length_7036_cov_65.961943	5538	5618	529	1	80	0.0125000
NODE_73_length_7036_cov_65.961943	5538	5618	537	1	80	0.0125000
NODE_73_length_7036_cov_65.961943	5538	5618	548	1	80	0.0125000
NODE_73_length_7036_cov_65.961943	5538	5618	554	1	80	0.0125000
NODE_73_length_7036_cov_65.961943	5538	5618	563	1	80	0.0125000
NODE_73_length_7036_cov_65.961943	5538	5618	572	1	80	0.0125000
NODE_73_length_7036_cov_65.961943	5538	5618	582	1	80	0.0125000
NODE_73_length_7036_cov_65.961943	5538	5618	584	1	80	0.0125000
NODE_73_length_7036_cov_65.961943	5538	5618	597	1	80	0.0125000
NODE_73_length_7036_cov_65.961943	5538	5618	602	1	80	0.0125000
NODE_73_length_7036_cov_65.961943	5538	5618	612	1	80	0.0125000
NODE_73_length_7036_cov_65.961943	5538	5618	618	2	80	0.0250000
NODE_73_length_7036_cov_65.961943	5538	5618	620	1	80	0.0125000
NODE_73_length_7036_cov_65.961943	5538	5618	622	1	80	0.0125000
NODE_73_length_7036_cov_65.961943	5538	5618	629	1	80	0.0125000
NODE_73_length_7036_cov_65.961943	5538	5618	631	2	80	0.0250000
NODE_73_length_7036_cov_65.961943	5538	5618	632	1	80	0.0125000
NODE_73_length_7036_cov_65.961943	5538	5618	637	1	80	0.0125000
NODE_73_length_7036_cov_65.961943	5538	5618	638	3	80	0.0375000
NODE_73_length_7036_cov_65.961943	5538	5618	650	1	80	0.0125000
NODE_73_length_7036_cov_65.961943	5538	5618	654	1	80	0.0125000
NODE_73_length_7036_cov_65.961943	5538	5618	658	2	80	0.0250000
NODE_73_length_7036_cov_65.961943	5538	5618	661	1	80	0.0125000
NODE_73_length_7036_cov_65.961943	5591	5666	537	1	75	0.0133333
NODE_73_length_7036_cov_65.961943	5591	5666	548	1	75	0.0133333
NODE_73_length_7036_cov_65.961943	5591	5666	554	1	75	0.0133333
NODE_73_length_7036_cov_65.961943	5591	5666	563	1	75	0.0133333
NODE_73_length_7036_cov_65.961943	5591	5666	572	1	75	0.0133333
NODE_73_length_7036_cov_65.961943	5591	5666	582	1	75	0.0133333
NODE_73_length_7036_cov_65.961943	5591	5666	584	1	75	0.0133333
NODE_73_length_7036_cov_65.961943	5591	5666	597	1	75	0.0133333
NODE_73_length_7036_cov_65.961943	5591	5666	602	1	75	0.0133333
NODE_73_length_7036_cov_65.961943	5591	5666	612	1	75	0.0133333
NODE_73_length_7036_cov_65.961943	5591	5666	618	2	75	0.0266667
NODE_73_length_7036_cov_65.961943	5591	5666	620	1	75	0.0133333
NODE_73_length_7036_cov_65.961943	5591	5666	622	1	75	0.0133333
NODE_73_length_7036_cov_65.961943	5591	5666	629	1	75	0.0133333
NODE_73_length_7036_cov_65.961943	5591	5666	631	2	75	0.0266667
NODE_73_length_7036_cov_65.961943	5591	5666	632	1	75	0.0133333
NODE_73_length_7036_cov_65.961943	5591	5666	637	1	75	0.0133333
NODE_73_length_7036_cov_65.961943	5591	5666	638	3	75	0.0400000
NODE_73_length_7036_cov_65.961943	5591	5666	650	1	75	0.0133333
NODE_73_length_7036_cov_65.961943	5591	5666	654	1	75	0.0133333
NODE_73_length_7036_cov_65.961943	5591	5666	656	1	75	0.0133333
NODE_73_length_7036_cov_65.961943	5591	5666	658	2	75	0.0266667
NODE_73_length_7036_cov_65.961943	5591	5666	661	1	75	0.0133333
NODE_73_length_7036_cov_65.961943	5591	5666	665	1	75	0.0133333
NODE_73_length_7036_cov_65.961943	5591	5666	666	1	75	0.0133333
NODE_73_length_7036_cov_65.961943	5591	5666	669	1	75	0.0133333
NODE_73_length_7036_cov_65.961943	5591	5666	688	1	75	0.0133333
NODE_73_length_7036_cov_65.961943	5591	5666	691	3	75	0.0400000
NODE_73_length_7036_cov_65.961943	5591	5666	692	2	75	0.0266667
NODE_73_length_7036_cov_65.961943	5591	5666	695	1	75	0.0133333
NODE_73_length_7036_cov_65.961943	5591	5666	696	1	75	0.0133333
NODE_73_length_7036_cov_65.961943	5591	5666	698	1	75	0.0133333
NODE_73_length_7036_cov_65.961943	5591	5666	699	3	75	0.0400000
NODE_73_length_7036_cov_65.961943	5591	5666	700	2	75	0.0266667
NODE_73_length_7036_cov_65.961943	5591	5666	702	2	75	0.0266667
NODE_73_length_7036_cov_65.961943	5591	5666	705	1	75	0.0133333
NODE_73_length_7036_cov_65.961943	5591	5666	706	1	75	0.0133333
NODE_73_length_7036_cov_65.961943	5591	5666	708	3	75	0.0400000
NODE_73_length_7036_cov_65.961943	5591	5666	712	1	75	0.0133333
NODE_73_length_7036_cov_65.961943	5591	5666	713	1	75	0.0133333
NODE_73_length_7036_cov_65.961943	5591	5666	716	2	75	0.0266667
NODE_73_length_7036_cov_65.961943	5591	5666	720	1	75	0.0133333
NODE_73_length_7036_cov_65.961943	5591	5666	739	1	75	0.0133333
NODE_73_length_7036_cov_65.961943	5591	5666	745	1	75	0.0133333
NODE_73_length_7036_cov_65.961943	5591	5666	766	1	75	0.0133333
NODE_73_length_7036_cov_65.961943	5591	5666	774	1	75	0.0133333
NODE_73_length_7036_cov_65.961943	5591	5666	796	1	75	0.0133333
NODE_73_length_7036_cov_65.961943	5591	5666	798	1	75	0.0133333
NODE_73_length_7036_cov_65.961943	5591	5666	803	1	75	0.0133333
NODE_73_length_7036_cov_65.961943	5591	5666	814	1	75	0.0133333
NODE_73_length_7036_cov_65.961943	5591	5666	819	1	75	0.0133333
NODE_73_length_7036_cov_65.961943	5591	5666	840	1	75	0.0133333
NODE_73_length_7036_cov_65.961943	5591	5666	847	1	75	0.0133333
NODE_73_length_7036_cov_65.961943	5591	5666	871	1	75	0.0133333
NODE_73_length_7036_cov_65.961943	5591	5666	878	1	75	0.0133333
NODE_73_length_7036_cov_65.961943	5591	5666	886	1	75	0.0133333
NODE_73_length_7036_cov_65.961943	5591	5666	895	1	75	0.0133333
NODE_73_length_7036_cov_65.961943	5591	5666	897	1	75	0.0133333
NODE_73_length_7036_cov_65.961943	5591	5666	898	1	75	0.0133333
NODE_73_length_7036_cov_65.961943	5591	5666	902	1	75	0.0133333
NODE_73_length_7036_cov_65.961943	5690	5746	960	1	56	0.0178571
NODE_73_length_7036_cov_65.961943	5690	5746	966	1	56	0.0178571
NODE_73_length_7036_cov_65.961943	5690	5746	967	1	56	0.0178571
NODE_73_length_7036_cov_65.961943	5690	5746	1010	1	56	0.0178571
NODE_73_length_7036_cov_65.961943	5690	5746	1013	1	56	0.0178571
NODE_73_length_7036_cov_65.961943	5690	5746	1016	1	56	0.0178571
NODE_73_length_7036_cov_65.961943	5690	5746	1018	1	56	0.0178571
NODE_73_length_7036_cov_65.961943	5690	5746	1020	1	56	0.0178571
NODE_73_length_7036_cov_65.961943	5690	5746	1026	1	56	0.0178571
NODE_73_length_7036_cov_65.961943	5690	5746	1028	1	56	0.0178571
NODE_73_length_7036_cov_65.961943	5690	5746	1031	1	56	0.0178571
NODE_73_length_7036_cov_65.961943	5690	5746	1036	1	56	0.0178571
NODE_73_length_7036_cov_65.961943	5690	5746	1038	2	56	0.0357143
NODE_73_length_7036_cov_65.961943	5690	5746	1039	3	56	0.0535714
NODE_73_length_7036_cov_65.961943	5690	5746	1041	2	56	0.0357143
NODE_73_length_7036_cov_65.961943	5690	5746	1042	1	56	0.0178571
NODE_73_length_7036_cov_65.961943	5690	5746	1043	1	56	0.0178571
NODE_73_length_7036_cov_65.961943	5690	5746	1044	1	56	0.0178571
NODE_73_length_7036_cov_65.961943	5690	5746	1047	2	56	0.0357143
NODE_73_length_7036_cov_65.961943	5690	5746	1048	2	56	0.0357143
NODE_73_length_7036_cov_65.961943	5690	5746	1049	1	56	0.0178571
NODE_73_length_7036_cov_65.961943	5690	5746	1053	1	56	0.0178571
NODE_73_length_7036_cov_65.961943	5690	5746	1058	2	56	0.0357143
NODE_73_length_7036_cov_65.961943	5690	5746	1059	3	56	0.0535714
NODE_73_length_7036_cov_65.961943	5690	5746	1061	1	56	0.0178571
NODE_73_length_7036_cov_65.961943	5690	5746	1063	1	56	0.0178571
NODE_73_length_7036_cov_65.961943	5690	5746	1064	1	56	0.0178571
NODE_73_length_7036_cov_65.961943	5690	5746	1065	1	56	0.0178571
NODE_73_length_7036_cov_65.961943	5690	5746	1066	1	56	0.0178571
NODE_73_length_7036_cov_65.961943	5690	5746	1068	2	56	0.0357143
NODE_73_length_7036_cov_65.961943	5690	5746	1069	2	56	0.0357143
NODE_73_length_7036_cov_65.961943	5690	5746	1073	1	56	0.0178571
NODE_73_length_7036_cov_65.961943	5690	5746	1075	1	56	0.0178571
NODE_73_length_7036_cov_65.961943	5690	5746	1077	1	56	0.0178571
NODE_73_length_7036_cov_65.961943	5690	5746	1078	2	56	0.0357143
NODE_73_length_7036_cov_65.961943	5690	5746	1079	1	56	0.0178571
NODE_73_length_7036_cov_65.961943	5690	5746	1081	2	56	0.0357143
NODE_73_length_7036_cov_65.961943	5690	5746	1083	1	56	0.0178571
NODE_73_length_7036_cov_65.961943	5690	5746	1088	1	56	0.0178571
NODE_73_length_7036_cov_65.961943	5690	5746	1090	1	56	0.0178571
NODE_73_length_7036_cov_65.961943	5690	5746	1099	1	56	0.0178571
NODE_73_length_7036_cov_65.961943	5690	5746	1107	1	56	0.0178571
NODE_73_length_7036_cov_65.961943	5690	5746	1116	1	56	0.0178571
NODE_73_length_7036_cov_65.961943	6373	6453	6	80	80	1.0000000
NODE_73_length_7036_cov_65.961943	6426	6506	0	31	80	0.3875000
NODE_73_length_7036_cov_65.961943	6426	6506	6	49	80	0.6125000
NODE_74_length_6974_cov_16.058327	976	1056	2	80	80	1.0000000
NODE_74_length_6974_cov_16.058327	1029	1109	2	48	80	0.6000000
NODE_74_length_6974_cov_16.058327	1029	1109	4	26	80	0.3250000
NODE_74_length_6974_cov_16.058327	1029	1109	6	6	80	0.0750000
NODE_80_length_6826_cov_10.483574	4462	4542	0	9	80	0.1125000
NODE_80_length_6826_cov_10.483574	4462	4542	1	1	80	0.0125000
NODE_80_length_6826_cov_10.483574	4462	4542	20	1	80	0.0125000
NODE_80_length_6826_cov_10.483574	4462	4542	21	1	80	0.0125000
NODE_80_length_6826_cov_10.483574	4462	4542	25	1	80	0.0125000
NODE_80_length_6826_cov_10.483574	4462	4542	27	1	80	0.0125000
NODE_80_length_6826_cov_10.483574	4462	4542	29	1	80	0.0125000
NODE_80_length_6826_cov_10.483574	4462	4542	31	9	80	0.1125000
NODE_80_length_6826_cov_10.483574	4462	4542	33	1	80	0.0125000
NODE_80_length_6826_cov_10.483574	4462	4542	35	1	80	0.0125000
NODE_80_length_6826_cov_10.483574	4462	4542	37	2	80	0.0250000
NODE_80_length_6826_cov_10.483574	4462	4542	40	1	80	0.0125000
NODE_80_length_6826_cov_10.483574	4462	4542	42	4	80	0.0500000
NODE_80_length_6826_cov_10.483574	4462	4542	44	3	80	0.0375000
NODE_80_length_6826_cov_10.483574	4462	4542	45	2	80	0.0250000
NODE_80_length_6826_cov_10.483574	4462	4542	51	1	80	0.0125000
NODE_80_length_6826_cov_10.483574	4462	4542	52	1	80	0.0125000
NODE_80_length_6826_cov_10.483574	4462	4542	53	3	80	0.0375000
NODE_80_length_6826_cov_10.483574	4462	4542	55	2	80	0.0250000
NODE_80_length_6826_cov_10.483574	4462	4542	58	1	80	0.0125000
NODE_80_length_6826_cov_10.483574	4462	4542	59	1	80	0.0125000
NODE_80_length_6826_cov_10.483574	4462	4542	61	5	80	0.0625000
NODE_80_length_6826_cov_10.483574	4462	4542	65	6	80	0.0750000
NODE_80_length_6826_cov_10.483574	4462	4542	67	7	80	0.0875000
NODE_80_length_6826_cov_10.483574	4462	4542	72	11	80	0.1375000
NODE_80_length_6826_cov_10.483574	4462	4542	74	1	80	0.0125000
NODE_80_length_6826_cov_10.483574	4462	4542	77	1	80	0.0125000
NODE_80_length_6826_cov_10.483574	4462	4542	79	2	80	0.0250000
NODE_80_length_6826_cov_10.483574	4515	4595	65	5	80	0.0625000
NODE_80_length_6826_cov_10.483574	4515	4595	67	7	80	0.0875000
NODE_80_length_6826_cov_10.483574	4515	4595	72	11	80	0.1375000
NODE_80_length_6826_cov_10.483574	4515	4595	74	1	80	0.0125000
NODE_80_length_6826_cov_10.483574	4515	4595	77	1	80	0.0125000
NODE_80_length_6826_cov_10.483574	4515	4595	78	5	80	0.0625000
NODE_80_length_6826_cov_10.483574	4515	4595	79	5	80	0.0625000
NODE_80_length_6826_cov_10.483574	4515	4595	81	18	80	0.2250000
NODE_80_length_6826_cov_10.483574	4515	4595	84	16	80	0.2000000
NODE_80_length_6826_cov_10.483574	4515	4595	86	6	80	0.0750000
NODE_80_length_6826_cov_10.483574	4515	4595	88	5	80	0.0625000
NODE_81_length_6816_cov_2.820753	6726	6801	0	75	75	1.0000000
NODE_81_length_6816_cov_2.820753	6774	6816	0	42	42	1.0000000
NODE_84_length_6744_cov_6.222272	5	85	0	80	80	1.0000000
NODE_84_length_6744_cov_6.222272	58	138	0	43	80	0.5375000
NODE_84_length_6744_cov_6.222272	58	138	2	37	80	0.4625000
NODE_84_length_6744_cov_6.222272	6650	6730	0	48	80	0.6000000
NODE_84_length_6744_cov_6.222272	6650	6730	2	32	80	0.4000000
NODE_84_length_6744_cov_6.222272	6703	6744	0	41	41	1.0000000
NODE_86_length_6733_cov_88.965029	3141	3221	0	80	80	1.0000000
NODE_86_length_6733_cov_88.965029	3194	3274	0	80	80	1.0000000
NODE_86_length_6733_cov_88.965029	3270	3350	0	80	80	1.0000000
NODE_86_length_6733_cov_88.965029	3323	3403	0	80	80	1.0000000
NODE_90_length_6627_cov_9.440564	350	430	0	80	80	1.0000000
NODE_90_length_6627_cov_9.440564	403	483	0	80	80	1.0000000
NODE_95_length_6507_cov_95.786049	171	247	0	73	76	0.9605263
NODE_95_length_6507_cov_95.786049	171	247	3	1	76	0.0131579
NODE_95_length_6507_cov_95.786049	171	247	7	1	76	0.0131579
NODE_95_length_6507_cov_95.786049	171	247	61	1	76	0.0131579
NODE_96_length_6497_cov_2.677399	366	436	4	19	70	0.2714286
NODE_96_length_6497_cov_2.677399	366	436	6	51	70	0.7285714
NODE_96_length_6497_cov_2.677399	409	444	0	1	35	0.0285714
NODE_96_length_6497_cov_2.677399	409	444	4	26	35	0.7428572
NODE_96_length_6497_cov_2.677399	409	444	6	8	35	0.2285714
NODE_97_length_6450_cov_26.108172	5024	5104	4	61	80	0.7625000
NODE_97_length_6450_cov_26.108172	5024	5104	6	19	80	0.2375000
NODE_109_length_6171_cov_36.061100	3743	3813	18	3	70	0.0428571
NODE_109_length_6171_cov_36.061100	3743	3813	20	1	70	0.0142857
NODE_109_length_6171_cov_36.061100	3743	3813	22	3	70	0.0428571
NODE_109_length_6171_cov_36.061100	3743	3813	27	2	70	0.0285714
NODE_109_length_6171_cov_36.061100	3743	3813	31	3	70	0.0428571
NODE_109_length_6171_cov_36.061100	3743	3813	33	10	70	0.1428571
NODE_109_length_6171_cov_36.061100	3743	3813	34	3	70	0.0428571
NODE_109_length_6171_cov_36.061100	3743	3813	36	3	70	0.0428571
NODE_109_length_6171_cov_36.061100	3743	3813	38	17	70	0.2428571
NODE_109_length_6171_cov_36.061100	3743	3813	46	12	70	0.1714286
NODE_109_length_6171_cov_36.061100	3743	3813	48	1	70	0.0142857
NODE_109_length_6171_cov_36.061100	3743	3813	50	3	70	0.0428571
NODE_109_length_6171_cov_36.061100	3743	3813	52	1	70	0.0142857
NODE_109_length_6171_cov_36.061100	3743	3813	53	8	70	0.1142857
NODE_109_length_6171_cov_36.061100	3798	3851	30	2	53	0.0377358
NODE_109_length_6171_cov_36.061100	3798	3851	31	1	53	0.0188679
NODE_109_length_6171_cov_36.061100	3798	3851	33	3	53	0.0566038
NODE_109_length_6171_cov_36.061100	3798	3851	39	1	53	0.0188679
NODE_109_length_6171_cov_36.061100	3798	3851	42	1	53	0.0188679
NODE_109_length_6171_cov_36.061100	3798	3851	43	2	53	0.0377358
NODE_109_length_6171_cov_36.061100	3798	3851	44	1	53	0.0188679
NODE_109_length_6171_cov_36.061100	3798	3851	45	1	53	0.0188679
NODE_109_length_6171_cov_36.061100	3798	3851	46	2	53	0.0377358
NODE_109_length_6171_cov_36.061100	3798	3851	47	1	53	0.0188679
NODE_109_length_6171_cov_36.061100	3798	3851	48	9	53	0.1698113
NODE_109_length_6171_cov_36.061100	3798	3851	49	2	53	0.0377358
NODE_109_length_6171_cov_36.061100	3798	3851	50	4	53	0.0754717
NODE_109_length_6171_cov_36.061100	3798	3851	51	1	53	0.0188679
NODE_109_length_6171_cov_36.061100	3798	3851	52	3	53	0.0566038
NODE_109_length_6171_cov_36.061100	3798	3851	53	17	53	0.3207547
NODE_109_length_6171_cov_36.061100	3798	3851	55	1	53	0.0188679
NODE_109_length_6171_cov_36.061100	3798	3851	57	1	53	0.0188679
NODE_109_length_6171_cov_36.061100	4552	4596	429	2	44	0.0454545
NODE_109_length_6171_cov_36.061100	4552	4596	430	1	44	0.0227273
NODE_109_length_6171_cov_36.061100	4552	4596	431	2	44	0.0454545
NODE_109_length_6171_cov_36.061100	4552	4596	432	2	44	0.0454545
NODE_109_length_6171_cov_36.061100	4552	4596	433	2	44	0.0454545
NODE_109_length_6171_cov_36.061100	4552	4596	434	2	44	0.0454545
NODE_109_length_6171_cov_36.061100	4552	4596	435	2	44	0.0454545
NODE_109_length_6171_cov_36.061100	4552	4596	436	4	44	0.0909091
NODE_109_length_6171_cov_36.061100	4552	4596	437	2	44	0.0454545
NODE_109_length_6171_cov_36.061100	4552	4596	438	2	44	0.0454545
NODE_109_length_6171_cov_36.061100	4552	4596	439	5	44	0.1136364
NODE_109_length_6171_cov_36.061100	4552	4596	440	4	44	0.0909091
NODE_109_length_6171_cov_36.061100	4552	4596	441	2	44	0.0454545
NODE_109_length_6171_cov_36.061100	4552	4596	443	1	44	0.0227273
NODE_109_length_6171_cov_36.061100	4552	4596	444	3	44	0.0681818
NODE_109_length_6171_cov_36.061100	4552	4596	446	1	44	0.0227273
NODE_109_length_6171_cov_36.061100	4552	4596	448	1	44	0.0227273
NODE_109_length_6171_cov_36.061100	4552	4596	450	1	44	0.0227273
NODE_109_length_6171_cov_36.061100	4552	4596	451	1	44	0.0227273
NODE_109_length_6171_cov_36.061100	4552	4596	452	1	44	0.0227273
NODE_109_length_6171_cov_36.061100	4552	4596	454	1	44	0.0227273
NODE_109_length_6171_cov_36.061100	4552	4596	456	2	44	0.0454545
NODE_109_length_6171_cov_36.061100	4569	4649	410	1	80	0.0125000
NODE_109_length_6171_cov_36.061100	4569	4649	414	1	80	0.0125000
NODE_109_length_6171_cov_36.061100	4569	4649	416	1	80	0.0125000
NODE_109_length_6171_cov_36.061100	4569	4649	419	2	80	0.0250000
NODE_109_length_6171_cov_36.061100	4569	4649	420	1	80	0.0125000
NODE_109_length_6171_cov_36.061100	4569	4649	421	3	80	0.0375000
NODE_109_length_6171_cov_36.061100	4569	4649	422	7	80	0.0875000
NODE_109_length_6171_cov_36.061100	4569	4649	423	7	80	0.0875000
NODE_109_length_6171_cov_36.061100	4569	4649	424	2	80	0.0250000
NODE_109_length_6171_cov_36.061100	4569	4649	425	3	80	0.0375000
NODE_109_length_6171_cov_36.061100	4569	4649	426	2	80	0.0250000
NODE_109_length_6171_cov_36.061100	4569	4649	427	2	80	0.0250000
NODE_109_length_6171_cov_36.061100	4569	4649	428	1	80	0.0125000
NODE_109_length_6171_cov_36.061100	4569	4649	429	5	80	0.0625000
NODE_109_length_6171_cov_36.061100	4569	4649	430	1	80	0.0125000
NODE_109_length_6171_cov_36.061100	4569	4649	431	5	80	0.0625000
NODE_109_length_6171_cov_36.061100	4569	4649	432	2	80	0.0250000
NODE_109_length_6171_cov_36.061100	4569	4649	433	1	80	0.0125000
NODE_109_length_6171_cov_36.061100	4569	4649	434	1	80	0.0125000
NODE_109_length_6171_cov_36.061100	4569	4649	436	4	80	0.0500000
NODE_109_length_6171_cov_36.061100	4569	4649	438	3	80	0.0375000
NODE_109_length_6171_cov_36.061100	4569	4649	439	5	80	0.0625000
NODE_109_length_6171_cov_36.061100	4569	4649	440	4	80	0.0500000
NODE_109_length_6171_cov_36.061100	4569	4649	441	3	80	0.0375000
NODE_109_length_6171_cov_36.061100	4569	4649	443	1	80	0.0125000
NODE_109_length_6171_cov_36.061100	4569	4649	444	2	80	0.0250000
NODE_109_length_6171_cov_36.061100	4569	4649	445	1	80	0.0125000
NODE_109_length_6171_cov_36.061100	4569	4649	446	1	80	0.0125000
NODE_109_length_6171_cov_36.061100	4569	4649	447	3	80	0.0375000
NODE_109_length_6171_cov_36.061100	4569	4649	448	2	80	0.0250000
NODE_109_length_6171_cov_36.061100	4569	4649	450	1	80	0.0125000
NODE_109_length_6171_cov_36.061100	4569	4649	452	1	80	0.0125000
NODE_109_length_6171_cov_36.061100	4569	4649	454	1	80	0.0125000
NODE_109_length_6171_cov_36.061100	5742	5788	0	46	46	1.0000000
NODE_109_length_6171_cov_36.061100	5761	5841	0	80	80	1.0000000
NODE_110_length_6148_cov_58.915358	5602	5682	0	80	80	1.0000000
NODE_110_length_6148_cov_58.915358	5655	5735	0	61	80	0.7625000
NODE_110_length_6148_cov_58.915358	5655	5735	2	19	80	0.2375000
NODE_112_length_6026_cov_17.775772	4124	4204	0	6	80	0.0750000
NODE_112_length_6026_cov_17.775772	4124	4204	2	74	80	0.9250000
NODE_112_length_6026_cov_17.775772	4177	4257	0	59	80	0.7375000
NODE_112_length_6026_cov_17.775772	4177	4257	2	21	80	0.2625000
NODE_112_length_6026_cov_17.775772	4253	4333	0	35	80	0.4375000
NODE_112_length_6026_cov_17.775772	4253	4333	2	3	80	0.0375000
NODE_112_length_6026_cov_17.775772	4253	4333	4	16	80	0.2000000
NODE_112_length_6026_cov_17.775772	4253	4333	6	11	80	0.1375000
NODE_112_length_6026_cov_17.775772	4253	4333	8	7	80	0.0875000
NODE_112_length_6026_cov_17.775772	4253	4333	10	8	80	0.1000000
NODE_112_length_6026_cov_17.775772	4306	4386	4	1	80	0.0125000
NODE_112_length_6026_cov_17.775772	4306	4386	6	11	80	0.1375000
NODE_112_length_6026_cov_17.775772	4306	4386	8	8	80	0.1000000
NODE_112_length_6026_cov_17.775772	4306	4386	10	17	80	0.2125000
NODE_112_length_6026_cov_17.775772	4306	4386	12	24	80	0.3000000
NODE_112_length_6026_cov_17.775772	4306	4386	14	19	80	0.2375000
NODE_124_length_5810_cov_24.750657	2064	2144	0	56	80	0.7000000
NODE_124_length_5810_cov_24.750657	2064	2144	2	22	80	0.2750000
NODE_124_length_5810_cov_24.750657	2064	2144	4	2	80	0.0250000
NODE_124_length_5810_cov_24.750657	2117	2194	0	77	77	1.0000000
NODE_127_length_5771_cov_10.854549	2814	2883	0	69	69	1.0000000
NODE_128_length_5769_cov_6.878483	5701	5731	0	30	30	1.0000000
NODE_133_length_5728_cov_16.351039	63	134	2	6	71	0.0845070
NODE_133_length_5728_cov_16.351039	63	134	4	34	71	0.4788733
NODE_133_length_5728_cov_16.351039	63	134	6	31	71	0.4366197
NODE_133_length_5728_cov_16.351039	2960	3040	0	27	80	0.3375000
NODE_133_length_5728_cov_16.351039	2960	3040	2	14	80	0.1750000
NODE_133_length_5728_cov_16.351039	2960	3040	4	39	80	0.4875000
NODE_133_length_5728_cov_16.351039	5106	5172	76	3	66	0.0454545
NODE_133_length_5728_cov_16.351039	5106	5172	80	3	66	0.0454545
NODE_133_length_5728_cov_16.351039	5106	5172	82	7	66	0.1060606
NODE_133_length_5728_cov_16.351039	5106	5172	86	1	66	0.0151515
NODE_133_length_5728_cov_16.351039	5106	5172	94	4	66	0.0606061
NODE_133_length_5728_cov_16.351039	5106	5172	100	2	66	0.0303030
NODE_133_length_5728_cov_16.351039	5106	5172	104	2	66	0.0303030
NODE_133_length_5728_cov_16.351039	5106	5172	106	9	66	0.1363636
NODE_133_length_5728_cov_16.351039	5106	5172	108	4	66	0.0606061
NODE_133_length_5728_cov_16.351039	5106	5172	110	12	66	0.1818182
NODE_133_length_5728_cov_16.351039	5106	5172	112	3	66	0.0454545
NODE_133_length_5728_cov_16.351039	5106	5172	116	1	66	0.0151515
NODE_133_length_5728_cov_16.351039	5106	5172	118	3	66	0.0454545
NODE_133_length_5728_cov_16.351039	5106	5172	122	1	66	0.0151515
NODE_133_length_5728_cov_16.351039	5106	5172	125	1	66	0.0151515
NODE_133_length_5728_cov_16.351039	5106	5172	127	1	66	0.0151515
NODE_133_length_5728_cov_16.351039	5106	5172	129	1	66	0.0151515
NODE_133_length_5728_cov_16.351039	5106	5172	133	1	66	0.0151515
NODE_133_length_5728_cov_16.351039	5106	5172	139	1	66	0.0151515
NODE_133_length_5728_cov_16.351039	5106	5172	143	1	66	0.0151515
NODE_133_length_5728_cov_16.351039	5106	5172	147	3	66	0.0454545
NODE_133_length_5728_cov_16.351039	5106	5172	149	2	66	0.0303030
NODE_133_length_5728_cov_16.351039	5145	5225	108	4	80	0.0500000
NODE_133_length_5728_cov_16.351039	5145	5225	110	6	80	0.0750000
NODE_133_length_5728_cov_16.351039	5145	5225	112	1	80	0.0125000
NODE_133_length_5728_cov_16.351039	5145	5225	116	1	80	0.0125000
NODE_133_length_5728_cov_16.351039	5145	5225	118	3	80	0.0375000
NODE_133_length_5728_cov_16.351039	5145	5225	122	1	80	0.0125000
NODE_133_length_5728_cov_16.351039	5145	5225	125	1	80	0.0125000
NODE_133_length_5728_cov_16.351039	5145	5225	127	1	80	0.0125000
NODE_133_length_5728_cov_16.351039	5145	5225	129	1	80	0.0125000
NODE_133_length_5728_cov_16.351039	5145	5225	133	1	80	0.0125000
NODE_133_length_5728_cov_16.351039	5145	5225	139	1	80	0.0125000
NODE_133_length_5728_cov_16.351039	5145	5225	143	1	80	0.0125000
NODE_133_length_5728_cov_16.351039	5145	5225	147	3	80	0.0375000
NODE_133_length_5728_cov_16.351039	5145	5225	149	2	80	0.0250000
NODE_133_length_5728_cov_16.351039	5145	5225	151	2	80	0.0250000
NODE_133_length_5728_cov_16.351039	5145	5225	155	1	80	0.0125000
NODE_133_length_5728_cov_16.351039	5145	5225	156	2	80	0.0250000
NODE_133_length_5728_cov_16.351039	5145	5225	157	4	80	0.0500000
NODE_133_length_5728_cov_16.351039	5145	5225	158	4	80	0.0500000
NODE_133_length_5728_cov_16.351039	5145	5225	159	1	80	0.0125000
NODE_133_length_5728_cov_16.351039	5145	5225	162	2	80	0.0250000
NODE_133_length_5728_cov_16.351039	5145	5225	164	2	80	0.0250000
NODE_133_length_5728_cov_16.351039	5145	5225	167	1	80	0.0125000
NODE_133_length_5728_cov_16.351039	5145	5225	172	4	80	0.0500000
NODE_133_length_5728_cov_16.351039	5145	5225	174	2	80	0.0250000
NODE_133_length_5728_cov_16.351039	5145	5225	175	1	80	0.0125000
NODE_133_length_5728_cov_16.351039	5145	5225	182	1	80	0.0125000
NODE_133_length_5728_cov_16.351039	5145	5225	185	2	80	0.0250000
NODE_133_length_5728_cov_16.351039	5145	5225	186	3	80	0.0375000
NODE_133_length_5728_cov_16.351039	5145	5225	187	5	80	0.0625000
NODE_133_length_5728_cov_16.351039	5145	5225	188	1	80	0.0125000
NODE_133_length_5728_cov_16.351039	5145	5225	190	4	80	0.0500000
NODE_133_length_5728_cov_16.351039	5145	5225	192	1	80	0.0125000
NODE_133_length_5728_cov_16.351039	5145	5225	194	4	80	0.0500000
NODE_133_length_5728_cov_16.351039	5145	5225	196	1	80	0.0125000
NODE_133_length_5728_cov_16.351039	5145	5225	198	4	80	0.0500000
NODE_133_length_5728_cov_16.351039	5145	5225	200	1	80	0.0125000
NODE_137_length_5696_cov_20.656244	179	258	0	66	79	0.8354430
NODE_137_length_5696_cov_20.656244	179	258	2	13	79	0.1645570
NODE_137_length_5696_cov_20.656244	231	311	0	80	80	1.0000000
NODE_137_length_5696_cov_20.656244	307	387	0	43	80	0.5375000
NODE_137_length_5696_cov_20.656244	307	387	2	37	80	0.4625000
NODE_137_length_5696_cov_20.656244	360	440	0	7	80	0.0875000
NODE_137_length_5696_cov_20.656244	360	440	2	73	80	0.9125000
NODE_137_length_5696_cov_20.656244	5100	5180	0	80	80	1.0000000
NODE_137_length_5696_cov_20.656244	5153	5233	0	80	80	1.0000000
NODE_137_length_5696_cov_20.656244	5280	5360	0	80	80	1.0000000
NODE_137_length_5696_cov_20.656244	5333	5413	0	80	80	1.0000000
NODE_139_length_5681_cov_68.065030	253	333	0	42	80	0.5250000
NODE_139_length_5681_cov_68.065030	253	333	4	38	80	0.4750000
NODE_139_length_5681_cov_68.065030	306	386	2	1	80	0.0125000
NODE_139_length_5681_cov_68.065030	306	386	4	30	80	0.3750000
NODE_139_length_5681_cov_68.065030	306	386	6	49	80	0.6125000
NODE_139_length_5681_cov_68.065030	4762	4842	97	1	80	0.0125000
NODE_139_length_5681_cov_68.065030	4762	4842	98	2	80	0.0250000
NODE_139_length_5681_cov_68.065030	4762	4842	99	4	80	0.0500000
NODE_139_length_5681_cov_68.065030	4762	4842	103	2	80	0.0250000
NODE_139_length_5681_cov_68.065030	4762	4842	104	1	80	0.0125000
NODE_139_length_5681_cov_68.065030	4762	4842	105	3	80	0.0375000
NODE_139_length_5681_cov_68.065030	4762	4842	106	1	80	0.0125000
NODE_139_length_5681_cov_68.065030	4762	4842	113	1	80	0.0125000
NODE_139_length_5681_cov_68.065030	4762	4842	115	2	80	0.0250000
NODE_139_length_5681_cov_68.065030	4762	4842	122	3	80	0.0375000
NODE_139_length_5681_cov_68.065030	4762	4842	123	1	80	0.0125000
NODE_139_length_5681_cov_68.065030	4762	4842	126	1	80	0.0125000
NODE_139_length_5681_cov_68.065030	4762	4842	127	1	80	0.0125000
NODE_139_length_5681_cov_68.065030	4762	4842	130	5	80	0.0625000
NODE_139_length_5681_cov_68.065030	4762	4842	134	1	80	0.0125000
NODE_139_length_5681_cov_68.065030	4762	4842	135	1	80	0.0125000
NODE_139_length_5681_cov_68.065030	4762	4842	137	6	80	0.0750000
NODE_139_length_5681_cov_68.065030	4762	4842	138	1	80	0.0125000
NODE_139_length_5681_cov_68.065030	4762	4842	140	1	80	0.0125000
NODE_139_length_5681_cov_68.065030	4762	4842	141	1	80	0.0125000
NODE_139_length_5681_cov_68.065030	4762	4842	145	1	80	0.0125000
NODE_139_length_5681_cov_68.065030	4762	4842	146	3	80	0.0375000
NODE_139_length_5681_cov_68.065030	4762	4842	147	7	80	0.0875000
NODE_139_length_5681_cov_68.065030	4762	4842	148	21	80	0.2625000
NODE_139_length_5681_cov_68.065030	4762	4842	149	3	80	0.0375000
NODE_139_length_5681_cov_68.065030	4762	4842	150	6	80	0.0750000
NODE_139_length_5681_cov_68.065030	4762	4842	97	1	80	0.0125000
NODE_139_length_5681_cov_68.065030	4762	4842	98	2	80	0.0250000
NODE_139_length_5681_cov_68.065030	4762	4842	99	4	80	0.0500000
NODE_139_length_5681_cov_68.065030	4762	4842	103	2	80	0.0250000
NODE_139_length_5681_cov_68.065030	4762	4842	104	1	80	0.0125000
NODE_139_length_5681_cov_68.065030	4762	4842	105	3	80	0.0375000
NODE_139_length_5681_cov_68.065030	4762	4842	106	1	80	0.0125000
NODE_139_length_5681_cov_68.065030	4762	4842	113	1	80	0.0125000
NODE_139_length_5681_cov_68.065030	4762	4842	115	2	80	0.0250000
NODE_139_length_5681_cov_68.065030	4762	4842	122	3	80	0.0375000
NODE_139_length_5681_cov_68.065030	4762	4842	123	1	80	0.0125000
NODE_139_length_5681_cov_68.065030	4762	4842	126	1	80	0.0125000
NODE_139_length_5681_cov_68.065030	4762	4842	127	1	80	0.0125000
NODE_139_length_5681_cov_68.065030	4762	4842	130	5	80	0.0625000
NODE_139_length_5681_cov_68.065030	4762	4842	134	1	80	0.0125000
NODE_139_length_5681_cov_68.065030	4762	4842	135	1	80	0.0125000
NODE_139_length_5681_cov_68.065030	4762	4842	137	6	80	0.0750000
NODE_139_length_5681_cov_68.065030	4762	4842	138	1	80	0.0125000
NODE_139_length_5681_cov_68.065030	4762	4842	140	1	80	0.0125000
NODE_139_length_5681_cov_68.065030	4762	4842	141	1	80	0.0125000
NODE_139_length_5681_cov_68.065030	4762	4842	145	1	80	0.0125000
NODE_139_length_5681_cov_68.065030	4762	4842	146	3	80	0.0375000
NODE_139_length_5681_cov_68.065030	4762	4842	147	7	80	0.0875000
NODE_139_length_5681_cov_68.065030	4762	4842	148	21	80	0.2625000
NODE_139_length_5681_cov_68.065030	4762	4842	149	3	80	0.0375000
NODE_139_length_5681_cov_68.065030	4762	4842	150	6	80	0.0750000
NODE_139_length_5681_cov_68.065030	4762	4842	97	1	80	0.0125000
NODE_139_length_5681_cov_68.065030	4762	4842	98	2	80	0.0250000
NODE_139_length_5681_cov_68.065030	4762	4842	99	4	80	0.0500000
NODE_139_length_5681_cov_68.065030	4762	4842	103	2	80	0.0250000
NODE_139_length_5681_cov_68.065030	4762	4842	104	1	80	0.0125000
NODE_139_length_5681_cov_68.065030	4762	4842	105	3	80	0.0375000
NODE_139_length_5681_cov_68.065030	4762	4842	106	1	80	0.0125000
NODE_139_length_5681_cov_68.065030	4762	4842	113	1	80	0.0125000
NODE_139_length_5681_cov_68.065030	4762	4842	115	2	80	0.0250000
NODE_139_length_5681_cov_68.065030	4762	4842	122	3	80	0.0375000
NODE_139_length_5681_cov_68.065030	4762	4842	123	1	80	0.0125000
NODE_139_length_5681_cov_68.065030	4762	4842	126	1	80	0.0125000
NODE_139_length_5681_cov_68.065030	4762	4842	127	1	80	0.0125000
NODE_139_length_5681_cov_68.065030	4762	4842	130	5	80	0.0625000
NODE_139_length_5681_cov_68.065030	4762	4842	134	1	80	0.0125000
NODE_139_length_5681_cov_68.065030	4762	4842	135	1	80	0.0125000
NODE_139_length_5681_cov_68.065030	4762	4842	137	6	80	0.0750000
NODE_139_length_5681_cov_68.065030	4762	4842	138	1	80	0.0125000
NODE_139_length_5681_cov_68.065030	4762	4842	140	1	80	0.0125000
NODE_139_length_5681_cov_68.065030	4762	4842	141	1	80	0.0125000
NODE_139_length_5681_cov_68.065030	4762	4842	145	1	80	0.0125000
NODE_139_length_5681_cov_68.065030	4762	4842	146	3	80	0.0375000
NODE_139_length_5681_cov_68.065030	4762	4842	147	7	80	0.0875000
NODE_139_length_5681_cov_68.065030	4762	4842	148	21	80	0.2625000
NODE_139_length_5681_cov_68.065030	4762	4842	149	3	80	0.0375000
NODE_139_length_5681_cov_68.065030	4762	4842	150	6	80	0.0750000
NODE_139_length_5681_cov_68.065030	4762	4842	97	1	80	0.0125000
NODE_139_length_5681_cov_68.065030	4762	4842	98	2	80	0.0250000
NODE_139_length_5681_cov_68.065030	4762	4842	99	4	80	0.0500000
NODE_139_length_5681_cov_68.065030	4762	4842	103	2	80	0.0250000
NODE_139_length_5681_cov_68.065030	4762	4842	104	1	80	0.0125000
NODE_139_length_5681_cov_68.065030	4762	4842	105	3	80	0.0375000
NODE_139_length_5681_cov_68.065030	4762	4842	106	1	80	0.0125000
NODE_139_length_5681_cov_68.065030	4762	4842	113	1	80	0.0125000
NODE_139_length_5681_cov_68.065030	4762	4842	115	2	80	0.0250000
NODE_139_length_5681_cov_68.065030	4762	4842	122	3	80	0.0375000
NODE_139_length_5681_cov_68.065030	4762	4842	123	1	80	0.0125000
NODE_139_length_5681_cov_68.065030	4762	4842	126	1	80	0.0125000
NODE_139_length_5681_cov_68.065030	4762	4842	127	1	80	0.0125000
NODE_139_length_5681_cov_68.065030	4762	4842	130	5	80	0.0625000
NODE_139_length_5681_cov_68.065030	4762	4842	134	1	80	0.0125000
NODE_139_length_5681_cov_68.065030	4762	4842	135	1	80	0.0125000
NODE_139_length_5681_cov_68.065030	4762	4842	137	6	80	0.0750000
NODE_139_length_5681_cov_68.065030	4762	4842	138	1	80	0.0125000
NODE_139_length_5681_cov_68.065030	4762	4842	140	1	80	0.0125000
NODE_139_length_5681_cov_68.065030	4762	4842	141	1	80	0.0125000
NODE_139_length_5681_cov_68.065030	4762	4842	145	1	80	0.0125000
NODE_139_length_5681_cov_68.065030	4762	4842	146	3	80	0.0375000
NODE_139_length_5681_cov_68.065030	4762	4842	147	7	80	0.0875000
NODE_139_length_5681_cov_68.065030	4762	4842	148	21	80	0.2625000
NODE_139_length_5681_cov_68.065030	4762	4842	149	3	80	0.0375000
NODE_139_length_5681_cov_68.065030	4762	4842	150	6	80	0.0750000
NODE_139_length_5681_cov_68.065030	4762	4842	97	1	80	0.0125000
NODE_139_length_5681_cov_68.065030	4762	4842	98	2	80	0.0250000
NODE_139_length_5681_cov_68.065030	4762	4842	99	4	80	0.0500000
NODE_139_length_5681_cov_68.065030	4762	4842	103	2	80	0.0250000
NODE_139_length_5681_cov_68.065030	4762	4842	104	1	80	0.0125000
NODE_139_length_5681_cov_68.065030	4762	4842	105	3	80	0.0375000
NODE_139_length_5681_cov_68.065030	4762	4842	106	1	80	0.0125000
NODE_139_length_5681_cov_68.065030	4762	4842	113	1	80	0.0125000
NODE_139_length_5681_cov_68.065030	4762	4842	115	2	80	0.0250000
NODE_139_length_5681_cov_68.065030	4762	4842	122	3	80	0.0375000
NODE_139_length_5681_cov_68.065030	4762	4842	123	1	80	0.0125000
NODE_139_length_5681_cov_68.065030	4762	4842	126	1	80	0.0125000
NODE_139_length_5681_cov_68.065030	4762	4842	127	1	80	0.0125000
NODE_139_length_5681_cov_68.065030	4762	4842	130	5	80	0.0625000
NODE_139_length_5681_cov_68.065030	4762	4842	134	1	80	0.0125000
NODE_139_length_5681_cov_68.065030	4762	4842	135	1	80	0.0125000
NODE_139_length_5681_cov_68.065030	4762	4842	137	6	80	0.0750000
NODE_139_length_5681_cov_68.065030	4762	4842	138	1	80	0.0125000
NODE_139_length_5681_cov_68.065030	4762	4842	140	1	80	0.0125000
NODE_139_length_5681_cov_68.065030	4762	4842	141	1	80	0.0125000
NODE_139_length_5681_cov_68.065030	4762	4842	145	1	80	0.0125000
NODE_139_length_5681_cov_68.065030	4762	4842	146	3	80	0.0375000
NODE_139_length_5681_cov_68.065030	4762	4842	147	7	80	0.0875000
NODE_139_length_5681_cov_68.065030	4762	4842	148	21	80	0.2625000
NODE_139_length_5681_cov_68.065030	4762	4842	149	3	80	0.0375000
NODE_139_length_5681_cov_68.065030	4762	4842	150	6	80	0.0750000
NODE_139_length_5681_cov_68.065030	4762	4842	97	1	80	0.0125000
NODE_139_length_5681_cov_68.065030	4762	4842	98	2	80	0.0250000
NODE_139_length_5681_cov_68.065030	4762	4842	99	4	80	0.0500000
NODE_139_length_5681_cov_68.065030	4762	4842	103	2	80	0.0250000
NODE_139_length_5681_cov_68.065030	4762	4842	104	1	80	0.0125000
NODE_139_length_5681_cov_68.065030	4762	4842	105	3	80	0.0375000
NODE_139_length_5681_cov_68.065030	4762	4842	106	1	80	0.0125000
NODE_139_length_5681_cov_68.065030	4762	4842	113	1	80	0.0125000
NODE_139_length_5681_cov_68.065030	4762	4842	115	2	80	0.0250000
NODE_139_length_5681_cov_68.065030	4762	4842	122	3	80	0.0375000
NODE_139_length_5681_cov_68.065030	4762	4842	123	1	80	0.0125000
NODE_139_length_5681_cov_68.065030	4762	4842	126	1	80	0.0125000
NODE_139_length_5681_cov_68.065030	4762	4842	127	1	80	0.0125000
NODE_139_length_5681_cov_68.065030	4762	4842	130	5	80	0.0625000
NODE_139_length_5681_cov_68.065030	4762	4842	134	1	80	0.0125000
NODE_139_length_5681_cov_68.065030	4762	4842	135	1	80	0.0125000
NODE_139_length_5681_cov_68.065030	4762	4842	137	6	80	0.0750000
NODE_139_length_5681_cov_68.065030	4762	4842	138	1	80	0.0125000
NODE_139_length_5681_cov_68.065030	4762	4842	140	1	80	0.0125000
NODE_139_length_5681_cov_68.065030	4762	4842	141	1	80	0.0125000
NODE_139_length_5681_cov_68.065030	4762	4842	145	1	80	0.0125000
NODE_139_length_5681_cov_68.065030	4762	4842	146	3	80	0.0375000
NODE_139_length_5681_cov_68.065030	4762	4842	147	7	80	0.0875000
NODE_139_length_5681_cov_68.065030	4762	4842	148	21	80	0.2625000
NODE_139_length_5681_cov_68.065030	4762	4842	149	3	80	0.0375000
NODE_139_length_5681_cov_68.065030	4762	4842	150	6	80	0.0750000
NODE_139_length_5681_cov_68.065030	4769	4839	99	4	70	0.0571429
NODE_139_length_5681_cov_68.065030	4769	4839	103	2	70	0.0285714
NODE_139_length_5681_cov_68.065030	4769	4839	104	1	70	0.0142857
NODE_139_length_5681_cov_68.065030	4769	4839	105	3	70	0.0428571
NODE_139_length_5681_cov_68.065030	4769	4839	106	1	70	0.0142857
NODE_139_length_5681_cov_68.065030	4769	4839	113	1	70	0.0142857
NODE_139_length_5681_cov_68.065030	4769	4839	115	2	70	0.0285714
NODE_139_length_5681_cov_68.065030	4769	4839	122	3	70	0.0428571
NODE_139_length_5681_cov_68.065030	4769	4839	123	1	70	0.0142857
NODE_139_length_5681_cov_68.065030	4769	4839	126	1	70	0.0142857
NODE_139_length_5681_cov_68.065030	4769	4839	127	1	70	0.0142857
NODE_139_length_5681_cov_68.065030	4769	4839	130	5	70	0.0714286
NODE_139_length_5681_cov_68.065030	4769	4839	134	1	70	0.0142857
NODE_139_length_5681_cov_68.065030	4769	4839	135	1	70	0.0142857
NODE_139_length_5681_cov_68.065030	4769	4839	137	6	70	0.0857143
NODE_139_length_5681_cov_68.065030	4769	4839	138	1	70	0.0142857
NODE_139_length_5681_cov_68.065030	4769	4839	140	1	70	0.0142857
NODE_139_length_5681_cov_68.065030	4769	4839	141	1	70	0.0142857
NODE_139_length_5681_cov_68.065030	4769	4839	145	1	70	0.0142857
NODE_139_length_5681_cov_68.065030	4769	4839	146	3	70	0.0428571
NODE_139_length_5681_cov_68.065030	4769	4839	147	7	70	0.1000000
NODE_139_length_5681_cov_68.065030	4769	4839	148	14	70	0.2000000
NODE_139_length_5681_cov_68.065030	4769	4839	149	3	70	0.0428571
NODE_139_length_5681_cov_68.065030	4769	4839	150	6	70	0.0857143
NODE_139_length_5681_cov_68.065030	4771	4842	97	1	71	0.0140845
NODE_139_length_5681_cov_68.065030	4771	4842	98	2	71	0.0281690
NODE_139_length_5681_cov_68.065030	4771	4842	99	4	71	0.0563380
NODE_139_length_5681_cov_68.065030	4771	4842	103	2	71	0.0281690
NODE_139_length_5681_cov_68.065030	4771	4842	104	1	71	0.0140845
NODE_139_length_5681_cov_68.065030	4771	4842	105	3	71	0.0422535
NODE_139_length_5681_cov_68.065030	4771	4842	106	1	71	0.0140845
NODE_139_length_5681_cov_68.065030	4771	4842	113	1	71	0.0140845
NODE_139_length_5681_cov_68.065030	4771	4842	115	2	71	0.0281690
NODE_139_length_5681_cov_68.065030	4771	4842	122	3	71	0.0422535
NODE_139_length_5681_cov_68.065030	4771	4842	123	1	71	0.0140845
NODE_139_length_5681_cov_68.065030	4771	4842	126	1	71	0.0140845
NODE_139_length_5681_cov_68.065030	4771	4842	127	1	71	0.0140845
NODE_139_length_5681_cov_68.065030	4771	4842	130	5	71	0.0704225
NODE_139_length_5681_cov_68.065030	4771	4842	134	1	71	0.0140845
NODE_139_length_5681_cov_68.065030	4771	4842	135	1	71	0.0140845
NODE_139_length_5681_cov_68.065030	4771	4842	137	6	71	0.0845070
NODE_139_length_5681_cov_68.065030	4771	4842	138	1	71	0.0140845
NODE_139_length_5681_cov_68.065030	4771	4842	140	1	71	0.0140845
NODE_139_length_5681_cov_68.065030	4771	4842	141	1	71	0.0140845
NODE_139_length_5681_cov_68.065030	4771	4842	145	1	71	0.0140845
NODE_139_length_5681_cov_68.065030	4771	4842	146	3	71	0.0422535
NODE_139_length_5681_cov_68.065030	4771	4842	147	7	71	0.0985916
NODE_139_length_5681_cov_68.065030	4771	4842	148	12	71	0.1690141
NODE_139_length_5681_cov_68.065030	4771	4842	149	3	71	0.0422535
NODE_139_length_5681_cov_68.065030	4771	4842	150	6	71	0.0845070
NODE_139_length_5681_cov_68.065030	4815	4895	45	11	80	0.1375000
NODE_139_length_5681_cov_68.065030	4815	4895	46	1	80	0.0125000
NODE_139_length_5681_cov_68.065030	4815	4895	49	16	80	0.2000000
NODE_139_length_5681_cov_68.065030	4815	4895	54	1	80	0.0125000
NODE_139_length_5681_cov_68.065030	4815	4895	56	4	80	0.0500000
NODE_139_length_5681_cov_68.065030	4815	4895	58	2	80	0.0250000
NODE_139_length_5681_cov_68.065030	4815	4895	66	2	80	0.0250000
NODE_139_length_5681_cov_68.065030	4815	4895	95	3	80	0.0375000
NODE_139_length_5681_cov_68.065030	4815	4895	97	14	80	0.1750000
NODE_139_length_5681_cov_68.065030	4815	4895	98	2	80	0.0250000
NODE_139_length_5681_cov_68.065030	4815	4895	99	4	80	0.0500000
NODE_139_length_5681_cov_68.065030	4815	4895	103	2	80	0.0250000
NODE_139_length_5681_cov_68.065030	4815	4895	104	1	80	0.0125000
NODE_139_length_5681_cov_68.065030	4815	4895	105	3	80	0.0375000
NODE_139_length_5681_cov_68.065030	4815	4895	106	1	80	0.0125000
NODE_139_length_5681_cov_68.065030	4815	4895	113	1	80	0.0125000
NODE_139_length_5681_cov_68.065030	4815	4895	115	2	80	0.0250000
NODE_139_length_5681_cov_68.065030	4815	4895	122	3	80	0.0375000
NODE_139_length_5681_cov_68.065030	4815	4895	123	1	80	0.0125000
NODE_139_length_5681_cov_68.065030	4815	4895	127	1	80	0.0125000
NODE_139_length_5681_cov_68.065030	4815	4895	130	5	80	0.0625000
NODE_139_length_5681_cov_68.065030	4815	4895	45	11	80	0.1375000
NODE_139_length_5681_cov_68.065030	4815	4895	46	1	80	0.0125000
NODE_139_length_5681_cov_68.065030	4815	4895	49	16	80	0.2000000
NODE_139_length_5681_cov_68.065030	4815	4895	54	1	80	0.0125000
NODE_139_length_5681_cov_68.065030	4815	4895	56	4	80	0.0500000
NODE_139_length_5681_cov_68.065030	4815	4895	58	2	80	0.0250000
NODE_139_length_5681_cov_68.065030	4815	4895	66	2	80	0.0250000
NODE_139_length_5681_cov_68.065030	4815	4895	95	3	80	0.0375000
NODE_139_length_5681_cov_68.065030	4815	4895	97	14	80	0.1750000
NODE_139_length_5681_cov_68.065030	4815	4895	98	2	80	0.0250000
NODE_139_length_5681_cov_68.065030	4815	4895	99	4	80	0.0500000
NODE_139_length_5681_cov_68.065030	4815	4895	103	2	80	0.0250000
NODE_139_length_5681_cov_68.065030	4815	4895	104	1	80	0.0125000
NODE_139_length_5681_cov_68.065030	4815	4895	105	3	80	0.0375000
NODE_139_length_5681_cov_68.065030	4815	4895	106	1	80	0.0125000
NODE_139_length_5681_cov_68.065030	4815	4895	113	1	80	0.0125000
NODE_139_length_5681_cov_68.065030	4815	4895	115	2	80	0.0250000
NODE_139_length_5681_cov_68.065030	4815	4895	122	3	80	0.0375000
NODE_139_length_5681_cov_68.065030	4815	4895	123	1	80	0.0125000
NODE_139_length_5681_cov_68.065030	4815	4895	127	1	80	0.0125000
NODE_139_length_5681_cov_68.065030	4815	4895	130	5	80	0.0625000
NODE_139_length_5681_cov_68.065030	4815	4895	45	11	80	0.1375000
NODE_139_length_5681_cov_68.065030	4815	4895	46	1	80	0.0125000
NODE_139_length_5681_cov_68.065030	4815	4895	49	16	80	0.2000000
NODE_139_length_5681_cov_68.065030	4815	4895	54	1	80	0.0125000
NODE_139_length_5681_cov_68.065030	4815	4895	56	4	80	0.0500000
NODE_139_length_5681_cov_68.065030	4815	4895	58	2	80	0.0250000
NODE_139_length_5681_cov_68.065030	4815	4895	66	2	80	0.0250000
NODE_139_length_5681_cov_68.065030	4815	4895	95	3	80	0.0375000
NODE_139_length_5681_cov_68.065030	4815	4895	97	14	80	0.1750000
NODE_139_length_5681_cov_68.065030	4815	4895	98	2	80	0.0250000
NODE_139_length_5681_cov_68.065030	4815	4895	99	4	80	0.0500000
NODE_139_length_5681_cov_68.065030	4815	4895	103	2	80	0.0250000
NODE_139_length_5681_cov_68.065030	4815	4895	104	1	80	0.0125000
NODE_139_length_5681_cov_68.065030	4815	4895	105	3	80	0.0375000
NODE_139_length_5681_cov_68.065030	4815	4895	106	1	80	0.0125000
NODE_139_length_5681_cov_68.065030	4815	4895	113	1	80	0.0125000
NODE_139_length_5681_cov_68.065030	4815	4895	115	2	80	0.0250000
NODE_139_length_5681_cov_68.065030	4815	4895	122	3	80	0.0375000
NODE_139_length_5681_cov_68.065030	4815	4895	123	1	80	0.0125000
NODE_139_length_5681_cov_68.065030	4815	4895	127	1	80	0.0125000
NODE_139_length_5681_cov_68.065030	4815	4895	130	5	80	0.0625000
NODE_139_length_5681_cov_68.065030	4815	4895	45	11	80	0.1375000
NODE_139_length_5681_cov_68.065030	4815	4895	46	1	80	0.0125000
NODE_139_length_5681_cov_68.065030	4815	4895	49	16	80	0.2000000
NODE_139_length_5681_cov_68.065030	4815	4895	54	1	80	0.0125000
NODE_139_length_5681_cov_68.065030	4815	4895	56	4	80	0.0500000
NODE_139_length_5681_cov_68.065030	4815	4895	58	2	80	0.0250000
NODE_139_length_5681_cov_68.065030	4815	4895	66	2	80	0.0250000
NODE_139_length_5681_cov_68.065030	4815	4895	95	3	80	0.0375000
NODE_139_length_5681_cov_68.065030	4815	4895	97	14	80	0.1750000
NODE_139_length_5681_cov_68.065030	4815	4895	98	2	80	0.0250000
NODE_139_length_5681_cov_68.065030	4815	4895	99	4	80	0.0500000
NODE_139_length_5681_cov_68.065030	4815	4895	103	2	80	0.0250000
NODE_139_length_5681_cov_68.065030	4815	4895	104	1	80	0.0125000
NODE_139_length_5681_cov_68.065030	4815	4895	105	3	80	0.0375000
NODE_139_length_5681_cov_68.065030	4815	4895	106	1	80	0.0125000
NODE_139_length_5681_cov_68.065030	4815	4895	113	1	80	0.0125000
NODE_139_length_5681_cov_68.065030	4815	4895	115	2	80	0.0250000
NODE_139_length_5681_cov_68.065030	4815	4895	122	3	80	0.0375000
NODE_139_length_5681_cov_68.065030	4815	4895	123	1	80	0.0125000
NODE_139_length_5681_cov_68.065030	4815	4895	127	1	80	0.0125000
NODE_139_length_5681_cov_68.065030	4815	4895	130	5	80	0.0625000
NODE_139_length_5681_cov_68.065030	4815	4895	45	11	80	0.1375000
NODE_139_length_5681_cov_68.065030	4815	4895	46	1	80	0.0125000
NODE_139_length_5681_cov_68.065030	4815	4895	49	16	80	0.2000000
NODE_139_length_5681_cov_68.065030	4815	4895	54	1	80	0.0125000
NODE_139_length_5681_cov_68.065030	4815	4895	56	4	80	0.0500000
NODE_139_length_5681_cov_68.065030	4815	4895	58	2	80	0.0250000
NODE_139_length_5681_cov_68.065030	4815	4895	66	2	80	0.0250000
NODE_139_length_5681_cov_68.065030	4815	4895	95	3	80	0.0375000
NODE_139_length_5681_cov_68.065030	4815	4895	97	14	80	0.1750000
NODE_139_length_5681_cov_68.065030	4815	4895	98	2	80	0.0250000
NODE_139_length_5681_cov_68.065030	4815	4895	99	4	80	0.0500000
NODE_139_length_5681_cov_68.065030	4815	4895	103	2	80	0.0250000
NODE_139_length_5681_cov_68.065030	4815	4895	104	1	80	0.0125000
NODE_139_length_5681_cov_68.065030	4815	4895	105	3	80	0.0375000
NODE_139_length_5681_cov_68.065030	4815	4895	106	1	80	0.0125000
NODE_139_length_5681_cov_68.065030	4815	4895	113	1	80	0.0125000
NODE_139_length_5681_cov_68.065030	4815	4895	115	2	80	0.0250000
NODE_139_length_5681_cov_68.065030	4815	4895	122	3	80	0.0375000
NODE_139_length_5681_cov_68.065030	4815	4895	123	1	80	0.0125000
NODE_139_length_5681_cov_68.065030	4815	4895	127	1	80	0.0125000
NODE_139_length_5681_cov_68.065030	4815	4895	130	5	80	0.0625000
NODE_139_length_5681_cov_68.065030	4815	4895	45	11	80	0.1375000
NODE_139_length_5681_cov_68.065030	4815	4895	46	1	80	0.0125000
NODE_139_length_5681_cov_68.065030	4815	4895	49	16	80	0.2000000
NODE_139_length_5681_cov_68.065030	4815	4895	54	1	80	0.0125000
NODE_139_length_5681_cov_68.065030	4815	4895	56	4	80	0.0500000
NODE_139_length_5681_cov_68.065030	4815	4895	58	2	80	0.0250000
NODE_139_length_5681_cov_68.065030	4815	4895	66	2	80	0.0250000
NODE_139_length_5681_cov_68.065030	4815	4895	95	3	80	0.0375000
NODE_139_length_5681_cov_68.065030	4815	4895	97	14	80	0.1750000
NODE_139_length_5681_cov_68.065030	4815	4895	98	2	80	0.0250000
NODE_139_length_5681_cov_68.065030	4815	4895	99	4	80	0.0500000
NODE_139_length_5681_cov_68.065030	4815	4895	103	2	80	0.0250000
NODE_139_length_5681_cov_68.065030	4815	4895	104	1	80	0.0125000
NODE_139_length_5681_cov_68.065030	4815	4895	105	3	80	0.0375000
NODE_139_length_5681_cov_68.065030	4815	4895	106	1	80	0.0125000
NODE_139_length_5681_cov_68.065030	4815	4895	113	1	80	0.0125000
NODE_139_length_5681_cov_68.065030	4815	4895	115	2	80	0.0250000
NODE_139_length_5681_cov_68.065030	4815	4895	122	3	80	0.0375000
NODE_139_length_5681_cov_68.065030	4815	4895	123	1	80	0.0125000
NODE_139_length_5681_cov_68.065030	4815	4895	127	1	80	0.0125000
NODE_139_length_5681_cov_68.065030	4815	4895	130	5	80	0.0625000
NODE_139_length_5681_cov_68.065030	4891	4971	0	26	80	0.3250000
NODE_139_length_5681_cov_68.065030	4891	4971	2	31	80	0.3875000
NODE_139_length_5681_cov_68.065030	4891	4971	3	2	80	0.0250000
NODE_139_length_5681_cov_68.065030	4891	4971	24	2	80	0.0250000
NODE_139_length_5681_cov_68.065030	4891	4971	29	2	80	0.0250000
NODE_139_length_5681_cov_68.065030	4891	4971	30	2	80	0.0250000
NODE_139_length_5681_cov_68.065030	4891	4971	34	2	80	0.0250000
NODE_139_length_5681_cov_68.065030	4891	4971	36	2	80	0.0250000
NODE_139_length_5681_cov_68.065030	4891	4971	41	1	80	0.0125000
NODE_139_length_5681_cov_68.065030	4891	4971	44	4	80	0.0500000
NODE_139_length_5681_cov_68.065030	4891	4971	45	6	80	0.0750000
NODE_139_length_5681_cov_68.065030	4944	5007	0	62	63	0.9841270
NODE_139_length_5681_cov_68.065030	4944	5007	2	1	63	0.0158730
NODE_139_length_5681_cov_68.065030	4944	5024	0	79	80	0.9875000
NODE_139_length_5681_cov_68.065030	4944	5024	2	1	80	0.0125000
NODE_140_length_5677_cov_21.613482	1792	1863	6	15	71	0.2112676
NODE_140_length_5677_cov_21.613482	1792	1863	8	17	71	0.2394366
NODE_140_length_5677_cov_21.613482	1792	1863	10	14	71	0.1971831
NODE_140_length_5677_cov_21.613482	1792	1863	12	9	71	0.1267606
NODE_140_length_5677_cov_21.613482	1792	1863	14	5	71	0.0704225
NODE_140_length_5677_cov_21.613482	1792	1863	15	1	71	0.0140845
NODE_140_length_5677_cov_21.613482	1792	1863	16	5	71	0.0704225
NODE_140_length_5677_cov_21.613482	1792	1863	18	1	71	0.0140845
NODE_140_length_5677_cov_21.613482	1792	1863	21	3	71	0.0422535
NODE_140_length_5677_cov_21.613482	1792	1863	23	1	71	0.0140845
NODE_140_length_5677_cov_21.613482	1845	1916	12	15	71	0.2112676
NODE_140_length_5677_cov_21.613482	1845	1916	14	25	71	0.3521127
NODE_140_length_5677_cov_21.613482	1845	1916	16	31	71	0.4366197
NODE_142_length_5631_cov_25.927332	96	176	24	11	80	0.1375000
NODE_142_length_5631_cov_25.927332	96	176	27	1	80	0.0125000
NODE_142_length_5631_cov_25.927332	96	176	28	7	80	0.0875000
NODE_142_length_5631_cov_25.927332	96	176	29	6	80	0.0750000
NODE_142_length_5631_cov_25.927332	96	176	30	42	80	0.5250000
NODE_142_length_5631_cov_25.927332	96	176	32	13	80	0.1625000
NODE_142_length_5631_cov_25.927332	149	229	2	2	80	0.0250000
NODE_142_length_5631_cov_25.927332	149	229	4	7	80	0.0875000
NODE_142_length_5631_cov_25.927332	149	229	6	2	80	0.0250000
NODE_142_length_5631_cov_25.927332	149	229	8	5	80	0.0625000
NODE_142_length_5631_cov_25.927332	149	229	10	11	80	0.1375000
NODE_142_length_5631_cov_25.927332	149	229	18	21	80	0.2625000
NODE_142_length_5631_cov_25.927332	149	229	24	16	80	0.2000000
NODE_142_length_5631_cov_25.927332	149	229	27	1	80	0.0125000
NODE_142_length_5631_cov_25.927332	149	229	28	6	80	0.0750000
NODE_142_length_5631_cov_25.927332	149	229	30	2	80	0.0250000
NODE_142_length_5631_cov_25.927332	149	229	32	7	80	0.0875000
NODE_146_length_5588_cov_40.961377	2793	2873	20	5	80	0.0625000
NODE_146_length_5588_cov_40.961377	2793	2873	22	2	80	0.0250000
NODE_146_length_5588_cov_40.961377	2793	2873	31	2	80	0.0250000
NODE_146_length_5588_cov_40.961377	2793	2873	33	11	80	0.1375000
NODE_146_length_5588_cov_40.961377	2793	2873	35	37	80	0.4625000
NODE_146_length_5588_cov_40.961377	2793	2873	37	9	80	0.1125000
NODE_146_length_5588_cov_40.961377	2793	2873	39	3	80	0.0375000
NODE_146_length_5588_cov_40.961377	2793	2873	41	1	80	0.0125000
NODE_146_length_5588_cov_40.961377	2793	2873	43	10	80	0.1250000
NODE_146_length_5588_cov_40.961377	2846	2926	4	11	80	0.1375000
NODE_146_length_5588_cov_40.961377	2846	2926	6	24	80	0.3000000
NODE_146_length_5588_cov_40.961377	2846	2926	10	3	80	0.0375000
NODE_146_length_5588_cov_40.961377	2846	2926	12	3	80	0.0375000
NODE_146_length_5588_cov_40.961377	2846	2926	16	4	80	0.0500000
NODE_146_length_5588_cov_40.961377	2846	2926	18	3	80	0.0375000
NODE_146_length_5588_cov_40.961377	2846	2926	20	10	80	0.1250000
NODE_146_length_5588_cov_40.961377	2846	2926	22	2	80	0.0250000
NODE_146_length_5588_cov_40.961377	2846	2926	31	2	80	0.0250000
NODE_146_length_5588_cov_40.961377	2846	2926	33	5	80	0.0625000
NODE_146_length_5588_cov_40.961377	2846	2926	35	13	80	0.1625000
NODE_146_length_5588_cov_40.961377	2922	3002	4	13	80	0.1625000
NODE_146_length_5588_cov_40.961377	2922	3002	6	10	80	0.1250000
NODE_146_length_5588_cov_40.961377	2922	3002	7	13	80	0.1625000
NODE_146_length_5588_cov_40.961377	2922	3002	9	14	80	0.1750000
NODE_146_length_5588_cov_40.961377	2922	3002	13	1	80	0.0125000
NODE_146_length_5588_cov_40.961377	2922	3002	14	7	80	0.0875000
NODE_146_length_5588_cov_40.961377	2922	3002	16	1	80	0.0125000
NODE_146_length_5588_cov_40.961377	2922	3002	20	5	80	0.0625000
NODE_146_length_5588_cov_40.961377	2922	3002	27	6	80	0.0750000
NODE_146_length_5588_cov_40.961377	2922	3002	29	7	80	0.0875000
NODE_146_length_5588_cov_40.961377	2922	3002	30	3	80	0.0375000
NODE_146_length_5588_cov_40.961377	2975	3055	14	5	80	0.0625000
NODE_146_length_5588_cov_40.961377	2975	3055	16	1	80	0.0125000
NODE_146_length_5588_cov_40.961377	2975	3055	20	5	80	0.0625000
NODE_146_length_5588_cov_40.961377	2975	3055	27	6	80	0.0750000
NODE_146_length_5588_cov_40.961377	2975	3055	29	7	80	0.0875000
NODE_146_length_5588_cov_40.961377	2975	3055	30	8	80	0.1000000
NODE_146_length_5588_cov_40.961377	2975	3055	32	1	80	0.0125000
NODE_146_length_5588_cov_40.961377	2975	3055	34	4	80	0.0500000
NODE_146_length_5588_cov_40.961377	2975	3055	37	16	80	0.2000000
NODE_146_length_5588_cov_40.961377	2975	3055	41	10	80	0.1250000
NODE_146_length_5588_cov_40.961377	2975	3055	42	4	80	0.0500000
NODE_146_length_5588_cov_40.961377	2975	3055	43	2	80	0.0250000
NODE_146_length_5588_cov_40.961377	2975	3055	45	6	80	0.0750000
NODE_146_length_5588_cov_40.961377	2975	3055	46	5	80	0.0625000
NODE_149_length_5578_cov_5.173389	331	411	0	80	80	1.0000000
NODE_149_length_5578_cov_5.173389	388	464	0	76	76	1.0000000
NODE_150_length_5572_cov_79.124246	1555	1627	31	5	72	0.0694444
NODE_150_length_5572_cov_79.124246	1555	1627	32	3	72	0.0416667
NODE_150_length_5572_cov_79.124246	1555	1627	33	2	72	0.0277778
NODE_150_length_5572_cov_79.124246	1555	1627	35	5	72	0.0694444
NODE_150_length_5572_cov_79.124246	1555	1627	37	1	72	0.0138889
NODE_150_length_5572_cov_79.124246	1555	1627	38	3	72	0.0416667
NODE_150_length_5572_cov_79.124246	1555	1627	39	1	72	0.0138889
NODE_150_length_5572_cov_79.124246	1555	1627	40	1	72	0.0138889
NODE_150_length_5572_cov_79.124246	1555	1627	42	1	72	0.0138889
NODE_150_length_5572_cov_79.124246	1555	1627	43	4	72	0.0555556
NODE_150_length_5572_cov_79.124246	1555	1627	45	2	72	0.0277778
NODE_150_length_5572_cov_79.124246	1555	1627	46	2	72	0.0277778
NODE_150_length_5572_cov_79.124246	1555	1627	48	4	72	0.0555556
NODE_150_length_5572_cov_79.124246	1555	1627	50	2	72	0.0277778
NODE_150_length_5572_cov_79.124246	1555	1627	51	2	72	0.0277778
NODE_150_length_5572_cov_79.124246	1555	1627	60	1	72	0.0138889
NODE_150_length_5572_cov_79.124246	1555	1627	65	1	72	0.0138889
NODE_150_length_5572_cov_79.124246	1555	1627	67	1	72	0.0138889
NODE_150_length_5572_cov_79.124246	1555	1627	69	1	72	0.0138889
NODE_150_length_5572_cov_79.124246	1555	1627	71	3	72	0.0416667
NODE_150_length_5572_cov_79.124246	1555	1627	82	1	72	0.0138889
NODE_150_length_5572_cov_79.124246	1555	1627	85	3	72	0.0416667
NODE_150_length_5572_cov_79.124246	1555	1627	89	1	72	0.0138889
NODE_150_length_5572_cov_79.124246	1555	1627	91	2	72	0.0277778
NODE_150_length_5572_cov_79.124246	1555	1627	112	1	72	0.0138889
NODE_150_length_5572_cov_79.124246	1555	1627	114	1	72	0.0138889
NODE_150_length_5572_cov_79.124246	1555	1627	116	1	72	0.0138889
NODE_150_length_5572_cov_79.124246	1555	1627	125	1	72	0.0138889
NODE_150_length_5572_cov_79.124246	1555	1627	126	1	72	0.0138889
NODE_150_length_5572_cov_79.124246	1555	1627	132	2	72	0.0277778
NODE_150_length_5572_cov_79.124246	1555	1627	133	1	72	0.0138889
NODE_150_length_5572_cov_79.124246	1555	1627	141	1	72	0.0138889
NODE_150_length_5572_cov_79.124246	1555	1627	142	1	72	0.0138889
NODE_150_length_5572_cov_79.124246	1555	1627	143	1	72	0.0138889
NODE_150_length_5572_cov_79.124246	1555	1627	157	1	72	0.0138889
NODE_150_length_5572_cov_79.124246	1555	1627	161	1	72	0.0138889
NODE_150_length_5572_cov_79.124246	1555	1627	163	1	72	0.0138889
NODE_150_length_5572_cov_79.124246	1555	1627	172	1	72	0.0138889
NODE_150_length_5572_cov_79.124246	1555	1627	180	1	72	0.0138889
NODE_150_length_5572_cov_79.124246	1555	1627	188	1	72	0.0138889
NODE_150_length_5572_cov_79.124246	1555	1627	190	1	72	0.0138889
NODE_150_length_5572_cov_79.124246	1555	1627	202	1	72	0.0138889
NODE_150_length_5572_cov_79.124246	1555	1627	208	1	72	0.0138889
NODE_150_length_5572_cov_79.124246	1603	1680	85	1	77	0.0129870
NODE_150_length_5572_cov_79.124246	1603	1680	89	1	77	0.0129870
NODE_150_length_5572_cov_79.124246	1603	1680	91	2	77	0.0259740
NODE_150_length_5572_cov_79.124246	1603	1680	112	1	77	0.0129870
NODE_150_length_5572_cov_79.124246	1603	1680	114	1	77	0.0129870
NODE_150_length_5572_cov_79.124246	1603	1680	116	1	77	0.0129870
NODE_150_length_5572_cov_79.124246	1603	1680	125	1	77	0.0129870
NODE_150_length_5572_cov_79.124246	1603	1680	126	1	77	0.0129870
NODE_150_length_5572_cov_79.124246	1603	1680	132	2	77	0.0259740
NODE_150_length_5572_cov_79.124246	1603	1680	133	1	77	0.0129870
NODE_150_length_5572_cov_79.124246	1603	1680	141	1	77	0.0129870
NODE_150_length_5572_cov_79.124246	1603	1680	142	1	77	0.0129870
NODE_150_length_5572_cov_79.124246	1603	1680	143	1	77	0.0129870
NODE_150_length_5572_cov_79.124246	1603	1680	157	1	77	0.0129870
NODE_150_length_5572_cov_79.124246	1603	1680	161	1	77	0.0129870
NODE_150_length_5572_cov_79.124246	1603	1680	163	1	77	0.0129870
NODE_150_length_5572_cov_79.124246	1603	1680	172	1	77	0.0129870
NODE_150_length_5572_cov_79.124246	1603	1680	180	1	77	0.0129870
NODE_150_length_5572_cov_79.124246	1603	1680	188	1	77	0.0129870
NODE_150_length_5572_cov_79.124246	1603	1680	190	1	77	0.0129870
NODE_150_length_5572_cov_79.124246	1603	1680	202	1	77	0.0129870
NODE_150_length_5572_cov_79.124246	1603	1680	208	2	77	0.0259740
NODE_150_length_5572_cov_79.124246	1603	1680	209	1	77	0.0129870
NODE_150_length_5572_cov_79.124246	1603	1680	212	2	77	0.0259740
NODE_150_length_5572_cov_79.124246	1603	1680	218	1	77	0.0129870
NODE_150_length_5572_cov_79.124246	1603	1680	219	1	77	0.0129870
NODE_150_length_5572_cov_79.124246	1603	1680	221	1	77	0.0129870
NODE_150_length_5572_cov_79.124246	1603	1680	224	1	77	0.0129870
NODE_150_length_5572_cov_79.124246	1603	1680	230	1	77	0.0129870
NODE_150_length_5572_cov_79.124246	1603	1680	231	1	77	0.0129870
NODE_150_length_5572_cov_79.124246	1603	1680	238	2	77	0.0259740
NODE_150_length_5572_cov_79.124246	1603	1680	260	1	77	0.0129870
NODE_150_length_5572_cov_79.124246	1603	1680	262	1	77	0.0129870
NODE_150_length_5572_cov_79.124246	1603	1680	272	1	77	0.0129870
NODE_150_length_5572_cov_79.124246	1603	1680	278	1	77	0.0129870
NODE_150_length_5572_cov_79.124246	1603	1680	293	1	77	0.0129870
NODE_150_length_5572_cov_79.124246	1603	1680	299	1	77	0.0129870
NODE_150_length_5572_cov_79.124246	1603	1680	347	1	77	0.0129870
NODE_150_length_5572_cov_79.124246	1603	1680	363	1	77	0.0129870
NODE_150_length_5572_cov_79.124246	1603	1680	396	1	77	0.0129870
NODE_150_length_5572_cov_79.124246	1603	1680	405	1	77	0.0129870
NODE_150_length_5572_cov_79.124246	1603	1680	420	1	77	0.0129870
NODE_150_length_5572_cov_79.124246	1603	1680	426	1	77	0.0129870
NODE_150_length_5572_cov_79.124246	1603	1680	440	1	77	0.0129870
NODE_150_length_5572_cov_79.124246	1603	1680	475	1	77	0.0129870
NODE_150_length_5572_cov_79.124246	1603	1680	494	1	77	0.0129870
NODE_150_length_5572_cov_79.124246	1603	1680	521	1	77	0.0129870
NODE_150_length_5572_cov_79.124246	1603	1680	540	1	77	0.0129870
NODE_150_length_5572_cov_79.124246	1603	1680	542	1	77	0.0129870
NODE_150_length_5572_cov_79.124246	1603	1680	543	1	77	0.0129870
NODE_150_length_5572_cov_79.124246	1603	1680	547	1	77	0.0129870
NODE_150_length_5572_cov_79.124246	1603	1680	549	1	77	0.0129870
NODE_150_length_5572_cov_79.124246	1603	1680	554	1	77	0.0129870
NODE_150_length_5572_cov_79.124246	1603	1680	560	1	77	0.0129870
NODE_150_length_5572_cov_79.124246	1603	1680	581	1	77	0.0129870
NODE_150_length_5572_cov_79.124246	1603	1680	594	1	77	0.0129870
NODE_150_length_5572_cov_79.124246	1603	1680	597	1	77	0.0129870
NODE_150_length_5572_cov_79.124246	1603	1680	604	2	77	0.0259740
NODE_150_length_5572_cov_79.124246	1603	1680	624	1	77	0.0129870
NODE_150_length_5572_cov_79.124246	1603	1680	638	1	77	0.0129870
NODE_150_length_5572_cov_79.124246	1603	1680	644	2	77	0.0259740
NODE_150_length_5572_cov_79.124246	1603	1680	647	1	77	0.0129870
NODE_150_length_5572_cov_79.124246	1603	1680	659	1	77	0.0129870
NODE_150_length_5572_cov_79.124246	1603	1680	675	1	77	0.0129870
NODE_150_length_5572_cov_79.124246	1603	1680	702	1	77	0.0129870
NODE_150_length_5572_cov_79.124246	1603	1680	733	1	77	0.0129870
NODE_150_length_5572_cov_79.124246	1603	1680	738	1	77	0.0129870
NODE_150_length_5572_cov_79.124246	1603	1680	765	1	77	0.0129870
NODE_150_length_5572_cov_79.124246	1603	1680	776	1	77	0.0129870
NODE_150_length_5572_cov_79.124246	1603	1680	780	1	77	0.0129870
NODE_150_length_5572_cov_79.124246	1637	1717	238	2	80	0.0250000
NODE_150_length_5572_cov_79.124246	1637	1717	260	1	80	0.0125000
NODE_150_length_5572_cov_79.124246	1637	1717	262	1	80	0.0125000
NODE_150_length_5572_cov_79.124246	1637	1717	272	1	80	0.0125000
NODE_150_length_5572_cov_79.124246	1637	1717	278	1	80	0.0125000
NODE_150_length_5572_cov_79.124246	1637	1717	293	1	80	0.0125000
NODE_150_length_5572_cov_79.124246	1637	1717	299	1	80	0.0125000
NODE_150_length_5572_cov_79.124246	1637	1717	347	1	80	0.0125000
NODE_150_length_5572_cov_79.124246	1637	1717	363	1	80	0.0125000
NODE_150_length_5572_cov_79.124246	1637	1717	396	1	80	0.0125000
NODE_150_length_5572_cov_79.124246	1637	1717	405	1	80	0.0125000
NODE_150_length_5572_cov_79.124246	1637	1717	420	1	80	0.0125000
NODE_150_length_5572_cov_79.124246	1637	1717	426	1	80	0.0125000
NODE_150_length_5572_cov_79.124246	1637	1717	440	1	80	0.0125000
NODE_150_length_5572_cov_79.124246	1637	1717	475	1	80	0.0125000
NODE_150_length_5572_cov_79.124246	1637	1717	494	1	80	0.0125000
NODE_150_length_5572_cov_79.124246	1637	1717	521	1	80	0.0125000
NODE_150_length_5572_cov_79.124246	1637	1717	540	1	80	0.0125000
NODE_150_length_5572_cov_79.124246	1637	1717	542	1	80	0.0125000
NODE_150_length_5572_cov_79.124246	1637	1717	543	1	80	0.0125000
NODE_150_length_5572_cov_79.124246	1637	1717	547	1	80	0.0125000
NODE_150_length_5572_cov_79.124246	1637	1717	549	1	80	0.0125000
NODE_150_length_5572_cov_79.124246	1637	1717	554	1	80	0.0125000
NODE_150_length_5572_cov_79.124246	1637	1717	560	1	80	0.0125000
NODE_150_length_5572_cov_79.124246	1637	1717	581	1	80	0.0125000
NODE_150_length_5572_cov_79.124246	1637	1717	594	1	80	0.0125000
NODE_150_length_5572_cov_79.124246	1637	1717	597	1	80	0.0125000
NODE_150_length_5572_cov_79.124246	1637	1717	604	2	80	0.0250000
NODE_150_length_5572_cov_79.124246	1637	1717	624	1	80	0.0125000
NODE_150_length_5572_cov_79.124246	1637	1717	638	1	80	0.0125000
NODE_150_length_5572_cov_79.124246	1637	1717	644	2	80	0.0250000
NODE_150_length_5572_cov_79.124246	1637	1717	647	1	80	0.0125000
NODE_150_length_5572_cov_79.124246	1637	1717	659	1	80	0.0125000
NODE_150_length_5572_cov_79.124246	1637	1717	675	1	80	0.0125000
NODE_150_length_5572_cov_79.124246	1637	1717	702	1	80	0.0125000
NODE_150_length_5572_cov_79.124246	1637	1717	733	1	80	0.0125000
NODE_150_length_5572_cov_79.124246	1637	1717	738	1	80	0.0125000
NODE_150_length_5572_cov_79.124246	1637	1717	765	1	80	0.0125000
NODE_150_length_5572_cov_79.124246	1637	1717	776	1	80	0.0125000
NODE_150_length_5572_cov_79.124246	1637	1717	780	1	80	0.0125000
NODE_150_length_5572_cov_79.124246	1637	1717	796	2	80	0.0250000
NODE_150_length_5572_cov_79.124246	1637	1717	804	1	80	0.0125000
NODE_150_length_5572_cov_79.124246	1637	1717	836	1	80	0.0125000
NODE_150_length_5572_cov_79.124246	1637	1717	837	1	80	0.0125000
NODE_150_length_5572_cov_79.124246	1637	1717	841	1	80	0.0125000
NODE_150_length_5572_cov_79.124246	1637	1717	847	1	80	0.0125000
NODE_150_length_5572_cov_79.124246	1637	1717	856	1	80	0.0125000
NODE_150_length_5572_cov_79.124246	1637	1717	883	1	80	0.0125000
NODE_150_length_5572_cov_79.124246	1637	1717	889	1	80	0.0125000
NODE_150_length_5572_cov_79.124246	1637	1717	898	1	80	0.0125000
NODE_150_length_5572_cov_79.124246	1637	1717	907	1	80	0.0125000
NODE_150_length_5572_cov_79.124246	1637	1717	916	1	80	0.0125000
NODE_150_length_5572_cov_79.124246	1637	1717	917	1	80	0.0125000
NODE_150_length_5572_cov_79.124246	1637	1717	924	1	80	0.0125000
NODE_150_length_5572_cov_79.124246	1637	1717	953	1	80	0.0125000
NODE_150_length_5572_cov_79.124246	1637	1717	955	1	80	0.0125000
NODE_150_length_5572_cov_79.124246	1637	1717	962	1	80	0.0125000
NODE_150_length_5572_cov_79.124246	1637	1717	965	1	80	0.0125000
NODE_150_length_5572_cov_79.124246	1637	1717	966	1	80	0.0125000
NODE_150_length_5572_cov_79.124246	1637	1717	974	1	80	0.0125000
NODE_150_length_5572_cov_79.124246	1637	1717	981	1	80	0.0125000
NODE_150_length_5572_cov_79.124246	1637	1717	983	1	80	0.0125000
NODE_150_length_5572_cov_79.124246	1637	1717	984	2	80	0.0250000
NODE_150_length_5572_cov_79.124246	1637	1717	986	1	80	0.0125000
NODE_150_length_5572_cov_79.124246	1637	1717	987	1	80	0.0125000
NODE_150_length_5572_cov_79.124246	1637	1717	989	1	80	0.0125000
NODE_150_length_5572_cov_79.124246	1637	1717	993	1	80	0.0125000
NODE_150_length_5572_cov_79.124246	1637	1717	995	4	80	0.0500000
NODE_150_length_5572_cov_79.124246	1637	1717	997	1	80	0.0125000
NODE_150_length_5572_cov_79.124246	1637	1717	998	3	80	0.0375000
NODE_150_length_5572_cov_79.124246	1690	1770	645	1	80	0.0125000
NODE_150_length_5572_cov_79.124246	1690	1770	658	1	80	0.0125000
NODE_150_length_5572_cov_79.124246	1690	1770	672	1	80	0.0125000
NODE_150_length_5572_cov_79.124246	1690	1770	691	1	80	0.0125000
NODE_150_length_5572_cov_79.124246	1690	1770	708	1	80	0.0125000
NODE_150_length_5572_cov_79.124246	1690	1770	732	1	80	0.0125000
NODE_150_length_5572_cov_79.124246	1690	1770	740	1	80	0.0125000
NODE_150_length_5572_cov_79.124246	1690	1770	750	1	80	0.0125000
NODE_150_length_5572_cov_79.124246	1690	1770	758	1	80	0.0125000
NODE_150_length_5572_cov_79.124246	1690	1770	768	1	80	0.0125000
NODE_150_length_5572_cov_79.124246	1690	1770	788	1	80	0.0125000
NODE_150_length_5572_cov_79.124246	1690	1770	791	1	80	0.0125000
NODE_150_length_5572_cov_79.124246	1690	1770	793	1	80	0.0125000
NODE_150_length_5572_cov_79.124246	1690	1770	812	1	80	0.0125000
NODE_150_length_5572_cov_79.124246	1690	1770	820	1	80	0.0125000
NODE_150_length_5572_cov_79.124246	1690	1770	835	1	80	0.0125000
NODE_150_length_5572_cov_79.124246	1690	1770	843	2	80	0.0250000
NODE_150_length_5572_cov_79.124246	1690	1770	847	1	80	0.0125000
NODE_150_length_5572_cov_79.124246	1690	1770	849	1	80	0.0125000
NODE_150_length_5572_cov_79.124246	1690	1770	857	1	80	0.0125000
NODE_150_length_5572_cov_79.124246	1690	1770	859	1	80	0.0125000
NODE_150_length_5572_cov_79.124246	1690	1770	865	1	80	0.0125000
NODE_150_length_5572_cov_79.124246	1690	1770	883	1	80	0.0125000
NODE_150_length_5572_cov_79.124246	1690	1770	891	1	80	0.0125000
NODE_150_length_5572_cov_79.124246	1690	1770	898	1	80	0.0125000
NODE_150_length_5572_cov_79.124246	1690	1770	906	1	80	0.0125000
NODE_150_length_5572_cov_79.124246	1690	1770	907	1	80	0.0125000
NODE_150_length_5572_cov_79.124246	1690	1770	916	1	80	0.0125000
NODE_150_length_5572_cov_79.124246	1690	1770	917	1	80	0.0125000
NODE_150_length_5572_cov_79.124246	1690	1770	924	1	80	0.0125000
NODE_150_length_5572_cov_79.124246	1690	1770	945	1	80	0.0125000
NODE_150_length_5572_cov_79.124246	1690	1770	948	1	80	0.0125000
NODE_150_length_5572_cov_79.124246	1690	1770	950	1	80	0.0125000
NODE_150_length_5572_cov_79.124246	1690	1770	953	1	80	0.0125000
NODE_150_length_5572_cov_79.124246	1690	1770	955	1	80	0.0125000
NODE_150_length_5572_cov_79.124246	1690	1770	962	2	80	0.0250000
NODE_150_length_5572_cov_79.124246	1690	1770	964	1	80	0.0125000
NODE_150_length_5572_cov_79.124246	1690	1770	965	1	80	0.0125000
NODE_150_length_5572_cov_79.124246	1690	1770	966	1	80	0.0125000
NODE_150_length_5572_cov_79.124246	1690	1770	974	2	80	0.0250000
NODE_150_length_5572_cov_79.124246	1690	1770	981	2	80	0.0250000
NODE_150_length_5572_cov_79.124246	1690	1770	983	1	80	0.0125000
NODE_150_length_5572_cov_79.124246	1690	1770	984	2	80	0.0250000
NODE_150_length_5572_cov_79.124246	1690	1770	985	2	80	0.0250000
NODE_150_length_5572_cov_79.124246	1690	1770	986	1	80	0.0125000
NODE_150_length_5572_cov_79.124246	1690	1770	987	1	80	0.0125000
NODE_150_length_5572_cov_79.124246	1690	1770	989	1	80	0.0125000
NODE_150_length_5572_cov_79.124246	1690	1770	991	1	80	0.0125000
NODE_150_length_5572_cov_79.124246	1690	1770	993	1	80	0.0125000
NODE_150_length_5572_cov_79.124246	1690	1770	995	4	80	0.0500000
NODE_150_length_5572_cov_79.124246	1690	1770	997	2	80	0.0250000
NODE_150_length_5572_cov_79.124246	1690	1770	998	3	80	0.0375000
NODE_150_length_5572_cov_79.124246	1690	1770	999	1	80	0.0125000
NODE_150_length_5572_cov_79.124246	1690	1770	1000	2	80	0.0250000
NODE_150_length_5572_cov_79.124246	1690	1770	1002	3	80	0.0375000
NODE_150_length_5572_cov_79.124246	1690	1770	1003	1	80	0.0125000
NODE_150_length_5572_cov_79.124246	1690	1770	1004	1	80	0.0125000
NODE_150_length_5572_cov_79.124246	1690	1770	1006	1	80	0.0125000
NODE_150_length_5572_cov_79.124246	1690	1770	1009	1	80	0.0125000
NODE_150_length_5572_cov_79.124246	1690	1770	1010	2	80	0.0250000
NODE_150_length_5572_cov_79.124246	1690	1770	1012	1	80	0.0125000
NODE_150_length_5572_cov_79.124246	1690	1770	1013	3	80	0.0375000
NODE_150_length_5572_cov_79.124246	5130	5210	0	80	80	1.0000000
NODE_150_length_5572_cov_79.124246	5183	5263	0	80	80	1.0000000
NODE_151_length_5557_cov_26.198241	341	414	0	73	73	1.0000000
NODE_151_length_5557_cov_26.198241	394	460	0	66	66	1.0000000
NODE_156_length_5500_cov_35.832438	81	161	0	79	80	0.9875000
NODE_156_length_5500_cov_35.832438	81	161	2	1	80	0.0125000
NODE_156_length_5500_cov_35.832438	134	214	0	26	80	0.3250000
NODE_156_length_5500_cov_35.832438	134	214	2	54	80	0.6750000
NODE_159_length_5470_cov_5.987526	5180	5249	2	69	69	1.0000000
NODE_160_length_5434_cov_14.997751	541	621	0	80	80	1.0000000
NODE_160_length_5434_cov_14.997751	594	674	0	80	80	1.0000000
NODE_160_length_5434_cov_14.997751	2664	2744	0	80	80	1.0000000
NODE_160_length_5434_cov_14.997751	2717	2797	0	80	80	1.0000000
NODE_160_length_5434_cov_14.997751	3041	3093	4	52	52	1.0000000
NODE_160_length_5434_cov_14.997751	3419	3467	14	4	48	0.0833333
NODE_160_length_5434_cov_14.997751	3419	3467	16	44	48	0.9166667
NODE_161_length_5425_cov_15.812242	141	218	50	1	77	0.0129870
NODE_161_length_5425_cov_15.812242	141	218	52	1	77	0.0129870
NODE_161_length_5425_cov_15.812242	141	218	55	2	77	0.0259740
NODE_161_length_5425_cov_15.812242	141	218	57	3	77	0.0389610
NODE_161_length_5425_cov_15.812242	141	218	68	9	77	0.1168831
NODE_161_length_5425_cov_15.812242	141	218	70	1	77	0.0129870
NODE_161_length_5425_cov_15.812242	141	218	72	1	77	0.0129870
NODE_161_length_5425_cov_15.812242	141	218	74	6	77	0.0779221
NODE_161_length_5425_cov_15.812242	141	218	75	1	77	0.0129870
NODE_161_length_5425_cov_15.812242	141	218	76	1	77	0.0129870
NODE_161_length_5425_cov_15.812242	141	218	77	3	77	0.0389610
NODE_161_length_5425_cov_15.812242	141	218	78	4	77	0.0519481
NODE_161_length_5425_cov_15.812242	141	218	79	7	77	0.0909091
NODE_161_length_5425_cov_15.812242	141	218	80	2	77	0.0259740
NODE_161_length_5425_cov_15.812242	141	218	81	2	77	0.0259740
NODE_161_length_5425_cov_15.812242	141	218	82	7	77	0.0909091
NODE_161_length_5425_cov_15.812242	141	218	83	7	77	0.0909091
NODE_161_length_5425_cov_15.812242	141	218	85	2	77	0.0259740
NODE_161_length_5425_cov_15.812242	141	218	87	2	77	0.0259740
NODE_161_length_5425_cov_15.812242	141	218	88	1	77	0.0129870
NODE_161_length_5425_cov_15.812242	141	218	89	4	77	0.0519481
NODE_161_length_5425_cov_15.812242	141	218	90	1	77	0.0129870
NODE_161_length_5425_cov_15.812242	141	218	93	2	77	0.0259740
NODE_161_length_5425_cov_15.812242	141	218	95	7	77	0.0909091
NODE_161_length_5425_cov_15.812242	841	921	2	22	80	0.2750000
NODE_161_length_5425_cov_15.812242	841	921	4	57	80	0.7125000
NODE_161_length_5425_cov_15.812242	841	921	6	1	80	0.0125000
NODE_161_length_5425_cov_15.812242	894	974	0	18	80	0.2250000
NODE_161_length_5425_cov_15.812242	894	974	2	57	80	0.7125000
NODE_161_length_5425_cov_15.812242	894	974	4	5	80	0.0625000
NODE_163_length_5402_cov_5.397322	191	263	8	1	72	0.0138889
NODE_163_length_5402_cov_5.397322	191	263	12	3	72	0.0416667
NODE_163_length_5402_cov_5.397322	191	263	14	5	72	0.0694444
NODE_163_length_5402_cov_5.397322	191	263	16	63	72	0.8750000
NODE_163_length_5402_cov_5.397322	2305	2385	40	7	80	0.0875000
NODE_163_length_5402_cov_5.397322	2305	2385	41	2	80	0.0250000
NODE_163_length_5402_cov_5.397322	2305	2385	44	5	80	0.0625000
NODE_163_length_5402_cov_5.397322	2305	2385	45	1	80	0.0125000
NODE_163_length_5402_cov_5.397322	2305	2385	46	1	80	0.0125000
NODE_163_length_5402_cov_5.397322	2305	2385	47	9	80	0.1125000
NODE_163_length_5402_cov_5.397322	2305	2385	48	3	80	0.0375000
NODE_163_length_5402_cov_5.397322	2305	2385	49	2	80	0.0250000
NODE_163_length_5402_cov_5.397322	2305	2385	50	9	80	0.1125000
NODE_163_length_5402_cov_5.397322	2305	2385	51	6	80	0.0750000
NODE_163_length_5402_cov_5.397322	2305	2385	52	16	80	0.2000000
NODE_163_length_5402_cov_5.397322	2305	2385	53	4	80	0.0500000
NODE_163_length_5402_cov_5.397322	2305	2385	54	12	80	0.1500000
NODE_163_length_5402_cov_5.397322	2305	2385	55	3	80	0.0375000
NODE_163_length_5402_cov_5.397322	2358	2438	30	4	80	0.0500000
NODE_163_length_5402_cov_5.397322	2358	2438	32	18	80	0.2250000
NODE_163_length_5402_cov_5.397322	2358	2438	34	8	80	0.1000000
NODE_163_length_5402_cov_5.397322	2358	2438	36	15	80	0.1875000
NODE_163_length_5402_cov_5.397322	2358	2438	38	1	80	0.0125000
NODE_163_length_5402_cov_5.397322	2358	2438	41	6	80	0.0750000
NODE_163_length_5402_cov_5.397322	2358	2438	43	2	80	0.0250000
NODE_163_length_5402_cov_5.397322	2358	2438	45	2	80	0.0250000
NODE_163_length_5402_cov_5.397322	2358	2438	47	9	80	0.1125000
NODE_163_length_5402_cov_5.397322	2358	2438	49	1	80	0.0125000
NODE_163_length_5402_cov_5.397322	2358	2438	51	1	80	0.0125000
NODE_163_length_5402_cov_5.397322	2358	2438	52	6	80	0.0750000
NODE_163_length_5402_cov_5.397322	2358	2438	53	4	80	0.0500000
NODE_163_length_5402_cov_5.397322	2358	2438	55	3	80	0.0375000
NODE_164_length_5383_cov_15.680545	205	285	0	80	80	1.0000000
NODE_164_length_5383_cov_15.680545	258	317	0	59	59	1.0000000
NODE_164_length_5383_cov_15.680545	2042	2122	8	8	80	0.1000000
NODE_164_length_5383_cov_15.680545	2042	2122	10	6	80	0.0750000
NODE_164_length_5383_cov_15.680545	2042	2122	12	3	80	0.0375000
NODE_164_length_5383_cov_15.680545	2042	2122	14	6	80	0.0750000
NODE_164_length_5383_cov_15.680545	2042	2122	16	2	80	0.0250000
NODE_164_length_5383_cov_15.680545	2042	2122	19	1	80	0.0125000
NODE_164_length_5383_cov_15.680545	2042	2122	20	1	80	0.0125000
NODE_164_length_5383_cov_15.680545	2042	2122	21	3	80	0.0375000
NODE_164_length_5383_cov_15.680545	2042	2122	23	1	80	0.0125000
NODE_164_length_5383_cov_15.680545	2042	2122	24	15	80	0.1875000
NODE_164_length_5383_cov_15.680545	2042	2122	25	5	80	0.0625000
NODE_164_length_5383_cov_15.680545	2042	2122	26	29	80	0.3625000
NODE_164_length_5383_cov_15.680545	2095	2175	0	46	80	0.5750000
NODE_164_length_5383_cov_15.680545	2095	2175	6	6	80	0.0750000
NODE_164_length_5383_cov_15.680545	2095	2175	8	9	80	0.1125000
NODE_164_length_5383_cov_15.680545	2095	2175	10	6	80	0.0750000
NODE_164_length_5383_cov_15.680545	2095	2175	12	3	80	0.0375000
NODE_164_length_5383_cov_15.680545	2095	2175	14	6	80	0.0750000
NODE_164_length_5383_cov_15.680545	2095	2175	16	2	80	0.0250000
NODE_164_length_5383_cov_15.680545	2095	2175	19	1	80	0.0125000
NODE_164_length_5383_cov_15.680545	2095	2175	20	1	80	0.0125000
NODE_165_length_5382_cov_16.894378	1301	1347	4	15	46	0.3260870
NODE_165_length_5382_cov_16.894378	1301	1347	6	8	46	0.1739130
NODE_165_length_5382_cov_16.894378	1301	1347	8	5	46	0.1086956
NODE_165_length_5382_cov_16.894378	1301	1347	10	18	46	0.3913043
NODE_165_length_5382_cov_16.894378	5056	5082	85	1	26	0.0384615
NODE_165_length_5382_cov_16.894378	5056	5082	86	2	26	0.0769231
NODE_165_length_5382_cov_16.894378	5056	5082	88	1	26	0.0384615
NODE_165_length_5382_cov_16.894378	5056	5082	92	1	26	0.0384615
NODE_165_length_5382_cov_16.894378	5056	5082	93	1	26	0.0384615
NODE_165_length_5382_cov_16.894378	5056	5082	94	2	26	0.0769231
NODE_165_length_5382_cov_16.894378	5056	5082	96	2	26	0.0769231
NODE_165_length_5382_cov_16.894378	5056	5082	97	1	26	0.0384615
NODE_165_length_5382_cov_16.894378	5056	5082	100	1	26	0.0384615
NODE_165_length_5382_cov_16.894378	5056	5082	101	3	26	0.1153846
NODE_165_length_5382_cov_16.894378	5056	5082	102	1	26	0.0384615
NODE_165_length_5382_cov_16.894378	5056	5082	107	1	26	0.0384615
NODE_165_length_5382_cov_16.894378	5056	5082	109	1	26	0.0384615
NODE_165_length_5382_cov_16.894378	5056	5082	121	2	26	0.0769231
NODE_165_length_5382_cov_16.894378	5056	5082	124	1	26	0.0384615
NODE_165_length_5382_cov_16.894378	5056	5082	132	1	26	0.0384615
NODE_165_length_5382_cov_16.894378	5056	5082	136	1	26	0.0384615
NODE_165_length_5382_cov_16.894378	5056	5082	139	1	26	0.0384615
NODE_165_length_5382_cov_16.894378	5056	5082	145	1	26	0.0384615
NODE_165_length_5382_cov_16.894378	5056	5082	149	1	26	0.0384615
NODE_165_length_5382_cov_16.894378	5056	5115	85	1	59	0.0169492
NODE_165_length_5382_cov_16.894378	5056	5115	86	2	59	0.0338983
NODE_165_length_5382_cov_16.894378	5056	5115	88	1	59	0.0169492
NODE_165_length_5382_cov_16.894378	5056	5115	92	1	59	0.0169492
NODE_165_length_5382_cov_16.894378	5056	5115	93	1	59	0.0169492
NODE_165_length_5382_cov_16.894378	5056	5115	94	2	59	0.0338983
NODE_165_length_5382_cov_16.894378	5056	5115	96	2	59	0.0338983
NODE_165_length_5382_cov_16.894378	5056	5115	97	1	59	0.0169492
NODE_165_length_5382_cov_16.894378	5056	5115	100	1	59	0.0169492
NODE_165_length_5382_cov_16.894378	5056	5115	101	3	59	0.0508475
NODE_165_length_5382_cov_16.894378	5056	5115	102	1	59	0.0169492
NODE_165_length_5382_cov_16.894378	5056	5115	107	1	59	0.0169492
NODE_165_length_5382_cov_16.894378	5056	5115	109	1	59	0.0169492
NODE_165_length_5382_cov_16.894378	5056	5115	121	2	59	0.0338983
NODE_165_length_5382_cov_16.894378	5056	5115	124	1	59	0.0169492
NODE_165_length_5382_cov_16.894378	5056	5115	132	1	59	0.0169492
NODE_165_length_5382_cov_16.894378	5056	5115	136	1	59	0.0169492
NODE_165_length_5382_cov_16.894378	5056	5115	139	1	59	0.0169492
NODE_165_length_5382_cov_16.894378	5056	5115	145	1	59	0.0169492
NODE_165_length_5382_cov_16.894378	5056	5115	149	1	59	0.0169492
NODE_165_length_5382_cov_16.894378	5056	5115	158	1	59	0.0169492
NODE_165_length_5382_cov_16.894378	5056	5115	164	1	59	0.0169492
NODE_165_length_5382_cov_16.894378	5056	5115	178	1	59	0.0169492
NODE_165_length_5382_cov_16.894378	5056	5115	180	1	59	0.0169492
NODE_165_length_5382_cov_16.894378	5056	5115	181	2	59	0.0338983
NODE_165_length_5382_cov_16.894378	5056	5115	183	2	59	0.0338983
NODE_165_length_5382_cov_16.894378	5056	5115	184	1	59	0.0169492
NODE_165_length_5382_cov_16.894378	5056	5115	185	2	59	0.0338983
NODE_165_length_5382_cov_16.894378	5056	5115	193	1	59	0.0169492
NODE_165_length_5382_cov_16.894378	5056	5115	201	1	59	0.0169492
NODE_165_length_5382_cov_16.894378	5056	5115	205	1	59	0.0169492
NODE_165_length_5382_cov_16.894378	5056	5115	207	1	59	0.0169492
NODE_165_length_5382_cov_16.894378	5056	5115	217	1	59	0.0169492
NODE_165_length_5382_cov_16.894378	5056	5115	223	1	59	0.0169492
NODE_165_length_5382_cov_16.894378	5056	5115	227	1	59	0.0169492
NODE_165_length_5382_cov_16.894378	5056	5115	231	1	59	0.0169492
NODE_165_length_5382_cov_16.894378	5056	5115	239	1	59	0.0169492
NODE_165_length_5382_cov_16.894378	5056	5115	241	2	59	0.0338983
NODE_165_length_5382_cov_16.894378	5056	5115	243	1	59	0.0169492
NODE_165_length_5382_cov_16.894378	5056	5115	249	1	59	0.0169492
NODE_165_length_5382_cov_16.894378	5056	5115	253	1	59	0.0169492
NODE_165_length_5382_cov_16.894378	5056	5115	259	1	59	0.0169492
NODE_165_length_5382_cov_16.894378	5056	5115	261	2	59	0.0338983
NODE_165_length_5382_cov_16.894378	5056	5115	264	1	59	0.0169492
NODE_165_length_5382_cov_16.894378	5056	5115	268	1	59	0.0169492
NODE_165_length_5382_cov_16.894378	5056	5115	272	1	59	0.0169492
NODE_165_length_5382_cov_16.894378	5056	5115	274	1	59	0.0169492
NODE_165_length_5382_cov_16.894378	5056	5115	280	1	59	0.0169492
NODE_167_length_5339_cov_28.708969	3375	3455	0	35	80	0.4375000
NODE_167_length_5339_cov_28.708969	3375	3455	2	15	80	0.1875000
NODE_167_length_5339_cov_28.708969	3375	3455	4	3	80	0.0375000
NODE_167_length_5339_cov_28.708969	3375	3455	6	7	80	0.0875000
NODE_167_length_5339_cov_28.708969	3375	3455	8	5	80	0.0625000
NODE_167_length_5339_cov_28.708969	3375	3455	10	8	80	0.1000000
NODE_167_length_5339_cov_28.708969	3375	3455	12	6	80	0.0750000
NODE_167_length_5339_cov_28.708969	3375	3455	16	1	80	0.0125000
NODE_167_length_5339_cov_28.708969	3428	3508	6	7	80	0.0875000
NODE_167_length_5339_cov_28.708969	3428	3508	8	5	80	0.0625000
NODE_167_length_5339_cov_28.708969	3428	3508	10	8	80	0.1000000
NODE_167_length_5339_cov_28.708969	3428	3508	12	6	80	0.0750000
NODE_167_length_5339_cov_28.708969	3428	3508	16	3	80	0.0375000
NODE_167_length_5339_cov_28.708969	3428	3508	18	5	80	0.0625000
NODE_167_length_5339_cov_28.708969	3428	3508	20	2	80	0.0250000
NODE_167_length_5339_cov_28.708969	3428	3508	24	44	80	0.5500000
NODE_168_length_5336_cov_33.036471	3109	3189	10	1	80	0.0125000
NODE_168_length_5336_cov_33.036471	3109	3189	14	2	80	0.0250000
NODE_168_length_5336_cov_33.036471	3109	3189	15	13	80	0.1625000
NODE_168_length_5336_cov_33.036471	3109	3189	18	10	80	0.1250000
NODE_168_length_5336_cov_33.036471	3109	3189	19	1	80	0.0125000
NODE_168_length_5336_cov_33.036471	3109	3189	22	3	80	0.0375000
NODE_168_length_5336_cov_33.036471	3109	3189	24	34	80	0.4250000
NODE_168_length_5336_cov_33.036471	3109	3189	26	5	80	0.0625000
NODE_168_length_5336_cov_33.036471	3109	3189	28	11	80	0.1375000
NODE_168_length_5336_cov_33.036471	3162	3242	2	9	80	0.1125000
NODE_168_length_5336_cov_33.036471	3162	3242	6	34	80	0.4250000
NODE_168_length_5336_cov_33.036471	3162	3242	10	11	80	0.1375000
NODE_168_length_5336_cov_33.036471	3162	3242	14	2	80	0.0250000
NODE_168_length_5336_cov_33.036471	3162	3242	18	10	80	0.1250000
NODE_168_length_5336_cov_33.036471	3162	3242	22	3	80	0.0375000
NODE_168_length_5336_cov_33.036471	3162	3242	24	7	80	0.0875000
NODE_168_length_5336_cov_33.036471	3162	3242	26	4	80	0.0500000
NODE_179_length_5269_cov_23.392650	1905	1985	0	80	80	1.0000000
NODE_179_length_5269_cov_23.392650	1958	2038	0	80	80	1.0000000
NODE_181_length_5207_cov_31.352780	4588	4668	0	80	80	1.0000000
NODE_181_length_5207_cov_31.352780	4641	4721	0	80	80	1.0000000
NODE_183_length_5193_cov_14.930506	4659	4739	0	15	80	0.1875000
NODE_183_length_5193_cov_14.930506	4659	4739	2	10	80	0.1250000
NODE_183_length_5193_cov_14.930506	4659	4739	4	55	80	0.6875000
NODE_183_length_5193_cov_14.930506	4712	4792	0	23	80	0.2875000
NODE_183_length_5193_cov_14.930506	4712	4792	4	57	80	0.7125000
NODE_183_length_5193_cov_14.930506	4788	4868	0	80	80	1.0000000
NODE_183_length_5193_cov_14.930506	4841	4921	0	50	80	0.6250000
NODE_183_length_5193_cov_14.930506	4841	4921	2	30	80	0.3750000
NODE_186_length_5159_cov_261.593676	158	227	205	1	69	0.0144928
NODE_186_length_5159_cov_261.593676	158	227	209	2	69	0.0289855
NODE_186_length_5159_cov_261.593676	158	227	212	1	69	0.0144928
NODE_186_length_5159_cov_261.593676	158	227	216	2	69	0.0289855
NODE_186_length_5159_cov_261.593676	158	227	217	1	69	0.0144928
NODE_186_length_5159_cov_261.593676	158	227	218	1	69	0.0144928
NODE_186_length_5159_cov_261.593676	158	227	219	1	69	0.0144928
NODE_186_length_5159_cov_261.593676	158	227	220	2	69	0.0289855
NODE_186_length_5159_cov_261.593676	158	227	221	1	69	0.0144928
NODE_186_length_5159_cov_261.593676	158	227	222	2	69	0.0289855
NODE_186_length_5159_cov_261.593676	158	227	223	1	69	0.0144928
NODE_186_length_5159_cov_261.593676	158	227	224	1	69	0.0144928
NODE_186_length_5159_cov_261.593676	158	227	225	1	69	0.0144928
NODE_186_length_5159_cov_261.593676	158	227	226	2	69	0.0289855
NODE_186_length_5159_cov_261.593676	158	227	227	3	69	0.0434783
NODE_186_length_5159_cov_261.593676	158	227	228	2	69	0.0289855
NODE_186_length_5159_cov_261.593676	158	227	229	2	69	0.0289855
NODE_186_length_5159_cov_261.593676	158	227	230	1	69	0.0144928
NODE_186_length_5159_cov_261.593676	158	227	231	2	69	0.0289855
NODE_186_length_5159_cov_261.593676	158	227	232	1	69	0.0144928
NODE_186_length_5159_cov_261.593676	158	227	233	4	69	0.0579710
NODE_186_length_5159_cov_261.593676	158	227	235	3	69	0.0434783
NODE_186_length_5159_cov_261.593676	158	227	237	1	69	0.0144928
NODE_186_length_5159_cov_261.593676	158	227	240	1	69	0.0144928
NODE_186_length_5159_cov_261.593676	158	227	241	1	69	0.0144928
NODE_186_length_5159_cov_261.593676	158	227	242	6	69	0.0869565
NODE_186_length_5159_cov_261.593676	158	227	244	1	69	0.0144928
NODE_186_length_5159_cov_261.593676	158	227	247	1	69	0.0144928
NODE_186_length_5159_cov_261.593676	158	227	249	1	69	0.0144928
NODE_186_length_5159_cov_261.593676	158	227	251	3	69	0.0434783
NODE_186_length_5159_cov_261.593676	158	227	253	2	69	0.0289855
NODE_186_length_5159_cov_261.593676	158	227	254	1	69	0.0144928
NODE_186_length_5159_cov_261.593676	158	227	255	4	69	0.0579710
NODE_186_length_5159_cov_261.593676	158	227	258	2	69	0.0289855
NODE_186_length_5159_cov_261.593676	158	227	259	1	69	0.0144928
NODE_186_length_5159_cov_261.593676	158	227	262	7	69	0.1014493
NODE_189_length_5138_cov_31.467355	3004	3075	5	3	71	0.0422535
NODE_189_length_5138_cov_31.467355	3004	3075	6	7	71	0.0985916
NODE_189_length_5138_cov_31.467355	3004	3075	7	1	71	0.0140845
NODE_189_length_5138_cov_31.467355	3004	3075	8	1	71	0.0140845
NODE_189_length_5138_cov_31.467355	3004	3075	10	1	71	0.0140845
NODE_189_length_5138_cov_31.467355	3004	3075	12	5	71	0.0704225
NODE_189_length_5138_cov_31.467355	3004	3075	14	2	71	0.0281690
NODE_189_length_5138_cov_31.467355	3004	3075	15	1	71	0.0140845
NODE_189_length_5138_cov_31.467355	3004	3075	16	1	71	0.0140845
NODE_189_length_5138_cov_31.467355	3004	3075	18	1	71	0.0140845
NODE_189_length_5138_cov_31.467355	3004	3075	19	1	71	0.0140845
NODE_189_length_5138_cov_31.467355	3004	3075	21	4	71	0.0563380
NODE_189_length_5138_cov_31.467355	3004	3075	23	2	71	0.0281690
NODE_189_length_5138_cov_31.467355	3004	3075	29	3	71	0.0422535
NODE_189_length_5138_cov_31.467355	3004	3075	30	1	71	0.0140845
NODE_189_length_5138_cov_31.467355	3004	3075	32	4	71	0.0563380
NODE_189_length_5138_cov_31.467355	3004	3075	33	3	71	0.0422535
NODE_189_length_5138_cov_31.467355	3004	3075	37	1	71	0.0140845
NODE_189_length_5138_cov_31.467355	3004	3075	38	1	71	0.0140845
NODE_189_length_5138_cov_31.467355	3004	3075	44	1	71	0.0140845
NODE_189_length_5138_cov_31.467355	3004	3075	47	2	71	0.0281690
NODE_189_length_5138_cov_31.467355	3004	3075	49	1	71	0.0140845
NODE_189_length_5138_cov_31.467355	3004	3075	51	3	71	0.0422535
NODE_189_length_5138_cov_31.467355	3004	3075	52	2	71	0.0281690
NODE_189_length_5138_cov_31.467355	3004	3075	58	1	71	0.0140845
NODE_189_length_5138_cov_31.467355	3004	3075	62	1	71	0.0140845
NODE_189_length_5138_cov_31.467355	3004	3075	64	4	71	0.0563380
NODE_189_length_5138_cov_31.467355	3004	3075	66	1	71	0.0140845
NODE_189_length_5138_cov_31.467355	3004	3075	67	4	71	0.0563380
NODE_189_length_5138_cov_31.467355	3004	3075	69	5	71	0.0704225
NODE_189_length_5138_cov_31.467355	3004	3075	71	1	71	0.0140845
NODE_189_length_5138_cov_31.467355	3004	3075	75	2	71	0.0281690
NODE_191_length_5126_cov_5.900935	731	811	2	3	80	0.0375000
NODE_191_length_5126_cov_5.900935	731	811	4	8	80	0.1000000
NODE_191_length_5126_cov_5.900935	731	811	12	10	80	0.1250000
NODE_191_length_5126_cov_5.900935	731	811	14	39	80	0.4875000
NODE_191_length_5126_cov_5.900935	731	811	16	11	80	0.1375000
NODE_191_length_5126_cov_5.900935	731	811	18	9	80	0.1125000
NODE_191_length_5126_cov_5.900935	784	864	0	2	80	0.0250000
NODE_191_length_5126_cov_5.900935	784	864	2	1	80	0.0125000
NODE_191_length_5126_cov_5.900935	784	864	4	3	80	0.0375000
NODE_191_length_5126_cov_5.900935	784	864	14	56	80	0.7000000
NODE_191_length_5126_cov_5.900935	784	864	16	9	80	0.1125000
NODE_191_length_5126_cov_5.900935	784	864	18	9	80	0.1125000
NODE_194_length_5102_cov_12.729962	367	447	6	17	80	0.2125000
NODE_194_length_5102_cov_12.729962	367	447	8	24	80	0.3000000
NODE_194_length_5102_cov_12.729962	367	447	10	15	80	0.1875000
NODE_194_length_5102_cov_12.729962	367	447	14	24	80	0.3000000
NODE_194_length_5102_cov_12.729962	420	500	6	66	80	0.8250000
NODE_194_length_5102_cov_12.729962	420	500	14	14	80	0.1750000
NODE_194_length_5102_cov_12.729962	496	576	0	52	80	0.6500000
NODE_194_length_5102_cov_12.729962	496	576	4	19	80	0.2375000
NODE_194_length_5102_cov_12.729962	496	576	6	9	80	0.1125000
NODE_194_length_5102_cov_12.729962	549	629	0	80	80	1.0000000
NODE_196_length_5079_cov_5.580522	875	940	36	4	65	0.0615385
NODE_196_length_5079_cov_5.580522	875	940	38	16	65	0.2461538
NODE_196_length_5079_cov_5.580522	875	940	40	3	65	0.0461538
NODE_196_length_5079_cov_5.580522	875	940	42	14	65	0.2153846
NODE_196_length_5079_cov_5.580522	875	940	43	1	65	0.0153846
NODE_196_length_5079_cov_5.580522	875	940	44	3	65	0.0461538
NODE_196_length_5079_cov_5.580522	875	940	46	1	65	0.0153846
NODE_196_length_5079_cov_5.580522	875	940	50	3	65	0.0461538
NODE_196_length_5079_cov_5.580522	875	940	55	1	65	0.0153846
NODE_196_length_5079_cov_5.580522	875	940	61	1	65	0.0153846
NODE_196_length_5079_cov_5.580522	875	940	64	5	65	0.0769231
NODE_196_length_5079_cov_5.580522	875	940	66	1	65	0.0153846
NODE_196_length_5079_cov_5.580522	875	940	69	1	65	0.0153846
NODE_196_length_5079_cov_5.580522	875	940	71	1	65	0.0153846
NODE_196_length_5079_cov_5.580522	875	940	72	2	65	0.0307692
NODE_196_length_5079_cov_5.580522	875	940	73	3	65	0.0461538
NODE_196_length_5079_cov_5.580522	875	940	75	1	65	0.0153846
NODE_196_length_5079_cov_5.580522	875	940	79	3	65	0.0461538
NODE_196_length_5079_cov_5.580522	875	940	80	1	65	0.0153846
NODE_197_length_5057_cov_16.348729	2929	3000	126	1	71	0.0140845
NODE_197_length_5057_cov_16.348729	2929	3000	130	1	71	0.0140845
NODE_197_length_5057_cov_16.348729	2929	3000	134	3	71	0.0422535
NODE_197_length_5057_cov_16.348729	2929	3000	138	2	71	0.0281690
NODE_197_length_5057_cov_16.348729	2929	3000	142	2	71	0.0281690
NODE_197_length_5057_cov_16.348729	2929	3000	146	2	71	0.0281690
NODE_197_length_5057_cov_16.348729	2929	3000	149	1	71	0.0140845
NODE_197_length_5057_cov_16.348729	2929	3000	156	1	71	0.0140845
NODE_197_length_5057_cov_16.348729	2929	3000	163	2	71	0.0281690
NODE_197_length_5057_cov_16.348729	2929	3000	172	1	71	0.0140845
NODE_197_length_5057_cov_16.348729	2929	3000	186	1	71	0.0140845
NODE_197_length_5057_cov_16.348729	2929	3000	198	1	71	0.0140845
NODE_197_length_5057_cov_16.348729	2929	3000	200	1	71	0.0140845
NODE_197_length_5057_cov_16.348729	2929	3000	204	1	71	0.0140845
NODE_197_length_5057_cov_16.348729	2929	3000	208	1	71	0.0140845
NODE_197_length_5057_cov_16.348729	2929	3000	221	1	71	0.0140845
NODE_197_length_5057_cov_16.348729	2929	3000	230	1	71	0.0140845
NODE_197_length_5057_cov_16.348729	2929	3000	231	1	71	0.0140845
NODE_197_length_5057_cov_16.348729	2929	3000	233	1	71	0.0140845
NODE_197_length_5057_cov_16.348729	2929	3000	235	3	71	0.0422535
NODE_197_length_5057_cov_16.348729	2929	3000	236	2	71	0.0281690
NODE_197_length_5057_cov_16.348729	2929	3000	240	1	71	0.0140845
NODE_197_length_5057_cov_16.348729	2929	3000	241	1	71	0.0140845
NODE_197_length_5057_cov_16.348729	2929	3000	243	1	71	0.0140845
NODE_197_length_5057_cov_16.348729	2929	3000	246	1	71	0.0140845
NODE_197_length_5057_cov_16.348729	2929	3000	248	3	71	0.0422535
NODE_197_length_5057_cov_16.348729	2929	3000	250	1	71	0.0140845
NODE_197_length_5057_cov_16.348729	2929	3000	252	3	71	0.0422535
NODE_197_length_5057_cov_16.348729	2929	3000	253	1	71	0.0140845
NODE_197_length_5057_cov_16.348729	2929	3000	260	2	71	0.0281690
NODE_197_length_5057_cov_16.348729	2929	3000	263	2	71	0.0281690
NODE_197_length_5057_cov_16.348729	2929	3000	264	1	71	0.0140845
NODE_197_length_5057_cov_16.348729	2929	3000	265	1	71	0.0140845
NODE_197_length_5057_cov_16.348729	2929	3000	266	5	71	0.0704225
NODE_197_length_5057_cov_16.348729	2929	3000	267	1	71	0.0140845
NODE_197_length_5057_cov_16.348729	2929	3000	268	1	71	0.0140845
NODE_197_length_5057_cov_16.348729	2929	3000	274	1	71	0.0140845
NODE_197_length_5057_cov_16.348729	2929	3000	276	2	71	0.0281690
NODE_197_length_5057_cov_16.348729	2929	3000	278	1	71	0.0140845
NODE_197_length_5057_cov_16.348729	2929	3000	280	1	71	0.0140845
NODE_197_length_5057_cov_16.348729	2929	3000	281	1	71	0.0140845
NODE_197_length_5057_cov_16.348729	2929	3000	283	1	71	0.0140845
NODE_197_length_5057_cov_16.348729	2929	3000	287	1	71	0.0140845
NODE_197_length_5057_cov_16.348729	2929	3000	293	2	71	0.0281690
NODE_197_length_5057_cov_16.348729	2929	3000	297	1	71	0.0140845
NODE_197_length_5057_cov_16.348729	2929	3000	299	3	71	0.0422535
NODE_197_length_5057_cov_16.348729	2929	3000	303	1	71	0.0140845
NODE_197_length_5057_cov_16.348729	2929	3000	305	1	71	0.0140845
NODE_197_length_5057_cov_16.348729	2973	3012	263	2	39	0.0512821
NODE_197_length_5057_cov_16.348729	2973	3012	264	1	39	0.0256410
NODE_197_length_5057_cov_16.348729	2973	3012	265	1	39	0.0256410
NODE_197_length_5057_cov_16.348729	2973	3012	266	5	39	0.1282051
NODE_197_length_5057_cov_16.348729	2973	3012	267	1	39	0.0256410
NODE_197_length_5057_cov_16.348729	2973	3012	268	1	39	0.0256410
NODE_197_length_5057_cov_16.348729	2973	3012	272	1	39	0.0256410
NODE_197_length_5057_cov_16.348729	2973	3012	274	4	39	0.1025641
NODE_197_length_5057_cov_16.348729	2973	3012	276	2	39	0.0512821
NODE_197_length_5057_cov_16.348729	2973	3012	278	1	39	0.0256410
NODE_197_length_5057_cov_16.348729	2973	3012	280	2	39	0.0512821
NODE_197_length_5057_cov_16.348729	2973	3012	281	1	39	0.0256410
NODE_197_length_5057_cov_16.348729	2973	3012	283	1	39	0.0256410
NODE_197_length_5057_cov_16.348729	2973	3012	287	1	39	0.0256410
NODE_197_length_5057_cov_16.348729	2973	3012	292	1	39	0.0256410
NODE_197_length_5057_cov_16.348729	2973	3012	293	2	39	0.0512821
NODE_197_length_5057_cov_16.348729	2973	3012	295	1	39	0.0256410
NODE_197_length_5057_cov_16.348729	2973	3012	297	1	39	0.0256410
NODE_197_length_5057_cov_16.348729	2973	3012	299	4	39	0.1025641
NODE_197_length_5057_cov_16.348729	2973	3012	303	3	39	0.0769231
NODE_197_length_5057_cov_16.348729	2973	3012	305	2	39	0.0512821
NODE_197_length_5057_cov_16.348729	2973	3012	307	1	39	0.0256410
NODE_198_length_5053_cov_11.281994	791	834	2	5	43	0.1162791
NODE_198_length_5053_cov_11.281994	791	834	4	38	43	0.8837209
NODE_198_length_5053_cov_11.281994	807	887	2	35	80	0.4375000
NODE_198_length_5053_cov_11.281994	807	887	4	45	80	0.5625000
NODE_198_length_5053_cov_11.281994	883	963	0	60	80	0.7500000
NODE_198_length_5053_cov_11.281994	883	963	2	20	80	0.2500000
NODE_198_length_5053_cov_11.281994	936	999	0	63	63	1.0000000
NODE_204_length_4906_cov_37.988350	3170	3251	26	1	81	0.0123457
NODE_204_length_4906_cov_37.988350	3170	3251	27	1	81	0.0123457
NODE_204_length_4906_cov_37.988350	3170	3251	30	3	81	0.0370370
NODE_204_length_4906_cov_37.988350	3170	3251	38	1	81	0.0123457
NODE_204_length_4906_cov_37.988350	3170	3251	39	2	81	0.0246914
NODE_204_length_4906_cov_37.988350	3170	3251	41	2	81	0.0246914
NODE_204_length_4906_cov_37.988350	3170	3251	49	1	81	0.0123457
NODE_204_length_4906_cov_37.988350	3170	3251	50	1	81	0.0123457
NODE_204_length_4906_cov_37.988350	3170	3251	56	1	81	0.0123457
NODE_204_length_4906_cov_37.988350	3170	3251	62	1	81	0.0123457
NODE_204_length_4906_cov_37.988350	3170	3251	63	4	81	0.0493827
NODE_204_length_4906_cov_37.988350	3170	3251	67	2	81	0.0246914
NODE_204_length_4906_cov_37.988350	3170	3251	71	1	81	0.0123457
NODE_204_length_4906_cov_37.988350	3170	3251	75	1	81	0.0123457
NODE_204_length_4906_cov_37.988350	3170	3251	77	1	81	0.0123457
NODE_204_length_4906_cov_37.988350	3170	3251	81	1	81	0.0123457
NODE_204_length_4906_cov_37.988350	3170	3251	85	1	81	0.0123457
NODE_204_length_4906_cov_37.988350	3170	3251	95	2	81	0.0246914
NODE_204_length_4906_cov_37.988350	3170	3251	97	1	81	0.0123457
NODE_204_length_4906_cov_37.988350	3170	3251	99	2	81	0.0246914
NODE_204_length_4906_cov_37.988350	3170	3251	101	4	81	0.0493827
NODE_204_length_4906_cov_37.988350	3170	3251	109	1	81	0.0123457
NODE_204_length_4906_cov_37.988350	3170	3251	112	2	81	0.0246914
NODE_204_length_4906_cov_37.988350	3170	3251	114	2	81	0.0246914
NODE_204_length_4906_cov_37.988350	3170	3251	120	1	81	0.0123457
NODE_204_length_4906_cov_37.988350	3170	3251	124	1	81	0.0123457
NODE_204_length_4906_cov_37.988350	3170	3251	125	2	81	0.0246914
NODE_204_length_4906_cov_37.988350	3170	3251	131	1	81	0.0123457
NODE_204_length_4906_cov_37.988350	3170	3251	140	1	81	0.0123457
NODE_204_length_4906_cov_37.988350	3170	3251	142	1	81	0.0123457
NODE_204_length_4906_cov_37.988350	3170	3251	146	1	81	0.0123457
NODE_204_length_4906_cov_37.988350	3170	3251	155	1	81	0.0123457
NODE_204_length_4906_cov_37.988350	3170	3251	157	2	81	0.0246914
NODE_204_length_4906_cov_37.988350	3170	3251	161	1	81	0.0123457
NODE_204_length_4906_cov_37.988350	3170	3251	163	1	81	0.0123457
NODE_204_length_4906_cov_37.988350	3170	3251	167	1	81	0.0123457
NODE_204_length_4906_cov_37.988350	3170	3251	171	1	81	0.0123457
NODE_204_length_4906_cov_37.988350	3170	3251	173	1	81	0.0123457
NODE_204_length_4906_cov_37.988350	3170	3251	176	2	81	0.0246914
NODE_204_length_4906_cov_37.988350	3170	3251	190	1	81	0.0123457
NODE_204_length_4906_cov_37.988350	3170	3251	193	3	81	0.0370370
NODE_204_length_4906_cov_37.988350	3170	3251	197	1	81	0.0123457
NODE_204_length_4906_cov_37.988350	3170	3251	203	2	81	0.0246914
NODE_204_length_4906_cov_37.988350	3170	3251	209	1	81	0.0123457
NODE_204_length_4906_cov_37.988350	3170	3251	211	1	81	0.0123457
NODE_204_length_4906_cov_37.988350	3170	3251	219	1	81	0.0123457
NODE_204_length_4906_cov_37.988350	3170	3251	227	1	81	0.0123457
NODE_204_length_4906_cov_37.988350	3170	3251	230	1	81	0.0123457
NODE_204_length_4906_cov_37.988350	3170	3251	239	1	81	0.0123457
NODE_204_length_4906_cov_37.988350	3170	3251	243	1	81	0.0123457
NODE_204_length_4906_cov_37.988350	3170	3251	244	2	81	0.0246914
NODE_204_length_4906_cov_37.988350	3170	3251	248	1	81	0.0123457
NODE_204_length_4906_cov_37.988350	3170	3251	251	1	81	0.0123457
NODE_204_length_4906_cov_37.988350	3170	3251	263	1	81	0.0123457
NODE_204_length_4906_cov_37.988350	3170	3251	264	1	81	0.0123457
NODE_204_length_4906_cov_37.988350	3170	3251	266	2	81	0.0246914
NODE_204_length_4906_cov_37.988350	3170	3251	272	1	81	0.0123457
NODE_204_length_4906_cov_37.988350	3170	3251	274	1	81	0.0123457
NODE_205_length_4888_cov_60.162247	4029	4068	0	35	39	0.8974359
NODE_205_length_4888_cov_60.162247	4029	4068	2	1	39	0.0256410
NODE_205_length_4888_cov_60.162247	4029	4068	4	3	39	0.0769231
NODE_205_length_4888_cov_60.162247	4041	4121	0	80	80	1.0000000
NODE_207_length_4875_cov_63.035176	2905	2985	0	80	80	1.0000000
NODE_207_length_4875_cov_63.035176	2958	3038	0	43	80	0.5375000
NODE_207_length_4875_cov_63.035176	2958	3038	2	1	80	0.0125000
NODE_207_length_4875_cov_63.035176	2958	3038	4	36	80	0.4500000
NODE_208_length_4875_cov_8.996859	4683	4760	0	19	77	0.2467532
NODE_208_length_4875_cov_8.996859	4683	4760	6	58	77	0.7532467
NODE_208_length_4875_cov_8.996859	4736	4813	6	77	77	1.0000000
NODE_211_length_4827_cov_15.364636	1803	1865	34	1	62	0.0161290
NODE_211_length_4827_cov_15.364636	1803	1865	36	12	62	0.1935484
NODE_211_length_4827_cov_15.364636	1803	1865	38	10	62	0.1612903
NODE_211_length_4827_cov_15.364636	1803	1865	39	1	62	0.0161290
NODE_211_length_4827_cov_15.364636	1803	1865	40	7	62	0.1129032
NODE_211_length_4827_cov_15.364636	1803	1865	41	1	62	0.0161290
NODE_211_length_4827_cov_15.364636	1803	1865	49	2	62	0.0322581
NODE_211_length_4827_cov_15.364636	1803	1865	52	3	62	0.0483871
NODE_211_length_4827_cov_15.364636	1803	1865	54	1	62	0.0161290
NODE_211_length_4827_cov_15.364636	1803	1865	60	1	62	0.0161290
NODE_211_length_4827_cov_15.364636	1803	1865	62	1	62	0.0161290
NODE_211_length_4827_cov_15.364636	1803	1865	63	2	62	0.0322581
NODE_211_length_4827_cov_15.364636	1803	1865	65	1	62	0.0161290
NODE_211_length_4827_cov_15.364636	1803	1865	68	1	62	0.0161290
NODE_211_length_4827_cov_15.364636	1803	1865	75	1	62	0.0161290
NODE_211_length_4827_cov_15.364636	1803	1865	77	3	62	0.0483871
NODE_211_length_4827_cov_15.364636	1803	1865	79	1	62	0.0161290
NODE_211_length_4827_cov_15.364636	1803	1865	80	1	62	0.0161290
NODE_211_length_4827_cov_15.364636	1803	1865	88	2	62	0.0322581
NODE_211_length_4827_cov_15.364636	1803	1865	89	2	62	0.0322581
NODE_211_length_4827_cov_15.364636	1803	1865	90	1	62	0.0161290
NODE_211_length_4827_cov_15.364636	1803	1865	91	1	62	0.0161290
NODE_211_length_4827_cov_15.364636	1803	1865	93	6	62	0.0967742
NODE_211_length_4827_cov_15.364636	1899	1979	29	2	80	0.0250000
NODE_211_length_4827_cov_15.364636	1899	1979	31	7	80	0.0875000
NODE_211_length_4827_cov_15.364636	1899	1979	32	3	80	0.0375000
NODE_211_length_4827_cov_15.364636	1899	1979	33	5	80	0.0625000
NODE_211_length_4827_cov_15.364636	1899	1979	34	10	80	0.1250000
NODE_211_length_4827_cov_15.364636	1899	1979	35	8	80	0.1000000
NODE_211_length_4827_cov_15.364636	1899	1979	37	13	80	0.1625000
NODE_211_length_4827_cov_15.364636	1899	1979	38	2	80	0.0250000
NODE_211_length_4827_cov_15.364636	1899	1979	39	8	80	0.1000000
NODE_211_length_4827_cov_15.364636	1899	1979	41	17	80	0.2125000
NODE_211_length_4827_cov_15.364636	1899	1979	43	5	80	0.0625000
NODE_211_length_4827_cov_15.364636	1952	1996	29	7	44	0.1590909
NODE_211_length_4827_cov_15.364636	1952	1996	31	8	44	0.1818182
NODE_211_length_4827_cov_15.364636	1952	1996	33	3	44	0.0681818
NODE_211_length_4827_cov_15.364636	1952	1996	35	7	44	0.1590909
NODE_211_length_4827_cov_15.364636	1952	1996	37	6	44	0.1363636
NODE_211_length_4827_cov_15.364636	1952	1996	38	2	44	0.0454545
NODE_211_length_4827_cov_15.364636	1952	1996	39	2	44	0.0454545
NODE_211_length_4827_cov_15.364636	1952	1996	41	4	44	0.0909091
NODE_211_length_4827_cov_15.364636	1952	1996	43	5	44	0.1136364
NODE_212_length_4821_cov_10.856840	999	1061	0	3	62	0.0483871
NODE_212_length_4821_cov_10.856840	999	1061	2	59	62	0.9516129
NODE_213_length_4819_cov_16.363347	2392	2461	32	12	69	0.1739130
NODE_213_length_4819_cov_16.363347	2392	2461	34	2	69	0.0289855
NODE_213_length_4819_cov_16.363347	2392	2461	38	14	69	0.2028985
NODE_213_length_4819_cov_16.363347	2392	2461	40	4	69	0.0579710
NODE_213_length_4819_cov_16.363347	2392	2461	42	8	69	0.1159420
NODE_213_length_4819_cov_16.363347	2392	2461	45	11	69	0.1594203
NODE_213_length_4819_cov_16.363347	2392	2461	46	11	69	0.1594203
NODE_213_length_4819_cov_16.363347	2392	2461	50	7	69	0.1014493
NODE_217_length_4794_cov_14.912886	657	737	60	3	80	0.0375000
NODE_217_length_4794_cov_14.912886	657	737	64	2	80	0.0250000
NODE_217_length_4794_cov_14.912886	657	737	66	1	80	0.0125000
NODE_217_length_4794_cov_14.912886	657	737	68	1	80	0.0125000
NODE_217_length_4794_cov_14.912886	657	737	72	2	80	0.0250000
NODE_217_length_4794_cov_14.912886	657	737	74	4	80	0.0500000
NODE_217_length_4794_cov_14.912886	657	737	76	3	80	0.0375000
NODE_217_length_4794_cov_14.912886	657	737	78	4	80	0.0500000
NODE_217_length_4794_cov_14.912886	657	737	80	2	80	0.0250000
NODE_217_length_4794_cov_14.912886	657	737	82	1	80	0.0125000
NODE_217_length_4794_cov_14.912886	657	737	86	2	80	0.0250000
NODE_217_length_4794_cov_14.912886	657	737	90	1	80	0.0125000
NODE_217_length_4794_cov_14.912886	657	737	91	2	80	0.0250000
NODE_217_length_4794_cov_14.912886	657	737	95	1	80	0.0125000
NODE_217_length_4794_cov_14.912886	657	737	96	2	80	0.0250000
NODE_217_length_4794_cov_14.912886	657	737	98	1	80	0.0125000
NODE_217_length_4794_cov_14.912886	657	737	100	1	80	0.0125000
NODE_217_length_4794_cov_14.912886	657	737	104	3	80	0.0375000
NODE_217_length_4794_cov_14.912886	657	737	106	4	80	0.0500000
NODE_217_length_4794_cov_14.912886	657	737	107	3	80	0.0375000
NODE_217_length_4794_cov_14.912886	657	737	109	2	80	0.0250000
NODE_217_length_4794_cov_14.912886	657	737	111	1	80	0.0125000
NODE_217_length_4794_cov_14.912886	657	737	113	1	80	0.0125000
NODE_217_length_4794_cov_14.912886	657	737	115	7	80	0.0875000
NODE_217_length_4794_cov_14.912886	657	737	117	7	80	0.0875000
NODE_217_length_4794_cov_14.912886	657	737	122	5	80	0.0625000
NODE_217_length_4794_cov_14.912886	657	737	124	5	80	0.0625000
NODE_217_length_4794_cov_14.912886	657	737	125	2	80	0.0250000
NODE_217_length_4794_cov_14.912886	657	737	127	1	80	0.0125000
NODE_217_length_4794_cov_14.912886	657	737	129	1	80	0.0125000
NODE_217_length_4794_cov_14.912886	657	737	131	4	80	0.0500000
NODE_217_length_4794_cov_14.912886	657	737	133	1	80	0.0125000
NODE_217_length_4794_cov_14.912886	4240	4312	0	72	72	1.0000000
NODE_217_length_4794_cov_14.912886	4293	4312	0	19	19	1.0000000
NODE_217_length_4794_cov_14.912886	4345	4408	0	5	63	0.0793651
NODE_217_length_4794_cov_14.912886	4345	4408	2	58	63	0.9206349
NODE_218_length_4791_cov_16.126172	2438	2518	0	80	80	1.0000000
NODE_218_length_4791_cov_16.126172	2491	2571	0	80	80	1.0000000
NODE_218_length_4791_cov_16.126172	2567	2647	0	80	80	1.0000000
NODE_218_length_4791_cov_16.126172	2620	2700	0	80	80	1.0000000
NODE_218_length_4791_cov_16.126172	4607	4687	0	43	80	0.5375000
NODE_218_length_4791_cov_16.126172	4607	4687	2	37	80	0.4625000
NODE_219_length_4790_cov_9.713494	2159	2239	25	4	80	0.0500000
NODE_219_length_4790_cov_9.713494	2159	2239	27	3	80	0.0375000
NODE_219_length_4790_cov_9.713494	2159	2239	31	25	80	0.3125000
NODE_219_length_4790_cov_9.713494	2159	2239	33	2	80	0.0250000
NODE_219_length_4790_cov_9.713494	2159	2239	35	2	80	0.0250000
NODE_219_length_4790_cov_9.713494	2159	2239	37	18	80	0.2250000
NODE_219_length_4790_cov_9.713494	2159	2239	38	6	80	0.0750000
NODE_219_length_4790_cov_9.713494	2159	2239	39	7	80	0.0875000
NODE_219_length_4790_cov_9.713494	2159	2239	41	3	80	0.0375000
NODE_219_length_4790_cov_9.713494	2159	2239	43	10	80	0.1250000
NODE_219_length_4790_cov_9.713494	4273	4353	5	32	80	0.4000000
NODE_219_length_4790_cov_9.713494	4273	4353	6	6	80	0.0750000
NODE_219_length_4790_cov_9.713494	4273	4353	7	2	80	0.0250000
NODE_219_length_4790_cov_9.713494	4273	4353	8	13	80	0.1625000
NODE_219_length_4790_cov_9.713494	4273	4353	9	3	80	0.0375000
NODE_219_length_4790_cov_9.713494	4273	4353	10	24	80	0.3000000
NODE_219_length_4790_cov_9.713494	4273	4335	5	17	62	0.2741936
NODE_219_length_4790_cov_9.713494	4273	4335	6	3	62	0.0483871
NODE_219_length_4790_cov_9.713494	4273	4335	7	2	62	0.0322581
NODE_219_length_4790_cov_9.713494	4273	4335	8	13	62	0.2096774
NODE_219_length_4790_cov_9.713494	4273	4335	9	3	62	0.0483871
NODE_219_length_4790_cov_9.713494	4273	4335	10	24	62	0.3870968
NODE_219_length_4790_cov_9.713494	4326	4406	5	24	80	0.3000000
NODE_219_length_4790_cov_9.713494	4326	4406	6	40	80	0.5000000
NODE_219_length_4790_cov_9.713494	4326	4406	8	15	80	0.1875000
NODE_219_length_4790_cov_9.713494	4326	4406	10	1	80	0.0125000
NODE_221_length_4772_cov_10.560454	4281	4367	0	65	86	0.7558140
NODE_221_length_4772_cov_10.560454	4281	4367	2	21	86	0.2441860
NODE_222_length_4770_cov_106.953543	2778	2858	44	2	80	0.0250000
NODE_222_length_4770_cov_106.953543	2778	2858	49	1	80	0.0125000
NODE_222_length_4770_cov_106.953543	2778	2858	50	2	80	0.0250000
NODE_222_length_4770_cov_106.953543	2778	2858	54	5	80	0.0625000
NODE_222_length_4770_cov_106.953543	2778	2858	56	4	80	0.0500000
NODE_222_length_4770_cov_106.953543	2778	2858	58	2	80	0.0250000
NODE_222_length_4770_cov_106.953543	2778	2858	61	5	80	0.0625000
NODE_222_length_4770_cov_106.953543	2778	2858	66	1	80	0.0125000
NODE_222_length_4770_cov_106.953543	2778	2858	68	1	80	0.0125000
NODE_222_length_4770_cov_106.953543	2778	2858	70	1	80	0.0125000
NODE_222_length_4770_cov_106.953543	2778	2858	72	4	80	0.0500000
NODE_222_length_4770_cov_106.953543	2778	2858	74	4	80	0.0500000
NODE_222_length_4770_cov_106.953543	2778	2858	75	1	80	0.0125000
NODE_222_length_4770_cov_106.953543	2778	2858	76	1	80	0.0125000
NODE_222_length_4770_cov_106.953543	2778	2858	77	3	80	0.0375000
NODE_222_length_4770_cov_106.953543	2778	2858	78	18	80	0.2250000
NODE_222_length_4770_cov_106.953543	2778	2858	79	3	80	0.0375000
NODE_222_length_4770_cov_106.953543	2778	2858	80	13	80	0.1625000
NODE_222_length_4770_cov_106.953543	2778	2858	81	3	80	0.0375000
NODE_222_length_4770_cov_106.953543	2778	2858	82	2	80	0.0250000
NODE_222_length_4770_cov_106.953543	2778	2858	83	1	80	0.0125000
NODE_222_length_4770_cov_106.953543	2778	2858	84	3	80	0.0375000
NODE_222_length_4770_cov_106.953543	2831	2911	37	1	80	0.0125000
NODE_222_length_4770_cov_106.953543	2831	2911	38	5	80	0.0625000
NODE_222_length_4770_cov_106.953543	2831	2911	39	4	80	0.0500000
NODE_222_length_4770_cov_106.953543	2831	2911	40	1	80	0.0125000
NODE_222_length_4770_cov_106.953543	2831	2911	41	10	80	0.1250000
NODE_222_length_4770_cov_106.953543	2831	2911	42	8	80	0.1000000
NODE_222_length_4770_cov_106.953543	2831	2911	43	1	80	0.0125000
NODE_222_length_4770_cov_106.953543	2831	2911	44	2	80	0.0250000
NODE_222_length_4770_cov_106.953543	2831	2911	46	3	80	0.0375000
NODE_222_length_4770_cov_106.953543	2831	2911	49	1	80	0.0125000
NODE_222_length_4770_cov_106.953543	2831	2911	50	2	80	0.0250000
NODE_222_length_4770_cov_106.953543	2831	2911	52	1	80	0.0125000
NODE_222_length_4770_cov_106.953543	2831	2911	54	8	80	0.1000000
NODE_222_length_4770_cov_106.953543	2831	2911	56	4	80	0.0500000
NODE_222_length_4770_cov_106.953543	2831	2911	58	2	80	0.0250000
NODE_222_length_4770_cov_106.953543	2831	2911	61	5	80	0.0625000
NODE_222_length_4770_cov_106.953543	2831	2911	62	1	80	0.0125000
NODE_222_length_4770_cov_106.953543	2831	2911	66	1	80	0.0125000
NODE_222_length_4770_cov_106.953543	2831	2911	67	1	80	0.0125000
NODE_222_length_4770_cov_106.953543	2831	2911	68	1	80	0.0125000
NODE_222_length_4770_cov_106.953543	2831	2911	70	1	80	0.0125000
NODE_222_length_4770_cov_106.953543	2831	2911	72	7	80	0.0875000
NODE_222_length_4770_cov_106.953543	2831	2911	76	4	80	0.0500000
NODE_222_length_4770_cov_106.953543	2831	2911	82	6	80	0.0750000
NODE_222_length_4770_cov_106.953543	2907	2987	82	4	80	0.0500000
NODE_222_length_4770_cov_106.953543	2907	2987	84	1	80	0.0125000
NODE_222_length_4770_cov_106.953543	2907	2987	88	2	80	0.0250000
NODE_222_length_4770_cov_106.953543	2907	2987	94	1	80	0.0125000
NODE_222_length_4770_cov_106.953543	2907	2987	99	1	80	0.0125000
NODE_222_length_4770_cov_106.953543	2907	2987	105	1	80	0.0125000
NODE_222_length_4770_cov_106.953543	2907	2987	114	1	80	0.0125000
NODE_222_length_4770_cov_106.953543	2907	2987	123	1	80	0.0125000
NODE_222_length_4770_cov_106.953543	2907	2987	129	1	80	0.0125000
NODE_222_length_4770_cov_106.953543	2907	2987	134	1	80	0.0125000
NODE_222_length_4770_cov_106.953543	2907	2987	136	1	80	0.0125000
NODE_222_length_4770_cov_106.953543	2907	2987	145	2	80	0.0250000
NODE_222_length_4770_cov_106.953543	2907	2987	156	1	80	0.0125000
NODE_222_length_4770_cov_106.953543	2907	2987	160	2	80	0.0250000
NODE_222_length_4770_cov_106.953543	2907	2987	161	1	80	0.0125000
NODE_222_length_4770_cov_106.953543	2907	2987	167	2	80	0.0250000
NODE_222_length_4770_cov_106.953543	2907	2987	168	1	80	0.0125000
NODE_222_length_4770_cov_106.953543	2907	2987	169	1	80	0.0125000
NODE_222_length_4770_cov_106.953543	2907	2987	171	1	80	0.0125000
NODE_222_length_4770_cov_106.953543	2907	2987	180	1	80	0.0125000
NODE_222_length_4770_cov_106.953543	2907	2987	183	1	80	0.0125000
NODE_222_length_4770_cov_106.953543	2907	2987	185	2	80	0.0250000
NODE_222_length_4770_cov_106.953543	2907	2987	189	1	80	0.0125000
NODE_222_length_4770_cov_106.953543	2907	2987	196	1	80	0.0125000
NODE_222_length_4770_cov_106.953543	2907	2987	204	1	80	0.0125000
NODE_222_length_4770_cov_106.953543	2907	2987	206	1	80	0.0125000
NODE_222_length_4770_cov_106.953543	2907	2987	208	1	80	0.0125000
NODE_222_length_4770_cov_106.953543	2907	2987	212	1	80	0.0125000
NODE_222_length_4770_cov_106.953543	2907	2987	214	3	80	0.0375000
NODE_222_length_4770_cov_106.953543	2907	2987	216	5	80	0.0625000
NODE_222_length_4770_cov_106.953543	2907	2987	218	2	80	0.0250000
NODE_222_length_4770_cov_106.953543	2907	2987	220	6	80	0.0750000
NODE_222_length_4770_cov_106.953543	2907	2987	222	5	80	0.0625000
NODE_222_length_4770_cov_106.953543	2907	2987	223	3	80	0.0375000
NODE_222_length_4770_cov_106.953543	2907	2987	224	1	80	0.0125000
NODE_222_length_4770_cov_106.953543	2907	2987	225	1	80	0.0125000
NODE_222_length_4770_cov_106.953543	2907	2987	227	1	80	0.0125000
NODE_222_length_4770_cov_106.953543	2907	2987	228	1	80	0.0125000
NODE_222_length_4770_cov_106.953543	2907	2987	232	1	80	0.0125000
NODE_222_length_4770_cov_106.953543	2907	2987	233	3	80	0.0375000
NODE_222_length_4770_cov_106.953543	2907	2987	235	1	80	0.0125000
NODE_222_length_4770_cov_106.953543	2907	2987	238	3	80	0.0375000
NODE_222_length_4770_cov_106.953543	2907	2987	239	2	80	0.0250000
NODE_222_length_4770_cov_106.953543	2907	2987	240	3	80	0.0375000
NODE_222_length_4770_cov_106.953543	2907	2987	243	2	80	0.0250000
NODE_222_length_4770_cov_106.953543	2907	2987	245	1	80	0.0125000
NODE_222_length_4770_cov_106.953543	2960	3040	178	1	80	0.0125000
NODE_222_length_4770_cov_106.953543	2960	3040	181	2	80	0.0250000
NODE_222_length_4770_cov_106.953543	2960	3040	183	2	80	0.0250000
NODE_222_length_4770_cov_106.953543	2960	3040	186	2	80	0.0250000
NODE_222_length_4770_cov_106.953543	2960	3040	188	1	80	0.0125000
NODE_222_length_4770_cov_106.953543	2960	3040	192	1	80	0.0125000
NODE_222_length_4770_cov_106.953543	2960	3040	195	1	80	0.0125000
NODE_222_length_4770_cov_106.953543	2960	3040	197	2	80	0.0250000
NODE_222_length_4770_cov_106.953543	2960	3040	198	1	80	0.0125000
NODE_222_length_4770_cov_106.953543	2960	3040	199	1	80	0.0125000
NODE_222_length_4770_cov_106.953543	2960	3040	206	2	80	0.0250000
NODE_222_length_4770_cov_106.953543	2960	3040	207	1	80	0.0125000
NODE_222_length_4770_cov_106.953543	2960	3040	210	1	80	0.0125000
NODE_222_length_4770_cov_106.953543	2960	3040	213	1	80	0.0125000
NODE_222_length_4770_cov_106.953543	2960	3040	215	2	80	0.0250000
NODE_222_length_4770_cov_106.953543	2960	3040	216	2	80	0.0250000
NODE_222_length_4770_cov_106.953543	2960	3040	217	1	80	0.0125000
NODE_222_length_4770_cov_106.953543	2960	3040	218	1	80	0.0125000
NODE_222_length_4770_cov_106.953543	2960	3040	222	4	80	0.0500000
NODE_222_length_4770_cov_106.953543	2960	3040	223	3	80	0.0375000
NODE_222_length_4770_cov_106.953543	2960	3040	224	1	80	0.0125000
NODE_222_length_4770_cov_106.953543	2960	3040	225	1	80	0.0125000
NODE_222_length_4770_cov_106.953543	2960	3040	227	1	80	0.0125000
NODE_222_length_4770_cov_106.953543	2960	3040	228	2	80	0.0250000
NODE_222_length_4770_cov_106.953543	2960	3040	231	1	80	0.0125000
NODE_222_length_4770_cov_106.953543	2960	3040	232	1	80	0.0125000
NODE_222_length_4770_cov_106.953543	2960	3040	233	4	80	0.0500000
NODE_222_length_4770_cov_106.953543	2960	3040	235	1	80	0.0125000
NODE_222_length_4770_cov_106.953543	2960	3040	238	3	80	0.0375000
NODE_222_length_4770_cov_106.953543	2960	3040	239	3	80	0.0375000
NODE_222_length_4770_cov_106.953543	2960	3040	240	3	80	0.0375000
NODE_222_length_4770_cov_106.953543	2960	3040	241	2	80	0.0250000
NODE_222_length_4770_cov_106.953543	2960	3040	242	4	80	0.0500000
NODE_222_length_4770_cov_106.953543	2960	3040	243	5	80	0.0625000
NODE_222_length_4770_cov_106.953543	2960	3040	244	1	80	0.0125000
NODE_222_length_4770_cov_106.953543	2960	3040	245	6	80	0.0750000
NODE_222_length_4770_cov_106.953543	2960	3040	246	2	80	0.0250000
NODE_222_length_4770_cov_106.953543	2960	3040	247	3	80	0.0375000
NODE_222_length_4770_cov_106.953543	2960	3040	248	1	80	0.0125000
NODE_222_length_4770_cov_106.953543	2960	3040	249	3	80	0.0375000
NODE_223_length_4768_cov_15.447205	1237	1317	54	2	80	0.0250000
NODE_223_length_4768_cov_15.447205	1237	1317	56	4	80	0.0500000
NODE_223_length_4768_cov_15.447205	1237	1317	58	4	80	0.0500000
NODE_223_length_4768_cov_15.447205	1237	1317	60	4	80	0.0500000
NODE_223_length_4768_cov_15.447205	1237	1317	62	1	80	0.0125000
NODE_223_length_4768_cov_15.447205	1237	1317	65	2	80	0.0250000
NODE_223_length_4768_cov_15.447205	1237	1317	67	1	80	0.0125000
NODE_223_length_4768_cov_15.447205	1237	1317	69	3	80	0.0375000
NODE_223_length_4768_cov_15.447205	1237	1317	70	2	80	0.0250000
NODE_223_length_4768_cov_15.447205	1237	1317	73	2	80	0.0250000
NODE_223_length_4768_cov_15.447205	1237	1317	75	1	80	0.0125000
NODE_223_length_4768_cov_15.447205	1237	1317	77	5	80	0.0625000
NODE_223_length_4768_cov_15.447205	1237	1317	79	8	80	0.1000000
NODE_223_length_4768_cov_15.447205	1237	1317	80	1	80	0.0125000
NODE_223_length_4768_cov_15.447205	1237	1317	81	5	80	0.0625000
NODE_223_length_4768_cov_15.447205	1237	1317	83	5	80	0.0625000
NODE_223_length_4768_cov_15.447205	1237	1317	84	6	80	0.0750000
NODE_223_length_4768_cov_15.447205	1237	1317	85	13	80	0.1625000
NODE_223_length_4768_cov_15.447205	1237	1317	87	11	80	0.1375000
NODE_228_length_4730_cov_30.142734	256	336	0	75	80	0.9375000
NODE_228_length_4730_cov_30.142734	256	336	2	5	80	0.0625000
NODE_228_length_4730_cov_30.142734	309	389	0	22	80	0.2750000
NODE_228_length_4730_cov_30.142734	309	389	2	58	80	0.7250000
NODE_228_length_4730_cov_30.142734	4052	4132	0	46	80	0.5750000
NODE_228_length_4730_cov_30.142734	4052	4132	2	34	80	0.4250000
NODE_228_length_4730_cov_30.142734	4105	4185	0	13	80	0.1625000
NODE_228_length_4730_cov_30.142734	4105	4185	2	67	80	0.8375000
NODE_231_length_4706_cov_25.522683	2181	2261	28	1	80	0.0125000
NODE_231_length_4706_cov_25.522683	2181	2261	32	4	80	0.0500000
NODE_231_length_4706_cov_25.522683	2181	2261	34	12	80	0.1500000
NODE_231_length_4706_cov_25.522683	2181	2261	36	6	80	0.0750000
NODE_231_length_4706_cov_25.522683	2181	2261	37	2	80	0.0250000
NODE_231_length_4706_cov_25.522683	2181	2261	39	2	80	0.0250000
NODE_231_length_4706_cov_25.522683	2181	2261	41	4	80	0.0500000
NODE_231_length_4706_cov_25.522683	2181	2261	42	1	80	0.0125000
NODE_231_length_4706_cov_25.522683	2181	2261	45	4	80	0.0500000
NODE_231_length_4706_cov_25.522683	2181	2261	51	2	80	0.0250000
NODE_231_length_4706_cov_25.522683	2181	2261	55	1	80	0.0125000
NODE_231_length_4706_cov_25.522683	2181	2261	61	1	80	0.0125000
NODE_231_length_4706_cov_25.522683	2181	2261	63	4	80	0.0500000
NODE_231_length_4706_cov_25.522683	2181	2261	69	2	80	0.0250000
NODE_231_length_4706_cov_25.522683	2181	2261	71	2	80	0.0250000
NODE_231_length_4706_cov_25.522683	2181	2261	74	1	80	0.0125000
NODE_231_length_4706_cov_25.522683	2181	2261	76	2	80	0.0250000
NODE_231_length_4706_cov_25.522683	2181	2261	81	1	80	0.0125000
NODE_231_length_4706_cov_25.522683	2181	2261	83	1	80	0.0125000
NODE_231_length_4706_cov_25.522683	2181	2261	89	3	80	0.0375000
NODE_231_length_4706_cov_25.522683	2181	2261	97	1	80	0.0125000
NODE_231_length_4706_cov_25.522683	2181	2261	100	1	80	0.0125000
NODE_231_length_4706_cov_25.522683	2181	2261	102	4	80	0.0500000
NODE_231_length_4706_cov_25.522683	2181	2261	106	4	80	0.0500000
NODE_231_length_4706_cov_25.522683	2181	2261	110	3	80	0.0375000
NODE_231_length_4706_cov_25.522683	2181	2261	113	2	80	0.0250000
NODE_231_length_4706_cov_25.522683	2181	2261	115	1	80	0.0125000
NODE_231_length_4706_cov_25.522683	2181	2261	117	1	80	0.0125000
NODE_231_length_4706_cov_25.522683	2181	2261	118	2	80	0.0250000
NODE_231_length_4706_cov_25.522683	2181	2261	120	2	80	0.0250000
NODE_231_length_4706_cov_25.522683	2181	2261	123	1	80	0.0125000
NODE_231_length_4706_cov_25.522683	2181	2261	125	2	80	0.0250000
NODE_231_length_4706_cov_25.522683	2234	2288	2	1	54	0.0185185
NODE_231_length_4706_cov_25.522683	2234	2288	4	1	54	0.0185185
NODE_231_length_4706_cov_25.522683	2234	2288	6	1	54	0.0185185
NODE_231_length_4706_cov_25.522683	2234	2288	7	3	54	0.0555556
NODE_231_length_4706_cov_25.522683	2234	2288	10	1	54	0.0185185
NODE_231_length_4706_cov_25.522683	2234	2288	12	3	54	0.0555556
NODE_231_length_4706_cov_25.522683	2234	2288	14	3	54	0.0555556
NODE_231_length_4706_cov_25.522683	2234	2288	16	4	54	0.0740741
NODE_231_length_4706_cov_25.522683	2234	2288	18	1	54	0.0185185
NODE_231_length_4706_cov_25.522683	2234	2288	20	3	54	0.0555556
NODE_231_length_4706_cov_25.522683	2234	2288	22	2	54	0.0370370
NODE_231_length_4706_cov_25.522683	2234	2288	24	1	54	0.0185185
NODE_231_length_4706_cov_25.522683	2234	2288	28	4	54	0.0740741
NODE_231_length_4706_cov_25.522683	2234	2288	32	4	54	0.0740741
NODE_231_length_4706_cov_25.522683	2234	2288	34	12	54	0.2222222
NODE_231_length_4706_cov_25.522683	2234	2288	36	6	54	0.1111111
NODE_231_length_4706_cov_25.522683	2234	2288	37	2	54	0.0370370
NODE_231_length_4706_cov_25.522683	2234	2288	39	2	54	0.0370370
NODE_231_length_4706_cov_25.522683	3943	4026	146	1	83	0.0120482
NODE_231_length_4706_cov_25.522683	3943	4026	148	4	83	0.0481928
NODE_231_length_4706_cov_25.522683	3943	4026	149	2	83	0.0240964
NODE_231_length_4706_cov_25.522683	3943	4026	150	2	83	0.0240964
NODE_231_length_4706_cov_25.522683	3943	4026	152	4	83	0.0481928
NODE_231_length_4706_cov_25.522683	3943	4026	153	1	83	0.0120482
NODE_231_length_4706_cov_25.522683	3943	4026	154	1	83	0.0120482
NODE_231_length_4706_cov_25.522683	3943	4026	155	1	83	0.0120482
NODE_231_length_4706_cov_25.522683	3943	4026	156	3	83	0.0361446
NODE_231_length_4706_cov_25.522683	3943	4026	157	9	83	0.1084337
NODE_231_length_4706_cov_25.522683	3943	4026	158	3	83	0.0361446
NODE_231_length_4706_cov_25.522683	3943	4026	159	3	83	0.0361446
NODE_231_length_4706_cov_25.522683	3943	4026	160	1	83	0.0120482
NODE_231_length_4706_cov_25.522683	3943	4026	161	4	83	0.0481928
NODE_231_length_4706_cov_25.522683	3943	4026	162	3	83	0.0361446
NODE_231_length_4706_cov_25.522683	3943	4026	163	1	83	0.0120482
NODE_231_length_4706_cov_25.522683	3943	4026	168	2	83	0.0240964
NODE_231_length_4706_cov_25.522683	3943	4026	171	1	83	0.0120482
NODE_231_length_4706_cov_25.522683	3943	4026	175	2	83	0.0240964
NODE_231_length_4706_cov_25.522683	3943	4026	176	1	83	0.0120482
NODE_231_length_4706_cov_25.522683	3943	4026	177	1	83	0.0120482
NODE_231_length_4706_cov_25.522683	3943	4026	178	1	83	0.0120482
NODE_231_length_4706_cov_25.522683	3943	4026	179	2	83	0.0240964
NODE_231_length_4706_cov_25.522683	3943	4026	183	1	83	0.0120482
NODE_231_length_4706_cov_25.522683	3943	4026	184	2	83	0.0240964
NODE_231_length_4706_cov_25.522683	3943	4026	186	2	83	0.0240964
NODE_231_length_4706_cov_25.522683	3943	4026	188	3	83	0.0361446
NODE_231_length_4706_cov_25.522683	3943	4026	189	1	83	0.0120482
NODE_231_length_4706_cov_25.522683	3943	4026	190	2	83	0.0240964
NODE_231_length_4706_cov_25.522683	3943	4026	192	3	83	0.0361446
NODE_231_length_4706_cov_25.522683	3943	4026	193	1	83	0.0120482
NODE_231_length_4706_cov_25.522683	3943	4026	194	2	83	0.0240964
NODE_231_length_4706_cov_25.522683	3943	4026	195	1	83	0.0120482
NODE_231_length_4706_cov_25.522683	3943	4026	196	2	83	0.0240964
NODE_231_length_4706_cov_25.522683	3943	4026	197	5	83	0.0602410
NODE_231_length_4706_cov_25.522683	3943	4026	198	3	83	0.0361446
NODE_231_length_4706_cov_25.522683	3943	4026	200	1	83	0.0120482
NODE_231_length_4706_cov_25.522683	3943	4026	202	1	83	0.0120482
NODE_235_length_4693_cov_16.973008	374	454	6	12	80	0.1500000
NODE_235_length_4693_cov_16.973008	374	454	8	4	80	0.0500000
NODE_235_length_4693_cov_16.973008	374	454	9	1	80	0.0125000
NODE_235_length_4693_cov_16.973008	374	454	11	16	80	0.2000000
NODE_235_length_4693_cov_16.973008	374	454	12	22	80	0.2750000
NODE_235_length_4693_cov_16.973008	374	454	13	5	80	0.0625000
NODE_235_length_4693_cov_16.973008	374	454	14	17	80	0.2125000
NODE_235_length_4693_cov_16.973008	374	454	15	3	80	0.0375000
NODE_235_length_4693_cov_16.973008	427	507	6	12	80	0.1500000
NODE_235_length_4693_cov_16.973008	427	507	8	11	80	0.1375000
NODE_235_length_4693_cov_16.973008	427	507	10	2	80	0.0250000
NODE_235_length_4693_cov_16.973008	427	507	12	17	80	0.2125000
NODE_235_length_4693_cov_16.973008	427	507	14	3	80	0.0375000
NODE_235_length_4693_cov_16.973008	427	507	18	18	80	0.2250000
NODE_235_length_4693_cov_16.973008	427	507	20	17	80	0.2125000
NODE_240_length_4672_cov_39.029084	1391	1470	134	1	79	0.0126582
NODE_240_length_4672_cov_39.029084	1391	1470	156	1	79	0.0126582
NODE_240_length_4672_cov_39.029084	1391	1470	167	1	79	0.0126582
NODE_240_length_4672_cov_39.029084	1391	1470	183	1	79	0.0126582
NODE_240_length_4672_cov_39.029084	1391	1470	208	1	79	0.0126582
NODE_240_length_4672_cov_39.029084	1391	1470	210	1	79	0.0126582
NODE_240_length_4672_cov_39.029084	1391	1470	216	1	79	0.0126582
NODE_240_length_4672_cov_39.029084	1391	1470	217	3	79	0.0379747
NODE_240_length_4672_cov_39.029084	1391	1470	229	2	79	0.0253165
NODE_240_length_4672_cov_39.029084	1391	1470	233	2	79	0.0253165
NODE_240_length_4672_cov_39.029084	1391	1470	234	3	79	0.0379747
NODE_240_length_4672_cov_39.029084	1391	1470	238	1	79	0.0126582
NODE_240_length_4672_cov_39.029084	1391	1470	240	3	79	0.0379747
NODE_240_length_4672_cov_39.029084	1391	1470	242	1	79	0.0126582
NODE_240_length_4672_cov_39.029084	1391	1470	255	1	79	0.0126582
NODE_240_length_4672_cov_39.029084	1391	1470	257	1	79	0.0126582
NODE_240_length_4672_cov_39.029084	1391	1470	262	1	79	0.0126582
NODE_240_length_4672_cov_39.029084	1391	1470	268	2	79	0.0253165
NODE_240_length_4672_cov_39.029084	1391	1470	270	1	79	0.0126582
NODE_240_length_4672_cov_39.029084	1391	1470	273	1	79	0.0126582
NODE_240_length_4672_cov_39.029084	1391	1470	277	1	79	0.0126582
NODE_240_length_4672_cov_39.029084	1391	1470	280	1	79	0.0126582
NODE_240_length_4672_cov_39.029084	1391	1470	288	1	79	0.0126582
NODE_240_length_4672_cov_39.029084	1391	1470	293	1	79	0.0126582
NODE_240_length_4672_cov_39.029084	1391	1470	304	1	79	0.0126582
NODE_240_length_4672_cov_39.029084	1391	1470	311	3	79	0.0379747
NODE_240_length_4672_cov_39.029084	1391	1470	313	1	79	0.0126582
NODE_240_length_4672_cov_39.029084	1391	1470	316	1	79	0.0126582
NODE_240_length_4672_cov_39.029084	1391	1470	318	1	79	0.0126582
NODE_240_length_4672_cov_39.029084	1391	1470	325	1	79	0.0126582
NODE_240_length_4672_cov_39.029084	1391	1470	339	1	79	0.0126582
NODE_240_length_4672_cov_39.029084	1391	1470	340	1	79	0.0126582
NODE_240_length_4672_cov_39.029084	1391	1470	341	1	79	0.0126582
NODE_240_length_4672_cov_39.029084	1391	1470	342	3	79	0.0379747
NODE_240_length_4672_cov_39.029084	1391	1470	344	1	79	0.0126582
NODE_240_length_4672_cov_39.029084	1391	1470	346	2	79	0.0253165
NODE_240_length_4672_cov_39.029084	1391	1470	352	2	79	0.0253165
NODE_240_length_4672_cov_39.029084	1391	1470	354	2	79	0.0253165
NODE_240_length_4672_cov_39.029084	1391	1470	356	1	79	0.0126582
NODE_240_length_4672_cov_39.029084	1391	1470	359	1	79	0.0126582
NODE_240_length_4672_cov_39.029084	1391	1470	360	2	79	0.0253165
NODE_240_length_4672_cov_39.029084	1391	1470	361	1	79	0.0126582
NODE_240_length_4672_cov_39.029084	1391	1470	363	1	79	0.0126582
NODE_240_length_4672_cov_39.029084	1391	1470	364	1	79	0.0126582
NODE_240_length_4672_cov_39.029084	1391	1470	370	2	79	0.0253165
NODE_240_length_4672_cov_39.029084	1391	1470	375	3	79	0.0379747
NODE_240_length_4672_cov_39.029084	1391	1470	376	1	79	0.0126582
NODE_240_length_4672_cov_39.029084	1391	1470	378	3	79	0.0379747
NODE_240_length_4672_cov_39.029084	1391	1470	380	5	79	0.0632911
NODE_240_length_4672_cov_39.029084	1391	1470	382	2	79	0.0253165
NODE_240_length_4672_cov_39.029084	1391	1470	384	2	79	0.0253165
NODE_240_length_4672_cov_39.029084	1444	1523	150	2	79	0.0253165
NODE_240_length_4672_cov_39.029084	1444	1523	158	1	79	0.0126582
NODE_240_length_4672_cov_39.029084	1444	1523	166	1	79	0.0126582
NODE_240_length_4672_cov_39.029084	1444	1523	176	1	79	0.0126582
NODE_240_length_4672_cov_39.029084	1444	1523	179	1	79	0.0126582
NODE_240_length_4672_cov_39.029084	1444	1523	186	1	79	0.0126582
NODE_240_length_4672_cov_39.029084	1444	1523	194	1	79	0.0126582
NODE_240_length_4672_cov_39.029084	1444	1523	202	1	79	0.0126582
NODE_240_length_4672_cov_39.029084	1444	1523	204	1	79	0.0126582
NODE_240_length_4672_cov_39.029084	1444	1523	206	1	79	0.0126582
NODE_240_length_4672_cov_39.029084	1444	1523	207	1	79	0.0126582
NODE_240_length_4672_cov_39.029084	1444	1523	226	1	79	0.0126582
NODE_240_length_4672_cov_39.029084	1444	1523	232	1	79	0.0126582
NODE_240_length_4672_cov_39.029084	1444	1523	239	1	79	0.0126582
NODE_240_length_4672_cov_39.029084	1444	1523	247	2	79	0.0253165
NODE_240_length_4672_cov_39.029084	1444	1523	255	1	79	0.0126582
NODE_240_length_4672_cov_39.029084	1444	1523	269	1	79	0.0126582
NODE_240_length_4672_cov_39.029084	1444	1523	271	2	79	0.0253165
NODE_240_length_4672_cov_39.029084	1444	1523	275	1	79	0.0126582
NODE_240_length_4672_cov_39.029084	1444	1523	279	1	79	0.0126582
NODE_240_length_4672_cov_39.029084	1444	1523	283	2	79	0.0253165
NODE_240_length_4672_cov_39.029084	1444	1523	286	3	79	0.0379747
NODE_240_length_4672_cov_39.029084	1444	1523	290	2	79	0.0253165
NODE_240_length_4672_cov_39.029084	1444	1523	295	1	79	0.0126582
NODE_240_length_4672_cov_39.029084	1444	1523	305	1	79	0.0126582
NODE_240_length_4672_cov_39.029084	1444	1523	308	1	79	0.0126582
NODE_240_length_4672_cov_39.029084	1444	1523	311	3	79	0.0379747
NODE_240_length_4672_cov_39.029084	1444	1523	312	1	79	0.0126582
NODE_240_length_4672_cov_39.029084	1444	1523	314	2	79	0.0253165
NODE_240_length_4672_cov_39.029084	1444	1523	316	1	79	0.0126582
NODE_240_length_4672_cov_39.029084	1444	1523	320	1	79	0.0126582
NODE_240_length_4672_cov_39.029084	1444	1523	324	3	79	0.0379747
NODE_240_length_4672_cov_39.029084	1444	1523	326	1	79	0.0126582
NODE_240_length_4672_cov_39.029084	1444	1523	328	2	79	0.0253165
NODE_240_length_4672_cov_39.029084	1444	1523	331	1	79	0.0126582
NODE_240_length_4672_cov_39.029084	1444	1523	332	1	79	0.0126582
NODE_240_length_4672_cov_39.029084	1444	1523	343	3	79	0.0379747
NODE_240_length_4672_cov_39.029084	1444	1523	344	1	79	0.0126582
NODE_240_length_4672_cov_39.029084	1444	1523	346	2	79	0.0253165
NODE_240_length_4672_cov_39.029084	1444	1523	352	1	79	0.0126582
NODE_240_length_4672_cov_39.029084	1444	1523	354	1	79	0.0126582
NODE_240_length_4672_cov_39.029084	1444	1523	360	2	79	0.0253165
NODE_240_length_4672_cov_39.029084	1444	1523	363	1	79	0.0126582
NODE_240_length_4672_cov_39.029084	1444	1523	364	1	79	0.0126582
NODE_240_length_4672_cov_39.029084	1444	1523	370	2	79	0.0253165
NODE_240_length_4672_cov_39.029084	1444	1523	375	3	79	0.0379747
NODE_240_length_4672_cov_39.029084	1444	1523	376	1	79	0.0126582
NODE_240_length_4672_cov_39.029084	1444	1523	378	3	79	0.0379747
NODE_240_length_4672_cov_39.029084	1444	1523	380	5	79	0.0632911
NODE_240_length_4672_cov_39.029084	1444	1523	382	2	79	0.0253165
NODE_240_length_4672_cov_39.029084	1444	1523	384	2	79	0.0253165
NODE_246_length_4602_cov_17.281368	3106	3186	44	1	80	0.0125000
NODE_246_length_4602_cov_17.281368	3106	3186	46	15	80	0.1875000
NODE_246_length_4602_cov_17.281368	3106	3186	50	1	80	0.0125000
NODE_246_length_4602_cov_17.281368	3106	3186	58	1	80	0.0125000
NODE_246_length_4602_cov_17.281368	3106	3186	60	3	80	0.0375000
NODE_246_length_4602_cov_17.281368	3106	3186	68	3	80	0.0375000
NODE_246_length_4602_cov_17.281368	3106	3186	70	5	80	0.0625000
NODE_246_length_4602_cov_17.281368	3106	3186	74	3	80	0.0375000
NODE_246_length_4602_cov_17.281368	3106	3186	76	5	80	0.0625000
NODE_246_length_4602_cov_17.281368	3106	3186	78	2	80	0.0250000
NODE_246_length_4602_cov_17.281368	3106	3186	80	31	80	0.3875000
NODE_246_length_4602_cov_17.281368	3106	3186	81	1	80	0.0125000
NODE_246_length_4602_cov_17.281368	3106	3186	82	1	80	0.0125000
NODE_246_length_4602_cov_17.281368	3106	3186	84	8	80	0.1000000
NODE_246_length_4602_cov_17.281368	3159	3239	24	2	80	0.0250000
NODE_246_length_4602_cov_17.281368	3159	3239	26	6	80	0.0750000
NODE_246_length_4602_cov_17.281368	3159	3239	28	5	80	0.0625000
NODE_246_length_4602_cov_17.281368	3159	3239	33	1	80	0.0125000
NODE_246_length_4602_cov_17.281368	3159	3239	34	1	80	0.0125000
NODE_246_length_4602_cov_17.281368	3159	3239	40	5	80	0.0625000
NODE_246_length_4602_cov_17.281368	3159	3239	42	9	80	0.1125000
NODE_246_length_4602_cov_17.281368	3159	3239	44	5	80	0.0625000
NODE_246_length_4602_cov_17.281368	3159	3239	50	3	80	0.0375000
NODE_246_length_4602_cov_17.281368	3159	3239	52	4	80	0.0500000
NODE_246_length_4602_cov_17.281368	3159	3239	60	1	80	0.0125000
NODE_246_length_4602_cov_17.281368	3159	3239	64	3	80	0.0375000
NODE_246_length_4602_cov_17.281368	3159	3239	66	2	80	0.0250000
NODE_246_length_4602_cov_17.281368	3159	3239	68	2	80	0.0250000
NODE_246_length_4602_cov_17.281368	3159	3239	70	4	80	0.0500000
NODE_246_length_4602_cov_17.281368	3159	3239	74	1	80	0.0125000
NODE_246_length_4602_cov_17.281368	3159	3239	78	1	80	0.0125000
NODE_246_length_4602_cov_17.281368	3159	3239	80	17	80	0.2125000
NODE_246_length_4602_cov_17.281368	3159	3239	81	1	80	0.0125000
NODE_246_length_4602_cov_17.281368	3159	3239	84	7	80	0.0875000
NODE_248_length_4587_cov_14.431150	1294	1370	170	2	76	0.0263158
NODE_248_length_4587_cov_14.431150	1294	1370	171	1	76	0.0131579
NODE_248_length_4587_cov_14.431150	1294	1370	173	2	76	0.0263158
NODE_248_length_4587_cov_14.431150	1294	1370	175	2	76	0.0263158
NODE_248_length_4587_cov_14.431150	1294	1370	176	1	76	0.0131579
NODE_248_length_4587_cov_14.431150	1294	1370	180	2	76	0.0263158
NODE_248_length_4587_cov_14.431150	1294	1370	186	1	76	0.0131579
NODE_248_length_4587_cov_14.431150	1294	1370	195	1	76	0.0131579
NODE_248_length_4587_cov_14.431150	1294	1370	200	1	76	0.0131579
NODE_248_length_4587_cov_14.431150	1294	1370	201	2	76	0.0263158
NODE_248_length_4587_cov_14.431150	1294	1370	210	1	76	0.0131579
NODE_248_length_4587_cov_14.431150	1294	1370	212	1	76	0.0131579
NODE_248_length_4587_cov_14.431150	1294	1370	223	1	76	0.0131579
NODE_248_length_4587_cov_14.431150	1294	1370	227	1	76	0.0131579
NODE_248_length_4587_cov_14.431150	1294	1370	229	1	76	0.0131579
NODE_248_length_4587_cov_14.431150	1294	1370	238	1	76	0.0131579
NODE_248_length_4587_cov_14.431150	1294	1370	243	1	76	0.0131579
NODE_248_length_4587_cov_14.431150	1294	1370	248	1	76	0.0131579
NODE_248_length_4587_cov_14.431150	1294	1370	249	1	76	0.0131579
NODE_248_length_4587_cov_14.431150	1294	1370	253	1	76	0.0131579
NODE_248_length_4587_cov_14.431150	1294	1370	257	2	76	0.0263158
NODE_248_length_4587_cov_14.431150	1294	1370	259	1	76	0.0131579
NODE_248_length_4587_cov_14.431150	1294	1370	261	2	76	0.0263158
NODE_248_length_4587_cov_14.431150	1294	1370	262	2	76	0.0263158
NODE_248_length_4587_cov_14.431150	1294	1370	263	1	76	0.0131579
NODE_248_length_4587_cov_14.431150	1294	1370	270	1	76	0.0131579
NODE_248_length_4587_cov_14.431150	1294	1370	274	1	76	0.0131579
NODE_248_length_4587_cov_14.431150	1294	1370	277	1	76	0.0131579
NODE_248_length_4587_cov_14.431150	1294	1370	281	1	76	0.0131579
NODE_248_length_4587_cov_14.431150	1294	1370	282	2	76	0.0263158
NODE_248_length_4587_cov_14.431150	1294	1370	284	1	76	0.0131579
NODE_248_length_4587_cov_14.431150	1294	1370	286	3	76	0.0394737
NODE_248_length_4587_cov_14.431150	1294	1370	288	7	76	0.0921053
NODE_248_length_4587_cov_14.431150	1294	1370	289	3	76	0.0394737
NODE_248_length_4587_cov_14.431150	1294	1370	290	4	76	0.0526316
NODE_248_length_4587_cov_14.431150	1294	1370	293	1	76	0.0131579
NODE_248_length_4587_cov_14.431150	1294	1370	300	1	76	0.0131579
NODE_248_length_4587_cov_14.431150	1294	1370	301	2	76	0.0263158
NODE_248_length_4587_cov_14.431150	1294	1370	303	1	76	0.0131579
NODE_248_length_4587_cov_14.431150	1294	1370	305	1	76	0.0131579
NODE_248_length_4587_cov_14.431150	1294	1370	307	1	76	0.0131579
NODE_248_length_4587_cov_14.431150	1294	1370	309	4	76	0.0526316
NODE_248_length_4587_cov_14.431150	1294	1370	310	4	76	0.0526316
NODE_248_length_4587_cov_14.431150	1294	1370	311	3	76	0.0394737
NODE_248_length_4587_cov_14.431150	1294	1370	314	1	76	0.0131579
NODE_248_length_4587_cov_14.431150	1347	1427	244	1	80	0.0125000
NODE_248_length_4587_cov_14.431150	1347	1427	245	1	80	0.0125000
NODE_248_length_4587_cov_14.431150	1347	1427	246	1	80	0.0125000
NODE_248_length_4587_cov_14.431150	1347	1427	247	1	80	0.0125000
NODE_248_length_4587_cov_14.431150	1347	1427	252	1	80	0.0125000
NODE_248_length_4587_cov_14.431150	1347	1427	256	1	80	0.0125000
NODE_248_length_4587_cov_14.431150	1347	1427	260	1	80	0.0125000
NODE_248_length_4587_cov_14.431150	1347	1427	261	1	80	0.0125000
NODE_248_length_4587_cov_14.431150	1347	1427	266	1	80	0.0125000
NODE_248_length_4587_cov_14.431150	1347	1427	268	2	80	0.0250000
NODE_248_length_4587_cov_14.431150	1347	1427	269	1	80	0.0125000
NODE_248_length_4587_cov_14.431150	1347	1427	270	2	80	0.0250000
NODE_248_length_4587_cov_14.431150	1347	1427	272	1	80	0.0125000
NODE_248_length_4587_cov_14.431150	1347	1427	273	1	80	0.0125000
NODE_248_length_4587_cov_14.431150	1347	1427	274	1	80	0.0125000
NODE_248_length_4587_cov_14.431150	1347	1427	275	1	80	0.0125000
NODE_248_length_4587_cov_14.431150	1347	1427	279	1	80	0.0125000
NODE_248_length_4587_cov_14.431150	1347	1427	281	1	80	0.0125000
NODE_248_length_4587_cov_14.431150	1347	1427	286	1	80	0.0125000
NODE_248_length_4587_cov_14.431150	1347	1427	289	3	80	0.0375000
NODE_248_length_4587_cov_14.431150	1347	1427	290	2	80	0.0250000
NODE_248_length_4587_cov_14.431150	1347	1427	291	1	80	0.0125000
NODE_248_length_4587_cov_14.431150	1347	1427	293	1	80	0.0125000
NODE_248_length_4587_cov_14.431150	1347	1427	294	1	80	0.0125000
NODE_248_length_4587_cov_14.431150	1347	1427	296	1	80	0.0125000
NODE_248_length_4587_cov_14.431150	1347	1427	298	1	80	0.0125000
NODE_248_length_4587_cov_14.431150	1347	1427	299	1	80	0.0125000
NODE_248_length_4587_cov_14.431150	1347	1427	300	3	80	0.0375000
NODE_248_length_4587_cov_14.431150	1347	1427	301	4	80	0.0500000
NODE_248_length_4587_cov_14.431150	1347	1427	303	5	80	0.0625000
NODE_248_length_4587_cov_14.431150	1347	1427	305	6	80	0.0750000
NODE_248_length_4587_cov_14.431150	1347	1427	307	9	80	0.1125000
NODE_248_length_4587_cov_14.431150	1347	1427	309	9	80	0.1125000
NODE_248_length_4587_cov_14.431150	1347	1427	310	4	80	0.0500000
NODE_248_length_4587_cov_14.431150	1347	1427	311	5	80	0.0625000
NODE_248_length_4587_cov_14.431150	1347	1427	314	2	80	0.0250000
NODE_248_length_4587_cov_14.431150	1347	1427	316	1	80	0.0125000
NODE_248_length_4587_cov_14.431150	1466	1533	106	1	67	0.0149254
NODE_248_length_4587_cov_14.431150	1466	1533	112	1	67	0.0149254
NODE_248_length_4587_cov_14.431150	1466	1533	113	2	67	0.0298507
NODE_248_length_4587_cov_14.431150	1466	1533	115	1	67	0.0149254
NODE_248_length_4587_cov_14.431150	1466	1533	119	2	67	0.0298507
NODE_248_length_4587_cov_14.431150	1466	1533	120	3	67	0.0447761
NODE_248_length_4587_cov_14.431150	1466	1533	121	2	67	0.0298507
NODE_248_length_4587_cov_14.431150	1466	1533	122	4	67	0.0597015
NODE_248_length_4587_cov_14.431150	1466	1533	123	1	67	0.0149254
NODE_248_length_4587_cov_14.431150	1466	1533	124	2	67	0.0298507
NODE_248_length_4587_cov_14.431150	1466	1533	130	5	67	0.0746269
NODE_248_length_4587_cov_14.431150	1466	1533	131	1	67	0.0149254
NODE_248_length_4587_cov_14.431150	1466	1533	132	1	67	0.0149254
NODE_248_length_4587_cov_14.431150	1466	1533	133	2	67	0.0298507
NODE_248_length_4587_cov_14.431150	1466	1533	134	3	67	0.0447761
NODE_248_length_4587_cov_14.431150	1466	1533	135	6	67	0.0895522
NODE_248_length_4587_cov_14.431150	1466	1533	137	2	67	0.0298507
NODE_248_length_4587_cov_14.431150	1466	1533	140	1	67	0.0149254
NODE_248_length_4587_cov_14.431150	1466	1533	141	5	67	0.0746269
NODE_248_length_4587_cov_14.431150	1466	1533	142	4	67	0.0597015
NODE_248_length_4587_cov_14.431150	1466	1533	143	3	67	0.0447761
NODE_248_length_4587_cov_14.431150	1466	1533	144	2	67	0.0298507
NODE_248_length_4587_cov_14.431150	1466	1533	145	3	67	0.0447761
NODE_248_length_4587_cov_14.431150	1466	1533	146	2	67	0.0298507
NODE_248_length_4587_cov_14.431150	1466	1533	147	2	67	0.0298507
NODE_248_length_4587_cov_14.431150	1466	1533	148	1	67	0.0149254
NODE_248_length_4587_cov_14.431150	1466	1533	149	1	67	0.0149254
NODE_248_length_4587_cov_14.431150	1466	1533	152	2	67	0.0298507
NODE_248_length_4587_cov_14.431150	1466	1533	156	1	67	0.0149254
NODE_248_length_4587_cov_14.431150	1466	1533	165	1	67	0.0149254
NODE_248_length_4587_cov_14.431150	4316	4382	348	1	66	0.0151515
NODE_248_length_4587_cov_14.431150	4316	4382	361	1	66	0.0151515
NODE_248_length_4587_cov_14.431150	4316	4382	368	1	66	0.0151515
NODE_248_length_4587_cov_14.431150	4316	4382	400	1	66	0.0151515
NODE_248_length_4587_cov_14.431150	4316	4382	402	1	66	0.0151515
NODE_248_length_4587_cov_14.431150	4316	4382	411	1	66	0.0151515
NODE_248_length_4587_cov_14.431150	4316	4382	413	1	66	0.0151515
NODE_248_length_4587_cov_14.431150	4316	4382	419	1	66	0.0151515
NODE_248_length_4587_cov_14.431150	4316	4382	422	1	66	0.0151515
NODE_248_length_4587_cov_14.431150	4316	4382	423	1	66	0.0151515
NODE_248_length_4587_cov_14.431150	4316	4382	424	1	66	0.0151515
NODE_248_length_4587_cov_14.431150	4316	4382	459	1	66	0.0151515
NODE_248_length_4587_cov_14.431150	4316	4382	485	1	66	0.0151515
NODE_248_length_4587_cov_14.431150	4316	4382	514	1	66	0.0151515
NODE_248_length_4587_cov_14.431150	4316	4382	520	1	66	0.0151515
NODE_248_length_4587_cov_14.431150	4316	4382	526	1	66	0.0151515
NODE_248_length_4587_cov_14.431150	4316	4382	535	1	66	0.0151515
NODE_248_length_4587_cov_14.431150	4316	4382	537	1	66	0.0151515
NODE_248_length_4587_cov_14.431150	4316	4382	547	1	66	0.0151515
NODE_248_length_4587_cov_14.431150	4316	4382	551	2	66	0.0303030
NODE_248_length_4587_cov_14.431150	4316	4382	554	1	66	0.0151515
NODE_248_length_4587_cov_14.431150	4316	4382	564	1	66	0.0151515
NODE_248_length_4587_cov_14.431150	4316	4382	567	2	66	0.0303030
NODE_248_length_4587_cov_14.431150	4316	4382	574	1	66	0.0151515
NODE_248_length_4587_cov_14.431150	4316	4382	578	1	66	0.0151515
NODE_248_length_4587_cov_14.431150	4316	4382	584	1	66	0.0151515
NODE_248_length_4587_cov_14.431150	4316	4382	587	1	66	0.0151515
NODE_248_length_4587_cov_14.431150	4316	4382	595	1	66	0.0151515
NODE_248_length_4587_cov_14.431150	4316	4382	613	1	66	0.0151515
NODE_248_length_4587_cov_14.431150	4316	4382	626	1	66	0.0151515
NODE_248_length_4587_cov_14.431150	4316	4382	627	1	66	0.0151515
NODE_248_length_4587_cov_14.431150	4316	4382	630	2	66	0.0303030
NODE_248_length_4587_cov_14.431150	4316	4382	632	2	66	0.0303030
NODE_248_length_4587_cov_14.431150	4316	4382	644	1	66	0.0151515
NODE_248_length_4587_cov_14.431150	4316	4382	646	1	66	0.0151515
NODE_248_length_4587_cov_14.431150	4316	4382	649	2	66	0.0303030
NODE_248_length_4587_cov_14.431150	4316	4382	657	1	66	0.0151515
NODE_248_length_4587_cov_14.431150	4316	4382	658	1	66	0.0151515
NODE_248_length_4587_cov_14.431150	4316	4382	660	1	66	0.0151515
NODE_248_length_4587_cov_14.431150	4316	4382	661	1	66	0.0151515
NODE_248_length_4587_cov_14.431150	4316	4382	662	3	66	0.0454545
NODE_248_length_4587_cov_14.431150	4316	4382	663	1	66	0.0151515
NODE_248_length_4587_cov_14.431150	4316	4382	664	1	66	0.0151515
NODE_248_length_4587_cov_14.431150	4316	4382	665	1	66	0.0151515
NODE_248_length_4587_cov_14.431150	4316	4382	667	2	66	0.0303030
NODE_248_length_4587_cov_14.431150	4316	4382	669	1	66	0.0151515
NODE_248_length_4587_cov_14.431150	4316	4382	670	5	66	0.0757576
NODE_248_length_4587_cov_14.431150	4316	4382	671	2	66	0.0303030
NODE_248_length_4587_cov_14.431150	4316	4382	672	3	66	0.0454545
NODE_248_length_4587_cov_14.431150	4316	4382	673	2	66	0.0303030
NODE_248_length_4587_cov_14.431150	4355	4435	482	1	80	0.0125000
NODE_248_length_4587_cov_14.431150	4355	4435	484	1	80	0.0125000
NODE_248_length_4587_cov_14.431150	4355	4435	488	1	80	0.0125000
NODE_248_length_4587_cov_14.431150	4355	4435	507	1	80	0.0125000
NODE_248_length_4587_cov_14.431150	4355	4435	521	1	80	0.0125000
NODE_248_length_4587_cov_14.431150	4355	4435	529	1	80	0.0125000
NODE_248_length_4587_cov_14.431150	4355	4435	542	1	80	0.0125000
NODE_248_length_4587_cov_14.431150	4355	4435	551	1	80	0.0125000
NODE_248_length_4587_cov_14.431150	4355	4435	566	1	80	0.0125000
NODE_248_length_4587_cov_14.431150	4355	4435	570	1	80	0.0125000
NODE_248_length_4587_cov_14.431150	4355	4435	574	1	80	0.0125000
NODE_248_length_4587_cov_14.431150	4355	4435	578	1	80	0.0125000
NODE_248_length_4587_cov_14.431150	4355	4435	582	1	80	0.0125000
NODE_248_length_4587_cov_14.431150	4355	4435	585	1	80	0.0125000
NODE_248_length_4587_cov_14.431150	4355	4435	601	1	80	0.0125000
NODE_248_length_4587_cov_14.431150	4355	4435	602	1	80	0.0125000
NODE_248_length_4587_cov_14.431150	4355	4435	603	1	80	0.0125000
NODE_248_length_4587_cov_14.431150	4355	4435	607	1	80	0.0125000
NODE_248_length_4587_cov_14.431150	4355	4435	643	1	80	0.0125000
NODE_248_length_4587_cov_14.431150	4355	4435	644	1	80	0.0125000
NODE_248_length_4587_cov_14.431150	4355	4435	647	1	80	0.0125000
NODE_248_length_4587_cov_14.431150	4355	4435	649	2	80	0.0250000
NODE_248_length_4587_cov_14.431150	4355	4435	650	1	80	0.0125000
NODE_248_length_4587_cov_14.431150	4355	4435	656	1	80	0.0125000
NODE_248_length_4587_cov_14.431150	4355	4435	657	1	80	0.0125000
NODE_248_length_4587_cov_14.431150	4355	4435	658	2	80	0.0250000
NODE_248_length_4587_cov_14.431150	4355	4435	660	2	80	0.0250000
NODE_248_length_4587_cov_14.431150	4355	4435	661	1	80	0.0125000
NODE_248_length_4587_cov_14.431150	4355	4435	662	4	80	0.0500000
NODE_248_length_4587_cov_14.431150	4355	4435	663	2	80	0.0250000
NODE_248_length_4587_cov_14.431150	4355	4435	664	2	80	0.0250000
NODE_248_length_4587_cov_14.431150	4355	4435	665	4	80	0.0500000
NODE_248_length_4587_cov_14.431150	4355	4435	666	1	80	0.0125000
NODE_248_length_4587_cov_14.431150	4355	4435	667	3	80	0.0375000
NODE_248_length_4587_cov_14.431150	4355	4435	669	1	80	0.0125000
NODE_248_length_4587_cov_14.431150	4355	4435	670	6	80	0.0750000
NODE_248_length_4587_cov_14.431150	4355	4435	671	4	80	0.0500000
NODE_248_length_4587_cov_14.431150	4355	4435	672	4	80	0.0500000
NODE_248_length_4587_cov_14.431150	4355	4435	673	2	80	0.0250000
NODE_248_length_4587_cov_14.431150	4355	4435	674	3	80	0.0375000
NODE_248_length_4587_cov_14.431150	4355	4435	676	3	80	0.0375000
NODE_248_length_4587_cov_14.431150	4355	4435	678	3	80	0.0375000
NODE_248_length_4587_cov_14.431150	4355	4435	681	2	80	0.0250000
NODE_248_length_4587_cov_14.431150	4355	4435	683	3	80	0.0375000
NODE_248_length_4587_cov_14.431150	4355	4435	685	2	80	0.0250000
NODE_249_length_4572_cov_50.244579	2406	2483	0	14	77	0.1818182
NODE_249_length_4572_cov_50.244579	2406	2483	2	13	77	0.1688312
NODE_249_length_4572_cov_50.244579	2406	2483	4	26	77	0.3376623
NODE_249_length_4572_cov_50.244579	2406	2483	6	24	77	0.3116883
NODE_249_length_4572_cov_50.244579	2406	2483	0	14	77	0.1818182
NODE_249_length_4572_cov_50.244579	2406	2483	2	13	77	0.1688312
NODE_249_length_4572_cov_50.244579	2406	2483	4	26	77	0.3376623
NODE_249_length_4572_cov_50.244579	2406	2483	6	24	77	0.3116883
NODE_251_length_4556_cov_14.556652	4229	4288	38	2	59	0.0338983
NODE_251_length_4556_cov_14.556652	4229	4288	40	1	59	0.0169492
NODE_251_length_4556_cov_14.556652	4229	4288	41	6	59	0.1016949
NODE_251_length_4556_cov_14.556652	4229	4288	43	4	59	0.0677966
NODE_251_length_4556_cov_14.556652	4229	4288	44	9	59	0.1525424
NODE_251_length_4556_cov_14.556652	4229	4288	46	3	59	0.0508475
NODE_251_length_4556_cov_14.556652	4229	4288	50	6	59	0.1016949
NODE_251_length_4556_cov_14.556652	4229	4288	51	5	59	0.0847458
NODE_251_length_4556_cov_14.556652	4229	4288	53	1	59	0.0169492
NODE_251_length_4556_cov_14.556652	4229	4288	54	1	59	0.0169492
NODE_251_length_4556_cov_14.556652	4229	4288	55	1	59	0.0169492
NODE_251_length_4556_cov_14.556652	4229	4288	57	1	59	0.0169492
NODE_251_length_4556_cov_14.556652	4229	4288	59	4	59	0.0677966
NODE_251_length_4556_cov_14.556652	4229	4288	60	11	59	0.1864407
NODE_251_length_4556_cov_14.556652	4229	4288	61	2	59	0.0338983
NODE_251_length_4556_cov_14.556652	4229	4288	62	1	59	0.0169492
NODE_251_length_4556_cov_14.556652	4229	4288	63	1	59	0.0169492
NODE_252_length_4550_cov_5.664120	3548	3628	0	80	80	1.0000000
NODE_252_length_4550_cov_5.664120	3601	3681	0	48	80	0.6000000
NODE_252_length_4550_cov_5.664120	3601	3681	4	2	80	0.0250000
NODE_252_length_4550_cov_5.664120	3601	3681	6	17	80	0.2125000
NODE_252_length_4550_cov_5.664120	3601	3681	8	13	80	0.1625000
NODE_253_length_4544_cov_10.690439	353	433	0	80	80	1.0000000
NODE_253_length_4544_cov_10.690439	406	486	0	80	80	1.0000000
NODE_253_length_4544_cov_10.690439	4487	4544	0	55	57	0.9649123
NODE_253_length_4544_cov_10.690439	4487	4544	17	1	57	0.0175439
NODE_253_length_4544_cov_10.690439	4487	4544	20	1	57	0.0175439
NODE_255_length_4535_cov_24.849188	675	755	0	50	80	0.6250000
NODE_255_length_4535_cov_24.849188	675	755	2	30	80	0.3750000
NODE_255_length_4535_cov_24.849188	728	809	0	15	81	0.1851852
NODE_255_length_4535_cov_24.849188	728	809	2	66	81	0.8148148
NODE_255_length_4535_cov_24.849188	1319	1399	0	47	80	0.5875000
NODE_255_length_4535_cov_24.849188	1319	1399	1	8	80	0.1000000
NODE_255_length_4535_cov_24.849188	1319	1399	2	18	80	0.2250000
NODE_255_length_4535_cov_24.849188	1319	1399	3	6	80	0.0750000
NODE_255_length_4535_cov_24.849188	1319	1399	4	1	80	0.0125000
NODE_255_length_4535_cov_24.849188	1372	1452	1	2	80	0.0250000
NODE_255_length_4535_cov_24.849188	1372	1452	2	18	80	0.2250000
NODE_255_length_4535_cov_24.849188	1372	1452	3	6	80	0.0750000
NODE_255_length_4535_cov_24.849188	1372	1452	4	13	80	0.1625000
NODE_255_length_4535_cov_24.849188	1372	1452	5	1	80	0.0125000
NODE_255_length_4535_cov_24.849188	1372	1452	6	5	80	0.0625000
NODE_255_length_4535_cov_24.849188	1372	1452	10	3	80	0.0375000
NODE_255_length_4535_cov_24.849188	1372	1452	11	1	80	0.0125000
NODE_255_length_4535_cov_24.849188	1372	1452	15	1	80	0.0125000
NODE_255_length_4535_cov_24.849188	1372	1452	17	4	80	0.0500000
NODE_255_length_4535_cov_24.849188	1372	1452	21	1	80	0.0125000
NODE_255_length_4535_cov_24.849188	1372	1452	22	1	80	0.0125000
NODE_255_length_4535_cov_24.849188	1372	1452	23	1	80	0.0125000
NODE_255_length_4535_cov_24.849188	1372	1452	24	2	80	0.0250000
NODE_255_length_4535_cov_24.849188	1372	1452	33	1	80	0.0125000
NODE_255_length_4535_cov_24.849188	1372	1452	36	1	80	0.0125000
NODE_255_length_4535_cov_24.849188	1372	1452	37	2	80	0.0250000
NODE_255_length_4535_cov_24.849188	1372	1452	40	1	80	0.0125000
NODE_255_length_4535_cov_24.849188	1372	1452	49	1	80	0.0125000
NODE_255_length_4535_cov_24.849188	1372	1452	57	1	80	0.0125000
NODE_255_length_4535_cov_24.849188	1372	1452	59	1	80	0.0125000
NODE_255_length_4535_cov_24.849188	1372	1452	63	2	80	0.0250000
NODE_255_length_4535_cov_24.849188	1372	1452	69	1	80	0.0125000
NODE_255_length_4535_cov_24.849188	1372	1452	72	2	80	0.0250000
NODE_255_length_4535_cov_24.849188	1372	1452	74	3	80	0.0375000
NODE_255_length_4535_cov_24.849188	1372	1452	78	1	80	0.0125000
NODE_255_length_4535_cov_24.849188	1372	1452	79	1	80	0.0125000
NODE_255_length_4535_cov_24.849188	1372	1452	82	1	80	0.0125000
NODE_255_length_4535_cov_24.849188	1372	1452	87	1	80	0.0125000
NODE_255_length_4535_cov_24.849188	1372	1452	89	1	80	0.0125000
NODE_258_length_4528_cov_19.736509	4295	4366	0	70	71	0.9859155
NODE_258_length_4528_cov_19.736509	4295	4366	3	1	71	0.0140845
NODE_259_length_4505_cov_10.409215	3166	3202	157	1	36	0.0277778
NODE_259_length_4505_cov_10.409215	3166	3202	168	2	36	0.0555556
NODE_259_length_4505_cov_10.409215	3166	3202	170	2	36	0.0555556
NODE_259_length_4505_cov_10.409215	3166	3202	171	5	36	0.1388889
NODE_259_length_4505_cov_10.409215	3166	3202	172	2	36	0.0555556
NODE_259_length_4505_cov_10.409215	3166	3202	173	1	36	0.0277778
NODE_259_length_4505_cov_10.409215	3166	3202	176	1	36	0.0277778
NODE_259_length_4505_cov_10.409215	3166	3202	180	5	36	0.1388889
NODE_259_length_4505_cov_10.409215	3166	3202	182	1	36	0.0277778
NODE_259_length_4505_cov_10.409215	3166	3202	188	1	36	0.0277778
NODE_259_length_4505_cov_10.409215	3166	3202	189	1	36	0.0277778
NODE_259_length_4505_cov_10.409215	3166	3202	190	2	36	0.0555556
NODE_259_length_4505_cov_10.409215	3166	3202	194	1	36	0.0277778
NODE_259_length_4505_cov_10.409215	3166	3202	197	3	36	0.0833333
NODE_259_length_4505_cov_10.409215	3166	3202	200	1	36	0.0277778
NODE_259_length_4505_cov_10.409215	3166	3202	202	1	36	0.0277778
NODE_259_length_4505_cov_10.409215	3166	3202	207	6	36	0.1666667
NODE_259_length_4505_cov_10.409215	3175	3255	169	1	80	0.0125000
NODE_259_length_4505_cov_10.409215	3175	3255	170	2	80	0.0250000
NODE_259_length_4505_cov_10.409215	3175	3255	172	1	80	0.0125000
NODE_259_length_4505_cov_10.409215	3175	3255	173	1	80	0.0125000
NODE_259_length_4505_cov_10.409215	3175	3255	175	1	80	0.0125000
NODE_259_length_4505_cov_10.409215	3175	3255	176	2	80	0.0250000
NODE_259_length_4505_cov_10.409215	3175	3255	179	7	80	0.0875000
NODE_259_length_4505_cov_10.409215	3175	3255	180	5	80	0.0625000
NODE_259_length_4505_cov_10.409215	3175	3255	181	1	80	0.0125000
NODE_259_length_4505_cov_10.409215	3175	3255	182	1	80	0.0125000
NODE_259_length_4505_cov_10.409215	3175	3255	186	4	80	0.0500000
NODE_259_length_4505_cov_10.409215	3175	3255	187	1	80	0.0125000
NODE_259_length_4505_cov_10.409215	3175	3255	188	3	80	0.0375000
NODE_259_length_4505_cov_10.409215	3175	3255	189	3	80	0.0375000
NODE_259_length_4505_cov_10.409215	3175	3255	190	2	80	0.0250000
NODE_259_length_4505_cov_10.409215	3175	3255	194	1	80	0.0125000
NODE_259_length_4505_cov_10.409215	3175	3255	195	3	80	0.0375000
NODE_259_length_4505_cov_10.409215	3175	3255	197	3	80	0.0375000
NODE_259_length_4505_cov_10.409215	3175	3255	199	2	80	0.0250000
NODE_259_length_4505_cov_10.409215	3175	3255	200	1	80	0.0125000
NODE_259_length_4505_cov_10.409215	3175	3255	202	1	80	0.0125000
NODE_259_length_4505_cov_10.409215	3175	3255	205	2	80	0.0250000
NODE_259_length_4505_cov_10.409215	3175	3255	207	8	80	0.1000000
NODE_259_length_4505_cov_10.409215	3175	3255	208	3	80	0.0375000
NODE_259_length_4505_cov_10.409215	3175	3255	209	1	80	0.0125000
NODE_259_length_4505_cov_10.409215	3175	3255	210	1	80	0.0125000
NODE_259_length_4505_cov_10.409215	3175	3255	211	4	80	0.0500000
NODE_259_length_4505_cov_10.409215	3175	3255	212	3	80	0.0375000
NODE_259_length_4505_cov_10.409215	3175	3255	213	1	80	0.0125000
NODE_259_length_4505_cov_10.409215	3175	3255	214	1	80	0.0125000
NODE_259_length_4505_cov_10.409215	3175	3255	215	1	80	0.0125000
NODE_259_length_4505_cov_10.409215	3175	3255	216	2	80	0.0250000
NODE_259_length_4505_cov_10.409215	3175	3255	217	1	80	0.0125000
NODE_259_length_4505_cov_10.409215	3175	3255	218	6	80	0.0750000
NODE_260_length_4498_cov_8.216185	3161	3219	0	10	58	0.1724138
NODE_260_length_4498_cov_8.216185	3161	3219	2	48	58	0.8275862
NODE_260_length_4498_cov_8.216185	4257	4314	0	57	57	1.0000000
NODE_263_length_4476_cov_29.825451	141	215	0	16	74	0.2162162
NODE_263_length_4476_cov_29.825451	141	215	4	58	74	0.7837838
NODE_263_length_4476_cov_29.825451	1890	1970	52	2	80	0.0250000
NODE_263_length_4476_cov_29.825451	1890	1970	54	2	80	0.0250000
NODE_263_length_4476_cov_29.825451	1890	1970	56	1	80	0.0125000
NODE_263_length_4476_cov_29.825451	1890	1970	58	1	80	0.0125000
NODE_263_length_4476_cov_29.825451	1890	1970	60	2	80	0.0250000
NODE_263_length_4476_cov_29.825451	1890	1970	66	3	80	0.0375000
NODE_263_length_4476_cov_29.825451	1890	1970	68	1	80	0.0125000
NODE_263_length_4476_cov_29.825451	1890	1970	70	1	80	0.0125000
NODE_263_length_4476_cov_29.825451	1890	1970	72	5	80	0.0625000
NODE_263_length_4476_cov_29.825451	1890	1970	78	3	80	0.0375000
NODE_263_length_4476_cov_29.825451	1890	1970	80	12	80	0.1500000
NODE_263_length_4476_cov_29.825451	1890	1970	81	1	80	0.0125000
NODE_263_length_4476_cov_29.825451	1890	1970	82	11	80	0.1375000
NODE_263_length_4476_cov_29.825451	1890	1970	85	7	80	0.0875000
NODE_263_length_4476_cov_29.825451	1890	1970	87	2	80	0.0250000
NODE_263_length_4476_cov_29.825451	1890	1970	90	1	80	0.0125000
NODE_263_length_4476_cov_29.825451	1890	1970	92	5	80	0.0625000
NODE_263_length_4476_cov_29.825451	1890	1970	94	5	80	0.0625000
NODE_263_length_4476_cov_29.825451	1890	1970	96	1	80	0.0125000
NODE_263_length_4476_cov_29.825451	1890	1970	98	2	80	0.0250000
NODE_263_length_4476_cov_29.825451	1890	1970	100	8	80	0.1000000
NODE_263_length_4476_cov_29.825451	1890	1970	102	4	80	0.0500000
NODE_263_length_4476_cov_29.825451	1943	2023	74	4	80	0.0500000
NODE_263_length_4476_cov_29.825451	1943	2023	76	1	80	0.0125000
NODE_263_length_4476_cov_29.825451	1943	2023	78	7	80	0.0875000
NODE_263_length_4476_cov_29.825451	1943	2023	80	2	80	0.0250000
NODE_263_length_4476_cov_29.825451	1943	2023	82	7	80	0.0875000
NODE_263_length_4476_cov_29.825451	1943	2023	84	5	80	0.0625000
NODE_263_length_4476_cov_29.825451	1943	2023	86	1	80	0.0125000
NODE_263_length_4476_cov_29.825451	1943	2023	87	1	80	0.0125000
NODE_263_length_4476_cov_29.825451	1943	2023	89	1	80	0.0125000
NODE_263_length_4476_cov_29.825451	1943	2023	90	2	80	0.0250000
NODE_263_length_4476_cov_29.825451	1943	2023	92	8	80	0.1000000
NODE_263_length_4476_cov_29.825451	1943	2023	94	9	80	0.1125000
NODE_263_length_4476_cov_29.825451	1943	2023	95	2	80	0.0250000
NODE_263_length_4476_cov_29.825451	1943	2023	96	4	80	0.0500000
NODE_263_length_4476_cov_29.825451	1943	2023	98	2	80	0.0250000
NODE_263_length_4476_cov_29.825451	1943	2023	100	8	80	0.1000000
NODE_263_length_4476_cov_29.825451	1943	2023	101	4	80	0.0500000
NODE_263_length_4476_cov_29.825451	1943	2023	102	8	80	0.1000000
NODE_263_length_4476_cov_29.825451	1943	2023	103	1	80	0.0125000
NODE_263_length_4476_cov_29.825451	1943	2023	104	1	80	0.0125000
NODE_263_length_4476_cov_29.825451	1943	2023	105	2	80	0.0250000
NODE_264_length_4474_cov_17.051886	23	99	2	6	76	0.0789474
NODE_264_length_4474_cov_17.051886	23	99	4	70	76	0.9210526
NODE_264_length_4474_cov_17.051886	23	98	2	6	75	0.0800000
NODE_264_length_4474_cov_17.051886	23	98	4	69	75	0.9200000
NODE_264_length_4474_cov_17.051886	23	99	2	6	76	0.0789474
NODE_264_length_4474_cov_17.051886	23	99	4	70	76	0.9210526
NODE_264_length_4474_cov_17.051886	32	99	4	67	67	1.0000000
NODE_264_length_4474_cov_17.051886	76	140	2	24	64	0.3750000
NODE_264_length_4474_cov_17.051886	76	140	4	40	64	0.6250000
NODE_264_length_4474_cov_17.051886	1528	1569	89	1	41	0.0243902
NODE_264_length_4474_cov_17.051886	1528	1569	92	1	41	0.0243902
NODE_264_length_4474_cov_17.051886	1528	1569	93	5	41	0.1219512
NODE_264_length_4474_cov_17.051886	1528	1569	97	1	41	0.0243902
NODE_264_length_4474_cov_17.051886	1528	1569	98	2	41	0.0487805
NODE_264_length_4474_cov_17.051886	1528	1569	101	1	41	0.0243902
NODE_264_length_4474_cov_17.051886	1528	1569	102	2	41	0.0487805
NODE_264_length_4474_cov_17.051886	1528	1569	108	3	41	0.0731707
NODE_264_length_4474_cov_17.051886	1528	1569	110	2	41	0.0487805
NODE_264_length_4474_cov_17.051886	1528	1569	111	1	41	0.0243902
NODE_264_length_4474_cov_17.051886	1528	1569	112	1	41	0.0243902
NODE_264_length_4474_cov_17.051886	1528	1569	114	1	41	0.0243902
NODE_264_length_4474_cov_17.051886	1528	1569	120	2	41	0.0487805
NODE_264_length_4474_cov_17.051886	1528	1569	122	1	41	0.0243902
NODE_264_length_4474_cov_17.051886	1528	1569	123	2	41	0.0487805
NODE_264_length_4474_cov_17.051886	1528	1569	127	1	41	0.0243902
NODE_264_length_4474_cov_17.051886	1528	1569	129	1	41	0.0243902
NODE_264_length_4474_cov_17.051886	1528	1569	134	1	41	0.0243902
NODE_264_length_4474_cov_17.051886	1528	1569	135	1	41	0.0243902
NODE_264_length_4474_cov_17.051886	1528	1569	136	2	41	0.0487805
NODE_264_length_4474_cov_17.051886	1528	1569	138	3	41	0.0731707
NODE_264_length_4474_cov_17.051886	1528	1569	143	2	41	0.0487805
NODE_264_length_4474_cov_17.051886	1528	1569	144	1	41	0.0243902
NODE_264_length_4474_cov_17.051886	1528	1569	145	1	41	0.0243902
NODE_264_length_4474_cov_17.051886	1528	1569	148	1	41	0.0243902
NODE_264_length_4474_cov_17.051886	1528	1569	153	1	41	0.0243902
NODE_264_length_4474_cov_17.051886	1536	1609	44	10	73	0.1369863
NODE_264_length_4474_cov_17.051886	1536	1609	46	2	73	0.0273973
NODE_264_length_4474_cov_17.051886	1536	1609	48	2	73	0.0273973
NODE_264_length_4474_cov_17.051886	1536	1609	54	3	73	0.0410959
NODE_264_length_4474_cov_17.051886	1536	1609	55	3	73	0.0410959
NODE_264_length_4474_cov_17.051886	1536	1609	57	1	73	0.0136986
NODE_264_length_4474_cov_17.051886	1536	1609	60	2	73	0.0273973
NODE_264_length_4474_cov_17.051886	1536	1609	65	1	73	0.0136986
NODE_264_length_4474_cov_17.051886	1536	1609	67	2	73	0.0273973
NODE_264_length_4474_cov_17.051886	1536	1609	71	1	73	0.0136986
NODE_264_length_4474_cov_17.051886	1536	1609	73	2	73	0.0273973
NODE_264_length_4474_cov_17.051886	1536	1609	75	1	73	0.0136986
NODE_264_length_4474_cov_17.051886	1536	1609	78	1	73	0.0136986
NODE_264_length_4474_cov_17.051886	1536	1609	79	3	73	0.0410959
NODE_264_length_4474_cov_17.051886	1536	1609	81	5	73	0.0684932
NODE_264_length_4474_cov_17.051886	1536	1609	89	2	73	0.0273973
NODE_264_length_4474_cov_17.051886	1536	1609	92	1	73	0.0136986
NODE_264_length_4474_cov_17.051886	1536	1609	93	5	73	0.0684932
NODE_264_length_4474_cov_17.051886	1536	1609	97	1	73	0.0136986
NODE_264_length_4474_cov_17.051886	1536	1609	98	2	73	0.0273973
NODE_264_length_4474_cov_17.051886	1536	1609	101	1	73	0.0136986
NODE_264_length_4474_cov_17.051886	1536	1609	102	2	73	0.0273973
NODE_264_length_4474_cov_17.051886	1536	1609	108	3	73	0.0410959
NODE_264_length_4474_cov_17.051886	1536	1609	110	2	73	0.0273973
NODE_264_length_4474_cov_17.051886	1536	1609	111	1	73	0.0136986
NODE_264_length_4474_cov_17.051886	1536	1609	112	1	73	0.0136986
NODE_264_length_4474_cov_17.051886	1536	1609	114	1	73	0.0136986
NODE_264_length_4474_cov_17.051886	1536	1609	120	2	73	0.0273973
NODE_264_length_4474_cov_17.051886	1536	1609	122	1	73	0.0136986
NODE_264_length_4474_cov_17.051886	1536	1609	123	2	73	0.0273973
NODE_264_length_4474_cov_17.051886	1536	1609	127	1	73	0.0136986
NODE_264_length_4474_cov_17.051886	1536	1609	129	1	73	0.0136986
NODE_264_length_4474_cov_17.051886	1536	1609	134	1	73	0.0136986
NODE_264_length_4474_cov_17.051886	1536	1609	135	1	73	0.0136986
NODE_264_length_4474_cov_17.051886	1536	1609	136	1	73	0.0136986
NODE_264_length_4474_cov_17.051886	1536	1609	138	2	73	0.0273973
NODE_264_length_4474_cov_17.051886	1618	1643	0	19	25	0.7600000
NODE_264_length_4474_cov_17.051886	1618	1643	8	1	25	0.0400000
NODE_264_length_4474_cov_17.051886	1618	1643	11	1	25	0.0400000
NODE_264_length_4474_cov_17.051886	1618	1643	15	2	25	0.0800000
NODE_264_length_4474_cov_17.051886	1618	1643	17	2	25	0.0800000
NODE_264_length_4474_cov_17.051886	1618	1696	0	72	78	0.9230769
NODE_264_length_4474_cov_17.051886	1618	1696	8	1	78	0.0128205
NODE_264_length_4474_cov_17.051886	1618	1696	11	1	78	0.0128205
NODE_264_length_4474_cov_17.051886	1618	1696	15	2	78	0.0256410
NODE_264_length_4474_cov_17.051886	1618	1696	17	2	78	0.0256410
NODE_265_length_4474_cov_14.441829	282	362	0	80	80	1.0000000
NODE_265_length_4474_cov_14.441829	335	415	0	76	80	0.9500000
NODE_265_length_4474_cov_14.441829	335	415	2	1	80	0.0125000
NODE_265_length_4474_cov_14.441829	335	415	8	1	80	0.0125000
NODE_265_length_4474_cov_14.441829	335	415	26	1	80	0.0125000
NODE_265_length_4474_cov_14.441829	335	415	38	1	80	0.0125000
NODE_265_length_4474_cov_14.441829	1522	1575	0	31	53	0.5849057
NODE_265_length_4474_cov_14.441829	1522	1575	2	18	53	0.3396226
NODE_265_length_4474_cov_14.441829	1522	1575	15	1	53	0.0188679
NODE_265_length_4474_cov_14.441829	1522	1575	17	3	53	0.0566038
NODE_265_length_4474_cov_14.441829	1548	1623	0	9	75	0.1200000
NODE_265_length_4474_cov_14.441829	1548	1623	2	24	75	0.3200000
NODE_265_length_4474_cov_14.441829	1548	1623	4	10	75	0.1333333
NODE_265_length_4474_cov_14.441829	1548	1623	6	1	75	0.0133333
NODE_265_length_4474_cov_14.441829	1548	1623	8	1	75	0.0133333
NODE_265_length_4474_cov_14.441829	1548	1623	10	1	75	0.0133333
NODE_265_length_4474_cov_14.441829	1548	1623	12	3	75	0.0400000
NODE_265_length_4474_cov_14.441829	1548	1623	14	9	75	0.1200000
NODE_265_length_4474_cov_14.441829	1548	1623	18	2	75	0.0266667
NODE_265_length_4474_cov_14.441829	1548	1623	20	3	75	0.0400000
NODE_265_length_4474_cov_14.441829	1548	1623	22	4	75	0.0533333
NODE_265_length_4474_cov_14.441829	1548	1623	23	3	75	0.0400000
NODE_265_length_4474_cov_14.441829	1548	1623	25	3	75	0.0400000
NODE_265_length_4474_cov_14.441829	1548	1623	27	2	75	0.0266667
NODE_265_length_4474_cov_14.441829	3068	3121	2	13	53	0.2452830
NODE_265_length_4474_cov_14.441829	3068	3121	3	21	53	0.3962264
NODE_265_length_4474_cov_14.441829	3068	3121	5	7	53	0.1320755
NODE_265_length_4474_cov_14.441829	3068	3121	7	1	53	0.0188679
NODE_265_length_4474_cov_14.441829	3068	3121	8	2	53	0.0377358
NODE_265_length_4474_cov_14.441829	3068	3121	9	8	53	0.1509434
NODE_265_length_4474_cov_14.441829	3068	3121	10	1	53	0.0188679
NODE_268_length_4463_cov_7.023144	119	168	0	44	49	0.8979592
NODE_268_length_4463_cov_7.023144	119	168	19	1	49	0.0204082
NODE_268_length_4463_cov_7.023144	119	168	21	4	49	0.0816327
NODE_270_length_4453_cov_16.820395	3383	3463	71	1	80	0.0125000
NODE_270_length_4453_cov_16.820395	3383	3463	76	2	80	0.0250000
NODE_270_length_4453_cov_16.820395	3383	3463	90	1	80	0.0125000
NODE_270_length_4453_cov_16.820395	3383	3463	92	2	80	0.0250000
NODE_270_length_4453_cov_16.820395	3383	3463	99	1	80	0.0125000
NODE_270_length_4453_cov_16.820395	3383	3463	103	2	80	0.0250000
NODE_270_length_4453_cov_16.820395	3383	3463	111	1	80	0.0125000
NODE_270_length_4453_cov_16.820395	3383	3463	114	1	80	0.0125000
NODE_270_length_4453_cov_16.820395	3383	3463	119	2	80	0.0250000
NODE_270_length_4453_cov_16.820395	3383	3463	123	4	80	0.0500000
NODE_270_length_4453_cov_16.820395	3383	3463	127	1	80	0.0125000
NODE_270_length_4453_cov_16.820395	3383	3463	129	6	80	0.0750000
NODE_270_length_4453_cov_16.820395	3383	3463	131	3	80	0.0375000
NODE_270_length_4453_cov_16.820395	3383	3463	132	6	80	0.0750000
NODE_270_length_4453_cov_16.820395	3383	3463	133	16	80	0.2000000
NODE_270_length_4453_cov_16.820395	3383	3463	134	1	80	0.0125000
NODE_270_length_4453_cov_16.820395	3383	3463	135	1	80	0.0125000
NODE_270_length_4453_cov_16.820395	3383	3463	136	4	80	0.0500000
NODE_270_length_4453_cov_16.820395	3383	3463	137	2	80	0.0250000
NODE_270_length_4453_cov_16.820395	3383	3463	138	5	80	0.0625000
NODE_270_length_4453_cov_16.820395	3383	3463	140	4	80	0.0500000
NODE_270_length_4453_cov_16.820395	3383	3463	142	2	80	0.0250000
NODE_270_length_4453_cov_16.820395	3383	3463	143	1	80	0.0125000
NODE_270_length_4453_cov_16.820395	3383	3463	145	1	80	0.0125000
NODE_270_length_4453_cov_16.820395	3383	3463	149	7	80	0.0875000
NODE_270_length_4453_cov_16.820395	3383	3463	150	1	80	0.0125000
NODE_270_length_4453_cov_16.820395	3383	3463	155	2	80	0.0250000
NODE_270_length_4453_cov_16.820395	3436	3496	38	5	60	0.0833333
NODE_270_length_4453_cov_16.820395	3436	3496	42	3	60	0.0500000
NODE_270_length_4453_cov_16.820395	3436	3496	44	1	60	0.0166667
NODE_270_length_4453_cov_16.820395	3436	3496	46	7	60	0.1166667
NODE_270_length_4453_cov_16.820395	3436	3496	50	1	60	0.0166667
NODE_270_length_4453_cov_16.820395	3436	3496	54	3	60	0.0500000
NODE_270_length_4453_cov_16.820395	3436	3496	58	3	60	0.0500000
NODE_270_length_4453_cov_16.820395	3436	3496	60	3	60	0.0500000
NODE_270_length_4453_cov_16.820395	3436	3496	62	2	60	0.0333333
NODE_270_length_4453_cov_16.820395	3436	3496	64	1	60	0.0166667
NODE_270_length_4453_cov_16.820395	3436	3496	66	3	60	0.0500000
NODE_270_length_4453_cov_16.820395	3436	3496	70	1	60	0.0166667
NODE_270_length_4453_cov_16.820395	3436	3496	71	1	60	0.0166667
NODE_270_length_4453_cov_16.820395	3436	3496	76	2	60	0.0333333
NODE_270_length_4453_cov_16.820395	3436	3496	90	1	60	0.0166667
NODE_270_length_4453_cov_16.820395	3436	3496	92	2	60	0.0333333
NODE_270_length_4453_cov_16.820395	3436	3496	99	1	60	0.0166667
NODE_270_length_4453_cov_16.820395	3436	3496	103	2	60	0.0333333
NODE_270_length_4453_cov_16.820395	3436	3496	111	1	60	0.0166667
NODE_270_length_4453_cov_16.820395	3436	3496	114	1	60	0.0166667
NODE_270_length_4453_cov_16.820395	3436	3496	119	2	60	0.0333333
NODE_270_length_4453_cov_16.820395	3436	3496	123	4	60	0.0666667
NODE_270_length_4453_cov_16.820395	3436	3496	127	1	60	0.0166667
NODE_270_length_4453_cov_16.820395	3436	3496	129	6	60	0.1000000
NODE_270_length_4453_cov_16.820395	3436	3496	131	3	60	0.0500000
NODE_272_length_4436_cov_31.114595	2807	2871	8	43	64	0.6718750
NODE_272_length_4436_cov_31.114595	2807	2871	12	21	64	0.3281250
NODE_272_length_4436_cov_31.114595	2846	2906	0	9	60	0.1500000
NODE_272_length_4436_cov_31.114595	2846	2906	1	8	60	0.1333333
NODE_272_length_4436_cov_31.114595	2846	2906	2	17	60	0.2833333
NODE_272_length_4436_cov_31.114595	2846	2906	4	1	60	0.0166667
NODE_272_length_4436_cov_31.114595	2846	2906	8	25	60	0.4166667
NODE_272_length_4436_cov_31.114595	2846	2898	0	1	52	0.0192308
NODE_272_length_4436_cov_31.114595	2846	2898	1	8	52	0.1538462
NODE_272_length_4436_cov_31.114595	2846	2898	2	17	52	0.3269231
NODE_272_length_4436_cov_31.114595	2846	2898	4	1	52	0.0192308
NODE_272_length_4436_cov_31.114595	2846	2898	8	25	52	0.4807692
NODE_278_length_4391_cov_7.711323	66	141	0	75	75	1.0000000
NODE_278_length_4391_cov_7.711323	119	155	0	31	36	0.8611111
NODE_278_length_4391_cov_7.711323	119	155	2	3	36	0.0833333
NODE_278_length_4391_cov_7.711323	119	155	4	2	36	0.0555556
NODE_279_length_4385_cov_6.067662	1556	1606	0	1	50	0.0200000
NODE_279_length_4385_cov_6.067662	1556	1606	2	2	50	0.0400000
NODE_279_length_4385_cov_6.067662	1556	1606	6	1	50	0.0200000
NODE_279_length_4385_cov_6.067662	1556	1606	22	1	50	0.0200000
NODE_279_length_4385_cov_6.067662	1556	1606	24	4	50	0.0800000
NODE_279_length_4385_cov_6.067662	1556	1606	26	3	50	0.0600000
NODE_279_length_4385_cov_6.067662	1556	1606	28	8	50	0.1600000
NODE_279_length_4385_cov_6.067662	1556	1606	30	6	50	0.1200000
NODE_279_length_4385_cov_6.067662	1556	1606	34	3	50	0.0600000
NODE_279_length_4385_cov_6.067662	1556	1606	36	4	50	0.0800000
NODE_279_length_4385_cov_6.067662	1556	1606	38	2	50	0.0400000
NODE_279_length_4385_cov_6.067662	1556	1606	40	3	50	0.0600000
NODE_279_length_4385_cov_6.067662	1556	1606	46	2	50	0.0400000
NODE_279_length_4385_cov_6.067662	1556	1606	48	2	50	0.0400000
NODE_279_length_4385_cov_6.067662	1556	1606	50	8	50	0.1600000
NODE_286_length_4331_cov_37.938800	1898	1978	12	14	80	0.1750000
NODE_286_length_4331_cov_37.938800	1898	1978	18	4	80	0.0500000
NODE_286_length_4331_cov_37.938800	1898	1978	20	1	80	0.0125000
NODE_286_length_4331_cov_37.938800	1898	1978	22	14	80	0.1750000
NODE_286_length_4331_cov_37.938800	1898	1978	24	4	80	0.0500000
NODE_286_length_4331_cov_37.938800	1898	1978	26	4	80	0.0500000
NODE_286_length_4331_cov_37.938800	1898	1978	37	3	80	0.0375000
NODE_286_length_4331_cov_37.938800	1898	1978	46	1	80	0.0125000
NODE_286_length_4331_cov_37.938800	1898	1978	47	14	80	0.1750000
NODE_286_length_4331_cov_37.938800	1898	1978	49	3	80	0.0375000
NODE_286_length_4331_cov_37.938800	1898	1978	53	4	80	0.0500000
NODE_286_length_4331_cov_37.938800	1898	1978	56	1	80	0.0125000
NODE_286_length_4331_cov_37.938800	1898	1978	58	5	80	0.0625000
NODE_286_length_4331_cov_37.938800	1898	1978	60	3	80	0.0375000
NODE_286_length_4331_cov_37.938800	1898	1978	68	4	80	0.0500000
NODE_286_length_4331_cov_37.938800	1898	1978	69	1	80	0.0125000
NODE_286_length_4331_cov_37.938800	1951	2031	47	6	80	0.0750000
NODE_286_length_4331_cov_37.938800	1951	2031	49	3	80	0.0375000
NODE_286_length_4331_cov_37.938800	1951	2031	53	4	80	0.0500000
NODE_286_length_4331_cov_37.938800	1951	2031	56	1	80	0.0125000
NODE_286_length_4331_cov_37.938800	1951	2031	58	5	80	0.0625000
NODE_286_length_4331_cov_37.938800	1951	2031	60	3	80	0.0375000
NODE_286_length_4331_cov_37.938800	1951	2031	68	4	80	0.0500000
NODE_286_length_4331_cov_37.938800	1951	2031	69	20	80	0.2500000
NODE_286_length_4331_cov_37.938800	1951	2031	70	3	80	0.0375000
NODE_286_length_4331_cov_37.938800	1951	2031	72	6	80	0.0750000
NODE_286_length_4331_cov_37.938800	1951	2031	73	2	80	0.0250000
NODE_286_length_4331_cov_37.938800	1951	2031	74	5	80	0.0625000
NODE_286_length_4331_cov_37.938800	1951	2031	80	2	80	0.0250000
NODE_286_length_4331_cov_37.938800	1951	2031	94	1	80	0.0125000
NODE_286_length_4331_cov_37.938800	1951	2031	97	1	80	0.0125000
NODE_286_length_4331_cov_37.938800	1951	2031	98	1	80	0.0125000
NODE_286_length_4331_cov_37.938800	1951	2031	99	1	80	0.0125000
NODE_286_length_4331_cov_37.938800	1951	2031	100	1	80	0.0125000
NODE_286_length_4331_cov_37.938800	1951	2031	103	1	80	0.0125000
NODE_286_length_4331_cov_37.938800	1951	2031	105	1	80	0.0125000
NODE_286_length_4331_cov_37.938800	1951	2031	107	3	80	0.0375000
NODE_286_length_4331_cov_37.938800	1951	2031	119	1	80	0.0125000
NODE_286_length_4331_cov_37.938800	1951	2031	120	5	80	0.0625000
NODE_286_length_4331_cov_37.938800	2027	2107	117	1	80	0.0125000
NODE_286_length_4331_cov_37.938800	2027	2107	119	1	80	0.0125000
NODE_286_length_4331_cov_37.938800	2027	2107	120	5	80	0.0625000
NODE_286_length_4331_cov_37.938800	2027	2107	121	1	80	0.0125000
NODE_286_length_4331_cov_37.938800	2027	2107	123	3	80	0.0375000
NODE_286_length_4331_cov_37.938800	2027	2107	124	1	80	0.0125000
NODE_286_length_4331_cov_37.938800	2027	2107	125	3	80	0.0375000
NODE_286_length_4331_cov_37.938800	2027	2107	127	2	80	0.0250000
NODE_286_length_4331_cov_37.938800	2027	2107	129	8	80	0.1000000
NODE_286_length_4331_cov_37.938800	2027	2107	130	3	80	0.0375000
NODE_286_length_4331_cov_37.938800	2027	2107	131	2	80	0.0250000
NODE_286_length_4331_cov_37.938800	2027	2107	132	1	80	0.0125000
NODE_286_length_4331_cov_37.938800	2027	2107	136	1	80	0.0125000
NODE_286_length_4331_cov_37.938800	2027	2107	137	1	80	0.0125000
NODE_286_length_4331_cov_37.938800	2027	2107	142	6	80	0.0750000
NODE_286_length_4331_cov_37.938800	2027	2107	145	2	80	0.0250000
NODE_286_length_4331_cov_37.938800	2027	2107	148	2	80	0.0250000
NODE_286_length_4331_cov_37.938800	2027	2107	152	4	80	0.0500000
NODE_286_length_4331_cov_37.938800	2027	2107	168	5	80	0.0625000
NODE_286_length_4331_cov_37.938800	2027	2107	170	1	80	0.0125000
NODE_286_length_4331_cov_37.938800	2027	2107	171	1	80	0.0125000
NODE_286_length_4331_cov_37.938800	2027	2107	179	3	80	0.0375000
NODE_286_length_4331_cov_37.938800	2027	2107	182	1	80	0.0125000
NODE_286_length_4331_cov_37.938800	2027	2107	183	1	80	0.0125000
NODE_286_length_4331_cov_37.938800	2027	2107	186	2	80	0.0250000
NODE_286_length_4331_cov_37.938800	2027	2107	187	3	80	0.0375000
NODE_286_length_4331_cov_37.938800	2027	2107	188	2	80	0.0250000
NODE_286_length_4331_cov_37.938800	2027	2107	189	11	80	0.1375000
NODE_286_length_4331_cov_37.938800	2027	2107	195	1	80	0.0125000
NODE_286_length_4331_cov_37.938800	2027	2107	196	1	80	0.0125000
NODE_286_length_4331_cov_37.938800	2027	2107	200	1	80	0.0125000
NODE_286_length_4331_cov_37.938800	2080	2160	108	1	80	0.0125000
NODE_286_length_4331_cov_37.938800	2080	2160	112	1	80	0.0125000
NODE_286_length_4331_cov_37.938800	2080	2160	117	1	80	0.0125000
NODE_286_length_4331_cov_37.938800	2080	2160	121	1	80	0.0125000
NODE_286_length_4331_cov_37.938800	2080	2160	134	3	80	0.0375000
NODE_286_length_4331_cov_37.938800	2080	2160	141	1	80	0.0125000
NODE_286_length_4331_cov_37.938800	2080	2160	145	4	80	0.0500000
NODE_286_length_4331_cov_37.938800	2080	2160	156	1	80	0.0125000
NODE_286_length_4331_cov_37.938800	2080	2160	157	1	80	0.0125000
NODE_286_length_4331_cov_37.938800	2080	2160	160	2	80	0.0250000
NODE_286_length_4331_cov_37.938800	2080	2160	161	1	80	0.0125000
NODE_286_length_4331_cov_37.938800	2080	2160	165	1	80	0.0125000
NODE_286_length_4331_cov_37.938800	2080	2160	169	2	80	0.0250000
NODE_286_length_4331_cov_37.938800	2080	2160	171	2	80	0.0250000
NODE_286_length_4331_cov_37.938800	2080	2160	173	1	80	0.0125000
NODE_286_length_4331_cov_37.938800	2080	2160	175	3	80	0.0375000
NODE_286_length_4331_cov_37.938800	2080	2160	177	7	80	0.0875000
NODE_286_length_4331_cov_37.938800	2080	2160	179	3	80	0.0375000
NODE_286_length_4331_cov_37.938800	2080	2160	182	1	80	0.0125000
NODE_286_length_4331_cov_37.938800	2080	2160	183	1	80	0.0125000
NODE_286_length_4331_cov_37.938800	2080	2160	185	5	80	0.0625000
NODE_286_length_4331_cov_37.938800	2080	2160	186	3	80	0.0375000
NODE_286_length_4331_cov_37.938800	2080	2160	187	6	80	0.0750000
NODE_286_length_4331_cov_37.938800	2080	2160	188	2	80	0.0250000
NODE_286_length_4331_cov_37.938800	2080	2160	189	11	80	0.1375000
NODE_286_length_4331_cov_37.938800	2080	2160	195	1	80	0.0125000
NODE_286_length_4331_cov_37.938800	2080	2160	196	1	80	0.0125000
NODE_286_length_4331_cov_37.938800	2080	2160	199	4	80	0.0500000
NODE_286_length_4331_cov_37.938800	2080	2160	200	8	80	0.1000000
NODE_286_length_4331_cov_37.938800	2080	2160	201	1	80	0.0125000
NODE_289_length_4320_cov_7.680881	442	522	2	53	80	0.6625000
NODE_289_length_4320_cov_7.680881	442	522	4	27	80	0.3375000
NODE_289_length_4320_cov_7.680881	495	575	0	15	80	0.1875000
NODE_289_length_4320_cov_7.680881	495	575	2	51	80	0.6375000
NODE_289_length_4320_cov_7.680881	495	575	4	14	80	0.1750000
NODE_289_length_4320_cov_7.680881	571	651	0	80	80	1.0000000
NODE_289_length_4320_cov_7.680881	624	704	0	80	80	1.0000000
NODE_290_length_4314_cov_5.311507	1436	1516	0	2	80	0.0250000
NODE_290_length_4314_cov_5.311507	1436	1516	2	25	80	0.3125000
NODE_290_length_4314_cov_5.311507	1436	1516	4	53	80	0.6625000
NODE_290_length_4314_cov_5.311507	1489	1569	0	55	80	0.6875000
NODE_290_length_4314_cov_5.311507	1489	1569	2	3	80	0.0375000
NODE_290_length_4314_cov_5.311507	1489	1569	4	22	80	0.2750000
NODE_290_length_4314_cov_5.311507	3331	3400	0	69	69	1.0000000
NODE_290_length_4314_cov_5.311507	3420	3482	0	3	62	0.0483871
NODE_290_length_4314_cov_5.311507	3420	3482	2	59	62	0.9516129
NODE_292_length_4311_cov_8.733381	92	171	22	7	79	0.0886076
NODE_292_length_4311_cov_8.733381	92	171	24	7	79	0.0886076
NODE_292_length_4311_cov_8.733381	92	171	28	1	79	0.0126582
NODE_292_length_4311_cov_8.733381	92	171	30	2	79	0.0253165
NODE_292_length_4311_cov_8.733381	92	171	32	6	79	0.0759494
NODE_292_length_4311_cov_8.733381	92	171	35	5	79	0.0632911
NODE_292_length_4311_cov_8.733381	92	171	40	1	79	0.0126582
NODE_292_length_4311_cov_8.733381	92	171	41	1	79	0.0126582
NODE_292_length_4311_cov_8.733381	92	171	42	32	79	0.4050633
NODE_292_length_4311_cov_8.733381	92	171	44	17	79	0.2151899
NODE_292_length_4311_cov_8.733381	1925	2005	0	19	80	0.2375000
NODE_292_length_4311_cov_8.733381	1925	2005	2	4	80	0.0500000
NODE_292_length_4311_cov_8.733381	1925	2005	8	4	80	0.0500000
NODE_292_length_4311_cov_8.733381	1925	2005	10	4	80	0.0500000
NODE_292_length_4311_cov_8.733381	1925	2005	12	1	80	0.0125000
NODE_292_length_4311_cov_8.733381	1925	2005	14	48	80	0.6000000
NODE_292_length_4311_cov_8.733381	1978	2058	0	4	80	0.0500000
NODE_292_length_4311_cov_8.733381	1978	2058	2	4	80	0.0500000
NODE_292_length_4311_cov_8.733381	1978	2058	4	4	80	0.0500000
NODE_292_length_4311_cov_8.733381	1978	2058	6	9	80	0.1125000
NODE_292_length_4311_cov_8.733381	1978	2058	8	5	80	0.0625000
NODE_292_length_4311_cov_8.733381	1978	2058	10	6	80	0.0750000
NODE_292_length_4311_cov_8.733381	1978	2058	12	8	80	0.1000000
NODE_292_length_4311_cov_8.733381	1978	2058	14	40	80	0.5000000
NODE_294_length_4293_cov_3.809251	244	326	2	82	82	1.0000000
NODE_294_length_4293_cov_3.809251	301	394	0	39	93	0.4193548
NODE_294_length_4293_cov_3.809251	301	394	2	54	93	0.5806451
NODE_295_length_4284_cov_15.940263	3726	3806	0	80	80	1.0000000
NODE_295_length_4284_cov_15.940263	3779	3858	0	47	79	0.5949367
NODE_295_length_4284_cov_15.940263	3779	3858	2	32	79	0.4050633
NODE_299_length_4277_cov_5.451173	3818	3898	2	24	80	0.3000000
NODE_299_length_4277_cov_5.451173	3818	3898	4	7	80	0.0875000
NODE_299_length_4277_cov_5.451173	3818	3898	6	49	80	0.6125000
NODE_299_length_4277_cov_5.451173	3927	3995	0	59	68	0.8676471
NODE_299_length_4277_cov_5.451173	3927	3995	2	6	68	0.0882353
NODE_299_length_4277_cov_5.451173	3927	3995	4	3	68	0.0441176
NODE_299_length_4277_cov_5.451173	3968	4048	0	80	80	1.0000000
NODE_300_length_4274_cov_18.943234	591	671	4	55	80	0.6875000
NODE_300_length_4274_cov_18.943234	591	671	6	2	80	0.0250000
NODE_300_length_4274_cov_18.943234	591	671	8	23	80	0.2875000
NODE_300_length_4274_cov_18.943234	644	724	0	5	80	0.0625000
NODE_300_length_4274_cov_18.943234	644	724	4	2	80	0.0250000
NODE_300_length_4274_cov_18.943234	644	724	6	50	80	0.6250000
NODE_300_length_4274_cov_18.943234	644	724	8	23	80	0.2875000
NODE_301_length_4274_cov_16.160958	416	496	0	1	80	0.0125000
NODE_301_length_4274_cov_16.160958	416	496	2	38	80	0.4750000
NODE_301_length_4274_cov_16.160958	416	496	3	1	80	0.0125000
NODE_301_length_4274_cov_16.160958	416	496	4	19	80	0.2375000
NODE_301_length_4274_cov_16.160958	416	496	5	13	80	0.1625000
NODE_301_length_4274_cov_16.160958	416	496	6	7	80	0.0875000
NODE_301_length_4274_cov_16.160958	416	496	7	1	80	0.0125000
NODE_301_length_4274_cov_16.160958	1034	1114	0	80	80	1.0000000
NODE_301_length_4274_cov_16.160958	1087	1167	0	80	80	1.0000000
NODE_301_length_4274_cov_16.160958	1163	1243	0	80	80	1.0000000
NODE_301_length_4274_cov_16.160958	1216	1296	0	80	80	1.0000000
NODE_301_length_4274_cov_16.160958	3411	3491	2	13	80	0.1625000
NODE_301_length_4274_cov_16.160958	3411	3491	6	5	80	0.0625000
NODE_301_length_4274_cov_16.160958	3411	3491	8	2	80	0.0250000
NODE_301_length_4274_cov_16.160958	3411	3491	10	60	80	0.7500000
NODE_302_length_4270_cov_14.045792	3835	3915	181	1	80	0.0125000
NODE_302_length_4270_cov_14.045792	3835	3915	189	1	80	0.0125000
NODE_302_length_4270_cov_14.045792	3835	3915	190	1	80	0.0125000
NODE_302_length_4270_cov_14.045792	3835	3915	191	1	80	0.0125000
NODE_302_length_4270_cov_14.045792	3835	3915	193	1	80	0.0125000
NODE_302_length_4270_cov_14.045792	3835	3915	195	1	80	0.0125000
NODE_302_length_4270_cov_14.045792	3835	3915	198	2	80	0.0250000
NODE_302_length_4270_cov_14.045792	3835	3915	206	1	80	0.0125000
NODE_302_length_4270_cov_14.045792	3835	3915	207	1	80	0.0125000
NODE_302_length_4270_cov_14.045792	3835	3915	211	1	80	0.0125000
NODE_302_length_4270_cov_14.045792	3835	3915	213	1	80	0.0125000
NODE_302_length_4270_cov_14.045792	3835	3915	214	1	80	0.0125000
NODE_302_length_4270_cov_14.045792	3835	3915	215	1	80	0.0125000
NODE_302_length_4270_cov_14.045792	3835	3915	216	3	80	0.0375000
NODE_302_length_4270_cov_14.045792	3835	3915	218	1	80	0.0125000
NODE_302_length_4270_cov_14.045792	3835	3915	221	1	80	0.0125000
NODE_302_length_4270_cov_14.045792	3835	3915	224	1	80	0.0125000
NODE_302_length_4270_cov_14.045792	3835	3915	225	1	80	0.0125000
NODE_302_length_4270_cov_14.045792	3835	3915	226	2	80	0.0250000
NODE_302_length_4270_cov_14.045792	3835	3915	228	1	80	0.0125000
NODE_302_length_4270_cov_14.045792	3835	3915	231	1	80	0.0125000
NODE_302_length_4270_cov_14.045792	3835	3915	235	2	80	0.0250000
NODE_302_length_4270_cov_14.045792	3835	3915	236	5	80	0.0625000
NODE_302_length_4270_cov_14.045792	3835	3915	237	4	80	0.0500000
NODE_302_length_4270_cov_14.045792	3835	3915	238	2	80	0.0250000
NODE_302_length_4270_cov_14.045792	3835	3915	239	1	80	0.0125000
NODE_302_length_4270_cov_14.045792	3835	3915	241	1	80	0.0125000
NODE_302_length_4270_cov_14.045792	3835	3915	247	2	80	0.0250000
NODE_302_length_4270_cov_14.045792	3835	3915	248	1	80	0.0125000
NODE_302_length_4270_cov_14.045792	3835	3915	250	1	80	0.0125000
NODE_302_length_4270_cov_14.045792	3835	3915	252	3	80	0.0375000
NODE_302_length_4270_cov_14.045792	3835	3915	253	2	80	0.0250000
NODE_302_length_4270_cov_14.045792	3835	3915	254	5	80	0.0625000
NODE_302_length_4270_cov_14.045792	3835	3915	255	1	80	0.0125000
NODE_302_length_4270_cov_14.045792	3835	3915	256	8	80	0.1000000
NODE_302_length_4270_cov_14.045792	3835	3915	257	1	80	0.0125000
NODE_302_length_4270_cov_14.045792	3835	3915	258	3	80	0.0375000
NODE_302_length_4270_cov_14.045792	3835	3915	259	2	80	0.0250000
NODE_302_length_4270_cov_14.045792	3835	3915	261	3	80	0.0375000
NODE_302_length_4270_cov_14.045792	3835	3915	262	1	80	0.0125000
NODE_302_length_4270_cov_14.045792	3835	3915	263	3	80	0.0375000
NODE_302_length_4270_cov_14.045792	3835	3915	265	2	80	0.0250000
NODE_302_length_4270_cov_14.045792	3835	3915	266	2	80	0.0250000
NODE_302_length_4270_cov_14.045792	3888	3968	176	1	80	0.0125000
NODE_302_length_4270_cov_14.045792	3888	3968	177	4	80	0.0500000
NODE_302_length_4270_cov_14.045792	3888	3968	178	3	80	0.0375000
NODE_302_length_4270_cov_14.045792	3888	3968	181	3	80	0.0375000
NODE_302_length_4270_cov_14.045792	3888	3968	182	3	80	0.0375000
NODE_302_length_4270_cov_14.045792	3888	3968	183	2	80	0.0250000
NODE_302_length_4270_cov_14.045792	3888	3968	184	2	80	0.0250000
NODE_302_length_4270_cov_14.045792	3888	3968	185	3	80	0.0375000
NODE_302_length_4270_cov_14.045792	3888	3968	187	1	80	0.0125000
NODE_302_length_4270_cov_14.045792	3888	3968	189	1	80	0.0125000
NODE_302_length_4270_cov_14.045792	3888	3968	191	3	80	0.0375000
NODE_302_length_4270_cov_14.045792	3888	3968	198	2	80	0.0250000
NODE_302_length_4270_cov_14.045792	3888	3968	202	1	80	0.0125000
NODE_302_length_4270_cov_14.045792	3888	3968	212	1	80	0.0125000
NODE_302_length_4270_cov_14.045792	3888	3968	214	1	80	0.0125000
NODE_302_length_4270_cov_14.045792	3888	3968	217	2	80	0.0250000
NODE_302_length_4270_cov_14.045792	3888	3968	219	1	80	0.0125000
NODE_302_length_4270_cov_14.045792	3888	3968	222	1	80	0.0125000
NODE_302_length_4270_cov_14.045792	3888	3968	230	1	80	0.0125000
NODE_302_length_4270_cov_14.045792	3888	3968	232	1	80	0.0125000
NODE_302_length_4270_cov_14.045792	3888	3968	234	1	80	0.0125000
NODE_302_length_4270_cov_14.045792	3888	3968	239	1	80	0.0125000
NODE_302_length_4270_cov_14.045792	3888	3968	240	1	80	0.0125000
NODE_302_length_4270_cov_14.045792	3888	3968	244	1	80	0.0125000
NODE_302_length_4270_cov_14.045792	3888	3968	245	2	80	0.0250000
NODE_302_length_4270_cov_14.045792	3888	3968	246	3	80	0.0375000
NODE_302_length_4270_cov_14.045792	3888	3968	247	1	80	0.0125000
NODE_302_length_4270_cov_14.045792	3888	3968	250	1	80	0.0125000
NODE_302_length_4270_cov_14.045792	3888	3968	253	4	80	0.0500000
NODE_302_length_4270_cov_14.045792	3888	3968	254	3	80	0.0375000
NODE_302_length_4270_cov_14.045792	3888	3968	255	1	80	0.0125000
NODE_302_length_4270_cov_14.045792	3888	3968	256	4	80	0.0500000
NODE_302_length_4270_cov_14.045792	3888	3968	257	1	80	0.0125000
NODE_302_length_4270_cov_14.045792	3888	3968	258	5	80	0.0625000
NODE_302_length_4270_cov_14.045792	3888	3968	259	3	80	0.0375000
NODE_302_length_4270_cov_14.045792	3888	3968	261	3	80	0.0375000
NODE_302_length_4270_cov_14.045792	3888	3968	262	1	80	0.0125000
NODE_302_length_4270_cov_14.045792	3888	3968	263	3	80	0.0375000
NODE_302_length_4270_cov_14.045792	3888	3968	265	2	80	0.0250000
NODE_302_length_4270_cov_14.045792	3888	3968	266	2	80	0.0250000
NODE_303_length_4260_cov_24.780822	244	311	12	5	67	0.0746269
NODE_303_length_4260_cov_24.780822	244	311	14	5	67	0.0746269
NODE_303_length_4260_cov_24.780822	244	311	15	9	67	0.1343284
NODE_303_length_4260_cov_24.780822	244	311	16	2	67	0.0298507
NODE_303_length_4260_cov_24.780822	244	311	17	6	67	0.0895522
NODE_303_length_4260_cov_24.780822	244	311	19	31	67	0.4626866
NODE_303_length_4260_cov_24.780822	244	311	20	6	67	0.0895522
NODE_303_length_4260_cov_24.780822	244	311	21	3	67	0.0447761
NODE_303_length_4260_cov_24.780822	244	311	12	5	67	0.0746269
NODE_303_length_4260_cov_24.780822	244	311	14	5	67	0.0746269
NODE_303_length_4260_cov_24.780822	244	311	15	9	67	0.1343284
NODE_303_length_4260_cov_24.780822	244	311	16	2	67	0.0298507
NODE_303_length_4260_cov_24.780822	244	311	17	6	67	0.0895522
NODE_303_length_4260_cov_24.780822	244	311	19	31	67	0.4626866
NODE_303_length_4260_cov_24.780822	244	311	20	6	67	0.0895522
NODE_303_length_4260_cov_24.780822	244	311	21	3	67	0.0447761
NODE_303_length_4260_cov_24.780822	263	311	12	5	48	0.1041667
NODE_303_length_4260_cov_24.780822	263	311	14	5	48	0.1041667
NODE_303_length_4260_cov_24.780822	263	311	16	2	48	0.0416667
NODE_303_length_4260_cov_24.780822	263	311	19	27	48	0.5625000
NODE_303_length_4260_cov_24.780822	263	311	20	6	48	0.1250000
NODE_303_length_4260_cov_24.780822	263	311	21	3	48	0.0625000
NODE_303_length_4260_cov_24.780822	1605	1633	0	16	28	0.5714286
NODE_303_length_4260_cov_24.780822	1605	1633	2	3	28	0.1071429
NODE_303_length_4260_cov_24.780822	1605	1633	4	7	28	0.2500000
NODE_303_length_4260_cov_24.780822	1605	1633	6	1	28	0.0357143
NODE_303_length_4260_cov_24.780822	1605	1633	14	1	28	0.0357143
NODE_303_length_4260_cov_24.780822	1660	1699	14	4	39	0.1025641
NODE_303_length_4260_cov_24.780822	1660	1699	16	6	39	0.1538462
NODE_303_length_4260_cov_24.780822	1660	1699	18	2	39	0.0512821
NODE_303_length_4260_cov_24.780822	1660	1699	20	7	39	0.1794872
NODE_303_length_4260_cov_24.780822	1660	1699	22	1	39	0.0256410
NODE_303_length_4260_cov_24.780822	1660	1699	28	2	39	0.0512821
NODE_303_length_4260_cov_24.780822	1660	1699	30	1	39	0.0256410
NODE_303_length_4260_cov_24.780822	1660	1699	32	3	39	0.0769231
NODE_303_length_4260_cov_24.780822	1660	1699	34	10	39	0.2564103
NODE_303_length_4260_cov_24.780822	1660	1699	35	3	39	0.0769231
NODE_310_length_4207_cov_6.923564	3664	3722	8	1	58	0.0172414
NODE_310_length_4207_cov_6.923564	3664	3722	10	35	58	0.6034483
NODE_310_length_4207_cov_6.923564	3664	3722	12	13	58	0.2241379
NODE_310_length_4207_cov_6.923564	3664	3722	16	9	58	0.1551724
NODE_310_length_4207_cov_6.923564	3695	3775	0	33	80	0.4125000
NODE_310_length_4207_cov_6.923564	3695	3775	2	2	80	0.0250000
NODE_310_length_4207_cov_6.923564	3695	3775	4	12	80	0.1500000
NODE_310_length_4207_cov_6.923564	3695	3775	6	1	80	0.0125000
NODE_310_length_4207_cov_6.923564	3695	3775	7	1	80	0.0125000
NODE_310_length_4207_cov_6.923564	3695	3775	8	5	80	0.0625000
NODE_310_length_4207_cov_6.923564	3695	3775	10	26	80	0.3250000
NODE_311_length_4205_cov_6.121042	592	632	0	2	40	0.0500000
NODE_311_length_4205_cov_6.121042	592	632	4	38	40	0.9500000
NODE_311_length_4205_cov_6.121042	605	685	4	80	80	1.0000000
NODE_311_length_4205_cov_6.121042	681	745	0	60	64	0.9375000
NODE_311_length_4205_cov_6.121042	681	745	4	4	64	0.0625000
NODE_312_length_4196_cov_4.170857	340	420	2	10	80	0.1250000
NODE_312_length_4196_cov_4.170857	340	420	6	61	80	0.7625000
NODE_312_length_4196_cov_4.170857	340	420	8	9	80	0.1125000
NODE_312_length_4196_cov_4.170857	393	473	0	2	80	0.0250000
NODE_312_length_4196_cov_4.170857	393	473	1	5	80	0.0625000
NODE_312_length_4196_cov_4.170857	393	473	2	56	80	0.7000000
NODE_312_length_4196_cov_4.170857	393	473	6	17	80	0.2125000
NODE_316_length_4179_cov_6.655882	1	65	4	3	64	0.0468750
NODE_316_length_4179_cov_6.655882	1	65	6	14	64	0.2187500
NODE_316_length_4179_cov_6.655882	1	65	8	1	64	0.0156250
NODE_316_length_4179_cov_6.655882	1	65	10	4	64	0.0625000
NODE_316_length_4179_cov_6.655882	1	65	14	2	64	0.0312500
NODE_316_length_4179_cov_6.655882	1	65	16	40	64	0.6250000
NODE_316_length_4179_cov_6.655882	1087	1140	0	53	53	1.0000000
NODE_316_length_4179_cov_6.655882	1818	1898	0	80	80	1.0000000
NODE_319_length_4150_cov_10.600099	2827	2849	6	21	22	0.9545454
NODE_319_length_4150_cov_10.600099	2827	2849	8	1	22	0.0454545
NODE_319_length_4150_cov_10.600099	2973	3053	0	6	80	0.0750000
NODE_319_length_4150_cov_10.600099	2973	3053	2	8	80	0.1000000
NODE_319_length_4150_cov_10.600099	2973	3053	4	66	80	0.8250000
NODE_319_length_4150_cov_10.600099	3026	3106	0	49	80	0.6125000
NODE_319_length_4150_cov_10.600099	3026	3106	2	1	80	0.0125000
NODE_319_length_4150_cov_10.600099	3026	3106	4	30	80	0.3750000
NODE_324_length_4119_cov_27.984328	2818	2898	106	3	80	0.0375000
NODE_324_length_4119_cov_27.984328	2818	2898	108	4	80	0.0500000
NODE_324_length_4119_cov_27.984328	2818	2898	110	2	80	0.0250000
NODE_324_length_4119_cov_27.984328	2818	2898	116	1	80	0.0125000
NODE_324_length_4119_cov_27.984328	2818	2898	117	2	80	0.0250000
NODE_324_length_4119_cov_27.984328	2818	2898	118	3	80	0.0375000
NODE_324_length_4119_cov_27.984328	2818	2898	119	5	80	0.0625000
NODE_324_length_4119_cov_27.984328	2818	2898	120	2	80	0.0250000
NODE_324_length_4119_cov_27.984328	2818	2898	121	1	80	0.0125000
NODE_324_length_4119_cov_27.984328	2818	2898	124	3	80	0.0375000
NODE_324_length_4119_cov_27.984328	2818	2898	126	6	80	0.0750000
NODE_324_length_4119_cov_27.984328	2818	2898	128	4	80	0.0500000
NODE_324_length_4119_cov_27.984328	2818	2898	130	11	80	0.1375000
NODE_324_length_4119_cov_27.984328	2818	2898	131	1	80	0.0125000
NODE_324_length_4119_cov_27.984328	2818	2898	132	10	80	0.1250000
NODE_324_length_4119_cov_27.984328	2818	2898	133	1	80	0.0125000
NODE_324_length_4119_cov_27.984328	2818	2898	134	3	80	0.0375000
NODE_324_length_4119_cov_27.984328	2818	2898	136	2	80	0.0250000
NODE_324_length_4119_cov_27.984328	2818	2898	138	7	80	0.0875000
NODE_324_length_4119_cov_27.984328	2818	2898	140	8	80	0.1000000
NODE_324_length_4119_cov_27.984328	2818	2898	142	1	80	0.0125000
NODE_325_length_4108_cov_14.755550	378	422	0	2	44	0.0454545
NODE_325_length_4108_cov_14.755550	378	422	2	34	44	0.7727273
NODE_325_length_4108_cov_14.755550	378	422	6	8	44	0.1818182
NODE_325_length_4108_cov_14.755550	3537	3617	0	31	80	0.3875000
NODE_325_length_4108_cov_14.755550	3537	3617	2	5	80	0.0625000
NODE_325_length_4108_cov_14.755550	3537	3617	4	21	80	0.2625000
NODE_325_length_4108_cov_14.755550	3537	3617	6	4	80	0.0500000
NODE_325_length_4108_cov_14.755550	3537	3617	8	19	80	0.2375000
NODE_325_length_4108_cov_14.755550	3590	3670	2	1	80	0.0125000
NODE_325_length_4108_cov_14.755550	3590	3670	4	17	80	0.2125000
NODE_325_length_4108_cov_14.755550	3590	3670	6	10	80	0.1250000
NODE_325_length_4108_cov_14.755550	3590	3670	8	38	80	0.4750000
NODE_325_length_4108_cov_14.755550	3590	3670	10	14	80	0.1750000
NODE_326_length_4107_cov_1.855539	207	287	0	80	80	1.0000000
NODE_328_length_4096_cov_31.197648	379	459	2	63	80	0.7875000
NODE_328_length_4096_cov_31.197648	379	459	4	17	80	0.2125000
NODE_328_length_4096_cov_31.197648	432	512	0	2	80	0.0250000
NODE_328_length_4096_cov_31.197648	432	512	2	29	80	0.3625000
NODE_328_length_4096_cov_31.197648	432	512	4	49	80	0.6125000
NODE_328_length_4096_cov_31.197648	3305	3385	0	80	80	1.0000000
NODE_328_length_4096_cov_31.197648	3358	3438	0	80	80	1.0000000
NODE_329_length_4081_cov_20.248870	3673	3753	0	16	80	0.2000000
NODE_329_length_4081_cov_20.248870	3673	3753	2	64	80	0.8000000
NODE_329_length_4081_cov_20.248870	3726	3806	0	28	80	0.3500000
NODE_329_length_4081_cov_20.248870	3726	3806	2	52	80	0.6500000
NODE_330_length_4076_cov_15.138044	1062	1142	0	80	80	1.0000000
NODE_330_length_4076_cov_15.138044	1115	1195	0	80	80	1.0000000
NODE_331_length_4069_cov_14.261209	3871	3936	2	63	65	0.9692308
NODE_331_length_4069_cov_14.261209	3871	3936	3	1	65	0.0153846
NODE_331_length_4069_cov_14.261209	3871	3936	4	1	65	0.0153846
NODE_333_length_4050_cov_31.044039	1703	1783	0	80	80	1.0000000
NODE_335_length_4021_cov_34.619072	379	459	6	29	80	0.3625000
NODE_335_length_4021_cov_34.619072	379	459	8	51	80	0.6375000
NODE_335_length_4021_cov_34.619072	432	512	0	41	80	0.5125000
NODE_335_length_4021_cov_34.619072	432	512	2	7	80	0.0875000
NODE_335_length_4021_cov_34.619072	432	512	6	32	80	0.4000000
NODE_336_length_4020_cov_5.130834	3455	3535	0	80	80	1.0000000
NODE_336_length_4020_cov_5.130834	3508	3588	0	80	80	1.0000000
NODE_339_length_4004_cov_9.718054	387	467	0	80	80	1.0000000
NODE_339_length_4004_cov_9.718054	440	520	0	80	80	1.0000000
NODE_339_length_4004_cov_9.718054	516	596	0	37	80	0.4625000
NODE_339_length_4004_cov_9.718054	516	596	2	43	80	0.5375000
NODE_339_length_4004_cov_9.718054	569	649	2	80	80	1.0000000
NODE_341_length_3991_cov_18.617934	867	947	0	80	80	1.0000000
NODE_341_length_3991_cov_18.617934	920	1000	0	80	80	1.0000000
NODE_341_length_3991_cov_18.617934	996	1076	0	80	80	1.0000000
NODE_341_length_3991_cov_18.617934	1049	1124	0	75	75	1.0000000
NODE_348_length_3973_cov_6.906298	17	65	0	47	48	0.9791667
NODE_348_length_3973_cov_6.906298	17	65	2	1	48	0.0208333
NODE_348_length_3973_cov_6.906298	1945	1995	16	4	50	0.0800000
NODE_348_length_3973_cov_6.906298	1945	1995	23	1	50	0.0200000
NODE_348_length_3973_cov_6.906298	1945	1995	24	15	50	0.3000000
NODE_348_length_3973_cov_6.906298	1945	1995	26	7	50	0.1400000
NODE_348_length_3973_cov_6.906298	1945	1995	28	6	50	0.1200000
NODE_348_length_3973_cov_6.906298	1945	1995	30	17	50	0.3400000
NODE_350_length_3960_cov_6.246827	2673	2761	0	88	88	1.0000000
NODE_350_length_3960_cov_6.246827	3520	3600	0	80	80	1.0000000
NODE_350_length_3960_cov_6.246827	3573	3653	0	80	80	1.0000000
NODE_353_length_3952_cov_8.805346	826	906	0	80	80	1.0000000
NODE_353_length_3952_cov_8.805346	879	959	0	80	80	1.0000000
NODE_354_length_3928_cov_5.936798	2440	2521	0	81	81	1.0000000
NODE_354_length_3928_cov_5.936798	2493	2574	0	81	81	1.0000000
NODE_356_length_3923_cov_14.807793	3759	3800	2	41	41	1.0000000
NODE_358_length_3922_cov_7.609731	1493	1573	70	2	80	0.0250000
NODE_358_length_3922_cov_7.609731	1493	1573	71	4	80	0.0500000
NODE_358_length_3922_cov_7.609731	1493	1573	72	4	80	0.0500000
NODE_358_length_3922_cov_7.609731	1493	1573	73	2	80	0.0250000
NODE_358_length_3922_cov_7.609731	1493	1573	76	4	80	0.0500000
NODE_358_length_3922_cov_7.609731	1493	1573	78	1	80	0.0125000
NODE_358_length_3922_cov_7.609731	1493	1573	79	2	80	0.0250000
NODE_358_length_3922_cov_7.609731	1493	1573	80	1	80	0.0125000
NODE_358_length_3922_cov_7.609731	1493	1573	81	7	80	0.0875000
NODE_358_length_3922_cov_7.609731	1493	1573	82	9	80	0.1125000
NODE_358_length_3922_cov_7.609731	1493	1573	83	5	80	0.0625000
NODE_358_length_3922_cov_7.609731	1493	1573	85	23	80	0.2875000
NODE_358_length_3922_cov_7.609731	1493	1573	86	4	80	0.0500000
NODE_358_length_3922_cov_7.609731	1493	1573	87	12	80	0.1500000
NODE_358_length_3922_cov_7.609731	1546	1600	52	2	54	0.0370370
NODE_358_length_3922_cov_7.609731	1546	1600	54	3	54	0.0555556
NODE_358_length_3922_cov_7.609731	1546	1600	55	5	54	0.0925926
NODE_358_length_3922_cov_7.609731	1546	1600	58	1	54	0.0185185
NODE_358_length_3922_cov_7.609731	1546	1600	62	2	54	0.0370370
NODE_358_length_3922_cov_7.609731	1546	1600	69	1	54	0.0185185
NODE_358_length_3922_cov_7.609731	1546	1600	70	2	54	0.0370370
NODE_358_length_3922_cov_7.609731	1546	1600	71	7	54	0.1296296
NODE_358_length_3922_cov_7.609731	1546	1600	72	4	54	0.0740741
NODE_358_length_3922_cov_7.609731	1546	1600	73	2	54	0.0370370
NODE_358_length_3922_cov_7.609731	1546	1600	76	4	54	0.0740741
NODE_358_length_3922_cov_7.609731	1546	1600	77	10	54	0.1851852
NODE_358_length_3922_cov_7.609731	1546	1600	78	1	54	0.0185185
NODE_358_length_3922_cov_7.609731	1546	1600	82	2	54	0.0370370
NODE_358_length_3922_cov_7.609731	1546	1600	85	8	54	0.1481481
NODE_359_length_3921_cov_9.943223	2936	3016	163	3	80	0.0375000
NODE_359_length_3921_cov_9.943223	2936	3016	165	5	80	0.0625000
NODE_359_length_3921_cov_9.943223	2936	3016	168	1	80	0.0125000
NODE_359_length_3921_cov_9.943223	2936	3016	169	1	80	0.0125000
NODE_359_length_3921_cov_9.943223	2936	3016	170	1	80	0.0125000
NODE_359_length_3921_cov_9.943223	2936	3016	171	2	80	0.0250000
NODE_359_length_3921_cov_9.943223	2936	3016	172	1	80	0.0125000
NODE_359_length_3921_cov_9.943223	2936	3016	173	5	80	0.0625000
NODE_359_length_3921_cov_9.943223	2936	3016	176	3	80	0.0375000
NODE_359_length_3921_cov_9.943223	2936	3016	178	1	80	0.0125000
NODE_359_length_3921_cov_9.943223	2936	3016	185	1	80	0.0125000
NODE_359_length_3921_cov_9.943223	2936	3016	186	1	80	0.0125000
NODE_359_length_3921_cov_9.943223	2936	3016	190	2	80	0.0250000
NODE_359_length_3921_cov_9.943223	2936	3016	194	2	80	0.0250000
NODE_359_length_3921_cov_9.943223	2936	3016	197	2	80	0.0250000
NODE_359_length_3921_cov_9.943223	2936	3016	200	1	80	0.0125000
NODE_359_length_3921_cov_9.943223	2936	3016	207	1	80	0.0125000
NODE_359_length_3921_cov_9.943223	2936	3016	211	1	80	0.0125000
NODE_359_length_3921_cov_9.943223	2936	3016	216	1	80	0.0125000
NODE_359_length_3921_cov_9.943223	2936	3016	218	1	80	0.0125000
NODE_359_length_3921_cov_9.943223	2936	3016	222	1	80	0.0125000
NODE_359_length_3921_cov_9.943223	2936	3016	224	1	80	0.0125000
NODE_359_length_3921_cov_9.943223	2936	3016	228	1	80	0.0125000
NODE_359_length_3921_cov_9.943223	2936	3016	234	1	80	0.0125000
NODE_359_length_3921_cov_9.943223	2936	3016	236	1	80	0.0125000
NODE_359_length_3921_cov_9.943223	2936	3016	239	2	80	0.0250000
NODE_359_length_3921_cov_9.943223	2936	3016	241	1	80	0.0125000
NODE_359_length_3921_cov_9.943223	2936	3016	249	1	80	0.0125000
NODE_359_length_3921_cov_9.943223	2936	3016	254	2	80	0.0250000
NODE_359_length_3921_cov_9.943223	2936	3016	260	2	80	0.0250000
NODE_359_length_3921_cov_9.943223	2936	3016	264	1	80	0.0125000
NODE_359_length_3921_cov_9.943223	2936	3016	267	1	80	0.0125000
NODE_359_length_3921_cov_9.943223	2936	3016	268	3	80	0.0375000
NODE_359_length_3921_cov_9.943223	2936	3016	269	1	80	0.0125000
NODE_359_length_3921_cov_9.943223	2936	3016	270	2	80	0.0250000
NODE_359_length_3921_cov_9.943223	2936	3016	272	1	80	0.0125000
NODE_359_length_3921_cov_9.943223	2936	3016	273	3	80	0.0375000
NODE_359_length_3921_cov_9.943223	2936	3016	275	5	80	0.0625000
NODE_359_length_3921_cov_9.943223	2936	3016	277	6	80	0.0750000
NODE_359_length_3921_cov_9.943223	2936	3016	278	6	80	0.0750000
NODE_359_length_3921_cov_9.943223	2936	3016	280	2	80	0.0250000
NODE_359_length_3921_cov_9.943223	2989	3057	189	3	68	0.0441176
NODE_359_length_3921_cov_9.943223	2989	3057	191	1	68	0.0147059
NODE_359_length_3921_cov_9.943223	2989	3057	196	2	68	0.0294118
NODE_359_length_3921_cov_9.943223	2989	3057	198	1	68	0.0147059
NODE_359_length_3921_cov_9.943223	2989	3057	200	1	68	0.0147059
NODE_359_length_3921_cov_9.943223	2989	3057	203	1	68	0.0147059
NODE_359_length_3921_cov_9.943223	2989	3057	205	1	68	0.0147059
NODE_359_length_3921_cov_9.943223	2989	3057	217	1	68	0.0147059
NODE_359_length_3921_cov_9.943223	2989	3057	219	1	68	0.0147059
NODE_359_length_3921_cov_9.943223	2989	3057	221	1	68	0.0147059
NODE_359_length_3921_cov_9.943223	2989	3057	224	1	68	0.0147059
NODE_359_length_3921_cov_9.943223	2989	3057	232	2	68	0.0294118
NODE_359_length_3921_cov_9.943223	2989	3057	233	1	68	0.0147059
NODE_359_length_3921_cov_9.943223	2989	3057	234	3	68	0.0441176
NODE_359_length_3921_cov_9.943223	2989	3057	243	1	68	0.0147059
NODE_359_length_3921_cov_9.943223	2989	3057	244	2	68	0.0294118
NODE_359_length_3921_cov_9.943223	2989	3057	245	1	68	0.0147059
NODE_359_length_3921_cov_9.943223	2989	3057	247	2	68	0.0294118
NODE_359_length_3921_cov_9.943223	2989	3057	260	1	68	0.0147059
NODE_359_length_3921_cov_9.943223	2989	3057	262	1	68	0.0147059
NODE_359_length_3921_cov_9.943223	2989	3057	264	1	68	0.0147059
NODE_359_length_3921_cov_9.943223	2989	3057	265	1	68	0.0147059
NODE_359_length_3921_cov_9.943223	2989	3057	266	1	68	0.0147059
NODE_359_length_3921_cov_9.943223	2989	3057	267	4	68	0.0588235
NODE_359_length_3921_cov_9.943223	2989	3057	268	5	68	0.0735294
NODE_359_length_3921_cov_9.943223	2989	3057	269	2	68	0.0294118
NODE_359_length_3921_cov_9.943223	2989	3057	270	1	68	0.0147059
NODE_359_length_3921_cov_9.943223	2989	3057	271	2	68	0.0294118
NODE_359_length_3921_cov_9.943223	2989	3057	272	1	68	0.0147059
NODE_359_length_3921_cov_9.943223	2989	3057	273	3	68	0.0441176
NODE_359_length_3921_cov_9.943223	2989	3057	275	5	68	0.0735294
NODE_359_length_3921_cov_9.943223	2989	3057	277	6	68	0.0882353
NODE_359_length_3921_cov_9.943223	2989	3057	278	6	68	0.0882353
NODE_359_length_3921_cov_9.943223	2989	3057	280	2	68	0.0294118
NODE_359_length_3921_cov_9.943223	3047	3066	189	4	19	0.2105263
NODE_359_length_3921_cov_9.943223	3047	3066	191	3	19	0.1578947
NODE_359_length_3921_cov_9.943223	3047	3066	193	2	19	0.1052632
NODE_359_length_3921_cov_9.943223	3047	3066	195	3	19	0.1578947
NODE_359_length_3921_cov_9.943223	3047	3066	196	3	19	0.1578947
NODE_359_length_3921_cov_9.943223	3047	3066	198	1	19	0.0526316
NODE_359_length_3921_cov_9.943223	3047	3066	200	1	19	0.0526316
NODE_359_length_3921_cov_9.943223	3047	3066	203	1	19	0.0526316
NODE_359_length_3921_cov_9.943223	3047	3066	205	1	19	0.0526316
NODE_363_length_3898_cov_40.033167	3296	3370	32	1	74	0.0135135
NODE_363_length_3898_cov_40.033167	3296	3370	34	7	74	0.0945946
NODE_363_length_3898_cov_40.033167	3296	3370	36	2	74	0.0270270
NODE_363_length_3898_cov_40.033167	3296	3370	38	5	74	0.0675676
NODE_363_length_3898_cov_40.033167	3296	3370	40	3	74	0.0405405
NODE_363_length_3898_cov_40.033167	3296	3370	42	4	74	0.0540541
NODE_363_length_3898_cov_40.033167	3296	3370	46	4	74	0.0540541
NODE_363_length_3898_cov_40.033167	3296	3370	49	14	74	0.1891892
NODE_363_length_3898_cov_40.033167	3296	3370	50	6	74	0.0810811
NODE_363_length_3898_cov_40.033167	3296	3370	51	1	74	0.0135135
NODE_363_length_3898_cov_40.033167	3296	3370	54	1	74	0.0135135
NODE_363_length_3898_cov_40.033167	3296	3370	62	18	74	0.2432432
NODE_363_length_3898_cov_40.033167	3296	3370	64	8	74	0.1081081
NODE_363_length_3898_cov_40.033167	3539	3619	8	13	80	0.1625000
NODE_363_length_3898_cov_40.033167	3539	3619	10	3	80	0.0375000
NODE_363_length_3898_cov_40.033167	3539	3619	11	1	80	0.0125000
NODE_363_length_3898_cov_40.033167	3539	3619	12	6	80	0.0750000
NODE_363_length_3898_cov_40.033167	3539	3619	14	3	80	0.0375000
NODE_363_length_3898_cov_40.033167	3539	3619	16	7	80	0.0875000
NODE_363_length_3898_cov_40.033167	3539	3619	18	26	80	0.3250000
NODE_363_length_3898_cov_40.033167	3539	3619	20	18	80	0.2250000
NODE_363_length_3898_cov_40.033167	3539	3619	22	3	80	0.0375000
NODE_364_length_3898_cov_7.550145	668	748	0	57	80	0.7125000
NODE_364_length_3898_cov_7.550145	668	748	2	10	80	0.1250000
NODE_364_length_3898_cov_7.550145	668	748	6	13	80	0.1625000
NODE_364_length_3898_cov_7.550145	721	801	0	4	80	0.0500000
NODE_364_length_3898_cov_7.550145	721	801	2	10	80	0.1250000
NODE_364_length_3898_cov_7.550145	721	801	6	58	80	0.7250000
NODE_364_length_3898_cov_7.550145	721	801	8	3	80	0.0375000
NODE_364_length_3898_cov_7.550145	721	801	12	1	80	0.0125000
NODE_364_length_3898_cov_7.550145	721	801	16	1	80	0.0125000
NODE_364_length_3898_cov_7.550145	721	801	18	1	80	0.0125000
NODE_364_length_3898_cov_7.550145	721	801	20	1	80	0.0125000
NODE_364_length_3898_cov_7.550145	721	801	22	1	80	0.0125000
NODE_367_length_3882_cov_4.166006	3244	3324	0	76	80	0.9500000
NODE_367_length_3882_cov_4.166006	3244	3324	2	4	80	0.0500000
NODE_367_length_3882_cov_4.166006	3282	3324	0	38	42	0.9047619
NODE_367_length_3882_cov_4.166006	3282	3324	2	4	42	0.0952381
NODE_367_length_3882_cov_4.166006	3297	3377	0	23	80	0.2875000
NODE_367_length_3882_cov_4.166006	3297	3377	2	47	80	0.5875000
NODE_367_length_3882_cov_4.166006	3297	3377	5	1	80	0.0125000
NODE_367_length_3882_cov_4.166006	3297	3377	6	9	80	0.1125000
NODE_367_length_3882_cov_4.166006	3297	3377	0	23	80	0.2875000
NODE_367_length_3882_cov_4.166006	3297	3377	2	47	80	0.5875000
NODE_367_length_3882_cov_4.166006	3297	3377	5	1	80	0.0125000
NODE_367_length_3882_cov_4.166006	3297	3377	6	9	80	0.1125000
NODE_367_length_3882_cov_4.166006	3373	3450	6	40	77	0.5194805
NODE_367_length_3882_cov_4.166006	3373	3450	8	37	77	0.4805195
NODE_374_length_3853_cov_18.816196	524	579	0	2	55	0.0363636
NODE_374_length_3853_cov_18.816196	524	579	2	53	55	0.9636363
NODE_374_length_3853_cov_18.816196	559	639	0	22	80	0.2750000
NODE_374_length_3853_cov_18.816196	559	639	2	58	80	0.7250000
NODE_379_length_3829_cov_12.697319	515	595	0	80	80	1.0000000
NODE_379_length_3829_cov_12.697319	568	648	0	80	80	1.0000000
NODE_379_length_3829_cov_12.697319	644	724	0	80	80	1.0000000
NODE_379_length_3829_cov_12.697319	697	777	0	80	80	1.0000000
NODE_381_length_3815_cov_17.218784	399	479	4	39	80	0.4875000
NODE_381_length_3815_cov_17.218784	399	479	6	16	80	0.2000000
NODE_381_length_3815_cov_17.218784	399	479	8	25	80	0.3125000
NODE_381_length_3815_cov_17.218784	452	532	4	47	80	0.5875000
NODE_381_length_3815_cov_17.218784	452	532	6	22	80	0.2750000
NODE_381_length_3815_cov_17.218784	452	532	8	11	80	0.1375000
NODE_383_length_3812_cov_65.007272	840	903	33	1	63	0.0158730
NODE_383_length_3812_cov_65.007272	840	903	41	1	63	0.0158730
NODE_383_length_3812_cov_65.007272	840	903	44	1	63	0.0158730
NODE_383_length_3812_cov_65.007272	840	903	49	1	63	0.0158730
NODE_383_length_3812_cov_65.007272	840	903	54	1	63	0.0158730
NODE_383_length_3812_cov_65.007272	840	903	66	1	63	0.0158730
NODE_383_length_3812_cov_65.007272	840	903	67	1	63	0.0158730
NODE_383_length_3812_cov_65.007272	840	903	71	1	63	0.0158730
NODE_383_length_3812_cov_65.007272	840	903	74	1	63	0.0158730
NODE_383_length_3812_cov_65.007272	840	903	83	2	63	0.0317460
NODE_383_length_3812_cov_65.007272	840	903	85	1	63	0.0158730
NODE_383_length_3812_cov_65.007272	840	903	86	1	63	0.0158730
NODE_383_length_3812_cov_65.007272	840	903	89	1	63	0.0158730
NODE_383_length_3812_cov_65.007272	840	903	101	1	63	0.0158730
NODE_383_length_3812_cov_65.007272	840	903	109	1	63	0.0158730
NODE_383_length_3812_cov_65.007272	840	903	117	1	63	0.0158730
NODE_383_length_3812_cov_65.007272	840	903	121	1	63	0.0158730
NODE_383_length_3812_cov_65.007272	840	903	128	1	63	0.0158730
NODE_383_length_3812_cov_65.007272	840	903	132	1	63	0.0158730
NODE_383_length_3812_cov_65.007272	840	903	137	1	63	0.0158730
NODE_383_length_3812_cov_65.007272	840	903	146	1	63	0.0158730
NODE_383_length_3812_cov_65.007272	840	903	159	1	63	0.0158730
NODE_383_length_3812_cov_65.007272	840	903	168	2	63	0.0317460
NODE_383_length_3812_cov_65.007272	840	903	169	1	63	0.0158730
NODE_383_length_3812_cov_65.007272	840	903	176	1	63	0.0158730
NODE_383_length_3812_cov_65.007272	840	903	180	1	63	0.0158730
NODE_383_length_3812_cov_65.007272	840	903	181	1	63	0.0158730
NODE_383_length_3812_cov_65.007272	840	903	186	1	63	0.0158730
NODE_383_length_3812_cov_65.007272	840	903	195	1	63	0.0158730
NODE_383_length_3812_cov_65.007272	840	903	205	1	63	0.0158730
NODE_383_length_3812_cov_65.007272	840	903	213	1	63	0.0158730
NODE_383_length_3812_cov_65.007272	840	903	215	1	63	0.0158730
NODE_383_length_3812_cov_65.007272	840	903	222	1	63	0.0158730
NODE_383_length_3812_cov_65.007272	840	903	223	1	63	0.0158730
NODE_383_length_3812_cov_65.007272	840	903	227	1	63	0.0158730
NODE_383_length_3812_cov_65.007272	840	903	230	1	63	0.0158730
NODE_383_length_3812_cov_65.007272	840	903	238	1	63	0.0158730
NODE_383_length_3812_cov_65.007272	840	903	247	2	63	0.0317460
NODE_383_length_3812_cov_65.007272	840	903	272	1	63	0.0158730
NODE_383_length_3812_cov_65.007272	840	903	277	1	63	0.0158730
NODE_383_length_3812_cov_65.007272	840	903	282	1	63	0.0158730
NODE_383_length_3812_cov_65.007272	840	903	285	2	63	0.0317460
NODE_383_length_3812_cov_65.007272	840	903	287	1	63	0.0158730
NODE_383_length_3812_cov_65.007272	840	903	295	1	63	0.0158730
NODE_383_length_3812_cov_65.007272	840	903	296	1	63	0.0158730
NODE_383_length_3812_cov_65.007272	840	903	301	1	63	0.0158730
NODE_383_length_3812_cov_65.007272	840	903	307	1	63	0.0158730
NODE_383_length_3812_cov_65.007272	840	903	312	1	63	0.0158730
NODE_383_length_3812_cov_65.007272	840	903	316	1	63	0.0158730
NODE_383_length_3812_cov_65.007272	840	903	321	1	63	0.0158730
NODE_383_length_3812_cov_65.007272	840	903	324	1	63	0.0158730
NODE_383_length_3812_cov_65.007272	840	903	339	1	63	0.0158730
NODE_383_length_3812_cov_65.007272	840	903	340	1	63	0.0158730
NODE_383_length_3812_cov_65.007272	840	903	349	1	63	0.0158730
NODE_383_length_3812_cov_65.007272	840	903	353	1	63	0.0158730
NODE_383_length_3812_cov_65.007272	840	903	356	1	63	0.0158730
NODE_383_length_3812_cov_65.007272	840	903	365	1	63	0.0158730
NODE_383_length_3812_cov_65.007272	840	903	370	1	63	0.0158730
NODE_383_length_3812_cov_65.007272	840	903	383	1	63	0.0158730
NODE_384_length_3805_cov_9.533189	145	236	0	91	91	1.0000000
NODE_384_length_3805_cov_9.533189	209	279	0	70	70	1.0000000
NODE_386_length_3799_cov_10.046486	2944	3024	0	27	80	0.3375000
NODE_386_length_3799_cov_10.046486	2944	3024	2	14	80	0.1750000
NODE_386_length_3799_cov_10.046486	2944	3024	4	28	80	0.3500000
NODE_386_length_3799_cov_10.046486	2944	3024	6	7	80	0.0875000
NODE_386_length_3799_cov_10.046486	2944	3024	14	2	80	0.0250000
NODE_386_length_3799_cov_10.046486	2944	3024	16	2	80	0.0250000
NODE_386_length_3799_cov_10.046486	2997	3077	0	80	80	1.0000000
NODE_388_length_3795_cov_13.724297	3350	3430	0	42	80	0.5250000
NODE_388_length_3795_cov_13.724297	3350	3430	2	38	80	0.4750000
NODE_388_length_3795_cov_13.724297	3403	3483	0	32	80	0.4000000
NODE_388_length_3795_cov_13.724297	3403	3483	2	34	80	0.4250000
NODE_388_length_3795_cov_13.724297	3403	3483	4	14	80	0.1750000
NODE_388_length_3795_cov_13.724297	3479	3562	4	26	83	0.3132530
NODE_388_length_3795_cov_13.724297	3479	3562	6	57	83	0.6867470
NODE_388_length_3795_cov_13.724297	3479	3562	4	26	83	0.3132530
NODE_388_length_3795_cov_13.724297	3479	3562	6	57	83	0.6867470
NODE_388_length_3795_cov_13.724297	3479	3552	4	26	73	0.3561644
NODE_388_length_3795_cov_13.724297	3479	3552	6	47	73	0.6438356
NODE_388_length_3795_cov_13.724297	3535	3586	0	11	51	0.2156863
NODE_388_length_3795_cov_13.724297	3535	3586	2	1	51	0.0196078
NODE_388_length_3795_cov_13.724297	3535	3586	4	1	51	0.0196078
NODE_388_length_3795_cov_13.724297	3535	3586	6	38	51	0.7450981
NODE_388_length_3795_cov_13.724297	3535	3584	0	9	49	0.1836735
NODE_388_length_3795_cov_13.724297	3535	3584	2	1	49	0.0204082
NODE_388_length_3795_cov_13.724297	3535	3584	4	1	49	0.0204082
NODE_388_length_3795_cov_13.724297	3535	3584	6	38	49	0.7755102
NODE_388_length_3795_cov_13.724297	3698	3721	34	23	23	1.0000000
NODE_394_length_3774_cov_7.720544	538	595	0	12	57	0.2105263
NODE_394_length_3774_cov_7.720544	538	595	2	33	57	0.5789474
NODE_394_length_3774_cov_7.720544	538	595	3	4	57	0.0701754
NODE_394_length_3774_cov_7.720544	538	595	5	8	57	0.1403509
NODE_404_length_3747_cov_3.328947	2230	2292	4	48	62	0.7741935
NODE_404_length_3747_cov_3.328947	2230	2292	6	12	62	0.1935484
NODE_404_length_3747_cov_3.328947	2230	2292	8	2	62	0.0322581
NODE_406_length_3743_cov_38.767014	1354	1434	14	18	80	0.2250000
NODE_406_length_3743_cov_38.767014	1354	1434	22	1	80	0.0125000
NODE_406_length_3743_cov_38.767014	1354	1434	24	3	80	0.0375000
NODE_406_length_3743_cov_38.767014	1354	1434	28	2	80	0.0250000
NODE_406_length_3743_cov_38.767014	1354	1434	30	5	80	0.0625000
NODE_406_length_3743_cov_38.767014	1354	1434	34	19	80	0.2375000
NODE_406_length_3743_cov_38.767014	1354	1434	36	24	80	0.3000000
NODE_406_length_3743_cov_38.767014	1354	1434	38	8	80	0.1000000
NODE_406_length_3743_cov_38.767014	1407	1487	12	5	80	0.0625000
NODE_406_length_3743_cov_38.767014	1407	1487	14	5	80	0.0625000
NODE_406_length_3743_cov_38.767014	1407	1487	18	2	80	0.0250000
NODE_406_length_3743_cov_38.767014	1407	1487	24	10	80	0.1250000
NODE_406_length_3743_cov_38.767014	1407	1487	26	8	80	0.1000000
NODE_406_length_3743_cov_38.767014	1407	1487	28	2	80	0.0250000
NODE_406_length_3743_cov_38.767014	1407	1487	29	4	80	0.0500000
NODE_406_length_3743_cov_38.767014	1407	1487	30	1	80	0.0125000
NODE_406_length_3743_cov_38.767014	1407	1487	32	5	80	0.0625000
NODE_406_length_3743_cov_38.767014	1407	1487	36	35	80	0.4375000
NODE_406_length_3743_cov_38.767014	1407	1487	38	3	80	0.0375000
NODE_408_length_3733_cov_16.204458	186	249	0	52	63	0.8253968
NODE_408_length_3733_cov_16.204458	186	249	4	6	63	0.0952381
NODE_408_length_3733_cov_16.204458	186	249	24	5	63	0.0793651
NODE_413_length_3707_cov_56.575665	2387	2467	6	16	80	0.2000000
NODE_413_length_3707_cov_56.575665	2387	2467	8	19	80	0.2375000
NODE_413_length_3707_cov_56.575665	2387	2467	10	29	80	0.3625000
NODE_413_length_3707_cov_56.575665	2387	2467	12	2	80	0.0250000
NODE_413_length_3707_cov_56.575665	2387	2467	13	1	80	0.0125000
NODE_413_length_3707_cov_56.575665	2387	2467	14	9	80	0.1125000
NODE_413_length_3707_cov_56.575665	2387	2467	16	4	80	0.0500000
NODE_413_length_3707_cov_56.575665	2440	2520	6	8	80	0.1000000
NODE_413_length_3707_cov_56.575665	2440	2520	8	15	80	0.1875000
NODE_413_length_3707_cov_56.575665	2440	2520	10	41	80	0.5125000
NODE_413_length_3707_cov_56.575665	2440	2520	12	2	80	0.0250000
NODE_413_length_3707_cov_56.575665	2440	2520	13	1	80	0.0125000
NODE_413_length_3707_cov_56.575665	2440	2520	14	9	80	0.1125000
NODE_413_length_3707_cov_56.575665	2440	2520	16	4	80	0.0500000
NODE_413_length_3707_cov_56.575665	2516	2596	2	2	80	0.0250000
NODE_413_length_3707_cov_56.575665	2516	2596	5	1	80	0.0125000
NODE_413_length_3707_cov_56.575665	2516	2596	6	17	80	0.2125000
NODE_413_length_3707_cov_56.575665	2516	2596	8	60	80	0.7500000
NODE_413_length_3707_cov_56.575665	2569	2649	2	55	80	0.6875000
NODE_413_length_3707_cov_56.575665	2569	2649	5	1	80	0.0125000
NODE_413_length_3707_cov_56.575665	2569	2649	8	24	80	0.3000000
NODE_416_length_3690_cov_7.476190	723	792	0	69	69	1.0000000
NODE_416_length_3690_cov_7.476190	776	855	0	79	79	1.0000000
NODE_419_length_3685_cov_7.011154	1966	2046	134	4	80	0.0500000
NODE_419_length_3685_cov_7.011154	1966	2046	136	2	80	0.0250000
NODE_419_length_3685_cov_7.011154	1966	2046	140	1	80	0.0125000
NODE_419_length_3685_cov_7.011154	1966	2046	142	1	80	0.0125000
NODE_419_length_3685_cov_7.011154	1966	2046	148	2	80	0.0250000
NODE_419_length_3685_cov_7.011154	1966	2046	156	1	80	0.0125000
NODE_419_length_3685_cov_7.011154	1966	2046	158	2	80	0.0250000
NODE_419_length_3685_cov_7.011154	1966	2046	159	6	80	0.0750000
NODE_419_length_3685_cov_7.011154	1966	2046	160	2	80	0.0250000
NODE_419_length_3685_cov_7.011154	1966	2046	162	2	80	0.0250000
NODE_419_length_3685_cov_7.011154	1966	2046	163	2	80	0.0250000
NODE_419_length_3685_cov_7.011154	1966	2046	164	2	80	0.0250000
NODE_419_length_3685_cov_7.011154	1966	2046	172	1	80	0.0125000
NODE_419_length_3685_cov_7.011154	1966	2046	174	1	80	0.0125000
NODE_419_length_3685_cov_7.011154	1966	2046	175	2	80	0.0250000
NODE_419_length_3685_cov_7.011154	1966	2046	178	1	80	0.0125000
NODE_419_length_3685_cov_7.011154	1966	2046	180	9	80	0.1125000
NODE_419_length_3685_cov_7.011154	1966	2046	181	6	80	0.0750000
NODE_419_length_3685_cov_7.011154	1966	2046	182	2	80	0.0250000
NODE_419_length_3685_cov_7.011154	1966	2046	183	4	80	0.0500000
NODE_419_length_3685_cov_7.011154	1966	2046	184	2	80	0.0250000
NODE_419_length_3685_cov_7.011154	1966	2046	190	1	80	0.0125000
NODE_419_length_3685_cov_7.011154	1966	2046	192	1	80	0.0125000
NODE_419_length_3685_cov_7.011154	1966	2046	194	1	80	0.0125000
NODE_419_length_3685_cov_7.011154	1966	2046	195	1	80	0.0125000
NODE_419_length_3685_cov_7.011154	1966	2046	196	1	80	0.0125000
NODE_419_length_3685_cov_7.011154	1966	2046	197	10	80	0.1250000
NODE_419_length_3685_cov_7.011154	1966	2046	198	1	80	0.0125000
NODE_419_length_3685_cov_7.011154	1966	2046	199	1	80	0.0125000
NODE_419_length_3685_cov_7.011154	1966	2046	201	3	80	0.0375000
NODE_419_length_3685_cov_7.011154	1966	2046	203	1	80	0.0125000
NODE_419_length_3685_cov_7.011154	1966	2046	205	4	80	0.0500000
NODE_419_length_3685_cov_7.011154	2019	2086	109	1	67	0.0149254
NODE_419_length_3685_cov_7.011154	2019	2086	112	1	67	0.0149254
NODE_419_length_3685_cov_7.011154	2019	2086	118	2	67	0.0298507
NODE_419_length_3685_cov_7.011154	2019	2086	119	1	67	0.0149254
NODE_419_length_3685_cov_7.011154	2019	2086	120	1	67	0.0149254
NODE_419_length_3685_cov_7.011154	2019	2086	124	2	67	0.0298507
NODE_419_length_3685_cov_7.011154	2019	2086	126	2	67	0.0298507
NODE_419_length_3685_cov_7.011154	2019	2086	133	1	67	0.0149254
NODE_419_length_3685_cov_7.011154	2019	2086	134	1	67	0.0149254
NODE_419_length_3685_cov_7.011154	2019	2086	139	1	67	0.0149254
NODE_419_length_3685_cov_7.011154	2019	2086	148	1	67	0.0149254
NODE_419_length_3685_cov_7.011154	2019	2086	154	1	67	0.0149254
NODE_419_length_3685_cov_7.011154	2019	2086	158	2	67	0.0298507
NODE_419_length_3685_cov_7.011154	2019	2086	162	2	67	0.0298507
NODE_419_length_3685_cov_7.011154	2019	2086	170	1	67	0.0149254
NODE_419_length_3685_cov_7.011154	2019	2086	172	1	67	0.0149254
NODE_419_length_3685_cov_7.011154	2019	2086	174	2	67	0.0298507
NODE_419_length_3685_cov_7.011154	2019	2086	179	1	67	0.0149254
NODE_419_length_3685_cov_7.011154	2019	2086	181	2	67	0.0298507
NODE_419_length_3685_cov_7.011154	2019	2086	183	2	67	0.0298507
NODE_419_length_3685_cov_7.011154	2019	2086	187	2	67	0.0298507
NODE_419_length_3685_cov_7.011154	2019	2086	188	2	67	0.0298507
NODE_419_length_3685_cov_7.011154	2019	2086	189	2	67	0.0298507
NODE_419_length_3685_cov_7.011154	2019	2086	190	1	67	0.0149254
NODE_419_length_3685_cov_7.011154	2019	2086	191	1	67	0.0149254
NODE_419_length_3685_cov_7.011154	2019	2086	192	2	67	0.0298507
NODE_419_length_3685_cov_7.011154	2019	2086	193	2	67	0.0298507
NODE_419_length_3685_cov_7.011154	2019	2086	194	1	67	0.0149254
NODE_419_length_3685_cov_7.011154	2019	2086	195	1	67	0.0149254
NODE_419_length_3685_cov_7.011154	2019	2086	196	1	67	0.0149254
NODE_419_length_3685_cov_7.011154	2019	2086	197	13	67	0.1940299
NODE_419_length_3685_cov_7.011154	2019	2086	198	1	67	0.0149254
NODE_419_length_3685_cov_7.011154	2019	2086	199	2	67	0.0298507
NODE_419_length_3685_cov_7.011154	2019	2086	201	3	67	0.0447761
NODE_419_length_3685_cov_7.011154	2019	2086	203	1	67	0.0149254
NODE_419_length_3685_cov_7.011154	2019	2086	205	4	67	0.0597015
NODE_426_length_3667_cov_1089.047365	1634	1705	29	10	71	0.1408451
NODE_426_length_3667_cov_1089.047365	1634	1705	31	3	71	0.0422535
NODE_426_length_3667_cov_1089.047365	1634	1705	32	2	71	0.0281690
NODE_426_length_3667_cov_1089.047365	1634	1705	33	1	71	0.0140845
NODE_426_length_3667_cov_1089.047365	1634	1705	34	3	71	0.0422535
NODE_426_length_3667_cov_1089.047365	1634	1705	38	2	71	0.0281690
NODE_426_length_3667_cov_1089.047365	1634	1705	40	6	71	0.0845070
NODE_426_length_3667_cov_1089.047365	1634	1705	42	11	71	0.1549296
NODE_426_length_3667_cov_1089.047365	1634	1705	44	4	71	0.0563380
NODE_426_length_3667_cov_1089.047365	1634	1705	46	9	71	0.1267606
NODE_426_length_3667_cov_1089.047365	1634	1705	48	14	71	0.1971831
NODE_426_length_3667_cov_1089.047365	1634	1705	50	1	71	0.0140845
NODE_426_length_3667_cov_1089.047365	1634	1705	52	5	71	0.0704225
NODE_426_length_3667_cov_1089.047365	1678	1758	28	3	80	0.0375000
NODE_426_length_3667_cov_1089.047365	1678	1758	29	5	80	0.0625000
NODE_426_length_3667_cov_1089.047365	1678	1758	31	1	80	0.0125000
NODE_426_length_3667_cov_1089.047365	1678	1758	33	1	80	0.0125000
NODE_426_length_3667_cov_1089.047365	1678	1758	35	6	80	0.0750000
NODE_426_length_3667_cov_1089.047365	1678	1758	39	1	80	0.0125000
NODE_426_length_3667_cov_1089.047365	1678	1758	41	3	80	0.0375000
NODE_426_length_3667_cov_1089.047365	1678	1758	43	2	80	0.0250000
NODE_426_length_3667_cov_1089.047365	1678	1758	46	7	80	0.0875000
NODE_426_length_3667_cov_1089.047365	1678	1758	47	4	80	0.0500000
NODE_426_length_3667_cov_1089.047365	1678	1758	48	19	80	0.2375000
NODE_426_length_3667_cov_1089.047365	1678	1758	49	1	80	0.0125000
NODE_426_length_3667_cov_1089.047365	1678	1758	50	7	80	0.0875000
NODE_426_length_3667_cov_1089.047365	1678	1758	52	8	80	0.1000000
NODE_426_length_3667_cov_1089.047365	1678	1758	54	12	80	0.1500000
NODE_428_length_3660_cov_79.447627	1806	1870	98	1	64	0.0156250
NODE_428_length_3660_cov_79.447627	1806	1870	99	1	64	0.0156250
NODE_428_length_3660_cov_79.447627	1806	1870	103	1	64	0.0156250
NODE_428_length_3660_cov_79.447627	1806	1870	108	3	64	0.0468750
NODE_428_length_3660_cov_79.447627	1806	1870	110	1	64	0.0156250
NODE_428_length_3660_cov_79.447627	1806	1870	114	1	64	0.0156250
NODE_428_length_3660_cov_79.447627	1806	1870	116	1	64	0.0156250
NODE_428_length_3660_cov_79.447627	1806	1870	121	1	64	0.0156250
NODE_428_length_3660_cov_79.447627	1806	1870	122	1	64	0.0156250
NODE_428_length_3660_cov_79.447627	1806	1870	130	2	64	0.0312500
NODE_428_length_3660_cov_79.447627	1806	1870	132	1	64	0.0156250
NODE_428_length_3660_cov_79.447627	1806	1870	136	1	64	0.0156250
NODE_428_length_3660_cov_79.447627	1806	1870	137	1	64	0.0156250
NODE_428_length_3660_cov_79.447627	1806	1870	138	1	64	0.0156250
NODE_428_length_3660_cov_79.447627	1806	1870	143	1	64	0.0156250
NODE_428_length_3660_cov_79.447627	1806	1870	151	1	64	0.0156250
NODE_428_length_3660_cov_79.447627	1806	1870	153	1	64	0.0156250
NODE_428_length_3660_cov_79.447627	1806	1870	161	1	64	0.0156250
NODE_428_length_3660_cov_79.447627	1806	1870	163	1	64	0.0156250
NODE_428_length_3660_cov_79.447627	1806	1870	165	1	64	0.0156250
NODE_428_length_3660_cov_79.447627	1806	1870	167	3	64	0.0468750
NODE_428_length_3660_cov_79.447627	1806	1870	169	2	64	0.0312500
NODE_428_length_3660_cov_79.447627	1806	1870	175	1	64	0.0156250
NODE_428_length_3660_cov_79.447627	1806	1870	176	1	64	0.0156250
NODE_428_length_3660_cov_79.447627	1806	1870	187	1	64	0.0156250
NODE_428_length_3660_cov_79.447627	1806	1870	189	1	64	0.0156250
NODE_428_length_3660_cov_79.447627	1806	1870	192	1	64	0.0156250
NODE_428_length_3660_cov_79.447627	1806	1870	194	2	64	0.0312500
NODE_428_length_3660_cov_79.447627	1806	1870	196	2	64	0.0312500
NODE_428_length_3660_cov_79.447627	1806	1870	201	1	64	0.0156250
NODE_428_length_3660_cov_79.447627	1806	1870	202	3	64	0.0468750
NODE_428_length_3660_cov_79.447627	1806	1870	203	2	64	0.0312500
NODE_428_length_3660_cov_79.447627	1806	1870	204	3	64	0.0468750
NODE_428_length_3660_cov_79.447627	1806	1870	207	3	64	0.0468750
NODE_428_length_3660_cov_79.447627	1806	1870	208	1	64	0.0156250
NODE_428_length_3660_cov_79.447627	1806	1870	209	1	64	0.0156250
NODE_428_length_3660_cov_79.447627	1806	1870	214	1	64	0.0156250
NODE_428_length_3660_cov_79.447627	1806	1870	216	2	64	0.0312500
NODE_428_length_3660_cov_79.447627	1806	1870	218	2	64	0.0312500
NODE_428_length_3660_cov_79.447627	1806	1870	220	2	64	0.0312500
NODE_428_length_3660_cov_79.447627	1806	1870	223	1	64	0.0156250
NODE_428_length_3660_cov_79.447627	1806	1870	225	2	64	0.0312500
NODE_428_length_3660_cov_79.447627	1806	1870	227	2	64	0.0312500
NODE_428_length_3660_cov_79.447627	1806	1870	233	1	64	0.0156250
NODE_428_length_3660_cov_79.447627	1859	1906	216	1	47	0.0212766
NODE_428_length_3660_cov_79.447627	1859	1906	218	2	47	0.0425532
NODE_428_length_3660_cov_79.447627	1859	1906	220	2	47	0.0425532
NODE_428_length_3660_cov_79.447627	1859	1906	223	1	47	0.0212766
NODE_428_length_3660_cov_79.447627	1859	1906	224	1	47	0.0212766
NODE_428_length_3660_cov_79.447627	1859	1906	225	2	47	0.0425532
NODE_428_length_3660_cov_79.447627	1859	1906	226	3	47	0.0638298
NODE_428_length_3660_cov_79.447627	1859	1906	227	2	47	0.0425532
NODE_428_length_3660_cov_79.447627	1859	1906	228	2	47	0.0425532
NODE_428_length_3660_cov_79.447627	1859	1906	230	2	47	0.0425532
NODE_428_length_3660_cov_79.447627	1859	1906	231	1	47	0.0212766
NODE_428_length_3660_cov_79.447627	1859	1906	232	4	47	0.0851064
NODE_428_length_3660_cov_79.447627	1859	1906	233	3	47	0.0638298
NODE_428_length_3660_cov_79.447627	1859	1906	234	1	47	0.0212766
NODE_428_length_3660_cov_79.447627	1859	1906	236	2	47	0.0425532
NODE_428_length_3660_cov_79.447627	1859	1906	238	1	47	0.0212766
NODE_428_length_3660_cov_79.447627	1859	1906	240	3	47	0.0638298
NODE_428_length_3660_cov_79.447627	1859	1906	242	1	47	0.0212766
NODE_428_length_3660_cov_79.447627	1859	1906	245	1	47	0.0212766
NODE_428_length_3660_cov_79.447627	1859	1906	246	1	47	0.0212766
NODE_428_length_3660_cov_79.447627	1859	1906	247	2	47	0.0425532
NODE_428_length_3660_cov_79.447627	1859	1906	248	5	47	0.1063830
NODE_428_length_3660_cov_79.447627	1859	1906	249	2	47	0.0425532
NODE_428_length_3660_cov_79.447627	1859	1906	251	2	47	0.0425532
NODE_428_length_3660_cov_79.447627	2358	2438	0	80	80	1.0000000
NODE_428_length_3660_cov_79.447627	2411	2491	0	80	80	1.0000000
NODE_428_length_3660_cov_79.447627	2487	2567	0	80	80	1.0000000
NODE_428_length_3660_cov_79.447627	2540	2620	0	80	80	1.0000000
NODE_430_length_3634_cov_34.913154	1499	1544	41	1	45	0.0222222
NODE_430_length_3634_cov_34.913154	1499	1544	44	1	45	0.0222222
NODE_430_length_3634_cov_34.913154	1499	1544	46	1	45	0.0222222
NODE_430_length_3634_cov_34.913154	1499	1544	49	1	45	0.0222222
NODE_430_length_3634_cov_34.913154	1499	1544	54	1	45	0.0222222
NODE_430_length_3634_cov_34.913154	1499	1544	58	1	45	0.0222222
NODE_430_length_3634_cov_34.913154	1499	1544	65	1	45	0.0222222
NODE_430_length_3634_cov_34.913154	1499	1544	70	1	45	0.0222222
NODE_430_length_3634_cov_34.913154	1499	1544	74	1	45	0.0222222
NODE_430_length_3634_cov_34.913154	1499	1544	76	2	45	0.0444444
NODE_430_length_3634_cov_34.913154	1499	1544	78	1	45	0.0222222
NODE_430_length_3634_cov_34.913154	1499	1544	84	2	45	0.0444444
NODE_430_length_3634_cov_34.913154	1499	1544	86	2	45	0.0444444
NODE_430_length_3634_cov_34.913154	1499	1544	88	2	45	0.0444444
NODE_430_length_3634_cov_34.913154	1499	1544	94	1	45	0.0222222
NODE_430_length_3634_cov_34.913154	1499	1544	96	2	45	0.0444444
NODE_430_length_3634_cov_34.913154	1499	1544	98	1	45	0.0222222
NODE_430_length_3634_cov_34.913154	1499	1544	100	1	45	0.0222222
NODE_430_length_3634_cov_34.913154	1499	1544	102	1	45	0.0222222
NODE_430_length_3634_cov_34.913154	1499	1544	107	1	45	0.0222222
NODE_430_length_3634_cov_34.913154	1499	1544	118	1	45	0.0222222
NODE_430_length_3634_cov_34.913154	1499	1544	128	1	45	0.0222222
NODE_430_length_3634_cov_34.913154	1499	1544	149	2	45	0.0444444
NODE_430_length_3634_cov_34.913154	1499	1544	151	2	45	0.0444444
NODE_430_length_3634_cov_34.913154	1499	1544	155	1	45	0.0222222
NODE_430_length_3634_cov_34.913154	1499	1544	159	1	45	0.0222222
NODE_430_length_3634_cov_34.913154	1499	1544	164	2	45	0.0444444
NODE_430_length_3634_cov_34.913154	1499	1544	169	1	45	0.0222222
NODE_430_length_3634_cov_34.913154	1499	1544	173	1	45	0.0222222
NODE_430_length_3634_cov_34.913154	1499	1544	181	1	45	0.0222222
NODE_430_length_3634_cov_34.913154	1499	1544	186	1	45	0.0222222
NODE_430_length_3634_cov_34.913154	1499	1544	192	1	45	0.0222222
NODE_430_length_3634_cov_34.913154	1499	1544	196	3	45	0.0666667
NODE_430_length_3634_cov_34.913154	1499	1544	206	2	45	0.0444444
NODE_430_length_3634_cov_34.913154	1517	1597	94	1	80	0.0125000
NODE_430_length_3634_cov_34.913154	1517	1597	96	2	80	0.0250000
NODE_430_length_3634_cov_34.913154	1517	1597	98	1	80	0.0125000
NODE_430_length_3634_cov_34.913154	1517	1597	100	1	80	0.0125000
NODE_430_length_3634_cov_34.913154	1517	1597	102	1	80	0.0125000
NODE_430_length_3634_cov_34.913154	1517	1597	107	1	80	0.0125000
NODE_430_length_3634_cov_34.913154	1517	1597	118	1	80	0.0125000
NODE_430_length_3634_cov_34.913154	1517	1597	128	1	80	0.0125000
NODE_430_length_3634_cov_34.913154	1517	1597	149	2	80	0.0250000
NODE_430_length_3634_cov_34.913154	1517	1597	151	2	80	0.0250000
NODE_430_length_3634_cov_34.913154	1517	1597	155	1	80	0.0125000
NODE_430_length_3634_cov_34.913154	1517	1597	159	1	80	0.0125000
NODE_430_length_3634_cov_34.913154	1517	1597	164	2	80	0.0250000
NODE_430_length_3634_cov_34.913154	1517	1597	169	1	80	0.0125000
NODE_430_length_3634_cov_34.913154	1517	1597	173	1	80	0.0125000
NODE_430_length_3634_cov_34.913154	1517	1597	181	1	80	0.0125000
NODE_430_length_3634_cov_34.913154	1517	1597	186	1	80	0.0125000
NODE_430_length_3634_cov_34.913154	1517	1597	192	1	80	0.0125000
NODE_430_length_3634_cov_34.913154	1517	1597	196	3	80	0.0375000
NODE_430_length_3634_cov_34.913154	1517	1597	206	2	80	0.0250000
NODE_430_length_3634_cov_34.913154	1517	1597	208	1	80	0.0125000
NODE_430_length_3634_cov_34.913154	1517	1597	209	1	80	0.0125000
NODE_430_length_3634_cov_34.913154	1517	1597	211	2	80	0.0250000
NODE_430_length_3634_cov_34.913154	1517	1597	216	3	80	0.0375000
NODE_430_length_3634_cov_34.913154	1517	1597	223	2	80	0.0250000
NODE_430_length_3634_cov_34.913154	1517	1597	228	1	80	0.0125000
NODE_430_length_3634_cov_34.913154	1517	1597	234	1	80	0.0125000
NODE_430_length_3634_cov_34.913154	1517	1597	239	2	80	0.0250000
NODE_430_length_3634_cov_34.913154	1517	1597	243	1	80	0.0125000
NODE_430_length_3634_cov_34.913154	1517	1597	246	1	80	0.0125000
NODE_430_length_3634_cov_34.913154	1517	1597	251	1	80	0.0125000
NODE_430_length_3634_cov_34.913154	1517	1597	258	1	80	0.0125000
NODE_430_length_3634_cov_34.913154	1517	1597	259	1	80	0.0125000
NODE_430_length_3634_cov_34.913154	1517	1597	260	2	80	0.0250000
NODE_430_length_3634_cov_34.913154	1517	1597	262	2	80	0.0250000
NODE_430_length_3634_cov_34.913154	1517	1597	265	2	80	0.0250000
NODE_430_length_3634_cov_34.913154	1517	1597	267	2	80	0.0250000
NODE_430_length_3634_cov_34.913154	1517	1597	269	1	80	0.0125000
NODE_430_length_3634_cov_34.913154	1517	1597	270	1	80	0.0125000
NODE_430_length_3634_cov_34.913154	1517	1597	275	1	80	0.0125000
NODE_430_length_3634_cov_34.913154	1517	1597	277	1	80	0.0125000
NODE_430_length_3634_cov_34.913154	1517	1597	279	1	80	0.0125000
NODE_430_length_3634_cov_34.913154	1517	1597	281	1	80	0.0125000
NODE_430_length_3634_cov_34.913154	1517	1597	284	1	80	0.0125000
NODE_430_length_3634_cov_34.913154	1517	1597	291	2	80	0.0250000
NODE_430_length_3634_cov_34.913154	1517	1597	297	2	80	0.0250000
NODE_430_length_3634_cov_34.913154	1517	1597	298	1	80	0.0125000
NODE_430_length_3634_cov_34.913154	1517	1597	299	1	80	0.0125000
NODE_430_length_3634_cov_34.913154	1517	1597	300	3	80	0.0375000
NODE_430_length_3634_cov_34.913154	1517	1597	302	3	80	0.0375000
NODE_430_length_3634_cov_34.913154	1517	1597	304	1	80	0.0125000
NODE_430_length_3634_cov_34.913154	1517	1597	305	1	80	0.0125000
NODE_430_length_3634_cov_34.913154	1517	1597	306	1	80	0.0125000
NODE_430_length_3634_cov_34.913154	1517	1597	308	1	80	0.0125000
NODE_430_length_3634_cov_34.913154	1517	1597	309	2	80	0.0250000
NODE_430_length_3634_cov_34.913154	1517	1597	312	2	80	0.0250000
NODE_430_length_3634_cov_34.913154	1978	2058	105	2	80	0.0250000
NODE_430_length_3634_cov_34.913154	1978	2058	107	1	80	0.0125000
NODE_430_length_3634_cov_34.913154	1978	2058	112	1	80	0.0125000
NODE_430_length_3634_cov_34.913154	1978	2058	123	1	80	0.0125000
NODE_430_length_3634_cov_34.913154	1978	2058	128	2	80	0.0250000
NODE_430_length_3634_cov_34.913154	1978	2058	130	1	80	0.0125000
NODE_430_length_3634_cov_34.913154	1978	2058	132	2	80	0.0250000
NODE_430_length_3634_cov_34.913154	1978	2058	134	1	80	0.0125000
NODE_430_length_3634_cov_34.913154	1978	2058	141	2	80	0.0250000
NODE_430_length_3634_cov_34.913154	1978	2058	145	1	80	0.0125000
NODE_430_length_3634_cov_34.913154	1978	2058	149	2	80	0.0250000
NODE_430_length_3634_cov_34.913154	1978	2058	152	1	80	0.0125000
NODE_430_length_3634_cov_34.913154	1978	2058	157	2	80	0.0250000
NODE_430_length_3634_cov_34.913154	1978	2058	161	1	80	0.0125000
NODE_430_length_3634_cov_34.913154	1978	2058	166	1	80	0.0125000
NODE_430_length_3634_cov_34.913154	1978	2058	170	2	80	0.0250000
NODE_430_length_3634_cov_34.913154	1978	2058	171	1	80	0.0125000
NODE_430_length_3634_cov_34.913154	1978	2058	178	1	80	0.0125000
NODE_430_length_3634_cov_34.913154	1978	2058	185	1	80	0.0125000
NODE_430_length_3634_cov_34.913154	1978	2058	189	2	80	0.0250000
NODE_430_length_3634_cov_34.913154	1978	2058	193	1	80	0.0125000
NODE_430_length_3634_cov_34.913154	1978	2058	194	2	80	0.0250000
NODE_430_length_3634_cov_34.913154	1978	2058	197	1	80	0.0125000
NODE_430_length_3634_cov_34.913154	1978	2058	201	1	80	0.0125000
NODE_430_length_3634_cov_34.913154	1978	2058	205	1	80	0.0125000
NODE_430_length_3634_cov_34.913154	1978	2058	207	1	80	0.0125000
NODE_430_length_3634_cov_34.913154	1978	2058	208	1	80	0.0125000
NODE_430_length_3634_cov_34.913154	1978	2058	211	1	80	0.0125000
NODE_430_length_3634_cov_34.913154	1978	2058	213	1	80	0.0125000
NODE_430_length_3634_cov_34.913154	1978	2058	215	1	80	0.0125000
NODE_430_length_3634_cov_34.913154	1978	2058	219	2	80	0.0250000
NODE_430_length_3634_cov_34.913154	1978	2058	221	3	80	0.0375000
NODE_430_length_3634_cov_34.913154	1978	2058	227	1	80	0.0125000
NODE_430_length_3634_cov_34.913154	1978	2058	232	1	80	0.0125000
NODE_430_length_3634_cov_34.913154	1978	2058	233	2	80	0.0250000
NODE_430_length_3634_cov_34.913154	1978	2058	235	1	80	0.0125000
NODE_430_length_3634_cov_34.913154	1978	2058	237	1	80	0.0125000
NODE_430_length_3634_cov_34.913154	1978	2058	243	2	80	0.0250000
NODE_430_length_3634_cov_34.913154	1978	2058	245	1	80	0.0125000
NODE_430_length_3634_cov_34.913154	1978	2058	247	1	80	0.0125000
NODE_430_length_3634_cov_34.913154	1978	2058	249	2	80	0.0250000
NODE_430_length_3634_cov_34.913154	1978	2058	251	2	80	0.0250000
NODE_430_length_3634_cov_34.913154	1978	2058	253	2	80	0.0250000
NODE_430_length_3634_cov_34.913154	1978	2058	257	1	80	0.0125000
NODE_430_length_3634_cov_34.913154	1978	2058	261	2	80	0.0250000
NODE_430_length_3634_cov_34.913154	1978	2058	268	1	80	0.0125000
NODE_430_length_3634_cov_34.913154	1978	2058	270	1	80	0.0125000
NODE_430_length_3634_cov_34.913154	1978	2058	286	1	80	0.0125000
NODE_430_length_3634_cov_34.913154	1978	2058	288	1	80	0.0125000
NODE_430_length_3634_cov_34.913154	1978	2058	289	1	80	0.0125000
NODE_430_length_3634_cov_34.913154	1978	2058	295	1	80	0.0125000
NODE_430_length_3634_cov_34.913154	1978	2058	296	1	80	0.0125000
NODE_430_length_3634_cov_34.913154	1978	2058	301	1	80	0.0125000
NODE_430_length_3634_cov_34.913154	1978	2058	308	1	80	0.0125000
NODE_430_length_3634_cov_34.913154	1978	2058	317	1	80	0.0125000
NODE_430_length_3634_cov_34.913154	1978	2058	323	2	80	0.0250000
NODE_430_length_3634_cov_34.913154	1978	2058	328	1	80	0.0125000
NODE_430_length_3634_cov_34.913154	1978	2058	336	1	80	0.0125000
NODE_430_length_3634_cov_34.913154	1978	2058	345	1	80	0.0125000
NODE_430_length_3634_cov_34.913154	1978	2058	347	1	80	0.0125000
NODE_430_length_3634_cov_34.913154	1978	2058	348	1	80	0.0125000
NODE_430_length_3634_cov_34.913154	2031	2077	34	2	46	0.0434783
NODE_430_length_3634_cov_34.913154	2031	2077	38	1	46	0.0217391
NODE_430_length_3634_cov_34.913154	2031	2077	54	1	46	0.0217391
NODE_430_length_3634_cov_34.913154	2031	2077	55	2	46	0.0434783
NODE_430_length_3634_cov_34.913154	2031	2077	56	1	46	0.0217391
NODE_430_length_3634_cov_34.913154	2031	2077	60	1	46	0.0217391
NODE_430_length_3634_cov_34.913154	2031	2077	65	1	46	0.0217391
NODE_430_length_3634_cov_34.913154	2031	2077	69	1	46	0.0217391
NODE_430_length_3634_cov_34.913154	2031	2077	71	1	46	0.0217391
NODE_430_length_3634_cov_34.913154	2031	2077	75	1	46	0.0217391
NODE_430_length_3634_cov_34.913154	2031	2077	79	1	46	0.0217391
NODE_430_length_3634_cov_34.913154	2031	2077	83	1	46	0.0217391
NODE_430_length_3634_cov_34.913154	2031	2077	88	3	46	0.0652174
NODE_430_length_3634_cov_34.913154	2031	2077	90	1	46	0.0217391
NODE_430_length_3634_cov_34.913154	2031	2077	98	1	46	0.0217391
NODE_430_length_3634_cov_34.913154	2031	2077	105	2	46	0.0434783
NODE_430_length_3634_cov_34.913154	2031	2077	107	1	46	0.0217391
NODE_430_length_3634_cov_34.913154	2031	2077	112	1	46	0.0217391
NODE_430_length_3634_cov_34.913154	2031	2077	123	1	46	0.0217391
NODE_430_length_3634_cov_34.913154	2031	2077	128	2	46	0.0434783
NODE_430_length_3634_cov_34.913154	2031	2077	130	1	46	0.0217391
NODE_430_length_3634_cov_34.913154	2031	2077	132	2	46	0.0434783
NODE_430_length_3634_cov_34.913154	2031	2077	134	1	46	0.0217391
NODE_430_length_3634_cov_34.913154	2031	2077	141	2	46	0.0434783
NODE_430_length_3634_cov_34.913154	2031	2077	145	1	46	0.0217391
NODE_430_length_3634_cov_34.913154	2031	2077	149	2	46	0.0434783
NODE_430_length_3634_cov_34.913154	2031	2077	152	1	46	0.0217391
NODE_430_length_3634_cov_34.913154	2031	2077	157	2	46	0.0434783
NODE_430_length_3634_cov_34.913154	2031	2077	161	1	46	0.0217391
NODE_430_length_3634_cov_34.913154	2031	2077	166	1	46	0.0217391
NODE_430_length_3634_cov_34.913154	2031	2077	170	2	46	0.0434783
NODE_430_length_3634_cov_34.913154	2031	2077	171	1	46	0.0217391
NODE_430_length_3634_cov_34.913154	2031	2077	178	1	46	0.0217391
NODE_430_length_3634_cov_34.913154	2031	2077	185	1	46	0.0217391
NODE_430_length_3634_cov_34.913154	2031	2077	189	1	46	0.0217391
NODE_435_length_3622_cov_29.112120	201	281	0	6	80	0.0750000
NODE_435_length_3622_cov_29.112120	201	281	3	40	80	0.5000000
NODE_435_length_3622_cov_29.112120	201	281	7	32	80	0.4000000
NODE_435_length_3622_cov_29.112120	201	281	8	1	80	0.0125000
NODE_435_length_3622_cov_29.112120	201	281	9	1	80	0.0125000
NODE_435_length_3622_cov_29.112120	254	334	7	25	80	0.3125000
NODE_435_length_3622_cov_29.112120	254	334	8	1	80	0.0125000
NODE_435_length_3622_cov_29.112120	254	334	9	53	80	0.6625000
NODE_435_length_3622_cov_29.112120	254	334	11	1	80	0.0125000
NODE_435_length_3622_cov_29.112120	2310	2390	67	1	80	0.0125000
NODE_435_length_3622_cov_29.112120	2310	2390	71	2	80	0.0250000
NODE_435_length_3622_cov_29.112120	2310	2390	75	2	80	0.0250000
NODE_435_length_3622_cov_29.112120	2310	2390	76	9	80	0.1125000
NODE_435_length_3622_cov_29.112120	2310	2390	80	4	80	0.0500000
NODE_435_length_3622_cov_29.112120	2310	2390	86	1	80	0.0125000
NODE_435_length_3622_cov_29.112120	2310	2390	89	1	80	0.0125000
NODE_435_length_3622_cov_29.112120	2310	2390	91	2	80	0.0250000
NODE_435_length_3622_cov_29.112120	2310	2390	93	2	80	0.0250000
NODE_435_length_3622_cov_29.112120	2310	2390	95	1	80	0.0125000
NODE_435_length_3622_cov_29.112120	2310	2390	102	1	80	0.0125000
NODE_435_length_3622_cov_29.112120	2310	2390	105	3	80	0.0375000
NODE_435_length_3622_cov_29.112120	2310	2390	107	1	80	0.0125000
NODE_435_length_3622_cov_29.112120	2310	2390	113	1	80	0.0125000
NODE_435_length_3622_cov_29.112120	2310	2390	115	1	80	0.0125000
NODE_435_length_3622_cov_29.112120	2310	2390	117	1	80	0.0125000
NODE_435_length_3622_cov_29.112120	2310	2390	119	1	80	0.0125000
NODE_435_length_3622_cov_29.112120	2310	2390	129	2	80	0.0250000
NODE_435_length_3622_cov_29.112120	2310	2390	135	1	80	0.0125000
NODE_435_length_3622_cov_29.112120	2310	2390	137	2	80	0.0250000
NODE_435_length_3622_cov_29.112120	2310	2390	138	1	80	0.0125000
NODE_435_length_3622_cov_29.112120	2310	2390	150	1	80	0.0125000
NODE_435_length_3622_cov_29.112120	2310	2390	153	1	80	0.0125000
NODE_435_length_3622_cov_29.112120	2310	2390	157	1	80	0.0125000
NODE_435_length_3622_cov_29.112120	2310	2390	158	3	80	0.0375000
NODE_435_length_3622_cov_29.112120	2310	2390	160	3	80	0.0375000
NODE_435_length_3622_cov_29.112120	2310	2390	162	1	80	0.0125000
NODE_435_length_3622_cov_29.112120	2310	2390	164	3	80	0.0375000
NODE_435_length_3622_cov_29.112120	2310	2390	168	1	80	0.0125000
NODE_435_length_3622_cov_29.112120	2310	2390	170	2	80	0.0250000
NODE_435_length_3622_cov_29.112120	2310	2390	173	1	80	0.0125000
NODE_435_length_3622_cov_29.112120	2310	2390	174	1	80	0.0125000
NODE_435_length_3622_cov_29.112120	2310	2390	175	3	80	0.0375000
NODE_435_length_3622_cov_29.112120	2310	2390	176	1	80	0.0125000
NODE_435_length_3622_cov_29.112120	2310	2390	178	2	80	0.0250000
NODE_435_length_3622_cov_29.112120	2310	2390	179	2	80	0.0250000
NODE_435_length_3622_cov_29.112120	2310	2390	181	1	80	0.0125000
NODE_435_length_3622_cov_29.112120	2310	2390	182	1	80	0.0125000
NODE_435_length_3622_cov_29.112120	2310	2390	183	2	80	0.0250000
NODE_435_length_3622_cov_29.112120	2310	2390	184	2	80	0.0250000
NODE_435_length_3622_cov_29.112120	2310	2390	185	1	80	0.0125000
NODE_435_length_3622_cov_29.112120	2310	2390	187	1	80	0.0125000
NODE_435_length_3622_cov_29.112120	2310	2390	197	6	80	0.0750000
NODE_435_length_3622_cov_29.112120	2363	2441	13	5	78	0.0641026
NODE_435_length_3622_cov_29.112120	2363	2441	18	2	78	0.0256410
NODE_435_length_3622_cov_29.112120	2363	2441	20	2	78	0.0256410
NODE_435_length_3622_cov_29.112120	2363	2441	21	3	78	0.0384615
NODE_435_length_3622_cov_29.112120	2363	2441	26	4	78	0.0512821
NODE_435_length_3622_cov_29.112120	2363	2441	29	2	78	0.0256410
NODE_435_length_3622_cov_29.112120	2363	2441	30	10	78	0.1282051
NODE_435_length_3622_cov_29.112120	2363	2441	36	7	78	0.0897436
NODE_435_length_3622_cov_29.112120	2363	2441	40	3	78	0.0384615
NODE_435_length_3622_cov_29.112120	2363	2441	42	2	78	0.0256410
NODE_435_length_3622_cov_29.112120	2363	2441	46	1	78	0.0128205
NODE_435_length_3622_cov_29.112120	2363	2441	48	5	78	0.0641026
NODE_435_length_3622_cov_29.112120	2363	2441	50	2	78	0.0256410
NODE_435_length_3622_cov_29.112120	2363	2441	59	2	78	0.0256410
NODE_435_length_3622_cov_29.112120	2363	2441	63	1	78	0.0128205
NODE_435_length_3622_cov_29.112120	2363	2441	67	1	78	0.0128205
NODE_435_length_3622_cov_29.112120	2363	2441	71	2	78	0.0256410
NODE_435_length_3622_cov_29.112120	2363	2441	75	2	78	0.0256410
NODE_435_length_3622_cov_29.112120	2363	2441	76	9	78	0.1153846
NODE_435_length_3622_cov_29.112120	2363	2441	80	4	78	0.0512821
NODE_435_length_3622_cov_29.112120	2363	2441	86	1	78	0.0128205
NODE_435_length_3622_cov_29.112120	2363	2441	89	1	78	0.0128205
NODE_435_length_3622_cov_29.112120	2363	2441	91	2	78	0.0256410
NODE_435_length_3622_cov_29.112120	2363	2441	93	2	78	0.0256410
NODE_435_length_3622_cov_29.112120	2363	2441	95	1	78	0.0128205
NODE_435_length_3622_cov_29.112120	2363	2441	102	1	78	0.0128205
NODE_435_length_3622_cov_29.112120	2363	2441	105	1	78	0.0128205
NODE_437_length_3610_cov_8.785816	294	340	0	17	46	0.3695652
NODE_437_length_3610_cov_8.785816	294	340	2	29	46	0.6304348
NODE_437_length_3610_cov_8.785816	313	393	2	80	80	1.0000000
NODE_444_length_3588_cov_16.296360	2421	2501	7	17	80	0.2125000
NODE_444_length_3588_cov_16.296360	2421	2501	9	5	80	0.0625000
NODE_444_length_3588_cov_16.296360	2421	2501	13	2	80	0.0250000
NODE_444_length_3588_cov_16.296360	2421	2501	17	1	80	0.0125000
NODE_444_length_3588_cov_16.296360	2421	2501	20	55	80	0.6875000
NODE_444_length_3588_cov_16.296360	2474	2539	14	7	65	0.1076923
NODE_444_length_3588_cov_16.296360	2474	2539	18	18	65	0.2769231
NODE_444_length_3588_cov_16.296360	2474	2539	20	40	65	0.6153846
NODE_447_length_3585_cov_2.283419	605	668	0	63	63	1.0000000
NODE_451_length_3567_cov_16.283160	410	429	22	5	19	0.2631579
NODE_451_length_3567_cov_16.283160	410	429	26	12	19	0.6315789
NODE_451_length_3567_cov_16.283160	410	429	28	1	19	0.0526316
NODE_451_length_3567_cov_16.283160	410	429	38	1	19	0.0526316
NODE_451_length_3567_cov_16.283160	2259	2339	218	2	80	0.0250000
NODE_451_length_3567_cov_16.283160	2259	2339	220	1	80	0.0125000
NODE_451_length_3567_cov_16.283160	2259	2339	221	1	80	0.0125000
NODE_451_length_3567_cov_16.283160	2259	2339	227	1	80	0.0125000
NODE_451_length_3567_cov_16.283160	2259	2339	228	1	80	0.0125000
NODE_451_length_3567_cov_16.283160	2259	2339	234	1	80	0.0125000
NODE_451_length_3567_cov_16.283160	2259	2339	235	1	80	0.0125000
NODE_451_length_3567_cov_16.283160	2259	2339	237	2	80	0.0250000
NODE_451_length_3567_cov_16.283160	2259	2339	239	1	80	0.0125000
NODE_451_length_3567_cov_16.283160	2259	2339	240	4	80	0.0500000
NODE_451_length_3567_cov_16.283160	2259	2339	242	2	80	0.0250000
NODE_451_length_3567_cov_16.283160	2259	2339	243	1	80	0.0125000
NODE_451_length_3567_cov_16.283160	2259	2339	247	2	80	0.0250000
NODE_451_length_3567_cov_16.283160	2259	2339	251	1	80	0.0125000
NODE_451_length_3567_cov_16.283160	2259	2339	252	1	80	0.0125000
NODE_451_length_3567_cov_16.283160	2259	2339	253	4	80	0.0500000
NODE_451_length_3567_cov_16.283160	2259	2339	254	2	80	0.0250000
NODE_451_length_3567_cov_16.283160	2259	2339	255	3	80	0.0375000
NODE_451_length_3567_cov_16.283160	2259	2339	256	1	80	0.0125000
NODE_451_length_3567_cov_16.283160	2259	2339	257	3	80	0.0375000
NODE_451_length_3567_cov_16.283160	2259	2339	259	6	80	0.0750000
NODE_451_length_3567_cov_16.283160	2259	2339	260	2	80	0.0250000
NODE_451_length_3567_cov_16.283160	2259	2339	261	7	80	0.0875000
NODE_451_length_3567_cov_16.283160	2259	2339	262	3	80	0.0375000
NODE_451_length_3567_cov_16.283160	2259	2339	264	8	80	0.1000000
NODE_451_length_3567_cov_16.283160	2259	2339	265	4	80	0.0500000
NODE_451_length_3567_cov_16.283160	2259	2339	266	5	80	0.0625000
NODE_451_length_3567_cov_16.283160	2259	2339	267	1	80	0.0125000
NODE_451_length_3567_cov_16.283160	2259	2339	268	2	80	0.0250000
NODE_451_length_3567_cov_16.283160	2259	2339	269	1	80	0.0125000
NODE_451_length_3567_cov_16.283160	2259	2339	270	4	80	0.0500000
NODE_451_length_3567_cov_16.283160	2259	2339	271	2	80	0.0250000
NODE_451_length_3567_cov_16.283160	2312	2379	10	1	67	0.0149254
NODE_451_length_3567_cov_16.283160	2312	2379	22	1	67	0.0149254
NODE_451_length_3567_cov_16.283160	2312	2379	28	2	67	0.0298507
NODE_451_length_3567_cov_16.283160	2312	2379	34	1	67	0.0149254
NODE_451_length_3567_cov_16.283160	2312	2379	47	1	67	0.0149254
NODE_451_length_3567_cov_16.283160	2312	2379	49	1	67	0.0149254
NODE_451_length_3567_cov_16.283160	2312	2379	57	1	67	0.0149254
NODE_451_length_3567_cov_16.283160	2312	2379	64	1	67	0.0149254
NODE_451_length_3567_cov_16.283160	2312	2379	70	1	67	0.0149254
NODE_451_length_3567_cov_16.283160	2312	2379	83	1	67	0.0149254
NODE_451_length_3567_cov_16.283160	2312	2379	87	1	67	0.0149254
NODE_451_length_3567_cov_16.283160	2312	2379	97	1	67	0.0149254
NODE_451_length_3567_cov_16.283160	2312	2379	114	3	67	0.0447761
NODE_451_length_3567_cov_16.283160	2312	2379	117	1	67	0.0149254
NODE_451_length_3567_cov_16.283160	2312	2379	135	1	67	0.0149254
NODE_451_length_3567_cov_16.283160	2312	2379	137	1	67	0.0149254
NODE_451_length_3567_cov_16.283160	2312	2379	145	1	67	0.0149254
NODE_451_length_3567_cov_16.283160	2312	2379	146	1	67	0.0149254
NODE_451_length_3567_cov_16.283160	2312	2379	162	1	67	0.0149254
NODE_451_length_3567_cov_16.283160	2312	2379	167	1	67	0.0149254
NODE_451_length_3567_cov_16.283160	2312	2379	177	2	67	0.0298507
NODE_451_length_3567_cov_16.283160	2312	2379	191	1	67	0.0149254
NODE_451_length_3567_cov_16.283160	2312	2379	193	1	67	0.0149254
NODE_451_length_3567_cov_16.283160	2312	2379	198	1	67	0.0149254
NODE_451_length_3567_cov_16.283160	2312	2379	203	1	67	0.0149254
NODE_451_length_3567_cov_16.283160	2312	2379	205	1	67	0.0149254
NODE_451_length_3567_cov_16.283160	2312	2379	211	1	67	0.0149254
NODE_451_length_3567_cov_16.283160	2312	2379	215	1	67	0.0149254
NODE_451_length_3567_cov_16.283160	2312	2379	219	1	67	0.0149254
NODE_451_length_3567_cov_16.283160	2312	2379	220	2	67	0.0298507
NODE_451_length_3567_cov_16.283160	2312	2379	221	1	67	0.0149254
NODE_451_length_3567_cov_16.283160	2312	2379	225	1	67	0.0149254
NODE_451_length_3567_cov_16.283160	2312	2379	229	2	67	0.0298507
NODE_451_length_3567_cov_16.283160	2312	2379	231	1	67	0.0149254
NODE_451_length_3567_cov_16.283160	2312	2379	234	1	67	0.0149254
NODE_451_length_3567_cov_16.283160	2312	2379	237	1	67	0.0149254
NODE_451_length_3567_cov_16.283160	2312	2379	240	4	67	0.0597015
NODE_451_length_3567_cov_16.283160	2312	2379	242	2	67	0.0298507
NODE_451_length_3567_cov_16.283160	2312	2379	247	1	67	0.0149254
NODE_451_length_3567_cov_16.283160	2312	2379	253	2	67	0.0298507
NODE_451_length_3567_cov_16.283160	2312	2379	254	1	67	0.0149254
NODE_451_length_3567_cov_16.283160	2312	2379	257	1	67	0.0149254
NODE_451_length_3567_cov_16.283160	2312	2379	259	2	67	0.0298507
NODE_451_length_3567_cov_16.283160	2312	2379	261	2	67	0.0298507
NODE_451_length_3567_cov_16.283160	2312	2379	262	2	67	0.0298507
NODE_451_length_3567_cov_16.283160	2312	2379	265	2	67	0.0298507
NODE_451_length_3567_cov_16.283160	2312	2379	266	4	67	0.0597015
NODE_451_length_3567_cov_16.283160	2312	2379	267	1	67	0.0149254
NODE_451_length_3567_cov_16.283160	2312	2379	268	1	67	0.0149254
NODE_454_length_3557_cov_12.423077	640	718	0	59	78	0.7564102
NODE_454_length_3557_cov_12.423077	640	718	2	19	78	0.2435897
NODE_454_length_3557_cov_12.423077	640	688	0	48	48	1.0000000
NODE_454_length_3557_cov_12.423077	640	688	0	48	48	1.0000000
NODE_454_length_3557_cov_12.423077	640	688	0	48	48	1.0000000
NODE_454_length_3557_cov_12.423077	640	688	0	48	48	1.0000000
NODE_454_length_3557_cov_12.423077	693	771	0	6	78	0.0769231
NODE_454_length_3557_cov_12.423077	693	771	2	72	78	0.9230769
NODE_455_length_3548_cov_7.216295	554	634	0	80	80	1.0000000
NODE_455_length_3548_cov_7.216295	607	687	0	80	80	1.0000000
NODE_461_length_3518_cov_40.508336	1320	1400	0	80	80	1.0000000
NODE_461_length_3518_cov_40.508336	1373	1453	0	80	80	1.0000000
NODE_465_length_3497_cov_65.791348	3062	3142	300	1	80	0.0125000
NODE_465_length_3497_cov_65.791348	3062	3142	301	1	80	0.0125000
NODE_465_length_3497_cov_65.791348	3062	3142	302	2	80	0.0250000
NODE_465_length_3497_cov_65.791348	3062	3142	304	1	80	0.0125000
NODE_465_length_3497_cov_65.791348	3062	3142	306	2	80	0.0250000
NODE_465_length_3497_cov_65.791348	3062	3142	307	1	80	0.0125000
NODE_465_length_3497_cov_65.791348	3062	3142	314	1	80	0.0125000
NODE_465_length_3497_cov_65.791348	3062	3142	318	2	80	0.0250000
NODE_465_length_3497_cov_65.791348	3062	3142	328	1	80	0.0125000
NODE_465_length_3497_cov_65.791348	3062	3142	332	1	80	0.0125000
NODE_465_length_3497_cov_65.791348	3062	3142	338	1	80	0.0125000
NODE_465_length_3497_cov_65.791348	3062	3142	351	1	80	0.0125000
NODE_465_length_3497_cov_65.791348	3062	3142	366	1	80	0.0125000
NODE_465_length_3497_cov_65.791348	3062	3142	369	2	80	0.0250000
NODE_465_length_3497_cov_65.791348	3062	3142	371	1	80	0.0125000
NODE_465_length_3497_cov_65.791348	3062	3142	374	1	80	0.0125000
NODE_465_length_3497_cov_65.791348	3062	3142	379	1	80	0.0125000
NODE_465_length_3497_cov_65.791348	3062	3142	380	1	80	0.0125000
NODE_465_length_3497_cov_65.791348	3062	3142	383	1	80	0.0125000
NODE_465_length_3497_cov_65.791348	3062	3142	384	1	80	0.0125000
NODE_465_length_3497_cov_65.791348	3062	3142	387	1	80	0.0125000
NODE_465_length_3497_cov_65.791348	3062	3142	388	1	80	0.0125000
NODE_465_length_3497_cov_65.791348	3062	3142	390	1	80	0.0125000
NODE_465_length_3497_cov_65.791348	3062	3142	396	2	80	0.0250000
NODE_465_length_3497_cov_65.791348	3062	3142	397	1	80	0.0125000
NODE_465_length_3497_cov_65.791348	3062	3142	402	1	80	0.0125000
NODE_465_length_3497_cov_65.791348	3062	3142	405	1	80	0.0125000
NODE_465_length_3497_cov_65.791348	3062	3142	406	4	80	0.0500000
NODE_465_length_3497_cov_65.791348	3062	3142	407	2	80	0.0250000
NODE_465_length_3497_cov_65.791348	3062	3142	408	3	80	0.0375000
NODE_465_length_3497_cov_65.791348	3062	3142	409	2	80	0.0250000
NODE_465_length_3497_cov_65.791348	3062	3142	410	2	80	0.0250000
NODE_465_length_3497_cov_65.791348	3062	3142	411	1	80	0.0125000
NODE_465_length_3497_cov_65.791348	3062	3142	412	2	80	0.0250000
NODE_465_length_3497_cov_65.791348	3062	3142	413	1	80	0.0125000
NODE_465_length_3497_cov_65.791348	3062	3142	414	1	80	0.0125000
NODE_465_length_3497_cov_65.791348	3062	3142	415	1	80	0.0125000
NODE_465_length_3497_cov_65.791348	3062	3142	416	1	80	0.0125000
NODE_465_length_3497_cov_65.791348	3062	3142	420	1	80	0.0125000
NODE_465_length_3497_cov_65.791348	3062	3142	421	1	80	0.0125000
NODE_465_length_3497_cov_65.791348	3062	3142	423	1	80	0.0125000
NODE_465_length_3497_cov_65.791348	3062	3142	424	1	80	0.0125000
NODE_465_length_3497_cov_65.791348	3062	3142	425	3	80	0.0375000
NODE_465_length_3497_cov_65.791348	3062	3142	426	3	80	0.0375000
NODE_465_length_3497_cov_65.791348	3062	3142	427	2	80	0.0250000
NODE_465_length_3497_cov_65.791348	3062	3142	428	5	80	0.0625000
NODE_465_length_3497_cov_65.791348	3062	3142	430	2	80	0.0250000
NODE_465_length_3497_cov_65.791348	3062	3142	431	2	80	0.0250000
NODE_465_length_3497_cov_65.791348	3062	3142	432	3	80	0.0375000
NODE_465_length_3497_cov_65.791348	3062	3142	436	3	80	0.0375000
NODE_465_length_3497_cov_65.791348	3062	3142	437	1	80	0.0125000
NODE_466_length_3488_cov_2.243730	506	529	0	23	23	1.0000000
NODE_470_length_3483_cov_14.759456	360	440	2	80	80	1.0000000
NODE_470_length_3483_cov_14.759456	413	493	0	36	80	0.4500000
NODE_470_length_3483_cov_14.759456	413	493	2	44	80	0.5500000
NODE_474_length_3471_cov_37.887604	2795	2875	0	38	80	0.4750000
NODE_474_length_3471_cov_37.887604	2795	2875	2	42	80	0.5250000
NODE_474_length_3471_cov_37.887604	2848	2928	0	10	80	0.1250000
NODE_474_length_3471_cov_37.887604	2848	2928	2	70	80	0.8750000
NODE_474_length_3471_cov_37.887604	2924	2943	0	19	19	1.0000000
NODE_474_length_3471_cov_37.887604	2924	3004	0	80	80	1.0000000
NODE_474_length_3471_cov_37.887604	2977	3057	0	80	80	1.0000000
NODE_479_length_3451_cov_29.833234	2973	3053	0	52	80	0.6500000
NODE_479_length_3451_cov_29.833234	2973	3053	2	28	80	0.3500000
NODE_479_length_3451_cov_29.833234	3026	3106	0	80	80	1.0000000
NODE_481_length_3446_cov_32.421273	3181	3261	18	2	80	0.0250000
NODE_481_length_3446_cov_32.421273	3181	3261	20	9	80	0.1125000
NODE_481_length_3446_cov_32.421273	3181	3261	22	4	80	0.0500000
NODE_481_length_3446_cov_32.421273	3181	3261	24	3	80	0.0375000
NODE_481_length_3446_cov_32.421273	3181	3261	26	14	80	0.1750000
NODE_481_length_3446_cov_32.421273	3181	3261	28	31	80	0.3875000
NODE_481_length_3446_cov_32.421273	3181	3261	30	17	80	0.2125000
NODE_482_length_3444_cov_29.954858	792	872	10	13	80	0.1625000
NODE_482_length_3444_cov_29.954858	792	872	16	1	80	0.0125000
NODE_482_length_3444_cov_29.954858	792	872	18	66	80	0.8250000
NODE_482_length_3444_cov_29.954858	845	925	2	5	80	0.0625000
NODE_482_length_3444_cov_29.954858	845	925	8	14	80	0.1750000
NODE_482_length_3444_cov_29.954858	845	925	10	16	80	0.2000000
NODE_482_length_3444_cov_29.954858	845	925	11	2	80	0.0250000
NODE_482_length_3444_cov_29.954858	845	925	12	8	80	0.1000000
NODE_482_length_3444_cov_29.954858	845	925	18	35	80	0.4375000
NODE_483_length_3442_cov_17.799880	3155	3220	16	1	65	0.0153846
NODE_483_length_3442_cov_17.799880	3155	3220	26	1	65	0.0153846
NODE_483_length_3442_cov_17.799880	3155	3220	28	4	65	0.0615385
NODE_483_length_3442_cov_17.799880	3155	3220	32	2	65	0.0307692
NODE_483_length_3442_cov_17.799880	3155	3220	38	1	65	0.0153846
NODE_483_length_3442_cov_17.799880	3155	3220	40	1	65	0.0153846
NODE_483_length_3442_cov_17.799880	3155	3220	46	1	65	0.0153846
NODE_483_length_3442_cov_17.799880	3155	3220	50	1	65	0.0153846
NODE_483_length_3442_cov_17.799880	3155	3220	52	2	65	0.0307692
NODE_483_length_3442_cov_17.799880	3155	3220	63	1	65	0.0153846
NODE_483_length_3442_cov_17.799880	3155	3220	64	2	65	0.0307692
NODE_483_length_3442_cov_17.799880	3155	3220	66	1	65	0.0153846
NODE_483_length_3442_cov_17.799880	3155	3220	76	2	65	0.0307692
NODE_483_length_3442_cov_17.799880	3155	3220	82	1	65	0.0153846
NODE_483_length_3442_cov_17.799880	3155	3220	84	1	65	0.0153846
NODE_483_length_3442_cov_17.799880	3155	3220	88	1	65	0.0153846
NODE_483_length_3442_cov_17.799880	3155	3220	98	1	65	0.0153846
NODE_483_length_3442_cov_17.799880	3155	3220	100	1	65	0.0153846
NODE_483_length_3442_cov_17.799880	3155	3220	104	3	65	0.0461538
NODE_483_length_3442_cov_17.799880	3155	3220	106	1	65	0.0153846
NODE_483_length_3442_cov_17.799880	3155	3220	111	1	65	0.0153846
NODE_483_length_3442_cov_17.799880	3155	3220	118	1	65	0.0153846
NODE_483_length_3442_cov_17.799880	3155	3220	120	1	65	0.0153846
NODE_483_length_3442_cov_17.799880	3155	3220	124	1	65	0.0153846
NODE_483_length_3442_cov_17.799880	3155	3220	136	4	65	0.0615385
NODE_483_length_3442_cov_17.799880	3155	3220	138	5	65	0.0769231
NODE_483_length_3442_cov_17.799880	3155	3220	142	7	65	0.1076923
NODE_483_length_3442_cov_17.799880	3155	3220	148	1	65	0.0153846
NODE_483_length_3442_cov_17.799880	3155	3220	149	1	65	0.0153846
NODE_483_length_3442_cov_17.799880	3155	3220	151	2	65	0.0307692
NODE_483_length_3442_cov_17.799880	3155	3220	153	1	65	0.0153846
NODE_483_length_3442_cov_17.799880	3155	3220	155	1	65	0.0153846
NODE_483_length_3442_cov_17.799880	3155	3220	157	1	65	0.0153846
NODE_483_length_3442_cov_17.799880	3155	3220	159	1	65	0.0153846
NODE_483_length_3442_cov_17.799880	3155	3220	160	8	65	0.1230769
NODE_483_length_3442_cov_17.799880	3208	3273	153	1	65	0.0153846
NODE_483_length_3442_cov_17.799880	3208	3273	155	1	65	0.0153846
NODE_483_length_3442_cov_17.799880	3208	3273	157	1	65	0.0153846
NODE_483_length_3442_cov_17.799880	3208	3273	158	1	65	0.0153846
NODE_483_length_3442_cov_17.799880	3208	3273	159	2	65	0.0307692
NODE_483_length_3442_cov_17.799880	3208	3273	160	9	65	0.1384615
NODE_483_length_3442_cov_17.799880	3208	3273	161	4	65	0.0615385
NODE_483_length_3442_cov_17.799880	3208	3273	162	6	65	0.0923077
NODE_483_length_3442_cov_17.799880	3208	3273	163	2	65	0.0307692
NODE_483_length_3442_cov_17.799880	3208	3273	164	3	65	0.0461538
NODE_483_length_3442_cov_17.799880	3208	3273	166	1	65	0.0153846
NODE_483_length_3442_cov_17.799880	3208	3273	167	1	65	0.0153846
NODE_483_length_3442_cov_17.799880	3208	3273	168	2	65	0.0307692
NODE_483_length_3442_cov_17.799880	3208	3273	170	2	65	0.0307692
NODE_483_length_3442_cov_17.799880	3208	3273	171	1	65	0.0153846
NODE_483_length_3442_cov_17.799880	3208	3273	172	5	65	0.0769231
NODE_483_length_3442_cov_17.799880	3208	3273	173	1	65	0.0153846
NODE_483_length_3442_cov_17.799880	3208	3273	174	13	65	0.2000000
NODE_483_length_3442_cov_17.799880	3208	3273	175	4	65	0.0615385
NODE_483_length_3442_cov_17.799880	3208	3273	177	5	65	0.0769231
NODE_486_length_3429_cov_5.070270	125	148	28	13	23	0.5652174
NODE_486_length_3429_cov_5.070270	125	148	32	3	23	0.1304348
NODE_486_length_3429_cov_5.070270	125	148	34	2	23	0.0869565
NODE_486_length_3429_cov_5.070270	125	148	37	4	23	0.1739130
NODE_486_length_3429_cov_5.070270	125	148	40	1	23	0.0434783
NODE_493_length_3408_cov_2.406769	0	45	0	45	45	1.0000000
NODE_495_length_3405_cov_44.930127	2683	2759	4	22	76	0.2894737
NODE_495_length_3405_cov_44.930127	2683	2759	6	5	76	0.0657895
NODE_495_length_3405_cov_44.930127	2683	2759	7	9	76	0.1184211
NODE_495_length_3405_cov_44.930127	2683	2759	8	37	76	0.4868421
NODE_495_length_3405_cov_44.930127	2683	2759	10	3	76	0.0394737
NODE_495_length_3405_cov_44.930127	3116	3164	0	48	48	1.0000000
NODE_496_length_3402_cov_28.961550	128	183	2	55	55	1.0000000
NODE_496_length_3402_cov_28.961550	3154	3234	37	2	80	0.0250000
NODE_496_length_3402_cov_28.961550	3154	3234	41	5	80	0.0625000
NODE_496_length_3402_cov_28.961550	3154	3234	46	9	80	0.1125000
NODE_496_length_3402_cov_28.961550	3154	3234	47	4	80	0.0500000
NODE_496_length_3402_cov_28.961550	3154	3234	48	1	80	0.0125000
NODE_496_length_3402_cov_28.961550	3154	3234	49	2	80	0.0250000
NODE_496_length_3402_cov_28.961550	3154	3234	50	24	80	0.3000000
NODE_496_length_3402_cov_28.961550	3154	3234	52	18	80	0.2250000
NODE_496_length_3402_cov_28.961550	3154	3234	54	15	80	0.1875000
NODE_496_length_3402_cov_28.961550	3207	3287	0	10	80	0.1250000
NODE_496_length_3402_cov_28.961550	3207	3287	6	3	80	0.0375000
NODE_496_length_3402_cov_28.961550	3207	3287	9	14	80	0.1750000
NODE_496_length_3402_cov_28.961550	3207	3287	10	1	80	0.0125000
NODE_496_length_3402_cov_28.961550	3207	3287	12	4	80	0.0500000
NODE_496_length_3402_cov_28.961550	3207	3287	14	1	80	0.0125000
NODE_496_length_3402_cov_28.961550	3207	3287	16	1	80	0.0125000
NODE_496_length_3402_cov_28.961550	3207	3287	18	2	80	0.0250000
NODE_496_length_3402_cov_28.961550	3207	3287	22	1	80	0.0125000
NODE_496_length_3402_cov_28.961550	3207	3287	23	5	80	0.0625000
NODE_496_length_3402_cov_28.961550	3207	3287	25	3	80	0.0375000
NODE_496_length_3402_cov_28.961550	3207	3287	26	4	80	0.0500000
NODE_496_length_3402_cov_28.961550	3207	3287	30	2	80	0.0250000
NODE_496_length_3402_cov_28.961550	3207	3287	34	1	80	0.0125000
NODE_496_length_3402_cov_28.961550	3207	3287	36	1	80	0.0125000
NODE_496_length_3402_cov_28.961550	3207	3287	37	2	80	0.0250000
NODE_496_length_3402_cov_28.961550	3207	3287	41	5	80	0.0625000
NODE_496_length_3402_cov_28.961550	3207	3287	47	4	80	0.0500000
NODE_496_length_3402_cov_28.961550	3207	3287	49	2	80	0.0250000
NODE_496_length_3402_cov_28.961550	3207	3287	50	14	80	0.1750000
NODE_498_length_3393_cov_43.623558	1009	1075	24	2	66	0.0303030
NODE_498_length_3393_cov_43.623558	1009	1075	28	4	66	0.0606061
NODE_498_length_3393_cov_43.623558	1009	1075	32	2	66	0.0303030
NODE_498_length_3393_cov_43.623558	1009	1075	34	2	66	0.0303030
NODE_498_length_3393_cov_43.623558	1009	1075	38	1	66	0.0151515
NODE_498_length_3393_cov_43.623558	1009	1075	40	1	66	0.0151515
NODE_498_length_3393_cov_43.623558	1009	1075	42	7	66	0.1060606
NODE_498_length_3393_cov_43.623558	1009	1075	44	1	66	0.0151515
NODE_498_length_3393_cov_43.623558	1009	1075	51	2	66	0.0303030
NODE_498_length_3393_cov_43.623558	1009	1075	53	1	66	0.0151515
NODE_498_length_3393_cov_43.623558	1009	1075	55	1	66	0.0151515
NODE_498_length_3393_cov_43.623558	1009	1075	57	1	66	0.0151515
NODE_498_length_3393_cov_43.623558	1009	1075	61	5	66	0.0757576
NODE_498_length_3393_cov_43.623558	1009	1075	62	1	66	0.0151515
NODE_498_length_3393_cov_43.623558	1009	1075	68	2	66	0.0303030
NODE_498_length_3393_cov_43.623558	1009	1075	70	1	66	0.0151515
NODE_498_length_3393_cov_43.623558	1009	1075	74	1	66	0.0151515
NODE_498_length_3393_cov_43.623558	1009	1075	82	1	66	0.0151515
NODE_498_length_3393_cov_43.623558	1009	1075	84	2	66	0.0303030
NODE_498_length_3393_cov_43.623558	1009	1075	86	1	66	0.0151515
NODE_498_length_3393_cov_43.623558	1009	1075	92	1	66	0.0151515
NODE_498_length_3393_cov_43.623558	1009	1075	105	1	66	0.0151515
NODE_498_length_3393_cov_43.623558	1009	1075	110	1	66	0.0151515
NODE_498_length_3393_cov_43.623558	1009	1075	112	1	66	0.0151515
NODE_498_length_3393_cov_43.623558	1009	1075	114	1	66	0.0151515
NODE_498_length_3393_cov_43.623558	1009	1075	118	3	66	0.0454545
NODE_498_length_3393_cov_43.623558	1009	1075	120	4	66	0.0606061
NODE_498_length_3393_cov_43.623558	1009	1075	121	1	66	0.0151515
NODE_498_length_3393_cov_43.623558	1009	1075	123	1	66	0.0151515
NODE_498_length_3393_cov_43.623558	1009	1075	129	3	66	0.0454545
NODE_498_length_3393_cov_43.623558	1009	1075	133	1	66	0.0151515
NODE_498_length_3393_cov_43.623558	1009	1075	135	1	66	0.0151515
NODE_498_length_3393_cov_43.623558	1009	1075	137	2	66	0.0303030
NODE_498_length_3393_cov_43.623558	1009	1075	141	5	66	0.0757576
NODE_498_length_3393_cov_43.623558	1009	1075	145	1	66	0.0151515
NODE_498_length_3393_cov_43.623558	1048	1128	11	2	80	0.0250000
NODE_498_length_3393_cov_43.623558	1048	1128	13	2	80	0.0250000
NODE_498_length_3393_cov_43.623558	1048	1128	21	2	80	0.0250000
NODE_498_length_3393_cov_43.623558	1048	1128	24	28	80	0.3500000
NODE_498_length_3393_cov_43.623558	1048	1128	25	5	80	0.0625000
NODE_498_length_3393_cov_43.623558	1048	1128	26	16	80	0.2000000
NODE_498_length_3393_cov_43.623558	1048	1128	28	4	80	0.0500000
NODE_498_length_3393_cov_43.623558	1048	1128	32	2	80	0.0250000
NODE_498_length_3393_cov_43.623558	1048	1128	34	2	80	0.0250000
NODE_498_length_3393_cov_43.623558	1048	1128	38	1	80	0.0125000
NODE_498_length_3393_cov_43.623558	1048	1128	40	1	80	0.0125000
NODE_498_length_3393_cov_43.623558	1048	1128	42	7	80	0.0875000
NODE_498_length_3393_cov_43.623558	1048	1128	44	1	80	0.0125000
NODE_498_length_3393_cov_43.623558	1048	1128	51	2	80	0.0250000
NODE_498_length_3393_cov_43.623558	1048	1128	53	1	80	0.0125000
NODE_498_length_3393_cov_43.623558	1048	1128	55	1	80	0.0125000
NODE_498_length_3393_cov_43.623558	1048	1128	57	1	80	0.0125000
NODE_498_length_3393_cov_43.623558	1048	1128	61	2	80	0.0250000
NODE_498_length_3393_cov_43.623558	3086	3128	10	1	42	0.0238095
NODE_498_length_3393_cov_43.623558	3086	3128	29	1	42	0.0238095
NODE_498_length_3393_cov_43.623558	3086	3128	31	1	42	0.0238095
NODE_498_length_3393_cov_43.623558	3086	3128	53	2	42	0.0476190
NODE_498_length_3393_cov_43.623558	3086	3128	67	1	42	0.0238095
NODE_498_length_3393_cov_43.623558	3086	3128	71	1	42	0.0238095
NODE_498_length_3393_cov_43.623558	3086	3128	76	1	42	0.0238095
NODE_498_length_3393_cov_43.623558	3086	3128	80	1	42	0.0238095
NODE_498_length_3393_cov_43.623558	3086	3128	86	1	42	0.0238095
NODE_498_length_3393_cov_43.623558	3086	3128	93	2	42	0.0476190
NODE_498_length_3393_cov_43.623558	3086	3128	95	3	42	0.0714286
NODE_498_length_3393_cov_43.623558	3086	3128	101	2	42	0.0476190
NODE_498_length_3393_cov_43.623558	3086	3128	105	2	42	0.0476190
NODE_498_length_3393_cov_43.623558	3086	3128	107	1	42	0.0238095
NODE_498_length_3393_cov_43.623558	3086	3128	111	1	42	0.0238095
NODE_498_length_3393_cov_43.623558	3086	3128	117	1	42	0.0238095
NODE_498_length_3393_cov_43.623558	3086	3128	123	1	42	0.0238095
NODE_498_length_3393_cov_43.623558	3086	3128	127	1	42	0.0238095
NODE_498_length_3393_cov_43.623558	3086	3128	135	1	42	0.0238095
NODE_498_length_3393_cov_43.623558	3086	3128	137	1	42	0.0238095
NODE_498_length_3393_cov_43.623558	3086	3128	155	1	42	0.0238095
NODE_498_length_3393_cov_43.623558	3086	3128	158	3	42	0.0714286
NODE_498_length_3393_cov_43.623558	3086	3128	161	1	42	0.0238095
NODE_498_length_3393_cov_43.623558	3086	3128	163	1	42	0.0238095
NODE_498_length_3393_cov_43.623558	3086	3128	166	1	42	0.0238095
NODE_498_length_3393_cov_43.623558	3086	3128	168	2	42	0.0476190
NODE_498_length_3393_cov_43.623558	3086	3128	176	2	42	0.0476190
NODE_498_length_3393_cov_43.623558	3086	3128	182	1	42	0.0238095
NODE_498_length_3393_cov_43.623558	3086	3128	187	1	42	0.0238095
NODE_498_length_3393_cov_43.623558	3086	3128	189	1	42	0.0238095
NODE_498_length_3393_cov_43.623558	3086	3128	191	1	42	0.0238095
NODE_498_length_3393_cov_43.623558	3086	3128	200	1	42	0.0238095
NODE_498_length_3393_cov_43.623558	3293	3373	94	2	80	0.0250000
NODE_498_length_3393_cov_43.623558	3293	3373	100	2	80	0.0250000
NODE_498_length_3393_cov_43.623558	3293	3373	108	1	80	0.0125000
NODE_498_length_3393_cov_43.623558	3293	3373	112	1	80	0.0125000
NODE_498_length_3393_cov_43.623558	3293	3373	119	2	80	0.0250000
NODE_498_length_3393_cov_43.623558	3293	3373	121	1	80	0.0125000
NODE_498_length_3393_cov_43.623558	3293	3373	127	1	80	0.0125000
NODE_498_length_3393_cov_43.623558	3293	3373	134	2	80	0.0250000
NODE_498_length_3393_cov_43.623558	3293	3373	152	1	80	0.0125000
NODE_498_length_3393_cov_43.623558	3293	3373	154	1	80	0.0125000
NODE_498_length_3393_cov_43.623558	3293	3373	168	1	80	0.0125000
NODE_498_length_3393_cov_43.623558	3293	3373	174	1	80	0.0125000
NODE_498_length_3393_cov_43.623558	3293	3373	192	1	80	0.0125000
NODE_498_length_3393_cov_43.623558	3293	3373	200	1	80	0.0125000
NODE_498_length_3393_cov_43.623558	3293	3373	206	1	80	0.0125000
NODE_498_length_3393_cov_43.623558	3293	3373	210	1	80	0.0125000
NODE_498_length_3393_cov_43.623558	3293	3373	217	1	80	0.0125000
NODE_498_length_3393_cov_43.623558	3293	3373	233	1	80	0.0125000
NODE_498_length_3393_cov_43.623558	3293	3373	239	2	80	0.0250000
NODE_498_length_3393_cov_43.623558	3293	3373	245	1	80	0.0125000
NODE_498_length_3393_cov_43.623558	3293	3373	270	1	80	0.0125000
NODE_498_length_3393_cov_43.623558	3293	3373	272	1	80	0.0125000
NODE_498_length_3393_cov_43.623558	3293	3373	277	1	80	0.0125000
NODE_498_length_3393_cov_43.623558	3293	3373	279	1	80	0.0125000
NODE_498_length_3393_cov_43.623558	3293	3373	283	1	80	0.0125000
NODE_498_length_3393_cov_43.623558	3293	3373	284	1	80	0.0125000
NODE_498_length_3393_cov_43.623558	3293	3373	285	1	80	0.0125000
NODE_498_length_3393_cov_43.623558	3293	3373	287	1	80	0.0125000
NODE_498_length_3393_cov_43.623558	3293	3373	290	1	80	0.0125000
NODE_498_length_3393_cov_43.623558	3293	3373	292	1	80	0.0125000
NODE_498_length_3393_cov_43.623558	3293	3373	304	1	80	0.0125000
NODE_498_length_3393_cov_43.623558	3293	3373	314	1	80	0.0125000
NODE_498_length_3393_cov_43.623558	3293	3373	316	1	80	0.0125000
NODE_498_length_3393_cov_43.623558	3293	3373	320	2	80	0.0250000
NODE_498_length_3393_cov_43.623558	3293	3373	322	4	80	0.0500000
NODE_498_length_3393_cov_43.623558	3293	3373	324	3	80	0.0375000
NODE_498_length_3393_cov_43.623558	3293	3373	326	1	80	0.0125000
NODE_498_length_3393_cov_43.623558	3293	3373	328	1	80	0.0125000
NODE_498_length_3393_cov_43.623558	3293	3373	329	3	80	0.0375000
NODE_498_length_3393_cov_43.623558	3293	3373	331	1	80	0.0125000
NODE_498_length_3393_cov_43.623558	3293	3373	333	1	80	0.0125000
NODE_498_length_3393_cov_43.623558	3293	3373	339	1	80	0.0125000
NODE_498_length_3393_cov_43.623558	3293	3373	341	1	80	0.0125000
NODE_498_length_3393_cov_43.623558	3293	3373	343	2	80	0.0250000
NODE_498_length_3393_cov_43.623558	3293	3373	350	1	80	0.0125000
NODE_498_length_3393_cov_43.623558	3293	3373	354	1	80	0.0125000
NODE_498_length_3393_cov_43.623558	3293	3373	359	1	80	0.0125000
NODE_498_length_3393_cov_43.623558	3293	3373	361	2	80	0.0250000
NODE_498_length_3393_cov_43.623558	3293	3373	364	1	80	0.0125000
NODE_498_length_3393_cov_43.623558	3293	3373	365	2	80	0.0250000
NODE_498_length_3393_cov_43.623558	3293	3373	368	2	80	0.0250000
NODE_498_length_3393_cov_43.623558	3293	3373	369	1	80	0.0125000
NODE_498_length_3393_cov_43.623558	3293	3373	373	1	80	0.0125000
NODE_498_length_3393_cov_43.623558	3293	3373	375	1	80	0.0125000
NODE_498_length_3393_cov_43.623558	3293	3373	377	1	80	0.0125000
NODE_498_length_3393_cov_43.623558	3293	3373	378	1	80	0.0125000
NODE_498_length_3393_cov_43.623558	3293	3373	379	1	80	0.0125000
NODE_498_length_3393_cov_43.623558	3293	3373	381	1	80	0.0125000
NODE_498_length_3393_cov_43.623558	3293	3373	391	2	80	0.0250000
NODE_498_length_3393_cov_43.623558	3293	3373	396	3	80	0.0375000
NODE_499_length_3392_cov_41.514728	255	335	0	80	80	1.0000000
NODE_499_length_3392_cov_41.514728	308	388	0	80	80	1.0000000
NODE_499_length_3392_cov_41.514728	917	997	146	3	80	0.0375000
NODE_499_length_3392_cov_41.514728	917	997	154	1	80	0.0125000
NODE_499_length_3392_cov_41.514728	917	997	155	1	80	0.0125000
NODE_499_length_3392_cov_41.514728	917	997	161	4	80	0.0500000
NODE_499_length_3392_cov_41.514728	917	997	162	1	80	0.0125000
NODE_499_length_3392_cov_41.514728	917	997	169	1	80	0.0125000
NODE_499_length_3392_cov_41.514728	917	997	175	1	80	0.0125000
NODE_499_length_3392_cov_41.514728	917	997	176	1	80	0.0125000
NODE_499_length_3392_cov_41.514728	917	997	177	1	80	0.0125000
NODE_499_length_3392_cov_41.514728	917	997	183	1	80	0.0125000
NODE_499_length_3392_cov_41.514728	917	997	191	1	80	0.0125000
NODE_499_length_3392_cov_41.514728	917	997	198	1	80	0.0125000
NODE_499_length_3392_cov_41.514728	917	997	202	1	80	0.0125000
NODE_499_length_3392_cov_41.514728	917	997	214	1	80	0.0125000
NODE_499_length_3392_cov_41.514728	917	997	220	1	80	0.0125000
NODE_499_length_3392_cov_41.514728	917	997	224	1	80	0.0125000
NODE_499_length_3392_cov_41.514728	917	997	227	2	80	0.0250000
NODE_499_length_3392_cov_41.514728	917	997	229	1	80	0.0125000
NODE_499_length_3392_cov_41.514728	917	997	232	1	80	0.0125000
NODE_499_length_3392_cov_41.514728	917	997	236	1	80	0.0125000
NODE_499_length_3392_cov_41.514728	917	997	241	1	80	0.0125000
NODE_499_length_3392_cov_41.514728	917	997	243	2	80	0.0250000
NODE_499_length_3392_cov_41.514728	917	997	246	1	80	0.0125000
NODE_499_length_3392_cov_41.514728	917	997	247	2	80	0.0250000
NODE_499_length_3392_cov_41.514728	917	997	250	2	80	0.0250000
NODE_499_length_3392_cov_41.514728	917	997	252	2	80	0.0250000
NODE_499_length_3392_cov_41.514728	917	997	254	1	80	0.0125000
NODE_499_length_3392_cov_41.514728	917	997	260	1	80	0.0125000
NODE_499_length_3392_cov_41.514728	917	997	262	1	80	0.0125000
NODE_499_length_3392_cov_41.514728	917	997	272	1	80	0.0125000
NODE_499_length_3392_cov_41.514728	917	997	281	1	80	0.0125000
NODE_499_length_3392_cov_41.514728	917	997	282	1	80	0.0125000
NODE_499_length_3392_cov_41.514728	917	997	283	1	80	0.0125000
NODE_499_length_3392_cov_41.514728	917	997	285	2	80	0.0250000
NODE_499_length_3392_cov_41.514728	917	997	289	1	80	0.0125000
NODE_499_length_3392_cov_41.514728	917	997	292	1	80	0.0125000
NODE_499_length_3392_cov_41.514728	917	997	295	1	80	0.0125000
NODE_499_length_3392_cov_41.514728	917	997	299	1	80	0.0125000
NODE_499_length_3392_cov_41.514728	917	997	308	1	80	0.0125000
NODE_499_length_3392_cov_41.514728	917	997	310	3	80	0.0375000
NODE_499_length_3392_cov_41.514728	917	997	316	2	80	0.0250000
NODE_499_length_3392_cov_41.514728	917	997	320	1	80	0.0125000
NODE_499_length_3392_cov_41.514728	917	997	323	2	80	0.0250000
NODE_499_length_3392_cov_41.514728	917	997	325	1	80	0.0125000
NODE_499_length_3392_cov_41.514728	917	997	329	1	80	0.0125000
NODE_499_length_3392_cov_41.514728	917	997	339	1	80	0.0125000
NODE_499_length_3392_cov_41.514728	917	997	347	1	80	0.0125000
NODE_499_length_3392_cov_41.514728	917	997	350	1	80	0.0125000
NODE_499_length_3392_cov_41.514728	917	997	361	2	80	0.0250000
NODE_499_length_3392_cov_41.514728	917	997	362	1	80	0.0125000
NODE_499_length_3392_cov_41.514728	917	997	363	3	80	0.0375000
NODE_499_length_3392_cov_41.514728	917	997	364	3	80	0.0375000
NODE_499_length_3392_cov_41.514728	917	997	365	1	80	0.0125000
NODE_499_length_3392_cov_41.514728	917	997	366	1	80	0.0125000
NODE_499_length_3392_cov_41.514728	917	997	367	2	80	0.0250000
NODE_499_length_3392_cov_41.514728	917	997	368	1	80	0.0125000
NODE_499_length_3392_cov_41.514728	917	997	369	2	80	0.0250000
NODE_499_length_3392_cov_41.514728	917	997	371	1	80	0.0125000
NODE_499_length_3392_cov_41.514728	970	1053	105	2	83	0.0240964
NODE_499_length_3392_cov_41.514728	970	1053	106	2	83	0.0240964
NODE_499_length_3392_cov_41.514728	970	1053	107	1	83	0.0120482
NODE_499_length_3392_cov_41.514728	970	1053	108	1	83	0.0120482
NODE_499_length_3392_cov_41.514728	970	1053	109	1	83	0.0120482
NODE_499_length_3392_cov_41.514728	970	1053	110	1	83	0.0120482
NODE_499_length_3392_cov_41.514728	970	1053	111	2	83	0.0240964
NODE_499_length_3392_cov_41.514728	970	1053	112	5	83	0.0602410
NODE_499_length_3392_cov_41.514728	970	1053	113	4	83	0.0481928
NODE_499_length_3392_cov_41.514728	970	1053	114	1	83	0.0120482
NODE_499_length_3392_cov_41.514728	970	1053	115	1	83	0.0120482
NODE_499_length_3392_cov_41.514728	970	1053	116	2	83	0.0240964
NODE_499_length_3392_cov_41.514728	970	1053	118	1	83	0.0120482
NODE_499_length_3392_cov_41.514728	970	1053	119	3	83	0.0361446
NODE_499_length_3392_cov_41.514728	970	1053	120	4	83	0.0481928
NODE_499_length_3392_cov_41.514728	970	1053	121	2	83	0.0240964
NODE_499_length_3392_cov_41.514728	970	1053	122	3	83	0.0361446
NODE_499_length_3392_cov_41.514728	970	1053	123	1	83	0.0120482
NODE_499_length_3392_cov_41.514728	970	1053	124	2	83	0.0240964
NODE_499_length_3392_cov_41.514728	970	1053	126	1	83	0.0120482
NODE_499_length_3392_cov_41.514728	970	1053	127	1	83	0.0120482
NODE_499_length_3392_cov_41.514728	970	1053	129	1	83	0.0120482
NODE_499_length_3392_cov_41.514728	970	1053	131	2	83	0.0240964
NODE_499_length_3392_cov_41.514728	970	1053	135	2	83	0.0240964
NODE_499_length_3392_cov_41.514728	970	1053	143	3	83	0.0361446
NODE_499_length_3392_cov_41.514728	970	1053	144	1	83	0.0120482
NODE_499_length_3392_cov_41.514728	970	1053	146	6	83	0.0722892
NODE_499_length_3392_cov_41.514728	970	1053	147	1	83	0.0120482
NODE_499_length_3392_cov_41.514728	970	1053	148	2	83	0.0240964
NODE_499_length_3392_cov_41.514728	970	1053	154	1	83	0.0120482
NODE_499_length_3392_cov_41.514728	970	1053	155	1	83	0.0120482
NODE_499_length_3392_cov_41.514728	970	1053	161	4	83	0.0481928
NODE_499_length_3392_cov_41.514728	970	1053	162	1	83	0.0120482
NODE_499_length_3392_cov_41.514728	970	1053	169	1	83	0.0120482
NODE_499_length_3392_cov_41.514728	970	1053	175	1	83	0.0120482
NODE_499_length_3392_cov_41.514728	970	1053	176	1	83	0.0120482
NODE_499_length_3392_cov_41.514728	970	1053	177	1	83	0.0120482
NODE_499_length_3392_cov_41.514728	970	1053	183	1	83	0.0120482
NODE_499_length_3392_cov_41.514728	970	1053	191	1	83	0.0120482
NODE_499_length_3392_cov_41.514728	970	1053	198	1	83	0.0120482
NODE_499_length_3392_cov_41.514728	970	1053	202	1	83	0.0120482
NODE_499_length_3392_cov_41.514728	970	1053	214	1	83	0.0120482
NODE_499_length_3392_cov_41.514728	970	1053	220	1	83	0.0120482
NODE_499_length_3392_cov_41.514728	970	1053	224	1	83	0.0120482
NODE_499_length_3392_cov_41.514728	970	1053	227	2	83	0.0240964
NODE_499_length_3392_cov_41.514728	970	1053	229	1	83	0.0120482
NODE_499_length_3392_cov_41.514728	970	1053	232	1	83	0.0120482
NODE_499_length_3392_cov_41.514728	970	1053	236	1	83	0.0120482
NODE_499_length_3392_cov_41.514728	970	1053	241	1	83	0.0120482
NODE_501_length_3389_cov_8.244073	2159	2239	0	80	80	1.0000000
NODE_501_length_3389_cov_8.244073	2212	2292	0	34	80	0.4250000
NODE_501_length_3389_cov_8.244073	2212	2292	2	46	80	0.5750000
NODE_506_length_3363_cov_4.412684	56	124	16	3	68	0.0441176
NODE_506_length_3363_cov_4.412684	56	124	22	1	68	0.0147059
NODE_506_length_3363_cov_4.412684	56	124	24	1	68	0.0147059
NODE_506_length_3363_cov_4.412684	56	124	27	1	68	0.0147059
NODE_506_length_3363_cov_4.412684	56	124	30	4	68	0.0588235
NODE_506_length_3363_cov_4.412684	56	124	38	1	68	0.0147059
NODE_506_length_3363_cov_4.412684	56	124	40	1	68	0.0147059
NODE_506_length_3363_cov_4.412684	56	124	42	7	68	0.1029412
NODE_506_length_3363_cov_4.412684	56	124	44	49	68	0.7205882
NODE_510_length_3353_cov_2.687462	0	61	0	61	61	1.0000000
NODE_510_length_3353_cov_2.687462	0	61	0	61	61	1.0000000
NODE_510_length_3353_cov_2.687462	34	99	0	65	65	1.0000000
NODE_513_length_3348_cov_243.959372	2473	2553	371	2	80	0.0250000
NODE_513_length_3348_cov_243.959372	2473	2553	374	1	80	0.0125000
NODE_513_length_3348_cov_243.959372	2473	2553	375	2	80	0.0250000
NODE_513_length_3348_cov_243.959372	2473	2553	377	1	80	0.0125000
NODE_513_length_3348_cov_243.959372	2473	2553	379	2	80	0.0250000
NODE_513_length_3348_cov_243.959372	2473	2553	380	1	80	0.0125000
NODE_513_length_3348_cov_243.959372	2473	2553	389	2	80	0.0250000
NODE_513_length_3348_cov_243.959372	2473	2553	390	1	80	0.0125000
NODE_513_length_3348_cov_243.959372	2473	2553	392	1	80	0.0125000
NODE_513_length_3348_cov_243.959372	2473	2553	396	3	80	0.0375000
NODE_513_length_3348_cov_243.959372	2473	2553	397	1	80	0.0125000
NODE_513_length_3348_cov_243.959372	2473	2553	398	1	80	0.0125000
NODE_513_length_3348_cov_243.959372	2473	2553	403	1	80	0.0125000
NODE_513_length_3348_cov_243.959372	2473	2553	404	1	80	0.0125000
NODE_513_length_3348_cov_243.959372	2473	2553	405	1	80	0.0125000
NODE_513_length_3348_cov_243.959372	2473	2553	406	1	80	0.0125000
NODE_513_length_3348_cov_243.959372	2473	2553	407	2	80	0.0250000
NODE_513_length_3348_cov_243.959372	2473	2553	408	1	80	0.0125000
NODE_513_length_3348_cov_243.959372	2473	2553	409	1	80	0.0125000
NODE_513_length_3348_cov_243.959372	2473	2553	412	2	80	0.0250000
NODE_513_length_3348_cov_243.959372	2473	2553	413	1	80	0.0125000
NODE_513_length_3348_cov_243.959372	2473	2553	414	1	80	0.0125000
NODE_513_length_3348_cov_243.959372	2473	2553	415	2	80	0.0250000
NODE_513_length_3348_cov_243.959372	2473	2553	417	2	80	0.0250000
NODE_513_length_3348_cov_243.959372	2473	2553	419	1	80	0.0125000
NODE_513_length_3348_cov_243.959372	2473	2553	420	1	80	0.0125000
NODE_513_length_3348_cov_243.959372	2473	2553	421	1	80	0.0125000
NODE_513_length_3348_cov_243.959372	2473	2553	423	1	80	0.0125000
NODE_513_length_3348_cov_243.959372	2473	2553	424	2	80	0.0250000
NODE_513_length_3348_cov_243.959372	2473	2553	426	2	80	0.0250000
NODE_513_length_3348_cov_243.959372	2473	2553	428	1	80	0.0125000
NODE_513_length_3348_cov_243.959372	2473	2553	429	1	80	0.0125000
NODE_513_length_3348_cov_243.959372	2473	2553	430	1	80	0.0125000
NODE_513_length_3348_cov_243.959372	2473	2553	431	1	80	0.0125000
NODE_513_length_3348_cov_243.959372	2473	2553	434	1	80	0.0125000
NODE_513_length_3348_cov_243.959372	2473	2553	438	1	80	0.0125000
NODE_513_length_3348_cov_243.959372	2473	2553	440	1	80	0.0125000
NODE_513_length_3348_cov_243.959372	2473	2553	441	1	80	0.0125000
NODE_513_length_3348_cov_243.959372	2473	2553	443	1	80	0.0125000
NODE_513_length_3348_cov_243.959372	2473	2553	445	1	80	0.0125000
NODE_513_length_3348_cov_243.959372	2473	2553	448	4	80	0.0500000
NODE_513_length_3348_cov_243.959372	2473	2553	449	1	80	0.0125000
NODE_513_length_3348_cov_243.959372	2473	2553	452	1	80	0.0125000
NODE_513_length_3348_cov_243.959372	2473	2553	453	2	80	0.0250000
NODE_513_length_3348_cov_243.959372	2473	2553	454	3	80	0.0375000
NODE_513_length_3348_cov_243.959372	2473	2553	455	2	80	0.0250000
NODE_513_length_3348_cov_243.959372	2473	2553	456	1	80	0.0125000
NODE_513_length_3348_cov_243.959372	2473	2553	457	1	80	0.0125000
NODE_513_length_3348_cov_243.959372	2473	2553	461	1	80	0.0125000
NODE_513_length_3348_cov_243.959372	2473	2553	463	1	80	0.0125000
NODE_513_length_3348_cov_243.959372	2473	2553	471	1	80	0.0125000
NODE_513_length_3348_cov_243.959372	2473	2553	473	1	80	0.0125000
NODE_513_length_3348_cov_243.959372	2473	2553	475	1	80	0.0125000
NODE_513_length_3348_cov_243.959372	2473	2553	479	1	80	0.0125000
NODE_513_length_3348_cov_243.959372	2473	2553	483	1	80	0.0125000
NODE_513_length_3348_cov_243.959372	2473	2553	484	1	80	0.0125000
NODE_513_length_3348_cov_243.959372	2473	2553	486	1	80	0.0125000
NODE_513_length_3348_cov_243.959372	2473	2553	488	2	80	0.0250000
NODE_513_length_3348_cov_243.959372	2473	2553	489	1	80	0.0125000
NODE_513_length_3348_cov_243.959372	2473	2553	490	1	80	0.0125000
NODE_513_length_3348_cov_243.959372	2526	2606	371	1	80	0.0125000
NODE_513_length_3348_cov_243.959372	2526	2606	374	1	80	0.0125000
NODE_513_length_3348_cov_243.959372	2526	2606	375	1	80	0.0125000
NODE_513_length_3348_cov_243.959372	2526	2606	380	1	80	0.0125000
NODE_513_length_3348_cov_243.959372	2526	2606	389	1	80	0.0125000
NODE_513_length_3348_cov_243.959372	2526	2606	396	3	80	0.0375000
NODE_513_length_3348_cov_243.959372	2526	2606	405	1	80	0.0125000
NODE_513_length_3348_cov_243.959372	2526	2606	406	1	80	0.0125000
NODE_513_length_3348_cov_243.959372	2526	2606	407	1	80	0.0125000
NODE_513_length_3348_cov_243.959372	2526	2606	409	1	80	0.0125000
NODE_513_length_3348_cov_243.959372	2526	2606	413	2	80	0.0250000
NODE_513_length_3348_cov_243.959372	2526	2606	415	1	80	0.0125000
NODE_513_length_3348_cov_243.959372	2526	2606	417	1	80	0.0125000
NODE_513_length_3348_cov_243.959372	2526	2606	418	2	80	0.0250000
NODE_513_length_3348_cov_243.959372	2526	2606	419	2	80	0.0250000
NODE_513_length_3348_cov_243.959372	2526	2606	421	1	80	0.0125000
NODE_513_length_3348_cov_243.959372	2526	2606	423	2	80	0.0250000
NODE_513_length_3348_cov_243.959372	2526	2606	424	1	80	0.0125000
NODE_513_length_3348_cov_243.959372	2526	2606	426	1	80	0.0125000
NODE_513_length_3348_cov_243.959372	2526	2606	429	1	80	0.0125000
NODE_513_length_3348_cov_243.959372	2526	2606	430	1	80	0.0125000
NODE_513_length_3348_cov_243.959372	2526	2606	431	1	80	0.0125000
NODE_513_length_3348_cov_243.959372	2526	2606	434	1	80	0.0125000
NODE_513_length_3348_cov_243.959372	2526	2606	438	1	80	0.0125000
NODE_513_length_3348_cov_243.959372	2526	2606	440	1	80	0.0125000
NODE_513_length_3348_cov_243.959372	2526	2606	441	1	80	0.0125000
NODE_513_length_3348_cov_243.959372	2526	2606	443	3	80	0.0375000
NODE_513_length_3348_cov_243.959372	2526	2606	444	1	80	0.0125000
NODE_513_length_3348_cov_243.959372	2526	2606	445	5	80	0.0625000
NODE_513_length_3348_cov_243.959372	2526	2606	446	3	80	0.0375000
NODE_513_length_3348_cov_243.959372	2526	2606	447	1	80	0.0125000
NODE_513_length_3348_cov_243.959372	2526	2606	448	1	80	0.0125000
NODE_513_length_3348_cov_243.959372	2526	2606	451	1	80	0.0125000
NODE_513_length_3348_cov_243.959372	2526	2606	453	1	80	0.0125000
NODE_513_length_3348_cov_243.959372	2526	2606	455	2	80	0.0250000
NODE_513_length_3348_cov_243.959372	2526	2606	456	1	80	0.0125000
NODE_513_length_3348_cov_243.959372	2526	2606	457	1	80	0.0125000
NODE_513_length_3348_cov_243.959372	2526	2606	458	1	80	0.0125000
NODE_513_length_3348_cov_243.959372	2526	2606	462	2	80	0.0250000
NODE_513_length_3348_cov_243.959372	2526	2606	464	2	80	0.0250000
NODE_513_length_3348_cov_243.959372	2526	2606	469	3	80	0.0375000
NODE_513_length_3348_cov_243.959372	2526	2606	470	2	80	0.0250000
NODE_513_length_3348_cov_243.959372	2526	2606	471	3	80	0.0375000
NODE_513_length_3348_cov_243.959372	2526	2606	472	2	80	0.0250000
NODE_513_length_3348_cov_243.959372	2526	2606	473	5	80	0.0625000
NODE_513_length_3348_cov_243.959372	2526	2606	474	2	80	0.0250000
NODE_513_length_3348_cov_243.959372	2526	2606	475	2	80	0.0250000
NODE_513_length_3348_cov_243.959372	2526	2606	476	1	80	0.0125000
NODE_513_length_3348_cov_243.959372	2526	2606	477	1	80	0.0125000
NODE_513_length_3348_cov_243.959372	2526	2606	478	2	80	0.0250000
NODE_514_length_3348_cov_31.953216	103	183	2	17	80	0.2125000
NODE_514_length_3348_cov_31.953216	103	183	8	6	80	0.0750000
NODE_514_length_3348_cov_31.953216	103	183	10	5	80	0.0625000
NODE_514_length_3348_cov_31.953216	103	183	12	1	80	0.0125000
NODE_514_length_3348_cov_31.953216	103	183	14	14	80	0.1750000
NODE_514_length_3348_cov_31.953216	103	183	15	3	80	0.0375000
NODE_514_length_3348_cov_31.953216	103	183	16	9	80	0.1125000
NODE_514_length_3348_cov_31.953216	103	183	17	1	80	0.0125000
NODE_514_length_3348_cov_31.953216	103	183	18	24	80	0.3000000
NODE_514_length_3348_cov_31.953216	105	179	2	15	74	0.2027027
NODE_514_length_3348_cov_31.953216	105	179	8	6	74	0.0810811
NODE_514_length_3348_cov_31.953216	105	179	10	5	74	0.0675676
NODE_514_length_3348_cov_31.953216	105	179	12	1	74	0.0135135
NODE_514_length_3348_cov_31.953216	105	179	14	14	74	0.1891892
NODE_514_length_3348_cov_31.953216	105	179	15	3	74	0.0405405
NODE_514_length_3348_cov_31.953216	105	179	16	9	74	0.1216216
NODE_514_length_3348_cov_31.953216	105	179	18	21	74	0.2837838
NODE_514_length_3348_cov_31.953216	156	236	12	4	80	0.0500000
NODE_514_length_3348_cov_31.953216	156	236	14	5	80	0.0625000
NODE_514_length_3348_cov_31.953216	156	236	16	30	80	0.3750000
NODE_514_length_3348_cov_31.953216	156	236	17	13	80	0.1625000
NODE_514_length_3348_cov_31.953216	156	236	18	28	80	0.3500000
NODE_514_length_3348_cov_31.953216	156	236	12	4	80	0.0500000
NODE_514_length_3348_cov_31.953216	156	236	14	5	80	0.0625000
NODE_514_length_3348_cov_31.953216	156	236	16	30	80	0.3750000
NODE_514_length_3348_cov_31.953216	156	236	17	13	80	0.1625000
NODE_514_length_3348_cov_31.953216	156	236	18	28	80	0.3500000
NODE_514_length_3348_cov_31.953216	2405	2476	78	1	71	0.0140845
NODE_514_length_3348_cov_31.953216	2405	2476	79	2	71	0.0281690
NODE_514_length_3348_cov_31.953216	2405	2476	80	1	71	0.0140845
NODE_514_length_3348_cov_31.953216	2405	2476	81	4	71	0.0563380
NODE_514_length_3348_cov_31.953216	2405	2476	84	3	71	0.0422535
NODE_514_length_3348_cov_31.953216	2405	2476	85	2	71	0.0281690
NODE_514_length_3348_cov_31.953216	2405	2476	86	2	71	0.0281690
NODE_514_length_3348_cov_31.953216	2405	2476	87	1	71	0.0140845
NODE_514_length_3348_cov_31.953216	2405	2476	88	1	71	0.0140845
NODE_514_length_3348_cov_31.953216	2405	2476	90	2	71	0.0281690
NODE_514_length_3348_cov_31.953216	2405	2476	94	1	71	0.0140845
NODE_514_length_3348_cov_31.953216	2405	2476	96	1	71	0.0140845
NODE_514_length_3348_cov_31.953216	2405	2476	102	1	71	0.0140845
NODE_514_length_3348_cov_31.953216	2405	2476	106	1	71	0.0140845
NODE_514_length_3348_cov_31.953216	2405	2476	110	2	71	0.0281690
NODE_514_length_3348_cov_31.953216	2405	2476	112	1	71	0.0140845
NODE_514_length_3348_cov_31.953216	2405	2476	117	1	71	0.0140845
NODE_514_length_3348_cov_31.953216	2405	2476	119	3	71	0.0422535
NODE_514_length_3348_cov_31.953216	2405	2476	127	4	71	0.0563380
NODE_514_length_3348_cov_31.953216	2405	2476	129	1	71	0.0140845
NODE_514_length_3348_cov_31.953216	2405	2476	132	1	71	0.0140845
NODE_514_length_3348_cov_31.953216	2405	2476	134	1	71	0.0140845
NODE_514_length_3348_cov_31.953216	2405	2476	135	1	71	0.0140845
NODE_514_length_3348_cov_31.953216	2405	2476	136	2	71	0.0281690
NODE_514_length_3348_cov_31.953216	2405	2476	137	1	71	0.0140845
NODE_514_length_3348_cov_31.953216	2405	2476	138	5	71	0.0704225
NODE_514_length_3348_cov_31.953216	2405	2476	139	1	71	0.0140845
NODE_514_length_3348_cov_31.953216	2405	2476	140	2	71	0.0281690
NODE_514_length_3348_cov_31.953216	2405	2476	144	1	71	0.0140845
NODE_514_length_3348_cov_31.953216	2405	2476	146	1	71	0.0140845
NODE_514_length_3348_cov_31.953216	2405	2476	151	1	71	0.0140845
NODE_514_length_3348_cov_31.953216	2405	2476	154	3	71	0.0422535
NODE_514_length_3348_cov_31.953216	2405	2476	155	2	71	0.0281690
NODE_514_length_3348_cov_31.953216	2405	2476	156	3	71	0.0422535
NODE_514_length_3348_cov_31.953216	2405	2476	157	4	71	0.0563380
NODE_514_length_3348_cov_31.953216	2405	2476	163	1	71	0.0140845
NODE_514_length_3348_cov_31.953216	2405	2476	173	1	71	0.0140845
NODE_514_length_3348_cov_31.953216	2405	2476	178	1	71	0.0140845
NODE_514_length_3348_cov_31.953216	2405	2476	180	1	71	0.0140845
NODE_514_length_3348_cov_31.953216	2405	2476	182	1	71	0.0140845
NODE_514_length_3348_cov_31.953216	2405	2476	184	1	71	0.0140845
NODE_514_length_3348_cov_31.953216	2405	2476	188	1	71	0.0140845
NODE_514_length_3348_cov_31.953216	2458	2529	154	3	71	0.0422535
NODE_514_length_3348_cov_31.953216	2458	2529	155	2	71	0.0281690
NODE_514_length_3348_cov_31.953216	2458	2529	156	3	71	0.0422535
NODE_514_length_3348_cov_31.953216	2458	2529	157	3	71	0.0422535
NODE_514_length_3348_cov_31.953216	2458	2529	163	1	71	0.0140845
NODE_514_length_3348_cov_31.953216	2458	2529	173	1	71	0.0140845
NODE_514_length_3348_cov_31.953216	2458	2529	178	1	71	0.0140845
NODE_514_length_3348_cov_31.953216	2458	2529	180	1	71	0.0140845
NODE_514_length_3348_cov_31.953216	2458	2529	182	1	71	0.0140845
NODE_514_length_3348_cov_31.953216	2458	2529	184	1	71	0.0140845
NODE_514_length_3348_cov_31.953216	2458	2529	188	2	71	0.0281690
NODE_514_length_3348_cov_31.953216	2458	2529	190	6	71	0.0845070
NODE_514_length_3348_cov_31.953216	2458	2529	192	1	71	0.0140845
NODE_514_length_3348_cov_31.953216	2458	2529	194	1	71	0.0140845
NODE_514_length_3348_cov_31.953216	2458	2529	200	1	71	0.0140845
NODE_514_length_3348_cov_31.953216	2458	2529	202	1	71	0.0140845
NODE_514_length_3348_cov_31.953216	2458	2529	203	2	71	0.0281690
NODE_514_length_3348_cov_31.953216	2458	2529	204	1	71	0.0140845
NODE_514_length_3348_cov_31.953216	2458	2529	205	2	71	0.0281690
NODE_514_length_3348_cov_31.953216	2458	2529	206	1	71	0.0140845
NODE_514_length_3348_cov_31.953216	2458	2529	207	1	71	0.0140845
NODE_514_length_3348_cov_31.953216	2458	2529	208	1	71	0.0140845
NODE_514_length_3348_cov_31.953216	2458	2529	219	1	71	0.0140845
NODE_514_length_3348_cov_31.953216	2458	2529	221	1	71	0.0140845
NODE_514_length_3348_cov_31.953216	2458	2529	223	1	71	0.0140845
NODE_514_length_3348_cov_31.953216	2458	2529	224	1	71	0.0140845
NODE_514_length_3348_cov_31.953216	2458	2529	225	5	71	0.0704225
NODE_514_length_3348_cov_31.953216	2458	2529	226	2	71	0.0281690
NODE_514_length_3348_cov_31.953216	2458	2529	227	2	71	0.0281690
NODE_514_length_3348_cov_31.953216	2458	2529	229	3	71	0.0422535
NODE_514_length_3348_cov_31.953216	2458	2529	231	2	71	0.0281690
NODE_514_length_3348_cov_31.953216	2458	2529	233	2	71	0.0281690
NODE_514_length_3348_cov_31.953216	2458	2529	235	1	71	0.0140845
NODE_514_length_3348_cov_31.953216	2458	2529	237	2	71	0.0281690
NODE_514_length_3348_cov_31.953216	2458	2529	238	2	71	0.0281690
NODE_514_length_3348_cov_31.953216	2458	2529	239	1	71	0.0140845
NODE_514_length_3348_cov_31.953216	2458	2529	240	3	71	0.0422535
NODE_514_length_3348_cov_31.953216	2458	2529	241	4	71	0.0563380
NODE_514_length_3348_cov_31.953216	2458	2529	242	1	71	0.0140845
NODE_517_length_3335_cov_19.649567	2100	2180	2	34	80	0.4250000
NODE_517_length_3335_cov_19.649567	2100	2180	4	46	80	0.5750000
NODE_517_length_3335_cov_19.649567	2153	2233	0	16	80	0.2000000
NODE_517_length_3335_cov_19.649567	2153	2233	2	28	80	0.3500000
NODE_517_length_3335_cov_19.649567	2153	2233	4	36	80	0.4500000
NODE_517_length_3335_cov_19.649567	2229	2309	0	37	80	0.4625000
NODE_517_length_3335_cov_19.649567	2229	2309	2	43	80	0.5375000
NODE_517_length_3335_cov_19.649567	2282	2362	2	80	80	1.0000000
NODE_518_length_3333_cov_24.805504	734	814	0	23	80	0.2875000
NODE_518_length_3333_cov_24.805504	734	814	6	57	80	0.7125000
NODE_518_length_3333_cov_24.805504	787	867	6	36	80	0.4500000
NODE_518_length_3333_cov_24.805504	787	867	8	42	80	0.5250000
NODE_518_length_3333_cov_24.805504	787	867	10	2	80	0.0250000
NODE_523_length_3312_cov_6.996576	85	165	0	10	80	0.1250000
NODE_523_length_3312_cov_6.996576	85	165	2	13	80	0.1625000
NODE_523_length_3312_cov_6.996576	85	165	4	57	80	0.7125000
NODE_523_length_3312_cov_6.996576	138	218	4	39	80	0.4875000
NODE_523_length_3312_cov_6.996576	138	218	10	3	80	0.0375000
NODE_523_length_3312_cov_6.996576	138	218	12	38	80	0.4750000
NODE_525_length_3302_cov_3.859195	3184	3262	2	3	78	0.0384615
NODE_525_length_3302_cov_3.859195	3184	3262	4	75	78	0.9615384
NODE_525_length_3302_cov_3.859195	3184	3253	4	69	69	1.0000000
NODE_526_length_3299_cov_6.014687	1632	1688	0	56	56	1.0000000
NODE_530_length_3290_cov_17.805390	773	853	0	20	80	0.2500000
NODE_530_length_3290_cov_17.805390	773	853	5	1	80	0.0125000
NODE_530_length_3290_cov_17.805390	773	853	6	3	80	0.0375000
NODE_530_length_3290_cov_17.805390	773	853	10	9	80	0.1125000
NODE_530_length_3290_cov_17.805390	773	853	14	47	80	0.5875000
NODE_530_length_3290_cov_17.805390	826	906	12	15	80	0.1875000
NODE_530_length_3290_cov_17.805390	826	906	14	65	80	0.8125000
NODE_531_length_3290_cov_12.352554	2749	2829	0	2	80	0.0250000
NODE_531_length_3290_cov_12.352554	2749	2829	2	78	80	0.9750000
NODE_531_length_3290_cov_12.352554	2802	2882	0	55	80	0.6875000
NODE_531_length_3290_cov_12.352554	2802	2882	2	25	80	0.3125000
NODE_532_length_3286_cov_5.973015	0	50	0	4	50	0.0800000
NODE_532_length_3286_cov_5.973015	0	50	2	46	50	0.9200000
NODE_532_length_3286_cov_5.973015	0	50	0	4	50	0.0800000
NODE_532_length_3286_cov_5.973015	0	50	2	46	50	0.9200000
NODE_532_length_3286_cov_5.973015	0	50	0	4	50	0.0800000
NODE_532_length_3286_cov_5.973015	0	50	2	46	50	0.9200000
NODE_532_length_3286_cov_5.973015	23	89	2	66	66	1.0000000
NODE_532_length_3286_cov_5.973015	23	94	2	71	71	1.0000000
NODE_533_length_3284_cov_6.453689	313	392	4	71	79	0.8987342
NODE_533_length_3284_cov_6.453689	313	392	6	8	79	0.1012658
NODE_533_length_3284_cov_6.453689	365	445	0	25	80	0.3125000
NODE_533_length_3284_cov_6.453689	365	445	2	17	80	0.2125000
NODE_533_length_3284_cov_6.453689	365	445	4	38	80	0.4750000
NODE_541_length_3267_cov_12.768624	11	91	0	1	80	0.0125000
NODE_541_length_3267_cov_12.768624	11	91	4	9	80	0.1125000
NODE_541_length_3267_cov_12.768624	11	91	6	4	80	0.0500000
NODE_541_length_3267_cov_12.768624	11	91	8	5	80	0.0625000
NODE_541_length_3267_cov_12.768624	11	91	10	4	80	0.0500000
NODE_541_length_3267_cov_12.768624	11	91	16	15	80	0.1875000
NODE_541_length_3267_cov_12.768624	11	91	20	13	80	0.1625000
NODE_541_length_3267_cov_12.768624	11	91	22	6	80	0.0750000
NODE_541_length_3267_cov_12.768624	11	91	24	20	80	0.2500000
NODE_541_length_3267_cov_12.768624	11	91	26	3	80	0.0375000
NODE_542_length_3266_cov_14.108304	2620	2684	11	12	64	0.1875000
NODE_542_length_3266_cov_14.108304	2620	2684	13	52	64	0.8125000
NODE_542_length_3266_cov_14.108304	2620	2684	11	12	64	0.1875000
NODE_542_length_3266_cov_14.108304	2620	2684	13	52	64	0.8125000
NODE_542_length_3266_cov_14.108304	2620	2684	11	12	64	0.1875000
NODE_542_length_3266_cov_14.108304	2620	2684	13	52	64	0.8125000
NODE_547_length_3242_cov_12.407891	391	471	0	80	80	1.0000000
NODE_547_length_3242_cov_12.407891	444	524	0	80	80	1.0000000
NODE_550_length_3233_cov_19.903957	411	491	0	80	80	1.0000000
NODE_550_length_3233_cov_19.903957	411	491	0	80	80	1.0000000
NODE_550_length_3233_cov_19.903957	464	544	0	80	80	1.0000000
NODE_552_length_3232_cov_11.378870	2586	2621	2	35	35	1.0000000
NODE_555_length_3214_cov_22.853291	2090	2170	38	2	80	0.0250000
NODE_555_length_3214_cov_22.853291	2090	2170	41	3	80	0.0375000
NODE_555_length_3214_cov_22.853291	2090	2170	44	1	80	0.0125000
NODE_555_length_3214_cov_22.853291	2090	2170	46	1	80	0.0125000
NODE_555_length_3214_cov_22.853291	2090	2170	48	9	80	0.1125000
NODE_555_length_3214_cov_22.853291	2090	2170	49	13	80	0.1625000
NODE_555_length_3214_cov_22.853291	2090	2170	50	4	80	0.0500000
NODE_555_length_3214_cov_22.853291	2090	2170	51	2	80	0.0250000
NODE_555_length_3214_cov_22.853291	2090	2170	53	1	80	0.0125000
NODE_555_length_3214_cov_22.853291	2090	2170	54	3	80	0.0375000
NODE_555_length_3214_cov_22.853291	2090	2170	56	1	80	0.0125000
NODE_555_length_3214_cov_22.853291	2090	2170	60	16	80	0.2000000
NODE_555_length_3214_cov_22.853291	2090	2170	61	7	80	0.0875000
NODE_555_length_3214_cov_22.853291	2090	2170	62	10	80	0.1250000
NODE_555_length_3214_cov_22.853291	2090	2170	63	6	80	0.0750000
NODE_555_length_3214_cov_22.853291	2090	2170	64	1	80	0.0125000
NODE_555_length_3214_cov_22.853291	2143	2223	39	8	80	0.1000000
NODE_555_length_3214_cov_22.853291	2143	2223	41	3	80	0.0375000
NODE_555_length_3214_cov_22.853291	2143	2223	43	1	80	0.0125000
NODE_555_length_3214_cov_22.853291	2143	2223	45	2	80	0.0250000
NODE_555_length_3214_cov_22.853291	2143	2223	47	2	80	0.0250000
NODE_555_length_3214_cov_22.853291	2143	2223	51	3	80	0.0375000
NODE_555_length_3214_cov_22.853291	2143	2223	55	5	80	0.0625000
NODE_555_length_3214_cov_22.853291	2143	2223	57	11	80	0.1375000
NODE_555_length_3214_cov_22.853291	2143	2223	58	12	80	0.1500000
NODE_555_length_3214_cov_22.853291	2143	2223	59	5	80	0.0625000
NODE_555_length_3214_cov_22.853291	2143	2223	60	16	80	0.2000000
NODE_555_length_3214_cov_22.853291	2143	2223	61	4	80	0.0500000
NODE_555_length_3214_cov_22.853291	2143	2223	62	7	80	0.0875000
NODE_555_length_3214_cov_22.853291	2143	2223	64	1	80	0.0125000
NODE_555_length_3214_cov_22.853291	3028	3086	0	56	58	0.9655172
NODE_555_length_3214_cov_22.853291	3028	3086	2	1	58	0.0172414
NODE_555_length_3214_cov_22.853291	3028	3086	8	1	58	0.0172414
NODE_556_length_3211_cov_1.921915	95	175	2	3	80	0.0375000
NODE_556_length_3211_cov_1.921915	95	175	4	1	80	0.0125000
NODE_556_length_3211_cov_1.921915	95	175	6	10	80	0.1250000
NODE_556_length_3211_cov_1.921915	95	175	7	2	80	0.0250000
NODE_556_length_3211_cov_1.921915	95	175	8	64	80	0.8000000
NODE_556_length_3211_cov_1.921915	148	178	2	6	30	0.2000000
NODE_556_length_3211_cov_1.921915	148	178	4	1	30	0.0333333
NODE_556_length_3211_cov_1.921915	148	178	6	5	30	0.1666667
NODE_556_length_3211_cov_1.921915	148	178	7	2	30	0.0666667
NODE_556_length_3211_cov_1.921915	148	178	8	16	30	0.5333334
NODE_557_length_3210_cov_7.428480	2040	2111	6	19	71	0.2676056
NODE_557_length_3210_cov_7.428480	2040	2111	8	23	71	0.3239437
NODE_557_length_3210_cov_7.428480	2040	2111	12	5	71	0.0704225
NODE_557_length_3210_cov_7.428480	2040	2111	14	4	71	0.0563380
NODE_557_length_3210_cov_7.428480	2040	2111	16	20	71	0.2816902
NODE_557_length_3210_cov_7.428480	2084	2164	6	6	80	0.0750000
NODE_557_length_3210_cov_7.428480	2084	2164	8	5	80	0.0625000
NODE_557_length_3210_cov_7.428480	2084	2164	12	35	80	0.4375000
NODE_557_length_3210_cov_7.428480	2084	2164	14	6	80	0.0750000
NODE_557_length_3210_cov_7.428480	2084	2164	16	28	80	0.3500000
NODE_557_length_3210_cov_7.428480	2715	2797	5	36	82	0.4390244
NODE_557_length_3210_cov_7.428480	2715	2797	6	33	82	0.4024390
NODE_557_length_3210_cov_7.428480	2715	2797	8	13	82	0.1585366
NODE_557_length_3210_cov_7.428480	2770	2850	2	24	80	0.3000000
NODE_557_length_3210_cov_7.428480	2770	2850	5	56	80	0.7000000
NODE_562_length_3201_cov_3.591231	3120	3200	0	80	80	1.0000000
NODE_566_length_3189_cov_69.446602	137	188	0	51	51	1.0000000
NODE_567_length_3188_cov_7.233085	1663	1743	0	40	80	0.5000000
NODE_567_length_3188_cov_7.233085	1663	1743	2	10	80	0.1250000
NODE_567_length_3188_cov_7.233085	1663	1743	4	30	80	0.3750000
NODE_567_length_3188_cov_7.233085	1716	1796	4	80	80	1.0000000
NODE_570_length_3177_cov_2.789474	2021	2042	0	21	21	1.0000000
NODE_575_length_3158_cov_19.018960	840	920	0	12	80	0.1500000
NODE_575_length_3158_cov_19.018960	840	920	4	9	80	0.1125000
NODE_575_length_3158_cov_19.018960	840	920	6	59	80	0.7375000
NODE_575_length_3158_cov_19.018960	893	973	0	65	80	0.8125000
NODE_575_length_3158_cov_19.018960	893	973	4	9	80	0.1125000
NODE_575_length_3158_cov_19.018960	893	973	6	6	80	0.0750000
NODE_575_length_3158_cov_19.018960	2833	2915	0	82	82	1.0000000
NODE_575_length_3158_cov_19.018960	2888	2959	0	71	71	1.0000000
NODE_576_length_3150_cov_26.520813	770	850	6	15	80	0.1875000
NODE_576_length_3150_cov_26.520813	770	850	8	21	80	0.2625000
NODE_576_length_3150_cov_26.520813	770	850	10	44	80	0.5500000
NODE_576_length_3150_cov_26.520813	823	901	0	4	78	0.0512821
NODE_576_length_3150_cov_26.520813	823	901	2	20	78	0.2564103
NODE_576_length_3150_cov_26.520813	823	901	4	1	78	0.0128205
NODE_576_length_3150_cov_26.520813	823	901	6	29	78	0.3717949
NODE_576_length_3150_cov_26.520813	823	901	8	17	78	0.2179487
NODE_576_length_3150_cov_26.520813	823	901	10	7	78	0.0897436
NODE_576_length_3150_cov_26.520813	2616	2696	6	1	80	0.0125000
NODE_576_length_3150_cov_26.520813	2616	2696	12	46	80	0.5750000
NODE_576_length_3150_cov_26.520813	2616	2696	13	33	80	0.4125000
NODE_576_length_3150_cov_26.520813	2669	2749	13	41	80	0.5125000
NODE_576_length_3150_cov_26.520813	2669	2749	14	39	80	0.4875000
NODE_577_length_3150_cov_5.923959	2313	2393	0	80	80	1.0000000
NODE_579_length_3148_cov_2.313873	3053	3105	0	52	52	1.0000000
NODE_581_length_3146_cov_18.277322	2418	2498	0	2	80	0.0250000
NODE_581_length_3146_cov_18.277322	2418	2498	4	78	80	0.9750000
NODE_581_length_3146_cov_18.277322	2471	2551	4	79	80	0.9875000
NODE_581_length_3146_cov_18.277322	2471	2551	5	1	80	0.0125000
NODE_581_length_3146_cov_18.277322	2547	2627	2	58	80	0.7250000
NODE_581_length_3146_cov_18.277322	2547	2627	4	13	80	0.1625000
NODE_581_length_3146_cov_18.277322	2547	2627	5	8	80	0.1000000
NODE_581_length_3146_cov_18.277322	2547	2627	6	1	80	0.0125000
NODE_581_length_3146_cov_18.277322	2600	2680	2	17	80	0.2125000
NODE_581_length_3146_cov_18.277322	2600	2680	4	16	80	0.2000000
NODE_581_length_3146_cov_18.277322	2600	2680	8	39	80	0.4875000
NODE_581_length_3146_cov_18.277322	2600	2680	10	8	80	0.1000000
NODE_581_length_3146_cov_18.277322	2975	3055	0	5	80	0.0625000
NODE_581_length_3146_cov_18.277322	2975	3055	2	7	80	0.0875000
NODE_581_length_3146_cov_18.277322	2975	3055	3	3	80	0.0375000
NODE_581_length_3146_cov_18.277322	2975	3055	4	2	80	0.0250000
NODE_581_length_3146_cov_18.277322	2975	3055	6	63	80	0.7875000
NODE_585_length_3134_cov_8.717957	1290	1362	73	1	72	0.0138889
NODE_585_length_3134_cov_8.717957	1290	1362	74	8	72	0.1111111
NODE_585_length_3134_cov_8.717957	1290	1362	76	8	72	0.1111111
NODE_585_length_3134_cov_8.717957	1290	1362	80	2	72	0.0277778
NODE_585_length_3134_cov_8.717957	1290	1362	84	2	72	0.0277778
NODE_585_length_3134_cov_8.717957	1290	1362	90	2	72	0.0277778
NODE_585_length_3134_cov_8.717957	1290	1362	101	1	72	0.0138889
NODE_585_length_3134_cov_8.717957	1290	1362	103	2	72	0.0277778
NODE_585_length_3134_cov_8.717957	1290	1362	112	3	72	0.0416667
NODE_585_length_3134_cov_8.717957	1290	1362	118	2	72	0.0277778
NODE_585_length_3134_cov_8.717957	1290	1362	122	1	72	0.0138889
NODE_585_length_3134_cov_8.717957	1290	1362	124	2	72	0.0277778
NODE_585_length_3134_cov_8.717957	1290	1362	126	1	72	0.0138889
NODE_585_length_3134_cov_8.717957	1290	1362	131	1	72	0.0138889
NODE_585_length_3134_cov_8.717957	1290	1362	136	2	72	0.0277778
NODE_585_length_3134_cov_8.717957	1290	1362	138	1	72	0.0138889
NODE_585_length_3134_cov_8.717957	1290	1362	140	2	72	0.0277778
NODE_585_length_3134_cov_8.717957	1290	1362	144	2	72	0.0277778
NODE_585_length_3134_cov_8.717957	1290	1362	147	3	72	0.0416667
NODE_585_length_3134_cov_8.717957	1290	1362	149	2	72	0.0277778
NODE_585_length_3134_cov_8.717957	1290	1362	150	7	72	0.0972222
NODE_585_length_3134_cov_8.717957	1290	1362	155	5	72	0.0694444
NODE_585_length_3134_cov_8.717957	1290	1362	156	3	72	0.0416667
NODE_585_length_3134_cov_8.717957	1290	1362	157	1	72	0.0138889
NODE_585_length_3134_cov_8.717957	1290	1362	159	1	72	0.0138889
NODE_585_length_3134_cov_8.717957	1290	1362	160	1	72	0.0138889
NODE_585_length_3134_cov_8.717957	1290	1362	162	3	72	0.0416667
NODE_585_length_3134_cov_8.717957	1290	1362	164	2	72	0.0277778
NODE_585_length_3134_cov_8.717957	1290	1362	166	1	72	0.0138889
NODE_585_length_3134_cov_8.717957	1335	1415	88	2	80	0.0250000
NODE_585_length_3134_cov_8.717957	1335	1415	93	2	80	0.0250000
NODE_585_length_3134_cov_8.717957	1335	1415	95	1	80	0.0125000
NODE_585_length_3134_cov_8.717957	1335	1415	97	2	80	0.0250000
NODE_585_length_3134_cov_8.717957	1335	1415	99	3	80	0.0375000
NODE_585_length_3134_cov_8.717957	1335	1415	101	1	80	0.0125000
NODE_585_length_3134_cov_8.717957	1335	1415	103	1	80	0.0125000
NODE_585_length_3134_cov_8.717957	1335	1415	111	1	80	0.0125000
NODE_585_length_3134_cov_8.717957	1335	1415	113	1	80	0.0125000
NODE_585_length_3134_cov_8.717957	1335	1415	115	1	80	0.0125000
NODE_585_length_3134_cov_8.717957	1335	1415	121	2	80	0.0250000
NODE_585_length_3134_cov_8.717957	1335	1415	123	5	80	0.0625000
NODE_585_length_3134_cov_8.717957	1335	1415	125	1	80	0.0125000
NODE_585_length_3134_cov_8.717957	1335	1415	129	4	80	0.0500000
NODE_585_length_3134_cov_8.717957	1335	1415	131	3	80	0.0375000
NODE_585_length_3134_cov_8.717957	1335	1415	132	3	80	0.0375000
NODE_585_length_3134_cov_8.717957	1335	1415	134	2	80	0.0250000
NODE_585_length_3134_cov_8.717957	1335	1415	135	1	80	0.0125000
NODE_585_length_3134_cov_8.717957	1335	1415	136	1	80	0.0125000
NODE_585_length_3134_cov_8.717957	1335	1415	137	3	80	0.0375000
NODE_585_length_3134_cov_8.717957	1335	1415	141	3	80	0.0375000
NODE_585_length_3134_cov_8.717957	1335	1415	143	1	80	0.0125000
NODE_585_length_3134_cov_8.717957	1335	1415	147	1	80	0.0125000
NODE_585_length_3134_cov_8.717957	1335	1415	149	2	80	0.0250000
NODE_585_length_3134_cov_8.717957	1335	1415	150	7	80	0.0875000
NODE_585_length_3134_cov_8.717957	1335	1415	151	1	80	0.0125000
NODE_585_length_3134_cov_8.717957	1335	1415	152	1	80	0.0125000
NODE_585_length_3134_cov_8.717957	1335	1415	153	2	80	0.0250000
NODE_585_length_3134_cov_8.717957	1335	1415	154	3	80	0.0375000
NODE_585_length_3134_cov_8.717957	1335	1415	155	5	80	0.0625000
NODE_585_length_3134_cov_8.717957	1335	1415	156	4	80	0.0500000
NODE_585_length_3134_cov_8.717957	1335	1415	157	2	80	0.0250000
NODE_585_length_3134_cov_8.717957	1335	1415	159	1	80	0.0125000
NODE_585_length_3134_cov_8.717957	1335	1415	160	1	80	0.0125000
NODE_585_length_3134_cov_8.717957	1335	1415	162	3	80	0.0375000
NODE_585_length_3134_cov_8.717957	1335	1415	164	2	80	0.0250000
NODE_585_length_3134_cov_8.717957	1335	1415	166	1	80	0.0125000
NODE_586_length_3131_cov_26.910620	232	312	0	53	80	0.6625000
NODE_586_length_3131_cov_26.910620	232	312	2	8	80	0.1000000
NODE_586_length_3131_cov_26.910620	232	312	3	19	80	0.2375000
NODE_586_length_3131_cov_26.910620	285	364	2	18	79	0.2278481
NODE_586_length_3131_cov_26.910620	285	364	3	23	79	0.2911392
NODE_586_length_3131_cov_26.910620	285	364	4	38	79	0.4810127
NODE_586_length_3131_cov_26.910620	2151	2231	6	80	80	1.0000000
NODE_586_length_3131_cov_26.910620	2155	2227	6	72	72	1.0000000
NODE_586_length_3131_cov_26.910620	2204	2284	0	15	80	0.1875000
NODE_586_length_3131_cov_26.910620	2204	2284	6	65	80	0.8125000
NODE_586_length_3131_cov_26.910620	2208	2284	0	15	76	0.1973684
NODE_586_length_3131_cov_26.910620	2208	2284	6	61	76	0.8026316
NODE_586_length_3131_cov_26.910620	2280	2360	0	80	80	1.0000000
NODE_586_length_3131_cov_26.910620	2333	2413	0	72	80	0.9000000
NODE_586_length_3131_cov_26.910620	2333	2413	2	8	80	0.1000000
NODE_590_length_3118_cov_5.059622	367	445	0	78	78	1.0000000
NODE_590_length_3118_cov_5.059622	418	498	0	80	80	1.0000000
NODE_591_length_3117_cov_5.938038	2525	2605	0	3	80	0.0375000
NODE_591_length_3117_cov_5.938038	2525	2605	2	61	80	0.7625000
NODE_591_length_3117_cov_5.938038	2525	2605	6	16	80	0.2000000
NODE_591_length_3117_cov_5.938038	2578	2658	2	11	80	0.1375000
NODE_591_length_3117_cov_5.938038	2578	2658	4	33	80	0.4125000
NODE_591_length_3117_cov_5.938038	2578	2658	6	36	80	0.4500000
NODE_595_length_3110_cov_31.733643	2864	2923	0	59	59	1.0000000
NODE_602_length_3093_cov_54.559786	571	651	0	80	80	1.0000000
NODE_602_length_3093_cov_54.559786	624	704	0	80	80	1.0000000
NODE_602_length_3093_cov_54.559786	2901	2981	0	36	80	0.4500000
NODE_602_length_3093_cov_54.559786	2901	2981	2	44	80	0.5500000
NODE_602_length_3093_cov_54.559786	2954	3034	2	80	80	1.0000000
NODE_603_length_3091_cov_35.895722	1743	1804	0	61	61	1.0000000
NODE_603_length_3091_cov_35.895722	1777	1857	0	80	80	1.0000000
NODE_603_length_3091_cov_35.895722	2472	2535	0	63	63	1.0000000
NODE_603_length_3091_cov_35.895722	2508	2553	0	45	45	1.0000000
NODE_603_length_3091_cov_35.895722	2534	2604	0	32	70	0.4571429
NODE_603_length_3091_cov_35.895722	2534	2604	4	11	70	0.1571429
NODE_603_length_3091_cov_35.895722	2534	2604	6	27	70	0.3857143
NODE_603_length_3091_cov_35.895722	2578	2618	6	40	40	1.0000000
NODE_603_length_3091_cov_35.895722	2586	2623	6	37	37	1.0000000
NODE_603_length_3091_cov_35.895722	2626	2671	0	16	45	0.3555556
NODE_603_length_3091_cov_35.895722	2626	2671	2	12	45	0.2666667
NODE_603_length_3091_cov_35.895722	2626	2671	6	17	45	0.3777778
NODE_603_length_3091_cov_35.895722	2682	2730	0	48	48	1.0000000
NODE_603_length_3091_cov_35.895722	2918	2969	0	51	51	1.0000000
NODE_603_length_3091_cov_35.895722	2942	2987	0	45	45	1.0000000
NODE_603_length_3091_cov_35.895722	2994	3039	0	45	45	1.0000000
NODE_607_length_3079_cov_7.081879	2340	2420	10	66	80	0.8250000
NODE_607_length_3079_cov_7.081879	2340	2420	11	2	80	0.0250000
NODE_607_length_3079_cov_7.081879	2340	2420	12	12	80	0.1500000
NODE_607_length_3079_cov_7.081879	2886	2938	3	34	52	0.6538461
NODE_607_length_3079_cov_7.081879	2886	2938	5	1	52	0.0192308
NODE_607_length_3079_cov_7.081879	2886	2938	6	7	52	0.1346154
NODE_607_length_3079_cov_7.081879	2886	2938	7	4	52	0.0769231
NODE_607_length_3079_cov_7.081879	2886	2938	18	6	52	0.1153846
NODE_607_length_3079_cov_7.081879	2893	2959	3	27	66	0.4090909
NODE_607_length_3079_cov_7.081879	2893	2959	5	1	66	0.0151515
NODE_607_length_3079_cov_7.081879	2893	2959	6	7	66	0.1060606
NODE_607_length_3079_cov_7.081879	2893	2959	7	4	66	0.0606061
NODE_607_length_3079_cov_7.081879	2893	2959	18	6	66	0.0909091
NODE_607_length_3079_cov_7.081879	2893	2959	24	1	66	0.0151515
NODE_607_length_3079_cov_7.081879	2893	2959	26	1	66	0.0151515
NODE_607_length_3079_cov_7.081879	2893	2959	32	3	66	0.0454545
NODE_607_length_3079_cov_7.081879	2893	2959	33	1	66	0.0151515
NODE_607_length_3079_cov_7.081879	2893	2959	36	2	66	0.0303030
NODE_607_length_3079_cov_7.081879	2893	2959	37	6	66	0.0909091
NODE_607_length_3079_cov_7.081879	2893	2959	40	2	66	0.0303030
NODE_607_length_3079_cov_7.081879	2893	2959	46	5	66	0.0757576
NODE_607_length_3079_cov_7.081879	2932	2993	18	6	61	0.0983607
NODE_607_length_3079_cov_7.081879	2932	2993	24	1	61	0.0163934
NODE_607_length_3079_cov_7.081879	2932	2993	26	1	61	0.0163934
NODE_607_length_3079_cov_7.081879	2932	2993	32	3	61	0.0491803
NODE_607_length_3079_cov_7.081879	2932	2993	33	1	61	0.0163934
NODE_607_length_3079_cov_7.081879	2932	2993	36	2	61	0.0327869
NODE_607_length_3079_cov_7.081879	2932	2993	37	6	61	0.0983607
NODE_607_length_3079_cov_7.081879	2932	2993	40	2	61	0.0327869
NODE_607_length_3079_cov_7.081879	2932	2993	46	13	61	0.2131148
NODE_607_length_3079_cov_7.081879	2932	2993	48	24	61	0.3934426
NODE_607_length_3079_cov_7.081879	2932	2993	50	2	61	0.0327869
NODE_607_length_3079_cov_7.081879	2932	2995	18	6	63	0.0952381
NODE_607_length_3079_cov_7.081879	2932	2995	24	1	63	0.0158730
NODE_607_length_3079_cov_7.081879	2932	2995	26	1	63	0.0158730
NODE_607_length_3079_cov_7.081879	2932	2995	32	3	63	0.0476190
NODE_607_length_3079_cov_7.081879	2932	2995	33	1	63	0.0158730
NODE_607_length_3079_cov_7.081879	2932	2995	36	2	63	0.0317460
NODE_607_length_3079_cov_7.081879	2932	2995	37	6	63	0.0952381
NODE_607_length_3079_cov_7.081879	2932	2995	40	2	63	0.0317460
NODE_607_length_3079_cov_7.081879	2932	2995	46	13	63	0.2063492
NODE_607_length_3079_cov_7.081879	2932	2995	48	26	63	0.4126984
NODE_607_length_3079_cov_7.081879	2932	2995	50	2	63	0.0317460
NODE_607_length_3079_cov_7.081879	2932	2995	18	6	63	0.0952381
NODE_607_length_3079_cov_7.081879	2932	2995	24	1	63	0.0158730
NODE_607_length_3079_cov_7.081879	2932	2995	26	1	63	0.0158730
NODE_607_length_3079_cov_7.081879	2932	2995	32	3	63	0.0476190
NODE_607_length_3079_cov_7.081879	2932	2995	33	1	63	0.0158730
NODE_607_length_3079_cov_7.081879	2932	2995	36	2	63	0.0317460
NODE_607_length_3079_cov_7.081879	2932	2995	37	6	63	0.0952381
NODE_607_length_3079_cov_7.081879	2932	2995	40	2	63	0.0317460
NODE_607_length_3079_cov_7.081879	2932	2995	46	13	63	0.2063492
NODE_607_length_3079_cov_7.081879	2932	2995	48	26	63	0.4126984
NODE_607_length_3079_cov_7.081879	2932	2995	50	2	63	0.0317460
NODE_608_length_3077_cov_23.535259	1244	1321	0	11	77	0.1428571
NODE_608_length_3077_cov_23.535259	1244	1321	2	66	77	0.8571429
NODE_608_length_3077_cov_23.535259	1911	1991	0	80	80	1.0000000
NODE_608_length_3077_cov_23.535259	1964	2016	0	52	52	1.0000000
NODE_608_length_3077_cov_23.535259	2028	2114	0	51	86	0.5930232
NODE_608_length_3077_cov_23.535259	2028	2114	2	11	86	0.1279070
NODE_608_length_3077_cov_23.535259	2028	2114	4	4	86	0.0465116
NODE_608_length_3077_cov_23.535259	2028	2114	6	14	86	0.1627907
NODE_608_length_3077_cov_23.535259	2028	2114	8	6	86	0.0697674
NODE_609_length_3077_cov_8.693083	1157	1237	2	1	80	0.0125000
NODE_609_length_3077_cov_8.693083	1157	1237	3	9	80	0.1125000
NODE_609_length_3077_cov_8.693083	1157	1237	5	14	80	0.1750000
NODE_609_length_3077_cov_8.693083	1157	1237	7	11	80	0.1375000
NODE_609_length_3077_cov_8.693083	1157	1237	9	19	80	0.2375000
NODE_609_length_3077_cov_8.693083	1157	1237	10	22	80	0.2750000
NODE_609_length_3077_cov_8.693083	1157	1237	11	4	80	0.0500000
NODE_609_length_3077_cov_8.693083	1161	1184	3	6	23	0.2608696
NODE_609_length_3077_cov_8.693083	1161	1184	5	14	23	0.6086956
NODE_609_length_3077_cov_8.693083	1161	1184	7	3	23	0.1304348
NODE_609_length_3077_cov_8.693083	1233	1313	9	7	80	0.0875000
NODE_609_length_3077_cov_8.693083	1233	1313	11	5	80	0.0625000
NODE_609_length_3077_cov_8.693083	1233	1313	15	5	80	0.0625000
NODE_609_length_3077_cov_8.693083	1233	1313	16	1	80	0.0125000
NODE_609_length_3077_cov_8.693083	1233	1313	17	4	80	0.0500000
NODE_609_length_3077_cov_8.693083	1233	1313	19	6	80	0.0750000
NODE_609_length_3077_cov_8.693083	1233	1313	27	7	80	0.0875000
NODE_609_length_3077_cov_8.693083	1233	1313	28	4	80	0.0500000
NODE_609_length_3077_cov_8.693083	1233	1313	31	1	80	0.0125000
NODE_609_length_3077_cov_8.693083	1233	1313	35	1	80	0.0125000
NODE_609_length_3077_cov_8.693083	1233	1313	37	2	80	0.0250000
NODE_609_length_3077_cov_8.693083	1233	1313	40	3	80	0.0375000
NODE_609_length_3077_cov_8.693083	1233	1313	42	4	80	0.0500000
NODE_609_length_3077_cov_8.693083	1233	1313	44	10	80	0.1250000
NODE_609_length_3077_cov_8.693083	1233	1313	46	9	80	0.1125000
NODE_609_length_3077_cov_8.693083	1233	1313	47	2	80	0.0250000
NODE_609_length_3077_cov_8.693083	1233	1313	49	4	80	0.0500000
NODE_609_length_3077_cov_8.693083	1233	1313	51	5	80	0.0625000
NODE_609_length_3077_cov_8.693083	1286	1352	44	7	66	0.1060606
NODE_609_length_3077_cov_8.693083	1286	1352	46	9	66	0.1363636
NODE_609_length_3077_cov_8.693083	1286	1352	47	2	66	0.0303030
NODE_609_length_3077_cov_8.693083	1286	1352	49	14	66	0.2121212
NODE_609_length_3077_cov_8.693083	1286	1352	51	9	66	0.1363636
NODE_609_length_3077_cov_8.693083	1286	1352	52	1	66	0.0151515
NODE_609_length_3077_cov_8.693083	1286	1352	53	11	66	0.1666667
NODE_609_length_3077_cov_8.693083	1286	1352	54	11	66	0.1666667
NODE_609_length_3077_cov_8.693083	1286	1352	56	2	66	0.0303030
NODE_609_length_3077_cov_8.693083	2672	2757	0	29	85	0.3411765
NODE_609_length_3077_cov_8.693083	2672	2757	2	7	85	0.0823529
NODE_609_length_3077_cov_8.693083	2672	2757	4	15	85	0.1764706
NODE_609_length_3077_cov_8.693083	2672	2757	6	13	85	0.1529412
NODE_609_length_3077_cov_8.693083	2672	2757	11	1	85	0.0117647
NODE_609_length_3077_cov_8.693083	2672	2757	12	2	85	0.0235294
NODE_609_length_3077_cov_8.693083	2672	2757	14	13	85	0.1529412
NODE_609_length_3077_cov_8.693083	2672	2757	16	5	85	0.0588235
NODE_611_length_3074_cov_2.996303	2561	2629	33	1	68	0.0147059
NODE_611_length_3074_cov_2.996303	2561	2629	34	1	68	0.0147059
NODE_611_length_3074_cov_2.996303	2561	2629	35	2	68	0.0294118
NODE_611_length_3074_cov_2.996303	2561	2629	39	1	68	0.0147059
NODE_611_length_3074_cov_2.996303	2561	2629	43	1	68	0.0147059
NODE_611_length_3074_cov_2.996303	2561	2629	47	1	68	0.0147059
NODE_611_length_3074_cov_2.996303	2561	2629	65	1	68	0.0147059
NODE_611_length_3074_cov_2.996303	2561	2629	66	1	68	0.0147059
NODE_611_length_3074_cov_2.996303	2561	2629	70	1	68	0.0147059
NODE_611_length_3074_cov_2.996303	2561	2629	78	1	68	0.0147059
NODE_611_length_3074_cov_2.996303	2561	2629	81	1	68	0.0147059
NODE_611_length_3074_cov_2.996303	2561	2629	85	3	68	0.0441176
NODE_611_length_3074_cov_2.996303	2561	2629	87	2	68	0.0294118
NODE_611_length_3074_cov_2.996303	2561	2629	88	2	68	0.0294118
NODE_611_length_3074_cov_2.996303	2561	2629	91	1	68	0.0147059
NODE_611_length_3074_cov_2.996303	2561	2629	99	1	68	0.0147059
NODE_611_length_3074_cov_2.996303	2561	2629	103	1	68	0.0147059
NODE_611_length_3074_cov_2.996303	2561	2629	107	1	68	0.0147059
NODE_611_length_3074_cov_2.996303	2561	2629	109	2	68	0.0294118
NODE_611_length_3074_cov_2.996303	2561	2629	113	3	68	0.0441176
NODE_611_length_3074_cov_2.996303	2561	2629	121	4	68	0.0588235
NODE_611_length_3074_cov_2.996303	2561	2629	123	1	68	0.0147059
NODE_611_length_3074_cov_2.996303	2561	2629	125	1	68	0.0147059
NODE_611_length_3074_cov_2.996303	2561	2629	129	1	68	0.0147059
NODE_611_length_3074_cov_2.996303	2561	2629	133	1	68	0.0147059
NODE_611_length_3074_cov_2.996303	2561	2629	135	1	68	0.0147059
NODE_611_length_3074_cov_2.996303	2561	2629	141	1	68	0.0147059
NODE_611_length_3074_cov_2.996303	2561	2629	147	2	68	0.0294118
NODE_611_length_3074_cov_2.996303	2561	2629	149	1	68	0.0147059
NODE_611_length_3074_cov_2.996303	2561	2629	151	1	68	0.0147059
NODE_611_length_3074_cov_2.996303	2561	2629	155	2	68	0.0294118
NODE_611_length_3074_cov_2.996303	2561	2629	157	1	68	0.0147059
NODE_611_length_3074_cov_2.996303	2561	2629	159	2	68	0.0294118
NODE_611_length_3074_cov_2.996303	2561	2629	161	1	68	0.0147059
NODE_611_length_3074_cov_2.996303	2561	2629	163	2	68	0.0294118
NODE_611_length_3074_cov_2.996303	2561	2629	165	1	68	0.0147059
NODE_611_length_3074_cov_2.996303	2561	2629	168	2	68	0.0294118
NODE_611_length_3074_cov_2.996303	2561	2629	176	1	68	0.0147059
NODE_611_length_3074_cov_2.996303	2561	2629	183	1	68	0.0147059
NODE_611_length_3074_cov_2.996303	2561	2629	185	1	68	0.0147059
NODE_611_length_3074_cov_2.996303	2561	2629	195	1	68	0.0147059
NODE_611_length_3074_cov_2.996303	2561	2629	205	1	68	0.0147059
NODE_611_length_3074_cov_2.996303	2561	2629	210	1	68	0.0147059
NODE_611_length_3074_cov_2.996303	2561	2629	227	1	68	0.0147059
NODE_611_length_3074_cov_2.996303	2561	2629	234	1	68	0.0147059
NODE_611_length_3074_cov_2.996303	2561	2629	240	1	68	0.0147059
NODE_611_length_3074_cov_2.996303	2561	2629	241	1	68	0.0147059
NODE_611_length_3074_cov_2.996303	2561	2629	256	1	68	0.0147059
NODE_611_length_3074_cov_2.996303	2561	2629	260	1	68	0.0147059
NODE_611_length_3074_cov_2.996303	2561	2629	275	1	68	0.0147059
NODE_611_length_3074_cov_2.996303	2561	2629	279	1	68	0.0147059
NODE_611_length_3074_cov_2.996303	2561	2629	282	1	68	0.0147059
NODE_615_length_3069_cov_2.448822	2948	2991	2	43	43	1.0000000
NODE_616_length_3059_cov_20.037500	346	426	28	4	80	0.0500000
NODE_616_length_3059_cov_20.037500	346	426	29	1	80	0.0125000
NODE_616_length_3059_cov_20.037500	346	426	30	1	80	0.0125000
NODE_616_length_3059_cov_20.037500	346	426	36	2	80	0.0250000
NODE_616_length_3059_cov_20.037500	346	426	40	1	80	0.0125000
NODE_616_length_3059_cov_20.037500	346	426	42	6	80	0.0750000
NODE_616_length_3059_cov_20.037500	346	426	45	1	80	0.0125000
NODE_616_length_3059_cov_20.037500	346	426	47	3	80	0.0375000
NODE_616_length_3059_cov_20.037500	346	426	49	1	80	0.0125000
NODE_616_length_3059_cov_20.037500	346	426	51	3	80	0.0375000
NODE_616_length_3059_cov_20.037500	346	426	54	1	80	0.0125000
NODE_616_length_3059_cov_20.037500	346	426	58	1	80	0.0125000
NODE_616_length_3059_cov_20.037500	346	426	59	2	80	0.0250000
NODE_616_length_3059_cov_20.037500	346	426	61	1	80	0.0125000
NODE_616_length_3059_cov_20.037500	346	426	63	1	80	0.0125000
NODE_616_length_3059_cov_20.037500	346	426	66	1	80	0.0125000
NODE_616_length_3059_cov_20.037500	346	426	67	5	80	0.0625000
NODE_616_length_3059_cov_20.037500	346	426	71	1	80	0.0125000
NODE_616_length_3059_cov_20.037500	346	426	73	2	80	0.0250000
NODE_616_length_3059_cov_20.037500	346	426	75	1	80	0.0125000
NODE_616_length_3059_cov_20.037500	346	426	77	3	80	0.0375000
NODE_616_length_3059_cov_20.037500	346	426	83	1	80	0.0125000
NODE_616_length_3059_cov_20.037500	346	426	85	4	80	0.0500000
NODE_616_length_3059_cov_20.037500	346	426	87	1	80	0.0125000
NODE_616_length_3059_cov_20.037500	346	426	92	6	80	0.0750000
NODE_616_length_3059_cov_20.037500	346	426	93	8	80	0.1000000
NODE_616_length_3059_cov_20.037500	346	426	95	3	80	0.0375000
NODE_616_length_3059_cov_20.037500	346	426	97	15	80	0.1875000
NODE_616_length_3059_cov_20.037500	399	479	53	2	80	0.0250000
NODE_616_length_3059_cov_20.037500	399	479	57	3	80	0.0375000
NODE_616_length_3059_cov_20.037500	399	479	59	1	80	0.0125000
NODE_616_length_3059_cov_20.037500	399	479	61	1	80	0.0125000
NODE_616_length_3059_cov_20.037500	399	479	63	3	80	0.0375000
NODE_616_length_3059_cov_20.037500	399	479	65	3	80	0.0375000
NODE_616_length_3059_cov_20.037500	399	479	67	1	80	0.0125000
NODE_616_length_3059_cov_20.037500	399	479	71	1	80	0.0125000
NODE_616_length_3059_cov_20.037500	399	479	73	2	80	0.0250000
NODE_616_length_3059_cov_20.037500	399	479	75	11	80	0.1375000
NODE_616_length_3059_cov_20.037500	399	479	76	2	80	0.0250000
NODE_616_length_3059_cov_20.037500	399	479	77	1	80	0.0125000
NODE_616_length_3059_cov_20.037500	399	479	78	5	80	0.0625000
NODE_616_length_3059_cov_20.037500	399	479	79	9	80	0.1125000
NODE_616_length_3059_cov_20.037500	399	479	81	5	80	0.0625000
NODE_616_length_3059_cov_20.037500	399	479	85	2	80	0.0250000
NODE_616_length_3059_cov_20.037500	399	479	92	4	80	0.0500000
NODE_616_length_3059_cov_20.037500	399	479	93	6	80	0.0750000
NODE_616_length_3059_cov_20.037500	399	479	95	3	80	0.0375000
NODE_616_length_3059_cov_20.037500	399	479	97	15	80	0.1875000
NODE_616_length_3059_cov_20.037500	1317	1397	2	12	80	0.1500000
NODE_616_length_3059_cov_20.037500	1317	1397	3	29	80	0.3625000
NODE_616_length_3059_cov_20.037500	1317	1397	4	6	80	0.0750000
NODE_616_length_3059_cov_20.037500	1317	1397	8	2	80	0.0250000
NODE_616_length_3059_cov_20.037500	1317	1397	10	16	80	0.2000000
NODE_616_length_3059_cov_20.037500	1317	1397	11	6	80	0.0750000
NODE_616_length_3059_cov_20.037500	1317	1397	12	8	80	0.1000000
NODE_616_length_3059_cov_20.037500	1317	1397	13	1	80	0.0125000
NODE_616_length_3059_cov_20.037500	1370	1447	2	32	77	0.4155844
NODE_616_length_3059_cov_20.037500	1370	1447	3	28	77	0.3636364
NODE_616_length_3059_cov_20.037500	1370	1447	4	17	77	0.2207792
NODE_616_length_3059_cov_20.037500	2514	2594	0	13	80	0.1625000
NODE_616_length_3059_cov_20.037500	2514	2594	2	67	80	0.8375000
NODE_616_length_3059_cov_20.037500	2567	2647	0	66	80	0.8250000
NODE_616_length_3059_cov_20.037500	2567	2647	2	14	80	0.1750000
NODE_617_length_3058_cov_21.767489	2802	2882	0	2	80	0.0250000
NODE_617_length_3058_cov_21.767489	2802	2882	2	1	80	0.0125000
NODE_617_length_3058_cov_21.767489	2802	2882	3	1	80	0.0125000
NODE_617_length_3058_cov_21.767489	2802	2882	4	16	80	0.2000000
NODE_617_length_3058_cov_21.767489	2802	2882	6	1	80	0.0125000
NODE_617_length_3058_cov_21.767489	2802	2882	8	23	80	0.2875000
NODE_617_length_3058_cov_21.767489	2802	2882	10	36	80	0.4500000
NODE_617_length_3058_cov_21.767489	2855	2930	8	20	75	0.2666667
NODE_617_length_3058_cov_21.767489	2855	2930	10	55	75	0.7333333
NODE_621_length_3047_cov_47.232361	418	489	0	71	71	1.0000000
NODE_621_length_3047_cov_47.232361	758	801	12	2	43	0.0465116
NODE_621_length_3047_cov_47.232361	758	801	14	4	43	0.0930233
NODE_621_length_3047_cov_47.232361	758	801	16	2	43	0.0465116
NODE_621_length_3047_cov_47.232361	758	801	20	2	43	0.0465116
NODE_621_length_3047_cov_47.232361	758	801	25	1	43	0.0232558
NODE_621_length_3047_cov_47.232361	758	801	27	2	43	0.0465116
NODE_621_length_3047_cov_47.232361	758	801	29	3	43	0.0697674
NODE_621_length_3047_cov_47.232361	758	801	30	3	43	0.0697674
NODE_621_length_3047_cov_47.232361	758	801	31	1	43	0.0232558
NODE_621_length_3047_cov_47.232361	758	801	32	12	43	0.2790698
NODE_621_length_3047_cov_47.232361	758	801	34	11	43	0.2558140
NODE_623_length_3044_cov_38.951783	1702	1782	0	8	80	0.1000000
NODE_623_length_3044_cov_38.951783	1702	1782	5	1	80	0.0125000
NODE_623_length_3044_cov_38.951783	1702	1782	6	71	80	0.8875000
NODE_623_length_3044_cov_38.951783	1755	1835	0	27	80	0.3375000
NODE_623_length_3044_cov_38.951783	1755	1835	6	53	80	0.6625000
NODE_623_length_3044_cov_38.951783	1831	1911	0	45	80	0.5625000
NODE_623_length_3044_cov_38.951783	1831	1911	2	35	80	0.4375000
NODE_623_length_3044_cov_38.951783	1884	1964	2	80	80	1.0000000
NODE_623_length_3044_cov_38.951783	2556	2636	0	70	80	0.8750000
NODE_623_length_3044_cov_38.951783	2556	2636	2	10	80	0.1250000
NODE_623_length_3044_cov_38.951783	2609	2689	0	17	80	0.2125000
NODE_623_length_3044_cov_38.951783	2609	2689	2	63	80	0.7875000
NODE_625_length_3039_cov_3.258163	261	337	2	76	76	1.0000000
NODE_625_length_3039_cov_3.258163	261	336	2	75	75	1.0000000
NODE_625_length_3039_cov_3.258163	261	337	2	76	76	1.0000000
NODE_625_length_3039_cov_3.258163	270	337	2	67	67	1.0000000
NODE_627_length_3036_cov_8.968676	2303	2367	0	55	64	0.8593750
NODE_627_length_3036_cov_8.968676	2303	2367	4	9	64	0.1406250
NODE_627_length_3036_cov_8.968676	2340	2420	0	80	80	1.0000000
NODE_627_length_3036_cov_8.968676	2416	2496	0	11	80	0.1375000
NODE_627_length_3036_cov_8.968676	2416	2496	2	69	80	0.8625000
NODE_627_length_3036_cov_8.968676	2469	2549	0	57	80	0.7125000
NODE_627_length_3036_cov_8.968676	2469	2549	2	23	80	0.2875000
NODE_629_length_3032_cov_7.470849	1026	1068	27	5	42	0.1190476
NODE_629_length_3032_cov_7.470849	1026	1068	29	1	42	0.0238095
NODE_629_length_3032_cov_7.470849	1026	1068	35	17	42	0.4047619
NODE_629_length_3032_cov_7.470849	1026	1068	37	9	42	0.2142857
NODE_629_length_3032_cov_7.470849	1026	1068	39	7	42	0.1666667
NODE_629_length_3032_cov_7.470849	1026	1068	40	3	42	0.0714286
NODE_630_length_3025_cov_11.862611	2371	2451	0	56	80	0.7000000
NODE_630_length_3025_cov_11.862611	2371	2451	2	24	80	0.3000000
NODE_630_length_3025_cov_11.862611	2424	2504	0	3	80	0.0375000
NODE_630_length_3025_cov_11.862611	2424	2504	2	72	80	0.9000000
NODE_630_length_3025_cov_11.862611	2424	2504	4	3	80	0.0375000
NODE_630_length_3025_cov_11.862611	2424	2504	6	2	80	0.0250000
NODE_630_length_3025_cov_11.862611	2500	2580	2	10	80	0.1250000
NODE_630_length_3025_cov_11.862611	2500	2580	4	28	80	0.3500000
NODE_630_length_3025_cov_11.862611	2500	2580	6	42	80	0.5250000
NODE_630_length_3025_cov_11.862611	2553	2633	0	1	80	0.0125000
NODE_630_length_3025_cov_11.862611	2553	2633	2	32	80	0.4000000
NODE_630_length_3025_cov_11.862611	2553	2633	4	47	80	0.5875000
NODE_635_length_3012_cov_33.100240	2379	2459	0	80	80	1.0000000
NODE_635_length_3012_cov_33.100240	2432	2512	0	30	80	0.3750000
NODE_635_length_3012_cov_33.100240	2432	2512	2	50	80	0.6250000
NODE_637_length_3007_cov_11.843535	2641	2721	0	15	80	0.1875000
NODE_637_length_3007_cov_11.843535	2641	2721	2	65	80	0.8125000
NODE_643_length_2992_cov_2.636709	2032	2112	0	60	80	0.7500000
NODE_643_length_2992_cov_2.636709	2032	2112	1	20	80	0.2500000
NODE_643_length_2992_cov_2.636709	2085	2165	0	7	80	0.0875000
NODE_643_length_2992_cov_2.636709	2085	2165	1	27	80	0.3375000
NODE_643_length_2992_cov_2.636709	2085	2165	2	7	80	0.0875000
NODE_643_length_2992_cov_2.636709	2085	2165	4	22	80	0.2750000
NODE_643_length_2992_cov_2.636709	2085	2165	6	17	80	0.2125000
NODE_646_length_2978_cov_4.883293	382	452	0	38	70	0.5428572
NODE_646_length_2978_cov_4.883293	382	452	2	32	70	0.4571429
NODE_646_length_2978_cov_4.883293	1858	1938	0	46	80	0.5750000
NODE_646_length_2978_cov_4.883293	1858	1938	2	34	80	0.4250000
NODE_646_length_2978_cov_4.883293	1926	1991	2	65	65	1.0000000
NODE_646_length_2978_cov_4.883293	1987	2066	0	55	79	0.6962025
NODE_646_length_2978_cov_4.883293	1987	2066	2	24	79	0.3037975
NODE_646_length_2978_cov_4.883293	2040	2079	0	39	39	1.0000000
NODE_647_length_2976_cov_24.683003	1764	1844	0	46	80	0.5750000
NODE_647_length_2976_cov_24.683003	1764	1844	2	34	80	0.4250000
NODE_647_length_2976_cov_24.683003	1817	1897	0	80	80	1.0000000
NODE_647_length_2976_cov_24.683003	1893	1973	0	33	80	0.4125000
NODE_647_length_2976_cov_24.683003	1893	1973	4	12	80	0.1500000
NODE_647_length_2976_cov_24.683003	1893	1973	6	35	80	0.4375000
NODE_647_length_2976_cov_24.683003	1946	2026	2	5	80	0.0625000
NODE_647_length_2976_cov_24.683003	1946	2026	3	2	80	0.0250000
NODE_647_length_2976_cov_24.683003	1946	2026	4	18	80	0.2250000
NODE_647_length_2976_cov_24.683003	1946	2026	6	33	80	0.4125000
NODE_647_length_2976_cov_24.683003	1946	2026	7	22	80	0.2750000
NODE_651_length_2967_cov_16.146095	238	318	0	15	80	0.1875000
NODE_651_length_2967_cov_16.146095	238	318	2	10	80	0.1250000
NODE_651_length_2967_cov_16.146095	238	318	4	55	80	0.6875000
NODE_651_length_2967_cov_16.146095	291	371	0	68	80	0.8500000
NODE_651_length_2967_cov_16.146095	291	371	2	10	80	0.1250000
NODE_651_length_2967_cov_16.146095	291	371	4	2	80	0.0250000
NODE_651_length_2967_cov_16.146095	367	447	0	80	80	1.0000000
NODE_651_length_2967_cov_16.146095	420	500	0	80	80	1.0000000
NODE_653_length_2965_cov_19.913468	92	134	0	8	42	0.1904762
NODE_653_length_2965_cov_19.913468	92	134	2	9	42	0.2142857
NODE_653_length_2965_cov_19.913468	92	134	4	3	42	0.0714286
NODE_653_length_2965_cov_19.913468	92	134	6	1	42	0.0238095
NODE_653_length_2965_cov_19.913468	92	134	8	2	42	0.0476190
NODE_653_length_2965_cov_19.913468	92	134	12	19	42	0.4523810
NODE_653_length_2965_cov_19.913468	109	178	0	52	69	0.7536232
NODE_653_length_2965_cov_19.913468	109	178	2	9	69	0.1304348
NODE_653_length_2965_cov_19.913468	109	178	4	3	69	0.0434783
NODE_653_length_2965_cov_19.913468	109	178	6	1	69	0.0144928
NODE_653_length_2965_cov_19.913468	109	178	8	2	69	0.0289855
NODE_653_length_2965_cov_19.913468	109	178	12	2	69	0.0289855
NODE_653_length_2965_cov_19.913468	109	178	0	52	69	0.7536232
NODE_653_length_2965_cov_19.913468	109	178	2	9	69	0.1304348
NODE_653_length_2965_cov_19.913468	109	178	4	3	69	0.0434783
NODE_653_length_2965_cov_19.913468	109	178	6	1	69	0.0144928
NODE_653_length_2965_cov_19.913468	109	178	8	2	69	0.0289855
NODE_653_length_2965_cov_19.913468	109	178	12	2	69	0.0289855
NODE_653_length_2965_cov_19.913468	2298	2378	0	49	80	0.6125000
NODE_653_length_2965_cov_19.913468	2298	2378	2	31	80	0.3875000
NODE_653_length_2965_cov_19.913468	2351	2431	0	80	80	1.0000000
NODE_653_length_2965_cov_19.913468	2427	2507	0	17	80	0.2125000
NODE_653_length_2965_cov_19.913468	2427	2507	2	63	80	0.7875000
NODE_653_length_2965_cov_19.913468	2480	2560	0	23	80	0.2875000
NODE_653_length_2965_cov_19.913468	2480	2560	1	1	80	0.0125000
NODE_653_length_2965_cov_19.913468	2480	2560	2	56	80	0.7000000
NODE_656_length_2960_cov_35.741699	459	539	0	80	80	1.0000000
NODE_656_length_2960_cov_35.741699	512	592	0	80	80	1.0000000
NODE_659_length_2951_cov_7.195652	1100	1141	166	1	41	0.0243902
NODE_659_length_2951_cov_7.195652	1100	1141	168	1	41	0.0243902
NODE_659_length_2951_cov_7.195652	1100	1141	170	1	41	0.0243902
NODE_659_length_2951_cov_7.195652	1100	1141	173	1	41	0.0243902
NODE_659_length_2951_cov_7.195652	1100	1141	174	1	41	0.0243902
NODE_659_length_2951_cov_7.195652	1100	1141	181	1	41	0.0243902
NODE_659_length_2951_cov_7.195652	1100	1141	185	2	41	0.0487805
NODE_659_length_2951_cov_7.195652	1100	1141	191	2	41	0.0487805
NODE_659_length_2951_cov_7.195652	1100	1141	193	1	41	0.0243902
NODE_659_length_2951_cov_7.195652	1100	1141	195	1	41	0.0243902
NODE_659_length_2951_cov_7.195652	1100	1141	198	1	41	0.0243902
NODE_659_length_2951_cov_7.195652	1100	1141	202	1	41	0.0243902
NODE_659_length_2951_cov_7.195652	1100	1141	203	1	41	0.0243902
NODE_659_length_2951_cov_7.195652	1100	1141	207	3	41	0.0731707
NODE_659_length_2951_cov_7.195652	1100	1141	210	1	41	0.0243902
NODE_659_length_2951_cov_7.195652	1100	1141	212	3	41	0.0731707
NODE_659_length_2951_cov_7.195652	1100	1141	215	2	41	0.0487805
NODE_659_length_2951_cov_7.195652	1100	1141	216	1	41	0.0243902
NODE_659_length_2951_cov_7.195652	1100	1141	222	2	41	0.0487805
NODE_659_length_2951_cov_7.195652	1100	1141	223	3	41	0.0731707
NODE_659_length_2951_cov_7.195652	1100	1141	224	2	41	0.0487805
NODE_659_length_2951_cov_7.195652	1100	1141	227	1	41	0.0243902
NODE_659_length_2951_cov_7.195652	1100	1141	228	3	41	0.0731707
NODE_659_length_2951_cov_7.195652	1100	1141	229	1	41	0.0243902
NODE_659_length_2951_cov_7.195652	1100	1141	230	1	41	0.0243902
NODE_659_length_2951_cov_7.195652	1100	1141	231	1	41	0.0243902
NODE_659_length_2951_cov_7.195652	1100	1141	233	1	41	0.0243902
NODE_659_length_2951_cov_7.195652	1100	1141	239	1	41	0.0243902
NODE_665_length_2935_cov_37.693230	1492	1572	44	1	80	0.0125000
NODE_665_length_2935_cov_37.693230	1492	1572	46	1	80	0.0125000
NODE_665_length_2935_cov_37.693230	1492	1572	48	1	80	0.0125000
NODE_665_length_2935_cov_37.693230	1492	1572	54	1	80	0.0125000
NODE_665_length_2935_cov_37.693230	1492	1572	60	3	80	0.0375000
NODE_665_length_2935_cov_37.693230	1492	1572	64	1	80	0.0125000
NODE_665_length_2935_cov_37.693230	1492	1572	66	3	80	0.0375000
NODE_665_length_2935_cov_37.693230	1492	1572	68	5	80	0.0625000
NODE_665_length_2935_cov_37.693230	1492	1572	70	6	80	0.0750000
NODE_665_length_2935_cov_37.693230	1492	1572	72	2	80	0.0250000
NODE_665_length_2935_cov_37.693230	1492	1572	74	3	80	0.0375000
NODE_665_length_2935_cov_37.693230	1492	1572	76	31	80	0.3875000
NODE_665_length_2935_cov_37.693230	1492	1572	77	1	80	0.0125000
NODE_665_length_2935_cov_37.693230	1492	1572	78	21	80	0.2625000
NODE_665_length_2935_cov_37.693230	1534	1589	58	3	55	0.0545455
NODE_665_length_2935_cov_37.693230	1534	1589	60	1	55	0.0181818
NODE_665_length_2935_cov_37.693230	1534	1589	62	1	55	0.0181818
NODE_665_length_2935_cov_37.693230	1534	1589	64	3	55	0.0545455
NODE_665_length_2935_cov_37.693230	1534	1589	66	1	55	0.0181818
NODE_665_length_2935_cov_37.693230	1534	1589	68	5	55	0.0909091
NODE_665_length_2935_cov_37.693230	1534	1589	70	4	55	0.0727273
NODE_665_length_2935_cov_37.693230	1534	1589	72	1	55	0.0181818
NODE_665_length_2935_cov_37.693230	1534	1589	74	1	55	0.0181818
NODE_665_length_2935_cov_37.693230	1534	1589	76	31	55	0.5636364
NODE_665_length_2935_cov_37.693230	1534	1589	78	4	55	0.0727273
NODE_665_length_2935_cov_37.693230	1545	1619	15	1	74	0.0135135
NODE_665_length_2935_cov_37.693230	1545	1619	16	1	74	0.0135135
NODE_665_length_2935_cov_37.693230	1545	1619	22	2	74	0.0270270
NODE_665_length_2935_cov_37.693230	1545	1619	24	2	74	0.0270270
NODE_665_length_2935_cov_37.693230	1545	1619	26	2	74	0.0270270
NODE_665_length_2935_cov_37.693230	1545	1619	28	4	74	0.0540541
NODE_665_length_2935_cov_37.693230	1545	1619	32	1	74	0.0135135
NODE_665_length_2935_cov_37.693230	1545	1619	36	2	74	0.0270270
NODE_665_length_2935_cov_37.693230	1545	1619	40	3	74	0.0405405
NODE_665_length_2935_cov_37.693230	1545	1619	42	3	74	0.0405405
NODE_665_length_2935_cov_37.693230	1545	1619	44	2	74	0.0270270
NODE_665_length_2935_cov_37.693230	1545	1619	46	1	74	0.0135135
NODE_665_length_2935_cov_37.693230	1545	1619	48	3	74	0.0405405
NODE_665_length_2935_cov_37.693230	1545	1619	50	1	74	0.0135135
NODE_665_length_2935_cov_37.693230	1545	1619	56	2	74	0.0270270
NODE_665_length_2935_cov_37.693230	1545	1619	58	3	74	0.0405405
NODE_665_length_2935_cov_37.693230	1545	1619	60	1	74	0.0135135
NODE_665_length_2935_cov_37.693230	1545	1619	62	1	74	0.0135135
NODE_665_length_2935_cov_37.693230	1545	1619	64	3	74	0.0405405
NODE_665_length_2935_cov_37.693230	1545	1619	66	1	74	0.0135135
NODE_665_length_2935_cov_37.693230	1545	1619	68	5	74	0.0675676
NODE_665_length_2935_cov_37.693230	1545	1619	70	4	74	0.0540541
NODE_665_length_2935_cov_37.693230	1545	1619	72	1	74	0.0135135
NODE_665_length_2935_cov_37.693230	1545	1619	74	1	74	0.0135135
NODE_665_length_2935_cov_37.693230	1545	1619	76	24	74	0.3243243
NODE_665_length_2935_cov_37.693230	1625	1701	0	75	76	0.9868421
NODE_665_length_2935_cov_37.693230	1625	1701	2	1	76	0.0131579
NODE_665_length_2935_cov_37.693230	2863	2906	4	43	43	1.0000000
NODE_675_length_2913_cov_4.376688	2664	2739	0	38	75	0.5066667
NODE_675_length_2913_cov_4.376688	2664	2739	2	37	75	0.4933333
NODE_675_length_2913_cov_4.376688	2664	2723	0	22	59	0.3728814
NODE_675_length_2913_cov_4.376688	2664	2723	2	37	59	0.6271186
NODE_675_length_2913_cov_4.376688	2664	2739	0	38	75	0.5066667
NODE_675_length_2913_cov_4.376688	2664	2739	2	37	75	0.4933333
NODE_675_length_2913_cov_4.376688	2664	2739	0	38	75	0.5066667
NODE_675_length_2913_cov_4.376688	2664	2739	2	37	75	0.4933333
NODE_675_length_2913_cov_4.376688	2673	2739	0	38	66	0.5757576
NODE_675_length_2913_cov_4.376688	2673	2739	2	28	66	0.4242424
NODE_675_length_2913_cov_4.376688	2717	2780	0	24	63	0.3809524
NODE_675_length_2913_cov_4.376688	2717	2780	2	2	63	0.0317460
NODE_675_length_2913_cov_4.376688	2717	2780	4	37	63	0.5873016
NODE_675_length_2913_cov_4.376688	2745	2778	4	33	33	1.0000000
NODE_677_length_2909_cov_71.975089	2090	2174	281	1	84	0.0119048
NODE_677_length_2909_cov_71.975089	2090	2174	282	1	84	0.0119048
NODE_677_length_2909_cov_71.975089	2090	2174	284	1	84	0.0119048
NODE_677_length_2909_cov_71.975089	2090	2174	285	1	84	0.0119048
NODE_677_length_2909_cov_71.975089	2090	2174	288	1	84	0.0119048
NODE_677_length_2909_cov_71.975089	2090	2174	300	1	84	0.0119048
NODE_677_length_2909_cov_71.975089	2090	2174	302	1	84	0.0119048
NODE_677_length_2909_cov_71.975089	2090	2174	303	2	84	0.0238095
NODE_677_length_2909_cov_71.975089	2090	2174	304	1	84	0.0119048
NODE_677_length_2909_cov_71.975089	2090	2174	307	1	84	0.0119048
NODE_677_length_2909_cov_71.975089	2090	2174	308	1	84	0.0119048
NODE_677_length_2909_cov_71.975089	2090	2174	309	1	84	0.0119048
NODE_677_length_2909_cov_71.975089	2090	2174	310	1	84	0.0119048
NODE_677_length_2909_cov_71.975089	2090	2174	311	3	84	0.0357143
NODE_677_length_2909_cov_71.975089	2090	2174	312	2	84	0.0238095
NODE_677_length_2909_cov_71.975089	2090	2174	313	2	84	0.0238095
NODE_677_length_2909_cov_71.975089	2090	2174	315	1	84	0.0119048
NODE_677_length_2909_cov_71.975089	2090	2174	316	2	84	0.0238095
NODE_677_length_2909_cov_71.975089	2090	2174	317	2	84	0.0238095
NODE_677_length_2909_cov_71.975089	2090	2174	318	2	84	0.0238095
NODE_677_length_2909_cov_71.975089	2090	2174	319	1	84	0.0119048
NODE_677_length_2909_cov_71.975089	2090	2174	321	1	84	0.0119048
NODE_677_length_2909_cov_71.975089	2090	2174	323	2	84	0.0238095
NODE_677_length_2909_cov_71.975089	2090	2174	325	1	84	0.0119048
NODE_677_length_2909_cov_71.975089	2090	2174	326	2	84	0.0238095
NODE_677_length_2909_cov_71.975089	2090	2174	327	3	84	0.0357143
NODE_677_length_2909_cov_71.975089	2090	2174	331	1	84	0.0119048
NODE_677_length_2909_cov_71.975089	2090	2174	332	1	84	0.0119048
NODE_677_length_2909_cov_71.975089	2090	2174	336	1	84	0.0119048
NODE_677_length_2909_cov_71.975089	2090	2174	337	3	84	0.0357143
NODE_677_length_2909_cov_71.975089	2090	2174	338	1	84	0.0119048
NODE_677_length_2909_cov_71.975089	2090	2174	341	1	84	0.0119048
NODE_677_length_2909_cov_71.975089	2090	2174	342	1	84	0.0119048
NODE_677_length_2909_cov_71.975089	2090	2174	346	2	84	0.0238095
NODE_677_length_2909_cov_71.975089	2090	2174	349	1	84	0.0119048
NODE_677_length_2909_cov_71.975089	2090	2174	355	1	84	0.0119048
NODE_677_length_2909_cov_71.975089	2090	2174	356	2	84	0.0238095
NODE_677_length_2909_cov_71.975089	2090	2174	365	1	84	0.0119048
NODE_677_length_2909_cov_71.975089	2090	2174	367	1	84	0.0119048
NODE_677_length_2909_cov_71.975089	2090	2174	375	1	84	0.0119048
NODE_677_length_2909_cov_71.975089	2090	2174	387	1	84	0.0119048
NODE_677_length_2909_cov_71.975089	2090	2174	388	2	84	0.0238095
NODE_677_length_2909_cov_71.975089	2090	2174	402	1	84	0.0119048
NODE_677_length_2909_cov_71.975089	2090	2174	407	1	84	0.0119048
NODE_677_length_2909_cov_71.975089	2090	2174	422	1	84	0.0119048
NODE_677_length_2909_cov_71.975089	2090	2174	442	1	84	0.0119048
NODE_677_length_2909_cov_71.975089	2090	2174	446	1	84	0.0119048
NODE_677_length_2909_cov_71.975089	2090	2174	450	1	84	0.0119048
NODE_677_length_2909_cov_71.975089	2090	2174	451	1	84	0.0119048
NODE_677_length_2909_cov_71.975089	2090	2174	452	2	84	0.0238095
NODE_677_length_2909_cov_71.975089	2090	2174	457	1	84	0.0119048
NODE_677_length_2909_cov_71.975089	2090	2174	460	1	84	0.0119048
NODE_677_length_2909_cov_71.975089	2090	2174	465	1	84	0.0119048
NODE_677_length_2909_cov_71.975089	2090	2174	476	1	84	0.0119048
NODE_677_length_2909_cov_71.975089	2090	2174	489	1	84	0.0119048
NODE_677_length_2909_cov_71.975089	2090	2174	494	1	84	0.0119048
NODE_677_length_2909_cov_71.975089	2090	2174	499	1	84	0.0119048
NODE_677_length_2909_cov_71.975089	2090	2174	503	1	84	0.0119048
NODE_677_length_2909_cov_71.975089	2090	2174	506	1	84	0.0119048
NODE_677_length_2909_cov_71.975089	2090	2174	508	2	84	0.0238095
NODE_677_length_2909_cov_71.975089	2090	2174	510	1	84	0.0119048
NODE_677_length_2909_cov_71.975089	2090	2174	511	1	84	0.0119048
NODE_677_length_2909_cov_71.975089	2090	2174	512	2	84	0.0238095
NODE_677_length_2909_cov_71.975089	2090	2174	519	1	84	0.0119048
NODE_678_length_2908_cov_5.937344	2495	2575	0	80	80	1.0000000
NODE_678_length_2908_cov_5.937344	2548	2628	0	80	80	1.0000000
NODE_678_length_2908_cov_5.937344	2624	2704	0	31	80	0.3875000
NODE_678_length_2908_cov_5.937344	2624	2704	4	49	80	0.6125000
NODE_678_length_2908_cov_5.937344	2677	2757	4	80	80	1.0000000
NODE_679_length_2905_cov_12.777619	2358	2419	2	5	61	0.0819672
NODE_679_length_2905_cov_12.777619	2358	2419	4	53	61	0.8688524
NODE_679_length_2905_cov_12.777619	2358	2419	7	3	61	0.0491803
NODE_679_length_2905_cov_12.777619	2358	2419	2	5	61	0.0819672
NODE_679_length_2905_cov_12.777619	2358	2419	4	53	61	0.8688524
NODE_679_length_2905_cov_12.777619	2358	2419	7	3	61	0.0491803
NODE_679_length_2905_cov_12.777619	2358	2419	2	5	61	0.0819672
NODE_679_length_2905_cov_12.777619	2358	2419	4	53	61	0.8688524
NODE_679_length_2905_cov_12.777619	2358	2419	7	3	61	0.0491803
NODE_679_length_2905_cov_12.777619	2392	2472	0	39	80	0.4875000
NODE_679_length_2905_cov_12.777619	2392	2472	2	19	80	0.2375000
NODE_679_length_2905_cov_12.777619	2392	2472	4	22	80	0.2750000
NODE_680_length_2903_cov_5.474322	2423	2464	16	6	41	0.1463415
NODE_680_length_2903_cov_5.474322	2423	2464	18	2	41	0.0487805
NODE_680_length_2903_cov_5.474322	2423	2464	19	2	41	0.0487805
NODE_680_length_2903_cov_5.474322	2423	2464	20	31	41	0.7560976
NODE_684_length_2898_cov_5.786352	0	74	0	74	74	1.0000000
NODE_684_length_2898_cov_5.786352	47	124	0	77	77	1.0000000
NODE_686_length_2895_cov_8.519313	869	949	2	67	80	0.8375000
NODE_686_length_2895_cov_8.519313	869	949	6	13	80	0.1625000
NODE_686_length_2895_cov_8.519313	922	1002	2	14	80	0.1750000
NODE_686_length_2895_cov_8.519313	922	1002	4	33	80	0.4125000
NODE_686_length_2895_cov_8.519313	922	1002	6	33	80	0.4125000
NODE_688_length_2894_cov_2.036136	2677	2757	10	7	80	0.0875000
NODE_688_length_2894_cov_2.036136	2677	2757	12	8	80	0.1000000
NODE_688_length_2894_cov_2.036136	2677	2757	14	16	80	0.2000000
NODE_688_length_2894_cov_2.036136	2677	2757	16	19	80	0.2375000
NODE_688_length_2894_cov_2.036136	2677	2757	18	11	80	0.1375000
NODE_688_length_2894_cov_2.036136	2677	2757	20	19	80	0.2375000
NODE_689_length_2891_cov_7.938037	193	275	2	5	82	0.0609756
NODE_689_length_2891_cov_7.938037	193	275	4	7	82	0.0853659
NODE_689_length_2891_cov_7.938037	193	275	5	6	82	0.0731707
NODE_689_length_2891_cov_7.938037	193	275	6	22	82	0.2682927
NODE_689_length_2891_cov_7.938037	193	275	10	13	82	0.1585366
NODE_689_length_2891_cov_7.938037	193	275	12	9	82	0.1097561
NODE_689_length_2891_cov_7.938037	193	275	17	3	82	0.0365854
NODE_689_length_2891_cov_7.938037	193	275	20	1	82	0.0121951
NODE_689_length_2891_cov_7.938037	193	275	21	6	82	0.0731707
NODE_689_length_2891_cov_7.938037	193	275	25	3	82	0.0365854
NODE_689_length_2891_cov_7.938037	193	275	27	7	82	0.0853659
NODE_691_length_2889_cov_11.426882	407	487	0	80	80	1.0000000
NODE_691_length_2889_cov_11.426882	460	540	0	31	80	0.3875000
NODE_691_length_2889_cov_11.426882	460	540	2	49	80	0.6125000
NODE_691_length_2889_cov_11.426882	1006	1086	10	1	80	0.0125000
NODE_691_length_2889_cov_11.426882	1006	1086	12	7	80	0.0875000
NODE_691_length_2889_cov_11.426882	1006	1086	14	1	80	0.0125000
NODE_691_length_2889_cov_11.426882	1006	1086	16	4	80	0.0500000
NODE_691_length_2889_cov_11.426882	1006	1086	18	4	80	0.0500000
NODE_691_length_2889_cov_11.426882	1006	1086	20	22	80	0.2750000
NODE_691_length_2889_cov_11.426882	1006	1086	24	4	80	0.0500000
NODE_691_length_2889_cov_11.426882	1006	1086	26	19	80	0.2375000
NODE_691_length_2889_cov_11.426882	1006	1086	28	3	80	0.0375000
NODE_691_length_2889_cov_11.426882	1006	1086	30	8	80	0.1000000
NODE_691_length_2889_cov_11.426882	1006	1086	32	5	80	0.0625000
NODE_691_length_2889_cov_11.426882	1006	1086	34	2	80	0.0250000
NODE_691_length_2889_cov_11.426882	1007	1086	10	1	79	0.0126582
NODE_691_length_2889_cov_11.426882	1007	1086	12	7	79	0.0886076
NODE_691_length_2889_cov_11.426882	1007	1086	14	1	79	0.0126582
NODE_691_length_2889_cov_11.426882	1007	1086	16	4	79	0.0506329
NODE_691_length_2889_cov_11.426882	1007	1086	18	4	79	0.0506329
NODE_691_length_2889_cov_11.426882	1007	1086	20	22	79	0.2784810
NODE_691_length_2889_cov_11.426882	1007	1086	24	4	79	0.0506329
NODE_691_length_2889_cov_11.426882	1007	1086	26	19	79	0.2405063
NODE_691_length_2889_cov_11.426882	1007	1086	28	3	79	0.0379747
NODE_691_length_2889_cov_11.426882	1007	1086	30	8	79	0.1012658
NODE_691_length_2889_cov_11.426882	1007	1086	32	5	79	0.0632911
NODE_691_length_2889_cov_11.426882	1007	1086	34	1	79	0.0126582
NODE_691_length_2889_cov_11.426882	1059	1138	0	45	79	0.5696203
NODE_691_length_2889_cov_11.426882	1059	1138	2	2	79	0.0253165
NODE_691_length_2889_cov_11.426882	1059	1138	6	3	79	0.0379747
NODE_691_length_2889_cov_11.426882	1059	1138	8	2	79	0.0253165
NODE_691_length_2889_cov_11.426882	1059	1138	10	1	79	0.0126582
NODE_691_length_2889_cov_11.426882	1059	1138	12	7	79	0.0886076
NODE_691_length_2889_cov_11.426882	1059	1138	14	1	79	0.0126582
NODE_691_length_2889_cov_11.426882	1059	1138	16	4	79	0.0506329
NODE_691_length_2889_cov_11.426882	1059	1138	18	4	79	0.0506329
NODE_691_length_2889_cov_11.426882	1059	1138	20	10	79	0.1265823
NODE_691_length_2889_cov_11.426882	1059	1138	0	45	79	0.5696203
NODE_691_length_2889_cov_11.426882	1059	1138	2	2	79	0.0253165
NODE_691_length_2889_cov_11.426882	1059	1138	6	3	79	0.0379747
NODE_691_length_2889_cov_11.426882	1059	1138	8	2	79	0.0253165
NODE_691_length_2889_cov_11.426882	1059	1138	10	1	79	0.0126582
NODE_691_length_2889_cov_11.426882	1059	1138	12	7	79	0.0886076
NODE_691_length_2889_cov_11.426882	1059	1138	14	1	79	0.0126582
NODE_691_length_2889_cov_11.426882	1059	1138	16	4	79	0.0506329
NODE_691_length_2889_cov_11.426882	1059	1138	18	4	79	0.0506329
NODE_691_length_2889_cov_11.426882	1059	1138	20	10	79	0.1265823
NODE_693_length_2888_cov_3.789172	992	1072	2	43	80	0.5375000
NODE_693_length_2888_cov_3.789172	992	1072	4	5	80	0.0625000
NODE_693_length_2888_cov_3.789172	992	1072	6	19	80	0.2375000
NODE_693_length_2888_cov_3.789172	992	1072	10	12	80	0.1500000
NODE_693_length_2888_cov_3.789172	992	1072	12	1	80	0.0125000
NODE_693_length_2888_cov_3.789172	1045	1087	0	1	42	0.0238095
NODE_693_length_2888_cov_3.789172	1045	1087	2	41	42	0.9761904
NODE_697_length_2878_cov_6.277798	2712	2781	2	36	69	0.5217391
NODE_697_length_2878_cov_6.277798	2712	2781	4	18	69	0.2608696
NODE_697_length_2878_cov_6.277798	2712	2781	6	15	69	0.2173913
NODE_703_length_2862_cov_9.060803	2409	2489	0	80	80	1.0000000
NODE_703_length_2862_cov_9.060803	2462	2542	0	80	80	1.0000000
NODE_712_length_2840_cov_2.079533	1660	1740	0	13	80	0.1625000
NODE_712_length_2840_cov_2.079533	1660	1740	2	67	80	0.8375000
NODE_713_length_2839_cov_16.762044	327	402	0	75	75	1.0000000
NODE_713_length_2839_cov_16.762044	380	468	0	88	88	1.0000000
NODE_713_length_2839_cov_16.762044	1021	1101	0	80	80	1.0000000
NODE_713_length_2839_cov_16.762044	1074	1154	0	80	80	1.0000000
NODE_714_length_2835_cov_29.691520	1552	1581	206	4	29	0.1379310
NODE_714_length_2835_cov_29.691520	1552	1581	207	1	29	0.0344828
NODE_714_length_2835_cov_29.691520	1552	1581	209	5	29	0.1724138
NODE_714_length_2835_cov_29.691520	1552	1581	219	1	29	0.0344828
NODE_714_length_2835_cov_29.691520	1552	1581	223	1	29	0.0344828
NODE_714_length_2835_cov_29.691520	1552	1581	231	1	29	0.0344828
NODE_714_length_2835_cov_29.691520	1552	1581	234	1	29	0.0344828
NODE_714_length_2835_cov_29.691520	1552	1581	243	1	29	0.0344828
NODE_714_length_2835_cov_29.691520	1552	1581	245	1	29	0.0344828
NODE_714_length_2835_cov_29.691520	1552	1581	247	1	29	0.0344828
NODE_714_length_2835_cov_29.691520	1552	1581	251	1	29	0.0344828
NODE_714_length_2835_cov_29.691520	1552	1581	253	1	29	0.0344828
NODE_714_length_2835_cov_29.691520	1552	1581	255	2	29	0.0689655
NODE_714_length_2835_cov_29.691520	1552	1581	257	1	29	0.0344828
NODE_714_length_2835_cov_29.691520	1552	1581	259	6	29	0.2068966
NODE_714_length_2835_cov_29.691520	1552	1581	261	1	29	0.0344828
NODE_714_length_2835_cov_29.691520	1554	1629	41	2	75	0.0266667
NODE_714_length_2835_cov_29.691520	1554	1629	47	1	75	0.0133333
NODE_714_length_2835_cov_29.691520	1554	1629	57	1	75	0.0133333
NODE_714_length_2835_cov_29.691520	1554	1629	59	1	75	0.0133333
NODE_714_length_2835_cov_29.691520	1554	1629	61	1	75	0.0133333
NODE_714_length_2835_cov_29.691520	1554	1629	63	1	75	0.0133333
NODE_714_length_2835_cov_29.691520	1554	1629	69	1	75	0.0133333
NODE_714_length_2835_cov_29.691520	1554	1629	71	2	75	0.0266667
NODE_714_length_2835_cov_29.691520	1554	1629	79	1	75	0.0133333
NODE_714_length_2835_cov_29.691520	1554	1629	84	1	75	0.0133333
NODE_714_length_2835_cov_29.691520	1554	1629	88	1	75	0.0133333
NODE_714_length_2835_cov_29.691520	1554	1629	94	1	75	0.0133333
NODE_714_length_2835_cov_29.691520	1554	1629	95	1	75	0.0133333
NODE_714_length_2835_cov_29.691520	1554	1629	101	1	75	0.0133333
NODE_714_length_2835_cov_29.691520	1554	1629	110	1	75	0.0133333
NODE_714_length_2835_cov_29.691520	1554	1629	117	2	75	0.0266667
NODE_714_length_2835_cov_29.691520	1554	1629	122	1	75	0.0133333
NODE_714_length_2835_cov_29.691520	1554	1629	124	1	75	0.0133333
NODE_714_length_2835_cov_29.691520	1554	1629	126	1	75	0.0133333
NODE_714_length_2835_cov_29.691520	1554	1629	135	1	75	0.0133333
NODE_714_length_2835_cov_29.691520	1554	1629	139	1	75	0.0133333
NODE_714_length_2835_cov_29.691520	1554	1629	147	2	75	0.0266667
NODE_714_length_2835_cov_29.691520	1554	1629	148	3	75	0.0400000
NODE_714_length_2835_cov_29.691520	1554	1629	152	1	75	0.0133333
NODE_714_length_2835_cov_29.691520	1554	1629	154	1	75	0.0133333
NODE_714_length_2835_cov_29.691520	1554	1629	157	1	75	0.0133333
NODE_714_length_2835_cov_29.691520	1554	1629	159	1	75	0.0133333
NODE_714_length_2835_cov_29.691520	1554	1629	163	1	75	0.0133333
NODE_714_length_2835_cov_29.691520	1554	1629	168	1	75	0.0133333
NODE_714_length_2835_cov_29.691520	1554	1629	170	1	75	0.0133333
NODE_714_length_2835_cov_29.691520	1554	1629	175	1	75	0.0133333
NODE_714_length_2835_cov_29.691520	1554	1629	176	1	75	0.0133333
NODE_714_length_2835_cov_29.691520	1554	1629	178	1	75	0.0133333
NODE_714_length_2835_cov_29.691520	1554	1629	188	1	75	0.0133333
NODE_714_length_2835_cov_29.691520	1554	1629	193	1	75	0.0133333
NODE_714_length_2835_cov_29.691520	1554	1629	203	4	75	0.0533333
NODE_714_length_2835_cov_29.691520	1554	1629	204	2	75	0.0266667
NODE_714_length_2835_cov_29.691520	1554	1629	206	5	75	0.0666667
NODE_714_length_2835_cov_29.691520	1554	1629	207	1	75	0.0133333
NODE_714_length_2835_cov_29.691520	1554	1629	209	5	75	0.0666667
NODE_714_length_2835_cov_29.691520	1554	1629	219	1	75	0.0133333
NODE_714_length_2835_cov_29.691520	1554	1629	223	1	75	0.0133333
NODE_714_length_2835_cov_29.691520	1554	1629	231	1	75	0.0133333
NODE_714_length_2835_cov_29.691520	1554	1629	234	1	75	0.0133333
NODE_714_length_2835_cov_29.691520	1554	1629	243	1	75	0.0133333
NODE_714_length_2835_cov_29.691520	1554	1629	245	1	75	0.0133333
NODE_714_length_2835_cov_29.691520	1554	1629	247	1	75	0.0133333
NODE_714_length_2835_cov_29.691520	1554	1629	251	1	75	0.0133333
NODE_714_length_2835_cov_29.691520	1554	1629	253	1	75	0.0133333
NODE_714_length_2835_cov_29.691520	1554	1629	255	2	75	0.0266667
NODE_714_length_2835_cov_29.691520	1554	1629	257	1	75	0.0133333
NODE_714_length_2835_cov_29.691520	1554	1629	259	5	75	0.0666667
NODE_720_length_2825_cov_9.731108	487	567	2	78	80	0.9750000
NODE_720_length_2825_cov_9.731108	487	567	4	2	80	0.0250000
NODE_720_length_2825_cov_9.731108	540	620	0	4	80	0.0500000
NODE_720_length_2825_cov_9.731108	540	620	2	55	80	0.6875000
NODE_720_length_2825_cov_9.731108	540	620	4	21	80	0.2625000
NODE_726_length_2810_cov_2.844338	206	289	20	2	83	0.0240964
NODE_726_length_2810_cov_2.844338	206	289	22	1	83	0.0120482
NODE_726_length_2810_cov_2.844338	206	289	25	2	83	0.0240964
NODE_726_length_2810_cov_2.844338	206	289	29	2	83	0.0240964
NODE_726_length_2810_cov_2.844338	206	289	31	1	83	0.0120482
NODE_726_length_2810_cov_2.844338	206	289	33	1	83	0.0120482
NODE_726_length_2810_cov_2.844338	206	289	36	1	83	0.0120482
NODE_726_length_2810_cov_2.844338	206	289	38	2	83	0.0240964
NODE_726_length_2810_cov_2.844338	206	289	40	1	83	0.0120482
NODE_726_length_2810_cov_2.844338	206	289	41	2	83	0.0240964
NODE_726_length_2810_cov_2.844338	206	289	43	3	83	0.0361446
NODE_726_length_2810_cov_2.844338	206	289	44	6	83	0.0722892
NODE_726_length_2810_cov_2.844338	206	289	46	7	83	0.0843373
NODE_726_length_2810_cov_2.844338	206	289	47	3	83	0.0361446
NODE_726_length_2810_cov_2.844338	206	289	53	3	83	0.0361446
NODE_726_length_2810_cov_2.844338	206	289	54	14	83	0.1686747
NODE_726_length_2810_cov_2.844338	206	289	56	4	83	0.0481928
NODE_726_length_2810_cov_2.844338	206	289	60	6	83	0.0722892
NODE_726_length_2810_cov_2.844338	206	289	61	5	83	0.0602410
NODE_726_length_2810_cov_2.844338	206	289	62	2	83	0.0240964
NODE_726_length_2810_cov_2.844338	206	289	64	1	83	0.0120482
NODE_726_length_2810_cov_2.844338	206	289	67	3	83	0.0361446
NODE_726_length_2810_cov_2.844338	206	289	69	1	83	0.0120482
NODE_726_length_2810_cov_2.844338	206	289	71	4	83	0.0481928
NODE_726_length_2810_cov_2.844338	206	289	73	1	83	0.0120482
NODE_726_length_2810_cov_2.844338	206	289	75	1	83	0.0120482
NODE_726_length_2810_cov_2.844338	206	289	79	1	83	0.0120482
NODE_726_length_2810_cov_2.844338	206	289	87	2	83	0.0240964
NODE_726_length_2810_cov_2.844338	206	289	91	1	83	0.0120482
NODE_728_length_2808_cov_2.867110	140	163	11	2	23	0.0869565
NODE_728_length_2808_cov_2.867110	140	163	13	4	23	0.1739130
NODE_728_length_2808_cov_2.867110	140	163	15	17	23	0.7391304
NODE_729_length_2807_cov_8.423191	125	205	0	2	80	0.0250000
NODE_729_length_2807_cov_8.423191	125	205	2	78	80	0.9750000
NODE_729_length_2807_cov_8.423191	178	258	0	3	80	0.0375000
NODE_729_length_2807_cov_8.423191	178	258	2	77	80	0.9625000
NODE_729_length_2807_cov_8.423191	2451	2515	0	64	64	1.0000000
NODE_735_length_2801_cov_26.131384	461	521	2	23	60	0.3833333
NODE_735_length_2801_cov_26.131384	461	521	4	37	60	0.6166667
NODE_735_length_2801_cov_26.131384	494	574	2	65	80	0.8125000
NODE_735_length_2801_cov_26.131384	494	574	4	15	80	0.1875000
NODE_735_length_2801_cov_26.131384	1536	1596	28	1	60	0.0166667
NODE_735_length_2801_cov_26.131384	1536	1596	32	2	60	0.0333333
NODE_735_length_2801_cov_26.131384	1536	1596	34	2	60	0.0333333
NODE_735_length_2801_cov_26.131384	1536	1596	36	3	60	0.0500000
NODE_735_length_2801_cov_26.131384	1536	1596	41	4	60	0.0666667
NODE_735_length_2801_cov_26.131384	1536	1596	49	1	60	0.0166667
NODE_735_length_2801_cov_26.131384	1536	1596	51	1	60	0.0166667
NODE_735_length_2801_cov_26.131384	1536	1596	57	1	60	0.0166667
NODE_735_length_2801_cov_26.131384	1536	1596	59	1	60	0.0166667
NODE_735_length_2801_cov_26.131384	1536	1596	69	1	60	0.0166667
NODE_735_length_2801_cov_26.131384	1536	1596	71	3	60	0.0500000
NODE_735_length_2801_cov_26.131384	1536	1596	73	1	60	0.0166667
NODE_735_length_2801_cov_26.131384	1536	1596	79	2	60	0.0333333
NODE_735_length_2801_cov_26.131384	1536	1596	85	2	60	0.0333333
NODE_735_length_2801_cov_26.131384	1536	1596	87	1	60	0.0166667
NODE_735_length_2801_cov_26.131384	1536	1596	89	1	60	0.0166667
NODE_735_length_2801_cov_26.131384	1536	1596	91	1	60	0.0166667
NODE_735_length_2801_cov_26.131384	1536	1596	95	1	60	0.0166667
NODE_735_length_2801_cov_26.131384	1536	1596	100	2	60	0.0333333
NODE_735_length_2801_cov_26.131384	1536	1596	104	2	60	0.0333333
NODE_735_length_2801_cov_26.131384	1536	1596	106	1	60	0.0166667
NODE_735_length_2801_cov_26.131384	1536	1596	116	3	60	0.0500000
NODE_735_length_2801_cov_26.131384	1536	1596	120	6	60	0.1000000
NODE_735_length_2801_cov_26.131384	1536	1596	121	5	60	0.0833333
NODE_735_length_2801_cov_26.131384	1536	1596	122	1	60	0.0166667
NODE_735_length_2801_cov_26.131384	1536	1596	126	3	60	0.0500000
NODE_735_length_2801_cov_26.131384	1536	1596	133	2	60	0.0333333
NODE_735_length_2801_cov_26.131384	1536	1596	137	1	60	0.0166667
NODE_735_length_2801_cov_26.131384	1536	1596	140	2	60	0.0333333
NODE_735_length_2801_cov_26.131384	1536	1596	142	1	60	0.0166667
NODE_735_length_2801_cov_26.131384	1536	1596	146	2	60	0.0333333
NODE_735_length_2801_cov_26.131384	1815	1881	0	21	66	0.3181818
NODE_735_length_2801_cov_26.131384	1815	1881	2	45	66	0.6818182
NODE_735_length_2801_cov_26.131384	1854	1934	2	80	80	1.0000000
NODE_736_length_2801_cov_3.594375	2589	2645	3	12	56	0.2142857
NODE_736_length_2801_cov_3.594375	2589	2645	5	17	56	0.3035714
NODE_736_length_2801_cov_3.594375	2589	2645	7	14	56	0.2500000
NODE_736_length_2801_cov_3.594375	2589	2645	8	12	56	0.2142857
NODE_736_length_2801_cov_3.594375	2589	2645	10	1	56	0.0178571
NODE_738_length_2796_cov_94.511680	1090	1137	3	1	47	0.0212766
NODE_738_length_2796_cov_94.511680	1090	1137	5	3	47	0.0638298
NODE_738_length_2796_cov_94.511680	1090	1137	7	2	47	0.0425532
NODE_738_length_2796_cov_94.511680	1090	1137	9	1	47	0.0212766
NODE_738_length_2796_cov_94.511680	1090	1137	11	1	47	0.0212766
NODE_738_length_2796_cov_94.511680	1090	1137	15	3	47	0.0638298
NODE_738_length_2796_cov_94.511680	1090	1137	23	5	47	0.1063830
NODE_738_length_2796_cov_94.511680	1090	1137	27	1	47	0.0212766
NODE_738_length_2796_cov_94.511680	1090	1137	28	4	47	0.0851064
NODE_738_length_2796_cov_94.511680	1090	1137	34	1	47	0.0212766
NODE_738_length_2796_cov_94.511680	1090	1137	36	1	47	0.0212766
NODE_738_length_2796_cov_94.511680	1090	1137	38	2	47	0.0425532
NODE_738_length_2796_cov_94.511680	1090	1137	40	4	47	0.0851064
NODE_738_length_2796_cov_94.511680	1090	1137	42	2	47	0.0425532
NODE_738_length_2796_cov_94.511680	1090	1137	46	5	47	0.1063830
NODE_738_length_2796_cov_94.511680	1090	1137	50	1	47	0.0212766
NODE_738_length_2796_cov_94.511680	1090	1137	56	2	47	0.0425532
NODE_738_length_2796_cov_94.511680	1090	1137	68	1	47	0.0212766
NODE_738_length_2796_cov_94.511680	1090	1137	69	1	47	0.0212766
NODE_738_length_2796_cov_94.511680	1090	1137	71	1	47	0.0212766
NODE_738_length_2796_cov_94.511680	1090	1137	74	1	47	0.0212766
NODE_738_length_2796_cov_94.511680	1090	1137	77	1	47	0.0212766
NODE_738_length_2796_cov_94.511680	1090	1137	81	1	47	0.0212766
NODE_738_length_2796_cov_94.511680	1090	1137	86	2	47	0.0425532
NODE_738_length_2796_cov_94.511680	2717	2796	0	79	79	1.0000000
NODE_744_length_2791_cov_9.997028	310	390	0	80	80	1.0000000
NODE_744_length_2791_cov_9.997028	363	443	0	80	80	1.0000000
NODE_752_length_2778_cov_31.340799	2241	2321	0	13	80	0.1625000
NODE_752_length_2778_cov_31.340799	2241	2321	2	67	80	0.8375000
NODE_752_length_2778_cov_31.340799	2294	2374	0	26	80	0.3250000
NODE_752_length_2778_cov_31.340799	2294	2374	2	54	80	0.6750000
NODE_752_length_2778_cov_31.340799	2370	2450	0	46	80	0.5750000
NODE_752_length_2778_cov_31.340799	2370	2450	4	34	80	0.4250000
NODE_752_length_2778_cov_31.340799	2423	2503	4	80	80	1.0000000
NODE_752_length_2778_cov_31.340799	2564	2620	0	56	56	1.0000000
NODE_758_length_2767_cov_12.450150	1941	2021	0	80	80	1.0000000
NODE_758_length_2767_cov_12.450150	1994	2074	0	80	80	1.0000000
NODE_767_length_2745_cov_5.322751	511	583	0	40	72	0.5555556
NODE_767_length_2745_cov_5.322751	511	583	2	32	72	0.4444444
NODE_777_length_2720_cov_25.561618	2213	2293	2	6	80	0.0750000
NODE_777_length_2720_cov_25.561618	2213	2293	6	14	80	0.1750000
NODE_777_length_2720_cov_25.561618	2213	2293	8	60	80	0.7500000
NODE_777_length_2720_cov_25.561618	2266	2346	0	12	80	0.1500000
NODE_777_length_2720_cov_25.561618	2266	2346	4	3	80	0.0375000
NODE_777_length_2720_cov_25.561618	2266	2346	6	9	80	0.1125000
NODE_777_length_2720_cov_25.561618	2266	2346	8	56	80	0.7000000
NODE_782_length_2716_cov_39.885747	715	795	10	5	80	0.0625000
NODE_782_length_2716_cov_39.885747	715	795	12	5	80	0.0625000
NODE_782_length_2716_cov_39.885747	715	795	14	15	80	0.1875000
NODE_782_length_2716_cov_39.885747	715	795	16	24	80	0.3000000
NODE_782_length_2716_cov_39.885747	715	795	18	31	80	0.3875000
NODE_782_length_2716_cov_39.885747	768	848	2	47	80	0.5875000
NODE_782_length_2716_cov_39.885747	768	848	4	2	80	0.0250000
NODE_782_length_2716_cov_39.885747	768	848	6	4	80	0.0500000
NODE_782_length_2716_cov_39.885747	768	848	10	5	80	0.0625000
NODE_782_length_2716_cov_39.885747	768	848	12	5	80	0.0625000
NODE_782_length_2716_cov_39.885747	768	848	16	16	80	0.2000000
NODE_782_length_2716_cov_39.885747	768	848	18	1	80	0.0125000
NODE_782_length_2716_cov_39.885747	844	924	0	31	80	0.3875000
NODE_782_length_2716_cov_39.885747	844	924	2	49	80	0.6125000
NODE_782_length_2716_cov_39.885747	897	977	0	80	80	1.0000000
NODE_785_length_2710_cov_10.896974	2410	2446	6	17	36	0.4722222
NODE_785_length_2710_cov_10.896974	2410	2446	8	19	36	0.5277778
NODE_785_length_2710_cov_10.896974	2419	2499	6	8	80	0.1000000
NODE_785_length_2710_cov_10.896974	2419	2499	8	38	80	0.4750000
NODE_785_length_2710_cov_10.896974	2419	2499	10	9	80	0.1125000
NODE_785_length_2710_cov_10.896974	2419	2499	12	7	80	0.0875000
NODE_785_length_2710_cov_10.896974	2419	2499	14	6	80	0.0750000
NODE_785_length_2710_cov_10.896974	2419	2499	16	3	80	0.0375000
NODE_785_length_2710_cov_10.896974	2419	2499	18	9	80	0.1125000
NODE_788_length_2708_cov_25.097355	2289	2369	0	80	80	1.0000000
NODE_788_length_2708_cov_25.097355	2342	2422	0	80	80	1.0000000
NODE_789_length_2708_cov_14.569950	18	98	100	1	80	0.0125000
NODE_789_length_2708_cov_14.569950	18	98	102	3	80	0.0375000
NODE_789_length_2708_cov_14.569950	18	98	105	1	80	0.0125000
NODE_789_length_2708_cov_14.569950	18	98	106	1	80	0.0125000
NODE_789_length_2708_cov_14.569950	18	98	120	1	80	0.0125000
NODE_789_length_2708_cov_14.569950	18	98	122	2	80	0.0250000
NODE_789_length_2708_cov_14.569950	18	98	126	1	80	0.0125000
NODE_789_length_2708_cov_14.569950	18	98	135	1	80	0.0125000
NODE_789_length_2708_cov_14.569950	18	98	138	3	80	0.0375000
NODE_789_length_2708_cov_14.569950	18	98	144	22	80	0.2750000
NODE_789_length_2708_cov_14.569950	18	98	146	40	80	0.5000000
NODE_789_length_2708_cov_14.569950	18	98	147	4	80	0.0500000
NODE_789_length_2708_cov_14.569950	71	134	26	1	63	0.0158730
NODE_789_length_2708_cov_14.569950	71	134	44	1	63	0.0158730
NODE_789_length_2708_cov_14.569950	71	134	57	1	63	0.0158730
NODE_789_length_2708_cov_14.569950	71	134	71	1	63	0.0158730
NODE_789_length_2708_cov_14.569950	71	134	73	1	63	0.0158730
NODE_789_length_2708_cov_14.569950	71	134	75	1	63	0.0158730
NODE_789_length_2708_cov_14.569950	71	134	87	1	63	0.0158730
NODE_789_length_2708_cov_14.569950	71	134	102	1	63	0.0158730
NODE_789_length_2708_cov_14.569950	71	134	104	3	63	0.0476190
NODE_789_length_2708_cov_14.569950	71	134	112	1	63	0.0158730
NODE_789_length_2708_cov_14.569950	71	134	113	4	63	0.0634921
NODE_789_length_2708_cov_14.569950	71	134	115	1	63	0.0158730
NODE_789_length_2708_cov_14.569950	71	134	117	1	63	0.0158730
NODE_789_length_2708_cov_14.569950	71	134	121	1	63	0.0158730
NODE_789_length_2708_cov_14.569950	71	134	127	1	63	0.0158730
NODE_789_length_2708_cov_14.569950	71	134	131	4	63	0.0634921
NODE_789_length_2708_cov_14.569950	71	134	135	2	63	0.0317460
NODE_789_length_2708_cov_14.569950	71	134	139	1	63	0.0158730
NODE_789_length_2708_cov_14.569950	71	134	143	1	63	0.0158730
NODE_789_length_2708_cov_14.569950	71	134	145	3	63	0.0476190
NODE_789_length_2708_cov_14.569950	71	134	146	32	63	0.5079365
NODE_797_length_2691_cov_35.457948	401	481	0	3	80	0.0375000
NODE_797_length_2691_cov_35.457948	401	481	2	37	80	0.4625000
NODE_797_length_2691_cov_35.457948	401	481	4	19	80	0.2375000
NODE_797_length_2691_cov_35.457948	401	481	6	21	80	0.2625000
NODE_797_length_2691_cov_35.457948	454	534	0	2	80	0.0250000
NODE_797_length_2691_cov_35.457948	454	534	2	22	80	0.2750000
NODE_797_length_2691_cov_35.457948	454	534	4	35	80	0.4375000
NODE_797_length_2691_cov_35.457948	454	534	6	21	80	0.2625000
NODE_803_length_2684_cov_17.345068	146	194	0	1	48	0.0208333
NODE_803_length_2684_cov_17.345068	146	194	2	1	48	0.0208333
NODE_803_length_2684_cov_17.345068	146	194	4	3	48	0.0625000
NODE_803_length_2684_cov_17.345068	146	194	6	43	48	0.8958333
NODE_803_length_2684_cov_17.345068	146	194	0	1	48	0.0208333
NODE_803_length_2684_cov_17.345068	146	194	2	1	48	0.0208333
NODE_803_length_2684_cov_17.345068	146	194	4	3	48	0.0625000
NODE_803_length_2684_cov_17.345068	146	194	6	43	48	0.8958333
NODE_803_length_2684_cov_17.345068	146	194	0	1	48	0.0208333
NODE_803_length_2684_cov_17.345068	146	194	2	1	48	0.0208333
NODE_803_length_2684_cov_17.345068	146	194	4	3	48	0.0625000
NODE_803_length_2684_cov_17.345068	146	194	6	43	48	0.8958333
NODE_803_length_2684_cov_17.345068	146	194	0	1	48	0.0208333
NODE_803_length_2684_cov_17.345068	146	194	2	1	48	0.0208333
NODE_803_length_2684_cov_17.345068	146	194	4	3	48	0.0625000
NODE_803_length_2684_cov_17.345068	146	194	6	43	48	0.8958333
NODE_803_length_2684_cov_17.345068	146	194	0	1	48	0.0208333
NODE_803_length_2684_cov_17.345068	146	194	2	1	48	0.0208333
NODE_803_length_2684_cov_17.345068	146	194	4	3	48	0.0625000
NODE_803_length_2684_cov_17.345068	146	194	6	43	48	0.8958333
NODE_805_length_2682_cov_43.500581	913	992	178	1	79	0.0126582
NODE_805_length_2682_cov_43.500581	913	992	179	2	79	0.0253165
NODE_805_length_2682_cov_43.500581	913	992	181	2	79	0.0253165
NODE_805_length_2682_cov_43.500581	913	992	182	1	79	0.0126582
NODE_805_length_2682_cov_43.500581	913	992	186	1	79	0.0126582
NODE_805_length_2682_cov_43.500581	913	992	191	1	79	0.0126582
NODE_805_length_2682_cov_43.500581	913	992	199	2	79	0.0253165
NODE_805_length_2682_cov_43.500581	913	992	201	1	79	0.0126582
NODE_805_length_2682_cov_43.500581	913	992	204	1	79	0.0126582
NODE_805_length_2682_cov_43.500581	913	992	206	1	79	0.0126582
NODE_805_length_2682_cov_43.500581	913	992	218	1	79	0.0126582
NODE_805_length_2682_cov_43.500581	913	992	220	1	79	0.0126582
NODE_805_length_2682_cov_43.500581	913	992	222	2	79	0.0253165
NODE_805_length_2682_cov_43.500581	913	992	224	1	79	0.0126582
NODE_805_length_2682_cov_43.500581	913	992	227	1	79	0.0126582
NODE_805_length_2682_cov_43.500581	913	992	229	2	79	0.0253165
NODE_805_length_2682_cov_43.500581	913	992	231	3	79	0.0379747
NODE_805_length_2682_cov_43.500581	913	992	233	1	79	0.0126582
NODE_805_length_2682_cov_43.500581	913	992	236	1	79	0.0126582
NODE_805_length_2682_cov_43.500581	913	992	239	1	79	0.0126582
NODE_805_length_2682_cov_43.500581	913	992	246	1	79	0.0126582
NODE_805_length_2682_cov_43.500581	913	992	253	1	79	0.0126582
NODE_805_length_2682_cov_43.500581	913	992	259	1	79	0.0126582
NODE_805_length_2682_cov_43.500581	913	992	265	1	79	0.0126582
NODE_805_length_2682_cov_43.500581	913	992	267	2	79	0.0253165
NODE_805_length_2682_cov_43.500581	913	992	268	1	79	0.0126582
NODE_805_length_2682_cov_43.500581	913	992	269	1	79	0.0126582
NODE_805_length_2682_cov_43.500581	913	992	273	1	79	0.0126582
NODE_805_length_2682_cov_43.500581	913	992	275	1	79	0.0126582
NODE_805_length_2682_cov_43.500581	913	992	279	1	79	0.0126582
NODE_805_length_2682_cov_43.500581	913	992	280	1	79	0.0126582
NODE_805_length_2682_cov_43.500581	913	992	282	2	79	0.0253165
NODE_805_length_2682_cov_43.500581	913	992	283	1	79	0.0126582
NODE_805_length_2682_cov_43.500581	913	992	290	1	79	0.0126582
NODE_805_length_2682_cov_43.500581	913	992	294	2	79	0.0253165
NODE_805_length_2682_cov_43.500581	913	992	295	3	79	0.0379747
NODE_805_length_2682_cov_43.500581	913	992	298	1	79	0.0126582
NODE_805_length_2682_cov_43.500581	913	992	300	1	79	0.0126582
NODE_805_length_2682_cov_43.500581	913	992	301	1	79	0.0126582
NODE_805_length_2682_cov_43.500581	913	992	302	1	79	0.0126582
NODE_805_length_2682_cov_43.500581	913	992	303	1	79	0.0126582
NODE_805_length_2682_cov_43.500581	913	992	305	2	79	0.0253165
NODE_805_length_2682_cov_43.500581	913	992	309	1	79	0.0126582
NODE_805_length_2682_cov_43.500581	913	992	320	1	79	0.0126582
NODE_805_length_2682_cov_43.500581	913	992	322	1	79	0.0126582
NODE_805_length_2682_cov_43.500581	913	992	324	2	79	0.0253165
NODE_805_length_2682_cov_43.500581	913	992	325	1	79	0.0126582
NODE_805_length_2682_cov_43.500581	913	992	326	1	79	0.0126582
NODE_805_length_2682_cov_43.500581	913	992	328	1	79	0.0126582
NODE_805_length_2682_cov_43.500581	913	992	329	1	79	0.0126582
NODE_805_length_2682_cov_43.500581	913	992	331	1	79	0.0126582
NODE_805_length_2682_cov_43.500581	913	992	333	1	79	0.0126582
NODE_805_length_2682_cov_43.500581	913	992	334	1	79	0.0126582
NODE_805_length_2682_cov_43.500581	913	992	343	1	79	0.0126582
NODE_805_length_2682_cov_43.500581	913	992	344	1	79	0.0126582
NODE_805_length_2682_cov_43.500581	913	992	349	1	79	0.0126582
NODE_805_length_2682_cov_43.500581	913	992	360	1	79	0.0126582
NODE_805_length_2682_cov_43.500581	913	992	377	1	79	0.0126582
NODE_805_length_2682_cov_43.500581	913	992	379	3	79	0.0379747
NODE_805_length_2682_cov_43.500581	913	992	380	1	79	0.0126582
NODE_805_length_2682_cov_43.500581	913	992	385	2	79	0.0253165
NODE_805_length_2682_cov_43.500581	913	992	387	1	79	0.0126582
NODE_805_length_2682_cov_43.500581	965	1002	165	1	37	0.0270270
NODE_805_length_2682_cov_43.500581	965	1002	169	6	37	0.1621622
NODE_805_length_2682_cov_43.500581	965	1002	173	2	37	0.0540541
NODE_805_length_2682_cov_43.500581	965	1002	175	1	37	0.0270270
NODE_805_length_2682_cov_43.500581	965	1002	178	1	37	0.0270270
NODE_805_length_2682_cov_43.500581	965	1002	179	2	37	0.0540541
NODE_805_length_2682_cov_43.500581	965	1002	181	2	37	0.0540541
NODE_805_length_2682_cov_43.500581	965	1002	182	1	37	0.0270270
NODE_805_length_2682_cov_43.500581	965	1002	186	1	37	0.0270270
NODE_805_length_2682_cov_43.500581	965	1002	191	1	37	0.0270270
NODE_805_length_2682_cov_43.500581	965	1002	199	2	37	0.0540541
NODE_805_length_2682_cov_43.500581	965	1002	201	1	37	0.0270270
NODE_805_length_2682_cov_43.500581	965	1002	204	1	37	0.0270270
NODE_805_length_2682_cov_43.500581	965	1002	206	1	37	0.0270270
NODE_805_length_2682_cov_43.500581	965	1002	218	1	37	0.0270270
NODE_805_length_2682_cov_43.500581	965	1002	220	1	37	0.0270270
NODE_805_length_2682_cov_43.500581	965	1002	222	2	37	0.0540541
NODE_805_length_2682_cov_43.500581	965	1002	224	1	37	0.0270270
NODE_805_length_2682_cov_43.500581	965	1002	227	1	37	0.0270270
NODE_805_length_2682_cov_43.500581	965	1002	229	2	37	0.0540541
NODE_805_length_2682_cov_43.500581	965	1002	231	3	37	0.0810811
NODE_805_length_2682_cov_43.500581	965	1002	233	1	37	0.0270270
NODE_805_length_2682_cov_43.500581	965	1002	236	1	37	0.0270270
NODE_805_length_2682_cov_43.500581	965	1002	239	1	37	0.0270270
NODE_808_length_2675_cov_10.369565	209	289	6	36	80	0.4500000
NODE_808_length_2675_cov_10.369565	209	289	8	14	80	0.1750000
NODE_808_length_2675_cov_10.369565	209	289	10	30	80	0.3750000
NODE_813_length_2670_cov_17.489304	1995	2075	0	61	80	0.7625000
NODE_813_length_2670_cov_17.489304	1995	2075	2	19	80	0.2375000
NODE_813_length_2670_cov_17.489304	2048	2128	0	80	80	1.0000000
NODE_813_length_2670_cov_17.489304	2124	2204	0	25	80	0.3125000
NODE_813_length_2670_cov_17.489304	2124	2204	9	44	80	0.5500000
NODE_813_length_2670_cov_17.489304	2124	2204	10	11	80	0.1375000
NODE_813_length_2670_cov_17.489304	2177	2257	2	1	80	0.0125000
NODE_813_length_2670_cov_17.489304	2177	2257	9	16	80	0.2000000
NODE_813_length_2670_cov_17.489304	2177	2257	10	26	80	0.3250000
NODE_813_length_2670_cov_17.489304	2177	2257	11	1	80	0.0125000
NODE_813_length_2670_cov_17.489304	2177	2257	12	36	80	0.4500000
NODE_815_length_2665_cov_19.145752	548	628	0	3	80	0.0375000
NODE_815_length_2665_cov_19.145752	548	628	2	23	80	0.2875000
NODE_815_length_2665_cov_19.145752	548	628	10	20	80	0.2500000
NODE_815_length_2665_cov_19.145752	548	628	12	34	80	0.4250000
NODE_815_length_2665_cov_19.145752	601	681	0	1	80	0.0125000
NODE_815_length_2665_cov_19.145752	601	681	10	12	80	0.1500000
NODE_815_length_2665_cov_19.145752	601	681	12	67	80	0.8375000
NODE_815_length_2665_cov_19.145752	2099	2176	2	54	77	0.7012987
NODE_815_length_2665_cov_19.145752	2099	2176	4	23	77	0.2987013
NODE_815_length_2665_cov_19.145752	2172	2252	2	53	80	0.6625000
NODE_815_length_2665_cov_19.145752	2172	2252	4	27	80	0.3375000
NODE_815_length_2665_cov_19.145752	2172	2252	2	53	80	0.6625000
NODE_815_length_2665_cov_19.145752	2172	2252	4	27	80	0.3375000
NODE_815_length_2665_cov_19.145752	2225	2267	2	13	42	0.3095238
NODE_815_length_2665_cov_19.145752	2225	2267	4	29	42	0.6904762
NODE_816_length_2664_cov_4.175049	2005	2085	2	28	80	0.3500000
NODE_816_length_2664_cov_4.175049	2005	2085	4	52	80	0.6500000
NODE_816_length_2664_cov_4.175049	2058	2138	2	52	80	0.6500000
NODE_816_length_2664_cov_4.175049	2058	2138	4	28	80	0.3500000
NODE_822_length_2650_cov_19.800862	800	880	12	5	80	0.0625000
NODE_822_length_2650_cov_19.800862	800	880	14	2	80	0.0250000
NODE_822_length_2650_cov_19.800862	800	880	16	51	80	0.6375000
NODE_822_length_2650_cov_19.800862	800	880	18	10	80	0.1250000
NODE_822_length_2650_cov_19.800862	800	880	19	1	80	0.0125000
NODE_822_length_2650_cov_19.800862	800	880	20	7	80	0.0875000
NODE_822_length_2650_cov_19.800862	800	880	22	2	80	0.0250000
NODE_822_length_2650_cov_19.800862	800	880	24	2	80	0.0250000
NODE_824_length_2645_cov_8.618225	931	1011	0	80	80	1.0000000
NODE_824_length_2645_cov_8.618225	984	1064	0	80	80	1.0000000
NODE_827_length_2640_cov_16.462810	94	164	134	1	70	0.0142857
NODE_827_length_2640_cov_16.462810	94	164	140	1	70	0.0142857
NODE_827_length_2640_cov_16.462810	94	164	142	1	70	0.0142857
NODE_827_length_2640_cov_16.462810	94	164	145	2	70	0.0285714
NODE_827_length_2640_cov_16.462810	94	164	147	1	70	0.0142857
NODE_827_length_2640_cov_16.462810	94	164	154	3	70	0.0428571
NODE_827_length_2640_cov_16.462810	94	164	155	2	70	0.0285714
NODE_827_length_2640_cov_16.462810	94	164	156	1	70	0.0142857
NODE_827_length_2640_cov_16.462810	94	164	158	2	70	0.0285714
NODE_827_length_2640_cov_16.462810	94	164	160	2	70	0.0285714
NODE_827_length_2640_cov_16.462810	94	164	164	1	70	0.0142857
NODE_827_length_2640_cov_16.462810	94	164	173	1	70	0.0142857
NODE_827_length_2640_cov_16.462810	94	164	174	1	70	0.0142857
NODE_827_length_2640_cov_16.462810	94	164	175	2	70	0.0285714
NODE_827_length_2640_cov_16.462810	94	164	181	1	70	0.0142857
NODE_827_length_2640_cov_16.462810	94	164	187	1	70	0.0142857
NODE_827_length_2640_cov_16.462810	94	164	192	2	70	0.0285714
NODE_827_length_2640_cov_16.462810	94	164	197	1	70	0.0142857
NODE_827_length_2640_cov_16.462810	94	164	199	1	70	0.0142857
NODE_827_length_2640_cov_16.462810	94	164	209	1	70	0.0142857
NODE_827_length_2640_cov_16.462810	94	164	214	1	70	0.0142857
NODE_827_length_2640_cov_16.462810	94	164	220	1	70	0.0142857
NODE_827_length_2640_cov_16.462810	94	164	225	1	70	0.0142857
NODE_827_length_2640_cov_16.462810	94	164	226	1	70	0.0142857
NODE_827_length_2640_cov_16.462810	94	164	227	3	70	0.0428571
NODE_827_length_2640_cov_16.462810	94	164	230	1	70	0.0142857
NODE_827_length_2640_cov_16.462810	94	164	231	1	70	0.0142857
NODE_827_length_2640_cov_16.462810	94	164	233	1	70	0.0142857
NODE_827_length_2640_cov_16.462810	94	164	236	1	70	0.0142857
NODE_827_length_2640_cov_16.462810	94	164	239	1	70	0.0142857
NODE_827_length_2640_cov_16.462810	94	164	241	1	70	0.0142857
NODE_827_length_2640_cov_16.462810	94	164	245	2	70	0.0285714
NODE_827_length_2640_cov_16.462810	94	164	255	1	70	0.0142857
NODE_827_length_2640_cov_16.462810	94	164	262	1	70	0.0142857
NODE_827_length_2640_cov_16.462810	94	164	264	1	70	0.0142857
NODE_827_length_2640_cov_16.462810	94	164	268	1	70	0.0142857
NODE_827_length_2640_cov_16.462810	94	164	277	1	70	0.0142857
NODE_827_length_2640_cov_16.462810	94	164	288	1	70	0.0142857
NODE_827_length_2640_cov_16.462810	94	164	289	1	70	0.0142857
NODE_827_length_2640_cov_16.462810	94	164	291	1	70	0.0142857
NODE_827_length_2640_cov_16.462810	94	164	294	2	70	0.0285714
NODE_827_length_2640_cov_16.462810	94	164	298	5	70	0.0714286
NODE_827_length_2640_cov_16.462810	94	164	299	6	70	0.0857143
NODE_827_length_2640_cov_16.462810	94	164	300	3	70	0.0428571
NODE_827_length_2640_cov_16.462810	94	164	301	2	70	0.0285714
NODE_827_length_2640_cov_16.462810	94	164	302	1	70	0.0142857
NODE_827_length_2640_cov_16.462810	147	209	96	1	62	0.0161290
NODE_827_length_2640_cov_16.462810	147	209	97	3	62	0.0483871
NODE_827_length_2640_cov_16.462810	147	209	98	2	62	0.0322581
NODE_827_length_2640_cov_16.462810	147	209	99	3	62	0.0483871
NODE_827_length_2640_cov_16.462810	147	209	100	6	62	0.0967742
NODE_827_length_2640_cov_16.462810	147	209	102	3	62	0.0483871
NODE_827_length_2640_cov_16.462810	147	209	103	4	62	0.0645161
NODE_827_length_2640_cov_16.462810	147	209	104	2	62	0.0322581
NODE_827_length_2640_cov_16.462810	147	209	109	6	62	0.0967742
NODE_827_length_2640_cov_16.462810	147	209	110	1	62	0.0161290
NODE_827_length_2640_cov_16.462810	147	209	111	2	62	0.0322581
NODE_827_length_2640_cov_16.462810	147	209	113	1	62	0.0161290
NODE_827_length_2640_cov_16.462810	147	209	125	4	62	0.0645161
NODE_827_length_2640_cov_16.462810	147	209	126	1	62	0.0161290
NODE_827_length_2640_cov_16.462810	147	209	127	2	62	0.0322581
NODE_827_length_2640_cov_16.462810	147	209	130	2	62	0.0322581
NODE_827_length_2640_cov_16.462810	147	209	131	1	62	0.0161290
NODE_827_length_2640_cov_16.462810	147	209	132	1	62	0.0161290
NODE_827_length_2640_cov_16.462810	147	209	134	1	62	0.0161290
NODE_827_length_2640_cov_16.462810	147	209	140	1	62	0.0161290
NODE_827_length_2640_cov_16.462810	147	209	142	1	62	0.0161290
NODE_827_length_2640_cov_16.462810	147	209	145	2	62	0.0322581
NODE_827_length_2640_cov_16.462810	147	209	147	1	62	0.0161290
NODE_827_length_2640_cov_16.462810	147	209	154	3	62	0.0483871
NODE_827_length_2640_cov_16.462810	147	209	155	2	62	0.0322581
NODE_827_length_2640_cov_16.462810	147	209	156	1	62	0.0161290
NODE_827_length_2640_cov_16.462810	147	209	158	2	62	0.0322581
NODE_827_length_2640_cov_16.462810	147	209	160	2	62	0.0322581
NODE_827_length_2640_cov_16.462810	147	209	164	1	62	0.0161290
NODE_828_length_2636_cov_200.191171	561	641	892	1	80	0.0125000
NODE_828_length_2636_cov_200.191171	561	641	894	1	80	0.0125000
NODE_828_length_2636_cov_200.191171	561	641	908	1	80	0.0125000
NODE_828_length_2636_cov_200.191171	561	641	914	1	80	0.0125000
NODE_828_length_2636_cov_200.191171	561	641	932	1	80	0.0125000
NODE_828_length_2636_cov_200.191171	561	641	939	1	80	0.0125000
NODE_828_length_2636_cov_200.191171	561	641	946	1	80	0.0125000
NODE_828_length_2636_cov_200.191171	561	641	968	1	80	0.0125000
NODE_828_length_2636_cov_200.191171	561	641	972	1	80	0.0125000
NODE_828_length_2636_cov_200.191171	561	641	979	1	80	0.0125000
NODE_828_length_2636_cov_200.191171	561	641	980	1	80	0.0125000
NODE_828_length_2636_cov_200.191171	561	641	981	1	80	0.0125000
NODE_828_length_2636_cov_200.191171	561	641	1000	1	80	0.0125000
NODE_828_length_2636_cov_200.191171	561	641	1011	1	80	0.0125000
NODE_828_length_2636_cov_200.191171	561	641	1014	1	80	0.0125000
NODE_828_length_2636_cov_200.191171	561	641	1016	1	80	0.0125000
NODE_828_length_2636_cov_200.191171	561	641	1024	1	80	0.0125000
NODE_828_length_2636_cov_200.191171	561	641	1025	1	80	0.0125000
NODE_828_length_2636_cov_200.191171	561	641	1026	1	80	0.0125000
NODE_828_length_2636_cov_200.191171	561	641	1030	1	80	0.0125000
NODE_828_length_2636_cov_200.191171	561	641	1032	1	80	0.0125000
NODE_828_length_2636_cov_200.191171	561	641	1039	1	80	0.0125000
NODE_828_length_2636_cov_200.191171	561	641	1041	1	80	0.0125000
NODE_828_length_2636_cov_200.191171	561	641	1044	2	80	0.0250000
NODE_828_length_2636_cov_200.191171	561	641	1052	1	80	0.0125000
NODE_828_length_2636_cov_200.191171	561	641	1053	1	80	0.0125000
NODE_828_length_2636_cov_200.191171	561	641	1055	1	80	0.0125000
NODE_828_length_2636_cov_200.191171	561	641	1056	1	80	0.0125000
NODE_828_length_2636_cov_200.191171	561	641	1061	1	80	0.0125000
NODE_828_length_2636_cov_200.191171	561	641	1063	1	80	0.0125000
NODE_828_length_2636_cov_200.191171	561	641	1064	2	80	0.0250000
NODE_828_length_2636_cov_200.191171	561	641	1068	1	80	0.0125000
NODE_828_length_2636_cov_200.191171	561	641	1074	1	80	0.0125000
NODE_828_length_2636_cov_200.191171	561	641	1076	1	80	0.0125000
NODE_828_length_2636_cov_200.191171	561	641	1081	1	80	0.0125000
NODE_828_length_2636_cov_200.191171	561	641	1082	1	80	0.0125000
NODE_828_length_2636_cov_200.191171	561	641	1087	1	80	0.0125000
NODE_828_length_2636_cov_200.191171	561	641	1089	1	80	0.0125000
NODE_828_length_2636_cov_200.191171	561	641	1092	1	80	0.0125000
NODE_828_length_2636_cov_200.191171	561	641	1093	1	80	0.0125000
NODE_828_length_2636_cov_200.191171	561	641	1097	1	80	0.0125000
NODE_828_length_2636_cov_200.191171	561	641	1099	1	80	0.0125000
NODE_828_length_2636_cov_200.191171	561	641	1104	1	80	0.0125000
NODE_828_length_2636_cov_200.191171	561	641	1105	1	80	0.0125000
NODE_828_length_2636_cov_200.191171	561	641	1109	1	80	0.0125000
NODE_828_length_2636_cov_200.191171	561	641	1113	1	80	0.0125000
NODE_828_length_2636_cov_200.191171	561	641	1114	1	80	0.0125000
NODE_828_length_2636_cov_200.191171	561	641	1121	1	80	0.0125000
NODE_828_length_2636_cov_200.191171	561	641	1123	1	80	0.0125000
NODE_828_length_2636_cov_200.191171	561	641	1124	1	80	0.0125000
NODE_828_length_2636_cov_200.191171	561	641	1126	1	80	0.0125000
NODE_828_length_2636_cov_200.191171	561	641	1129	1	80	0.0125000
NODE_828_length_2636_cov_200.191171	561	641	1133	1	80	0.0125000
NODE_828_length_2636_cov_200.191171	561	641	1136	1	80	0.0125000
NODE_828_length_2636_cov_200.191171	561	641	1139	1	80	0.0125000
NODE_828_length_2636_cov_200.191171	561	641	1144	1	80	0.0125000
NODE_828_length_2636_cov_200.191171	561	641	1146	1	80	0.0125000
NODE_828_length_2636_cov_200.191171	561	641	1149	1	80	0.0125000
NODE_828_length_2636_cov_200.191171	561	641	1150	2	80	0.0250000
NODE_828_length_2636_cov_200.191171	561	641	1156	2	80	0.0250000
NODE_828_length_2636_cov_200.191171	561	641	1163	1	80	0.0125000
NODE_828_length_2636_cov_200.191171	561	641	1168	2	80	0.0250000
NODE_828_length_2636_cov_200.191171	561	641	1169	1	80	0.0125000
NODE_828_length_2636_cov_200.191171	561	641	1170	1	80	0.0125000
NODE_828_length_2636_cov_200.191171	561	641	1171	2	80	0.0250000
NODE_828_length_2636_cov_200.191171	561	641	1172	1	80	0.0125000
NODE_828_length_2636_cov_200.191171	561	641	1174	1	80	0.0125000
NODE_828_length_2636_cov_200.191171	561	641	1175	1	80	0.0125000
NODE_828_length_2636_cov_200.191171	561	641	1176	1	80	0.0125000
NODE_828_length_2636_cov_200.191171	561	641	1180	1	80	0.0125000
NODE_828_length_2636_cov_200.191171	561	641	1183	2	80	0.0250000
NODE_828_length_2636_cov_200.191171	561	641	1184	1	80	0.0125000
NODE_828_length_2636_cov_200.191171	561	641	1186	1	80	0.0125000
NODE_828_length_2636_cov_200.191171	614	695	194	1	81	0.0123457
NODE_828_length_2636_cov_200.191171	614	695	200	1	81	0.0123457
NODE_828_length_2636_cov_200.191171	614	695	205	1	81	0.0123457
NODE_828_length_2636_cov_200.191171	614	695	226	1	81	0.0123457
NODE_828_length_2636_cov_200.191171	614	695	230	1	81	0.0123457
NODE_828_length_2636_cov_200.191171	614	695	242	1	81	0.0123457
NODE_828_length_2636_cov_200.191171	614	695	259	2	81	0.0246914
NODE_828_length_2636_cov_200.191171	614	695	260	2	81	0.0246914
NODE_828_length_2636_cov_200.191171	614	695	261	1	81	0.0123457
NODE_828_length_2636_cov_200.191171	614	695	279	1	81	0.0123457
NODE_828_length_2636_cov_200.191171	614	695	288	1	81	0.0123457
NODE_828_length_2636_cov_200.191171	614	695	292	1	81	0.0123457
NODE_828_length_2636_cov_200.191171	614	695	324	1	81	0.0123457
NODE_828_length_2636_cov_200.191171	614	695	327	1	81	0.0123457
NODE_828_length_2636_cov_200.191171	614	695	333	1	81	0.0123457
NODE_828_length_2636_cov_200.191171	614	695	338	1	81	0.0123457
NODE_828_length_2636_cov_200.191171	614	695	352	1	81	0.0123457
NODE_828_length_2636_cov_200.191171	614	695	357	1	81	0.0123457
NODE_828_length_2636_cov_200.191171	614	695	361	1	81	0.0123457
NODE_828_length_2636_cov_200.191171	614	695	374	1	81	0.0123457
NODE_828_length_2636_cov_200.191171	614	695	389	1	81	0.0123457
NODE_828_length_2636_cov_200.191171	614	695	413	1	81	0.0123457
NODE_828_length_2636_cov_200.191171	614	695	435	1	81	0.0123457
NODE_828_length_2636_cov_200.191171	614	695	456	1	81	0.0123457
NODE_828_length_2636_cov_200.191171	614	695	462	1	81	0.0123457
NODE_828_length_2636_cov_200.191171	614	695	470	1	81	0.0123457
NODE_828_length_2636_cov_200.191171	614	695	526	1	81	0.0123457
NODE_828_length_2636_cov_200.191171	614	695	551	1	81	0.0123457
NODE_828_length_2636_cov_200.191171	614	695	632	1	81	0.0123457
NODE_828_length_2636_cov_200.191171	614	695	638	2	81	0.0246914
NODE_828_length_2636_cov_200.191171	614	695	639	1	81	0.0123457
NODE_828_length_2636_cov_200.191171	614	695	643	1	81	0.0123457
NODE_828_length_2636_cov_200.191171	614	695	646	1	81	0.0123457
NODE_828_length_2636_cov_200.191171	614	695	653	1	81	0.0123457
NODE_828_length_2636_cov_200.191171	614	695	656	2	81	0.0246914
NODE_828_length_2636_cov_200.191171	614	695	662	1	81	0.0123457
NODE_828_length_2636_cov_200.191171	614	695	670	1	81	0.0123457
NODE_828_length_2636_cov_200.191171	614	695	683	1	81	0.0123457
NODE_828_length_2636_cov_200.191171	614	695	738	1	81	0.0123457
NODE_828_length_2636_cov_200.191171	614	695	757	1	81	0.0123457
NODE_828_length_2636_cov_200.191171	614	695	768	1	81	0.0123457
NODE_828_length_2636_cov_200.191171	614	695	790	1	81	0.0123457
NODE_828_length_2636_cov_200.191171	614	695	802	1	81	0.0123457
NODE_828_length_2636_cov_200.191171	614	695	804	1	81	0.0123457
NODE_828_length_2636_cov_200.191171	614	695	820	1	81	0.0123457
NODE_828_length_2636_cov_200.191171	614	695	822	1	81	0.0123457
NODE_828_length_2636_cov_200.191171	614	695	829	1	81	0.0123457
NODE_828_length_2636_cov_200.191171	614	695	830	1	81	0.0123457
NODE_828_length_2636_cov_200.191171	614	695	850	1	81	0.0123457
NODE_828_length_2636_cov_200.191171	614	695	886	1	81	0.0123457
NODE_828_length_2636_cov_200.191171	614	695	892	1	81	0.0123457
NODE_828_length_2636_cov_200.191171	614	695	894	1	81	0.0123457
NODE_828_length_2636_cov_200.191171	614	695	908	1	81	0.0123457
NODE_828_length_2636_cov_200.191171	614	695	914	1	81	0.0123457
NODE_828_length_2636_cov_200.191171	614	695	932	1	81	0.0123457
NODE_828_length_2636_cov_200.191171	614	695	939	1	81	0.0123457
NODE_828_length_2636_cov_200.191171	614	695	946	1	81	0.0123457
NODE_828_length_2636_cov_200.191171	614	695	968	1	81	0.0123457
NODE_828_length_2636_cov_200.191171	614	695	972	1	81	0.0123457
NODE_828_length_2636_cov_200.191171	614	695	1000	1	81	0.0123457
NODE_828_length_2636_cov_200.191171	614	695	1011	1	81	0.0123457
NODE_828_length_2636_cov_200.191171	614	695	1014	1	81	0.0123457
NODE_828_length_2636_cov_200.191171	614	695	1024	1	81	0.0123457
NODE_828_length_2636_cov_200.191171	614	695	1026	1	81	0.0123457
NODE_828_length_2636_cov_200.191171	614	695	1030	1	81	0.0123457
NODE_828_length_2636_cov_200.191171	614	695	1032	1	81	0.0123457
NODE_828_length_2636_cov_200.191171	614	695	1039	1	81	0.0123457
NODE_828_length_2636_cov_200.191171	614	695	1041	1	81	0.0123457
NODE_828_length_2636_cov_200.191171	614	695	1044	1	81	0.0123457
NODE_828_length_2636_cov_200.191171	614	695	1052	1	81	0.0123457
NODE_828_length_2636_cov_200.191171	614	695	1053	1	81	0.0123457
NODE_828_length_2636_cov_200.191171	614	695	1055	1	81	0.0123457
NODE_828_length_2636_cov_200.191171	614	695	1056	1	81	0.0123457
NODE_828_length_2636_cov_200.191171	614	695	1061	1	81	0.0123457
NODE_828_length_2636_cov_200.191171	614	695	1064	2	81	0.0246914
NODE_828_length_2636_cov_200.191171	614	695	1068	1	81	0.0123457
NODE_830_length_2631_cov_10.831754	446	526	2	27	80	0.3375000
NODE_830_length_2631_cov_10.831754	446	526	4	51	80	0.6375000
NODE_830_length_2631_cov_10.831754	446	526	6	2	80	0.0250000
NODE_830_length_2631_cov_10.831754	499	572	2	19	73	0.2602740
NODE_830_length_2631_cov_10.831754	499	572	4	52	73	0.7123288
NODE_830_length_2631_cov_10.831754	499	572	6	2	73	0.0273973
NODE_833_length_2622_cov_63.057471	1877	1953	103	1	76	0.0131579
NODE_833_length_2622_cov_63.057471	1877	1953	105	2	76	0.0263158
NODE_833_length_2622_cov_63.057471	1877	1953	109	4	76	0.0526316
NODE_833_length_2622_cov_63.057471	1877	1953	110	1	76	0.0131579
NODE_833_length_2622_cov_63.057471	1877	1953	112	1	76	0.0131579
NODE_833_length_2622_cov_63.057471	1877	1953	114	2	76	0.0263158
NODE_833_length_2622_cov_63.057471	1877	1953	117	1	76	0.0131579
NODE_833_length_2622_cov_63.057471	1877	1953	119	1	76	0.0131579
NODE_833_length_2622_cov_63.057471	1877	1953	124	1	76	0.0131579
NODE_833_length_2622_cov_63.057471	1877	1953	126	2	76	0.0263158
NODE_833_length_2622_cov_63.057471	1877	1953	128	1	76	0.0131579
NODE_833_length_2622_cov_63.057471	1877	1953	130	1	76	0.0131579
NODE_833_length_2622_cov_63.057471	1877	1953	131	2	76	0.0263158
NODE_833_length_2622_cov_63.057471	1877	1953	133	2	76	0.0263158
NODE_833_length_2622_cov_63.057471	1877	1953	139	6	76	0.0789474
NODE_833_length_2622_cov_63.057471	1877	1953	141	2	76	0.0263158
NODE_833_length_2622_cov_63.057471	1877	1953	143	3	76	0.0394737
NODE_833_length_2622_cov_63.057471	1877	1953	145	1	76	0.0131579
NODE_833_length_2622_cov_63.057471	1877	1953	149	1	76	0.0131579
NODE_833_length_2622_cov_63.057471	1877	1953	151	2	76	0.0263158
NODE_833_length_2622_cov_63.057471	1877	1953	153	1	76	0.0131579
NODE_833_length_2622_cov_63.057471	1877	1953	154	1	76	0.0131579
NODE_833_length_2622_cov_63.057471	1877	1953	155	1	76	0.0131579
NODE_833_length_2622_cov_63.057471	1877	1953	156	9	76	0.1184211
NODE_833_length_2622_cov_63.057471	1877	1953	157	4	76	0.0526316
NODE_833_length_2622_cov_63.057471	1877	1953	158	15	76	0.1973684
NODE_833_length_2622_cov_63.057471	1877	1953	159	8	76	0.1052632
NODE_833_length_2622_cov_63.057471	2426	2506	10	5	80	0.0625000
NODE_833_length_2622_cov_63.057471	2426	2506	12	10	80	0.1250000
NODE_833_length_2622_cov_63.057471	2426	2506	14	10	80	0.1250000
NODE_833_length_2622_cov_63.057471	2426	2506	15	1	80	0.0125000
NODE_833_length_2622_cov_63.057471	2426	2506	16	6	80	0.0750000
NODE_833_length_2622_cov_63.057471	2426	2506	18	1	80	0.0125000
NODE_833_length_2622_cov_63.057471	2426	2506	19	1	80	0.0125000
NODE_833_length_2622_cov_63.057471	2426	2506	20	3	80	0.0375000
NODE_833_length_2622_cov_63.057471	2426	2506	22	1	80	0.0125000
NODE_833_length_2622_cov_63.057471	2426	2506	23	1	80	0.0125000
NODE_833_length_2622_cov_63.057471	2426	2506	29	2	80	0.0250000
NODE_833_length_2622_cov_63.057471	2426	2506	30	2	80	0.0250000
NODE_833_length_2622_cov_63.057471	2426	2506	32	3	80	0.0375000
NODE_833_length_2622_cov_63.057471	2426	2506	34	1	80	0.0125000
NODE_833_length_2622_cov_63.057471	2426	2506	36	2	80	0.0250000
NODE_833_length_2622_cov_63.057471	2426	2506	38	2	80	0.0250000
NODE_833_length_2622_cov_63.057471	2426	2506	42	4	80	0.0500000
NODE_833_length_2622_cov_63.057471	2426	2506	44	1	80	0.0125000
NODE_833_length_2622_cov_63.057471	2426	2506	46	2	80	0.0250000
NODE_833_length_2622_cov_63.057471	2426	2506	50	1	80	0.0125000
NODE_833_length_2622_cov_63.057471	2426	2506	52	2	80	0.0250000
NODE_833_length_2622_cov_63.057471	2426	2506	54	1	80	0.0125000
NODE_833_length_2622_cov_63.057471	2426	2506	55	6	80	0.0750000
NODE_833_length_2622_cov_63.057471	2426	2506	56	4	80	0.0500000
NODE_833_length_2622_cov_63.057471	2426	2506	60	2	80	0.0250000
NODE_833_length_2622_cov_63.057471	2426	2506	62	3	80	0.0375000
NODE_833_length_2622_cov_63.057471	2426	2506	64	1	80	0.0125000
NODE_833_length_2622_cov_63.057471	2426	2506	66	1	80	0.0125000
NODE_833_length_2622_cov_63.057471	2426	2506	68	1	80	0.0125000
NODE_833_length_2622_cov_63.057471	2479	2559	42	2	80	0.0250000
NODE_833_length_2622_cov_63.057471	2479	2559	44	1	80	0.0125000
NODE_833_length_2622_cov_63.057471	2479	2559	46	2	80	0.0250000
NODE_833_length_2622_cov_63.057471	2479	2559	50	1	80	0.0125000
NODE_833_length_2622_cov_63.057471	2479	2559	52	2	80	0.0250000
NODE_833_length_2622_cov_63.057471	2479	2559	54	1	80	0.0125000
NODE_833_length_2622_cov_63.057471	2479	2559	55	6	80	0.0750000
NODE_833_length_2622_cov_63.057471	2479	2559	56	4	80	0.0500000
NODE_833_length_2622_cov_63.057471	2479	2559	60	4	80	0.0500000
NODE_833_length_2622_cov_63.057471	2479	2559	62	8	80	0.1000000
NODE_833_length_2622_cov_63.057471	2479	2559	64	1	80	0.0125000
NODE_833_length_2622_cov_63.057471	2479	2559	66	3	80	0.0375000
NODE_833_length_2622_cov_63.057471	2479	2559	67	1	80	0.0125000
NODE_833_length_2622_cov_63.057471	2479	2559	68	8	80	0.1000000
NODE_833_length_2622_cov_63.057471	2479	2559	70	4	80	0.0500000
NODE_833_length_2622_cov_63.057471	2479	2559	72	32	80	0.4000000
NODE_836_length_2617_cov_16.817315	1404	1448	10	40	44	0.9090909
NODE_836_length_2617_cov_16.817315	1404	1448	12	4	44	0.0909091
NODE_836_length_2617_cov_16.817315	1467	1521	2	2	54	0.0370370
NODE_836_length_2617_cov_16.817315	1467	1521	4	5	54	0.0925926
NODE_836_length_2617_cov_16.817315	1467	1521	6	11	54	0.2037037
NODE_836_length_2617_cov_16.817315	1467	1521	7	24	54	0.4444444
NODE_836_length_2617_cov_16.817315	1467	1521	8	11	54	0.2037037
NODE_836_length_2617_cov_16.817315	1467	1521	9	1	54	0.0185185
NODE_839_length_2610_cov_2.232577	2127	2163	0	36	36	1.0000000
NODE_840_length_2609_cov_13.245418	2066	2146	0	6	80	0.0750000
NODE_840_length_2609_cov_13.245418	2066	2146	6	3	80	0.0375000
NODE_840_length_2609_cov_13.245418	2066	2146	12	6	80	0.0750000
NODE_840_length_2609_cov_13.245418	2066	2146	14	32	80	0.4000000
NODE_840_length_2609_cov_13.245418	2066	2146	18	7	80	0.0875000
NODE_840_length_2609_cov_13.245418	2066	2146	19	18	80	0.2250000
NODE_840_length_2609_cov_13.245418	2066	2146	20	8	80	0.1000000
NODE_840_length_2609_cov_13.245418	2119	2199	0	41	80	0.5125000
NODE_840_length_2609_cov_13.245418	2119	2199	2	18	80	0.2250000
NODE_840_length_2609_cov_13.245418	2119	2199	6	3	80	0.0375000
NODE_840_length_2609_cov_13.245418	2119	2199	12	6	80	0.0750000
NODE_840_length_2609_cov_13.245418	2119	2199	14	12	80	0.1500000
NODE_840_length_2609_cov_13.245418	2195	2275	0	21	80	0.2625000
NODE_840_length_2609_cov_13.245418	2195	2275	2	59	80	0.7375000
NODE_840_length_2609_cov_13.245418	2248	2328	0	74	80	0.9250000
NODE_840_length_2609_cov_13.245418	2248	2328	2	6	80	0.0750000
NODE_845_length_2595_cov_5.638622	2157	2237	0	80	80	1.0000000
NODE_847_length_2594_cov_109.880160	386	450	43	1	64	0.0156250
NODE_847_length_2594_cov_109.880160	386	450	45	3	64	0.0468750
NODE_847_length_2594_cov_109.880160	386	450	47	1	64	0.0156250
NODE_847_length_2594_cov_109.880160	386	450	61	3	64	0.0468750
NODE_847_length_2594_cov_109.880160	386	450	69	2	64	0.0312500
NODE_847_length_2594_cov_109.880160	386	450	73	1	64	0.0156250
NODE_847_length_2594_cov_109.880160	386	450	81	1	64	0.0156250
NODE_847_length_2594_cov_109.880160	386	450	85	2	64	0.0312500
NODE_847_length_2594_cov_109.880160	386	450	88	1	64	0.0156250
NODE_847_length_2594_cov_109.880160	386	450	91	1	64	0.0156250
NODE_847_length_2594_cov_109.880160	386	450	95	1	64	0.0156250
NODE_847_length_2594_cov_109.880160	386	450	105	1	64	0.0156250
NODE_847_length_2594_cov_109.880160	386	450	121	1	64	0.0156250
NODE_847_length_2594_cov_109.880160	386	450	122	1	64	0.0156250
NODE_847_length_2594_cov_109.880160	386	450	125	2	64	0.0312500
NODE_847_length_2594_cov_109.880160	386	450	135	1	64	0.0156250
NODE_847_length_2594_cov_109.880160	386	450	138	2	64	0.0312500
NODE_847_length_2594_cov_109.880160	386	450	146	1	64	0.0156250
NODE_847_length_2594_cov_109.880160	386	450	151	1	64	0.0156250
NODE_847_length_2594_cov_109.880160	386	450	162	1	64	0.0156250
NODE_847_length_2594_cov_109.880160	386	450	164	1	64	0.0156250
NODE_847_length_2594_cov_109.880160	386	450	177	1	64	0.0156250
NODE_847_length_2594_cov_109.880160	386	450	178	1	64	0.0156250
NODE_847_length_2594_cov_109.880160	386	450	180	2	64	0.0312500
NODE_847_length_2594_cov_109.880160	386	450	182	1	64	0.0156250
NODE_847_length_2594_cov_109.880160	386	450	186	1	64	0.0156250
NODE_847_length_2594_cov_109.880160	386	450	188	5	64	0.0781250
NODE_847_length_2594_cov_109.880160	386	450	194	1	64	0.0156250
NODE_847_length_2594_cov_109.880160	386	450	198	1	64	0.0156250
NODE_847_length_2594_cov_109.880160	386	450	213	1	64	0.0156250
NODE_847_length_2594_cov_109.880160	386	450	214	2	64	0.0312500
NODE_847_length_2594_cov_109.880160	386	450	216	7	64	0.1093750
NODE_847_length_2594_cov_109.880160	386	450	218	2	64	0.0312500
NODE_847_length_2594_cov_109.880160	386	450	224	2	64	0.0312500
NODE_847_length_2594_cov_109.880160	386	450	225	1	64	0.0156250
NODE_847_length_2594_cov_109.880160	386	450	231	1	64	0.0156250
NODE_847_length_2594_cov_109.880160	386	450	233	2	64	0.0312500
NODE_847_length_2594_cov_109.880160	386	450	237	3	64	0.0468750
NODE_847_length_2594_cov_109.880160	386	450	239	1	64	0.0156250
NODE_856_length_2575_cov_4.890549	1860	1912	0	30	52	0.5769231
NODE_856_length_2575_cov_4.890549	1860	1912	2	9	52	0.1730769
NODE_856_length_2575_cov_4.890549	1860	1912	8	13	52	0.2500000
NODE_857_length_2572_cov_46.828548	302	382	0	33	80	0.4125000
NODE_857_length_2572_cov_46.828548	302	382	2	47	80	0.5875000
NODE_857_length_2572_cov_46.828548	355	435	0	80	80	1.0000000
NODE_868_length_2551_cov_40.721860	1104	1150	14	26	46	0.5652174
NODE_868_length_2551_cov_40.721860	1104	1150	16	12	46	0.2608696
NODE_868_length_2551_cov_40.721860	1104	1150	18	7	46	0.1521739
NODE_868_length_2551_cov_40.721860	1104	1150	20	1	46	0.0217391
NODE_868_length_2551_cov_40.721860	1199	1259	8	1	60	0.0166667
NODE_868_length_2551_cov_40.721860	1199	1259	10	23	60	0.3833333
NODE_868_length_2551_cov_40.721860	1199	1259	12	7	60	0.1166667
NODE_868_length_2551_cov_40.721860	1199	1259	13	21	60	0.3500000
NODE_868_length_2551_cov_40.721860	1199	1259	14	8	60	0.1333333
NODE_870_length_2547_cov_218.062908	436	486	0	36	50	0.7200000
NODE_870_length_2547_cov_218.062908	436	486	2	8	50	0.1600000
NODE_870_length_2547_cov_218.062908	436	486	4	3	50	0.0600000
NODE_870_length_2547_cov_218.062908	436	486	6	3	50	0.0600000
NODE_879_length_2527_cov_27.275947	503	548	34	2	45	0.0444444
NODE_879_length_2527_cov_27.275947	503	548	36	17	45	0.3777778
NODE_879_length_2527_cov_27.275947	503	548	38	7	45	0.1555556
NODE_879_length_2527_cov_27.275947	503	548	39	3	45	0.0666667
NODE_879_length_2527_cov_27.275947	503	548	40	8	45	0.1777778
NODE_879_length_2527_cov_27.275947	503	548	41	6	45	0.1333333
NODE_879_length_2527_cov_27.275947	503	548	43	2	45	0.0444444
NODE_884_length_2519_cov_15.991322	2122	2202	0	80	80	1.0000000
NODE_884_length_2519_cov_15.991322	2175	2255	0	80	80	1.0000000
NODE_885_length_2518_cov_7.035965	62	142	129	2	80	0.0250000
NODE_885_length_2518_cov_7.035965	62	142	130	1	80	0.0125000
NODE_885_length_2518_cov_7.035965	62	142	132	1	80	0.0125000
NODE_885_length_2518_cov_7.035965	62	142	135	3	80	0.0375000
NODE_885_length_2518_cov_7.035965	62	142	136	1	80	0.0125000
NODE_885_length_2518_cov_7.035965	62	142	137	1	80	0.0125000
NODE_885_length_2518_cov_7.035965	62	142	140	1	80	0.0125000
NODE_885_length_2518_cov_7.035965	62	142	141	2	80	0.0250000
NODE_885_length_2518_cov_7.035965	62	142	145	2	80	0.0250000
NODE_885_length_2518_cov_7.035965	62	142	148	5	80	0.0625000
NODE_885_length_2518_cov_7.035965	62	142	152	3	80	0.0375000
NODE_885_length_2518_cov_7.035965	62	142	154	4	80	0.0500000
NODE_885_length_2518_cov_7.035965	62	142	156	6	80	0.0750000
NODE_885_length_2518_cov_7.035965	62	142	158	9	80	0.1125000
NODE_885_length_2518_cov_7.035965	62	142	159	4	80	0.0500000
NODE_885_length_2518_cov_7.035965	62	142	160	11	80	0.1375000
NODE_885_length_2518_cov_7.035965	62	142	161	1	80	0.0125000
NODE_885_length_2518_cov_7.035965	62	142	162	5	80	0.0625000
NODE_885_length_2518_cov_7.035965	62	142	164	1	80	0.0125000
NODE_885_length_2518_cov_7.035965	62	142	165	2	80	0.0250000
NODE_885_length_2518_cov_7.035965	62	142	166	4	80	0.0500000
NODE_885_length_2518_cov_7.035965	62	142	167	1	80	0.0125000
NODE_885_length_2518_cov_7.035965	62	142	168	10	80	0.1250000
NODE_885_length_2518_cov_7.035965	2005	2085	0	80	80	1.0000000
NODE_885_length_2518_cov_7.035965	2058	2138	0	80	80	1.0000000
NODE_887_length_2515_cov_37.984272	393	473	0	80	80	1.0000000
NODE_887_length_2515_cov_37.984272	446	526	0	80	80	1.0000000
NODE_887_length_2515_cov_37.984272	1896	1976	0	80	80	1.0000000
NODE_887_length_2515_cov_37.984272	1949	2029	0	80	80	1.0000000
NODE_887_length_2515_cov_37.984272	2025	2105	0	80	80	1.0000000
NODE_887_length_2515_cov_37.984272	2025	2104	0	79	79	1.0000000
NODE_887_length_2515_cov_37.984272	2078	2158	0	80	80	1.0000000
NODE_888_length_2512_cov_48.259428	1299	1379	24	3	80	0.0375000
NODE_888_length_2512_cov_48.259428	1299	1379	26	19	80	0.2375000
NODE_888_length_2512_cov_48.259428	1299	1379	27	4	80	0.0500000
NODE_888_length_2512_cov_48.259428	1299	1379	28	10	80	0.1250000
NODE_888_length_2512_cov_48.259428	1299	1379	34	3	80	0.0375000
NODE_888_length_2512_cov_48.259428	1299	1379	38	5	80	0.0625000
NODE_888_length_2512_cov_48.259428	1299	1379	39	1	80	0.0125000
NODE_888_length_2512_cov_48.259428	1299	1379	43	8	80	0.1000000
NODE_888_length_2512_cov_48.259428	1299	1379	45	1	80	0.0125000
NODE_888_length_2512_cov_48.259428	1299	1379	46	8	80	0.1000000
NODE_888_length_2512_cov_48.259428	1299	1379	48	12	80	0.1500000
NODE_888_length_2512_cov_48.259428	1299	1379	49	3	80	0.0375000
NODE_888_length_2512_cov_48.259428	1299	1379	50	1	80	0.0125000
NODE_888_length_2512_cov_48.259428	1299	1379	52	2	80	0.0250000
NODE_888_length_2512_cov_48.259428	1352	1432	19	7	80	0.0875000
NODE_888_length_2512_cov_48.259428	1352	1432	21	15	80	0.1875000
NODE_888_length_2512_cov_48.259428	1352	1432	22	8	80	0.1000000
NODE_888_length_2512_cov_48.259428	1352	1432	23	5	80	0.0625000
NODE_888_length_2512_cov_48.259428	1352	1432	24	1	80	0.0125000
NODE_888_length_2512_cov_48.259428	1352	1432	25	1	80	0.0125000
NODE_888_length_2512_cov_48.259428	1352	1432	26	18	80	0.2250000
NODE_888_length_2512_cov_48.259428	1352	1432	27	15	80	0.1875000
NODE_888_length_2512_cov_48.259428	1352	1432	28	10	80	0.1250000
NODE_888_length_2512_cov_48.259428	1428	1512	19	7	84	0.0833333
NODE_888_length_2512_cov_48.259428	1428	1512	21	5	84	0.0595238
NODE_888_length_2512_cov_48.259428	1428	1512	23	2	84	0.0238095
NODE_888_length_2512_cov_48.259428	1428	1512	25	10	84	0.1190476
NODE_888_length_2512_cov_48.259428	1428	1512	27	1	84	0.0119048
NODE_888_length_2512_cov_48.259428	1428	1512	32	1	84	0.0119048
NODE_888_length_2512_cov_48.259428	1428	1512	40	3	84	0.0357143
NODE_888_length_2512_cov_48.259428	1428	1512	41	3	84	0.0357143
NODE_888_length_2512_cov_48.259428	1428	1512	43	11	84	0.1309524
NODE_888_length_2512_cov_48.259428	1428	1512	45	2	84	0.0238095
NODE_888_length_2512_cov_48.259428	1428	1512	46	1	84	0.0119048
NODE_888_length_2512_cov_48.259428	1428	1512	50	1	84	0.0119048
NODE_888_length_2512_cov_48.259428	1428	1512	54	1	84	0.0119048
NODE_888_length_2512_cov_48.259428	1428	1512	58	1	84	0.0119048
NODE_888_length_2512_cov_48.259428	1428	1512	60	1	84	0.0119048
NODE_888_length_2512_cov_48.259428	1428	1512	61	1	84	0.0119048
NODE_888_length_2512_cov_48.259428	1428	1512	65	3	84	0.0357143
NODE_888_length_2512_cov_48.259428	1428	1512	69	1	84	0.0119048
NODE_888_length_2512_cov_48.259428	1428	1512	75	2	84	0.0238095
NODE_888_length_2512_cov_48.259428	1428	1512	77	2	84	0.0238095
NODE_888_length_2512_cov_48.259428	1428	1512	83	1	84	0.0119048
NODE_888_length_2512_cov_48.259428	1428	1512	89	4	84	0.0476190
NODE_888_length_2512_cov_48.259428	1428	1512	95	2	84	0.0238095
NODE_888_length_2512_cov_48.259428	1428	1512	97	5	84	0.0595238
NODE_888_length_2512_cov_48.259428	1428	1512	99	2	84	0.0238095
NODE_888_length_2512_cov_48.259428	1428	1512	103	1	84	0.0119048
NODE_888_length_2512_cov_48.259428	1428	1512	105	1	84	0.0119048
NODE_888_length_2512_cov_48.259428	1428	1512	108	1	84	0.0119048
NODE_888_length_2512_cov_48.259428	1428	1512	113	1	84	0.0119048
NODE_888_length_2512_cov_48.259428	1428	1512	116	1	84	0.0119048
NODE_888_length_2512_cov_48.259428	1428	1512	120	6	84	0.0714286
NODE_888_length_2512_cov_48.259428	1485	1565	77	2	80	0.0250000
NODE_888_length_2512_cov_48.259428	1485	1565	83	1	80	0.0125000
NODE_888_length_2512_cov_48.259428	1485	1565	89	4	80	0.0500000
NODE_888_length_2512_cov_48.259428	1485	1565	95	2	80	0.0250000
NODE_888_length_2512_cov_48.259428	1485	1565	97	5	80	0.0625000
NODE_888_length_2512_cov_48.259428	1485	1565	99	2	80	0.0250000
NODE_888_length_2512_cov_48.259428	1485	1565	103	1	80	0.0125000
NODE_888_length_2512_cov_48.259428	1485	1565	105	1	80	0.0125000
NODE_888_length_2512_cov_48.259428	1485	1565	108	1	80	0.0125000
NODE_888_length_2512_cov_48.259428	1485	1565	113	1	80	0.0125000
NODE_888_length_2512_cov_48.259428	1485	1565	116	3	80	0.0375000
NODE_888_length_2512_cov_48.259428	1485	1565	117	2	80	0.0250000
NODE_888_length_2512_cov_48.259428	1485	1565	119	1	80	0.0125000
NODE_888_length_2512_cov_48.259428	1485	1565	120	11	80	0.1375000
NODE_888_length_2512_cov_48.259428	1485	1565	122	8	80	0.1000000
NODE_888_length_2512_cov_48.259428	1485	1565	124	7	80	0.0875000
NODE_888_length_2512_cov_48.259428	1485	1565	126	16	80	0.2000000
NODE_888_length_2512_cov_48.259428	1485	1565	128	6	80	0.0750000
NODE_888_length_2512_cov_48.259428	1485	1565	129	1	80	0.0125000
NODE_888_length_2512_cov_48.259428	1485	1565	130	1	80	0.0125000
NODE_888_length_2512_cov_48.259428	1485	1565	131	3	80	0.0375000
NODE_888_length_2512_cov_48.259428	1485	1565	132	1	80	0.0125000
NODE_891_length_2505_cov_102.009975	390	470	2	80	80	1.0000000
NODE_891_length_2505_cov_102.009975	443	510	0	8	67	0.1194030
NODE_891_length_2505_cov_102.009975	443	510	2	59	67	0.8805970
NODE_894_length_2499_cov_2.655417	2325	2375	0	50	50	1.0000000
NODE_895_length_2498_cov_9.614840	239	281	2	42	42	1.0000000
NODE_895_length_2498_cov_9.614840	254	335	0	35	81	0.4320988
NODE_895_length_2498_cov_9.614840	254	335	2	46	81	0.5679013
NODE_895_length_2498_cov_9.614840	254	335	0	35	81	0.4320988
NODE_895_length_2498_cov_9.614840	254	335	2	46	81	0.5679013
NODE_895_length_2498_cov_9.614840	331	411	0	80	80	1.0000000
NODE_895_length_2498_cov_9.614840	384	464	0	80	80	1.0000000
NODE_898_length_2495_cov_5.151085	2395	2444	10	10	49	0.2040816
NODE_898_length_2495_cov_5.151085	2395	2444	13	1	49	0.0204082
NODE_898_length_2495_cov_5.151085	2395	2444	14	38	49	0.7755102
NODE_898_length_2495_cov_5.151085	2395	2444	10	10	49	0.2040816
NODE_898_length_2495_cov_5.151085	2395	2444	13	1	49	0.0204082
NODE_898_length_2495_cov_5.151085	2395	2444	14	38	49	0.7755102
NODE_898_length_2495_cov_5.151085	2396	2444	10	10	48	0.2083333
NODE_898_length_2495_cov_5.151085	2396	2444	14	38	48	0.7916667
NODE_898_length_2495_cov_5.151085	2396	2444	10	10	48	0.2083333
NODE_898_length_2495_cov_5.151085	2396	2444	14	38	48	0.7916667
NODE_898_length_2495_cov_5.151085	2396	2444	10	10	48	0.2083333
NODE_898_length_2495_cov_5.151085	2396	2444	14	38	48	0.7916667
NODE_900_length_2492_cov_43.645215	408	488	0	80	80	1.0000000
NODE_903_length_2489_cov_15.105021	204	234	0	30	30	1.0000000
NODE_905_length_2488_cov_2.434910	2141	2200	17	8	59	0.1355932
NODE_905_length_2488_cov_2.434910	2141	2200	19	20	59	0.3389831
NODE_905_length_2488_cov_2.434910	2141	2200	23	9	59	0.1525424
NODE_905_length_2488_cov_2.434910	2141	2200	25	6	59	0.1016949
NODE_905_length_2488_cov_2.434910	2141	2200	28	3	59	0.0508475
NODE_905_length_2488_cov_2.434910	2141	2200	29	13	59	0.2203390
NODE_906_length_2484_cov_335.301887	224	279	658	2	55	0.0363636
NODE_906_length_2484_cov_335.301887	224	279	660	1	55	0.0181818
NODE_906_length_2484_cov_335.301887	224	279	671	1	55	0.0181818
NODE_906_length_2484_cov_335.301887	224	279	678	1	55	0.0181818
NODE_906_length_2484_cov_335.301887	224	279	679	1	55	0.0181818
NODE_906_length_2484_cov_335.301887	224	279	680	1	55	0.0181818
NODE_906_length_2484_cov_335.301887	224	279	685	1	55	0.0181818
NODE_906_length_2484_cov_335.301887	224	279	695	2	55	0.0363636
NODE_906_length_2484_cov_335.301887	224	279	704	1	55	0.0181818
NODE_906_length_2484_cov_335.301887	224	279	708	1	55	0.0181818
NODE_906_length_2484_cov_335.301887	224	279	710	1	55	0.0181818
NODE_906_length_2484_cov_335.301887	224	279	714	3	55	0.0545455
NODE_906_length_2484_cov_335.301887	224	279	718	1	55	0.0181818
NODE_906_length_2484_cov_335.301887	224	279	719	2	55	0.0363636
NODE_906_length_2484_cov_335.301887	224	279	724	1	55	0.0181818
NODE_906_length_2484_cov_335.301887	224	279	732	1	55	0.0181818
NODE_906_length_2484_cov_335.301887	224	279	735	1	55	0.0181818
NODE_906_length_2484_cov_335.301887	224	279	736	3	55	0.0545455
NODE_906_length_2484_cov_335.301887	224	279	739	1	55	0.0181818
NODE_906_length_2484_cov_335.301887	224	279	740	1	55	0.0181818
NODE_906_length_2484_cov_335.301887	224	279	741	1	55	0.0181818
NODE_906_length_2484_cov_335.301887	224	279	742	1	55	0.0181818
NODE_906_length_2484_cov_335.301887	224	279	745	1	55	0.0181818
NODE_906_length_2484_cov_335.301887	224	279	746	2	55	0.0363636
NODE_906_length_2484_cov_335.301887	224	279	756	2	55	0.0363636
NODE_906_length_2484_cov_335.301887	224	279	765	1	55	0.0181818
NODE_906_length_2484_cov_335.301887	224	279	771	1	55	0.0181818
NODE_906_length_2484_cov_335.301887	224	279	790	2	55	0.0363636
NODE_906_length_2484_cov_335.301887	224	279	797	1	55	0.0181818
NODE_906_length_2484_cov_335.301887	224	279	799	1	55	0.0181818
NODE_906_length_2484_cov_335.301887	224	279	801	1	55	0.0181818
NODE_906_length_2484_cov_335.301887	224	279	802	1	55	0.0181818
NODE_906_length_2484_cov_335.301887	224	279	803	1	55	0.0181818
NODE_906_length_2484_cov_335.301887	224	279	805	2	55	0.0363636
NODE_906_length_2484_cov_335.301887	224	279	807	1	55	0.0181818
NODE_906_length_2484_cov_335.301887	224	279	810	3	55	0.0545455
NODE_906_length_2484_cov_335.301887	224	279	816	1	55	0.0181818
NODE_906_length_2484_cov_335.301887	224	279	822	1	55	0.0181818
NODE_906_length_2484_cov_335.301887	224	279	824	1	55	0.0181818
NODE_906_length_2484_cov_335.301887	224	279	831	1	55	0.0181818
NODE_906_length_2484_cov_335.301887	224	279	836	1	55	0.0181818
NODE_906_length_2484_cov_335.301887	224	279	840	1	55	0.0181818
NODE_906_length_2484_cov_335.301887	252	332	609	2	80	0.0250000
NODE_906_length_2484_cov_335.301887	252	332	611	1	80	0.0125000
NODE_906_length_2484_cov_335.301887	252	332	621	1	80	0.0125000
NODE_906_length_2484_cov_335.301887	252	332	631	1	80	0.0125000
NODE_906_length_2484_cov_335.301887	252	332	640	1	80	0.0125000
NODE_906_length_2484_cov_335.301887	252	332	643	1	80	0.0125000
NODE_906_length_2484_cov_335.301887	252	332	663	1	80	0.0125000
NODE_906_length_2484_cov_335.301887	252	332	680	1	80	0.0125000
NODE_906_length_2484_cov_335.301887	252	332	698	1	80	0.0125000
NODE_906_length_2484_cov_335.301887	252	332	706	1	80	0.0125000
NODE_906_length_2484_cov_335.301887	252	332	721	1	80	0.0125000
NODE_906_length_2484_cov_335.301887	252	332	728	1	80	0.0125000
NODE_906_length_2484_cov_335.301887	252	332	742	1	80	0.0125000
NODE_906_length_2484_cov_335.301887	252	332	745	1	80	0.0125000
NODE_906_length_2484_cov_335.301887	252	332	746	2	80	0.0250000
NODE_906_length_2484_cov_335.301887	252	332	753	1	80	0.0125000
NODE_906_length_2484_cov_335.301887	252	332	756	2	80	0.0250000
NODE_906_length_2484_cov_335.301887	252	332	765	1	80	0.0125000
NODE_906_length_2484_cov_335.301887	252	332	771	1	80	0.0125000
NODE_906_length_2484_cov_335.301887	252	332	779	1	80	0.0125000
NODE_906_length_2484_cov_335.301887	252	332	790	3	80	0.0375000
NODE_906_length_2484_cov_335.301887	252	332	797	1	80	0.0125000
NODE_906_length_2484_cov_335.301887	252	332	799	1	80	0.0125000
NODE_906_length_2484_cov_335.301887	252	332	801	1	80	0.0125000
NODE_906_length_2484_cov_335.301887	252	332	802	2	80	0.0250000
NODE_906_length_2484_cov_335.301887	252	332	803	1	80	0.0125000
NODE_906_length_2484_cov_335.301887	252	332	805	2	80	0.0250000
NODE_906_length_2484_cov_335.301887	252	332	807	2	80	0.0250000
NODE_906_length_2484_cov_335.301887	252	332	808	1	80	0.0125000
NODE_906_length_2484_cov_335.301887	252	332	809	2	80	0.0250000
NODE_906_length_2484_cov_335.301887	252	332	810	3	80	0.0375000
NODE_906_length_2484_cov_335.301887	252	332	816	1	80	0.0125000
NODE_906_length_2484_cov_335.301887	252	332	821	1	80	0.0125000
NODE_906_length_2484_cov_335.301887	252	332	822	1	80	0.0125000
NODE_906_length_2484_cov_335.301887	252	332	823	2	80	0.0250000
NODE_906_length_2484_cov_335.301887	252	332	824	1	80	0.0125000
NODE_906_length_2484_cov_335.301887	252	332	825	2	80	0.0250000
NODE_906_length_2484_cov_335.301887	252	332	827	5	80	0.0625000
NODE_906_length_2484_cov_335.301887	252	332	828	3	80	0.0375000
NODE_906_length_2484_cov_335.301887	252	332	829	4	80	0.0500000
NODE_906_length_2484_cov_335.301887	252	332	831	2	80	0.0250000
NODE_906_length_2484_cov_335.301887	252	332	832	1	80	0.0125000
NODE_906_length_2484_cov_335.301887	252	332	833	1	80	0.0125000
NODE_906_length_2484_cov_335.301887	252	332	834	1	80	0.0125000
NODE_906_length_2484_cov_335.301887	252	332	835	1	80	0.0125000
NODE_906_length_2484_cov_335.301887	252	332	836	2	80	0.0250000
NODE_906_length_2484_cov_335.301887	252	332	838	1	80	0.0125000
NODE_906_length_2484_cov_335.301887	252	332	840	1	80	0.0125000
NODE_906_length_2484_cov_335.301887	252	332	841	1	80	0.0125000
NODE_906_length_2484_cov_335.301887	252	332	843	2	80	0.0250000
NODE_906_length_2484_cov_335.301887	252	332	844	1	80	0.0125000
NODE_906_length_2484_cov_335.301887	252	332	847	1	80	0.0125000
NODE_906_length_2484_cov_335.301887	252	332	850	1	80	0.0125000
NODE_906_length_2484_cov_335.301887	252	332	853	1	80	0.0125000
NODE_906_length_2484_cov_335.301887	252	332	856	1	80	0.0125000
NODE_912_length_2479_cov_90.381092	369	449	0	80	80	1.0000000
NODE_912_length_2479_cov_90.381092	422	499	0	77	77	1.0000000
NODE_912_length_2479_cov_90.381092	1610	1685	110	1	75	0.0133333
NODE_912_length_2479_cov_90.381092	1610	1685	136	1	75	0.0133333
NODE_912_length_2479_cov_90.381092	1610	1685	145	2	75	0.0266667
NODE_912_length_2479_cov_90.381092	1610	1685	148	2	75	0.0266667
NODE_912_length_2479_cov_90.381092	1610	1685	158	1	75	0.0133333
NODE_912_length_2479_cov_90.381092	1610	1685	162	1	75	0.0133333
NODE_912_length_2479_cov_90.381092	1610	1685	164	2	75	0.0266667
NODE_912_length_2479_cov_90.381092	1610	1685	180	2	75	0.0266667
NODE_912_length_2479_cov_90.381092	1610	1685	184	2	75	0.0266667
NODE_912_length_2479_cov_90.381092	1610	1685	198	1	75	0.0133333
NODE_912_length_2479_cov_90.381092	1610	1685	202	1	75	0.0133333
NODE_912_length_2479_cov_90.381092	1610	1685	213	1	75	0.0133333
NODE_912_length_2479_cov_90.381092	1610	1685	218	1	75	0.0133333
NODE_912_length_2479_cov_90.381092	1610	1685	223	1	75	0.0133333
NODE_912_length_2479_cov_90.381092	1610	1685	227	1	75	0.0133333
NODE_912_length_2479_cov_90.381092	1610	1685	247	1	75	0.0133333
NODE_912_length_2479_cov_90.381092	1610	1685	255	1	75	0.0133333
NODE_912_length_2479_cov_90.381092	1610	1685	263	1	75	0.0133333
NODE_912_length_2479_cov_90.381092	1610	1685	266	1	75	0.0133333
NODE_912_length_2479_cov_90.381092	1610	1685	289	1	75	0.0133333
NODE_912_length_2479_cov_90.381092	1610	1685	291	1	75	0.0133333
NODE_912_length_2479_cov_90.381092	1610	1685	305	1	75	0.0133333
NODE_912_length_2479_cov_90.381092	1610	1685	309	2	75	0.0266667
NODE_912_length_2479_cov_90.381092	1610	1685	323	3	75	0.0400000
NODE_912_length_2479_cov_90.381092	1610	1685	337	1	75	0.0133333
NODE_912_length_2479_cov_90.381092	1610	1685	348	1	75	0.0133333
NODE_912_length_2479_cov_90.381092	1610	1685	352	1	75	0.0133333
NODE_912_length_2479_cov_90.381092	1610	1685	360	1	75	0.0133333
NODE_912_length_2479_cov_90.381092	1610	1685	365	2	75	0.0266667
NODE_912_length_2479_cov_90.381092	1610	1685	366	1	75	0.0133333
NODE_912_length_2479_cov_90.381092	1610	1685	377	1	75	0.0133333
NODE_912_length_2479_cov_90.381092	1610	1685	383	1	75	0.0133333
NODE_912_length_2479_cov_90.381092	1610	1685	391	1	75	0.0133333
NODE_912_length_2479_cov_90.381092	1610	1685	401	1	75	0.0133333
NODE_912_length_2479_cov_90.381092	1610	1685	405	1	75	0.0133333
NODE_912_length_2479_cov_90.381092	1610	1685	415	1	75	0.0133333
NODE_912_length_2479_cov_90.381092	1610	1685	416	1	75	0.0133333
NODE_912_length_2479_cov_90.381092	1610	1685	427	1	75	0.0133333
NODE_912_length_2479_cov_90.381092	1610	1685	432	1	75	0.0133333
NODE_912_length_2479_cov_90.381092	1610	1685	434	1	75	0.0133333
NODE_912_length_2479_cov_90.381092	1610	1685	436	1	75	0.0133333
NODE_912_length_2479_cov_90.381092	1610	1685	443	1	75	0.0133333
NODE_912_length_2479_cov_90.381092	1610	1685	455	1	75	0.0133333
NODE_912_length_2479_cov_90.381092	1610	1685	462	1	75	0.0133333
NODE_912_length_2479_cov_90.381092	1610	1685	464	1	75	0.0133333
NODE_912_length_2479_cov_90.381092	1610	1685	469	1	75	0.0133333
NODE_912_length_2479_cov_90.381092	1610	1685	474	1	75	0.0133333
NODE_912_length_2479_cov_90.381092	1610	1685	481	1	75	0.0133333
NODE_912_length_2479_cov_90.381092	1610	1685	492	2	75	0.0266667
NODE_912_length_2479_cov_90.381092	1610	1685	506	1	75	0.0133333
NODE_912_length_2479_cov_90.381092	1610	1685	507	1	75	0.0133333
NODE_912_length_2479_cov_90.381092	1610	1685	508	4	75	0.0533333
NODE_912_length_2479_cov_90.381092	1610	1685	509	5	75	0.0666667
NODE_912_length_2479_cov_90.381092	1610	1685	510	2	75	0.0266667
NODE_912_length_2479_cov_90.381092	1610	1685	511	1	75	0.0133333
NODE_912_length_2479_cov_90.381092	1610	1685	512	2	75	0.0266667
NODE_912_length_2479_cov_90.381092	1658	1730	434	1	72	0.0138889
NODE_912_length_2479_cov_90.381092	1658	1730	436	2	72	0.0277778
NODE_912_length_2479_cov_90.381092	1658	1730	437	1	72	0.0138889
NODE_912_length_2479_cov_90.381092	1658	1730	438	1	72	0.0138889
NODE_912_length_2479_cov_90.381092	1658	1730	440	1	72	0.0138889
NODE_912_length_2479_cov_90.381092	1658	1730	443	2	72	0.0277778
NODE_912_length_2479_cov_90.381092	1658	1730	445	1	72	0.0138889
NODE_912_length_2479_cov_90.381092	1658	1730	452	1	72	0.0138889
NODE_912_length_2479_cov_90.381092	1658	1730	455	1	72	0.0138889
NODE_912_length_2479_cov_90.381092	1658	1730	456	1	72	0.0138889
NODE_912_length_2479_cov_90.381092	1658	1730	461	3	72	0.0416667
NODE_912_length_2479_cov_90.381092	1658	1730	462	1	72	0.0138889
NODE_912_length_2479_cov_90.381092	1658	1730	463	1	72	0.0138889
NODE_912_length_2479_cov_90.381092	1658	1730	464	2	72	0.0277778
NODE_912_length_2479_cov_90.381092	1658	1730	467	1	72	0.0138889
NODE_912_length_2479_cov_90.381092	1658	1730	469	1	72	0.0138889
NODE_912_length_2479_cov_90.381092	1658	1730	472	1	72	0.0138889
NODE_912_length_2479_cov_90.381092	1658	1730	474	4	72	0.0555556
NODE_912_length_2479_cov_90.381092	1658	1730	475	1	72	0.0138889
NODE_912_length_2479_cov_90.381092	1658	1730	478	1	72	0.0138889
NODE_912_length_2479_cov_90.381092	1658	1730	479	2	72	0.0277778
NODE_912_length_2479_cov_90.381092	1658	1730	480	1	72	0.0138889
NODE_912_length_2479_cov_90.381092	1658	1730	481	2	72	0.0277778
NODE_912_length_2479_cov_90.381092	1658	1730	483	3	72	0.0416667
NODE_912_length_2479_cov_90.381092	1658	1730	485	1	72	0.0138889
NODE_912_length_2479_cov_90.381092	1658	1730	490	1	72	0.0138889
NODE_912_length_2479_cov_90.381092	1658	1730	492	3	72	0.0416667
NODE_912_length_2479_cov_90.381092	1658	1730	498	1	72	0.0138889
NODE_912_length_2479_cov_90.381092	1658	1730	502	1	72	0.0138889
NODE_912_length_2479_cov_90.381092	1658	1730	506	1	72	0.0138889
NODE_912_length_2479_cov_90.381092	1658	1730	507	1	72	0.0138889
NODE_912_length_2479_cov_90.381092	1658	1730	508	4	72	0.0555556
NODE_912_length_2479_cov_90.381092	1658	1730	509	6	72	0.0833333
NODE_912_length_2479_cov_90.381092	1658	1730	510	3	72	0.0416667
NODE_912_length_2479_cov_90.381092	1658	1730	511	2	72	0.0277778
NODE_912_length_2479_cov_90.381092	1658	1730	512	3	72	0.0416667
NODE_912_length_2479_cov_90.381092	1658	1730	515	1	72	0.0138889
NODE_912_length_2479_cov_90.381092	1658	1730	516	2	72	0.0277778
NODE_912_length_2479_cov_90.381092	1658	1730	517	1	72	0.0138889
NODE_912_length_2479_cov_90.381092	1658	1730	519	1	72	0.0138889
NODE_912_length_2479_cov_90.381092	1658	1730	520	3	72	0.0416667
NODE_912_length_2479_cov_90.381092	1658	1730	522	1	72	0.0138889
NODE_913_length_2479_cov_3.433193	2379	2426	2	46	47	0.9787234
NODE_913_length_2479_cov_3.433193	2379	2426	4	1	47	0.0212766
NODE_913_length_2479_cov_3.433193	2399	2479	0	6	80	0.0750000
NODE_913_length_2479_cov_3.433193	2399	2479	2	74	80	0.9250000
NODE_915_length_2474_cov_7.237895	399	479	2	4	80	0.0500000
NODE_915_length_2474_cov_7.237895	399	479	4	76	80	0.9500000
NODE_915_length_2474_cov_7.237895	452	532	0	41	80	0.5125000
NODE_915_length_2474_cov_7.237895	452	532	2	16	80	0.2000000
NODE_915_length_2474_cov_7.237895	452	532	4	23	80	0.2875000
NODE_922_length_2465_cov_3.098056	2133	2213	0	29	80	0.3625000
NODE_922_length_2465_cov_3.098056	2133	2213	2	1	80	0.0125000
NODE_922_length_2465_cov_3.098056	2133	2213	4	5	80	0.0625000
NODE_922_length_2465_cov_3.098056	2133	2213	6	15	80	0.1875000
NODE_922_length_2465_cov_3.098056	2133	2213	8	2	80	0.0250000
NODE_922_length_2465_cov_3.098056	2133	2213	10	28	80	0.3500000
NODE_922_length_2465_cov_3.098056	2191	2253	4	4	62	0.0645161
NODE_922_length_2465_cov_3.098056	2191	2253	8	19	62	0.3064516
NODE_922_length_2465_cov_3.098056	2191	2253	10	39	62	0.6290323
NODE_923_length_2464_cov_24.562791	331	409	0	39	78	0.5000000
NODE_923_length_2464_cov_24.562791	331	409	4	39	78	0.5000000
NODE_923_length_2464_cov_24.562791	382	462	0	1	80	0.0125000
NODE_923_length_2464_cov_24.562791	382	462	4	79	80	0.9875000
NODE_924_length_2461_cov_2.696444	292	372	0	20	80	0.2500000
NODE_924_length_2461_cov_2.696444	292	372	2	59	80	0.7375000
NODE_924_length_2461_cov_2.696444	292	372	3	1	80	0.0125000
NODE_924_length_2461_cov_2.696444	345	425	0	40	80	0.5000000
NODE_924_length_2461_cov_2.696444	345	425	2	40	80	0.5000000
NODE_938_length_2447_cov_16.079216	2344	2424	36	3	80	0.0375000
NODE_938_length_2447_cov_16.079216	2344	2424	37	2	80	0.0250000
NODE_938_length_2447_cov_16.079216	2344	2424	39	1	80	0.0125000
NODE_938_length_2447_cov_16.079216	2344	2424	43	1	80	0.0125000
NODE_938_length_2447_cov_16.079216	2344	2424	45	4	80	0.0500000
NODE_938_length_2447_cov_16.079216	2344	2424	46	1	80	0.0125000
NODE_938_length_2447_cov_16.079216	2344	2424	48	5	80	0.0625000
NODE_938_length_2447_cov_16.079216	2344	2424	50	3	80	0.0375000
NODE_938_length_2447_cov_16.079216	2344	2424	52	5	80	0.0625000
NODE_938_length_2447_cov_16.079216	2344	2424	55	2	80	0.0250000
NODE_938_length_2447_cov_16.079216	2344	2424	57	3	80	0.0375000
NODE_938_length_2447_cov_16.079216	2344	2424	59	4	80	0.0500000
NODE_938_length_2447_cov_16.079216	2344	2424	61	12	80	0.1500000
NODE_938_length_2447_cov_16.079216	2344	2424	63	4	80	0.0500000
NODE_938_length_2447_cov_16.079216	2344	2424	64	6	80	0.0750000
NODE_938_length_2447_cov_16.079216	2344	2424	66	5	80	0.0625000
NODE_938_length_2447_cov_16.079216	2344	2424	70	2	80	0.0250000
NODE_938_length_2447_cov_16.079216	2344	2424	72	7	80	0.0875000
NODE_938_length_2447_cov_16.079216	2344	2424	74	2	80	0.0250000
NODE_938_length_2447_cov_16.079216	2344	2424	78	6	80	0.0750000
NODE_938_length_2447_cov_16.079216	2344	2424	80	2	80	0.0250000
NODE_938_length_2447_cov_16.079216	2397	2447	1	2	50	0.0400000
NODE_938_length_2447_cov_16.079216	2397	2447	4	1	50	0.0200000
NODE_938_length_2447_cov_16.079216	2397	2447	9	1	50	0.0200000
NODE_938_length_2447_cov_16.079216	2397	2447	13	1	50	0.0200000
NODE_938_length_2447_cov_16.079216	2397	2447	19	5	50	0.1000000
NODE_938_length_2447_cov_16.079216	2397	2447	22	3	50	0.0600000
NODE_938_length_2447_cov_16.079216	2397	2447	25	2	50	0.0400000
NODE_938_length_2447_cov_16.079216	2397	2447	31	4	50	0.0800000
NODE_938_length_2447_cov_16.079216	2397	2447	34	3	50	0.0600000
NODE_938_length_2447_cov_16.079216	2397	2447	36	4	50	0.0800000
NODE_938_length_2447_cov_16.079216	2397	2447	37	2	50	0.0400000
NODE_938_length_2447_cov_16.079216	2397	2447	39	1	50	0.0200000
NODE_938_length_2447_cov_16.079216	2397	2447	43	1	50	0.0200000
NODE_938_length_2447_cov_16.079216	2397	2447	45	4	50	0.0800000
NODE_938_length_2447_cov_16.079216	2397	2447	46	1	50	0.0200000
NODE_938_length_2447_cov_16.079216	2397	2447	48	5	50	0.1000000
NODE_938_length_2447_cov_16.079216	2397	2447	50	3	50	0.0600000
NODE_938_length_2447_cov_16.079216	2397	2447	52	5	50	0.1000000
NODE_938_length_2447_cov_16.079216	2397	2447	55	2	50	0.0400000
NODE_940_length_2446_cov_2.341287	1521	1578	2	26	57	0.4561403
NODE_940_length_2446_cov_2.341287	1521	1578	3	1	57	0.0175439
NODE_940_length_2446_cov_2.341287	1521	1578	4	30	57	0.5263158
NODE_940_length_2446_cov_2.341287	1551	1593	2	32	42	0.7619048
NODE_940_length_2446_cov_2.341287	1551	1593	4	10	42	0.2380952
NODE_949_length_2437_cov_13.341745	418	498	4	37	80	0.4625000
NODE_949_length_2437_cov_13.341745	418	498	6	43	80	0.5375000
NODE_949_length_2437_cov_13.341745	471	551	0	3	80	0.0375000
NODE_949_length_2437_cov_13.341745	471	551	2	43	80	0.5375000
NODE_949_length_2437_cov_13.341745	471	551	4	30	80	0.3750000
NODE_949_length_2437_cov_13.341745	471	551	10	2	80	0.0250000
NODE_949_length_2437_cov_13.341745	471	551	11	1	80	0.0125000
NODE_949_length_2437_cov_13.341745	471	551	13	1	80	0.0125000
NODE_951_length_2432_cov_70.360909	1875	1955	0	38	80	0.4750000
NODE_951_length_2432_cov_70.360909	1875	1955	2	42	80	0.5250000
NODE_951_length_2432_cov_70.360909	1928	2008	0	13	80	0.1625000
NODE_951_length_2432_cov_70.360909	1928	2008	2	67	80	0.8375000
NODE_955_length_2430_cov_19.835264	0	68	11	1	68	0.0147059
NODE_955_length_2430_cov_19.835264	0	68	13	1	68	0.0147059
NODE_955_length_2430_cov_19.835264	0	68	17	3	68	0.0441176
NODE_955_length_2430_cov_19.835264	0	68	19	1	68	0.0147059
NODE_955_length_2430_cov_19.835264	0	68	20	1	68	0.0147059
NODE_955_length_2430_cov_19.835264	0	68	24	6	68	0.0882353
NODE_955_length_2430_cov_19.835264	0	68	27	1	68	0.0147059
NODE_955_length_2430_cov_19.835264	0	68	28	1	68	0.0147059
NODE_955_length_2430_cov_19.835264	0	68	30	1	68	0.0147059
NODE_955_length_2430_cov_19.835264	0	68	31	1	68	0.0147059
NODE_955_length_2430_cov_19.835264	0	68	33	1	68	0.0147059
NODE_955_length_2430_cov_19.835264	0	68	35	1	68	0.0147059
NODE_955_length_2430_cov_19.835264	0	68	39	1	68	0.0147059
NODE_955_length_2430_cov_19.835264	0	68	41	3	68	0.0441176
NODE_955_length_2430_cov_19.835264	0	68	43	1	68	0.0147059
NODE_955_length_2430_cov_19.835264	0	68	47	1	68	0.0147059
NODE_955_length_2430_cov_19.835264	0	68	48	2	68	0.0294118
NODE_955_length_2430_cov_19.835264	0	68	50	2	68	0.0294118
NODE_955_length_2430_cov_19.835264	0	68	52	7	68	0.1029412
NODE_955_length_2430_cov_19.835264	0	68	56	1	68	0.0147059
NODE_955_length_2430_cov_19.835264	0	68	60	5	68	0.0735294
NODE_955_length_2430_cov_19.835264	0	68	62	2	68	0.0294118
NODE_955_length_2430_cov_19.835264	0	68	64	2	68	0.0294118
NODE_955_length_2430_cov_19.835264	0	68	66	1	68	0.0147059
NODE_955_length_2430_cov_19.835264	0	68	76	1	68	0.0147059
NODE_955_length_2430_cov_19.835264	0	68	82	2	68	0.0294118
NODE_955_length_2430_cov_19.835264	0	68	84	3	68	0.0441176
NODE_955_length_2430_cov_19.835264	0	68	88	4	68	0.0588235
NODE_955_length_2430_cov_19.835264	0	68	91	2	68	0.0294118
NODE_955_length_2430_cov_19.835264	0	68	104	3	68	0.0441176
NODE_955_length_2430_cov_19.835264	0	68	105	2	68	0.0294118
NODE_955_length_2430_cov_19.835264	0	68	106	4	68	0.0588235
NODE_955_length_2430_cov_19.835264	0	24	11	1	24	0.0416667
NODE_955_length_2430_cov_19.835264	0	24	13	1	24	0.0416667
NODE_955_length_2430_cov_19.835264	0	24	17	3	24	0.1250000
NODE_955_length_2430_cov_19.835264	0	24	19	1	24	0.0416667
NODE_955_length_2430_cov_19.835264	0	24	20	1	24	0.0416667
NODE_955_length_2430_cov_19.835264	0	24	24	6	24	0.2500000
NODE_955_length_2430_cov_19.835264	0	24	27	1	24	0.0416667
NODE_955_length_2430_cov_19.835264	0	24	28	1	24	0.0416667
NODE_955_length_2430_cov_19.835264	0	24	30	1	24	0.0416667
NODE_955_length_2430_cov_19.835264	0	24	31	1	24	0.0416667
NODE_955_length_2430_cov_19.835264	0	24	33	1	24	0.0416667
NODE_955_length_2430_cov_19.835264	0	24	35	1	24	0.0416667
NODE_955_length_2430_cov_19.835264	0	24	39	1	24	0.0416667
NODE_955_length_2430_cov_19.835264	0	24	41	3	24	0.1250000
NODE_955_length_2430_cov_19.835264	0	24	43	1	24	0.0416667
NODE_956_length_2428_cov_179.842422	538	618	0	80	80	1.0000000
NODE_956_length_2428_cov_179.842422	591	671	0	80	80	1.0000000
NODE_956_length_2428_cov_179.842422	667	747	0	80	80	1.0000000
NODE_956_length_2428_cov_179.842422	720	800	0	80	80	1.0000000
NODE_956_length_2428_cov_179.842422	1308	1388	2	8	80	0.1000000
NODE_956_length_2428_cov_179.842422	1308	1388	6	72	80	0.9000000
NODE_956_length_2428_cov_179.842422	1361	1441	0	30	80	0.3750000
NODE_956_length_2428_cov_179.842422	1361	1441	4	2	80	0.0250000
NODE_956_length_2428_cov_179.842422	1361	1441	6	48	80	0.6000000
NODE_956_length_2428_cov_179.842422	1437	1517	0	80	80	1.0000000
NODE_956_length_2428_cov_179.842422	1490	1570	0	80	80	1.0000000
NODE_956_length_2428_cov_179.842422	1986	2026	721	1	40	0.0250000
NODE_956_length_2428_cov_179.842422	1986	2026	724	1	40	0.0250000
NODE_956_length_2428_cov_179.842422	1986	2026	725	1	40	0.0250000
NODE_956_length_2428_cov_179.842422	1986	2026	726	1	40	0.0250000
NODE_956_length_2428_cov_179.842422	1986	2026	727	2	40	0.0500000
NODE_956_length_2428_cov_179.842422	1986	2026	728	1	40	0.0250000
NODE_956_length_2428_cov_179.842422	1986	2026	729	2	40	0.0500000
NODE_956_length_2428_cov_179.842422	1986	2026	730	2	40	0.0500000
NODE_956_length_2428_cov_179.842422	1986	2026	732	1	40	0.0250000
NODE_956_length_2428_cov_179.842422	1986	2026	734	2	40	0.0500000
NODE_956_length_2428_cov_179.842422	1986	2026	736	1	40	0.0250000
NODE_956_length_2428_cov_179.842422	1986	2026	738	1	40	0.0250000
NODE_956_length_2428_cov_179.842422	1986	2026	740	1	40	0.0250000
NODE_956_length_2428_cov_179.842422	1986	2026	741	1	40	0.0250000
NODE_956_length_2428_cov_179.842422	1986	2026	742	1	40	0.0250000
NODE_956_length_2428_cov_179.842422	1986	2026	743	2	40	0.0500000
NODE_956_length_2428_cov_179.842422	1986	2026	745	2	40	0.0500000
NODE_956_length_2428_cov_179.842422	1986	2026	746	1	40	0.0250000
NODE_956_length_2428_cov_179.842422	1986	2026	754	2	40	0.0500000
NODE_956_length_2428_cov_179.842422	1986	2026	759	1	40	0.0250000
NODE_956_length_2428_cov_179.842422	1986	2026	762	2	40	0.0500000
NODE_956_length_2428_cov_179.842422	1986	2026	765	1	40	0.0250000
NODE_956_length_2428_cov_179.842422	1986	2026	767	2	40	0.0500000
NODE_956_length_2428_cov_179.842422	1986	2026	773	1	40	0.0250000
NODE_956_length_2428_cov_179.842422	1986	2026	779	1	40	0.0250000
NODE_956_length_2428_cov_179.842422	1986	2026	781	1	40	0.0250000
NODE_956_length_2428_cov_179.842422	1986	2026	786	1	40	0.0250000
NODE_956_length_2428_cov_179.842422	1986	2026	799	1	40	0.0250000
NODE_956_length_2428_cov_179.842422	1986	2026	802	1	40	0.0250000
NODE_956_length_2428_cov_179.842422	1986	2026	811	1	40	0.0250000
NODE_956_length_2428_cov_179.842422	1986	2026	813	1	40	0.0250000
NODE_959_length_2422_cov_6.665088	197	255	0	57	58	0.9827586
NODE_959_length_2422_cov_6.665088	197	255	2	1	58	0.0172414
NODE_963_length_2414_cov_32.871706	411	491	0	80	80	1.0000000
NODE_963_length_2414_cov_32.871706	464	544	0	66	80	0.8250000
NODE_963_length_2414_cov_32.871706	464	544	4	14	80	0.1750000
NODE_964_length_2414_cov_2.105832	2349	2390	0	41	41	1.0000000
NODE_968_length_2410_cov_9.107313	1874	1954	0	67	80	0.8375000
NODE_968_length_2410_cov_9.107313	1874	1954	5	1	80	0.0125000
NODE_968_length_2410_cov_9.107313	1874	1954	6	12	80	0.1500000
NODE_968_length_2410_cov_9.107313	1927	2007	0	14	80	0.1750000
NODE_968_length_2410_cov_9.107313	1927	2007	5	1	80	0.0125000
NODE_968_length_2410_cov_9.107313	1927	2007	6	65	80	0.8125000
NODE_977_length_2390_cov_20.371454	1753	1833	0	80	80	1.0000000
NODE_977_length_2390_cov_20.371454	1806	1886	0	80	80	1.0000000
NODE_979_length_2389_cov_17.904803	1601	1681	0	29	80	0.3625000
NODE_979_length_2389_cov_17.904803	1601	1681	2	51	80	0.6375000
NODE_979_length_2389_cov_17.904803	1654	1734	0	71	80	0.8875000
NODE_979_length_2389_cov_17.904803	1654	1734	4	9	80	0.1125000
NODE_979_length_2389_cov_17.904803	1730	1810	4	80	80	1.0000000
NODE_979_length_2389_cov_17.904803	1783	1863	4	80	80	1.0000000
NODE_988_length_2381_cov_32.280894	398	478	0	72	80	0.9000000
NODE_988_length_2381_cov_32.280894	398	478	6	8	80	0.1000000
NODE_988_length_2381_cov_32.280894	451	531	0	19	80	0.2375000
NODE_988_length_2381_cov_32.280894	451	531	6	61	80	0.7625000
NODE_988_length_2381_cov_32.280894	527	607	4	11	80	0.1375000
NODE_988_length_2381_cov_32.280894	527	607	6	67	80	0.8375000
NODE_988_length_2381_cov_32.280894	527	607	10	2	80	0.0250000
NODE_988_length_2381_cov_32.280894	580	660	4	64	80	0.8000000
NODE_988_length_2381_cov_32.280894	580	660	6	14	80	0.1750000
NODE_988_length_2381_cov_32.280894	580	660	10	2	80	0.0250000
NODE_988_length_2381_cov_32.280894	2288	2368	0	80	80	1.0000000
NODE_997_length_2369_cov_4.896916	241	321	0	80	80	1.0000000
NODE_997_length_2369_cov_4.896916	294	374	0	80	80	1.0000000
NODE_1002_length_2364_cov_2.482561	0	79	0	79	79	1.0000000
NODE_1004_length_2360_cov_8.620080	587	651	19	4	64	0.0625000
NODE_1004_length_2360_cov_8.620080	587	651	27	4	64	0.0625000
NODE_1004_length_2360_cov_8.620080	587	651	33	12	64	0.1875000
NODE_1004_length_2360_cov_8.620080	587	651	35	44	64	0.6875000
NODE_1004_length_2360_cov_8.620080	587	651	19	4	64	0.0625000
NODE_1004_length_2360_cov_8.620080	587	651	27	4	64	0.0625000
NODE_1004_length_2360_cov_8.620080	587	651	33	12	64	0.1875000
NODE_1004_length_2360_cov_8.620080	587	651	35	44	64	0.6875000
NODE_1004_length_2360_cov_8.620080	624	684	6	17	60	0.2833333
NODE_1004_length_2360_cov_8.620080	624	684	10	5	60	0.0833333
NODE_1004_length_2360_cov_8.620080	624	684	12	2	60	0.0333333
NODE_1004_length_2360_cov_8.620080	624	684	14	4	60	0.0666667
NODE_1004_length_2360_cov_8.620080	624	684	18	5	60	0.0833333
NODE_1004_length_2360_cov_8.620080	624	684	19	4	60	0.0666667
NODE_1004_length_2360_cov_8.620080	624	684	27	4	60	0.0666667
NODE_1004_length_2360_cov_8.620080	624	684	33	12	60	0.2000000
NODE_1004_length_2360_cov_8.620080	624	684	35	7	60	0.1166667
NODE_1004_length_2360_cov_8.620080	1827	1907	0	80	80	1.0000000
NODE_1004_length_2360_cov_8.620080	1880	1960	0	80	80	1.0000000
NODE_1005_length_2359_cov_22.317257	958	1038	0	25	80	0.3125000
NODE_1005_length_2359_cov_22.317257	958	1038	2	55	80	0.6875000
NODE_1005_length_2359_cov_22.317257	1011	1091	0	78	80	0.9750000
NODE_1005_length_2359_cov_22.317257	1011	1091	2	2	80	0.0250000
NODE_1008_length_2357_cov_25.711249	716	796	6	60	80	0.7500000
NODE_1008_length_2357_cov_25.711249	716	796	12	10	80	0.1250000
NODE_1008_length_2357_cov_25.711249	716	796	14	10	80	0.1250000
NODE_1008_length_2357_cov_25.711249	769	849	6	7	80	0.0875000
NODE_1008_length_2357_cov_25.711249	769	849	10	25	80	0.3125000
NODE_1008_length_2357_cov_25.711249	769	849	12	10	80	0.1250000
NODE_1008_length_2357_cov_25.711249	769	849	14	15	80	0.1875000
NODE_1008_length_2357_cov_25.711249	769	849	16	23	80	0.2875000
NODE_1015_length_2345_cov_5.386465	1845	1925	0	80	80	1.0000000
NODE_1015_length_2345_cov_5.386465	1898	1978	0	80	80	1.0000000
NODE_1016_length_2344_cov_6.236526	1208	1269	2	12	61	0.1967213
NODE_1016_length_2344_cov_6.236526	1208	1269	4	2	61	0.0327869
NODE_1016_length_2344_cov_6.236526	1208	1269	6	4	61	0.0655738
NODE_1016_length_2344_cov_6.236526	1208	1269	8	19	61	0.3114754
NODE_1016_length_2344_cov_6.236526	1208	1269	10	24	61	0.3934426
NODE_1016_length_2344_cov_6.236526	1208	1269	2	12	61	0.1967213
NODE_1016_length_2344_cov_6.236526	1208	1269	4	2	61	0.0327869
NODE_1016_length_2344_cov_6.236526	1208	1269	6	4	61	0.0655738
NODE_1016_length_2344_cov_6.236526	1208	1269	8	19	61	0.3114754
NODE_1016_length_2344_cov_6.236526	1208	1269	10	24	61	0.3934426
NODE_1016_length_2344_cov_6.236526	1208	1269	2	12	61	0.1967213
NODE_1016_length_2344_cov_6.236526	1208	1269	4	2	61	0.0327869
NODE_1016_length_2344_cov_6.236526	1208	1269	6	4	61	0.0655738
NODE_1016_length_2344_cov_6.236526	1208	1269	8	19	61	0.3114754
NODE_1016_length_2344_cov_6.236526	1208	1269	10	24	61	0.3934426
NODE_1016_length_2344_cov_6.236526	1208	1267	2	12	59	0.2033898
NODE_1016_length_2344_cov_6.236526	1208	1267	4	2	59	0.0338983
NODE_1016_length_2344_cov_6.236526	1208	1267	6	4	59	0.0677966
NODE_1016_length_2344_cov_6.236526	1208	1267	8	18	59	0.3050847
NODE_1016_length_2344_cov_6.236526	1208	1267	10	23	59	0.3898305
NODE_1023_length_2332_cov_4.725929	34	101	0	65	67	0.9701493
NODE_1023_length_2332_cov_4.725929	34	101	10	2	67	0.0298507
NODE_1027_length_2327_cov_18.210952	2213	2293	0	55	80	0.6875000
NODE_1027_length_2327_cov_18.210952	2213	2293	2	25	80	0.3125000
NODE_1027_length_2327_cov_18.210952	2266	2327	0	2	61	0.0327869
NODE_1027_length_2327_cov_18.210952	2266	2327	2	59	61	0.9672131
NODE_1028_length_2326_cov_15.583745	1709	1789	0	16	80	0.2000000
NODE_1028_length_2326_cov_15.583745	1709	1789	2	31	80	0.3875000
NODE_1028_length_2326_cov_15.583745	1709	1789	8	33	80	0.4125000
NODE_1028_length_2326_cov_15.583745	1762	1842	8	32	80	0.4000000
NODE_1028_length_2326_cov_15.583745	1762	1842	10	7	80	0.0875000
NODE_1028_length_2326_cov_15.583745	1762	1842	15	1	80	0.0125000
NODE_1028_length_2326_cov_15.583745	1762	1842	16	40	80	0.5000000
NODE_1030_length_2325_cov_14.998652	553	633	0	80	80	1.0000000
NODE_1030_length_2325_cov_14.998652	606	686	0	80	80	1.0000000
NODE_1034_length_2317_cov_11.956718	920	1000	0	80	80	1.0000000
NODE_1034_length_2317_cov_11.956718	973	1053	0	80	80	1.0000000
NODE_1034_length_2317_cov_11.956718	1049	1129	0	51	80	0.6375000
NODE_1034_length_2317_cov_11.956718	1049	1129	2	29	80	0.3625000
NODE_1034_length_2317_cov_11.956718	1102	1184	2	36	82	0.4390244
NODE_1034_length_2317_cov_11.956718	1102	1184	4	46	82	0.5609756
NODE_1037_length_2316_cov_8.556608	168	247	74	2	79	0.0253165
NODE_1037_length_2316_cov_8.556608	168	247	75	1	79	0.0126582
NODE_1037_length_2316_cov_8.556608	168	247	77	1	79	0.0126582
NODE_1037_length_2316_cov_8.556608	168	247	79	1	79	0.0126582
NODE_1037_length_2316_cov_8.556608	168	247	81	8	79	0.1012658
NODE_1037_length_2316_cov_8.556608	168	247	83	6	79	0.0759494
NODE_1037_length_2316_cov_8.556608	168	247	85	3	79	0.0379747
NODE_1037_length_2316_cov_8.556608	168	247	89	1	79	0.0126582
NODE_1037_length_2316_cov_8.556608	168	247	91	1	79	0.0126582
NODE_1037_length_2316_cov_8.556608	168	247	93	1	79	0.0126582
NODE_1037_length_2316_cov_8.556608	168	247	97	1	79	0.0126582
NODE_1037_length_2316_cov_8.556608	168	247	103	1	79	0.0126582
NODE_1037_length_2316_cov_8.556608	168	247	105	1	79	0.0126582
NODE_1037_length_2316_cov_8.556608	168	247	106	1	79	0.0126582
NODE_1037_length_2316_cov_8.556608	168	247	108	2	79	0.0253165
NODE_1037_length_2316_cov_8.556608	168	247	111	7	79	0.0886076
NODE_1037_length_2316_cov_8.556608	168	247	113	8	79	0.1012658
NODE_1037_length_2316_cov_8.556608	168	247	114	5	79	0.0632911
NODE_1037_length_2316_cov_8.556608	168	247	115	5	79	0.0632911
NODE_1037_length_2316_cov_8.556608	168	247	116	5	79	0.0632911
NODE_1037_length_2316_cov_8.556608	168	247	117	2	79	0.0253165
NODE_1037_length_2316_cov_8.556608	168	247	119	8	79	0.1012658
NODE_1037_length_2316_cov_8.556608	168	247	120	1	79	0.0126582
NODE_1037_length_2316_cov_8.556608	168	247	121	4	79	0.0506329
NODE_1037_length_2316_cov_8.556608	168	247	123	3	79	0.0379747
NODE_1037_length_2316_cov_8.556608	1117	1198	36	5	81	0.0617284
NODE_1037_length_2316_cov_8.556608	1117	1198	37	1	81	0.0123457
NODE_1037_length_2316_cov_8.556608	1117	1198	38	6	81	0.0740741
NODE_1037_length_2316_cov_8.556608	1117	1198	40	4	81	0.0493827
NODE_1037_length_2316_cov_8.556608	1117	1198	44	1	81	0.0123457
NODE_1037_length_2316_cov_8.556608	1117	1198	46	7	81	0.0864198
NODE_1037_length_2316_cov_8.556608	1117	1198	47	10	81	0.1234568
NODE_1037_length_2316_cov_8.556608	1117	1198	48	6	81	0.0740741
NODE_1037_length_2316_cov_8.556608	1117	1198	49	6	81	0.0740741
NODE_1037_length_2316_cov_8.556608	1117	1198	50	3	81	0.0370370
NODE_1037_length_2316_cov_8.556608	1117	1198	51	9	81	0.1111111
NODE_1037_length_2316_cov_8.556608	1117	1198	52	3	81	0.0370370
NODE_1037_length_2316_cov_8.556608	1117	1198	53	14	81	0.1728395
NODE_1037_length_2316_cov_8.556608	1117	1198	55	6	81	0.0740741
NODE_1037_length_2316_cov_8.556608	1369	1412	101	2	43	0.0465116
NODE_1037_length_2316_cov_8.556608	1369	1412	107	2	43	0.0465116
NODE_1037_length_2316_cov_8.556608	1369	1412	109	2	43	0.0465116
NODE_1037_length_2316_cov_8.556608	1369	1412	111	4	43	0.0930233
NODE_1037_length_2316_cov_8.556608	1369	1412	115	1	43	0.0232558
NODE_1037_length_2316_cov_8.556608	1369	1412	116	2	43	0.0465116
NODE_1037_length_2316_cov_8.556608	1369	1412	117	2	43	0.0465116
NODE_1037_length_2316_cov_8.556608	1369	1412	118	3	43	0.0697674
NODE_1037_length_2316_cov_8.556608	1369	1412	124	2	43	0.0465116
NODE_1037_length_2316_cov_8.556608	1369	1412	125	1	43	0.0232558
NODE_1037_length_2316_cov_8.556608	1369	1412	126	3	43	0.0697674
NODE_1037_length_2316_cov_8.556608	1369	1412	127	1	43	0.0232558
NODE_1037_length_2316_cov_8.556608	1369	1412	128	2	43	0.0465116
NODE_1037_length_2316_cov_8.556608	1369	1412	129	3	43	0.0697674
NODE_1037_length_2316_cov_8.556608	1369	1412	131	4	43	0.0930233
NODE_1037_length_2316_cov_8.556608	1369	1412	133	7	43	0.1627907
NODE_1037_length_2316_cov_8.556608	1369	1412	137	1	43	0.0232558
NODE_1037_length_2316_cov_8.556608	1369	1412	139	1	43	0.0232558
NODE_1040_length_2311_cov_2.821881	2121	2201	0	80	80	1.0000000
NODE_1040_length_2311_cov_2.821881	2174	2225	0	51	51	1.0000000
NODE_1044_length_2306_cov_17.347984	995	1075	0	43	80	0.5375000
NODE_1044_length_2306_cov_17.347984	995	1075	4	37	80	0.4625000
NODE_1044_length_2306_cov_17.347984	1048	1128	0	9	80	0.1125000
NODE_1044_length_2306_cov_17.347984	1048	1128	3	1	80	0.0125000
NODE_1044_length_2306_cov_17.347984	1048	1128	4	70	80	0.8750000
NODE_1052_length_2300_cov_9.803271	934	1014	0	10	80	0.1250000
NODE_1052_length_2300_cov_9.803271	934	1014	2	1	80	0.0125000
NODE_1052_length_2300_cov_9.803271	934	1014	4	2	80	0.0250000
NODE_1052_length_2300_cov_9.803271	934	1014	6	1	80	0.0125000
NODE_1052_length_2300_cov_9.803271	934	1014	8	23	80	0.2875000
NODE_1052_length_2300_cov_9.803271	934	1014	9	43	80	0.5375000
NODE_1052_length_2300_cov_9.803271	1892	1965	0	71	73	0.9726027
NODE_1052_length_2300_cov_9.803271	1892	1965	2	2	73	0.0273973
NODE_1059_length_2289_cov_17.807306	968	1026	206	2	58	0.0344828
NODE_1059_length_2289_cov_17.807306	968	1026	207	1	58	0.0172414
NODE_1059_length_2289_cov_17.807306	968	1026	208	1	58	0.0172414
NODE_1059_length_2289_cov_17.807306	968	1026	210	1	58	0.0172414
NODE_1059_length_2289_cov_17.807306	968	1026	212	3	58	0.0517241
NODE_1059_length_2289_cov_17.807306	968	1026	213	3	58	0.0517241
NODE_1059_length_2289_cov_17.807306	968	1026	214	1	58	0.0172414
NODE_1059_length_2289_cov_17.807306	968	1026	215	2	58	0.0344828
NODE_1059_length_2289_cov_17.807306	968	1026	216	7	58	0.1206897
NODE_1059_length_2289_cov_17.807306	968	1026	217	1	58	0.0172414
NODE_1059_length_2289_cov_17.807306	968	1026	219	5	58	0.0862069
NODE_1059_length_2289_cov_17.807306	968	1026	220	3	58	0.0517241
NODE_1059_length_2289_cov_17.807306	968	1026	222	1	58	0.0172414
NODE_1059_length_2289_cov_17.807306	968	1026	223	1	58	0.0172414
NODE_1059_length_2289_cov_17.807306	968	1026	224	3	58	0.0517241
NODE_1059_length_2289_cov_17.807306	968	1026	225	2	58	0.0344828
NODE_1059_length_2289_cov_17.807306	968	1026	226	3	58	0.0517241
NODE_1059_length_2289_cov_17.807306	968	1026	228	8	58	0.1379310
NODE_1059_length_2289_cov_17.807306	968	1026	229	2	58	0.0344828
NODE_1059_length_2289_cov_17.807306	968	1026	230	2	58	0.0344828
NODE_1059_length_2289_cov_17.807306	968	1026	231	3	58	0.0517241
NODE_1059_length_2289_cov_17.807306	968	1026	232	1	58	0.0172414
NODE_1059_length_2289_cov_17.807306	968	1026	237	1	58	0.0172414
NODE_1059_length_2289_cov_17.807306	968	1026	238	1	58	0.0172414
NODE_1059_length_2289_cov_17.807306	1021	1079	177	2	58	0.0344828
NODE_1059_length_2289_cov_17.807306	1021	1079	179	5	58	0.0862069
NODE_1059_length_2289_cov_17.807306	1021	1079	180	4	58	0.0689655
NODE_1059_length_2289_cov_17.807306	1021	1079	181	5	58	0.0862069
NODE_1059_length_2289_cov_17.807306	1021	1079	182	1	58	0.0172414
NODE_1059_length_2289_cov_17.807306	1021	1079	183	6	58	0.1034483
NODE_1059_length_2289_cov_17.807306	1021	1079	184	5	58	0.0862069
NODE_1059_length_2289_cov_17.807306	1021	1079	186	1	58	0.0172414
NODE_1059_length_2289_cov_17.807306	1021	1079	190	3	58	0.0517241
NODE_1059_length_2289_cov_17.807306	1021	1079	192	1	58	0.0172414
NODE_1059_length_2289_cov_17.807306	1021	1079	193	1	58	0.0172414
NODE_1059_length_2289_cov_17.807306	1021	1079	196	2	58	0.0344828
NODE_1059_length_2289_cov_17.807306	1021	1079	198	1	58	0.0172414
NODE_1059_length_2289_cov_17.807306	1021	1079	200	1	58	0.0172414
NODE_1059_length_2289_cov_17.807306	1021	1079	202	1	58	0.0172414
NODE_1059_length_2289_cov_17.807306	1021	1079	204	1	58	0.0172414
NODE_1059_length_2289_cov_17.807306	1021	1079	207	1	58	0.0172414
NODE_1059_length_2289_cov_17.807306	1021	1079	209	1	58	0.0172414
NODE_1059_length_2289_cov_17.807306	1021	1079	210	2	58	0.0344828
NODE_1059_length_2289_cov_17.807306	1021	1079	211	2	58	0.0344828
NODE_1059_length_2289_cov_17.807306	1021	1079	214	2	58	0.0344828
NODE_1059_length_2289_cov_17.807306	1021	1079	215	2	58	0.0344828
NODE_1059_length_2289_cov_17.807306	1021	1079	216	6	58	0.1034483
NODE_1059_length_2289_cov_17.807306	1021	1079	217	1	58	0.0172414
NODE_1059_length_2289_cov_17.807306	1021	1079	220	1	58	0.0172414
NODE_1060_length_2289_cov_7.736986	2161	2218	160	1	57	0.0175439
NODE_1060_length_2289_cov_7.736986	2161	2218	195	1	57	0.0175439
NODE_1060_length_2289_cov_7.736986	2161	2218	199	1	57	0.0175439
NODE_1060_length_2289_cov_7.736986	2161	2218	211	1	57	0.0175439
NODE_1060_length_2289_cov_7.736986	2161	2218	217	1	57	0.0175439
NODE_1060_length_2289_cov_7.736986	2161	2218	223	2	57	0.0350877
NODE_1060_length_2289_cov_7.736986	2161	2218	227	1	57	0.0175439
NODE_1060_length_2289_cov_7.736986	2161	2218	228	1	57	0.0175439
NODE_1060_length_2289_cov_7.736986	2161	2218	236	1	57	0.0175439
NODE_1060_length_2289_cov_7.736986	2161	2218	240	3	57	0.0526316
NODE_1060_length_2289_cov_7.736986	2161	2218	242	1	57	0.0175439
NODE_1060_length_2289_cov_7.736986	2161	2218	246	1	57	0.0175439
NODE_1060_length_2289_cov_7.736986	2161	2218	250	3	57	0.0526316
NODE_1060_length_2289_cov_7.736986	2161	2218	255	1	57	0.0175439
NODE_1060_length_2289_cov_7.736986	2161	2218	261	1	57	0.0175439
NODE_1060_length_2289_cov_7.736986	2161	2218	274	2	57	0.0350877
NODE_1060_length_2289_cov_7.736986	2161	2218	276	2	57	0.0350877
NODE_1060_length_2289_cov_7.736986	2161	2218	280	14	57	0.2456140
NODE_1060_length_2289_cov_7.736986	2161	2218	282	19	57	0.3333333
NODE_1060_length_2289_cov_7.736986	2191	2271	177	1	80	0.0125000
NODE_1060_length_2289_cov_7.736986	2191	2271	181	2	80	0.0250000
NODE_1060_length_2289_cov_7.736986	2191	2271	189	1	80	0.0125000
NODE_1060_length_2289_cov_7.736986	2191	2271	191	1	80	0.0125000
NODE_1060_length_2289_cov_7.736986	2191	2271	215	1	80	0.0125000
NODE_1060_length_2289_cov_7.736986	2191	2271	217	1	80	0.0125000
NODE_1060_length_2289_cov_7.736986	2191	2271	219	1	80	0.0125000
NODE_1060_length_2289_cov_7.736986	2191	2271	225	1	80	0.0125000
NODE_1060_length_2289_cov_7.736986	2191	2271	245	1	80	0.0125000
NODE_1060_length_2289_cov_7.736986	2191	2271	255	1	80	0.0125000
NODE_1060_length_2289_cov_7.736986	2191	2271	260	1	80	0.0125000
NODE_1060_length_2289_cov_7.736986	2191	2271	262	1	80	0.0125000
NODE_1060_length_2289_cov_7.736986	2191	2271	263	1	80	0.0125000
NODE_1060_length_2289_cov_7.736986	2191	2271	276	1	80	0.0125000
NODE_1060_length_2289_cov_7.736986	2191	2271	279	1	80	0.0125000
NODE_1060_length_2289_cov_7.736986	2191	2271	280	50	80	0.6250000
NODE_1060_length_2289_cov_7.736986	2191	2271	282	14	80	0.1750000
NODE_1061_length_2288_cov_8.539973	340	420	0	15	80	0.1875000
NODE_1061_length_2288_cov_8.539973	340	420	2	6	80	0.0750000
NODE_1061_length_2288_cov_8.539973	340	420	4	1	80	0.0125000
NODE_1061_length_2288_cov_8.539973	340	420	9	1	80	0.0125000
NODE_1061_length_2288_cov_8.539973	340	420	10	5	80	0.0625000
NODE_1061_length_2288_cov_8.539973	340	420	12	3	80	0.0375000
NODE_1061_length_2288_cov_8.539973	340	420	14	1	80	0.0125000
NODE_1061_length_2288_cov_8.539973	340	420	16	28	80	0.3500000
NODE_1061_length_2288_cov_8.539973	340	420	17	1	80	0.0125000
NODE_1061_length_2288_cov_8.539973	340	420	20	13	80	0.1625000
NODE_1061_length_2288_cov_8.539973	340	420	22	2	80	0.0250000
NODE_1061_length_2288_cov_8.539973	340	420	24	4	80	0.0500000
NODE_1061_length_2288_cov_8.539973	393	473	0	1	80	0.0125000
NODE_1061_length_2288_cov_8.539973	393	473	2	1	80	0.0125000
NODE_1061_length_2288_cov_8.539973	393	473	6	3	80	0.0375000
NODE_1061_length_2288_cov_8.539973	393	473	10	1	80	0.0125000
NODE_1061_length_2288_cov_8.539973	393	473	12	13	80	0.1625000
NODE_1061_length_2288_cov_8.539973	393	473	14	1	80	0.0125000
NODE_1061_length_2288_cov_8.539973	393	473	16	60	80	0.7500000
NODE_1065_length_2278_cov_19.655805	450	530	8	14	80	0.1750000
NODE_1065_length_2278_cov_19.655805	450	530	12	41	80	0.5125000
NODE_1065_length_2278_cov_19.655805	450	530	13	5	80	0.0625000
NODE_1065_length_2278_cov_19.655805	450	530	14	20	80	0.2500000
NODE_1065_length_2278_cov_19.655805	503	583	2	31	80	0.3875000
NODE_1065_length_2278_cov_19.655805	503	583	4	6	80	0.0750000
NODE_1065_length_2278_cov_19.655805	503	583	8	30	80	0.3750000
NODE_1065_length_2278_cov_19.655805	503	583	13	5	80	0.0625000
NODE_1065_length_2278_cov_19.655805	503	583	14	8	80	0.1000000
NODE_1065_length_2278_cov_19.655805	579	659	0	73	80	0.9125000
NODE_1065_length_2278_cov_19.655805	579	659	2	7	80	0.0875000
NODE_1065_length_2278_cov_19.655805	632	712	0	80	80	1.0000000
NODE_1071_length_2272_cov_26.123792	226	306	0	76	80	0.9500000
NODE_1071_length_2272_cov_26.123792	226	306	1	4	80	0.0500000
NODE_1071_length_2272_cov_26.123792	279	359	0	23	80	0.2875000
NODE_1071_length_2272_cov_26.123792	279	359	1	57	80	0.7125000
NODE_1071_length_2272_cov_26.123792	1684	1731	25	2	47	0.0425532
NODE_1071_length_2272_cov_26.123792	1684	1731	37	1	47	0.0212766
NODE_1071_length_2272_cov_26.123792	1684	1731	43	1	47	0.0212766
NODE_1071_length_2272_cov_26.123792	1684	1731	58	1	47	0.0212766
NODE_1071_length_2272_cov_26.123792	1684	1731	61	1	47	0.0212766
NODE_1071_length_2272_cov_26.123792	1684	1731	63	1	47	0.0212766
NODE_1071_length_2272_cov_26.123792	1684	1731	66	1	47	0.0212766
NODE_1071_length_2272_cov_26.123792	1684	1731	68	1	47	0.0212766
NODE_1071_length_2272_cov_26.123792	1684	1731	88	1	47	0.0212766
NODE_1071_length_2272_cov_26.123792	1684	1731	89	3	47	0.0638298
NODE_1071_length_2272_cov_26.123792	1684	1731	91	2	47	0.0425532
NODE_1071_length_2272_cov_26.123792	1684	1731	92	2	47	0.0425532
NODE_1071_length_2272_cov_26.123792	1684	1731	93	1	47	0.0212766
NODE_1071_length_2272_cov_26.123792	1684	1731	95	1	47	0.0212766
NODE_1071_length_2272_cov_26.123792	1684	1731	101	1	47	0.0212766
NODE_1071_length_2272_cov_26.123792	1684	1731	106	2	47	0.0425532
NODE_1071_length_2272_cov_26.123792	1684	1731	108	2	47	0.0425532
NODE_1071_length_2272_cov_26.123792	1684	1731	110	1	47	0.0212766
NODE_1071_length_2272_cov_26.123792	1684	1731	115	1	47	0.0212766
NODE_1071_length_2272_cov_26.123792	1684	1731	121	2	47	0.0425532
NODE_1071_length_2272_cov_26.123792	1684	1731	122	1	47	0.0212766
NODE_1071_length_2272_cov_26.123792	1684	1731	132	1	47	0.0212766
NODE_1071_length_2272_cov_26.123792	1684	1731	135	1	47	0.0212766
NODE_1071_length_2272_cov_26.123792	1684	1731	136	2	47	0.0425532
NODE_1071_length_2272_cov_26.123792	1684	1731	137	1	47	0.0212766
NODE_1071_length_2272_cov_26.123792	1684	1731	145	3	47	0.0638298
NODE_1071_length_2272_cov_26.123792	1684	1731	151	1	47	0.0212766
NODE_1071_length_2272_cov_26.123792	1684	1731	157	1	47	0.0212766
NODE_1071_length_2272_cov_26.123792	1684	1731	161	1	47	0.0212766
NODE_1071_length_2272_cov_26.123792	1684	1731	166	1	47	0.0212766
NODE_1071_length_2272_cov_26.123792	1684	1731	170	1	47	0.0212766
NODE_1071_length_2272_cov_26.123792	1684	1731	179	1	47	0.0212766
NODE_1071_length_2272_cov_26.123792	1684	1731	181	1	47	0.0212766
NODE_1071_length_2272_cov_26.123792	1684	1731	183	1	47	0.0212766
NODE_1071_length_2272_cov_26.123792	1684	1731	188	1	47	0.0212766
NODE_1071_length_2272_cov_26.123792	1684	1731	190	1	47	0.0212766
NODE_1071_length_2272_cov_26.123792	1694	1725	63	1	31	0.0322581
NODE_1071_length_2272_cov_26.123792	1694	1725	66	1	31	0.0322581
NODE_1071_length_2272_cov_26.123792	1694	1725	68	1	31	0.0322581
NODE_1071_length_2272_cov_26.123792	1694	1725	88	1	31	0.0322581
NODE_1071_length_2272_cov_26.123792	1694	1725	89	3	31	0.0967742
NODE_1071_length_2272_cov_26.123792	1694	1725	91	2	31	0.0645161
NODE_1071_length_2272_cov_26.123792	1694	1725	92	2	31	0.0645161
NODE_1071_length_2272_cov_26.123792	1694	1725	93	1	31	0.0322581
NODE_1071_length_2272_cov_26.123792	1694	1725	95	1	31	0.0322581
NODE_1071_length_2272_cov_26.123792	1694	1725	101	1	31	0.0322581
NODE_1071_length_2272_cov_26.123792	1694	1725	106	2	31	0.0645161
NODE_1071_length_2272_cov_26.123792	1694	1725	108	2	31	0.0645161
NODE_1071_length_2272_cov_26.123792	1694	1725	110	1	31	0.0322581
NODE_1071_length_2272_cov_26.123792	1694	1725	115	1	31	0.0322581
NODE_1071_length_2272_cov_26.123792	1694	1725	121	2	31	0.0645161
NODE_1071_length_2272_cov_26.123792	1694	1725	122	1	31	0.0322581
NODE_1071_length_2272_cov_26.123792	1694	1725	132	1	31	0.0322581
NODE_1071_length_2272_cov_26.123792	1694	1725	135	1	31	0.0322581
NODE_1071_length_2272_cov_26.123792	1694	1725	136	2	31	0.0645161
NODE_1071_length_2272_cov_26.123792	1694	1725	137	1	31	0.0322581
NODE_1071_length_2272_cov_26.123792	1694	1725	145	3	31	0.0967742
NODE_1071_length_2272_cov_26.123792	1759	1833	0	26	74	0.3513514
NODE_1071_length_2272_cov_26.123792	1759	1833	2	20	74	0.2702703
NODE_1071_length_2272_cov_26.123792	1759	1833	4	28	74	0.3783784
NODE_1071_length_2272_cov_26.123792	1812	1892	2	1	80	0.0125000
NODE_1071_length_2272_cov_26.123792	1812	1892	4	79	80	0.9875000
NODE_1072_length_2272_cov_8.175334	213	293	116	1	80	0.0125000
NODE_1072_length_2272_cov_8.175334	213	293	123	1	80	0.0125000
NODE_1072_length_2272_cov_8.175334	213	293	124	1	80	0.0125000
NODE_1072_length_2272_cov_8.175334	213	293	126	2	80	0.0250000
NODE_1072_length_2272_cov_8.175334	213	293	128	1	80	0.0125000
NODE_1072_length_2272_cov_8.175334	213	293	130	2	80	0.0250000
NODE_1072_length_2272_cov_8.175334	213	293	133	3	80	0.0375000
NODE_1072_length_2272_cov_8.175334	213	293	135	1	80	0.0125000
NODE_1072_length_2272_cov_8.175334	213	293	139	2	80	0.0250000
NODE_1072_length_2272_cov_8.175334	213	293	143	1	80	0.0125000
NODE_1072_length_2272_cov_8.175334	213	293	145	2	80	0.0250000
NODE_1072_length_2272_cov_8.175334	213	293	147	1	80	0.0125000
NODE_1072_length_2272_cov_8.175334	213	293	149	1	80	0.0125000
NODE_1072_length_2272_cov_8.175334	213	293	151	1	80	0.0125000
NODE_1072_length_2272_cov_8.175334	213	293	153	1	80	0.0125000
NODE_1072_length_2272_cov_8.175334	213	293	155	1	80	0.0125000
NODE_1072_length_2272_cov_8.175334	213	293	157	1	80	0.0125000
NODE_1072_length_2272_cov_8.175334	213	293	163	2	80	0.0250000
NODE_1072_length_2272_cov_8.175334	213	293	165	2	80	0.0250000
NODE_1072_length_2272_cov_8.175334	213	293	167	4	80	0.0500000
NODE_1072_length_2272_cov_8.175334	213	293	168	1	80	0.0125000
NODE_1072_length_2272_cov_8.175334	213	293	169	2	80	0.0250000
NODE_1072_length_2272_cov_8.175334	213	293	170	1	80	0.0125000
NODE_1072_length_2272_cov_8.175334	213	293	173	3	80	0.0375000
NODE_1072_length_2272_cov_8.175334	213	293	178	3	80	0.0375000
NODE_1072_length_2272_cov_8.175334	213	293	182	5	80	0.0625000
NODE_1072_length_2272_cov_8.175334	213	293	184	2	80	0.0250000
NODE_1072_length_2272_cov_8.175334	213	293	185	1	80	0.0125000
NODE_1072_length_2272_cov_8.175334	213	293	186	2	80	0.0250000
NODE_1072_length_2272_cov_8.175334	213	293	188	3	80	0.0375000
NODE_1072_length_2272_cov_8.175334	213	293	189	2	80	0.0250000
NODE_1072_length_2272_cov_8.175334	213	293	193	1	80	0.0125000
NODE_1072_length_2272_cov_8.175334	213	293	195	1	80	0.0125000
NODE_1072_length_2272_cov_8.175334	213	293	197	1	80	0.0125000
NODE_1072_length_2272_cov_8.175334	213	293	198	1	80	0.0125000
NODE_1072_length_2272_cov_8.175334	213	293	199	5	80	0.0625000
NODE_1072_length_2272_cov_8.175334	213	293	201	5	80	0.0625000
NODE_1072_length_2272_cov_8.175334	213	293	202	4	80	0.0500000
NODE_1072_length_2272_cov_8.175334	213	293	203	1	80	0.0125000
NODE_1072_length_2272_cov_8.175334	213	293	204	4	80	0.0500000
NODE_1072_length_2272_cov_8.175334	213	293	206	1	80	0.0125000
NODE_1072_length_2272_cov_8.175334	266	346	2	1	80	0.0125000
NODE_1072_length_2272_cov_8.175334	266	346	6	1	80	0.0125000
NODE_1072_length_2272_cov_8.175334	266	346	25	2	80	0.0250000
NODE_1072_length_2272_cov_8.175334	266	346	27	1	80	0.0125000
NODE_1072_length_2272_cov_8.175334	266	346	32	1	80	0.0125000
NODE_1072_length_2272_cov_8.175334	266	346	33	1	80	0.0125000
NODE_1072_length_2272_cov_8.175334	266	346	38	3	80	0.0375000
NODE_1072_length_2272_cov_8.175334	266	346	40	2	80	0.0250000
NODE_1072_length_2272_cov_8.175334	266	346	41	1	80	0.0125000
NODE_1072_length_2272_cov_8.175334	266	346	43	1	80	0.0125000
NODE_1072_length_2272_cov_8.175334	266	346	46	1	80	0.0125000
NODE_1072_length_2272_cov_8.175334	266	346	50	4	80	0.0500000
NODE_1072_length_2272_cov_8.175334	266	346	52	1	80	0.0125000
NODE_1072_length_2272_cov_8.175334	266	346	54	1	80	0.0125000
NODE_1072_length_2272_cov_8.175334	266	346	56	2	80	0.0250000
NODE_1072_length_2272_cov_8.175334	266	346	58	2	80	0.0250000
NODE_1072_length_2272_cov_8.175334	266	346	59	1	80	0.0125000
NODE_1072_length_2272_cov_8.175334	266	346	61	3	80	0.0375000
NODE_1072_length_2272_cov_8.175334	266	346	62	3	80	0.0375000
NODE_1072_length_2272_cov_8.175334	266	346	64	1	80	0.0125000
NODE_1072_length_2272_cov_8.175334	266	346	68	1	80	0.0125000
NODE_1072_length_2272_cov_8.175334	266	346	84	2	80	0.0250000
NODE_1072_length_2272_cov_8.175334	266	346	86	1	80	0.0125000
NODE_1072_length_2272_cov_8.175334	266	346	88	1	80	0.0125000
NODE_1072_length_2272_cov_8.175334	266	346	89	1	80	0.0125000
NODE_1072_length_2272_cov_8.175334	266	346	91	3	80	0.0375000
NODE_1072_length_2272_cov_8.175334	266	346	95	2	80	0.0250000
NODE_1072_length_2272_cov_8.175334	266	346	100	1	80	0.0125000
NODE_1072_length_2272_cov_8.175334	266	346	103	2	80	0.0250000
NODE_1072_length_2272_cov_8.175334	266	346	107	1	80	0.0125000
NODE_1072_length_2272_cov_8.175334	266	346	108	3	80	0.0375000
NODE_1072_length_2272_cov_8.175334	266	346	110	1	80	0.0125000
NODE_1072_length_2272_cov_8.175334	266	346	115	1	80	0.0125000
NODE_1072_length_2272_cov_8.175334	266	346	116	1	80	0.0125000
NODE_1072_length_2272_cov_8.175334	266	346	123	1	80	0.0125000
NODE_1072_length_2272_cov_8.175334	266	346	124	1	80	0.0125000
NODE_1072_length_2272_cov_8.175334	266	346	126	2	80	0.0250000
NODE_1072_length_2272_cov_8.175334	266	346	128	1	80	0.0125000
NODE_1072_length_2272_cov_8.175334	266	346	130	2	80	0.0250000
NODE_1072_length_2272_cov_8.175334	266	346	133	3	80	0.0375000
NODE_1072_length_2272_cov_8.175334	266	346	135	1	80	0.0125000
NODE_1072_length_2272_cov_8.175334	266	346	139	2	80	0.0250000
NODE_1072_length_2272_cov_8.175334	266	346	143	1	80	0.0125000
NODE_1072_length_2272_cov_8.175334	266	346	145	2	80	0.0250000
NODE_1072_length_2272_cov_8.175334	266	346	147	1	80	0.0125000
NODE_1072_length_2272_cov_8.175334	266	346	149	1	80	0.0125000
NODE_1072_length_2272_cov_8.175334	266	346	151	1	80	0.0125000
NODE_1072_length_2272_cov_8.175334	266	346	153	1	80	0.0125000
NODE_1072_length_2272_cov_8.175334	266	346	155	1	80	0.0125000
NODE_1072_length_2272_cov_8.175334	266	346	157	1	80	0.0125000
NODE_1072_length_2272_cov_8.175334	266	346	163	2	80	0.0250000
NODE_1072_length_2272_cov_8.175334	266	346	165	2	80	0.0250000
NODE_1077_length_2266_cov_13.206276	359	439	0	5	80	0.0625000
NODE_1077_length_2266_cov_13.206276	359	439	2	6	80	0.0750000
NODE_1077_length_2266_cov_13.206276	359	439	4	19	80	0.2375000
NODE_1077_length_2266_cov_13.206276	359	439	6	49	80	0.6125000
NODE_1077_length_2266_cov_13.206276	359	439	8	1	80	0.0125000
NODE_1077_length_2266_cov_13.206276	412	492	6	33	80	0.4125000
NODE_1077_length_2266_cov_13.206276	412	492	8	21	80	0.2625000
NODE_1077_length_2266_cov_13.206276	412	492	10	8	80	0.1000000
NODE_1077_length_2266_cov_13.206276	412	492	12	5	80	0.0625000
NODE_1077_length_2266_cov_13.206276	412	492	17	13	80	0.1625000
NODE_1077_length_2266_cov_13.206276	488	568	13	5	80	0.0625000
NODE_1077_length_2266_cov_13.206276	488	568	15	8	80	0.1000000
NODE_1077_length_2266_cov_13.206276	488	568	17	30	80	0.3750000
NODE_1077_length_2266_cov_13.206276	488	568	18	19	80	0.2375000
NODE_1077_length_2266_cov_13.206276	488	568	20	18	80	0.2250000
NODE_1077_length_2266_cov_13.206276	541	627	0	17	86	0.1976744
NODE_1077_length_2266_cov_13.206276	541	627	2	23	86	0.2674419
NODE_1077_length_2266_cov_13.206276	541	627	4	3	86	0.0348837
NODE_1077_length_2266_cov_13.206276	541	627	5	2	86	0.0232558
NODE_1077_length_2266_cov_13.206276	541	627	13	2	86	0.0232558
NODE_1077_length_2266_cov_13.206276	541	627	17	4	86	0.0465116
NODE_1077_length_2266_cov_13.206276	541	627	18	24	86	0.2790698
NODE_1077_length_2266_cov_13.206276	541	627	20	11	86	0.1279070
NODE_1078_length_2262_cov_11.759131	413	493	0	80	80	1.0000000
NODE_1078_length_2262_cov_11.759131	466	546	0	80	80	1.0000000
NODE_1079_length_2260_cov_37.814901	219	299	0	7	80	0.0875000
NODE_1079_length_2260_cov_37.814901	219	299	2	5	80	0.0625000
NODE_1079_length_2260_cov_37.814901	219	299	4	68	80	0.8500000
NODE_1079_length_2260_cov_37.814901	742	822	0	44	80	0.5500000
NODE_1079_length_2260_cov_37.814901	742	822	2	36	80	0.4500000
NODE_1079_length_2260_cov_37.814901	795	875	0	80	80	1.0000000
NODE_1079_length_2260_cov_37.814901	1533	1613	4	9	80	0.1125000
NODE_1079_length_2260_cov_37.814901	1533	1613	6	13	80	0.1625000
NODE_1079_length_2260_cov_37.814901	1533	1613	8	31	80	0.3875000
NODE_1079_length_2260_cov_37.814901	1533	1613	10	27	80	0.3375000
NODE_1079_length_2260_cov_37.814901	1586	1666	2	7	80	0.0875000
NODE_1079_length_2260_cov_37.814901	1586	1666	4	30	80	0.3750000
NODE_1079_length_2260_cov_37.814901	1586	1666	6	13	80	0.1625000
NODE_1079_length_2260_cov_37.814901	1586	1666	8	27	80	0.3375000
NODE_1079_length_2260_cov_37.814901	1586	1666	10	3	80	0.0375000
NODE_1079_length_2260_cov_37.814901	1662	1742	2	71	80	0.8875000
NODE_1079_length_2260_cov_37.814901	1662	1742	4	9	80	0.1125000
NODE_1079_length_2260_cov_37.814901	1715	1795	2	80	80	1.0000000
NODE_1082_length_2253_cov_8.904828	472	552	8	15	80	0.1875000
NODE_1082_length_2253_cov_8.904828	472	552	9	4	80	0.0500000
NODE_1082_length_2253_cov_8.904828	472	552	10	2	80	0.0250000
NODE_1082_length_2253_cov_8.904828	472	552	12	6	80	0.0750000
NODE_1082_length_2253_cov_8.904828	472	552	16	1	80	0.0125000
NODE_1082_length_2253_cov_8.904828	472	552	17	14	80	0.1750000
NODE_1082_length_2253_cov_8.904828	472	552	19	2	80	0.0250000
NODE_1082_length_2253_cov_8.904828	472	552	22	1	80	0.0125000
NODE_1082_length_2253_cov_8.904828	472	552	24	6	80	0.0750000
NODE_1082_length_2253_cov_8.904828	472	552	26	8	80	0.1000000
NODE_1082_length_2253_cov_8.904828	472	552	28	1	80	0.0125000
NODE_1082_length_2253_cov_8.904828	472	552	32	2	80	0.0250000
NODE_1082_length_2253_cov_8.904828	472	552	34	2	80	0.0250000
NODE_1082_length_2253_cov_8.904828	472	552	38	1	80	0.0125000
NODE_1082_length_2253_cov_8.904828	472	552	42	1	80	0.0125000
NODE_1082_length_2253_cov_8.904828	472	552	54	2	80	0.0250000
NODE_1082_length_2253_cov_8.904828	472	552	56	1	80	0.0125000
NODE_1082_length_2253_cov_8.904828	472	552	58	2	80	0.0250000
NODE_1082_length_2253_cov_8.904828	472	552	60	3	80	0.0375000
NODE_1082_length_2253_cov_8.904828	472	552	64	2	80	0.0250000
NODE_1082_length_2253_cov_8.904828	472	552	68	1	80	0.0125000
NODE_1082_length_2253_cov_8.904828	472	552	74	1	80	0.0125000
NODE_1082_length_2253_cov_8.904828	472	552	76	1	80	0.0125000
NODE_1082_length_2253_cov_8.904828	472	552	77	1	80	0.0125000
NODE_1085_length_2252_cov_2.801208	1128	1170	0	2	42	0.0476190
NODE_1085_length_2252_cov_2.801208	1128	1170	2	15	42	0.3571429
NODE_1085_length_2252_cov_2.801208	1128	1170	4	25	42	0.5952381
NODE_1085_length_2252_cov_2.801208	1137	1172	2	8	35	0.2285714
NODE_1085_length_2252_cov_2.801208	1137	1172	4	27	35	0.7714286
NODE_1086_length_2252_cov_2.078031	13	62	0	49	49	1.0000000
NODE_1086_length_2252_cov_2.078031	13	61	0	48	48	1.0000000
NODE_1086_length_2252_cov_2.078031	13	62	0	49	49	1.0000000
NODE_1086_length_2252_cov_2.078031	13	62	0	49	49	1.0000000
NODE_1086_length_2252_cov_2.078031	13	61	0	48	48	1.0000000
NODE_1087_length_2251_cov_15.458178	1443	1506	0	59	63	0.9365079
NODE_1087_length_2251_cov_15.458178	1443	1506	1	1	63	0.0158730
NODE_1087_length_2251_cov_15.458178	1443	1506	2	1	63	0.0158730
NODE_1087_length_2251_cov_15.458178	1443	1506	4	1	63	0.0158730
NODE_1087_length_2251_cov_15.458178	1443	1506	10	1	63	0.0158730
NODE_1087_length_2251_cov_15.458178	1496	1550	0	9	54	0.1666667
NODE_1087_length_2251_cov_15.458178	1496	1550	1	16	54	0.2962963
NODE_1087_length_2251_cov_15.458178	1496	1550	2	5	54	0.0925926
NODE_1087_length_2251_cov_15.458178	1496	1550	4	1	54	0.0185185
NODE_1087_length_2251_cov_15.458178	1496	1550	6	1	54	0.0185185
NODE_1087_length_2251_cov_15.458178	1496	1550	8	3	54	0.0555556
NODE_1087_length_2251_cov_15.458178	1496	1550	9	2	54	0.0370370
NODE_1087_length_2251_cov_15.458178	1496	1550	11	11	54	0.2037037
NODE_1087_length_2251_cov_15.458178	1496	1550	21	1	54	0.0185185
NODE_1087_length_2251_cov_15.458178	1496	1550	23	1	54	0.0185185
NODE_1087_length_2251_cov_15.458178	1496	1550	28	2	54	0.0370370
NODE_1087_length_2251_cov_15.458178	1496	1550	30	2	54	0.0370370
NODE_1089_length_2250_cov_18.370990	1658	1738	2	57	80	0.7125000
NODE_1089_length_2250_cov_18.370990	1658	1738	4	15	80	0.1875000
NODE_1089_length_2250_cov_18.370990	1658	1738	6	8	80	0.1000000
NODE_1089_length_2250_cov_18.370990	1711	1791	0	7	80	0.0875000
NODE_1089_length_2250_cov_18.370990	1711	1791	2	4	80	0.0500000
NODE_1089_length_2250_cov_18.370990	1711	1791	4	61	80	0.7625000
NODE_1089_length_2250_cov_18.370990	1711	1791	6	8	80	0.1000000
NODE_1090_length_2250_cov_5.331474	1844	1924	0	33	80	0.4125000
NODE_1090_length_2250_cov_5.331474	1844	1924	2	47	80	0.5875000
NODE_1093_length_2247_cov_7.906890	364	436	10	17	72	0.2361111
NODE_1093_length_2247_cov_7.906890	364	436	14	10	72	0.1388889
NODE_1093_length_2247_cov_7.906890	364	436	16	5	72	0.0694444
NODE_1093_length_2247_cov_7.906890	364	436	17	6	72	0.0833333
NODE_1093_length_2247_cov_7.906890	364	436	18	25	72	0.3472222
NODE_1093_length_2247_cov_7.906890	364	436	19	5	72	0.0694444
NODE_1093_length_2247_cov_7.906890	364	436	20	4	72	0.0555556
NODE_1095_length_2246_cov_7.612948	1992	2055	0	57	63	0.9047619
NODE_1095_length_2246_cov_7.612948	1992	2055	2	6	63	0.0952381
NODE_1095_length_2246_cov_7.612948	2045	2108	0	63	63	1.0000000
NODE_1104_length_2233_cov_35.127460	1517	1597	0	80	80	1.0000000
NODE_1104_length_2233_cov_35.127460	1570	1650	0	80	80	1.0000000
NODE_1105_length_2231_cov_45.701689	315	396	16	9	81	0.1111111
NODE_1105_length_2231_cov_45.701689	315	396	18	2	81	0.0246914
NODE_1105_length_2231_cov_45.701689	315	396	22	9	81	0.1111111
NODE_1105_length_2231_cov_45.701689	315	396	24	17	81	0.2098765
NODE_1105_length_2231_cov_45.701689	315	396	26	19	81	0.2345679
NODE_1105_length_2231_cov_45.701689	315	396	28	6	81	0.0740741
NODE_1105_length_2231_cov_45.701689	315	396	30	14	81	0.1728395
NODE_1105_length_2231_cov_45.701689	315	396	31	5	81	0.0617284
NODE_1105_length_2231_cov_45.701689	369	449	0	2	80	0.0250000
NODE_1105_length_2231_cov_45.701689	369	449	1	1	80	0.0125000
NODE_1105_length_2231_cov_45.701689	369	449	2	2	80	0.0250000
NODE_1105_length_2231_cov_45.701689	369	449	3	5	80	0.0625000
NODE_1105_length_2231_cov_45.701689	369	449	5	5	80	0.0625000
NODE_1105_length_2231_cov_45.701689	369	449	7	15	80	0.1875000
NODE_1105_length_2231_cov_45.701689	369	449	8	17	80	0.2125000
NODE_1105_length_2231_cov_45.701689	369	449	12	1	80	0.0125000
NODE_1105_length_2231_cov_45.701689	369	449	16	14	80	0.1750000
NODE_1105_length_2231_cov_45.701689	369	449	18	2	80	0.0250000
NODE_1105_length_2231_cov_45.701689	369	449	22	9	80	0.1125000
NODE_1105_length_2231_cov_45.701689	369	449	24	7	80	0.0875000
NODE_1105_length_2231_cov_45.701689	496	576	0	80	80	1.0000000
NODE_1105_length_2231_cov_45.701689	582	662	0	80	80	1.0000000
NODE_1105_length_2231_cov_45.701689	625	705	0	80	80	1.0000000
NODE_1105_length_2231_cov_45.701689	711	791	0	80	80	1.0000000
NODE_1105_length_2231_cov_45.701689	1141	1186	4	14	45	0.3111111
NODE_1105_length_2231_cov_45.701689	1141	1186	8	10	45	0.2222222
NODE_1105_length_2231_cov_45.701689	1141	1186	10	21	45	0.4666667
NODE_1105_length_2231_cov_45.701689	1787	1867	0	80	80	1.0000000
NODE_1105_length_2231_cov_45.701689	1840	1920	0	80	80	1.0000000
NODE_1106_length_2230_cov_12.608634	1520	1600	0	5	80	0.0625000
NODE_1106_length_2230_cov_12.608634	1520	1600	2	75	80	0.9375000
NODE_1106_length_2230_cov_12.608634	1573	1653	0	58	80	0.7250000
NODE_1106_length_2230_cov_12.608634	1573	1653	2	22	80	0.2750000
NODE_1112_length_2218_cov_5.292591	1427	1497	6	67	70	0.9571428
NODE_1112_length_2218_cov_5.292591	1427	1497	8	3	70	0.0428571
NODE_1112_length_2218_cov_5.292591	1470	1536	2	4	66	0.0606061
NODE_1112_length_2218_cov_5.292591	1470	1536	4	16	66	0.2424242
NODE_1112_length_2218_cov_5.292591	1470	1536	6	43	66	0.6515151
NODE_1112_length_2218_cov_5.292591	1470	1536	8	3	66	0.0454545
NODE_1115_length_2215_cov_51.865784	108	188	0	80	80	1.0000000
NODE_1115_length_2215_cov_51.865784	161	241	0	80	80	1.0000000
NODE_1115_length_2215_cov_51.865784	237	317	0	80	80	1.0000000
NODE_1115_length_2215_cov_51.865784	290	370	0	80	80	1.0000000
NODE_1115_length_2215_cov_51.865784	1030	1102	21	1	72	0.0138889
NODE_1115_length_2215_cov_51.865784	1030	1102	27	4	72	0.0555556
NODE_1115_length_2215_cov_51.865784	1030	1102	28	1	72	0.0138889
NODE_1115_length_2215_cov_51.865784	1030	1102	29	1	72	0.0138889
NODE_1115_length_2215_cov_51.865784	1030	1102	31	2	72	0.0277778
NODE_1115_length_2215_cov_51.865784	1030	1102	33	10	72	0.1388889
NODE_1115_length_2215_cov_51.865784	1030	1102	34	8	72	0.1111111
NODE_1115_length_2215_cov_51.865784	1030	1102	36	11	72	0.1527778
NODE_1115_length_2215_cov_51.865784	1030	1102	37	2	72	0.0277778
NODE_1115_length_2215_cov_51.865784	1030	1102	39	3	72	0.0416667
NODE_1115_length_2215_cov_51.865784	1030	1102	40	2	72	0.0277778
NODE_1115_length_2215_cov_51.865784	1030	1102	41	5	72	0.0694444
NODE_1115_length_2215_cov_51.865784	1030	1102	43	6	72	0.0833333
NODE_1115_length_2215_cov_51.865784	1030	1102	44	5	72	0.0694444
NODE_1115_length_2215_cov_51.865784	1030	1102	46	3	72	0.0416667
NODE_1115_length_2215_cov_51.865784	1030	1102	47	5	72	0.0694444
NODE_1115_length_2215_cov_51.865784	1030	1102	48	3	72	0.0416667
NODE_1115_length_2215_cov_51.865784	1571	1651	2	32	80	0.4000000
NODE_1115_length_2215_cov_51.865784	1571	1651	4	48	80	0.6000000
NODE_1115_length_2215_cov_51.865784	1624	1704	2	37	80	0.4625000
NODE_1115_length_2215_cov_51.865784	1624	1704	4	43	80	0.5375000
NODE_1117_length_2212_cov_63.988168	459	539	6	29	80	0.3625000
NODE_1117_length_2212_cov_63.988168	459	539	9	34	80	0.4250000
NODE_1117_length_2212_cov_63.988168	459	539	10	17	80	0.2125000
NODE_1117_length_2212_cov_63.988168	512	592	4	31	80	0.3875000
NODE_1117_length_2212_cov_63.988168	512	592	6	27	80	0.3375000
NODE_1117_length_2212_cov_63.988168	512	592	8	22	80	0.2750000
NODE_1117_length_2212_cov_63.988168	588	668	0	30	80	0.3750000
NODE_1117_length_2212_cov_63.988168	588	668	1	39	80	0.4875000
NODE_1117_length_2212_cov_63.988168	588	668	3	2	80	0.0250000
NODE_1117_length_2212_cov_63.988168	588	668	4	9	80	0.1125000
NODE_1117_length_2212_cov_63.988168	641	721	0	80	80	1.0000000
NODE_1119_length_2212_cov_4.632750	1479	1559	0	80	80	1.0000000
NODE_1119_length_2212_cov_4.632750	1532	1612	0	80	80	1.0000000
NODE_1122_length_2211_cov_16.247159	1808	1888	8	26	80	0.3250000
NODE_1122_length_2211_cov_16.247159	1808	1888	9	4	80	0.0500000
NODE_1122_length_2211_cov_16.247159	1808	1888	10	23	80	0.2875000
NODE_1122_length_2211_cov_16.247159	1808	1888	12	15	80	0.1875000
NODE_1122_length_2211_cov_16.247159	1808	1888	13	3	80	0.0375000
NODE_1122_length_2211_cov_16.247159	1808	1888	14	9	80	0.1125000
NODE_1124_length_2207_cov_46.766129	1273	1348	63	1	75	0.0133333
NODE_1124_length_2207_cov_46.766129	1273	1348	71	14	75	0.1866667
NODE_1124_length_2207_cov_46.766129	1273	1348	77	1	75	0.0133333
NODE_1124_length_2207_cov_46.766129	1273	1348	79	2	75	0.0266667
NODE_1124_length_2207_cov_46.766129	1273	1348	80	5	75	0.0666667
NODE_1124_length_2207_cov_46.766129	1273	1348	82	2	75	0.0266667
NODE_1124_length_2207_cov_46.766129	1273	1348	83	5	75	0.0666667
NODE_1124_length_2207_cov_46.766129	1273	1348	84	1	75	0.0133333
NODE_1124_length_2207_cov_46.766129	1273	1348	91	2	75	0.0266667
NODE_1124_length_2207_cov_46.766129	1273	1348	92	3	75	0.0400000
NODE_1124_length_2207_cov_46.766129	1273	1348	93	4	75	0.0533333
NODE_1124_length_2207_cov_46.766129	1273	1348	94	6	75	0.0800000
NODE_1124_length_2207_cov_46.766129	1273	1348	95	5	75	0.0666667
NODE_1124_length_2207_cov_46.766129	1273	1348	96	1	75	0.0133333
NODE_1124_length_2207_cov_46.766129	1273	1348	97	1	75	0.0133333
NODE_1124_length_2207_cov_46.766129	1273	1348	100	2	75	0.0266667
NODE_1124_length_2207_cov_46.766129	1273	1348	107	1	75	0.0133333
NODE_1124_length_2207_cov_46.766129	1273	1348	110	2	75	0.0266667
NODE_1124_length_2207_cov_46.766129	1273	1348	112	3	75	0.0400000
NODE_1124_length_2207_cov_46.766129	1273	1348	114	1	75	0.0133333
NODE_1124_length_2207_cov_46.766129	1273	1348	116	1	75	0.0133333
NODE_1124_length_2207_cov_46.766129	1273	1348	117	2	75	0.0266667
NODE_1124_length_2207_cov_46.766129	1273	1348	118	4	75	0.0533333
NODE_1124_length_2207_cov_46.766129	1273	1348	119	1	75	0.0133333
NODE_1124_length_2207_cov_46.766129	1273	1348	121	5	75	0.0666667
NODE_1124_length_2207_cov_46.766129	1324	1401	65	1	77	0.0129870
NODE_1124_length_2207_cov_46.766129	1324	1401	67	5	77	0.0649351
NODE_1124_length_2207_cov_46.766129	1324	1401	69	5	77	0.0649351
NODE_1124_length_2207_cov_46.766129	1324	1401	71	2	77	0.0259740
NODE_1124_length_2207_cov_46.766129	1324	1401	73	2	77	0.0259740
NODE_1124_length_2207_cov_46.766129	1324	1401	74	1	77	0.0129870
NODE_1124_length_2207_cov_46.766129	1324	1401	75	3	77	0.0389610
NODE_1124_length_2207_cov_46.766129	1324	1401	78	2	77	0.0259740
NODE_1124_length_2207_cov_46.766129	1324	1401	86	1	77	0.0129870
NODE_1124_length_2207_cov_46.766129	1324	1401	87	2	77	0.0259740
NODE_1124_length_2207_cov_46.766129	1324	1401	88	6	77	0.0779221
NODE_1124_length_2207_cov_46.766129	1324	1401	90	3	77	0.0389610
NODE_1124_length_2207_cov_46.766129	1324	1401	92	2	77	0.0259740
NODE_1124_length_2207_cov_46.766129	1324	1401	96	1	77	0.0129870
NODE_1124_length_2207_cov_46.766129	1324	1401	98	1	77	0.0129870
NODE_1124_length_2207_cov_46.766129	1324	1401	100	2	77	0.0259740
NODE_1124_length_2207_cov_46.766129	1324	1401	105	1	77	0.0129870
NODE_1124_length_2207_cov_46.766129	1324	1401	107	5	77	0.0649351
NODE_1124_length_2207_cov_46.766129	1324	1401	110	5	77	0.0649351
NODE_1124_length_2207_cov_46.766129	1324	1401	112	5	77	0.0649351
NODE_1124_length_2207_cov_46.766129	1324	1401	113	1	77	0.0129870
NODE_1124_length_2207_cov_46.766129	1324	1401	114	1	77	0.0129870
NODE_1124_length_2207_cov_46.766129	1324	1401	116	7	77	0.0909091
NODE_1124_length_2207_cov_46.766129	1324	1401	117	2	77	0.0259740
NODE_1124_length_2207_cov_46.766129	1324	1401	118	5	77	0.0649351
NODE_1124_length_2207_cov_46.766129	1324	1401	119	1	77	0.0129870
NODE_1124_length_2207_cov_46.766129	1324	1401	121	5	77	0.0649351
NODE_1127_length_2205_cov_12.762108	1818	1898	3	3	80	0.0375000
NODE_1127_length_2205_cov_12.762108	1818	1898	5	77	80	0.9625000
NODE_1127_length_2205_cov_12.762108	1871	1951	0	41	80	0.5125000
NODE_1127_length_2205_cov_12.762108	1871	1951	3	15	80	0.1875000
NODE_1127_length_2205_cov_12.762108	1871	1951	5	24	80	0.3000000
NODE_1127_length_2205_cov_12.762108	1872	1951	0	41	79	0.5189874
NODE_1127_length_2205_cov_12.762108	1872	1951	3	15	79	0.1898734
NODE_1127_length_2205_cov_12.762108	1872	1951	5	23	79	0.2911392
NODE_1127_length_2205_cov_12.762108	1947	2020	0	27	73	0.3698630
NODE_1127_length_2205_cov_12.762108	1947	2020	2	46	73	0.6301370
NODE_1128_length_2202_cov_8.687114	1848	1912	0	64	64	1.0000000
NODE_1130_length_2200_cov_10.639695	1461	1541	0	80	80	1.0000000
NODE_1130_length_2200_cov_10.639695	1514	1594	0	80	80	1.0000000
NODE_1131_length_2199_cov_10.839524	1709	1789	0	80	80	1.0000000
NODE_1131_length_2199_cov_10.839524	1762	1842	0	80	80	1.0000000
NODE_1135_length_2196_cov_64.718646	885	965	2	2	80	0.0250000
NODE_1135_length_2196_cov_64.718646	885	965	4	53	80	0.6625000
NODE_1135_length_2196_cov_64.718646	885	965	6	15	80	0.1875000
NODE_1135_length_2196_cov_64.718646	885	965	8	10	80	0.1250000
NODE_1135_length_2196_cov_64.718646	938	1018	4	36	80	0.4500000
NODE_1135_length_2196_cov_64.718646	938	1018	6	24	80	0.3000000
NODE_1135_length_2196_cov_64.718646	938	1018	8	20	80	0.2500000
NODE_1138_length_2195_cov_8.443225	114	136	0	22	22	1.0000000
NODE_1139_length_2195_cov_6.113550	1245	1330	2	59	85	0.6941177
NODE_1139_length_2195_cov_6.113550	1245	1330	4	26	85	0.3058824
NODE_1139_length_2195_cov_6.113550	1306	1352	2	41	46	0.8913044
NODE_1139_length_2195_cov_6.113550	1306	1352	4	5	46	0.1086956
NODE_1141_length_2194_cov_1.366587	15	77	2	62	62	1.0000000
NODE_1142_length_2193_cov_8.320917	374	454	0	80	80	1.0000000
NODE_1142_length_2193_cov_8.320917	427	502	0	75	75	1.0000000
NODE_1146_length_2189_cov_36.884689	383	463	0	47	80	0.5875000
NODE_1146_length_2189_cov_36.884689	383	463	2	8	80	0.1000000
NODE_1146_length_2189_cov_36.884689	383	463	4	25	80	0.3125000
NODE_1146_length_2189_cov_36.884689	436	516	0	6	80	0.0750000
NODE_1146_length_2189_cov_36.884689	436	516	2	5	80	0.0625000
NODE_1146_length_2189_cov_36.884689	436	516	4	69	80	0.8625000
NODE_1146_length_2189_cov_36.884689	1257	1337	0	32	80	0.4000000
NODE_1146_length_2189_cov_36.884689	1257	1337	2	48	80	0.6000000
NODE_1146_length_2189_cov_36.884689	1310	1390	0	37	80	0.4625000
NODE_1146_length_2189_cov_36.884689	1310	1390	2	43	80	0.5375000
NODE_1146_length_2189_cov_36.884689	1427	1507	0	62	80	0.7750000
NODE_1146_length_2189_cov_36.884689	1427	1507	2	18	80	0.2250000
NODE_1146_length_2189_cov_36.884689	1480	1560	0	13	80	0.1625000
NODE_1146_length_2189_cov_36.884689	1480	1560	2	67	80	0.8375000
NODE_1152_length_2184_cov_9.464748	1536	1616	2	66	80	0.8250000
NODE_1152_length_2184_cov_9.464748	1536	1616	4	14	80	0.1750000
NODE_1152_length_2184_cov_9.464748	1589	1669	0	6	80	0.0750000
NODE_1152_length_2184_cov_9.464748	1589	1669	2	74	80	0.9250000
NODE_1154_length_2183_cov_45.471209	1632	1712	4	10	80	0.1250000
NODE_1154_length_2183_cov_45.471209	1632	1712	10	7	80	0.0875000
NODE_1154_length_2183_cov_45.471209	1632	1712	12	45	80	0.5625000
NODE_1154_length_2183_cov_45.471209	1632	1712	14	18	80	0.2250000
NODE_1154_length_2183_cov_45.471209	1685	1765	4	44	80	0.5500000
NODE_1154_length_2183_cov_45.471209	1685	1765	6	3	80	0.0375000
NODE_1154_length_2183_cov_45.471209	1685	1765	8	3	80	0.0375000
NODE_1154_length_2183_cov_45.471209	1685	1765	12	12	80	0.1500000
NODE_1154_length_2183_cov_45.471209	1685	1765	14	18	80	0.2250000
NODE_1159_length_2176_cov_47.338950	0	52	0	52	52	1.0000000
NODE_1162_length_2174_cov_40.560964	1638	1718	0	55	80	0.6875000
NODE_1162_length_2174_cov_40.560964	1638	1718	4	25	80	0.3125000
NODE_1162_length_2174_cov_40.560964	1691	1771	0	2	80	0.0250000
NODE_1162_length_2174_cov_40.560964	1691	1771	4	78	80	0.9750000
NODE_1163_length_2174_cov_35.399518	284	364	0	80	80	1.0000000
NODE_1163_length_2174_cov_35.399518	337	414	0	77	77	1.0000000
NODE_1163_length_2174_cov_35.399518	1542	1620	209	1	78	0.0128205
NODE_1163_length_2174_cov_35.399518	1542	1620	211	1	78	0.0128205
NODE_1163_length_2174_cov_35.399518	1542	1620	216	1	78	0.0128205
NODE_1163_length_2174_cov_35.399518	1542	1620	219	1	78	0.0128205
NODE_1163_length_2174_cov_35.399518	1542	1620	221	1	78	0.0128205
NODE_1163_length_2174_cov_35.399518	1542	1620	224	1	78	0.0128205
NODE_1163_length_2174_cov_35.399518	1542	1620	225	3	78	0.0384615
NODE_1163_length_2174_cov_35.399518	1542	1620	226	2	78	0.0256410
NODE_1163_length_2174_cov_35.399518	1542	1620	227	1	78	0.0128205
NODE_1163_length_2174_cov_35.399518	1542	1620	229	2	78	0.0256410
NODE_1163_length_2174_cov_35.399518	1542	1620	231	2	78	0.0256410
NODE_1163_length_2174_cov_35.399518	1542	1620	233	1	78	0.0128205
NODE_1163_length_2174_cov_35.399518	1542	1620	235	3	78	0.0384615
NODE_1163_length_2174_cov_35.399518	1542	1620	236	5	78	0.0641026
NODE_1163_length_2174_cov_35.399518	1542	1620	237	5	78	0.0641026
NODE_1163_length_2174_cov_35.399518	1542	1620	238	1	78	0.0128205
NODE_1163_length_2174_cov_35.399518	1542	1620	239	1	78	0.0128205
NODE_1163_length_2174_cov_35.399518	1542	1620	240	1	78	0.0128205
NODE_1163_length_2174_cov_35.399518	1542	1620	241	1	78	0.0128205
NODE_1163_length_2174_cov_35.399518	1542	1620	242	2	78	0.0256410
NODE_1163_length_2174_cov_35.399518	1542	1620	243	1	78	0.0128205
NODE_1163_length_2174_cov_35.399518	1542	1620	246	2	78	0.0256410
NODE_1163_length_2174_cov_35.399518	1542	1620	248	2	78	0.0256410
NODE_1163_length_2174_cov_35.399518	1542	1620	250	1	78	0.0128205
NODE_1163_length_2174_cov_35.399518	1542	1620	254	1	78	0.0128205
NODE_1163_length_2174_cov_35.399518	1542	1620	258	1	78	0.0128205
NODE_1163_length_2174_cov_35.399518	1542	1620	261	1	78	0.0128205
NODE_1163_length_2174_cov_35.399518	1542	1620	263	2	78	0.0256410
NODE_1163_length_2174_cov_35.399518	1542	1620	267	1	78	0.0128205
NODE_1163_length_2174_cov_35.399518	1542	1620	269	3	78	0.0384615
NODE_1163_length_2174_cov_35.399518	1542	1620	271	1	78	0.0128205
NODE_1163_length_2174_cov_35.399518	1542	1620	272	4	78	0.0512821
NODE_1163_length_2174_cov_35.399518	1542	1620	273	2	78	0.0256410
NODE_1163_length_2174_cov_35.399518	1542	1620	274	3	78	0.0384615
NODE_1163_length_2174_cov_35.399518	1542	1620	276	3	78	0.0384615
NODE_1163_length_2174_cov_35.399518	1542	1620	277	1	78	0.0128205
NODE_1163_length_2174_cov_35.399518	1542	1620	278	3	78	0.0384615
NODE_1163_length_2174_cov_35.399518	1542	1620	279	2	78	0.0256410
NODE_1163_length_2174_cov_35.399518	1542	1620	280	1	78	0.0128205
NODE_1163_length_2174_cov_35.399518	1542	1620	281	3	78	0.0384615
NODE_1163_length_2174_cov_35.399518	1542	1620	283	2	78	0.0256410
NODE_1163_length_2174_cov_35.399518	1542	1620	284	1	78	0.0128205
NODE_1163_length_2174_cov_35.399518	1542	1620	286	1	78	0.0128205
NODE_1163_length_2174_cov_35.399518	1593	1673	193	1	80	0.0125000
NODE_1163_length_2174_cov_35.399518	1593	1673	195	5	80	0.0625000
NODE_1163_length_2174_cov_35.399518	1593	1673	196	2	80	0.0250000
NODE_1163_length_2174_cov_35.399518	1593	1673	198	1	80	0.0125000
NODE_1163_length_2174_cov_35.399518	1593	1673	199	2	80	0.0250000
NODE_1163_length_2174_cov_35.399518	1593	1673	202	1	80	0.0125000
NODE_1163_length_2174_cov_35.399518	1593	1673	204	1	80	0.0125000
NODE_1163_length_2174_cov_35.399518	1593	1673	205	1	80	0.0125000
NODE_1163_length_2174_cov_35.399518	1593	1673	206	4	80	0.0500000
NODE_1163_length_2174_cov_35.399518	1593	1673	207	3	80	0.0375000
NODE_1163_length_2174_cov_35.399518	1593	1673	208	3	80	0.0375000
NODE_1163_length_2174_cov_35.399518	1593	1673	209	4	80	0.0500000
NODE_1163_length_2174_cov_35.399518	1593	1673	210	1	80	0.0125000
NODE_1163_length_2174_cov_35.399518	1593	1673	211	1	80	0.0125000
NODE_1163_length_2174_cov_35.399518	1593	1673	212	1	80	0.0125000
NODE_1163_length_2174_cov_35.399518	1593	1673	213	1	80	0.0125000
NODE_1163_length_2174_cov_35.399518	1593	1673	214	2	80	0.0250000
NODE_1163_length_2174_cov_35.399518	1593	1673	215	3	80	0.0375000
NODE_1163_length_2174_cov_35.399518	1593	1673	216	2	80	0.0250000
NODE_1163_length_2174_cov_35.399518	1593	1673	217	1	80	0.0125000
NODE_1163_length_2174_cov_35.399518	1593	1673	218	3	80	0.0375000
NODE_1163_length_2174_cov_35.399518	1593	1673	219	4	80	0.0500000
NODE_1163_length_2174_cov_35.399518	1593	1673	220	2	80	0.0250000
NODE_1163_length_2174_cov_35.399518	1593	1673	221	1	80	0.0125000
NODE_1163_length_2174_cov_35.399518	1593	1673	222	4	80	0.0500000
NODE_1163_length_2174_cov_35.399518	1593	1673	224	1	80	0.0125000
NODE_1163_length_2174_cov_35.399518	1593	1673	225	3	80	0.0375000
NODE_1163_length_2174_cov_35.399518	1593	1673	226	2	80	0.0250000
NODE_1163_length_2174_cov_35.399518	1593	1673	227	1	80	0.0125000
NODE_1163_length_2174_cov_35.399518	1593	1673	229	2	80	0.0250000
NODE_1163_length_2174_cov_35.399518	1593	1673	230	1	80	0.0125000
NODE_1163_length_2174_cov_35.399518	1593	1673	231	1	80	0.0125000
NODE_1163_length_2174_cov_35.399518	1593	1673	233	2	80	0.0250000
NODE_1163_length_2174_cov_35.399518	1593	1673	235	2	80	0.0250000
NODE_1163_length_2174_cov_35.399518	1593	1673	236	3	80	0.0375000
NODE_1163_length_2174_cov_35.399518	1593	1673	237	4	80	0.0500000
NODE_1163_length_2174_cov_35.399518	1593	1673	239	1	80	0.0125000
NODE_1163_length_2174_cov_35.399518	1593	1673	240	2	80	0.0250000
NODE_1163_length_2174_cov_35.399518	1593	1673	241	1	80	0.0125000
NODE_1163_length_2174_cov_35.399518	2075	2152	52	77	77	1.0000000
NODE_1163_length_2174_cov_35.399518	2075	2152	52	77	77	1.0000000
NODE_1163_length_2174_cov_35.399518	2075	2152	52	77	77	1.0000000
NODE_1163_length_2174_cov_35.399518	2125	2174	6	2	49	0.0408163
NODE_1163_length_2174_cov_35.399518	2125	2174	10	4	49	0.0816327
NODE_1163_length_2174_cov_35.399518	2125	2174	18	2	49	0.0408163
NODE_1163_length_2174_cov_35.399518	2125	2174	28	3	49	0.0612245
NODE_1163_length_2174_cov_35.399518	2125	2174	36	1	49	0.0204082
NODE_1163_length_2174_cov_35.399518	2125	2174	44	1	49	0.0204082
NODE_1163_length_2174_cov_35.399518	2125	2174	45	4	49	0.0816327
NODE_1163_length_2174_cov_35.399518	2125	2174	48	1	49	0.0204082
NODE_1163_length_2174_cov_35.399518	2125	2174	50	3	49	0.0612245
NODE_1163_length_2174_cov_35.399518	2125	2174	52	28	49	0.5714286
NODE_1163_length_2174_cov_35.399518	2128	2174	6	2	46	0.0434783
NODE_1163_length_2174_cov_35.399518	2128	2174	10	4	46	0.0869565
NODE_1163_length_2174_cov_35.399518	2128	2174	18	2	46	0.0434783
NODE_1163_length_2174_cov_35.399518	2128	2174	28	3	46	0.0652174
NODE_1163_length_2174_cov_35.399518	2128	2174	36	1	46	0.0217391
NODE_1163_length_2174_cov_35.399518	2128	2174	44	1	46	0.0217391
NODE_1163_length_2174_cov_35.399518	2128	2174	45	4	46	0.0869565
NODE_1163_length_2174_cov_35.399518	2128	2174	48	1	46	0.0217391
NODE_1163_length_2174_cov_35.399518	2128	2174	50	3	46	0.0652174
NODE_1163_length_2174_cov_35.399518	2128	2174	52	25	46	0.5434783
NODE_1163_length_2174_cov_35.399518	2130	2174	6	2	44	0.0454545
NODE_1163_length_2174_cov_35.399518	2130	2174	10	4	44	0.0909091
NODE_1163_length_2174_cov_35.399518	2130	2174	18	2	44	0.0454545
NODE_1163_length_2174_cov_35.399518	2130	2174	28	3	44	0.0681818
NODE_1163_length_2174_cov_35.399518	2130	2174	36	1	44	0.0227273
NODE_1163_length_2174_cov_35.399518	2130	2174	44	1	44	0.0227273
NODE_1163_length_2174_cov_35.399518	2130	2174	45	4	44	0.0909091
NODE_1163_length_2174_cov_35.399518	2130	2174	48	1	44	0.0227273
NODE_1163_length_2174_cov_35.399518	2130	2174	50	3	44	0.0681818
NODE_1163_length_2174_cov_35.399518	2130	2174	52	23	44	0.5227273
NODE_1164_length_2172_cov_44.861553	1110	1190	8	6	80	0.0750000
NODE_1164_length_2172_cov_44.861553	1110	1190	10	18	80	0.2250000
NODE_1164_length_2172_cov_44.861553	1110	1190	11	1	80	0.0125000
NODE_1164_length_2172_cov_44.861553	1110	1190	12	3	80	0.0375000
NODE_1164_length_2172_cov_44.861553	1110	1190	13	2	80	0.0250000
NODE_1164_length_2172_cov_44.861553	1110	1190	14	29	80	0.3625000
NODE_1164_length_2172_cov_44.861553	1110	1190	15	1	80	0.0125000
NODE_1164_length_2172_cov_44.861553	1110	1190	16	20	80	0.2500000
NODE_1164_length_2172_cov_44.861553	1163	1243	8	6	80	0.0750000
NODE_1164_length_2172_cov_44.861553	1163	1243	10	14	80	0.1750000
NODE_1164_length_2172_cov_44.861553	1163	1243	11	1	80	0.0125000
NODE_1164_length_2172_cov_44.861553	1163	1243	12	13	80	0.1625000
NODE_1164_length_2172_cov_44.861553	1163	1243	13	29	80	0.3625000
NODE_1164_length_2172_cov_44.861553	1163	1243	14	17	80	0.2125000
NODE_1164_length_2172_cov_44.861553	1239	1319	13	6	80	0.0750000
NODE_1164_length_2172_cov_44.861553	1239	1319	18	1	80	0.0125000
NODE_1164_length_2172_cov_44.861553	1239	1319	23	1	80	0.0125000
NODE_1164_length_2172_cov_44.861553	1239	1319	24	17	80	0.2125000
NODE_1164_length_2172_cov_44.861553	1239	1319	26	5	80	0.0625000
NODE_1164_length_2172_cov_44.861553	1239	1319	27	3	80	0.0375000
NODE_1164_length_2172_cov_44.861553	1239	1319	28	7	80	0.0875000
NODE_1164_length_2172_cov_44.861553	1239	1319	30	24	80	0.3000000
NODE_1164_length_2172_cov_44.861553	1239	1319	31	3	80	0.0375000
NODE_1164_length_2172_cov_44.861553	1239	1319	32	4	80	0.0500000
NODE_1164_length_2172_cov_44.861553	1239	1319	39	1	80	0.0125000
NODE_1164_length_2172_cov_44.861553	1239	1319	40	4	80	0.0500000
NODE_1164_length_2172_cov_44.861553	1239	1319	43	4	80	0.0500000
NODE_1164_length_2172_cov_44.861553	1292	1372	19	4	80	0.0500000
NODE_1164_length_2172_cov_44.861553	1292	1372	25	8	80	0.1000000
NODE_1164_length_2172_cov_44.861553	1292	1372	29	1	80	0.0125000
NODE_1164_length_2172_cov_44.861553	1292	1372	30	29	80	0.3625000
NODE_1164_length_2172_cov_44.861553	1292	1372	32	10	80	0.1250000
NODE_1164_length_2172_cov_44.861553	1292	1372	35	1	80	0.0125000
NODE_1164_length_2172_cov_44.861553	1292	1372	36	1	80	0.0125000
NODE_1164_length_2172_cov_44.861553	1292	1372	39	12	80	0.1500000
NODE_1164_length_2172_cov_44.861553	1292	1372	40	4	80	0.0500000
NODE_1164_length_2172_cov_44.861553	1292	1372	41	6	80	0.0750000
NODE_1164_length_2172_cov_44.861553	1292	1372	43	4	80	0.0500000
NODE_1166_length_2167_cov_33.133946	414	494	0	80	80	1.0000000
NODE_1166_length_2167_cov_33.133946	467	547	0	80	80	1.0000000
NODE_1166_length_2167_cov_33.133946	543	623	0	76	80	0.9500000
NODE_1166_length_2167_cov_33.133946	543	623	2	4	80	0.0500000
NODE_1166_length_2167_cov_33.133946	596	676	0	23	80	0.2875000
NODE_1166_length_2167_cov_33.133946	596	676	2	51	80	0.6375000
NODE_1166_length_2167_cov_33.133946	596	676	6	6	80	0.0750000
NODE_1169_length_2165_cov_21.460794	980	1060	0	75	80	0.9375000
NODE_1169_length_2165_cov_21.460794	980	1060	4	4	80	0.0500000
NODE_1169_length_2165_cov_21.460794	980	1060	6	1	80	0.0125000
NODE_1169_length_2165_cov_21.460794	1033	1113	0	26	80	0.3250000
NODE_1169_length_2165_cov_21.460794	1033	1113	4	4	80	0.0500000
NODE_1169_length_2165_cov_21.460794	1033	1113	6	50	80	0.6250000
NODE_1176_length_2157_cov_22.284257	989	1069	0	26	80	0.3250000
NODE_1176_length_2157_cov_22.284257	989	1069	1	1	80	0.0125000
NODE_1176_length_2157_cov_22.284257	989	1069	2	53	80	0.6625000
NODE_1176_length_2157_cov_22.284257	1042	1122	0	79	80	0.9875000
NODE_1176_length_2157_cov_22.284257	1042	1122	1	1	80	0.0125000
NODE_1176_length_2157_cov_22.284257	1118	1198	0	54	80	0.6750000
NODE_1176_length_2157_cov_22.284257	1118	1198	2	26	80	0.3250000
NODE_1176_length_2157_cov_22.284257	1171	1251	0	1	80	0.0125000
NODE_1176_length_2157_cov_22.284257	1171	1251	2	79	80	0.9875000
NODE_1177_length_2157_cov_8.830418	867	947	0	80	80	1.0000000
NODE_1177_length_2157_cov_8.830418	920	1000	0	80	80	1.0000000
NODE_1177_length_2157_cov_8.830418	996	1076	0	80	80	1.0000000
NODE_1177_length_2157_cov_8.830418	1049	1129	0	43	80	0.5375000
NODE_1177_length_2157_cov_8.830418	1049	1129	2	37	80	0.4625000
NODE_1178_length_2156_cov_25.065630	0	41	12	1	41	0.0243902
NODE_1178_length_2156_cov_25.065630	0	41	21	4	41	0.0975610
NODE_1178_length_2156_cov_25.065630	0	41	25	1	41	0.0243902
NODE_1178_length_2156_cov_25.065630	0	41	29	2	41	0.0487805
NODE_1178_length_2156_cov_25.065630	0	41	33	2	41	0.0487805
NODE_1178_length_2156_cov_25.065630	0	41	37	1	41	0.0243902
NODE_1178_length_2156_cov_25.065630	0	41	39	2	41	0.0487805
NODE_1178_length_2156_cov_25.065630	0	41	51	4	41	0.0975610
NODE_1178_length_2156_cov_25.065630	0	41	55	3	41	0.0731707
NODE_1178_length_2156_cov_25.065630	0	41	57	13	41	0.3170732
NODE_1178_length_2156_cov_25.065630	0	41	59	7	41	0.1707317
NODE_1178_length_2156_cov_25.065630	0	41	69	1	41	0.0243902
NODE_1178_length_2156_cov_25.065630	14	94	51	3	80	0.0375000
NODE_1178_length_2156_cov_25.065630	14	94	55	3	80	0.0375000
NODE_1178_length_2156_cov_25.065630	14	94	57	13	80	0.1625000
NODE_1178_length_2156_cov_25.065630	14	94	59	7	80	0.0875000
NODE_1178_length_2156_cov_25.065630	14	94	69	4	80	0.0500000
NODE_1178_length_2156_cov_25.065630	14	94	75	1	80	0.0125000
NODE_1178_length_2156_cov_25.065630	14	94	77	2	80	0.0250000
NODE_1178_length_2156_cov_25.065630	14	94	79	1	80	0.0125000
NODE_1178_length_2156_cov_25.065630	14	94	81	1	80	0.0125000
NODE_1178_length_2156_cov_25.065630	14	94	82	1	80	0.0125000
NODE_1178_length_2156_cov_25.065630	14	94	84	1	80	0.0125000
NODE_1178_length_2156_cov_25.065630	14	94	86	5	80	0.0625000
NODE_1178_length_2156_cov_25.065630	14	94	88	2	80	0.0250000
NODE_1178_length_2156_cov_25.065630	14	94	90	1	80	0.0125000
NODE_1178_length_2156_cov_25.065630	14	94	92	2	80	0.0250000
NODE_1178_length_2156_cov_25.065630	14	94	94	1	80	0.0125000
NODE_1178_length_2156_cov_25.065630	14	94	96	2	80	0.0250000
NODE_1178_length_2156_cov_25.065630	14	94	98	2	80	0.0250000
NODE_1178_length_2156_cov_25.065630	14	94	102	3	80	0.0375000
NODE_1178_length_2156_cov_25.065630	14	94	106	18	80	0.2250000
NODE_1178_length_2156_cov_25.065630	14	94	108	1	80	0.0125000
NODE_1178_length_2156_cov_25.065630	14	94	109	4	80	0.0500000
NODE_1178_length_2156_cov_25.065630	14	94	111	2	80	0.0250000
NODE_1181_length_2156_cov_3.216334	1890	1970	0	13	80	0.1625000
NODE_1181_length_2156_cov_3.216334	1890	1970	2	67	80	0.8375000
NODE_1181_length_2156_cov_3.216334	1943	2023	0	38	80	0.4750000
NODE_1181_length_2156_cov_3.216334	1943	2023	2	42	80	0.5250000
NODE_1184_length_2153_cov_11.610029	1968	2048	0	67	80	0.8375000
NODE_1184_length_2153_cov_11.610029	1968	2048	2	1	80	0.0125000
NODE_1184_length_2153_cov_11.610029	1968	2048	6	1	80	0.0125000
NODE_1184_length_2153_cov_11.610029	1968	2048	8	1	80	0.0125000
NODE_1184_length_2153_cov_11.610029	1968	2048	10	2	80	0.0250000
NODE_1184_length_2153_cov_11.610029	1968	2048	16	3	80	0.0375000
NODE_1184_length_2153_cov_11.610029	1968	2048	18	1	80	0.0125000
NODE_1184_length_2153_cov_11.610029	1968	2048	20	4	80	0.0500000
NODE_1184_length_2153_cov_11.610029	1977	2048	0	58	71	0.8169014
NODE_1184_length_2153_cov_11.610029	1977	2048	2	1	71	0.0140845
NODE_1184_length_2153_cov_11.610029	1977	2048	6	1	71	0.0140845
NODE_1184_length_2153_cov_11.610029	1977	2048	8	1	71	0.0140845
NODE_1184_length_2153_cov_11.610029	1977	2048	10	2	71	0.0281690
NODE_1184_length_2153_cov_11.610029	1977	2048	16	3	71	0.0422535
NODE_1184_length_2153_cov_11.610029	1977	2048	18	1	71	0.0140845
NODE_1184_length_2153_cov_11.610029	1977	2048	20	4	71	0.0563380
NODE_1190_length_2147_cov_25.116211	814	894	0	1	80	0.0125000
NODE_1190_length_2147_cov_25.116211	814	894	4	5	80	0.0625000
NODE_1190_length_2147_cov_25.116211	814	894	6	1	80	0.0125000
NODE_1190_length_2147_cov_25.116211	814	894	10	1	80	0.0125000
NODE_1190_length_2147_cov_25.116211	814	894	12	35	80	0.4375000
NODE_1190_length_2147_cov_25.116211	814	894	14	17	80	0.2125000
NODE_1190_length_2147_cov_25.116211	814	894	16	15	80	0.1875000
NODE_1190_length_2147_cov_25.116211	814	894	18	5	80	0.0625000
NODE_1190_length_2147_cov_25.116211	867	947	4	23	80	0.2875000
NODE_1190_length_2147_cov_25.116211	867	947	6	2	80	0.0250000
NODE_1190_length_2147_cov_25.116211	867	947	8	6	80	0.0750000
NODE_1190_length_2147_cov_25.116211	867	947	10	16	80	0.2000000
NODE_1190_length_2147_cov_25.116211	867	947	14	13	80	0.1625000
NODE_1190_length_2147_cov_25.116211	867	947	16	15	80	0.1875000
NODE_1190_length_2147_cov_25.116211	867	947	18	5	80	0.0625000
NODE_1197_length_2136_cov_16.947472	279	359	2	19	80	0.2375000
NODE_1197_length_2136_cov_16.947472	279	359	6	18	80	0.2250000
NODE_1197_length_2136_cov_16.947472	279	359	8	43	80	0.5375000
NODE_1197_length_2136_cov_16.947472	332	412	6	51	80	0.6375000
NODE_1197_length_2136_cov_16.947472	332	412	8	9	80	0.1125000
NODE_1197_length_2136_cov_16.947472	332	412	10	20	80	0.2500000
NODE_1197_length_2136_cov_16.947472	408	488	2	6	80	0.0750000
NODE_1197_length_2136_cov_16.947472	408	488	4	9	80	0.1125000
NODE_1197_length_2136_cov_16.947472	408	488	6	44	80	0.5500000
NODE_1197_length_2136_cov_16.947472	408	488	10	21	80	0.2625000
NODE_1197_length_2136_cov_16.947472	461	541	0	29	80	0.3625000
NODE_1197_length_2136_cov_16.947472	461	541	2	30	80	0.3750000
NODE_1197_length_2136_cov_16.947472	461	541	6	21	80	0.2625000
NODE_1199_length_2133_cov_15.038840	498	578	0	80	80	1.0000000
NODE_1199_length_2133_cov_15.038840	551	631	0	80	80	1.0000000
NODE_1199_length_2133_cov_15.038840	627	707	0	80	80	1.0000000
NODE_1199_length_2133_cov_15.038840	680	722	0	42	42	1.0000000
NODE_1204_length_2128_cov_11.799409	1698	1778	0	80	80	1.0000000
NODE_1204_length_2128_cov_11.799409	1751	1831	0	80	80	1.0000000
NODE_1206_length_2126_cov_6.854465	1614	1694	0	23	80	0.2875000
NODE_1206_length_2126_cov_6.854465	1614	1694	2	57	80	0.7125000
NODE_1206_length_2126_cov_6.854465	1667	1747	0	76	80	0.9500000
NODE_1206_length_2126_cov_6.854465	1667	1747	2	4	80	0.0500000
NODE_1209_length_2123_cov_12.668478	102	143	0	41	41	1.0000000
NODE_1209_length_2123_cov_12.668478	1474	1500	2	26	26	1.0000000
NODE_1209_length_2123_cov_12.668478	1552	1601	8	11	49	0.2244898
NODE_1209_length_2123_cov_12.668478	1552	1601	12	29	49	0.5918368
NODE_1209_length_2123_cov_12.668478	1552	1601	14	3	49	0.0612245
NODE_1209_length_2123_cov_12.668478	1552	1601	15	6	49	0.1224490
NODE_1209_length_2123_cov_12.668478	1574	1654	10	3	80	0.0375000
NODE_1209_length_2123_cov_12.668478	1574	1654	12	18	80	0.2250000
NODE_1209_length_2123_cov_12.668478	1574	1654	14	3	80	0.0375000
NODE_1209_length_2123_cov_12.668478	1574	1654	15	52	80	0.6500000
NODE_1209_length_2123_cov_12.668478	1574	1654	16	4	80	0.0500000
NODE_1211_length_2121_cov_10.101879	497	577	2	10	80	0.1250000
NODE_1211_length_2121_cov_10.101879	497	577	4	4	80	0.0500000
NODE_1211_length_2121_cov_10.101879	497	577	5	60	80	0.7500000
NODE_1211_length_2121_cov_10.101879	497	577	6	6	80	0.0750000
NODE_1211_length_2121_cov_10.101879	550	630	0	24	80	0.3000000
NODE_1211_length_2121_cov_10.101879	550	630	4	25	80	0.3125000
NODE_1211_length_2121_cov_10.101879	550	630	5	21	80	0.2625000
NODE_1211_length_2121_cov_10.101879	550	630	6	10	80	0.1250000
NODE_1211_length_2121_cov_10.101879	1935	2008	0	2	73	0.0273973
NODE_1211_length_2121_cov_10.101879	1935	2008	4	4	73	0.0547945
NODE_1211_length_2121_cov_10.101879	1935	2008	6	9	73	0.1232877
NODE_1211_length_2121_cov_10.101879	1935	2008	8	4	73	0.0547945
NODE_1211_length_2121_cov_10.101879	1935	2008	10	1	73	0.0136986
NODE_1211_length_2121_cov_10.101879	1935	2008	11	25	73	0.3424658
NODE_1211_length_2121_cov_10.101879	1935	2008	13	7	73	0.0958904
NODE_1211_length_2121_cov_10.101879	1935	2008	15	18	73	0.2465753
NODE_1211_length_2121_cov_10.101879	1935	2008	17	3	73	0.0410959
NODE_1212_length_2121_cov_9.964886	1523	1603	0	80	80	1.0000000
NODE_1212_length_2121_cov_9.964886	1576	1656	0	80	80	1.0000000
NODE_1213_length_2120_cov_24.609599	25	92	0	67	67	1.0000000
NODE_1215_length_2119_cov_18.446040	366	446	0	80	80	1.0000000
NODE_1215_length_2119_cov_18.446040	419	499	0	80	80	1.0000000
NODE_1215_length_2119_cov_18.446040	1239	1319	0	37	80	0.4625000
NODE_1215_length_2119_cov_18.446040	1239	1319	2	43	80	0.5375000
NODE_1215_length_2119_cov_18.446040	1292	1372	0	56	80	0.7000000
NODE_1215_length_2119_cov_18.446040	1292	1372	2	24	80	0.3000000
NODE_1225_length_2110_cov_8.668324	1755	1835	0	80	80	1.0000000
NODE_1225_length_2110_cov_8.668324	1808	1888	0	67	80	0.8375000
NODE_1225_length_2110_cov_8.668324	1808	1888	2	13	80	0.1625000
NODE_1227_length_2106_cov_14.643747	1579	1659	0	80	80	1.0000000
NODE_1227_length_2106_cov_14.643747	1632	1712	0	80	80	1.0000000
NODE_1227_length_2106_cov_14.643747	1708	1786	0	78	78	1.0000000
NODE_1227_length_2106_cov_14.643747	1759	1839	0	48	80	0.6000000
NODE_1227_length_2106_cov_14.643747	1759	1839	3	32	80	0.4000000
NODE_1228_length_2106_cov_3.173393	48	96	0	48	48	1.0000000
NODE_1228_length_2106_cov_3.173393	48	96	0	48	48	1.0000000
NODE_1228_length_2106_cov_3.173393	48	96	0	48	48	1.0000000
NODE_1228_length_2106_cov_3.173393	48	96	0	48	48	1.0000000
NODE_1228_length_2106_cov_3.173393	48	96	0	48	48	1.0000000
NODE_1229_length_2102_cov_23.872192	390	470	0	29	80	0.3625000
NODE_1229_length_2102_cov_23.872192	390	470	4	51	80	0.6375000
NODE_1229_length_2102_cov_23.872192	443	523	0	80	80	1.0000000
NODE_1229_length_2102_cov_23.872192	519	599	0	64	80	0.8000000
NODE_1229_length_2102_cov_23.872192	519	599	2	3	80	0.0375000
NODE_1229_length_2102_cov_23.872192	519	599	4	11	80	0.1375000
NODE_1229_length_2102_cov_23.872192	519	599	8	2	80	0.0250000
NODE_1229_length_2102_cov_23.872192	572	652	0	11	80	0.1375000
NODE_1229_length_2102_cov_23.872192	572	652	2	3	80	0.0375000
NODE_1229_length_2102_cov_23.872192	572	652	4	11	80	0.1375000
NODE_1229_length_2102_cov_23.872192	572	652	6	29	80	0.3625000
NODE_1229_length_2102_cov_23.872192	572	652	8	26	80	0.3250000
NODE_1229_length_2102_cov_23.872192	1049	1101	261	1	52	0.0192308
NODE_1229_length_2102_cov_23.872192	1049	1101	262	1	52	0.0192308
NODE_1229_length_2102_cov_23.872192	1049	1101	263	1	52	0.0192308
NODE_1229_length_2102_cov_23.872192	1049	1101	264	1	52	0.0192308
NODE_1229_length_2102_cov_23.872192	1049	1101	266	2	52	0.0384615
NODE_1229_length_2102_cov_23.872192	1049	1101	274	1	52	0.0192308
NODE_1229_length_2102_cov_23.872192	1049	1101	276	1	52	0.0192308
NODE_1229_length_2102_cov_23.872192	1049	1101	277	1	52	0.0192308
NODE_1229_length_2102_cov_23.872192	1049	1101	284	1	52	0.0192308
NODE_1229_length_2102_cov_23.872192	1049	1101	285	1	52	0.0192308
NODE_1229_length_2102_cov_23.872192	1049	1101	286	1	52	0.0192308
NODE_1229_length_2102_cov_23.872192	1049	1101	289	2	52	0.0384615
NODE_1229_length_2102_cov_23.872192	1049	1101	291	1	52	0.0192308
NODE_1229_length_2102_cov_23.872192	1049	1101	299	1	52	0.0192308
NODE_1229_length_2102_cov_23.872192	1049	1101	300	1	52	0.0192308
NODE_1229_length_2102_cov_23.872192	1049	1101	304	1	52	0.0192308
NODE_1229_length_2102_cov_23.872192	1049	1101	305	1	52	0.0192308
NODE_1229_length_2102_cov_23.872192	1049	1101	307	1	52	0.0192308
NODE_1229_length_2102_cov_23.872192	1049	1101	314	2	52	0.0384615
NODE_1229_length_2102_cov_23.872192	1049	1101	322	1	52	0.0192308
NODE_1229_length_2102_cov_23.872192	1049	1101	332	1	52	0.0192308
NODE_1229_length_2102_cov_23.872192	1049	1101	334	1	52	0.0192308
NODE_1229_length_2102_cov_23.872192	1049	1101	338	2	52	0.0384615
NODE_1229_length_2102_cov_23.872192	1049	1101	341	1	52	0.0192308
NODE_1229_length_2102_cov_23.872192	1049	1101	348	1	52	0.0192308
NODE_1229_length_2102_cov_23.872192	1049	1101	350	1	52	0.0192308
NODE_1229_length_2102_cov_23.872192	1049	1101	356	1	52	0.0192308
NODE_1229_length_2102_cov_23.872192	1049	1101	358	2	52	0.0384615
NODE_1229_length_2102_cov_23.872192	1049	1101	359	1	52	0.0192308
NODE_1229_length_2102_cov_23.872192	1049	1101	360	1	52	0.0192308
NODE_1229_length_2102_cov_23.872192	1049	1101	361	1	52	0.0192308
NODE_1229_length_2102_cov_23.872192	1049	1101	362	1	52	0.0192308
NODE_1229_length_2102_cov_23.872192	1049	1101	365	1	52	0.0192308
NODE_1229_length_2102_cov_23.872192	1049	1101	367	2	52	0.0384615
NODE_1229_length_2102_cov_23.872192	1049	1101	368	2	52	0.0384615
NODE_1229_length_2102_cov_23.872192	1049	1101	369	6	52	0.1153846
NODE_1229_length_2102_cov_23.872192	1049	1101	370	2	52	0.0384615
NODE_1229_length_2102_cov_23.872192	1049	1101	371	2	52	0.0384615
NODE_1231_length_2100_cov_21.504248	450	530	0	80	80	1.0000000
NODE_1231_length_2100_cov_21.504248	503	578	0	75	75	1.0000000
NODE_1231_length_2100_cov_21.504248	579	659	0	80	80	1.0000000
NODE_1231_length_2100_cov_21.504248	632	712	0	80	80	1.0000000
NODE_1231_length_2100_cov_21.504248	1420	1500	0	80	80	1.0000000
NODE_1231_length_2100_cov_21.504248	1473	1553	0	80	80	1.0000000
NODE_1232_length_2100_cov_6.399300	1510	1590	0	9	80	0.1125000
NODE_1232_length_2100_cov_6.399300	1510	1590	2	40	80	0.5000000
NODE_1232_length_2100_cov_6.399300	1510	1590	4	31	80	0.3875000
NODE_1232_length_2100_cov_6.399300	1559	1590	4	31	31	1.0000000
NODE_1232_length_2100_cov_6.399300	1563	1644	2	47	81	0.5802469
NODE_1232_length_2100_cov_6.399300	1563	1644	4	34	81	0.4197531
NODE_1232_length_2100_cov_6.399300	1563	1644	2	47	81	0.5802469
NODE_1232_length_2100_cov_6.399300	1563	1644	4	34	81	0.4197531
NODE_1234_length_2099_cov_40.603500	960	1040	4	64	80	0.8000000
NODE_1234_length_2099_cov_40.603500	960	1040	6	16	80	0.2000000
NODE_1234_length_2099_cov_40.603500	1013	1093	4	18	80	0.2250000
NODE_1234_length_2099_cov_40.603500	1013	1093	6	25	80	0.3125000
NODE_1234_length_2099_cov_40.603500	1013	1093	8	37	80	0.4625000
NODE_1234_length_2099_cov_40.603500	1089	1169	4	13	80	0.1625000
NODE_1234_length_2099_cov_40.603500	1089	1169	12	8	80	0.1000000
NODE_1234_length_2099_cov_40.603500	1089	1169	14	37	80	0.4625000
NODE_1234_length_2099_cov_40.603500	1089	1169	16	22	80	0.2750000
NODE_1234_length_2099_cov_40.603500	1142	1222	8	13	80	0.1625000
NODE_1234_length_2099_cov_40.603500	1142	1222	14	5	80	0.0625000
NODE_1234_length_2099_cov_40.603500	1142	1222	16	62	80	0.7750000
NODE_1235_length_2098_cov_62.733867	1042	1122	0	80	80	1.0000000
NODE_1235_length_2098_cov_62.733867	1095	1175	0	80	80	1.0000000
NODE_1235_length_2098_cov_62.733867	1171	1251	0	26	80	0.3250000
NODE_1235_length_2098_cov_62.733867	1171	1251	2	54	80	0.6750000
NODE_1235_length_2098_cov_62.733867	1224	1304	0	6	80	0.0750000
NODE_1235_length_2098_cov_62.733867	1224	1304	2	74	80	0.9250000
NODE_1236_length_2098_cov_20.220110	550	630	0	80	80	1.0000000
NODE_1236_length_2098_cov_20.220110	603	683	0	80	80	1.0000000
NODE_1236_length_2098_cov_20.220110	1571	1651	0	80	80	1.0000000
NODE_1236_length_2098_cov_20.220110	1624	1704	0	80	80	1.0000000
NODE_1237_length_2098_cov_8.261631	324	404	0	80	80	1.0000000
NODE_1239_length_2095_cov_29.930862	1128	1209	98	1	81	0.0123457
NODE_1239_length_2095_cov_29.930862	1128	1209	101	1	81	0.0123457
NODE_1239_length_2095_cov_29.930862	1128	1209	111	1	81	0.0123457
NODE_1239_length_2095_cov_29.930862	1128	1209	117	3	81	0.0370370
NODE_1239_length_2095_cov_29.930862	1128	1209	120	1	81	0.0123457
NODE_1239_length_2095_cov_29.930862	1128	1209	121	1	81	0.0123457
NODE_1239_length_2095_cov_29.930862	1128	1209	127	1	81	0.0123457
NODE_1239_length_2095_cov_29.930862	1128	1209	131	1	81	0.0123457
NODE_1239_length_2095_cov_29.930862	1128	1209	137	1	81	0.0123457
NODE_1239_length_2095_cov_29.930862	1128	1209	142	1	81	0.0123457
NODE_1239_length_2095_cov_29.930862	1128	1209	143	1	81	0.0123457
NODE_1239_length_2095_cov_29.930862	1128	1209	145	1	81	0.0123457
NODE_1239_length_2095_cov_29.930862	1128	1209	151	4	81	0.0493827
NODE_1239_length_2095_cov_29.930862	1128	1209	153	2	81	0.0246914
NODE_1239_length_2095_cov_29.930862	1128	1209	157	1	81	0.0123457
NODE_1239_length_2095_cov_29.930862	1128	1209	162	1	81	0.0123457
NODE_1239_length_2095_cov_29.930862	1128	1209	164	1	81	0.0123457
NODE_1239_length_2095_cov_29.930862	1128	1209	179	2	81	0.0246914
NODE_1239_length_2095_cov_29.930862	1128	1209	189	1	81	0.0123457
NODE_1239_length_2095_cov_29.930862	1128	1209	193	1	81	0.0123457
NODE_1239_length_2095_cov_29.930862	1128	1209	199	1	81	0.0123457
NODE_1239_length_2095_cov_29.930862	1128	1209	205	1	81	0.0123457
NODE_1239_length_2095_cov_29.930862	1128	1209	211	1	81	0.0123457
NODE_1239_length_2095_cov_29.930862	1128	1209	213	3	81	0.0370370
NODE_1239_length_2095_cov_29.930862	1128	1209	224	1	81	0.0123457
NODE_1239_length_2095_cov_29.930862	1128	1209	225	2	81	0.0246914
NODE_1239_length_2095_cov_29.930862	1128	1209	230	1	81	0.0123457
NODE_1239_length_2095_cov_29.930862	1128	1209	238	1	81	0.0123457
NODE_1239_length_2095_cov_29.930862	1128	1209	240	1	81	0.0123457
NODE_1239_length_2095_cov_29.930862	1128	1209	243	1	81	0.0123457
NODE_1239_length_2095_cov_29.930862	1128	1209	250	1	81	0.0123457
NODE_1239_length_2095_cov_29.930862	1128	1209	260	1	81	0.0123457
NODE_1239_length_2095_cov_29.930862	1128	1209	267	1	81	0.0123457
NODE_1239_length_2095_cov_29.930862	1128	1209	271	2	81	0.0246914
NODE_1239_length_2095_cov_29.930862	1128	1209	277	1	81	0.0123457
NODE_1239_length_2095_cov_29.930862	1128	1209	278	1	81	0.0123457
NODE_1239_length_2095_cov_29.930862	1128	1209	284	1	81	0.0123457
NODE_1239_length_2095_cov_29.930862	1128	1209	286	1	81	0.0123457
NODE_1239_length_2095_cov_29.930862	1128	1209	288	1	81	0.0123457
NODE_1239_length_2095_cov_29.930862	1128	1209	289	1	81	0.0123457
NODE_1239_length_2095_cov_29.930862	1128	1209	297	1	81	0.0123457
NODE_1239_length_2095_cov_29.930862	1128	1209	298	4	81	0.0493827
NODE_1239_length_2095_cov_29.930862	1128	1209	299	1	81	0.0123457
NODE_1239_length_2095_cov_29.930862	1128	1209	304	1	81	0.0123457
NODE_1239_length_2095_cov_29.930862	1128	1209	309	1	81	0.0123457
NODE_1239_length_2095_cov_29.930862	1128	1209	325	1	81	0.0123457
NODE_1239_length_2095_cov_29.930862	1128	1209	329	1	81	0.0123457
NODE_1239_length_2095_cov_29.930862	1128	1209	333	1	81	0.0123457
NODE_1239_length_2095_cov_29.930862	1128	1209	335	1	81	0.0123457
NODE_1239_length_2095_cov_29.930862	1128	1209	351	2	81	0.0246914
NODE_1239_length_2095_cov_29.930862	1128	1209	365	1	81	0.0123457
NODE_1239_length_2095_cov_29.930862	1128	1209	375	1	81	0.0123457
NODE_1239_length_2095_cov_29.930862	1128	1209	377	1	81	0.0123457
NODE_1239_length_2095_cov_29.930862	1128	1209	383	1	81	0.0123457
NODE_1239_length_2095_cov_29.930862	1128	1209	387	1	81	0.0123457
NODE_1239_length_2095_cov_29.930862	1128	1209	389	1	81	0.0123457
NODE_1239_length_2095_cov_29.930862	1128	1209	394	1	81	0.0123457
NODE_1239_length_2095_cov_29.930862	1128	1209	396	1	81	0.0123457
NODE_1239_length_2095_cov_29.930862	1128	1209	398	1	81	0.0123457
NODE_1239_length_2095_cov_29.930862	1128	1209	400	1	81	0.0123457
NODE_1239_length_2095_cov_29.930862	1128	1209	401	1	81	0.0123457
NODE_1239_length_2095_cov_29.930862	1128	1209	413	1	81	0.0123457
NODE_1239_length_2095_cov_29.930862	1128	1209	416	1	81	0.0123457
NODE_1239_length_2095_cov_29.930862	1128	1209	417	1	81	0.0123457
NODE_1239_length_2095_cov_29.930862	1128	1209	427	1	81	0.0123457
NODE_1239_length_2095_cov_29.930862	1128	1209	431	1	81	0.0123457
NODE_1239_length_2095_cov_29.930862	1204	1258	413	1	54	0.0185185
NODE_1239_length_2095_cov_29.930862	1204	1258	416	1	54	0.0185185
NODE_1239_length_2095_cov_29.930862	1204	1258	417	1	54	0.0185185
NODE_1239_length_2095_cov_29.930862	1204	1258	427	1	54	0.0185185
NODE_1239_length_2095_cov_29.930862	1204	1258	431	1	54	0.0185185
NODE_1239_length_2095_cov_29.930862	1204	1258	434	1	54	0.0185185
NODE_1239_length_2095_cov_29.930862	1204	1258	436	1	54	0.0185185
NODE_1239_length_2095_cov_29.930862	1204	1258	437	4	54	0.0740741
NODE_1239_length_2095_cov_29.930862	1204	1258	438	1	54	0.0185185
NODE_1239_length_2095_cov_29.930862	1204	1258	439	2	54	0.0370370
NODE_1239_length_2095_cov_29.930862	1204	1258	440	1	54	0.0185185
NODE_1239_length_2095_cov_29.930862	1204	1258	441	3	54	0.0555556
NODE_1239_length_2095_cov_29.930862	1204	1258	442	1	54	0.0185185
NODE_1239_length_2095_cov_29.930862	1204	1258	443	1	54	0.0185185
NODE_1239_length_2095_cov_29.930862	1204	1258	444	3	54	0.0555556
NODE_1239_length_2095_cov_29.930862	1204	1258	445	2	54	0.0370370
NODE_1239_length_2095_cov_29.930862	1204	1258	446	2	54	0.0370370
NODE_1239_length_2095_cov_29.930862	1204	1258	448	2	54	0.0370370
NODE_1239_length_2095_cov_29.930862	1204	1258	450	3	54	0.0555556
NODE_1239_length_2095_cov_29.930862	1204	1258	451	2	54	0.0370370
NODE_1239_length_2095_cov_29.930862	1204	1258	453	4	54	0.0740741
NODE_1239_length_2095_cov_29.930862	1204	1258	454	1	54	0.0185185
NODE_1239_length_2095_cov_29.930862	1204	1258	456	4	54	0.0740741
NODE_1239_length_2095_cov_29.930862	1204	1258	458	4	54	0.0740741
NODE_1239_length_2095_cov_29.930862	1204	1258	460	1	54	0.0185185
NODE_1239_length_2095_cov_29.930862	1204	1258	461	1	54	0.0185185
NODE_1239_length_2095_cov_29.930862	1204	1258	462	3	54	0.0555556
NODE_1239_length_2095_cov_29.930862	1204	1258	465	1	54	0.0185185
NODE_1239_length_2095_cov_29.930862	1204	1258	466	1	54	0.0185185
NODE_1251_length_2084_cov_1.720403	959	1039	4	31	80	0.3875000
NODE_1251_length_2084_cov_1.720403	959	1039	6	31	80	0.3875000
NODE_1251_length_2084_cov_1.720403	959	1039	8	18	80	0.2250000
NODE_1251_length_2084_cov_1.720403	1012	1092	3	7	80	0.0875000
NODE_1251_length_2084_cov_1.720403	1012	1092	4	53	80	0.6625000
NODE_1251_length_2084_cov_1.720403	1012	1092	5	15	80	0.1875000
NODE_1251_length_2084_cov_1.720403	1012	1092	6	5	80	0.0625000
NODE_1252_length_2083_cov_5.864415	419	499	0	80	80	1.0000000
NODE_1252_length_2083_cov_5.864415	472	552	0	80	80	1.0000000
NODE_1252_length_2083_cov_5.864415	548	628	0	80	80	1.0000000
NODE_1252_length_2083_cov_5.864415	601	681	0	80	80	1.0000000
NODE_1256_length_2078_cov_47.394644	311	391	0	12	80	0.1500000
NODE_1256_length_2078_cov_47.394644	311	391	2	68	80	0.8500000
NODE_1256_length_2078_cov_47.394644	364	444	0	53	80	0.6625000
NODE_1256_length_2078_cov_47.394644	364	444	2	17	80	0.2125000
NODE_1256_length_2078_cov_47.394644	364	444	4	10	80	0.1250000
NODE_1256_length_2078_cov_47.394644	440	520	4	55	80	0.6875000
NODE_1256_length_2078_cov_47.394644	440	520	8	25	80	0.3125000
NODE_1256_length_2078_cov_47.394644	493	573	4	2	80	0.0250000
NODE_1256_length_2078_cov_47.394644	493	573	8	35	80	0.4375000
NODE_1256_length_2078_cov_47.394644	493	573	11	2	80	0.0250000
NODE_1256_length_2078_cov_47.394644	493	573	12	41	80	0.5125000
NODE_1267_length_2067_cov_13.647866	1349	1429	0	80	80	1.0000000
NODE_1267_length_2067_cov_13.647866	1402	1482	0	80	80	1.0000000
NODE_1269_length_2066_cov_19.127605	1497	1577	2	5	80	0.0625000
NODE_1269_length_2066_cov_19.127605	1497	1577	3	31	80	0.3875000
NODE_1269_length_2066_cov_19.127605	1497	1577	5	1	80	0.0125000
NODE_1269_length_2066_cov_19.127605	1497	1577	6	43	80	0.5375000
NODE_1269_length_2066_cov_19.127605	1550	1630	2	52	80	0.6500000
NODE_1269_length_2066_cov_19.127605	1550	1630	4	6	80	0.0750000
NODE_1269_length_2066_cov_19.127605	1550	1630	6	22	80	0.2750000
NODE_1274_length_2061_cov_43.187054	364	444	0	80	80	1.0000000
NODE_1274_length_2061_cov_43.187054	417	497	0	80	80	1.0000000
NODE_1275_length_2061_cov_3.251784	981	1033	0	52	52	1.0000000
NODE_1275_length_2061_cov_3.251784	1006	1086	0	80	80	1.0000000
NODE_1277_length_2058_cov_4.531394	1844	1875	0	4	31	0.1290323
NODE_1277_length_2058_cov_4.531394	1844	1875	4	23	31	0.7419355
NODE_1277_length_2058_cov_4.531394	1844	1875	8	4	31	0.1290323
NODE_1277_length_2058_cov_4.531394	1848	1928	4	23	80	0.2875000
NODE_1277_length_2058_cov_4.531394	1848	1928	8	21	80	0.2625000
NODE_1277_length_2058_cov_4.531394	1848	1928	12	2	80	0.0250000
NODE_1277_length_2058_cov_4.531394	1848	1928	14	34	80	0.4250000
NODE_1279_length_2056_cov_20.525805	749	829	0	80	80	1.0000000
NODE_1279_length_2056_cov_20.525805	802	882	0	80	80	1.0000000
NODE_1279_length_2056_cov_20.525805	878	958	0	80	80	1.0000000
NODE_1279_length_2056_cov_20.525805	931	1011	0	80	80	1.0000000
NODE_1281_length_2055_cov_10.047546	1468	1548	0	80	80	1.0000000
NODE_1281_length_2055_cov_10.047546	1521	1601	0	80	80	1.0000000
NODE_1286_length_2049_cov_6.846154	270	350	0	80	80	1.0000000
NODE_1286_length_2049_cov_6.846154	323	403	0	80	80	1.0000000
NODE_1286_length_2049_cov_6.846154	1595	1674	0	79	79	1.0000000
NODE_1286_length_2049_cov_6.846154	1648	1712	0	64	64	1.0000000
NODE_1293_length_2045_cov_46.790339	876	956	10	22	80	0.2750000
NODE_1293_length_2045_cov_46.790339	876	956	12	1	80	0.0125000
NODE_1293_length_2045_cov_46.790339	876	956	14	10	80	0.1250000
NODE_1293_length_2045_cov_46.790339	876	956	16	6	80	0.0750000
NODE_1293_length_2045_cov_46.790339	876	956	17	9	80	0.1125000
NODE_1293_length_2045_cov_46.790339	876	956	18	14	80	0.1750000
NODE_1293_length_2045_cov_46.790339	876	956	19	18	80	0.2250000
NODE_1293_length_2045_cov_46.790339	929	1009	17	16	80	0.2000000
NODE_1293_length_2045_cov_46.790339	929	1009	19	18	80	0.2250000
NODE_1293_length_2045_cov_46.790339	929	1009	21	2	80	0.0250000
NODE_1293_length_2045_cov_46.790339	929	1009	22	27	80	0.3375000
NODE_1293_length_2045_cov_46.790339	929	1009	24	15	80	0.1875000
NODE_1293_length_2045_cov_46.790339	929	1009	32	2	80	0.0250000
NODE_1293_length_2045_cov_46.790339	1005	1085	12	3	80	0.0375000
NODE_1293_length_2045_cov_46.790339	1005	1085	14	3	80	0.0375000
NODE_1293_length_2045_cov_46.790339	1005	1085	16	11	80	0.1375000
NODE_1293_length_2045_cov_46.790339	1005	1085	20	1	80	0.0125000
NODE_1293_length_2045_cov_46.790339	1005	1085	22	2	80	0.0250000
NODE_1293_length_2045_cov_46.790339	1005	1085	24	1	80	0.0125000
NODE_1293_length_2045_cov_46.790339	1005	1085	25	1	80	0.0125000
NODE_1293_length_2045_cov_46.790339	1005	1085	26	1	80	0.0125000
NODE_1293_length_2045_cov_46.790339	1005	1085	30	25	80	0.3125000
NODE_1293_length_2045_cov_46.790339	1005	1085	32	22	80	0.2750000
NODE_1293_length_2045_cov_46.790339	1005	1085	34	10	80	0.1250000
NODE_1293_length_2045_cov_46.790339	1058	1138	0	11	80	0.1375000
NODE_1293_length_2045_cov_46.790339	1058	1138	2	8	80	0.1000000
NODE_1293_length_2045_cov_46.790339	1058	1138	12	37	80	0.4625000
NODE_1293_length_2045_cov_46.790339	1058	1138	14	3	80	0.0375000
NODE_1293_length_2045_cov_46.790339	1058	1138	16	11	80	0.1375000
NODE_1293_length_2045_cov_46.790339	1058	1138	20	1	80	0.0125000
NODE_1293_length_2045_cov_46.790339	1058	1138	22	1	80	0.0125000
NODE_1293_length_2045_cov_46.790339	1058	1138	25	1	80	0.0125000
NODE_1293_length_2045_cov_46.790339	1058	1138	26	1	80	0.0125000
NODE_1293_length_2045_cov_46.790339	1058	1138	30	6	80	0.0750000
NODE_1298_length_2042_cov_4.447761	241	315	1	4	74	0.0540541
NODE_1298_length_2042_cov_4.447761	241	315	2	29	74	0.3918919
NODE_1298_length_2042_cov_4.447761	241	315	4	41	74	0.5540541
NODE_1301_length_2040_cov_30.109737	1760	1844	349	1	84	0.0119048
NODE_1301_length_2040_cov_30.109737	1760	1844	354	1	84	0.0119048
NODE_1301_length_2040_cov_30.109737	1760	1844	358	2	84	0.0238095
NODE_1301_length_2040_cov_30.109737	1760	1844	361	1	84	0.0119048
NODE_1301_length_2040_cov_30.109737	1760	1844	365	1	84	0.0119048
NODE_1301_length_2040_cov_30.109737	1760	1844	369	1	84	0.0119048
NODE_1301_length_2040_cov_30.109737	1760	1844	375	1	84	0.0119048
NODE_1301_length_2040_cov_30.109737	1760	1844	382	1	84	0.0119048
NODE_1301_length_2040_cov_30.109737	1760	1844	384	3	84	0.0357143
NODE_1301_length_2040_cov_30.109737	1760	1844	386	2	84	0.0238095
NODE_1301_length_2040_cov_30.109737	1760	1844	387	1	84	0.0119048
NODE_1301_length_2040_cov_30.109737	1760	1844	388	2	84	0.0238095
NODE_1301_length_2040_cov_30.109737	1760	1844	389	1	84	0.0119048
NODE_1301_length_2040_cov_30.109737	1760	1844	390	3	84	0.0357143
NODE_1301_length_2040_cov_30.109737	1760	1844	391	3	84	0.0357143
NODE_1301_length_2040_cov_30.109737	1760	1844	392	5	84	0.0595238
NODE_1301_length_2040_cov_30.109737	1760	1844	393	1	84	0.0119048
NODE_1301_length_2040_cov_30.109737	1760	1844	394	3	84	0.0357143
NODE_1301_length_2040_cov_30.109737	1760	1844	395	3	84	0.0357143
NODE_1301_length_2040_cov_30.109737	1760	1844	396	2	84	0.0238095
NODE_1301_length_2040_cov_30.109737	1760	1844	397	4	84	0.0476190
NODE_1301_length_2040_cov_30.109737	1760	1844	399	1	84	0.0119048
NODE_1301_length_2040_cov_30.109737	1760	1844	400	1	84	0.0119048
NODE_1301_length_2040_cov_30.109737	1760	1844	401	2	84	0.0238095
NODE_1301_length_2040_cov_30.109737	1760	1844	402	3	84	0.0357143
NODE_1301_length_2040_cov_30.109737	1760	1844	403	1	84	0.0119048
NODE_1301_length_2040_cov_30.109737	1760	1844	405	1	84	0.0119048
NODE_1301_length_2040_cov_30.109737	1760	1844	406	2	84	0.0238095
NODE_1301_length_2040_cov_30.109737	1760	1844	408	1	84	0.0119048
NODE_1301_length_2040_cov_30.109737	1760	1844	409	3	84	0.0357143
NODE_1301_length_2040_cov_30.109737	1760	1844	410	3	84	0.0357143
NODE_1301_length_2040_cov_30.109737	1760	1844	412	2	84	0.0238095
NODE_1301_length_2040_cov_30.109737	1760	1844	413	3	84	0.0357143
NODE_1301_length_2040_cov_30.109737	1760	1844	414	1	84	0.0119048
NODE_1301_length_2040_cov_30.109737	1760	1844	416	2	84	0.0238095
NODE_1301_length_2040_cov_30.109737	1760	1844	417	1	84	0.0119048
NODE_1301_length_2040_cov_30.109737	1760	1844	419	1	84	0.0119048
NODE_1301_length_2040_cov_30.109737	1760	1844	420	3	84	0.0357143
NODE_1301_length_2040_cov_30.109737	1760	1844	422	1	84	0.0119048
NODE_1301_length_2040_cov_30.109737	1760	1844	423	4	84	0.0476190
NODE_1301_length_2040_cov_30.109737	1760	1844	425	2	84	0.0238095
NODE_1301_length_2040_cov_30.109737	1760	1844	426	1	84	0.0119048
NODE_1301_length_2040_cov_30.109737	1760	1844	427	1	84	0.0119048
NODE_1301_length_2040_cov_30.109737	1760	1844	429	1	84	0.0119048
NODE_1301_length_2040_cov_30.109737	1760	1844	431	1	84	0.0119048
NODE_1306_length_2036_cov_11.672173	369	449	0	80	80	1.0000000
NODE_1306_length_2036_cov_11.672173	422	502	0	80	80	1.0000000
NODE_1312_length_2032_cov_11.188308	416	496	0	37	80	0.4625000
NODE_1312_length_2032_cov_11.188308	416	496	2	43	80	0.5375000
NODE_1312_length_2032_cov_11.188308	469	549	0	30	80	0.3750000
NODE_1312_length_2032_cov_11.188308	469	549	2	50	80	0.6250000
NODE_1318_length_2027_cov_43.702282	1129	1209	0	80	80	1.0000000
NODE_1318_length_2027_cov_43.702282	1182	1262	0	80	80	1.0000000
NODE_1318_length_2027_cov_43.702282	1258	1338	0	80	80	1.0000000
NODE_1318_length_2027_cov_43.702282	1311	1391	0	29	80	0.3625000
NODE_1318_length_2027_cov_43.702282	1311	1391	2	51	80	0.6375000
NODE_1319_length_2027_cov_6.558610	229	303	0	74	74	1.0000000
NODE_1319_length_2027_cov_6.558610	229	303	0	74	74	1.0000000
NODE_1319_length_2027_cov_6.558610	276	356	0	80	80	1.0000000
NODE_1320_length_2026_cov_18.457706	688	768	2	43	80	0.5375000
NODE_1320_length_2026_cov_18.457706	688	768	4	37	80	0.4625000
NODE_1320_length_2026_cov_18.457706	741	821	0	19	80	0.2375000
NODE_1320_length_2026_cov_18.457706	741	821	2	55	80	0.6875000
NODE_1320_length_2026_cov_18.457706	741	821	4	6	80	0.0750000
NODE_1324_length_2025_cov_10.711319	617	697	4	47	80	0.5875000
NODE_1324_length_2025_cov_10.711319	617	697	6	17	80	0.2125000
NODE_1324_length_2025_cov_10.711319	617	697	8	3	80	0.0375000
NODE_1324_length_2025_cov_10.711319	617	697	10	2	80	0.0250000
NODE_1324_length_2025_cov_10.711319	617	697	12	5	80	0.0625000
NODE_1324_length_2025_cov_10.711319	617	697	14	6	80	0.0750000
NODE_1324_length_2025_cov_10.711319	712	783	4	3	71	0.0422535
NODE_1324_length_2025_cov_10.711319	712	783	5	2	71	0.0281690
NODE_1324_length_2025_cov_10.711319	712	783	6	20	71	0.2816902
NODE_1324_length_2025_cov_10.711319	712	783	9	7	71	0.0985916
NODE_1324_length_2025_cov_10.711319	712	783	13	2	71	0.0281690
NODE_1324_length_2025_cov_10.711319	712	783	16	10	71	0.1408451
NODE_1324_length_2025_cov_10.711319	712	783	18	27	71	0.3802817
NODE_1324_length_2025_cov_10.711319	756	829	14	2	73	0.0273973
NODE_1324_length_2025_cov_10.711319	756	829	15	1	73	0.0136986
NODE_1324_length_2025_cov_10.711319	756	829	16	21	73	0.2876712
NODE_1324_length_2025_cov_10.711319	756	829	18	49	73	0.6712329
NODE_1325_length_2024_cov_33.891948	1045	1125	0	25	80	0.3125000
NODE_1325_length_2024_cov_33.891948	1045	1125	2	16	80	0.2000000
NODE_1325_length_2024_cov_33.891948	1045	1125	6	39	80	0.4875000
NODE_1325_length_2024_cov_33.891948	1098	1178	0	4	80	0.0500000
NODE_1325_length_2024_cov_33.891948	1098	1178	4	25	80	0.3125000
NODE_1325_length_2024_cov_33.891948	1098	1178	6	51	80	0.6375000
NODE_1331_length_2018_cov_33.742053	1215	1295	170	1	80	0.0125000
NODE_1331_length_2018_cov_33.742053	1215	1295	173	1	80	0.0125000
NODE_1331_length_2018_cov_33.742053	1215	1295	175	1	80	0.0125000
NODE_1331_length_2018_cov_33.742053	1215	1295	176	1	80	0.0125000
NODE_1331_length_2018_cov_33.742053	1215	1295	180	1	80	0.0125000
NODE_1331_length_2018_cov_33.742053	1215	1295	182	1	80	0.0125000
NODE_1331_length_2018_cov_33.742053	1215	1295	183	1	80	0.0125000
NODE_1331_length_2018_cov_33.742053	1215	1295	191	1	80	0.0125000
NODE_1331_length_2018_cov_33.742053	1215	1295	192	1	80	0.0125000
NODE_1331_length_2018_cov_33.742053	1215	1295	193	1	80	0.0125000
NODE_1331_length_2018_cov_33.742053	1215	1295	203	1	80	0.0125000
NODE_1331_length_2018_cov_33.742053	1215	1295	205	1	80	0.0125000
NODE_1331_length_2018_cov_33.742053	1215	1295	207	2	80	0.0250000
NODE_1331_length_2018_cov_33.742053	1215	1295	208	1	80	0.0125000
NODE_1331_length_2018_cov_33.742053	1215	1295	209	2	80	0.0250000
NODE_1331_length_2018_cov_33.742053	1215	1295	210	1	80	0.0125000
NODE_1331_length_2018_cov_33.742053	1215	1295	211	4	80	0.0500000
NODE_1331_length_2018_cov_33.742053	1215	1295	212	1	80	0.0125000
NODE_1331_length_2018_cov_33.742053	1215	1295	213	1	80	0.0125000
NODE_1331_length_2018_cov_33.742053	1215	1295	214	1	80	0.0125000
NODE_1331_length_2018_cov_33.742053	1215	1295	216	3	80	0.0375000
NODE_1331_length_2018_cov_33.742053	1215	1295	229	1	80	0.0125000
NODE_1331_length_2018_cov_33.742053	1215	1295	230	2	80	0.0250000
NODE_1331_length_2018_cov_33.742053	1215	1295	231	1	80	0.0125000
NODE_1331_length_2018_cov_33.742053	1215	1295	232	3	80	0.0375000
NODE_1331_length_2018_cov_33.742053	1215	1295	236	1	80	0.0125000
NODE_1331_length_2018_cov_33.742053	1215	1295	238	3	80	0.0375000
NODE_1331_length_2018_cov_33.742053	1215	1295	240	1	80	0.0125000
NODE_1331_length_2018_cov_33.742053	1215	1295	244	2	80	0.0250000
NODE_1331_length_2018_cov_33.742053	1215	1295	248	2	80	0.0250000
NODE_1331_length_2018_cov_33.742053	1215	1295	249	1	80	0.0125000
NODE_1331_length_2018_cov_33.742053	1215	1295	250	1	80	0.0125000
NODE_1331_length_2018_cov_33.742053	1215	1295	251	4	80	0.0500000
NODE_1331_length_2018_cov_33.742053	1215	1295	252	3	80	0.0375000
NODE_1331_length_2018_cov_33.742053	1215	1295	256	1	80	0.0125000
NODE_1331_length_2018_cov_33.742053	1215	1295	257	2	80	0.0250000
NODE_1331_length_2018_cov_33.742053	1215	1295	261	1	80	0.0125000
NODE_1331_length_2018_cov_33.742053	1215	1295	262	3	80	0.0375000
NODE_1331_length_2018_cov_33.742053	1215	1295	263	1	80	0.0125000
NODE_1331_length_2018_cov_33.742053	1215	1295	264	1	80	0.0125000
NODE_1331_length_2018_cov_33.742053	1215	1295	265	2	80	0.0250000
NODE_1331_length_2018_cov_33.742053	1215	1295	266	3	80	0.0375000
NODE_1331_length_2018_cov_33.742053	1215	1295	267	3	80	0.0375000
NODE_1331_length_2018_cov_33.742053	1215	1295	268	4	80	0.0500000
NODE_1331_length_2018_cov_33.742053	1215	1295	269	3	80	0.0375000
NODE_1331_length_2018_cov_33.742053	1215	1295	270	1	80	0.0125000
NODE_1331_length_2018_cov_33.742053	1215	1295	271	1	80	0.0125000
NODE_1331_length_2018_cov_33.742053	1215	1295	277	1	80	0.0125000
NODE_1331_length_2018_cov_33.742053	1268	1298	256	1	30	0.0333333
NODE_1331_length_2018_cov_33.742053	1268	1298	257	2	30	0.0666667
NODE_1331_length_2018_cov_33.742053	1268	1298	261	1	30	0.0333333
NODE_1331_length_2018_cov_33.742053	1268	1298	262	3	30	0.1000000
NODE_1331_length_2018_cov_33.742053	1268	1298	263	1	30	0.0333333
NODE_1331_length_2018_cov_33.742053	1268	1298	264	1	30	0.0333333
NODE_1331_length_2018_cov_33.742053	1268	1298	265	2	30	0.0666667
NODE_1331_length_2018_cov_33.742053	1268	1298	266	3	30	0.1000000
NODE_1331_length_2018_cov_33.742053	1268	1298	267	3	30	0.1000000
NODE_1331_length_2018_cov_33.742053	1268	1298	268	4	30	0.1333333
NODE_1331_length_2018_cov_33.742053	1268	1298	269	6	30	0.2000000
NODE_1331_length_2018_cov_33.742053	1268	1298	270	1	30	0.0333333
NODE_1331_length_2018_cov_33.742053	1268	1298	271	1	30	0.0333333
NODE_1331_length_2018_cov_33.742053	1268	1298	277	1	30	0.0333333
NODE_1331_length_2018_cov_33.742053	1876	1942	65	4	66	0.0606061
NODE_1331_length_2018_cov_33.742053	1876	1942	70	3	66	0.0454545
NODE_1331_length_2018_cov_33.742053	1876	1942	71	2	66	0.0303030
NODE_1331_length_2018_cov_33.742053	1876	1942	75	1	66	0.0151515
NODE_1331_length_2018_cov_33.742053	1876	1942	78	1	66	0.0151515
NODE_1331_length_2018_cov_33.742053	1876	1942	82	2	66	0.0303030
NODE_1331_length_2018_cov_33.742053	1876	1942	83	1	66	0.0151515
NODE_1331_length_2018_cov_33.742053	1876	1942	85	1	66	0.0151515
NODE_1331_length_2018_cov_33.742053	1876	1942	97	1	66	0.0151515
NODE_1331_length_2018_cov_33.742053	1876	1942	100	4	66	0.0606061
NODE_1331_length_2018_cov_33.742053	1876	1942	102	1	66	0.0151515
NODE_1331_length_2018_cov_33.742053	1876	1942	103	2	66	0.0303030
NODE_1331_length_2018_cov_33.742053	1876	1942	110	1	66	0.0151515
NODE_1331_length_2018_cov_33.742053	1876	1942	111	3	66	0.0454545
NODE_1331_length_2018_cov_33.742053	1876	1942	115	2	66	0.0303030
NODE_1331_length_2018_cov_33.742053	1876	1942	119	1	66	0.0151515
NODE_1331_length_2018_cov_33.742053	1876	1942	125	1	66	0.0151515
NODE_1331_length_2018_cov_33.742053	1876	1942	130	1	66	0.0151515
NODE_1331_length_2018_cov_33.742053	1876	1942	131	3	66	0.0454545
NODE_1331_length_2018_cov_33.742053	1876	1942	136	1	66	0.0151515
NODE_1331_length_2018_cov_33.742053	1876	1942	158	2	66	0.0303030
NODE_1331_length_2018_cov_33.742053	1876	1942	168	1	66	0.0151515
NODE_1331_length_2018_cov_33.742053	1876	1942	170	1	66	0.0151515
NODE_1331_length_2018_cov_33.742053	1876	1942	176	1	66	0.0151515
NODE_1331_length_2018_cov_33.742053	1876	1942	184	1	66	0.0151515
NODE_1331_length_2018_cov_33.742053	1876	1942	188	1	66	0.0151515
NODE_1331_length_2018_cov_33.742053	1876	1942	193	2	66	0.0303030
NODE_1331_length_2018_cov_33.742053	1876	1942	202	1	66	0.0151515
NODE_1331_length_2018_cov_33.742053	1876	1942	205	1	66	0.0151515
NODE_1331_length_2018_cov_33.742053	1876	1942	212	1	66	0.0151515
NODE_1331_length_2018_cov_33.742053	1876	1942	213	2	66	0.0303030
NODE_1331_length_2018_cov_33.742053	1876	1942	222	1	66	0.0151515
NODE_1331_length_2018_cov_33.742053	1876	1942	225	1	66	0.0151515
NODE_1331_length_2018_cov_33.742053	1876	1942	227	4	66	0.0606061
NODE_1331_length_2018_cov_33.742053	1876	1942	230	2	66	0.0303030
NODE_1331_length_2018_cov_33.742053	1876	1942	231	2	66	0.0303030
NODE_1331_length_2018_cov_33.742053	1876	1942	232	1	66	0.0151515
NODE_1331_length_2018_cov_33.742053	1876	1942	234	1	66	0.0151515
NODE_1331_length_2018_cov_33.742053	1876	1942	238	1	66	0.0151515
NODE_1331_length_2018_cov_33.742053	1876	1942	243	1	66	0.0151515
NODE_1331_length_2018_cov_33.742053	1876	1942	245	1	66	0.0151515
NODE_1331_length_2018_cov_33.742053	1876	1942	256	1	66	0.0151515
NODE_1331_length_2018_cov_33.742053	1915	1995	2	2	80	0.0250000
NODE_1331_length_2018_cov_33.742053	1915	1995	4	1	80	0.0125000
NODE_1331_length_2018_cov_33.742053	1915	1995	8	1	80	0.0125000
NODE_1331_length_2018_cov_33.742053	1915	1995	10	1	80	0.0125000
NODE_1331_length_2018_cov_33.742053	1915	1995	12	1	80	0.0125000
NODE_1331_length_2018_cov_33.742053	1915	1995	14	9	80	0.1125000
NODE_1331_length_2018_cov_33.742053	1915	1995	15	6	80	0.0750000
NODE_1331_length_2018_cov_33.742053	1915	1995	16	3	80	0.0375000
NODE_1331_length_2018_cov_33.742053	1915	1995	17	2	80	0.0250000
NODE_1331_length_2018_cov_33.742053	1915	1995	21	3	80	0.0375000
NODE_1331_length_2018_cov_33.742053	1915	1995	23	1	80	0.0125000
NODE_1331_length_2018_cov_33.742053	1915	1995	25	1	80	0.0125000
NODE_1331_length_2018_cov_33.742053	1915	1995	30	1	80	0.0125000
NODE_1331_length_2018_cov_33.742053	1915	1995	37	4	80	0.0500000
NODE_1331_length_2018_cov_33.742053	1915	1995	44	1	80	0.0125000
NODE_1331_length_2018_cov_33.742053	1915	1995	50	1	80	0.0125000
NODE_1331_length_2018_cov_33.742053	1915	1995	54	1	80	0.0125000
NODE_1331_length_2018_cov_33.742053	1915	1995	57	5	80	0.0625000
NODE_1331_length_2018_cov_33.742053	1915	1995	59	1	80	0.0125000
NODE_1331_length_2018_cov_33.742053	1915	1995	61	2	80	0.0250000
NODE_1331_length_2018_cov_33.742053	1915	1995	63	5	80	0.0625000
NODE_1331_length_2018_cov_33.742053	1915	1995	65	5	80	0.0625000
NODE_1331_length_2018_cov_33.742053	1915	1995	70	3	80	0.0375000
NODE_1331_length_2018_cov_33.742053	1915	1995	71	2	80	0.0250000
NODE_1331_length_2018_cov_33.742053	1915	1995	75	1	80	0.0125000
NODE_1331_length_2018_cov_33.742053	1915	1995	78	1	80	0.0125000
NODE_1331_length_2018_cov_33.742053	1915	1995	82	2	80	0.0250000
NODE_1331_length_2018_cov_33.742053	1915	1995	83	1	80	0.0125000
NODE_1331_length_2018_cov_33.742053	1915	1995	85	1	80	0.0125000
NODE_1331_length_2018_cov_33.742053	1915	1995	97	1	80	0.0125000
NODE_1331_length_2018_cov_33.742053	1915	1995	100	4	80	0.0500000
NODE_1331_length_2018_cov_33.742053	1915	1995	102	1	80	0.0125000
NODE_1331_length_2018_cov_33.742053	1915	1995	103	2	80	0.0250000
NODE_1331_length_2018_cov_33.742053	1915	1995	110	1	80	0.0125000
NODE_1331_length_2018_cov_33.742053	1915	1995	111	3	80	0.0375000
NODE_1337_length_2011_cov_22.430439	434	514	2	19	80	0.2375000
NODE_1337_length_2011_cov_22.430439	434	514	3	5	80	0.0625000
NODE_1337_length_2011_cov_22.430439	434	514	4	56	80	0.7000000
NODE_1337_length_2011_cov_22.430439	487	567	2	68	80	0.8500000
NODE_1337_length_2011_cov_22.430439	487	567	4	12	80	0.1500000
NODE_1337_length_2011_cov_22.430439	1124	1204	0	20	80	0.2500000
NODE_1337_length_2011_cov_22.430439	1124	1204	2	16	80	0.2000000
NODE_1337_length_2011_cov_22.430439	1124	1204	4	44	80	0.5500000
NODE_1337_length_2011_cov_22.430439	1177	1257	0	11	80	0.1375000
NODE_1337_length_2011_cov_22.430439	1177	1257	2	28	80	0.3500000
NODE_1337_length_2011_cov_22.430439	1177	1257	4	41	80	0.5125000
NODE_1343_length_2001_cov_10.416404	692	772	0	80	80	1.0000000
NODE_1343_length_2001_cov_10.416404	745	825	0	80	80	1.0000000
NODE_1350_length_1991_cov_112.926533	212	292	229	1	80	0.0125000
NODE_1350_length_1991_cov_112.926533	212	292	239	1	80	0.0125000
NODE_1350_length_1991_cov_112.926533	212	292	243	2	80	0.0250000
NODE_1350_length_1991_cov_112.926533	212	292	246	1	80	0.0125000
NODE_1350_length_1991_cov_112.926533	212	292	248	1	80	0.0125000
NODE_1350_length_1991_cov_112.926533	212	292	252	4	80	0.0500000
NODE_1350_length_1991_cov_112.926533	212	292	256	1	80	0.0125000
NODE_1350_length_1991_cov_112.926533	212	292	258	1	80	0.0125000
NODE_1350_length_1991_cov_112.926533	212	292	277	1	80	0.0125000
NODE_1350_length_1991_cov_112.926533	212	292	283	1	80	0.0125000
NODE_1350_length_1991_cov_112.926533	212	292	285	3	80	0.0375000
NODE_1350_length_1991_cov_112.926533	212	292	286	1	80	0.0125000
NODE_1350_length_1991_cov_112.926533	212	292	288	1	80	0.0125000
NODE_1350_length_1991_cov_112.926533	212	292	289	1	80	0.0125000
NODE_1350_length_1991_cov_112.926533	212	292	290	2	80	0.0250000
NODE_1350_length_1991_cov_112.926533	212	292	294	3	80	0.0375000
NODE_1350_length_1991_cov_112.926533	212	292	295	2	80	0.0250000
NODE_1350_length_1991_cov_112.926533	212	292	299	1	80	0.0125000
NODE_1350_length_1991_cov_112.926533	212	292	303	1	80	0.0125000
NODE_1350_length_1991_cov_112.926533	212	292	307	2	80	0.0250000
NODE_1350_length_1991_cov_112.926533	212	292	311	3	80	0.0375000
NODE_1350_length_1991_cov_112.926533	212	292	314	3	80	0.0375000
NODE_1350_length_1991_cov_112.926533	212	292	315	6	80	0.0750000
NODE_1350_length_1991_cov_112.926533	212	292	316	1	80	0.0125000
NODE_1350_length_1991_cov_112.926533	212	292	317	4	80	0.0500000
NODE_1350_length_1991_cov_112.926533	212	292	318	1	80	0.0125000
NODE_1350_length_1991_cov_112.926533	212	292	319	1	80	0.0125000
NODE_1350_length_1991_cov_112.926533	212	292	322	1	80	0.0125000
NODE_1350_length_1991_cov_112.926533	212	292	323	5	80	0.0625000
NODE_1350_length_1991_cov_112.926533	212	292	327	2	80	0.0250000
NODE_1350_length_1991_cov_112.926533	212	292	329	10	80	0.1250000
NODE_1350_length_1991_cov_112.926533	212	292	331	2	80	0.0250000
NODE_1350_length_1991_cov_112.926533	212	292	332	5	80	0.0625000
NODE_1350_length_1991_cov_112.926533	212	292	333	5	80	0.0625000
NODE_1352_length_1988_cov_13.736368	865	945	0	12	80	0.1500000
NODE_1352_length_1988_cov_13.736368	865	945	2	3	80	0.0375000
NODE_1352_length_1988_cov_13.736368	865	945	4	25	80	0.3125000
NODE_1352_length_1988_cov_13.736368	865	945	6	40	80	0.5000000
NODE_1352_length_1988_cov_13.736368	918	998	2	11	80	0.1375000
NODE_1352_length_1988_cov_13.736368	918	998	4	4	80	0.0500000
NODE_1352_length_1988_cov_13.736368	918	998	6	51	80	0.6375000
NODE_1352_length_1988_cov_13.736368	918	998	8	14	80	0.1750000
NODE_1353_length_1988_cov_9.980413	1616	1696	0	80	80	1.0000000
NODE_1353_length_1988_cov_9.980413	1669	1749	0	80	80	1.0000000
NODE_1356_length_1983_cov_17.332803	494	574	0	36	80	0.4500000
NODE_1356_length_1983_cov_17.332803	494	574	4	44	80	0.5500000
NODE_1356_length_1983_cov_17.332803	547	627	4	80	80	1.0000000
NODE_1356_length_1983_cov_17.332803	1600	1680	0	16	80	0.2000000
NODE_1356_length_1983_cov_17.332803	1600	1680	4	64	80	0.8000000
NODE_1356_length_1983_cov_17.332803	1653	1733	2	19	80	0.2375000
NODE_1356_length_1983_cov_17.332803	1653	1733	4	48	80	0.6000000
NODE_1356_length_1983_cov_17.332803	1653	1733	6	13	80	0.1625000
NODE_1359_length_1982_cov_17.164100	457	537	0	80	80	1.0000000
NODE_1359_length_1982_cov_17.164100	510	590	0	80	80	1.0000000
NODE_1359_length_1982_cov_17.164100	586	666	0	80	80	1.0000000
NODE_1359_length_1982_cov_17.164100	639	723	0	84	84	1.0000000
NODE_1360_length_1981_cov_46.444208	0	70	0	70	70	1.0000000
NODE_1362_length_1979_cov_1.630851	1554	1634	0	80	80	1.0000000
NODE_1364_length_1976_cov_1.959510	154	215	6	2	61	0.0327869
NODE_1364_length_1976_cov_1.959510	154	215	10	17	61	0.2786885
NODE_1364_length_1976_cov_1.959510	154	215	11	24	61	0.3934426
NODE_1364_length_1976_cov_1.959510	154	215	12	18	61	0.2950820
NODE_1364_length_1976_cov_1.959510	154	215	6	2	61	0.0327869
NODE_1364_length_1976_cov_1.959510	154	215	10	17	61	0.2786885
NODE_1364_length_1976_cov_1.959510	154	215	11	24	61	0.3934426
NODE_1364_length_1976_cov_1.959510	154	215	12	18	61	0.2950820
NODE_1364_length_1976_cov_1.959510	154	213	6	2	59	0.0338983
NODE_1364_length_1976_cov_1.959510	154	213	10	17	59	0.2881356
NODE_1364_length_1976_cov_1.959510	154	213	11	24	59	0.4067796
NODE_1364_length_1976_cov_1.959510	154	213	12	16	59	0.2711864
NODE_1365_length_1974_cov_8.058133	617	697	57	3	80	0.0375000
NODE_1365_length_1974_cov_8.058133	617	697	58	4	80	0.0500000
NODE_1365_length_1974_cov_8.058133	617	697	61	3	80	0.0375000
NODE_1365_length_1974_cov_8.058133	617	697	63	11	80	0.1375000
NODE_1365_length_1974_cov_8.058133	617	697	65	6	80	0.0750000
NODE_1365_length_1974_cov_8.058133	617	697	68	3	80	0.0375000
NODE_1365_length_1974_cov_8.058133	617	697	69	3	80	0.0375000
NODE_1365_length_1974_cov_8.058133	617	697	70	11	80	0.1375000
NODE_1365_length_1974_cov_8.058133	617	697	72	5	80	0.0625000
NODE_1365_length_1974_cov_8.058133	617	697	74	10	80	0.1250000
NODE_1365_length_1974_cov_8.058133	617	697	75	1	80	0.0125000
NODE_1365_length_1974_cov_8.058133	617	697	76	6	80	0.0750000
NODE_1365_length_1974_cov_8.058133	617	697	77	2	80	0.0250000
NODE_1365_length_1974_cov_8.058133	617	697	78	12	80	0.1500000
NODE_1365_length_1974_cov_8.058133	670	750	10	7	80	0.0875000
NODE_1365_length_1974_cov_8.058133	670	750	12	1	80	0.0125000
NODE_1365_length_1974_cov_8.058133	670	750	14	1	80	0.0125000
NODE_1365_length_1974_cov_8.058133	670	750	16	1	80	0.0125000
NODE_1365_length_1974_cov_8.058133	670	750	18	2	80	0.0250000
NODE_1365_length_1974_cov_8.058133	670	750	20	4	80	0.0500000
NODE_1365_length_1974_cov_8.058133	670	750	23	2	80	0.0250000
NODE_1365_length_1974_cov_8.058133	670	750	25	5	80	0.0625000
NODE_1365_length_1974_cov_8.058133	670	750	33	4	80	0.0500000
NODE_1365_length_1974_cov_8.058133	670	750	39	2	80	0.0250000
NODE_1365_length_1974_cov_8.058133	670	750	40	1	80	0.0125000
NODE_1365_length_1974_cov_8.058133	670	750	42	1	80	0.0125000
NODE_1365_length_1974_cov_8.058133	670	750	44	1	80	0.0125000
NODE_1365_length_1974_cov_8.058133	670	750	46	3	80	0.0375000
NODE_1365_length_1974_cov_8.058133	670	750	48	1	80	0.0125000
NODE_1365_length_1974_cov_8.058133	670	750	49	3	80	0.0375000
NODE_1365_length_1974_cov_8.058133	670	750	53	5	80	0.0625000
NODE_1365_length_1974_cov_8.058133	670	750	55	7	80	0.0875000
NODE_1365_length_1974_cov_8.058133	670	750	57	5	80	0.0625000
NODE_1365_length_1974_cov_8.058133	670	750	58	4	80	0.0500000
NODE_1365_length_1974_cov_8.058133	670	750	68	2	80	0.0250000
NODE_1365_length_1974_cov_8.058133	670	750	70	4	80	0.0500000
NODE_1365_length_1974_cov_8.058133	670	750	74	2	80	0.0250000
NODE_1365_length_1974_cov_8.058133	670	750	75	1	80	0.0125000
NODE_1365_length_1974_cov_8.058133	670	750	76	2	80	0.0250000
NODE_1365_length_1974_cov_8.058133	670	750	77	2	80	0.0250000
NODE_1365_length_1974_cov_8.058133	670	750	78	7	80	0.0875000
NODE_1366_length_1973_cov_14.885272	640	726	0	5	86	0.0581395
NODE_1366_length_1973_cov_14.885272	640	726	1	36	86	0.4186046
NODE_1366_length_1973_cov_14.885272	640	726	2	45	86	0.5232558
NODE_1366_length_1973_cov_14.885272	699	779	0	58	80	0.7250000
NODE_1366_length_1973_cov_14.885272	699	779	1	22	80	0.2750000
NODE_1366_length_1973_cov_14.885272	1389	1469	0	80	80	1.0000000
NODE_1366_length_1973_cov_14.885272	1442	1522	0	80	80	1.0000000
NODE_1372_length_1971_cov_3.126068	1662	1742	10	30	80	0.3750000
NODE_1372_length_1971_cov_3.126068	1662	1742	12	35	80	0.4375000
NODE_1372_length_1971_cov_3.126068	1662	1742	14	15	80	0.1875000
NODE_1372_length_1971_cov_3.126068	1715	1799	5	5	84	0.0595238
NODE_1372_length_1971_cov_3.126068	1715	1799	6	18	84	0.2142857
NODE_1372_length_1971_cov_3.126068	1715	1799	7	1	84	0.0119048
NODE_1372_length_1971_cov_3.126068	1715	1799	8	6	84	0.0714286
NODE_1372_length_1971_cov_3.126068	1715	1799	9	4	84	0.0476190
NODE_1372_length_1971_cov_3.126068	1715	1799	10	34	84	0.4047619
NODE_1372_length_1971_cov_3.126068	1715	1799	12	16	84	0.1904762
NODE_1386_length_1962_cov_23.774557	281	311	2	30	30	1.0000000
NODE_1386_length_1962_cov_23.774557	329	355	2	26	26	1.0000000
NODE_1386_length_1962_cov_23.774557	408	487	0	79	79	1.0000000
NODE_1386_length_1962_cov_23.774557	460	540	0	80	80	1.0000000
NODE_1386_length_1962_cov_23.774557	1417	1497	0	80	80	1.0000000
NODE_1386_length_1962_cov_23.774557	1470	1550	0	80	80	1.0000000
NODE_1386_length_1962_cov_23.774557	1607	1640	0	31	33	0.9393939
NODE_1386_length_1962_cov_23.774557	1607	1640	2	2	33	0.0606061
NODE_1395_length_1953_cov_26.183927	1	81	15	2	80	0.0250000
NODE_1395_length_1953_cov_26.183927	1	81	18	2	80	0.0250000
NODE_1395_length_1953_cov_26.183927	1	81	24	4	80	0.0500000
NODE_1395_length_1953_cov_26.183927	1	81	45	4	80	0.0500000
NODE_1395_length_1953_cov_26.183927	1	81	47	2	80	0.0250000
NODE_1395_length_1953_cov_26.183927	1	81	49	10	80	0.1250000
NODE_1395_length_1953_cov_26.183927	1	81	53	1	80	0.0125000
NODE_1395_length_1953_cov_26.183927	1	81	57	2	80	0.0250000
NODE_1395_length_1953_cov_26.183927	1	81	61	1	80	0.0125000
NODE_1395_length_1953_cov_26.183927	1	81	70	2	80	0.0250000
NODE_1395_length_1953_cov_26.183927	1	81	81	1	80	0.0125000
NODE_1395_length_1953_cov_26.183927	1	81	83	10	80	0.1250000
NODE_1395_length_1953_cov_26.183927	1	81	84	23	80	0.2875000
NODE_1395_length_1953_cov_26.183927	1	81	85	2	80	0.0250000
NODE_1395_length_1953_cov_26.183927	1	81	87	4	80	0.0500000
NODE_1395_length_1953_cov_26.183927	1	81	88	10	80	0.1250000
NODE_1395_length_1953_cov_26.183927	6	28	24	3	22	0.1363636
NODE_1395_length_1953_cov_26.183927	6	28	45	4	22	0.1818182
NODE_1395_length_1953_cov_26.183927	6	28	47	2	22	0.0909091
NODE_1395_length_1953_cov_26.183927	6	28	49	10	22	0.4545455
NODE_1395_length_1953_cov_26.183927	6	28	53	1	22	0.0454545
NODE_1395_length_1953_cov_26.183927	6	28	57	2	22	0.0909091
NODE_1395_length_1953_cov_26.183927	152	232	0	80	80	1.0000000
NODE_1395_length_1953_cov_26.183927	205	257	0	50	52	0.9615384
NODE_1395_length_1953_cov_26.183927	205	257	4	2	52	0.0384615
NODE_1405_length_1943_cov_11.218547	516	596	0	80	80	1.0000000
NODE_1405_length_1943_cov_11.218547	569	649	0	80	80	1.0000000
NODE_1408_length_1941_cov_14.407709	891	921	0	30	30	1.0000000
NODE_1408_length_1941_cov_14.407709	894	964	0	70	70	1.0000000
NODE_1408_length_1941_cov_14.407709	1878	1941	0	63	63	1.0000000
NODE_1409_length_1941_cov_9.632465	139	213	4	7	74	0.0945946
NODE_1409_length_1941_cov_9.632465	139	213	6	11	74	0.1486486
NODE_1409_length_1941_cov_9.632465	139	213	8	56	74	0.7567568
NODE_1409_length_1941_cov_9.632465	139	219	4	12	80	0.1500000
NODE_1409_length_1941_cov_9.632465	139	219	6	12	80	0.1500000
NODE_1409_length_1941_cov_9.632465	139	219	8	56	80	0.7000000
NODE_1409_length_1941_cov_9.632465	139	194	6	6	55	0.1090909
NODE_1409_length_1941_cov_9.632465	139	194	8	49	55	0.8909091
NODE_1409_length_1941_cov_9.632465	192	272	2	50	80	0.6250000
NODE_1409_length_1941_cov_9.632465	192	272	4	12	80	0.1500000
NODE_1409_length_1941_cov_9.632465	192	272	6	9	80	0.1125000
NODE_1409_length_1941_cov_9.632465	192	272	8	9	80	0.1125000
NODE_1414_length_1936_cov_13.338596	679	759	0	80	80	1.0000000
NODE_1414_length_1936_cov_13.338596	732	812	0	80	80	1.0000000
NODE_1414_length_1936_cov_13.338596	738	812	0	74	74	1.0000000
NODE_1414_length_1936_cov_13.338596	738	759	0	21	21	1.0000000
NODE_1415_length_1936_cov_12.592814	102	153	0	16	51	0.3137255
NODE_1415_length_1936_cov_12.592814	102	153	2	8	51	0.1568628
NODE_1415_length_1936_cov_12.592814	102	153	6	2	51	0.0392157
NODE_1415_length_1936_cov_12.592814	102	153	8	5	51	0.0980392
NODE_1415_length_1936_cov_12.592814	102	153	12	9	51	0.1764706
NODE_1415_length_1936_cov_12.592814	102	153	16	1	51	0.0196078
NODE_1415_length_1936_cov_12.592814	102	153	20	8	51	0.1568628
NODE_1415_length_1936_cov_12.592814	102	153	22	2	51	0.0392157
NODE_1415_length_1936_cov_12.592814	154	230	2	7	76	0.0921053
NODE_1415_length_1936_cov_12.592814	154	230	4	12	76	0.1578947
NODE_1415_length_1936_cov_12.592814	154	230	6	57	76	0.7500000
NODE_1415_length_1936_cov_12.592814	211	251	2	8	40	0.2000000
NODE_1415_length_1936_cov_12.592814	211	251	4	15	40	0.3750000
NODE_1415_length_1936_cov_12.592814	211	251	6	17	40	0.4250000
NODE_1416_length_1933_cov_86.724646	1044	1124	0	80	80	1.0000000
NODE_1416_length_1933_cov_86.724646	1097	1177	0	80	80	1.0000000
NODE_1416_length_1933_cov_86.724646	1173	1253	0	80	80	1.0000000
NODE_1416_length_1933_cov_86.724646	1226	1306	0	80	80	1.0000000
NODE_1419_length_1932_cov_5.905074	1534	1614	2	5	80	0.0625000
NODE_1419_length_1932_cov_5.905074	1534	1614	4	23	80	0.2875000
NODE_1419_length_1932_cov_5.905074	1534	1614	6	52	80	0.6500000
NODE_1422_length_1930_cov_3.005461	1700	1780	60	5	80	0.0625000
NODE_1422_length_1930_cov_3.005461	1700	1780	62	2	80	0.0250000
NODE_1422_length_1930_cov_3.005461	1700	1780	72	3	80	0.0375000
NODE_1422_length_1930_cov_3.005461	1700	1780	90	1	80	0.0125000
NODE_1422_length_1930_cov_3.005461	1700	1780	92	19	80	0.2375000
NODE_1422_length_1930_cov_3.005461	1700	1780	96	5	80	0.0625000
NODE_1422_length_1930_cov_3.005461	1700	1780	98	5	80	0.0625000
NODE_1422_length_1930_cov_3.005461	1700	1780	100	21	80	0.2625000
NODE_1422_length_1930_cov_3.005461	1700	1780	102	6	80	0.0750000
NODE_1422_length_1930_cov_3.005461	1700	1780	103	12	80	0.1500000
NODE_1422_length_1930_cov_3.005461	1700	1780	104	1	80	0.0125000
NODE_1427_length_1928_cov_2.580098	74	131	48	5	57	0.0877193
NODE_1427_length_1928_cov_2.580098	74	131	50	5	57	0.0877193
NODE_1427_length_1928_cov_2.580098	74	131	52	13	57	0.2280702
NODE_1427_length_1928_cov_2.580098	74	131	54	9	57	0.1578947
NODE_1427_length_1928_cov_2.580098	74	131	56	16	57	0.2807018
NODE_1427_length_1928_cov_2.580098	74	131	58	9	57	0.1578947
NODE_1427_length_1928_cov_2.580098	127	184	8	2	57	0.0350877
NODE_1427_length_1928_cov_2.580098	127	184	10	3	57	0.0526316
NODE_1427_length_1928_cov_2.580098	127	184	12	5	57	0.0877193
NODE_1427_length_1928_cov_2.580098	127	184	14	2	57	0.0350877
NODE_1427_length_1928_cov_2.580098	127	184	16	7	57	0.1228070
NODE_1427_length_1928_cov_2.580098	127	184	19	1	57	0.0175439
NODE_1427_length_1928_cov_2.580098	127	184	20	10	57	0.1754386
NODE_1427_length_1928_cov_2.580098	127	184	25	1	57	0.0175439
NODE_1427_length_1928_cov_2.580098	127	184	26	2	57	0.0350877
NODE_1427_length_1928_cov_2.580098	127	184	28	3	57	0.0526316
NODE_1427_length_1928_cov_2.580098	127	184	32	6	57	0.1052632
NODE_1427_length_1928_cov_2.580098	127	184	40	2	57	0.0350877
NODE_1427_length_1928_cov_2.580098	127	184	46	5	57	0.0877193
NODE_1427_length_1928_cov_2.580098	127	184	48	1	57	0.0175439
NODE_1427_length_1928_cov_2.580098	127	184	50	4	57	0.0701754
NODE_1427_length_1928_cov_2.580098	127	184	52	3	57	0.0526316
NODE_1434_length_1919_cov_17.901099	454	529	12	6	75	0.0800000
NODE_1434_length_1919_cov_17.901099	454	529	16	7	75	0.0933333
NODE_1434_length_1919_cov_17.901099	454	529	18	29	75	0.3866667
NODE_1434_length_1919_cov_17.901099	454	529	20	33	75	0.4400000
NODE_1434_length_1919_cov_17.901099	507	558	0	7	51	0.1372549
NODE_1434_length_1919_cov_17.901099	507	558	2	1	51	0.0196078
NODE_1434_length_1919_cov_17.901099	507	558	4	2	51	0.0392157
NODE_1434_length_1919_cov_17.901099	507	558	8	11	51	0.2156863
NODE_1434_length_1919_cov_17.901099	507	558	18	30	51	0.5882353
NODE_1436_length_1918_cov_14.876855	314	396	0	4	82	0.0487805
NODE_1436_length_1918_cov_14.876855	314	396	2	36	82	0.4390244
NODE_1436_length_1918_cov_14.876855	314	396	6	42	82	0.5121951
NODE_1438_length_1918_cov_3.493128	9	55	0	31	46	0.6739131
NODE_1438_length_1918_cov_3.493128	9	55	4	15	46	0.3260870
NODE_1438_length_1918_cov_3.493128	1480	1561	0	50	81	0.6172839
NODE_1438_length_1918_cov_3.493128	1480	1561	2	31	81	0.3827161
NODE_1440_length_1916_cov_4.426527	162	192	0	30	30	1.0000000
NODE_1442_length_1915_cov_35.787996	106	186	21	3	80	0.0375000
NODE_1442_length_1915_cov_35.787996	106	186	25	1	80	0.0125000
NODE_1442_length_1915_cov_35.787996	106	186	35	2	80	0.0250000
NODE_1442_length_1915_cov_35.787996	106	186	37	1	80	0.0125000
NODE_1442_length_1915_cov_35.787996	106	186	41	1	80	0.0125000
NODE_1442_length_1915_cov_35.787996	106	186	43	1	80	0.0125000
NODE_1442_length_1915_cov_35.787996	106	186	45	2	80	0.0250000
NODE_1442_length_1915_cov_35.787996	106	186	47	1	80	0.0125000
NODE_1442_length_1915_cov_35.787996	106	186	57	2	80	0.0250000
NODE_1442_length_1915_cov_35.787996	106	186	61	2	80	0.0250000
NODE_1442_length_1915_cov_35.787996	106	186	71	1	80	0.0125000
NODE_1442_length_1915_cov_35.787996	106	186	72	1	80	0.0125000
NODE_1442_length_1915_cov_35.787996	106	186	78	1	80	0.0125000
NODE_1442_length_1915_cov_35.787996	106	186	80	1	80	0.0125000
NODE_1442_length_1915_cov_35.787996	106	186	81	3	80	0.0375000
NODE_1442_length_1915_cov_35.787996	106	186	83	1	80	0.0125000
NODE_1442_length_1915_cov_35.787996	106	186	87	1	80	0.0125000
NODE_1442_length_1915_cov_35.787996	106	186	92	1	80	0.0125000
NODE_1442_length_1915_cov_35.787996	106	186	94	2	80	0.0250000
NODE_1442_length_1915_cov_35.787996	106	186	100	2	80	0.0250000
NODE_1442_length_1915_cov_35.787996	106	186	102	1	80	0.0125000
NODE_1442_length_1915_cov_35.787996	106	186	104	1	80	0.0125000
NODE_1442_length_1915_cov_35.787996	106	186	108	1	80	0.0125000
NODE_1442_length_1915_cov_35.787996	106	186	110	5	80	0.0625000
NODE_1442_length_1915_cov_35.787996	106	186	111	7	80	0.0875000
NODE_1442_length_1915_cov_35.787996	106	186	115	2	80	0.0250000
NODE_1442_length_1915_cov_35.787996	106	186	117	1	80	0.0125000
NODE_1442_length_1915_cov_35.787996	106	186	119	4	80	0.0500000
NODE_1442_length_1915_cov_35.787996	106	186	121	2	80	0.0250000
NODE_1442_length_1915_cov_35.787996	106	186	123	1	80	0.0125000
NODE_1442_length_1915_cov_35.787996	106	186	125	14	80	0.1750000
NODE_1442_length_1915_cov_35.787996	106	186	127	2	80	0.0250000
NODE_1442_length_1915_cov_35.787996	106	186	129	3	80	0.0375000
NODE_1442_length_1915_cov_35.787996	106	186	130	1	80	0.0125000
NODE_1442_length_1915_cov_35.787996	106	186	131	4	80	0.0500000
NODE_1442_length_1915_cov_35.787996	106	186	133	1	80	0.0125000
NODE_1451_length_1905_cov_18.464563	740	820	0	80	80	1.0000000
NODE_1451_length_1905_cov_18.464563	793	873	0	80	80	1.0000000
NODE_1451_length_1905_cov_18.464563	869	949	0	80	80	1.0000000
NODE_1451_length_1905_cov_18.464563	922	1010	0	88	88	1.0000000
NODE_1452_length_1905_cov_7.197121	596	676	0	47	80	0.5875000
NODE_1452_length_1905_cov_7.197121	596	676	2	33	80	0.4125000
NODE_1452_length_1905_cov_7.197121	649	682	2	33	33	1.0000000
NODE_1455_length_1902_cov_1.633943	1728	1792	41	1	64	0.0156250
NODE_1455_length_1902_cov_1.633943	1728	1792	43	1	64	0.0156250
NODE_1455_length_1902_cov_1.633943	1728	1792	46	5	64	0.0781250
NODE_1455_length_1902_cov_1.633943	1728	1792	52	5	64	0.0781250
NODE_1455_length_1902_cov_1.633943	1728	1792	53	3	64	0.0468750
NODE_1455_length_1902_cov_1.633943	1728	1792	55	3	64	0.0468750
NODE_1455_length_1902_cov_1.633943	1728	1792	59	1	64	0.0156250
NODE_1455_length_1902_cov_1.633943	1728	1792	66	2	64	0.0312500
NODE_1455_length_1902_cov_1.633943	1728	1792	67	1	64	0.0156250
NODE_1455_length_1902_cov_1.633943	1728	1792	69	1	64	0.0156250
NODE_1455_length_1902_cov_1.633943	1728	1792	75	3	64	0.0468750
NODE_1455_length_1902_cov_1.633943	1728	1792	77	1	64	0.0156250
NODE_1455_length_1902_cov_1.633943	1728	1792	85	1	64	0.0156250
NODE_1455_length_1902_cov_1.633943	1728	1792	87	2	64	0.0312500
NODE_1455_length_1902_cov_1.633943	1728	1792	95	3	64	0.0468750
NODE_1455_length_1902_cov_1.633943	1728	1792	97	1	64	0.0156250
NODE_1455_length_1902_cov_1.633943	1728	1792	100	4	64	0.0625000
NODE_1455_length_1902_cov_1.633943	1728	1792	102	7	64	0.1093750
NODE_1455_length_1902_cov_1.633943	1728	1792	104	4	64	0.0625000
NODE_1455_length_1902_cov_1.633943	1728	1792	106	2	64	0.0312500
NODE_1455_length_1902_cov_1.633943	1728	1792	107	1	64	0.0156250
NODE_1455_length_1902_cov_1.633943	1728	1792	108	3	64	0.0468750
NODE_1455_length_1902_cov_1.633943	1728	1792	110	1	64	0.0156250
NODE_1455_length_1902_cov_1.633943	1728	1792	114	2	64	0.0312500
NODE_1455_length_1902_cov_1.633943	1728	1792	116	6	64	0.0937500
NODE_1458_length_1900_cov_1.081066	1805	1851	0	46	46	1.0000000
NODE_1458_length_1900_cov_1.081066	1824	1900	0	76	76	1.0000000
NODE_1461_length_1895_cov_17.940980	1070	1150	0	10	80	0.1250000
NODE_1461_length_1895_cov_17.940980	1070	1150	4	70	80	0.8750000
NODE_1461_length_1895_cov_17.940980	1123	1203	0	3	80	0.0375000
NODE_1461_length_1895_cov_17.940980	1123	1203	4	77	80	0.9625000
NODE_1466_length_1893_cov_3.299331	918	998	0	21	80	0.2625000
NODE_1466_length_1893_cov_3.299331	918	998	2	59	80	0.7375000
NODE_1467_length_1892_cov_5.158394	317	397	0	80	80	1.0000000
NODE_1467_length_1892_cov_5.158394	370	445	0	75	75	1.0000000
NODE_1469_length_1889_cov_4.049162	1652	1686	4	34	34	1.0000000
NODE_1470_length_1889_cov_3.888268	960	1040	0	80	80	1.0000000
NODE_1470_length_1889_cov_3.888268	1013	1093	0	80	80	1.0000000
NODE_1472_length_1888_cov_17.106764	15	96	20	5	81	0.0617284
NODE_1472_length_1888_cov_17.106764	15	96	26	1	81	0.0123457
NODE_1472_length_1888_cov_17.106764	15	96	36	2	81	0.0246914
NODE_1472_length_1888_cov_17.106764	15	96	39	1	81	0.0123457
NODE_1472_length_1888_cov_17.106764	15	96	40	3	81	0.0370370
NODE_1472_length_1888_cov_17.106764	15	96	44	1	81	0.0123457
NODE_1472_length_1888_cov_17.106764	15	96	50	1	81	0.0123457
NODE_1472_length_1888_cov_17.106764	15	96	52	4	81	0.0493827
NODE_1472_length_1888_cov_17.106764	15	96	54	30	81	0.3703704
NODE_1472_length_1888_cov_17.106764	15	96	56	10	81	0.1234568
NODE_1472_length_1888_cov_17.106764	15	96	58	20	81	0.2469136
NODE_1472_length_1888_cov_17.106764	15	96	60	3	81	0.0370370
NODE_1472_length_1888_cov_17.106764	68	143	18	1	75	0.0133333
NODE_1472_length_1888_cov_17.106764	68	143	20	9	75	0.1200000
NODE_1472_length_1888_cov_17.106764	68	143	25	1	75	0.0133333
NODE_1472_length_1888_cov_17.106764	68	143	30	1	75	0.0133333
NODE_1472_length_1888_cov_17.106764	68	143	32	1	75	0.0133333
NODE_1472_length_1888_cov_17.106764	68	143	33	2	75	0.0266667
NODE_1472_length_1888_cov_17.106764	68	143	34	3	75	0.0400000
NODE_1472_length_1888_cov_17.106764	68	143	35	1	75	0.0133333
NODE_1472_length_1888_cov_17.106764	68	143	38	1	75	0.0133333
NODE_1472_length_1888_cov_17.106764	68	143	40	2	75	0.0266667
NODE_1472_length_1888_cov_17.106764	68	143	44	3	75	0.0400000
NODE_1472_length_1888_cov_17.106764	68	143	48	1	75	0.0133333
NODE_1472_length_1888_cov_17.106764	68	143	51	1	75	0.0133333
NODE_1472_length_1888_cov_17.106764	68	143	52	4	75	0.0533333
NODE_1472_length_1888_cov_17.106764	68	143	56	7	75	0.0933333
NODE_1472_length_1888_cov_17.106764	68	143	58	20	75	0.2666667
NODE_1472_length_1888_cov_17.106764	68	143	60	12	75	0.1600000
NODE_1472_length_1888_cov_17.106764	68	143	62	5	75	0.0666667
NODE_1477_length_1885_cov_4.439530	441	521	0	80	80	1.0000000
NODE_1477_length_1885_cov_4.439530	494	574	0	80	80	1.0000000
NODE_1483_length_1882_cov_5.884464	1499	1579	0	80	80	1.0000000
NODE_1483_length_1882_cov_5.884464	1552	1632	0	80	80	1.0000000
NODE_1493_length_1875_cov_3.974662	1650	1730	8	7	80	0.0875000
NODE_1493_length_1875_cov_3.974662	1650	1730	10	38	80	0.4750000
NODE_1493_length_1875_cov_3.974662	1650	1730	12	1	80	0.0125000
NODE_1493_length_1875_cov_3.974662	1650	1730	14	11	80	0.1375000
NODE_1493_length_1875_cov_3.974662	1650	1730	16	20	80	0.2500000
NODE_1493_length_1875_cov_3.974662	1650	1730	18	2	80	0.0250000
NODE_1493_length_1875_cov_3.974662	1650	1730	20	1	80	0.0125000
NODE_1497_length_1872_cov_21.355330	153	201	0	48	48	1.0000000
NODE_1503_length_1868_cov_96.046919	1018	1098	32	1	80	0.0125000
NODE_1503_length_1868_cov_96.046919	1018	1098	36	1	80	0.0125000
NODE_1503_length_1868_cov_96.046919	1018	1098	39	4	80	0.0500000
NODE_1503_length_1868_cov_96.046919	1018	1098	43	1	80	0.0125000
NODE_1503_length_1868_cov_96.046919	1018	1098	45	2	80	0.0250000
NODE_1503_length_1868_cov_96.046919	1018	1098	47	1	80	0.0125000
NODE_1503_length_1868_cov_96.046919	1018	1098	48	1	80	0.0125000
NODE_1503_length_1868_cov_96.046919	1018	1098	52	3	80	0.0375000
NODE_1503_length_1868_cov_96.046919	1018	1098	58	1	80	0.0125000
NODE_1503_length_1868_cov_96.046919	1018	1098	62	2	80	0.0250000
NODE_1503_length_1868_cov_96.046919	1018	1098	66	1	80	0.0125000
NODE_1503_length_1868_cov_96.046919	1018	1098	69	5	80	0.0625000
NODE_1503_length_1868_cov_96.046919	1018	1098	83	1	80	0.0125000
NODE_1503_length_1868_cov_96.046919	1018	1098	87	1	80	0.0125000
NODE_1503_length_1868_cov_96.046919	1018	1098	88	1	80	0.0125000
NODE_1503_length_1868_cov_96.046919	1018	1098	92	1	80	0.0125000
NODE_1503_length_1868_cov_96.046919	1018	1098	93	1	80	0.0125000
NODE_1503_length_1868_cov_96.046919	1018	1098	103	1	80	0.0125000
NODE_1503_length_1868_cov_96.046919	1018	1098	112	1	80	0.0125000
NODE_1503_length_1868_cov_96.046919	1018	1098	113	8	80	0.1000000
NODE_1503_length_1868_cov_96.046919	1018	1098	121	1	80	0.0125000
NODE_1503_length_1868_cov_96.046919	1018	1098	129	1	80	0.0125000
NODE_1503_length_1868_cov_96.046919	1018	1098	139	1	80	0.0125000
NODE_1503_length_1868_cov_96.046919	1018	1098	141	1	80	0.0125000
NODE_1503_length_1868_cov_96.046919	1018	1098	149	4	80	0.0500000
NODE_1503_length_1868_cov_96.046919	1018	1098	153	1	80	0.0125000
NODE_1503_length_1868_cov_96.046919	1018	1098	155	4	80	0.0500000
NODE_1503_length_1868_cov_96.046919	1018	1098	169	3	80	0.0375000
NODE_1503_length_1868_cov_96.046919	1018	1098	171	6	80	0.0750000
NODE_1503_length_1868_cov_96.046919	1018	1098	173	1	80	0.0125000
NODE_1503_length_1868_cov_96.046919	1018	1098	184	2	80	0.0250000
NODE_1503_length_1868_cov_96.046919	1018	1098	186	3	80	0.0375000
NODE_1503_length_1868_cov_96.046919	1018	1098	189	1	80	0.0125000
NODE_1503_length_1868_cov_96.046919	1018	1098	196	1	80	0.0125000
NODE_1503_length_1868_cov_96.046919	1018	1098	197	1	80	0.0125000
NODE_1503_length_1868_cov_96.046919	1018	1098	198	7	80	0.0875000
NODE_1503_length_1868_cov_96.046919	1018	1098	199	1	80	0.0125000
NODE_1503_length_1868_cov_96.046919	1018	1098	200	2	80	0.0250000
NODE_1503_length_1868_cov_96.046919	1018	1098	203	1	80	0.0125000
NODE_1503_length_1868_cov_96.046919	1071	1151	169	1	80	0.0125000
NODE_1503_length_1868_cov_96.046919	1071	1151	171	7	80	0.0875000
NODE_1503_length_1868_cov_96.046919	1071	1151	173	1	80	0.0125000
NODE_1503_length_1868_cov_96.046919	1071	1151	184	2	80	0.0250000
NODE_1503_length_1868_cov_96.046919	1071	1151	186	4	80	0.0500000
NODE_1503_length_1868_cov_96.046919	1071	1151	189	1	80	0.0125000
NODE_1503_length_1868_cov_96.046919	1071	1151	192	5	80	0.0625000
NODE_1503_length_1868_cov_96.046919	1071	1151	196	3	80	0.0375000
NODE_1503_length_1868_cov_96.046919	1071	1151	197	1	80	0.0125000
NODE_1503_length_1868_cov_96.046919	1071	1151	198	14	80	0.1750000
NODE_1503_length_1868_cov_96.046919	1071	1151	199	1	80	0.0125000
NODE_1503_length_1868_cov_96.046919	1071	1151	200	2	80	0.0250000
NODE_1503_length_1868_cov_96.046919	1071	1151	202	5	80	0.0625000
NODE_1503_length_1868_cov_96.046919	1071	1151	203	2	80	0.0250000
NODE_1503_length_1868_cov_96.046919	1071	1151	206	2	80	0.0250000
NODE_1503_length_1868_cov_96.046919	1071	1151	207	1	80	0.0125000
NODE_1503_length_1868_cov_96.046919	1071	1151	209	1	80	0.0125000
NODE_1503_length_1868_cov_96.046919	1071	1151	210	3	80	0.0375000
NODE_1503_length_1868_cov_96.046919	1071	1151	211	2	80	0.0250000
NODE_1503_length_1868_cov_96.046919	1071	1151	212	1	80	0.0125000
NODE_1503_length_1868_cov_96.046919	1071	1151	213	3	80	0.0375000
NODE_1503_length_1868_cov_96.046919	1071	1151	214	1	80	0.0125000
NODE_1503_length_1868_cov_96.046919	1071	1151	215	2	80	0.0250000
NODE_1503_length_1868_cov_96.046919	1071	1151	216	1	80	0.0125000
NODE_1503_length_1868_cov_96.046919	1071	1151	217	1	80	0.0125000
NODE_1503_length_1868_cov_96.046919	1071	1151	220	1	80	0.0125000
NODE_1503_length_1868_cov_96.046919	1071	1151	221	2	80	0.0250000
NODE_1503_length_1868_cov_96.046919	1071	1151	222	2	80	0.0250000
NODE_1503_length_1868_cov_96.046919	1071	1151	223	1	80	0.0125000
NODE_1503_length_1868_cov_96.046919	1071	1151	226	1	80	0.0125000
NODE_1503_length_1868_cov_96.046919	1071	1151	227	2	80	0.0250000
NODE_1503_length_1868_cov_96.046919	1071	1151	229	4	80	0.0500000
NODE_1508_length_1866_cov_53.869270	1149	1229	0	80	80	1.0000000
NODE_1508_length_1866_cov_53.869270	1202	1282	0	31	80	0.3875000
NODE_1508_length_1866_cov_53.869270	1202	1282	2	49	80	0.6125000
NODE_1508_length_1866_cov_53.869270	1278	1358	0	16	80	0.2000000
NODE_1508_length_1866_cov_53.869270	1278	1358	1	1	80	0.0125000
NODE_1508_length_1866_cov_53.869270	1278	1358	2	63	80	0.7875000
NODE_1508_length_1866_cov_53.869270	1331	1411	0	69	80	0.8625000
NODE_1508_length_1866_cov_53.869270	1331	1411	1	1	80	0.0125000
NODE_1508_length_1866_cov_53.869270	1331	1411	2	10	80	0.1250000
NODE_1510_length_1866_cov_3.347482	888	966	0	78	78	1.0000000
NODE_1510_length_1866_cov_3.347482	939	1019	0	80	80	1.0000000
NODE_1513_length_1863_cov_11.265306	698	778	0	16	80	0.2000000
NODE_1513_length_1863_cov_11.265306	698	778	2	64	80	0.8000000
NODE_1513_length_1863_cov_11.265306	751	831	0	69	80	0.8625000
NODE_1513_length_1863_cov_11.265306	751	831	2	11	80	0.1375000
NODE_1518_length_1858_cov_19.019329	23	85	0	62	62	1.0000000
NODE_1518_length_1858_cov_19.019329	1125	1205	0	16	80	0.2000000
NODE_1518_length_1858_cov_19.019329	1125	1205	2	64	80	0.8000000
NODE_1518_length_1858_cov_19.019329	1178	1256	0	67	78	0.8589743
NODE_1518_length_1858_cov_19.019329	1178	1256	2	11	78	0.1410256
NODE_1518_length_1858_cov_19.019329	1387	1464	0	77	77	1.0000000
NODE_1518_length_1858_cov_19.019329	1440	1503	0	63	63	1.0000000
NODE_1519_length_1857_cov_18.402730	1282	1348	0	28	66	0.4242424
NODE_1519_length_1857_cov_18.402730	1282	1348	2	38	66	0.5757576
NODE_1519_length_1857_cov_18.402730	1321	1401	2	80	80	1.0000000
NODE_1519_length_1857_cov_18.402730	1397	1477	0	53	80	0.6625000
NODE_1519_length_1857_cov_18.402730	1397	1477	2	27	80	0.3375000
NODE_1519_length_1857_cov_18.402730	1450	1530	0	80	80	1.0000000
NODE_1531_length_1845_cov_12.653494	473	553	2	80	80	1.0000000
NODE_1531_length_1845_cov_12.653494	526	606	0	8	80	0.1000000
NODE_1531_length_1845_cov_12.653494	526	606	2	72	80	0.9000000
NODE_1546_length_1833_cov_31.337947	810	888	2	65	78	0.8333333
NODE_1546_length_1833_cov_31.337947	810	888	3	12	78	0.1538462
NODE_1546_length_1833_cov_31.337947	810	888	5	1	78	0.0128205
NODE_1546_length_1833_cov_31.337947	861	941	2	14	80	0.1750000
NODE_1546_length_1833_cov_31.337947	861	941	3	65	80	0.8125000
NODE_1546_length_1833_cov_31.337947	861	941	5	1	80	0.0125000
NODE_1546_length_1833_cov_31.337947	937	1017	3	39	80	0.4875000
NODE_1546_length_1833_cov_31.337947	937	1017	4	24	80	0.3000000
NODE_1546_length_1833_cov_31.337947	937	1017	6	16	80	0.2000000
NODE_1546_length_1833_cov_31.337947	937	1017	7	1	80	0.0125000
NODE_1546_length_1833_cov_31.337947	990	1070	4	63	80	0.7875000
NODE_1546_length_1833_cov_31.337947	990	1070	6	16	80	0.2000000
NODE_1546_length_1833_cov_31.337947	990	1070	7	1	80	0.0125000
NODE_1550_length_1831_cov_3.065820	112	154	8	6	42	0.1428571
NODE_1550_length_1831_cov_3.065820	112	154	12	5	42	0.1190476
NODE_1550_length_1831_cov_3.065820	112	154	14	5	42	0.1190476
NODE_1550_length_1831_cov_3.065820	112	154	16	1	42	0.0238095
NODE_1550_length_1831_cov_3.065820	112	154	24	1	42	0.0238095
NODE_1550_length_1831_cov_3.065820	112	154	28	1	42	0.0238095
NODE_1550_length_1831_cov_3.065820	112	154	30	1	42	0.0238095
NODE_1550_length_1831_cov_3.065820	112	154	32	1	42	0.0238095
NODE_1550_length_1831_cov_3.065820	112	154	34	1	42	0.0238095
NODE_1550_length_1831_cov_3.065820	112	154	38	2	42	0.0476190
NODE_1550_length_1831_cov_3.065820	112	154	44	3	42	0.0714286
NODE_1550_length_1831_cov_3.065820	112	154	48	4	42	0.0952381
NODE_1550_length_1831_cov_3.065820	112	154	50	1	42	0.0238095
NODE_1550_length_1831_cov_3.065820	112	154	54	4	42	0.0952381
NODE_1550_length_1831_cov_3.065820	112	154	56	2	42	0.0476190
NODE_1550_length_1831_cov_3.065820	112	154	60	2	42	0.0476190
NODE_1550_length_1831_cov_3.065820	112	154	64	1	42	0.0238095
NODE_1550_length_1831_cov_3.065820	112	154	66	1	42	0.0238095
NODE_1553_length_1830_cov_2.512998	123	203	0	80	80	1.0000000
NODE_1553_length_1830_cov_2.512998	176	256	0	80	80	1.0000000
NODE_1553_length_1830_cov_2.512998	308	357	0	49	49	1.0000000
NODE_1554_length_1828_cov_40.437825	789	869	0	17	80	0.2125000
NODE_1554_length_1828_cov_40.437825	789	869	2	63	80	0.7875000
NODE_1554_length_1828_cov_40.437825	842	922	0	50	80	0.6250000
NODE_1554_length_1828_cov_40.437825	842	922	2	30	80	0.3750000
NODE_1554_length_1828_cov_40.437825	918	998	0	60	80	0.7500000
NODE_1554_length_1828_cov_40.437825	918	998	2	20	80	0.2500000
NODE_1554_length_1828_cov_40.437825	971	1051	0	8	80	0.1000000
NODE_1554_length_1828_cov_40.437825	971	1051	2	72	80	0.9000000
NODE_1559_length_1825_cov_6.652955	641	689	0	9	48	0.1875000
NODE_1559_length_1825_cov_6.652955	641	689	5	1	48	0.0208333
NODE_1559_length_1825_cov_6.652955	641	689	6	3	48	0.0625000
NODE_1559_length_1825_cov_6.652955	641	689	10	35	48	0.7291667
NODE_1559_length_1825_cov_6.652955	694	744	12	2	50	0.0400000
NODE_1559_length_1825_cov_6.652955	694	744	14	13	50	0.2600000
NODE_1559_length_1825_cov_6.652955	694	744	20	35	50	0.7000000
NODE_1562_length_1824_cov_10.152464	685	765	0	80	80	1.0000000
NODE_1562_length_1824_cov_10.152464	738	818	0	80	80	1.0000000
NODE_1562_length_1824_cov_10.152464	1412	1433	2	21	21	1.0000000
NODE_1564_length_1821_cov_7.682346	953	1033	0	29	80	0.3625000
NODE_1564_length_1821_cov_7.682346	953	1033	10	1	80	0.0125000
NODE_1564_length_1821_cov_7.682346	953	1033	11	8	80	0.1000000
NODE_1564_length_1821_cov_7.682346	953	1033	12	42	80	0.5250000
NODE_1564_length_1821_cov_7.682346	1006	1086	0	3	80	0.0375000
NODE_1564_length_1821_cov_7.682346	1006	1086	10	51	80	0.6375000
NODE_1564_length_1821_cov_7.682346	1006	1086	11	8	80	0.1000000
NODE_1564_length_1821_cov_7.682346	1006	1086	12	18	80	0.2250000
NODE_1566_length_1820_cov_12.061592	477	557	6	12	80	0.1500000
NODE_1566_length_1820_cov_12.061592	477	557	8	50	80	0.6250000
NODE_1566_length_1820_cov_12.061592	477	557	14	18	80	0.2250000
NODE_1566_length_1820_cov_12.061592	530	610	6	20	80	0.2500000
NODE_1566_length_1820_cov_12.061592	530	610	8	9	80	0.1125000
NODE_1566_length_1820_cov_12.061592	530	610	12	11	80	0.1375000
NODE_1566_length_1820_cov_12.061592	530	610	14	40	80	0.5000000
NODE_1566_length_1820_cov_12.061592	1232	1312	0	80	80	1.0000000
NODE_1566_length_1820_cov_12.061592	1285	1365	0	80	80	1.0000000
NODE_1572_length_1817_cov_8.302095	63	122	0	4	59	0.0677966
NODE_1572_length_1817_cov_8.302095	63	122	10	15	59	0.2542373
NODE_1572_length_1817_cov_8.302095	63	122	16	40	59	0.6779661
NODE_1572_length_1817_cov_8.302095	1195	1275	0	80	80	1.0000000
NODE_1572_length_1817_cov_8.302095	1248	1328	0	80	80	1.0000000
NODE_1573_length_1816_cov_25.489225	1059	1139	0	80	80	1.0000000
NODE_1573_length_1816_cov_25.489225	1112	1192	0	80	80	1.0000000
NODE_1578_length_1812_cov_11.453006	398	427	0	1	29	0.0344828
NODE_1578_length_1812_cov_11.453006	398	427	2	2	29	0.0689655
NODE_1578_length_1812_cov_11.453006	398	427	6	26	29	0.8965517
NODE_1578_length_1812_cov_11.453006	400	480	0	1	80	0.0125000
NODE_1578_length_1812_cov_11.453006	400	480	6	79	80	0.9875000
NODE_1586_length_1807_cov_3.977752	1743	1807	0	64	64	1.0000000
NODE_1590_length_1806_cov_2.681312	1461	1541	4	17	80	0.2125000
NODE_1590_length_1806_cov_2.681312	1461	1541	6	3	80	0.0375000
NODE_1590_length_1806_cov_2.681312	1461	1541	8	7	80	0.0875000
NODE_1590_length_1806_cov_2.681312	1461	1541	10	19	80	0.2375000
NODE_1590_length_1806_cov_2.681312	1461	1541	14	3	80	0.0375000
NODE_1590_length_1806_cov_2.681312	1461	1541	16	6	80	0.0750000
NODE_1590_length_1806_cov_2.681312	1461	1541	19	1	80	0.0125000
NODE_1590_length_1806_cov_2.681312	1461	1541	22	4	80	0.0500000
NODE_1590_length_1806_cov_2.681312	1461	1541	26	13	80	0.1625000
NODE_1590_length_1806_cov_2.681312	1461	1541	28	7	80	0.0875000
NODE_1590_length_1806_cov_2.681312	1517	1594	0	6	77	0.0779221
NODE_1590_length_1806_cov_2.681312	1517	1594	2	2	77	0.0259740
NODE_1590_length_1806_cov_2.681312	1517	1594	3	1	77	0.0129870
NODE_1590_length_1806_cov_2.681312	1517	1594	4	61	77	0.7922078
NODE_1590_length_1806_cov_2.681312	1517	1594	6	3	77	0.0389610
NODE_1590_length_1806_cov_2.681312	1517	1594	8	4	77	0.0519481
NODE_1593_length_1805_cov_10.271395	258	329	0	71	71	1.0000000
NODE_1593_length_1805_cov_10.271395	311	391	0	80	80	1.0000000
NODE_1598_length_1802_cov_11.546682	1284	1364	0	80	80	1.0000000
NODE_1598_length_1802_cov_11.546682	1337	1417	0	80	80	1.0000000
NODE_1600_length_1801_cov_12.145711	85	165	37	13	80	0.1625000
NODE_1600_length_1801_cov_12.145711	85	165	39	2	80	0.0250000
NODE_1600_length_1801_cov_12.145711	85	165	43	3	80	0.0375000
NODE_1600_length_1801_cov_12.145711	85	165	47	4	80	0.0500000
NODE_1600_length_1801_cov_12.145711	85	165	49	7	80	0.0875000
NODE_1600_length_1801_cov_12.145711	85	165	51	8	80	0.1000000
NODE_1600_length_1801_cov_12.145711	85	165	57	5	80	0.0625000
NODE_1600_length_1801_cov_12.145711	85	165	58	4	80	0.0500000
NODE_1600_length_1801_cov_12.145711	85	165	59	19	80	0.2375000
NODE_1600_length_1801_cov_12.145711	85	165	60	15	80	0.1875000
NODE_1600_length_1801_cov_12.145711	138	218	2	2	80	0.0250000
NODE_1600_length_1801_cov_12.145711	138	218	7	4	80	0.0500000
NODE_1600_length_1801_cov_12.145711	138	218	9	2	80	0.0250000
NODE_1600_length_1801_cov_12.145711	138	218	11	1	80	0.0125000
NODE_1600_length_1801_cov_12.145711	138	218	15	1	80	0.0125000
NODE_1600_length_1801_cov_12.145711	138	218	19	14	80	0.1750000
NODE_1600_length_1801_cov_12.145711	138	218	21	4	80	0.0500000
NODE_1600_length_1801_cov_12.145711	138	218	25	3	80	0.0375000
NODE_1600_length_1801_cov_12.145711	138	218	31	1	80	0.0125000
NODE_1600_length_1801_cov_12.145711	138	218	33	8	80	0.1000000
NODE_1600_length_1801_cov_12.145711	138	218	39	3	80	0.0375000
NODE_1600_length_1801_cov_12.145711	138	218	49	10	80	0.1250000
NODE_1600_length_1801_cov_12.145711	138	218	51	4	80	0.0500000
NODE_1600_length_1801_cov_12.145711	138	218	57	2	80	0.0250000
NODE_1600_length_1801_cov_12.145711	138	218	58	3	80	0.0375000
NODE_1600_length_1801_cov_12.145711	138	218	59	3	80	0.0375000
NODE_1600_length_1801_cov_12.145711	138	218	60	15	80	0.1875000
NODE_1601_length_1801_cov_9.793184	1010	1090	8	11	80	0.1375000
NODE_1601_length_1801_cov_9.793184	1010	1090	10	4	80	0.0500000
NODE_1601_length_1801_cov_9.793184	1010	1090	12	3	80	0.0375000
NODE_1601_length_1801_cov_9.793184	1010	1090	15	20	80	0.2500000
NODE_1601_length_1801_cov_9.793184	1010	1090	17	9	80	0.1125000
NODE_1601_length_1801_cov_9.793184	1010	1090	19	1	80	0.0125000
NODE_1601_length_1801_cov_9.793184	1010	1090	21	12	80	0.1500000
NODE_1601_length_1801_cov_9.793184	1010	1090	23	20	80	0.2500000
NODE_1601_length_1801_cov_9.793184	1063	1143	2	11	80	0.1375000
NODE_1601_length_1801_cov_9.793184	1063	1143	4	35	80	0.4375000
NODE_1601_length_1801_cov_9.793184	1063	1143	6	7	80	0.0875000
NODE_1601_length_1801_cov_9.793184	1063	1143	8	11	80	0.1375000
NODE_1601_length_1801_cov_9.793184	1063	1143	10	4	80	0.0500000
NODE_1601_length_1801_cov_9.793184	1063	1143	12	3	80	0.0375000
NODE_1601_length_1801_cov_9.793184	1063	1143	15	9	80	0.1125000
NODE_1604_length_1800_cov_15.074662	695	775	0	80	80	1.0000000
NODE_1604_length_1800_cov_15.074662	755	826	0	71	71	1.0000000
NODE_1605_length_1800_cov_7.281599	10	74	35	1	64	0.0156250
NODE_1605_length_1800_cov_7.281599	10	74	41	1	64	0.0156250
NODE_1605_length_1800_cov_7.281599	10	74	48	1	64	0.0156250
NODE_1605_length_1800_cov_7.281599	10	74	52	10	64	0.1562500
NODE_1605_length_1800_cov_7.281599	10	74	55	5	64	0.0781250
NODE_1605_length_1800_cov_7.281599	10	74	63	1	64	0.0156250
NODE_1605_length_1800_cov_7.281599	10	74	69	1	64	0.0156250
NODE_1605_length_1800_cov_7.281599	10	74	71	14	64	0.2187500
NODE_1605_length_1800_cov_7.281599	10	74	73	2	64	0.0312500
NODE_1605_length_1800_cov_7.281599	10	74	75	4	64	0.0625000
NODE_1605_length_1800_cov_7.281599	10	74	76	3	64	0.0468750
NODE_1605_length_1800_cov_7.281599	10	74	85	1	64	0.0156250
NODE_1605_length_1800_cov_7.281599	10	74	86	3	64	0.0468750
NODE_1605_length_1800_cov_7.281599	10	74	88	3	64	0.0468750
NODE_1605_length_1800_cov_7.281599	10	74	92	2	64	0.0312500
NODE_1605_length_1800_cov_7.281599	10	74	95	4	64	0.0625000
NODE_1605_length_1800_cov_7.281599	10	74	97	1	64	0.0156250
NODE_1605_length_1800_cov_7.281599	10	74	99	6	64	0.0937500
NODE_1605_length_1800_cov_7.281599	10	74	107	1	64	0.0156250
NODE_1605_length_1800_cov_7.281599	10	74	35	1	64	0.0156250
NODE_1605_length_1800_cov_7.281599	10	74	41	1	64	0.0156250
NODE_1605_length_1800_cov_7.281599	10	74	48	1	64	0.0156250
NODE_1605_length_1800_cov_7.281599	10	74	52	10	64	0.1562500
NODE_1605_length_1800_cov_7.281599	10	74	55	5	64	0.0781250
NODE_1605_length_1800_cov_7.281599	10	74	63	1	64	0.0156250
NODE_1605_length_1800_cov_7.281599	10	74	69	1	64	0.0156250
NODE_1605_length_1800_cov_7.281599	10	74	71	14	64	0.2187500
NODE_1605_length_1800_cov_7.281599	10	74	73	2	64	0.0312500
NODE_1605_length_1800_cov_7.281599	10	74	75	4	64	0.0625000
NODE_1605_length_1800_cov_7.281599	10	74	76	3	64	0.0468750
NODE_1605_length_1800_cov_7.281599	10	74	85	1	64	0.0156250
NODE_1605_length_1800_cov_7.281599	10	74	86	3	64	0.0468750
NODE_1605_length_1800_cov_7.281599	10	74	88	3	64	0.0468750
NODE_1605_length_1800_cov_7.281599	10	74	92	2	64	0.0312500
NODE_1605_length_1800_cov_7.281599	10	74	95	4	64	0.0625000
NODE_1605_length_1800_cov_7.281599	10	74	97	1	64	0.0156250
NODE_1605_length_1800_cov_7.281599	10	74	99	6	64	0.0937500
NODE_1605_length_1800_cov_7.281599	10	74	107	1	64	0.0156250
NODE_1605_length_1800_cov_7.281599	10	74	35	1	64	0.0156250
NODE_1605_length_1800_cov_7.281599	10	74	41	1	64	0.0156250
NODE_1605_length_1800_cov_7.281599	10	74	48	1	64	0.0156250
NODE_1605_length_1800_cov_7.281599	10	74	52	10	64	0.1562500
NODE_1605_length_1800_cov_7.281599	10	74	55	5	64	0.0781250
NODE_1605_length_1800_cov_7.281599	10	74	63	1	64	0.0156250
NODE_1605_length_1800_cov_7.281599	10	74	69	1	64	0.0156250
NODE_1605_length_1800_cov_7.281599	10	74	71	14	64	0.2187500
NODE_1605_length_1800_cov_7.281599	10	74	73	2	64	0.0312500
NODE_1605_length_1800_cov_7.281599	10	74	75	4	64	0.0625000
NODE_1605_length_1800_cov_7.281599	10	74	76	3	64	0.0468750
NODE_1605_length_1800_cov_7.281599	10	74	85	1	64	0.0156250
NODE_1605_length_1800_cov_7.281599	10	74	86	3	64	0.0468750
NODE_1605_length_1800_cov_7.281599	10	74	88	3	64	0.0468750
NODE_1605_length_1800_cov_7.281599	10	74	92	2	64	0.0312500
NODE_1605_length_1800_cov_7.281599	10	74	95	4	64	0.0625000
NODE_1605_length_1800_cov_7.281599	10	74	97	1	64	0.0156250
NODE_1605_length_1800_cov_7.281599	10	74	99	6	64	0.0937500
NODE_1605_length_1800_cov_7.281599	10	74	107	1	64	0.0156250
NODE_1605_length_1800_cov_7.281599	47	127	75	3	80	0.0375000
NODE_1605_length_1800_cov_7.281599	47	127	76	3	80	0.0375000
NODE_1605_length_1800_cov_7.281599	47	127	85	1	80	0.0125000
NODE_1605_length_1800_cov_7.281599	47	127	86	3	80	0.0375000
NODE_1605_length_1800_cov_7.281599	47	127	88	3	80	0.0375000
NODE_1605_length_1800_cov_7.281599	47	127	92	2	80	0.0250000
NODE_1605_length_1800_cov_7.281599	47	127	95	4	80	0.0500000
NODE_1605_length_1800_cov_7.281599	47	127	97	3	80	0.0375000
NODE_1605_length_1800_cov_7.281599	47	127	99	6	80	0.0750000
NODE_1605_length_1800_cov_7.281599	47	127	105	7	80	0.0875000
NODE_1605_length_1800_cov_7.281599	47	127	107	2	80	0.0250000
NODE_1605_length_1800_cov_7.281599	47	127	108	4	80	0.0500000
NODE_1605_length_1800_cov_7.281599	47	127	109	1	80	0.0125000
NODE_1605_length_1800_cov_7.281599	47	127	110	1	80	0.0125000
NODE_1605_length_1800_cov_7.281599	47	127	112	19	80	0.2375000
NODE_1605_length_1800_cov_7.281599	47	127	113	1	80	0.0125000
NODE_1605_length_1800_cov_7.281599	47	127	115	9	80	0.1125000
NODE_1605_length_1800_cov_7.281599	47	127	116	8	80	0.1000000
NODE_1605_length_1800_cov_7.281599	63	126	95	3	63	0.0476190
NODE_1605_length_1800_cov_7.281599	63	126	97	2	63	0.0317460
NODE_1605_length_1800_cov_7.281599	63	126	99	6	63	0.0952381
NODE_1605_length_1800_cov_7.281599	63	126	105	7	63	0.1111111
NODE_1605_length_1800_cov_7.281599	63	126	107	2	63	0.0317460
NODE_1605_length_1800_cov_7.281599	63	126	108	4	63	0.0634921
NODE_1605_length_1800_cov_7.281599	63	126	109	1	63	0.0158730
NODE_1605_length_1800_cov_7.281599	63	126	110	1	63	0.0158730
NODE_1605_length_1800_cov_7.281599	63	126	112	19	63	0.3015873
NODE_1605_length_1800_cov_7.281599	63	126	113	1	63	0.0158730
NODE_1605_length_1800_cov_7.281599	63	126	115	9	63	0.1428571
NODE_1605_length_1800_cov_7.281599	63	126	116	8	63	0.1269841
NODE_1616_length_1793_cov_16.161157	539	619	0	39	80	0.4875000
NODE_1616_length_1793_cov_16.161157	539	619	2	11	80	0.1375000
NODE_1616_length_1793_cov_16.161157	539	619	4	30	80	0.3750000
NODE_1616_length_1793_cov_16.161157	592	672	0	12	80	0.1500000
NODE_1616_length_1793_cov_16.161157	592	672	2	11	80	0.1375000
NODE_1616_length_1793_cov_16.161157	592	672	4	57	80	0.7125000
NODE_1616_length_1793_cov_16.161157	1202	1281	2	79	79	1.0000000
NODE_1616_length_1793_cov_16.161157	1254	1335	0	13	81	0.1604938
NODE_1616_length_1793_cov_16.161157	1254	1335	2	68	81	0.8395061
NODE_1617_length_1793_cov_14.322904	521	601	0	80	80	1.0000000
NODE_1617_length_1793_cov_14.322904	574	654	0	80	80	1.0000000
NODE_1617_length_1793_cov_14.322904	1230	1310	2	9	80	0.1125000
NODE_1617_length_1793_cov_14.322904	1230	1310	4	17	80	0.2125000
NODE_1617_length_1793_cov_14.322904	1230	1310	14	54	80	0.6750000
NODE_1618_length_1791_cov_5.516548	1190	1261	0	71	71	1.0000000
NODE_1621_length_1790_cov_4.282082	684	764	0	80	80	1.0000000
NODE_1621_length_1790_cov_4.282082	737	817	0	80	80	1.0000000
NODE_1623_length_1788_cov_39.558911	385	465	0	80	80	1.0000000
NODE_1623_length_1788_cov_39.558911	438	518	0	80	80	1.0000000
NODE_1623_length_1788_cov_39.558911	514	594	0	80	80	1.0000000
NODE_1623_length_1788_cov_39.558911	567	647	0	80	80	1.0000000
NODE_1624_length_1787_cov_44.927133	530	610	20	5	80	0.0625000
NODE_1624_length_1787_cov_44.927133	530	610	21	2	80	0.0250000
NODE_1624_length_1787_cov_44.927133	530	610	22	3	80	0.0375000
NODE_1624_length_1787_cov_44.927133	530	610	23	9	80	0.1125000
NODE_1624_length_1787_cov_44.927133	530	610	24	5	80	0.0625000
NODE_1624_length_1787_cov_44.927133	530	610	25	1	80	0.0125000
NODE_1624_length_1787_cov_44.927133	530	610	26	2	80	0.0250000
NODE_1624_length_1787_cov_44.927133	530	610	27	4	80	0.0500000
NODE_1624_length_1787_cov_44.927133	530	610	30	1	80	0.0125000
NODE_1624_length_1787_cov_44.927133	530	610	31	3	80	0.0375000
NODE_1624_length_1787_cov_44.927133	530	610	43	1	80	0.0125000
NODE_1624_length_1787_cov_44.927133	530	610	47	2	80	0.0250000
NODE_1624_length_1787_cov_44.927133	530	610	49	1	80	0.0125000
NODE_1624_length_1787_cov_44.927133	530	610	51	1	80	0.0125000
NODE_1624_length_1787_cov_44.927133	530	610	52	1	80	0.0125000
NODE_1624_length_1787_cov_44.927133	530	610	53	1	80	0.0125000
NODE_1624_length_1787_cov_44.927133	530	610	54	18	80	0.2250000
NODE_1624_length_1787_cov_44.927133	530	610	56	5	80	0.0625000
NODE_1624_length_1787_cov_44.927133	530	610	58	1	80	0.0125000
NODE_1624_length_1787_cov_44.927133	530	610	60	2	80	0.0250000
NODE_1624_length_1787_cov_44.927133	530	610	62	4	80	0.0500000
NODE_1624_length_1787_cov_44.927133	530	610	64	8	80	0.1000000
NODE_1625_length_1787_cov_2.752370	675	755	0	80	80	1.0000000
NODE_1625_length_1787_cov_2.752370	728	806	0	78	78	1.0000000
NODE_1626_length_1786_cov_13.459395	523	603	0	4	80	0.0500000
NODE_1626_length_1786_cov_13.459395	523	603	2	4	80	0.0500000
NODE_1626_length_1786_cov_13.459395	523	603	9	52	80	0.6500000
NODE_1626_length_1786_cov_13.459395	523	603	10	9	80	0.1125000
NODE_1626_length_1786_cov_13.459395	523	603	12	11	80	0.1375000
NODE_1626_length_1786_cov_13.459395	576	656	9	7	80	0.0875000
NODE_1626_length_1786_cov_13.459395	576	656	10	62	80	0.7750000
NODE_1626_length_1786_cov_13.459395	576	656	12	11	80	0.1375000
NODE_1633_length_1784_cov_40.769733	358	438	0	80	80	1.0000000
NODE_1633_length_1784_cov_40.769733	411	491	0	80	80	1.0000000
NODE_1633_length_1784_cov_40.769733	1057	1137	2	43	80	0.5375000
NODE_1633_length_1784_cov_40.769733	1057	1137	4	37	80	0.4625000
NODE_1633_length_1784_cov_40.769733	1110	1190	2	11	80	0.1375000
NODE_1633_length_1784_cov_40.769733	1110	1190	4	69	80	0.8625000
NODE_1633_length_1784_cov_40.769733	1186	1266	0	49	80	0.6125000
NODE_1633_length_1784_cov_40.769733	1186	1266	2	24	80	0.3000000
NODE_1633_length_1784_cov_40.769733	1186	1266	4	7	80	0.0875000
NODE_1633_length_1784_cov_40.769733	1239	1319	0	80	80	1.0000000
NODE_1634_length_1784_cov_6.049258	1646	1725	2	42	79	0.5316456
NODE_1634_length_1784_cov_6.049258	1646	1725	4	37	79	0.4683544
NODE_1637_length_1783_cov_45.569477	600	680	0	80	80	1.0000000
NODE_1637_length_1783_cov_45.569477	653	733	0	80	80	1.0000000
NODE_1640_length_1780_cov_21.089233	361	441	0	80	80	1.0000000
NODE_1640_length_1780_cov_21.089233	414	494	0	80	80	1.0000000
NODE_1640_length_1780_cov_21.089233	1031	1104	2	6	73	0.0821918
NODE_1640_length_1780_cov_21.089233	1031	1104	4	19	73	0.2602740
NODE_1640_length_1780_cov_21.089233	1031	1104	6	23	73	0.3150685
NODE_1640_length_1780_cov_21.089233	1031	1104	10	1	73	0.0136986
NODE_1640_length_1780_cov_21.089233	1031	1104	11	6	73	0.0821918
NODE_1640_length_1780_cov_21.089233	1031	1104	13	6	73	0.0821918
NODE_1640_length_1780_cov_21.089233	1031	1104	15	12	73	0.1643836
NODE_1640_length_1780_cov_21.089233	1071	1112	6	8	41	0.1951219
NODE_1640_length_1780_cov_21.089233	1071	1112	10	1	41	0.0243902
NODE_1640_length_1780_cov_21.089233	1071	1112	11	6	41	0.1463415
NODE_1640_length_1780_cov_21.089233	1071	1112	13	6	41	0.1463415
NODE_1640_length_1780_cov_21.089233	1071	1112	15	14	41	0.3414634
NODE_1640_length_1780_cov_21.089233	1071	1112	17	4	41	0.0975610
NODE_1640_length_1780_cov_21.089233	1071	1112	19	2	41	0.0487805
NODE_1641_length_1780_cov_7.837597	1682	1747	0	65	65	1.0000000
NODE_1649_length_1778_cov_52.804050	1528	1568	0	1	40	0.0250000
NODE_1649_length_1778_cov_52.804050	1528	1568	2	2	40	0.0500000
NODE_1649_length_1778_cov_52.804050	1528	1568	4	2	40	0.0500000
NODE_1649_length_1778_cov_52.804050	1528	1568	6	3	40	0.0750000
NODE_1649_length_1778_cov_52.804050	1528	1568	15	1	40	0.0250000
NODE_1649_length_1778_cov_52.804050	1528	1568	17	2	40	0.0500000
NODE_1649_length_1778_cov_52.804050	1528	1568	21	4	40	0.1000000
NODE_1649_length_1778_cov_52.804050	1528	1568	23	1	40	0.0250000
NODE_1649_length_1778_cov_52.804050	1528	1568	27	3	40	0.0750000
NODE_1649_length_1778_cov_52.804050	1528	1568	31	2	40	0.0500000
NODE_1649_length_1778_cov_52.804050	1528	1568	32	4	40	0.1000000
NODE_1649_length_1778_cov_52.804050	1528	1568	36	4	40	0.1000000
NODE_1649_length_1778_cov_52.804050	1528	1568	39	1	40	0.0250000
NODE_1649_length_1778_cov_52.804050	1528	1568	40	4	40	0.1000000
NODE_1649_length_1778_cov_52.804050	1528	1568	44	6	40	0.1500000
NODE_1649_length_1778_cov_52.804050	1541	1621	21	2	80	0.0250000
NODE_1649_length_1778_cov_52.804050	1541	1621	23	1	80	0.0125000
NODE_1649_length_1778_cov_52.804050	1541	1621	27	3	80	0.0375000
NODE_1649_length_1778_cov_52.804050	1541	1621	31	2	80	0.0250000
NODE_1649_length_1778_cov_52.804050	1541	1621	32	4	80	0.0500000
NODE_1649_length_1778_cov_52.804050	1541	1621	36	4	80	0.0500000
NODE_1649_length_1778_cov_52.804050	1541	1621	39	1	80	0.0125000
NODE_1649_length_1778_cov_52.804050	1541	1621	40	4	80	0.0500000
NODE_1649_length_1778_cov_52.804050	1541	1621	44	6	80	0.0750000
NODE_1649_length_1778_cov_52.804050	1541	1621	48	4	80	0.0500000
NODE_1649_length_1778_cov_52.804050	1541	1621	52	3	80	0.0375000
NODE_1649_length_1778_cov_52.804050	1541	1621	54	16	80	0.2000000
NODE_1649_length_1778_cov_52.804050	1541	1621	58	10	80	0.1250000
NODE_1649_length_1778_cov_52.804050	1541	1621	62	18	80	0.2250000
NODE_1649_length_1778_cov_52.804050	1541	1621	64	2	80	0.0250000
NODE_1649_length_1778_cov_52.804050	1541	1621	21	2	80	0.0250000
NODE_1649_length_1778_cov_52.804050	1541	1621	23	1	80	0.0125000
NODE_1649_length_1778_cov_52.804050	1541	1621	27	3	80	0.0375000
NODE_1649_length_1778_cov_52.804050	1541	1621	31	2	80	0.0250000
NODE_1649_length_1778_cov_52.804050	1541	1621	32	4	80	0.0500000
NODE_1649_length_1778_cov_52.804050	1541	1621	36	4	80	0.0500000
NODE_1649_length_1778_cov_52.804050	1541	1621	39	1	80	0.0125000
NODE_1649_length_1778_cov_52.804050	1541	1621	40	4	80	0.0500000
NODE_1649_length_1778_cov_52.804050	1541	1621	44	6	80	0.0750000
NODE_1649_length_1778_cov_52.804050	1541	1621	48	4	80	0.0500000
NODE_1649_length_1778_cov_52.804050	1541	1621	52	3	80	0.0375000
NODE_1649_length_1778_cov_52.804050	1541	1621	54	16	80	0.2000000
NODE_1649_length_1778_cov_52.804050	1541	1621	58	10	80	0.1250000
NODE_1649_length_1778_cov_52.804050	1541	1621	62	18	80	0.2250000
NODE_1649_length_1778_cov_52.804050	1541	1621	64	2	80	0.0250000
NODE_1649_length_1778_cov_52.804050	1541	1621	21	2	80	0.0250000
NODE_1649_length_1778_cov_52.804050	1541	1621	23	1	80	0.0125000
NODE_1649_length_1778_cov_52.804050	1541	1621	27	3	80	0.0375000
NODE_1649_length_1778_cov_52.804050	1541	1621	31	2	80	0.0250000
NODE_1649_length_1778_cov_52.804050	1541	1621	32	4	80	0.0500000
NODE_1649_length_1778_cov_52.804050	1541	1621	36	4	80	0.0500000
NODE_1649_length_1778_cov_52.804050	1541	1621	39	1	80	0.0125000
NODE_1649_length_1778_cov_52.804050	1541	1621	40	4	80	0.0500000
NODE_1649_length_1778_cov_52.804050	1541	1621	44	6	80	0.0750000
NODE_1649_length_1778_cov_52.804050	1541	1621	48	4	80	0.0500000
NODE_1649_length_1778_cov_52.804050	1541	1621	52	3	80	0.0375000
NODE_1649_length_1778_cov_52.804050	1541	1621	54	16	80	0.2000000
NODE_1649_length_1778_cov_52.804050	1541	1621	58	10	80	0.1250000
NODE_1649_length_1778_cov_52.804050	1541	1621	62	18	80	0.2250000
NODE_1649_length_1778_cov_52.804050	1541	1621	64	2	80	0.0250000
NODE_1649_length_1778_cov_52.804050	1541	1621	21	2	80	0.0250000
NODE_1649_length_1778_cov_52.804050	1541	1621	23	1	80	0.0125000
NODE_1649_length_1778_cov_52.804050	1541	1621	27	3	80	0.0375000
NODE_1649_length_1778_cov_52.804050	1541	1621	31	2	80	0.0250000
NODE_1649_length_1778_cov_52.804050	1541	1621	32	4	80	0.0500000
NODE_1649_length_1778_cov_52.804050	1541	1621	36	4	80	0.0500000
NODE_1649_length_1778_cov_52.804050	1541	1621	39	1	80	0.0125000
NODE_1649_length_1778_cov_52.804050	1541	1621	40	4	80	0.0500000
NODE_1649_length_1778_cov_52.804050	1541	1621	44	6	80	0.0750000
NODE_1649_length_1778_cov_52.804050	1541	1621	48	4	80	0.0500000
NODE_1649_length_1778_cov_52.804050	1541	1621	52	3	80	0.0375000
NODE_1649_length_1778_cov_52.804050	1541	1621	54	16	80	0.2000000
NODE_1649_length_1778_cov_52.804050	1541	1621	58	10	80	0.1250000
NODE_1649_length_1778_cov_52.804050	1541	1621	62	18	80	0.2250000
NODE_1649_length_1778_cov_52.804050	1541	1621	64	2	80	0.0250000
NODE_1649_length_1778_cov_52.804050	1541	1621	21	2	80	0.0250000
NODE_1649_length_1778_cov_52.804050	1541	1621	23	1	80	0.0125000
NODE_1649_length_1778_cov_52.804050	1541	1621	27	3	80	0.0375000
NODE_1649_length_1778_cov_52.804050	1541	1621	31	2	80	0.0250000
NODE_1649_length_1778_cov_52.804050	1541	1621	32	4	80	0.0500000
NODE_1649_length_1778_cov_52.804050	1541	1621	36	4	80	0.0500000
NODE_1649_length_1778_cov_52.804050	1541	1621	39	1	80	0.0125000
NODE_1649_length_1778_cov_52.804050	1541	1621	40	4	80	0.0500000
NODE_1649_length_1778_cov_52.804050	1541	1621	44	6	80	0.0750000
NODE_1649_length_1778_cov_52.804050	1541	1621	48	4	80	0.0500000
NODE_1649_length_1778_cov_52.804050	1541	1621	52	3	80	0.0375000
NODE_1649_length_1778_cov_52.804050	1541	1621	54	16	80	0.2000000
NODE_1649_length_1778_cov_52.804050	1541	1621	58	10	80	0.1250000
NODE_1649_length_1778_cov_52.804050	1541	1621	62	18	80	0.2250000
NODE_1649_length_1778_cov_52.804050	1541	1621	64	2	80	0.0250000
NODE_1649_length_1778_cov_52.804050	1541	1621	21	2	80	0.0250000
NODE_1649_length_1778_cov_52.804050	1541	1621	23	1	80	0.0125000
NODE_1649_length_1778_cov_52.804050	1541	1621	27	3	80	0.0375000
NODE_1649_length_1778_cov_52.804050	1541	1621	31	2	80	0.0250000
NODE_1649_length_1778_cov_52.804050	1541	1621	32	4	80	0.0500000
NODE_1649_length_1778_cov_52.804050	1541	1621	36	4	80	0.0500000
NODE_1649_length_1778_cov_52.804050	1541	1621	39	1	80	0.0125000
NODE_1649_length_1778_cov_52.804050	1541	1621	40	4	80	0.0500000
NODE_1649_length_1778_cov_52.804050	1541	1621	44	6	80	0.0750000
NODE_1649_length_1778_cov_52.804050	1541	1621	48	4	80	0.0500000
NODE_1649_length_1778_cov_52.804050	1541	1621	52	3	80	0.0375000
NODE_1649_length_1778_cov_52.804050	1541	1621	54	16	80	0.2000000
NODE_1649_length_1778_cov_52.804050	1541	1621	58	10	80	0.1250000
NODE_1649_length_1778_cov_52.804050	1541	1621	62	18	80	0.2250000
NODE_1649_length_1778_cov_52.804050	1541	1621	64	2	80	0.0250000
NODE_1649_length_1778_cov_52.804050	1617	1697	31	10	80	0.1250000
NODE_1649_length_1778_cov_52.804050	1617	1697	33	1	80	0.0125000
NODE_1649_length_1778_cov_52.804050	1617	1697	34	8	80	0.1000000
NODE_1649_length_1778_cov_52.804050	1617	1697	36	3	80	0.0375000
NODE_1649_length_1778_cov_52.804050	1617	1697	40	3	80	0.0375000
NODE_1649_length_1778_cov_52.804050	1617	1697	42	5	80	0.0625000
NODE_1649_length_1778_cov_52.804050	1617	1697	44	1	80	0.0125000
NODE_1649_length_1778_cov_52.804050	1617	1697	48	2	80	0.0250000
NODE_1649_length_1778_cov_52.804050	1617	1697	50	1	80	0.0125000
NODE_1649_length_1778_cov_52.804050	1617	1697	54	1	80	0.0125000
NODE_1649_length_1778_cov_52.804050	1617	1697	56	1	80	0.0125000
NODE_1649_length_1778_cov_52.804050	1617	1697	57	1	80	0.0125000
NODE_1649_length_1778_cov_52.804050	1617	1697	58	11	80	0.1375000
NODE_1649_length_1778_cov_52.804050	1617	1697	60	1	80	0.0125000
NODE_1649_length_1778_cov_52.804050	1617	1697	62	9	80	0.1125000
NODE_1649_length_1778_cov_52.804050	1617	1697	64	13	80	0.1625000
NODE_1649_length_1778_cov_52.804050	1617	1697	66	4	80	0.0500000
NODE_1649_length_1778_cov_52.804050	1617	1697	69	1	80	0.0125000
NODE_1649_length_1778_cov_52.804050	1617	1697	70	4	80	0.0500000
NODE_1649_length_1778_cov_52.804050	1617	1697	31	10	80	0.1250000
NODE_1649_length_1778_cov_52.804050	1617	1697	33	1	80	0.0125000
NODE_1649_length_1778_cov_52.804050	1617	1697	34	8	80	0.1000000
NODE_1649_length_1778_cov_52.804050	1617	1697	36	3	80	0.0375000
NODE_1649_length_1778_cov_52.804050	1617	1697	40	3	80	0.0375000
NODE_1649_length_1778_cov_52.804050	1617	1697	42	5	80	0.0625000
NODE_1649_length_1778_cov_52.804050	1617	1697	44	1	80	0.0125000
NODE_1649_length_1778_cov_52.804050	1617	1697	48	2	80	0.0250000
NODE_1649_length_1778_cov_52.804050	1617	1697	50	1	80	0.0125000
NODE_1649_length_1778_cov_52.804050	1617	1697	54	1	80	0.0125000
NODE_1649_length_1778_cov_52.804050	1617	1697	56	1	80	0.0125000
NODE_1649_length_1778_cov_52.804050	1617	1697	57	1	80	0.0125000
NODE_1649_length_1778_cov_52.804050	1617	1697	58	11	80	0.1375000
NODE_1649_length_1778_cov_52.804050	1617	1697	60	1	80	0.0125000
NODE_1649_length_1778_cov_52.804050	1617	1697	62	9	80	0.1125000
NODE_1649_length_1778_cov_52.804050	1617	1697	64	13	80	0.1625000
NODE_1649_length_1778_cov_52.804050	1617	1697	66	4	80	0.0500000
NODE_1649_length_1778_cov_52.804050	1617	1697	69	1	80	0.0125000
NODE_1649_length_1778_cov_52.804050	1617	1697	70	4	80	0.0500000
NODE_1649_length_1778_cov_52.804050	1617	1697	31	10	80	0.1250000
NODE_1649_length_1778_cov_52.804050	1617	1697	33	1	80	0.0125000
NODE_1649_length_1778_cov_52.804050	1617	1697	34	8	80	0.1000000
NODE_1649_length_1778_cov_52.804050	1617	1697	36	3	80	0.0375000
NODE_1649_length_1778_cov_52.804050	1617	1697	40	3	80	0.0375000
NODE_1649_length_1778_cov_52.804050	1617	1697	42	5	80	0.0625000
NODE_1649_length_1778_cov_52.804050	1617	1697	44	1	80	0.0125000
NODE_1649_length_1778_cov_52.804050	1617	1697	48	2	80	0.0250000
NODE_1649_length_1778_cov_52.804050	1617	1697	50	1	80	0.0125000
NODE_1649_length_1778_cov_52.804050	1617	1697	54	1	80	0.0125000
NODE_1649_length_1778_cov_52.804050	1617	1697	56	1	80	0.0125000
NODE_1649_length_1778_cov_52.804050	1617	1697	57	1	80	0.0125000
NODE_1649_length_1778_cov_52.804050	1617	1697	58	11	80	0.1375000
NODE_1649_length_1778_cov_52.804050	1617	1697	60	1	80	0.0125000
NODE_1649_length_1778_cov_52.804050	1617	1697	62	9	80	0.1125000
NODE_1649_length_1778_cov_52.804050	1617	1697	64	13	80	0.1625000
NODE_1649_length_1778_cov_52.804050	1617	1697	66	4	80	0.0500000
NODE_1649_length_1778_cov_52.804050	1617	1697	69	1	80	0.0125000
NODE_1649_length_1778_cov_52.804050	1617	1697	70	4	80	0.0500000
NODE_1649_length_1778_cov_52.804050	1617	1697	31	10	80	0.1250000
NODE_1649_length_1778_cov_52.804050	1617	1697	33	1	80	0.0125000
NODE_1649_length_1778_cov_52.804050	1617	1697	34	8	80	0.1000000
NODE_1649_length_1778_cov_52.804050	1617	1697	36	3	80	0.0375000
NODE_1649_length_1778_cov_52.804050	1617	1697	40	3	80	0.0375000
NODE_1649_length_1778_cov_52.804050	1617	1697	42	5	80	0.0625000
NODE_1649_length_1778_cov_52.804050	1617	1697	44	1	80	0.0125000
NODE_1649_length_1778_cov_52.804050	1617	1697	48	2	80	0.0250000
NODE_1649_length_1778_cov_52.804050	1617	1697	50	1	80	0.0125000
NODE_1649_length_1778_cov_52.804050	1617	1697	54	1	80	0.0125000
NODE_1649_length_1778_cov_52.804050	1617	1697	56	1	80	0.0125000
NODE_1649_length_1778_cov_52.804050	1617	1697	57	1	80	0.0125000
NODE_1649_length_1778_cov_52.804050	1617	1697	58	11	80	0.1375000
NODE_1649_length_1778_cov_52.804050	1617	1697	60	1	80	0.0125000
NODE_1649_length_1778_cov_52.804050	1617	1697	62	9	80	0.1125000
NODE_1649_length_1778_cov_52.804050	1617	1697	64	13	80	0.1625000
NODE_1649_length_1778_cov_52.804050	1617	1697	66	4	80	0.0500000
NODE_1649_length_1778_cov_52.804050	1617	1697	69	1	80	0.0125000
NODE_1649_length_1778_cov_52.804050	1617	1697	70	4	80	0.0500000
NODE_1649_length_1778_cov_52.804050	1670	1750	20	2	80	0.0250000
NODE_1649_length_1778_cov_52.804050	1670	1750	22	23	80	0.2875000
NODE_1649_length_1778_cov_52.804050	1670	1750	26	26	80	0.3250000
NODE_1649_length_1778_cov_52.804050	1670	1750	31	12	80	0.1500000
NODE_1649_length_1778_cov_52.804050	1670	1750	33	1	80	0.0125000
NODE_1649_length_1778_cov_52.804050	1670	1750	34	8	80	0.1000000
NODE_1649_length_1778_cov_52.804050	1670	1750	36	3	80	0.0375000
NODE_1649_length_1778_cov_52.804050	1670	1750	40	1	80	0.0125000
NODE_1649_length_1778_cov_52.804050	1670	1750	42	4	80	0.0500000
NODE_1649_length_1778_cov_52.804050	1670	1750	20	2	80	0.0250000
NODE_1649_length_1778_cov_52.804050	1670	1750	22	23	80	0.2875000
NODE_1649_length_1778_cov_52.804050	1670	1750	26	26	80	0.3250000
NODE_1649_length_1778_cov_52.804050	1670	1750	31	12	80	0.1500000
NODE_1649_length_1778_cov_52.804050	1670	1750	33	1	80	0.0125000
NODE_1649_length_1778_cov_52.804050	1670	1750	34	8	80	0.1000000
NODE_1649_length_1778_cov_52.804050	1670	1750	36	3	80	0.0375000
NODE_1649_length_1778_cov_52.804050	1670	1750	40	1	80	0.0125000
NODE_1649_length_1778_cov_52.804050	1670	1750	42	4	80	0.0500000
NODE_1649_length_1778_cov_52.804050	1670	1750	20	2	80	0.0250000
NODE_1649_length_1778_cov_52.804050	1670	1750	22	23	80	0.2875000
NODE_1649_length_1778_cov_52.804050	1670	1750	26	26	80	0.3250000
NODE_1649_length_1778_cov_52.804050	1670	1750	31	12	80	0.1500000
NODE_1649_length_1778_cov_52.804050	1670	1750	33	1	80	0.0125000
NODE_1649_length_1778_cov_52.804050	1670	1750	34	8	80	0.1000000
NODE_1649_length_1778_cov_52.804050	1670	1750	36	3	80	0.0375000
NODE_1649_length_1778_cov_52.804050	1670	1750	40	1	80	0.0125000
NODE_1649_length_1778_cov_52.804050	1670	1750	42	4	80	0.0500000
NODE_1649_length_1778_cov_52.804050	1670	1741	22	16	71	0.2253521
NODE_1649_length_1778_cov_52.804050	1670	1741	26	26	71	0.3661972
NODE_1649_length_1778_cov_52.804050	1670	1741	31	12	71	0.1690141
NODE_1649_length_1778_cov_52.804050	1670	1741	33	1	71	0.0140845
NODE_1649_length_1778_cov_52.804050	1670	1741	34	8	71	0.1126761
NODE_1649_length_1778_cov_52.804050	1670	1741	36	3	71	0.0422535
NODE_1649_length_1778_cov_52.804050	1670	1741	40	1	71	0.0140845
NODE_1649_length_1778_cov_52.804050	1670	1741	42	4	71	0.0563380
NODE_1649_length_1778_cov_52.804050	1673	1743	22	18	70	0.2571429
NODE_1649_length_1778_cov_52.804050	1673	1743	26	26	70	0.3714286
NODE_1649_length_1778_cov_52.804050	1673	1743	31	12	70	0.1714286
NODE_1649_length_1778_cov_52.804050	1673	1743	33	1	70	0.0142857
NODE_1649_length_1778_cov_52.804050	1673	1743	34	8	70	0.1142857
NODE_1649_length_1778_cov_52.804050	1673	1743	36	3	70	0.0428571
NODE_1649_length_1778_cov_52.804050	1673	1743	40	1	70	0.0142857
NODE_1649_length_1778_cov_52.804050	1673	1743	42	1	70	0.0142857
NODE_1649_length_1778_cov_52.804050	1679	1750	20	2	71	0.0281690
NODE_1649_length_1778_cov_52.804050	1679	1750	22	23	71	0.3239437
NODE_1649_length_1778_cov_52.804050	1679	1750	26	26	71	0.3661972
NODE_1649_length_1778_cov_52.804050	1679	1750	31	12	71	0.1690141
NODE_1649_length_1778_cov_52.804050	1679	1750	33	1	71	0.0140845
NODE_1649_length_1778_cov_52.804050	1679	1750	34	6	71	0.0845070
NODE_1649_length_1778_cov_52.804050	1679	1750	36	1	71	0.0140845
NODE_1651_length_1776_cov_43.081694	1246	1308	0	56	62	0.9032258
NODE_1651_length_1776_cov_43.081694	1246	1308	10	3	62	0.0483871
NODE_1651_length_1776_cov_43.081694	1246	1308	15	1	62	0.0161290
NODE_1651_length_1776_cov_43.081694	1246	1308	16	1	62	0.0161290
NODE_1651_length_1776_cov_43.081694	1246	1308	45	1	62	0.0161290
NODE_1651_length_1776_cov_43.081694	1281	1361	0	80	80	1.0000000
NODE_1652_length_1776_cov_9.256410	1120	1200	0	80	80	1.0000000
NODE_1652_length_1776_cov_9.256410	1173	1253	0	80	80	1.0000000
NODE_1652_length_1776_cov_9.256410	1249	1329	0	80	80	1.0000000
NODE_1652_length_1776_cov_9.256410	1302	1382	0	80	80	1.0000000
NODE_1657_length_1775_cov_54.208234	1103	1167	114	4	64	0.0625000
NODE_1657_length_1775_cov_54.208234	1103	1167	118	4	64	0.0625000
NODE_1657_length_1775_cov_54.208234	1103	1167	122	1	64	0.0156250
NODE_1657_length_1775_cov_54.208234	1103	1167	124	2	64	0.0312500
NODE_1657_length_1775_cov_54.208234	1103	1167	126	2	64	0.0312500
NODE_1657_length_1775_cov_54.208234	1103	1167	130	1	64	0.0156250
NODE_1657_length_1775_cov_54.208234	1103	1167	131	1	64	0.0156250
NODE_1657_length_1775_cov_54.208234	1103	1167	132	1	64	0.0156250
NODE_1657_length_1775_cov_54.208234	1103	1167	134	2	64	0.0312500
NODE_1657_length_1775_cov_54.208234	1103	1167	136	3	64	0.0468750
NODE_1657_length_1775_cov_54.208234	1103	1167	140	2	64	0.0312500
NODE_1657_length_1775_cov_54.208234	1103	1167	141	3	64	0.0468750
NODE_1657_length_1775_cov_54.208234	1103	1167	142	5	64	0.0781250
NODE_1657_length_1775_cov_54.208234	1103	1167	143	1	64	0.0156250
NODE_1657_length_1775_cov_54.208234	1103	1167	144	9	64	0.1406250
NODE_1657_length_1775_cov_54.208234	1103	1167	145	1	64	0.0156250
NODE_1657_length_1775_cov_54.208234	1103	1167	146	1	64	0.0156250
NODE_1657_length_1775_cov_54.208234	1103	1167	147	7	64	0.1093750
NODE_1657_length_1775_cov_54.208234	1103	1167	148	10	64	0.1562500
NODE_1657_length_1775_cov_54.208234	1103	1167	150	3	64	0.0468750
NODE_1657_length_1775_cov_54.208234	1103	1167	152	1	64	0.0156250
NODE_1657_length_1775_cov_54.208234	1103	1167	114	4	64	0.0625000
NODE_1657_length_1775_cov_54.208234	1103	1167	118	4	64	0.0625000
NODE_1657_length_1775_cov_54.208234	1103	1167	122	1	64	0.0156250
NODE_1657_length_1775_cov_54.208234	1103	1167	124	2	64	0.0312500
NODE_1657_length_1775_cov_54.208234	1103	1167	126	2	64	0.0312500
NODE_1657_length_1775_cov_54.208234	1103	1167	130	1	64	0.0156250
NODE_1657_length_1775_cov_54.208234	1103	1167	131	1	64	0.0156250
NODE_1657_length_1775_cov_54.208234	1103	1167	132	1	64	0.0156250
NODE_1657_length_1775_cov_54.208234	1103	1167	134	2	64	0.0312500
NODE_1657_length_1775_cov_54.208234	1103	1167	136	3	64	0.0468750
NODE_1657_length_1775_cov_54.208234	1103	1167	140	2	64	0.0312500
NODE_1657_length_1775_cov_54.208234	1103	1167	141	3	64	0.0468750
NODE_1657_length_1775_cov_54.208234	1103	1167	142	5	64	0.0781250
NODE_1657_length_1775_cov_54.208234	1103	1167	143	1	64	0.0156250
NODE_1657_length_1775_cov_54.208234	1103	1167	144	9	64	0.1406250
NODE_1657_length_1775_cov_54.208234	1103	1167	145	1	64	0.0156250
NODE_1657_length_1775_cov_54.208234	1103	1167	146	1	64	0.0156250
NODE_1657_length_1775_cov_54.208234	1103	1167	147	7	64	0.1093750
NODE_1657_length_1775_cov_54.208234	1103	1167	148	10	64	0.1562500
NODE_1657_length_1775_cov_54.208234	1103	1167	150	3	64	0.0468750
NODE_1657_length_1775_cov_54.208234	1103	1167	152	1	64	0.0156250
NODE_1657_length_1775_cov_54.208234	1140	1200	72	1	60	0.0166667
NODE_1657_length_1775_cov_54.208234	1140	1200	76	1	60	0.0166667
NODE_1657_length_1775_cov_54.208234	1140	1200	78	1	60	0.0166667
NODE_1657_length_1775_cov_54.208234	1140	1200	80	4	60	0.0666667
NODE_1657_length_1775_cov_54.208234	1140	1200	83	2	60	0.0333333
NODE_1657_length_1775_cov_54.208234	1140	1200	85	2	60	0.0333333
NODE_1657_length_1775_cov_54.208234	1140	1200	87	7	60	0.1166667
NODE_1657_length_1775_cov_54.208234	1140	1200	89	4	60	0.0666667
NODE_1657_length_1775_cov_54.208234	1140	1200	91	1	60	0.0166667
NODE_1657_length_1775_cov_54.208234	1140	1200	95	1	60	0.0166667
NODE_1657_length_1775_cov_54.208234	1140	1200	97	1	60	0.0166667
NODE_1657_length_1775_cov_54.208234	1140	1200	99	2	60	0.0333333
NODE_1657_length_1775_cov_54.208234	1140	1200	105	4	60	0.0666667
NODE_1657_length_1775_cov_54.208234	1140	1200	107	1	60	0.0166667
NODE_1657_length_1775_cov_54.208234	1140	1200	108	1	60	0.0166667
NODE_1657_length_1775_cov_54.208234	1140	1200	114	4	60	0.0666667
NODE_1657_length_1775_cov_54.208234	1140	1200	118	4	60	0.0666667
NODE_1657_length_1775_cov_54.208234	1140	1200	124	2	60	0.0333333
NODE_1657_length_1775_cov_54.208234	1140	1200	130	1	60	0.0166667
NODE_1657_length_1775_cov_54.208234	1140	1200	132	1	60	0.0166667
NODE_1657_length_1775_cov_54.208234	1140	1200	134	2	60	0.0333333
NODE_1657_length_1775_cov_54.208234	1140	1200	136	3	60	0.0500000
NODE_1657_length_1775_cov_54.208234	1140	1200	140	2	60	0.0333333
NODE_1657_length_1775_cov_54.208234	1140	1200	141	1	60	0.0166667
NODE_1657_length_1775_cov_54.208234	1140	1200	142	1	60	0.0166667
NODE_1657_length_1775_cov_54.208234	1140	1200	144	4	60	0.0666667
NODE_1657_length_1775_cov_54.208234	1140	1200	145	1	60	0.0166667
NODE_1657_length_1775_cov_54.208234	1140	1200	146	1	60	0.0166667
NODE_1658_length_1775_cov_13.181981	1170	1250	0	80	80	1.0000000
NODE_1658_length_1775_cov_13.181981	1223	1303	0	80	80	1.0000000
NODE_1659_length_1775_cov_4.218974	1304	1384	0	80	80	1.0000000
NODE_1659_length_1775_cov_4.218974	1357	1437	0	80	80	1.0000000
NODE_1660_length_1774_cov_48.617313	345	425	4	46	80	0.5750000
NODE_1660_length_1774_cov_48.617313	345	425	6	20	80	0.2500000
NODE_1660_length_1774_cov_48.617313	345	425	8	14	80	0.1750000
NODE_1660_length_1774_cov_48.617313	398	478	0	6	80	0.0750000
NODE_1660_length_1774_cov_48.617313	398	478	4	53	80	0.6625000
NODE_1660_length_1774_cov_48.617313	398	478	6	20	80	0.2500000
NODE_1660_length_1774_cov_48.617313	398	478	8	1	80	0.0125000
NODE_1660_length_1774_cov_48.617313	474	554	0	80	80	1.0000000
NODE_1660_length_1774_cov_48.617313	527	607	0	80	80	1.0000000
NODE_1660_length_1774_cov_48.617313	1027	1107	2	28	80	0.3500000
NODE_1660_length_1774_cov_48.617313	1027	1107	4	52	80	0.6500000
NODE_1660_length_1774_cov_48.617313	1080	1160	0	6	80	0.0750000
NODE_1660_length_1774_cov_48.617313	1080	1160	2	47	80	0.5875000
NODE_1660_length_1774_cov_48.617313	1080	1160	4	27	80	0.3375000
NODE_1660_length_1774_cov_48.617313	1156	1236	0	80	80	1.0000000
NODE_1660_length_1774_cov_48.617313	1209	1289	0	80	80	1.0000000
NODE_1662_length_1774_cov_8.011343	1655	1735	0	80	80	1.0000000
NODE_1663_length_1773_cov_5.547192	433	513	0	9	80	0.1125000
NODE_1663_length_1773_cov_5.547192	433	513	2	3	80	0.0375000
NODE_1663_length_1773_cov_5.547192	433	513	6	68	80	0.8500000
NODE_1663_length_1773_cov_5.547192	486	566	4	48	80	0.6000000
NODE_1663_length_1773_cov_5.547192	486	566	6	32	80	0.4000000
NODE_1664_length_1773_cov_3.925329	267	347	0	80	80	1.0000000
NODE_1664_length_1773_cov_3.925329	320	400	0	80	80	1.0000000
NODE_1666_length_1770_cov_9.912029	369	437	0	68	68	1.0000000
NODE_1666_length_1770_cov_9.912029	388	431	0	43	43	1.0000000
NODE_1666_length_1770_cov_9.912029	509	577	0	68	68	1.0000000
NODE_1666_length_1770_cov_9.912029	515	571	0	56	56	1.0000000
NODE_1666_length_1770_cov_9.912029	579	618	0	39	39	1.0000000
NODE_1666_length_1770_cov_9.912029	697	776	0	45	79	0.5696203
NODE_1666_length_1770_cov_9.912029	697	776	2	34	79	0.4303797
NODE_1666_length_1770_cov_9.912029	714	794	0	63	80	0.7875000
NODE_1666_length_1770_cov_9.912029	714	794	2	17	80	0.2125000
NODE_1666_length_1770_cov_9.912029	767	819	0	52	52	1.0000000
NODE_1666_length_1770_cov_9.912029	785	819	0	34	34	1.0000000
NODE_1667_length_1768_cov_9.134811	687	736	26	1	49	0.0204082
NODE_1667_length_1768_cov_9.134811	687	736	30	18	49	0.3673469
NODE_1667_length_1768_cov_9.134811	687	736	32	17	49	0.3469388
NODE_1667_length_1768_cov_9.134811	687	736	34	3	49	0.0612245
NODE_1667_length_1768_cov_9.134811	687	736	36	6	49	0.1224490
NODE_1667_length_1768_cov_9.134811	687	736	38	4	49	0.0816327
NODE_1668_length_1768_cov_6.605153	1207	1287	0	80	80	1.0000000
NODE_1668_length_1768_cov_6.605153	1260	1340	0	71	80	0.8875000
NODE_1668_length_1768_cov_6.605153	1260	1340	2	9	80	0.1125000
NODE_1668_length_1768_cov_6.605153	1336	1416	2	80	80	1.0000000
NODE_1668_length_1768_cov_6.605153	1389	1469	0	18	80	0.2250000
NODE_1668_length_1768_cov_6.605153	1389	1469	2	62	80	0.7750000
NODE_1669_length_1767_cov_5.475420	508	588	12	6	80	0.0750000
NODE_1669_length_1767_cov_5.475420	508	588	16	31	80	0.3875000
NODE_1669_length_1767_cov_5.475420	508	588	18	27	80	0.3375000
NODE_1669_length_1767_cov_5.475420	508	588	20	4	80	0.0500000
NODE_1669_length_1767_cov_5.475420	508	588	22	12	80	0.1500000
NODE_1680_length_1762_cov_18.673482	606	686	0	80	80	1.0000000
NODE_1680_length_1762_cov_18.673482	659	739	0	80	80	1.0000000
NODE_1680_length_1762_cov_18.673482	735	815	0	28	80	0.3500000
NODE_1680_length_1762_cov_18.673482	735	815	2	19	80	0.2375000
NODE_1680_length_1762_cov_18.673482	735	815	4	33	80	0.4125000
NODE_1680_length_1762_cov_18.673482	788	868	4	80	80	1.0000000
NODE_1681_length_1762_cov_6.760072	1033	1113	0	69	80	0.8625000
NODE_1681_length_1762_cov_6.760072	1033	1113	2	11	80	0.1375000
NODE_1681_length_1762_cov_6.760072	1086	1166	0	80	80	1.0000000
NODE_1685_length_1760_cov_8.064419	941	1021	0	80	80	1.0000000
NODE_1685_length_1760_cov_8.064419	994	1074	0	80	80	1.0000000
NODE_1692_length_1758_cov_99.869198	599	679	0	8	80	0.1000000
NODE_1692_length_1758_cov_99.869198	599	679	2	45	80	0.5625000
NODE_1692_length_1758_cov_99.869198	599	679	4	27	80	0.3375000
NODE_1692_length_1758_cov_99.869198	652	732	4	38	80	0.4750000
NODE_1692_length_1758_cov_99.869198	652	732	6	5	80	0.0625000
NODE_1692_length_1758_cov_99.869198	652	732	10	12	80	0.1500000
NODE_1692_length_1758_cov_99.869198	652	732	12	25	80	0.3125000
NODE_1692_length_1758_cov_99.869198	728	808	4	2	80	0.0250000
NODE_1692_length_1758_cov_99.869198	728	808	6	5	80	0.0625000
NODE_1692_length_1758_cov_99.869198	728	808	8	13	80	0.1625000
NODE_1692_length_1758_cov_99.869198	728	808	10	3	80	0.0375000
NODE_1692_length_1758_cov_99.869198	728	808	12	6	80	0.0750000
NODE_1692_length_1758_cov_99.869198	728	808	14	41	80	0.5125000
NODE_1692_length_1758_cov_99.869198	728	808	16	10	80	0.1250000
NODE_1692_length_1758_cov_99.869198	781	861	0	21	80	0.2625000
NODE_1692_length_1758_cov_99.869198	781	861	2	25	80	0.3125000
NODE_1692_length_1758_cov_99.869198	781	861	4	9	80	0.1125000
NODE_1692_length_1758_cov_99.869198	781	861	6	5	80	0.0625000
NODE_1692_length_1758_cov_99.869198	781	861	8	13	80	0.1625000
NODE_1692_length_1758_cov_99.869198	781	861	10	3	80	0.0375000
NODE_1692_length_1758_cov_99.869198	781	861	14	4	80	0.0500000
NODE_1693_length_1757_cov_3.126659	49	121	0	72	72	1.0000000
NODE_1696_length_1755_cov_9.938406	231	311	0	74	80	0.9250000
NODE_1696_length_1755_cov_9.938406	231	311	2	6	80	0.0750000
NODE_1696_length_1755_cov_9.938406	284	364	0	80	80	1.0000000
NODE_1698_length_1755_cov_3.614130	171	222	2	51	51	1.0000000
NODE_1699_length_1754_cov_8.523263	0	77	0	3	77	0.0389610
NODE_1699_length_1754_cov_8.523263	0	77	1	55	77	0.7142857
NODE_1699_length_1754_cov_8.523263	0	77	2	1	77	0.0129870
NODE_1699_length_1754_cov_8.523263	0	77	3	18	77	0.2337662
NODE_1699_length_1754_cov_8.523263	0	77	0	3	77	0.0389610
NODE_1699_length_1754_cov_8.523263	0	77	1	55	77	0.7142857
NODE_1699_length_1754_cov_8.523263	0	77	2	1	77	0.0129870
NODE_1699_length_1754_cov_8.523263	0	77	3	18	77	0.2337662
NODE_1699_length_1754_cov_8.523263	0	77	0	3	77	0.0389610
NODE_1699_length_1754_cov_8.523263	0	77	1	55	77	0.7142857
NODE_1699_length_1754_cov_8.523263	0	77	2	1	77	0.0129870
NODE_1699_length_1754_cov_8.523263	0	77	3	18	77	0.2337662
NODE_1699_length_1754_cov_8.523263	50	99	1	8	49	0.1632653
NODE_1699_length_1754_cov_8.523263	50	99	2	4	49	0.0816327
NODE_1699_length_1754_cov_8.523263	50	99	3	18	49	0.3673469
NODE_1699_length_1754_cov_8.523263	50	99	6	19	49	0.3877551
NODE_1699_length_1754_cov_8.523263	53	99	1	5	46	0.1086956
NODE_1699_length_1754_cov_8.523263	53	99	2	4	46	0.0869565
NODE_1699_length_1754_cov_8.523263	53	99	3	18	46	0.3913043
NODE_1699_length_1754_cov_8.523263	53	99	6	19	46	0.4130435
NODE_1699_length_1754_cov_8.523263	55	99	1	3	44	0.0681818
NODE_1699_length_1754_cov_8.523263	55	99	2	4	44	0.0909091
NODE_1699_length_1754_cov_8.523263	55	99	3	18	44	0.4090909
NODE_1699_length_1754_cov_8.523263	55	99	6	19	44	0.4318182
NODE_1700_length_1753_cov_26.851874	356	436	0	80	80	1.0000000
NODE_1700_length_1753_cov_26.851874	409	489	0	80	80	1.0000000
NODE_1701_length_1753_cov_12.297461	355	435	0	47	80	0.5875000
NODE_1701_length_1753_cov_12.297461	355	435	2	33	80	0.4125000
NODE_1701_length_1753_cov_12.297461	408	488	2	55	80	0.6875000
NODE_1701_length_1753_cov_12.297461	408	488	4	25	80	0.3125000
NODE_1705_length_1750_cov_90.732283	1191	1254	327	2	63	0.0317460
NODE_1705_length_1750_cov_90.732283	1191	1254	328	1	63	0.0158730
NODE_1705_length_1750_cov_90.732283	1191	1254	329	1	63	0.0158730
NODE_1705_length_1750_cov_90.732283	1191	1254	331	2	63	0.0317460
NODE_1705_length_1750_cov_90.732283	1191	1254	332	2	63	0.0317460
NODE_1705_length_1750_cov_90.732283	1191	1254	335	1	63	0.0158730
NODE_1705_length_1750_cov_90.732283	1191	1254	336	1	63	0.0158730
NODE_1705_length_1750_cov_90.732283	1191	1254	339	1	63	0.0158730
NODE_1705_length_1750_cov_90.732283	1191	1254	345	1	63	0.0158730
NODE_1705_length_1750_cov_90.732283	1191	1254	347	1	63	0.0158730
NODE_1705_length_1750_cov_90.732283	1191	1254	360	1	63	0.0158730
NODE_1705_length_1750_cov_90.732283	1191	1254	382	1	63	0.0158730
NODE_1705_length_1750_cov_90.732283	1191	1254	384	1	63	0.0158730
NODE_1705_length_1750_cov_90.732283	1191	1254	387	1	63	0.0158730
NODE_1705_length_1750_cov_90.732283	1191	1254	390	2	63	0.0317460
NODE_1705_length_1750_cov_90.732283	1191	1254	399	2	63	0.0317460
NODE_1705_length_1750_cov_90.732283	1191	1254	401	1	63	0.0158730
NODE_1705_length_1750_cov_90.732283	1191	1254	402	3	63	0.0476190
NODE_1705_length_1750_cov_90.732283	1191	1254	403	1	63	0.0158730
NODE_1705_length_1750_cov_90.732283	1191	1254	404	1	63	0.0158730
NODE_1705_length_1750_cov_90.732283	1191	1254	406	3	63	0.0476190
NODE_1705_length_1750_cov_90.732283	1191	1254	407	1	63	0.0158730
NODE_1705_length_1750_cov_90.732283	1191	1254	414	1	63	0.0158730
NODE_1705_length_1750_cov_90.732283	1191	1254	416	1	63	0.0158730
NODE_1705_length_1750_cov_90.732283	1191	1254	417	1	63	0.0158730
NODE_1705_length_1750_cov_90.732283	1191	1254	420	1	63	0.0158730
NODE_1705_length_1750_cov_90.732283	1191	1254	421	2	63	0.0317460
NODE_1705_length_1750_cov_90.732283	1191	1254	436	1	63	0.0158730
NODE_1705_length_1750_cov_90.732283	1191	1254	442	1	63	0.0158730
NODE_1705_length_1750_cov_90.732283	1191	1254	450	1	63	0.0158730
NODE_1705_length_1750_cov_90.732283	1191	1254	453	1	63	0.0158730
NODE_1705_length_1750_cov_90.732283	1191	1254	462	1	63	0.0158730
NODE_1705_length_1750_cov_90.732283	1191	1254	471	1	63	0.0158730
NODE_1705_length_1750_cov_90.732283	1191	1254	473	1	63	0.0158730
NODE_1705_length_1750_cov_90.732283	1191	1254	474	1	63	0.0158730
NODE_1705_length_1750_cov_90.732283	1191	1254	479	1	63	0.0158730
NODE_1705_length_1750_cov_90.732283	1191	1254	486	1	63	0.0158730
NODE_1705_length_1750_cov_90.732283	1191	1254	487	1	63	0.0158730
NODE_1705_length_1750_cov_90.732283	1191	1254	488	2	63	0.0317460
NODE_1705_length_1750_cov_90.732283	1191	1254	490	1	63	0.0158730
NODE_1705_length_1750_cov_90.732283	1191	1254	492	3	63	0.0476190
NODE_1705_length_1750_cov_90.732283	1191	1254	493	1	63	0.0158730
NODE_1705_length_1750_cov_90.732283	1191	1254	494	1	63	0.0158730
NODE_1705_length_1750_cov_90.732283	1191	1254	496	3	63	0.0476190
NODE_1705_length_1750_cov_90.732283	1191	1254	508	1	63	0.0158730
NODE_1705_length_1750_cov_90.732283	1191	1254	513	1	63	0.0158730
NODE_1705_length_1750_cov_90.732283	1191	1254	521	1	63	0.0158730
NODE_1705_length_1750_cov_90.732283	1191	1254	526	1	63	0.0158730
NODE_1705_length_1750_cov_90.732283	1239	1310	486	1	71	0.0140845
NODE_1705_length_1750_cov_90.732283	1239	1310	488	2	71	0.0281690
NODE_1705_length_1750_cov_90.732283	1239	1310	490	1	71	0.0140845
NODE_1705_length_1750_cov_90.732283	1239	1310	492	2	71	0.0281690
NODE_1705_length_1750_cov_90.732283	1239	1310	493	1	71	0.0140845
NODE_1705_length_1750_cov_90.732283	1239	1310	494	1	71	0.0140845
NODE_1705_length_1750_cov_90.732283	1239	1310	496	3	71	0.0422535
NODE_1705_length_1750_cov_90.732283	1239	1310	508	1	71	0.0140845
NODE_1705_length_1750_cov_90.732283	1239	1310	513	1	71	0.0140845
NODE_1705_length_1750_cov_90.732283	1239	1310	514	1	71	0.0140845
NODE_1705_length_1750_cov_90.732283	1239	1310	515	2	71	0.0281690
NODE_1705_length_1750_cov_90.732283	1239	1310	518	1	71	0.0140845
NODE_1705_length_1750_cov_90.732283	1239	1310	521	1	71	0.0140845
NODE_1705_length_1750_cov_90.732283	1239	1310	524	1	71	0.0140845
NODE_1705_length_1750_cov_90.732283	1239	1310	525	1	71	0.0140845
NODE_1705_length_1750_cov_90.732283	1239	1310	526	1	71	0.0140845
NODE_1705_length_1750_cov_90.732283	1239	1310	527	2	71	0.0281690
NODE_1705_length_1750_cov_90.732283	1239	1310	528	2	71	0.0281690
NODE_1705_length_1750_cov_90.732283	1239	1310	529	1	71	0.0140845
NODE_1705_length_1750_cov_90.732283	1239	1310	531	1	71	0.0140845
NODE_1705_length_1750_cov_90.732283	1239	1310	533	1	71	0.0140845
NODE_1705_length_1750_cov_90.732283	1239	1310	538	1	71	0.0140845
NODE_1705_length_1750_cov_90.732283	1239	1310	540	1	71	0.0140845
NODE_1705_length_1750_cov_90.732283	1239	1310	543	1	71	0.0140845
NODE_1705_length_1750_cov_90.732283	1239	1310	546	2	71	0.0281690
NODE_1705_length_1750_cov_90.732283	1239	1310	548	1	71	0.0140845
NODE_1705_length_1750_cov_90.732283	1239	1310	550	1	71	0.0140845
NODE_1705_length_1750_cov_90.732283	1239	1310	553	3	71	0.0422535
NODE_1705_length_1750_cov_90.732283	1239	1310	554	1	71	0.0140845
NODE_1705_length_1750_cov_90.732283	1239	1310	555	2	71	0.0281690
NODE_1705_length_1750_cov_90.732283	1239	1310	557	2	71	0.0281690
NODE_1705_length_1750_cov_90.732283	1239	1310	558	1	71	0.0140845
NODE_1705_length_1750_cov_90.732283	1239	1310	559	1	71	0.0140845
NODE_1705_length_1750_cov_90.732283	1239	1310	560	1	71	0.0140845
NODE_1705_length_1750_cov_90.732283	1239	1310	561	3	71	0.0422535
NODE_1705_length_1750_cov_90.732283	1239	1310	566	1	71	0.0140845
NODE_1705_length_1750_cov_90.732283	1239	1310	568	4	71	0.0563380
NODE_1705_length_1750_cov_90.732283	1239	1310	569	1	71	0.0140845
NODE_1705_length_1750_cov_90.732283	1239	1310	570	1	71	0.0140845
NODE_1705_length_1750_cov_90.732283	1239	1310	573	1	71	0.0140845
NODE_1705_length_1750_cov_90.732283	1239	1310	577	1	71	0.0140845
NODE_1705_length_1750_cov_90.732283	1239	1310	580	1	71	0.0140845
NODE_1705_length_1750_cov_90.732283	1239	1310	581	2	71	0.0281690
NODE_1705_length_1750_cov_90.732283	1239	1310	582	1	71	0.0140845
NODE_1705_length_1750_cov_90.732283	1239	1310	586	3	71	0.0422535
NODE_1705_length_1750_cov_90.732283	1239	1310	587	1	71	0.0140845
NODE_1705_length_1750_cov_90.732283	1239	1310	590	1	71	0.0140845
NODE_1705_length_1750_cov_90.732283	1239	1310	593	2	71	0.0281690
NODE_1705_length_1750_cov_90.732283	1239	1310	595	2	71	0.0281690
NODE_1711_length_1746_cov_3.095932	458	524	2	2	66	0.0303030
NODE_1711_length_1746_cov_3.095932	458	524	4	64	66	0.9696970
NODE_1712_length_1745_cov_7.646416	430	510	0	80	80	1.0000000
NODE_1712_length_1745_cov_7.646416	483	563	0	80	80	1.0000000
NODE_1715_length_1744_cov_10.144681	1213	1289	0	18	76	0.2368421
NODE_1715_length_1744_cov_10.144681	1213	1289	6	2	76	0.0263158
NODE_1715_length_1744_cov_10.144681	1213	1289	8	16	76	0.2105263
NODE_1715_length_1744_cov_10.144681	1213	1289	10	7	76	0.0921053
NODE_1715_length_1744_cov_10.144681	1213	1289	13	2	76	0.0263158
NODE_1715_length_1744_cov_10.144681	1213	1289	17	1	76	0.0131579
NODE_1715_length_1744_cov_10.144681	1213	1289	20	9	76	0.1184211
NODE_1715_length_1744_cov_10.144681	1213	1289	23	3	76	0.0394737
NODE_1715_length_1744_cov_10.144681	1213	1289	25	10	76	0.1315790
NODE_1715_length_1744_cov_10.144681	1213	1289	29	3	76	0.0394737
NODE_1715_length_1744_cov_10.144681	1213	1289	31	5	76	0.0657895
NODE_1715_length_1744_cov_10.144681	1262	1342	20	6	80	0.0750000
NODE_1715_length_1744_cov_10.144681	1262	1342	23	3	80	0.0375000
NODE_1715_length_1744_cov_10.144681	1262	1342	24	1	80	0.0125000
NODE_1715_length_1744_cov_10.144681	1262	1342	25	10	80	0.1250000
NODE_1715_length_1744_cov_10.144681	1262	1342	29	3	80	0.0375000
NODE_1715_length_1744_cov_10.144681	1262	1342	30	34	80	0.4250000
NODE_1715_length_1744_cov_10.144681	1262	1342	31	18	80	0.2250000
NODE_1715_length_1744_cov_10.144681	1262	1342	32	5	80	0.0625000
NODE_1719_length_1742_cov_18.923311	699	776	0	77	77	1.0000000
NODE_1719_length_1742_cov_18.923311	749	829	0	80	80	1.0000000
NODE_1722_length_1741_cov_7.657734	1234	1314	0	80	80	1.0000000
NODE_1722_length_1741_cov_7.657734	1287	1367	0	80	80	1.0000000
NODE_1722_length_1741_cov_7.657734	1363	1443	0	80	80	1.0000000
NODE_1722_length_1741_cov_7.657734	1416	1496	0	80	80	1.0000000
NODE_1726_length_1740_cov_38.411335	517	597	0	9	80	0.1125000
NODE_1726_length_1740_cov_38.411335	517	597	4	71	80	0.8875000
NODE_1726_length_1740_cov_38.411335	570	650	0	47	80	0.5875000
NODE_1726_length_1740_cov_38.411335	570	650	4	33	80	0.4125000
NODE_1726_length_1740_cov_38.411335	646	726	0	80	80	1.0000000
NODE_1726_length_1740_cov_38.411335	699	779	0	80	80	1.0000000
NODE_1727_length_1740_cov_10.843388	552	632	0	73	80	0.9125000
NODE_1727_length_1740_cov_10.843388	552	632	2	7	80	0.0875000
NODE_1727_length_1740_cov_10.843388	708	788	0	39	80	0.4875000
NODE_1727_length_1740_cov_10.843388	708	788	2	25	80	0.3125000
NODE_1727_length_1740_cov_10.843388	708	788	4	16	80	0.2000000
NODE_1727_length_1740_cov_10.843388	708	788	0	39	80	0.4875000
NODE_1727_length_1740_cov_10.843388	708	788	2	25	80	0.3125000
NODE_1727_length_1740_cov_10.843388	708	788	4	16	80	0.2000000
NODE_1727_length_1740_cov_10.843388	708	788	0	39	80	0.4875000
NODE_1727_length_1740_cov_10.843388	708	788	2	25	80	0.3125000
NODE_1727_length_1740_cov_10.843388	708	788	4	16	80	0.2000000
NODE_1727_length_1740_cov_10.843388	761	841	0	80	80	1.0000000
NODE_1727_length_1740_cov_10.843388	761	808	0	47	47	1.0000000
NODE_1727_length_1740_cov_10.843388	761	808	0	47	47	1.0000000
NODE_1737_length_1736_cov_71.959682	841	901	578	2	60	0.0333333
NODE_1737_length_1736_cov_71.959682	841	901	590	1	60	0.0166667
NODE_1737_length_1736_cov_71.959682	841	901	594	1	60	0.0166667
NODE_1737_length_1736_cov_71.959682	841	901	596	1	60	0.0166667
NODE_1737_length_1736_cov_71.959682	841	901	599	1	60	0.0166667
NODE_1737_length_1736_cov_71.959682	841	901	604	1	60	0.0166667
NODE_1737_length_1736_cov_71.959682	841	901	608	1	60	0.0166667
NODE_1737_length_1736_cov_71.959682	841	901	610	1	60	0.0166667
NODE_1737_length_1736_cov_71.959682	841	901	613	1	60	0.0166667
NODE_1737_length_1736_cov_71.959682	841	901	616	1	60	0.0166667
NODE_1737_length_1736_cov_71.959682	841	901	617	1	60	0.0166667
NODE_1737_length_1736_cov_71.959682	841	901	629	1	60	0.0166667
NODE_1737_length_1736_cov_71.959682	841	901	630	1	60	0.0166667
NODE_1737_length_1736_cov_71.959682	841	901	631	1	60	0.0166667
NODE_1737_length_1736_cov_71.959682	841	901	637	1	60	0.0166667
NODE_1737_length_1736_cov_71.959682	841	901	639	1	60	0.0166667
NODE_1737_length_1736_cov_71.959682	841	901	642	1	60	0.0166667
NODE_1737_length_1736_cov_71.959682	841	901	648	3	60	0.0500000
NODE_1737_length_1736_cov_71.959682	841	901	649	5	60	0.0833333
NODE_1737_length_1736_cov_71.959682	841	901	651	2	60	0.0333333
NODE_1737_length_1736_cov_71.959682	841	901	652	1	60	0.0166667
NODE_1737_length_1736_cov_71.959682	841	901	653	3	60	0.0500000
NODE_1737_length_1736_cov_71.959682	841	901	656	1	60	0.0166667
NODE_1737_length_1736_cov_71.959682	841	901	657	3	60	0.0500000
NODE_1737_length_1736_cov_71.959682	841	901	659	1	60	0.0166667
NODE_1737_length_1736_cov_71.959682	841	901	660	1	60	0.0166667
NODE_1737_length_1736_cov_71.959682	841	901	661	1	60	0.0166667
NODE_1737_length_1736_cov_71.959682	841	901	663	1	60	0.0166667
NODE_1737_length_1736_cov_71.959682	841	901	664	3	60	0.0500000
NODE_1737_length_1736_cov_71.959682	841	901	667	2	60	0.0333333
NODE_1737_length_1736_cov_71.959682	841	901	669	1	60	0.0166667
NODE_1737_length_1736_cov_71.959682	841	901	670	1	60	0.0166667
NODE_1737_length_1736_cov_71.959682	841	901	671	3	60	0.0500000
NODE_1737_length_1736_cov_71.959682	841	901	672	2	60	0.0333333
NODE_1737_length_1736_cov_71.959682	841	901	673	1	60	0.0166667
NODE_1737_length_1736_cov_71.959682	841	901	675	5	60	0.0833333
NODE_1737_length_1736_cov_71.959682	841	901	677	1	60	0.0166667
NODE_1737_length_1736_cov_71.959682	841	901	679	1	60	0.0166667
NODE_1738_length_1736_cov_29.174710	1361	1390	96	1	29	0.0344828
NODE_1738_length_1736_cov_29.174710	1361	1390	97	1	29	0.0344828
NODE_1738_length_1736_cov_29.174710	1361	1390	99	2	29	0.0689655
NODE_1738_length_1736_cov_29.174710	1361	1390	101	3	29	0.1034483
NODE_1738_length_1736_cov_29.174710	1361	1390	102	3	29	0.1034483
NODE_1738_length_1736_cov_29.174710	1361	1390	103	11	29	0.3793103
NODE_1738_length_1736_cov_29.174710	1361	1390	104	1	29	0.0344828
NODE_1738_length_1736_cov_29.174710	1361	1390	105	4	29	0.1379310
NODE_1738_length_1736_cov_29.174710	1361	1390	108	1	29	0.0344828
NODE_1738_length_1736_cov_29.174710	1361	1390	109	2	29	0.0689655
NODE_1738_length_1736_cov_29.174710	1566	1628	184	1	62	0.0161290
NODE_1738_length_1736_cov_29.174710	1566	1628	185	3	62	0.0483871
NODE_1738_length_1736_cov_29.174710	1566	1628	187	1	62	0.0161290
NODE_1738_length_1736_cov_29.174710	1566	1628	188	2	62	0.0322581
NODE_1738_length_1736_cov_29.174710	1566	1628	191	2	62	0.0322581
NODE_1738_length_1736_cov_29.174710	1566	1628	192	3	62	0.0483871
NODE_1738_length_1736_cov_29.174710	1566	1628	198	2	62	0.0322581
NODE_1738_length_1736_cov_29.174710	1566	1628	201	1	62	0.0161290
NODE_1738_length_1736_cov_29.174710	1566	1628	203	4	62	0.0645161
NODE_1738_length_1736_cov_29.174710	1566	1628	211	1	62	0.0161290
NODE_1738_length_1736_cov_29.174710	1566	1628	219	1	62	0.0161290
NODE_1738_length_1736_cov_29.174710	1566	1628	220	1	62	0.0161290
NODE_1738_length_1736_cov_29.174710	1566	1628	221	2	62	0.0322581
NODE_1738_length_1736_cov_29.174710	1566	1628	223	1	62	0.0161290
NODE_1738_length_1736_cov_29.174710	1566	1628	226	1	62	0.0161290
NODE_1738_length_1736_cov_29.174710	1566	1628	227	2	62	0.0322581
NODE_1738_length_1736_cov_29.174710	1566	1628	228	1	62	0.0161290
NODE_1738_length_1736_cov_29.174710	1566	1628	229	3	62	0.0483871
NODE_1738_length_1736_cov_29.174710	1566	1628	230	1	62	0.0161290
NODE_1738_length_1736_cov_29.174710	1566	1628	231	6	62	0.0967742
NODE_1738_length_1736_cov_29.174710	1566	1628	232	4	62	0.0645161
NODE_1738_length_1736_cov_29.174710	1566	1628	233	2	62	0.0322581
NODE_1738_length_1736_cov_29.174710	1566	1628	234	2	62	0.0322581
NODE_1738_length_1736_cov_29.174710	1566	1628	235	2	62	0.0322581
NODE_1738_length_1736_cov_29.174710	1566	1628	236	2	62	0.0322581
NODE_1738_length_1736_cov_29.174710	1566	1628	237	3	62	0.0483871
NODE_1738_length_1736_cov_29.174710	1566	1628	238	1	62	0.0161290
NODE_1738_length_1736_cov_29.174710	1566	1628	239	3	62	0.0483871
NODE_1738_length_1736_cov_29.174710	1566	1628	243	2	62	0.0322581
NODE_1738_length_1736_cov_29.174710	1566	1628	247	2	62	0.0322581
NODE_1743_length_1732_cov_6.162890	807	887	2	80	80	1.0000000
NODE_1743_length_1732_cov_6.162890	860	940	0	44	80	0.5500000
NODE_1743_length_1732_cov_6.162890	860	940	2	36	80	0.4500000
NODE_1749_length_1729_cov_23.708589	364	443	0	79	79	1.0000000
NODE_1749_length_1729_cov_23.708589	416	496	0	80	80	1.0000000
NODE_1749_length_1729_cov_23.708589	492	572	0	80	80	1.0000000
NODE_1749_length_1729_cov_23.708589	545	625	0	80	80	1.0000000
NODE_1753_length_1728_cov_26.505832	259	339	5	1	80	0.0125000
NODE_1753_length_1728_cov_26.505832	259	339	6	57	80	0.7125000
NODE_1753_length_1728_cov_26.505832	259	339	9	22	80	0.2750000
NODE_1753_length_1728_cov_26.505832	312	392	3	36	80	0.4500000
NODE_1753_length_1728_cov_26.505832	312	392	6	5	80	0.0625000
NODE_1753_length_1728_cov_26.505832	312	392	9	39	80	0.4875000
NODE_1757_length_1725_cov_142.158057	767	814	311	1	47	0.0212766
NODE_1757_length_1725_cov_142.158057	767	814	313	2	47	0.0425532
NODE_1757_length_1725_cov_142.158057	767	814	315	2	47	0.0425532
NODE_1757_length_1725_cov_142.158057	767	814	323	1	47	0.0212766
NODE_1757_length_1725_cov_142.158057	767	814	325	3	47	0.0638298
NODE_1757_length_1725_cov_142.158057	767	814	329	1	47	0.0212766
NODE_1757_length_1725_cov_142.158057	767	814	334	2	47	0.0425532
NODE_1757_length_1725_cov_142.158057	767	814	335	1	47	0.0212766
NODE_1757_length_1725_cov_142.158057	767	814	341	1	47	0.0212766
NODE_1757_length_1725_cov_142.158057	767	814	343	1	47	0.0212766
NODE_1757_length_1725_cov_142.158057	767	814	344	1	47	0.0212766
NODE_1757_length_1725_cov_142.158057	767	814	352	1	47	0.0212766
NODE_1757_length_1725_cov_142.158057	767	814	360	1	47	0.0212766
NODE_1757_length_1725_cov_142.158057	767	814	361	1	47	0.0212766
NODE_1757_length_1725_cov_142.158057	767	814	362	2	47	0.0425532
NODE_1757_length_1725_cov_142.158057	767	814	365	1	47	0.0212766
NODE_1757_length_1725_cov_142.158057	767	814	375	1	47	0.0212766
NODE_1757_length_1725_cov_142.158057	767	814	383	1	47	0.0212766
NODE_1757_length_1725_cov_142.158057	767	814	394	1	47	0.0212766
NODE_1757_length_1725_cov_142.158057	767	814	395	2	47	0.0425532
NODE_1757_length_1725_cov_142.158057	767	814	405	1	47	0.0212766
NODE_1757_length_1725_cov_142.158057	767	814	407	4	47	0.0851064
NODE_1757_length_1725_cov_142.158057	767	814	409	1	47	0.0212766
NODE_1757_length_1725_cov_142.158057	767	814	417	2	47	0.0425532
NODE_1757_length_1725_cov_142.158057	767	814	424	1	47	0.0212766
NODE_1757_length_1725_cov_142.158057	767	814	426	3	47	0.0638298
NODE_1757_length_1725_cov_142.158057	767	814	427	1	47	0.0212766
NODE_1757_length_1725_cov_142.158057	767	814	429	1	47	0.0212766
NODE_1757_length_1725_cov_142.158057	767	814	430	1	47	0.0212766
NODE_1757_length_1725_cov_142.158057	767	814	431	2	47	0.0425532
NODE_1757_length_1725_cov_142.158057	767	814	432	2	47	0.0425532
NODE_1757_length_1725_cov_142.158057	767	814	435	1	47	0.0212766
NODE_1757_length_1725_cov_142.158057	803	867	339	1	64	0.0156250
NODE_1757_length_1725_cov_142.158057	803	867	340	2	64	0.0312500
NODE_1757_length_1725_cov_142.158057	803	867	341	1	64	0.0156250
NODE_1757_length_1725_cov_142.158057	803	867	342	1	64	0.0156250
NODE_1757_length_1725_cov_142.158057	803	867	344	1	64	0.0156250
NODE_1757_length_1725_cov_142.158057	803	867	348	2	64	0.0312500
NODE_1757_length_1725_cov_142.158057	803	867	360	3	64	0.0468750
NODE_1757_length_1725_cov_142.158057	803	867	362	2	64	0.0312500
NODE_1757_length_1725_cov_142.158057	803	867	364	1	64	0.0156250
NODE_1757_length_1725_cov_142.158057	803	867	366	2	64	0.0312500
NODE_1757_length_1725_cov_142.158057	803	867	368	1	64	0.0156250
NODE_1757_length_1725_cov_142.158057	803	867	372	1	64	0.0156250
NODE_1757_length_1725_cov_142.158057	803	867	378	1	64	0.0156250
NODE_1757_length_1725_cov_142.158057	803	867	379	1	64	0.0156250
NODE_1757_length_1725_cov_142.158057	803	867	387	1	64	0.0156250
NODE_1757_length_1725_cov_142.158057	803	867	395	1	64	0.0156250
NODE_1757_length_1725_cov_142.158057	803	867	398	2	64	0.0312500
NODE_1757_length_1725_cov_142.158057	803	867	400	2	64	0.0312500
NODE_1757_length_1725_cov_142.158057	803	867	402	1	64	0.0156250
NODE_1757_length_1725_cov_142.158057	803	867	408	1	64	0.0156250
NODE_1757_length_1725_cov_142.158057	803	867	413	1	64	0.0156250
NODE_1757_length_1725_cov_142.158057	803	867	419	1	64	0.0156250
NODE_1757_length_1725_cov_142.158057	803	867	423	1	64	0.0156250
NODE_1757_length_1725_cov_142.158057	803	867	424	2	64	0.0312500
NODE_1757_length_1725_cov_142.158057	803	867	426	5	64	0.0781250
NODE_1757_length_1725_cov_142.158057	803	867	427	3	64	0.0468750
NODE_1757_length_1725_cov_142.158057	803	867	428	1	64	0.0156250
NODE_1757_length_1725_cov_142.158057	803	867	429	2	64	0.0312500
NODE_1757_length_1725_cov_142.158057	803	867	430	2	64	0.0312500
NODE_1757_length_1725_cov_142.158057	803	867	431	3	64	0.0468750
NODE_1757_length_1725_cov_142.158057	803	867	432	2	64	0.0312500
NODE_1757_length_1725_cov_142.158057	803	867	434	1	64	0.0156250
NODE_1757_length_1725_cov_142.158057	803	867	435	4	64	0.0625000
NODE_1757_length_1725_cov_142.158057	803	867	438	1	64	0.0156250
NODE_1757_length_1725_cov_142.158057	803	867	440	1	64	0.0156250
NODE_1757_length_1725_cov_142.158057	803	867	441	1	64	0.0156250
NODE_1757_length_1725_cov_142.158057	803	867	442	4	64	0.0625000
NODE_1757_length_1725_cov_142.158057	803	867	444	1	64	0.0156250
NODE_1759_length_1724_cov_17.931077	677	746	0	40	69	0.5797101
NODE_1759_length_1724_cov_17.931077	677	746	2	29	69	0.4202898
NODE_1759_length_1724_cov_17.931077	788	850	4	9	62	0.1451613
NODE_1759_length_1724_cov_17.931077	788	850	10	53	62	0.8548387
NODE_1761_length_1723_cov_35.355296	1174	1254	0	37	80	0.4625000
NODE_1761_length_1723_cov_35.355296	1174	1254	4	43	80	0.5375000
NODE_1761_length_1723_cov_35.355296	1227	1307	4	80	80	1.0000000
NODE_1763_length_1722_cov_13.235367	708	788	2	53	80	0.6625000
NODE_1763_length_1722_cov_13.235367	708	788	4	27	80	0.3375000
NODE_1763_length_1722_cov_13.235367	761	841	2	54	80	0.6750000
NODE_1763_length_1722_cov_13.235367	761	841	4	26	80	0.3250000
NODE_1763_length_1722_cov_13.235367	1319	1399	0	80	80	1.0000000
NODE_1763_length_1722_cov_13.235367	1372	1452	0	80	80	1.0000000
NODE_1765_length_1720_cov_27.328192	1248	1307	106	5	59	0.0847458
NODE_1765_length_1720_cov_27.328192	1248	1307	107	2	59	0.0338983
NODE_1765_length_1720_cov_27.328192	1248	1307	108	1	59	0.0169492
NODE_1765_length_1720_cov_27.328192	1248	1307	109	1	59	0.0169492
NODE_1765_length_1720_cov_27.328192	1248	1307	110	1	59	0.0169492
NODE_1765_length_1720_cov_27.328192	1248	1307	112	1	59	0.0169492
NODE_1765_length_1720_cov_27.328192	1248	1307	114	5	59	0.0847458
NODE_1765_length_1720_cov_27.328192	1248	1307	116	2	59	0.0338983
NODE_1765_length_1720_cov_27.328192	1248	1307	122	1	59	0.0169492
NODE_1765_length_1720_cov_27.328192	1248	1307	125	2	59	0.0338983
NODE_1765_length_1720_cov_27.328192	1248	1307	128	1	59	0.0169492
NODE_1765_length_1720_cov_27.328192	1248	1307	139	7	59	0.1186441
NODE_1765_length_1720_cov_27.328192	1248	1307	143	1	59	0.0169492
NODE_1765_length_1720_cov_27.328192	1248	1307	145	7	59	0.1186441
NODE_1765_length_1720_cov_27.328192	1248	1307	147	5	59	0.0847458
NODE_1765_length_1720_cov_27.328192	1248	1307	150	1	59	0.0169492
NODE_1765_length_1720_cov_27.328192	1248	1307	153	3	59	0.0508475
NODE_1765_length_1720_cov_27.328192	1248	1307	157	7	59	0.1186441
NODE_1765_length_1720_cov_27.328192	1248	1307	159	4	59	0.0677966
NODE_1765_length_1720_cov_27.328192	1248	1307	161	2	59	0.0338983
NODE_1765_length_1720_cov_27.328192	1280	1360	79	5	80	0.0625000
NODE_1765_length_1720_cov_27.328192	1280	1360	87	1	80	0.0125000
NODE_1765_length_1720_cov_27.328192	1280	1360	91	3	80	0.0375000
NODE_1765_length_1720_cov_27.328192	1280	1360	95	4	80	0.0500000
NODE_1765_length_1720_cov_27.328192	1280	1360	96	6	80	0.0750000
NODE_1765_length_1720_cov_27.328192	1280	1360	100	2	80	0.0250000
NODE_1765_length_1720_cov_27.328192	1280	1360	102	1	80	0.0125000
NODE_1765_length_1720_cov_27.328192	1280	1360	103	1	80	0.0125000
NODE_1765_length_1720_cov_27.328192	1280	1360	107	2	80	0.0250000
NODE_1765_length_1720_cov_27.328192	1280	1360	111	6	80	0.0750000
NODE_1765_length_1720_cov_27.328192	1280	1360	113	2	80	0.0250000
NODE_1765_length_1720_cov_27.328192	1280	1360	117	1	80	0.0125000
NODE_1765_length_1720_cov_27.328192	1280	1360	121	2	80	0.0250000
NODE_1765_length_1720_cov_27.328192	1280	1360	123	2	80	0.0250000
NODE_1765_length_1720_cov_27.328192	1280	1360	126	2	80	0.0250000
NODE_1765_length_1720_cov_27.328192	1280	1360	128	4	80	0.0500000
NODE_1765_length_1720_cov_27.328192	1280	1360	134	2	80	0.0250000
NODE_1765_length_1720_cov_27.328192	1280	1360	137	2	80	0.0250000
NODE_1765_length_1720_cov_27.328192	1280	1360	143	1	80	0.0125000
NODE_1765_length_1720_cov_27.328192	1280	1360	145	4	80	0.0500000
NODE_1765_length_1720_cov_27.328192	1280	1360	147	8	80	0.1000000
NODE_1765_length_1720_cov_27.328192	1280	1360	148	1	80	0.0125000
NODE_1765_length_1720_cov_27.328192	1280	1360	150	1	80	0.0125000
NODE_1765_length_1720_cov_27.328192	1280	1360	152	1	80	0.0125000
NODE_1765_length_1720_cov_27.328192	1280	1360	153	3	80	0.0375000
NODE_1765_length_1720_cov_27.328192	1280	1360	157	7	80	0.0875000
NODE_1765_length_1720_cov_27.328192	1280	1360	159	4	80	0.0500000
NODE_1765_length_1720_cov_27.328192	1280	1360	161	2	80	0.0250000
NODE_1766_length_1720_cov_4.129550	241	321	0	80	80	1.0000000
NODE_1766_length_1720_cov_4.129550	294	374	0	80	80	1.0000000
NODE_1768_length_1719_cov_9.878395	410	490	0	11	80	0.1375000
NODE_1768_length_1719_cov_9.878395	410	490	2	69	80	0.8625000
NODE_1768_length_1719_cov_9.878395	463	543	0	41	80	0.5125000
NODE_1768_length_1719_cov_9.878395	463	543	2	39	80	0.4875000
NODE_1768_length_1719_cov_9.878395	539	619	0	57	80	0.7125000
NODE_1768_length_1719_cov_9.878395	539	619	2	23	80	0.2875000
NODE_1768_length_1719_cov_9.878395	592	672	0	4	80	0.0500000
NODE_1768_length_1719_cov_9.878395	592	672	2	76	80	0.9500000
NODE_1772_length_1717_cov_5.159456	145	219	0	3	74	0.0405405
NODE_1772_length_1717_cov_5.159456	145	219	2	4	74	0.0540541
NODE_1772_length_1717_cov_5.159456	145	219	12	3	74	0.0405405
NODE_1772_length_1717_cov_5.159456	145	219	16	3	74	0.0405405
NODE_1772_length_1717_cov_5.159456	145	219	18	3	74	0.0405405
NODE_1772_length_1717_cov_5.159456	145	219	20	5	74	0.0675676
NODE_1772_length_1717_cov_5.159456	145	219	24	3	74	0.0405405
NODE_1772_length_1717_cov_5.159456	145	219	26	1	74	0.0135135
NODE_1772_length_1717_cov_5.159456	145	219	40	3	74	0.0405405
NODE_1772_length_1717_cov_5.159456	145	219	42	2	74	0.0270270
NODE_1772_length_1717_cov_5.159456	145	219	44	8	74	0.1081081
NODE_1772_length_1717_cov_5.159456	145	219	46	1	74	0.0135135
NODE_1772_length_1717_cov_5.159456	145	219	48	3	74	0.0405405
NODE_1772_length_1717_cov_5.159456	145	219	50	2	74	0.0270270
NODE_1772_length_1717_cov_5.159456	145	219	52	1	74	0.0135135
NODE_1772_length_1717_cov_5.159456	145	219	56	3	74	0.0405405
NODE_1772_length_1717_cov_5.159456	145	219	58	1	74	0.0135135
NODE_1772_length_1717_cov_5.159456	145	219	60	1	74	0.0135135
NODE_1772_length_1717_cov_5.159456	145	219	62	7	74	0.0945946
NODE_1772_length_1717_cov_5.159456	145	219	64	5	74	0.0675676
NODE_1772_length_1717_cov_5.159456	145	219	66	4	74	0.0540541
NODE_1772_length_1717_cov_5.159456	145	219	68	8	74	0.1081081
NODE_1772_length_1717_cov_5.159456	1450	1508	0	58	58	1.0000000
NODE_1772_length_1717_cov_5.159456	1503	1561	0	58	58	1.0000000
NODE_1778_length_1715_cov_12.607054	555	635	0	77	80	0.9625000
NODE_1778_length_1715_cov_12.607054	555	635	2	3	80	0.0375000
NODE_1778_length_1715_cov_12.607054	608	688	0	80	80	1.0000000
NODE_1778_length_1715_cov_12.607054	684	764	0	80	80	1.0000000
NODE_1778_length_1715_cov_12.607054	737	817	0	80	80	1.0000000
NODE_1788_length_1707_cov_16.909204	397	477	0	29	80	0.3625000
NODE_1788_length_1707_cov_16.909204	397	477	4	51	80	0.6375000
NODE_1788_length_1707_cov_16.909204	450	530	0	34	80	0.4250000
NODE_1788_length_1707_cov_16.909204	450	530	4	46	80	0.5750000
NODE_1788_length_1707_cov_16.909204	1151	1231	0	80	80	1.0000000
NODE_1788_length_1707_cov_16.909204	1204	1284	0	80	80	1.0000000
NODE_1792_length_1705_cov_19.645081	451	531	0	80	80	1.0000000
NODE_1792_length_1705_cov_19.645081	504	584	0	80	80	1.0000000
NODE_1792_length_1705_cov_19.645081	580	660	0	80	80	1.0000000
NODE_1792_length_1705_cov_19.645081	633	714	0	81	81	1.0000000
NODE_1792_length_1705_cov_19.645081	1315	1395	0	5	80	0.0625000
NODE_1792_length_1705_cov_19.645081	1315	1395	2	75	80	0.9375000
NODE_1792_length_1705_cov_19.645081	1368	1448	0	27	80	0.3375000
NODE_1792_length_1705_cov_19.645081	1368	1448	2	53	80	0.6625000
NODE_1796_length_1703_cov_26.016833	1201	1264	4	50	63	0.7936508
NODE_1796_length_1703_cov_26.016833	1201	1264	6	2	63	0.0317460
NODE_1796_length_1703_cov_26.016833	1201	1264	8	1	63	0.0158730
NODE_1796_length_1703_cov_26.016833	1201	1264	10	2	63	0.0317460
NODE_1796_length_1703_cov_26.016833	1201	1264	14	1	63	0.0158730
NODE_1796_length_1703_cov_26.016833	1201	1264	18	6	63	0.0952381
NODE_1796_length_1703_cov_26.016833	1201	1264	20	1	63	0.0158730
NODE_1796_length_1703_cov_26.016833	1207	1264	4	50	57	0.8771930
NODE_1796_length_1703_cov_26.016833	1207	1264	6	2	57	0.0350877
NODE_1796_length_1703_cov_26.016833	1207	1264	8	1	57	0.0175439
NODE_1796_length_1703_cov_26.016833	1207	1264	10	2	57	0.0350877
NODE_1796_length_1703_cov_26.016833	1207	1264	14	1	57	0.0175439
NODE_1796_length_1703_cov_26.016833	1207	1264	18	1	57	0.0175439
NODE_1796_length_1703_cov_26.016833	1207	1264	4	50	57	0.8771930
NODE_1796_length_1703_cov_26.016833	1207	1264	6	2	57	0.0350877
NODE_1796_length_1703_cov_26.016833	1207	1264	8	1	57	0.0175439
NODE_1796_length_1703_cov_26.016833	1207	1264	10	2	57	0.0350877
NODE_1796_length_1703_cov_26.016833	1207	1264	14	1	57	0.0175439
NODE_1796_length_1703_cov_26.016833	1207	1264	18	1	57	0.0175439
NODE_1799_length_1701_cov_15.969413	1490	1565	6	4	75	0.0533333
NODE_1799_length_1701_cov_15.969413	1490	1565	10	4	75	0.0533333
NODE_1799_length_1701_cov_15.969413	1490	1565	13	2	75	0.0266667
NODE_1799_length_1701_cov_15.969413	1490	1565	17	1	75	0.0133333
NODE_1799_length_1701_cov_15.969413	1490	1565	21	6	75	0.0800000
NODE_1799_length_1701_cov_15.969413	1490	1565	27	1	75	0.0133333
NODE_1799_length_1701_cov_15.969413	1490	1565	29	2	75	0.0266667
NODE_1799_length_1701_cov_15.969413	1490	1565	33	4	75	0.0533333
NODE_1799_length_1701_cov_15.969413	1490	1565	37	1	75	0.0133333
NODE_1799_length_1701_cov_15.969413	1490	1565	42	9	75	0.1200000
NODE_1799_length_1701_cov_15.969413	1490	1565	43	2	75	0.0266667
NODE_1799_length_1701_cov_15.969413	1490	1565	44	2	75	0.0266667
NODE_1799_length_1701_cov_15.969413	1490	1565	45	4	75	0.0533333
NODE_1799_length_1701_cov_15.969413	1490	1565	48	6	75	0.0800000
NODE_1799_length_1701_cov_15.969413	1490	1565	50	1	75	0.0133333
NODE_1799_length_1701_cov_15.969413	1490	1565	51	9	75	0.1200000
NODE_1799_length_1701_cov_15.969413	1490	1565	54	4	75	0.0533333
NODE_1799_length_1701_cov_15.969413	1490	1565	56	3	75	0.0400000
NODE_1799_length_1701_cov_15.969413	1490	1565	58	10	75	0.1333333
NODE_1799_length_1701_cov_15.969413	1538	1603	50	1	65	0.0153846
NODE_1799_length_1701_cov_15.969413	1538	1603	51	9	65	0.1384615
NODE_1799_length_1701_cov_15.969413	1538	1603	54	4	65	0.0615385
NODE_1799_length_1701_cov_15.969413	1538	1603	56	3	65	0.0461538
NODE_1799_length_1701_cov_15.969413	1538	1603	58	12	65	0.1846154
NODE_1799_length_1701_cov_15.969413	1538	1603	59	5	65	0.0769231
NODE_1799_length_1701_cov_15.969413	1538	1603	61	1	65	0.0153846
NODE_1799_length_1701_cov_15.969413	1538	1603	63	1	65	0.0153846
NODE_1799_length_1701_cov_15.969413	1538	1603	69	10	65	0.1538462
NODE_1799_length_1701_cov_15.969413	1538	1603	79	4	65	0.0615385
NODE_1799_length_1701_cov_15.969413	1538	1603	81	1	65	0.0153846
NODE_1799_length_1701_cov_15.969413	1538	1603	82	6	65	0.0923077
NODE_1799_length_1701_cov_15.969413	1538	1603	83	8	65	0.1230769
NODE_1800_length_1701_cov_13.549313	607	687	0	65	80	0.8125000
NODE_1800_length_1701_cov_13.549313	607	687	2	15	80	0.1875000
NODE_1800_length_1701_cov_13.549313	660	740	0	12	80	0.1500000
NODE_1800_length_1701_cov_13.549313	660	740	2	42	80	0.5250000
NODE_1800_length_1701_cov_13.549313	660	740	4	26	80	0.3250000
NODE_1805_length_1700_cov_20.003123	1168	1197	185	2	29	0.0689655
NODE_1805_length_1700_cov_20.003123	1168	1197	187	2	29	0.0689655
NODE_1805_length_1700_cov_20.003123	1168	1197	191	1	29	0.0344828
NODE_1805_length_1700_cov_20.003123	1168	1197	192	1	29	0.0344828
NODE_1805_length_1700_cov_20.003123	1168	1197	193	4	29	0.1379310
NODE_1805_length_1700_cov_20.003123	1168	1197	195	2	29	0.0689655
NODE_1805_length_1700_cov_20.003123	1168	1197	197	1	29	0.0344828
NODE_1805_length_1700_cov_20.003123	1168	1197	199	1	29	0.0344828
NODE_1805_length_1700_cov_20.003123	1168	1197	207	2	29	0.0689655
NODE_1805_length_1700_cov_20.003123	1168	1197	209	3	29	0.1034483
NODE_1805_length_1700_cov_20.003123	1168	1197	213	1	29	0.0344828
NODE_1805_length_1700_cov_20.003123	1168	1197	223	1	29	0.0344828
NODE_1805_length_1700_cov_20.003123	1168	1197	225	1	29	0.0344828
NODE_1805_length_1700_cov_20.003123	1168	1197	227	1	29	0.0344828
NODE_1805_length_1700_cov_20.003123	1168	1197	228	1	29	0.0344828
NODE_1805_length_1700_cov_20.003123	1168	1197	230	1	29	0.0344828
NODE_1805_length_1700_cov_20.003123	1168	1197	235	1	29	0.0344828
NODE_1805_length_1700_cov_20.003123	1168	1197	244	1	29	0.0344828
NODE_1805_length_1700_cov_20.003123	1168	1197	246	1	29	0.0344828
NODE_1805_length_1700_cov_20.003123	1168	1197	248	1	29	0.0344828
NODE_1805_length_1700_cov_20.003123	1184	1263	185	2	79	0.0253165
NODE_1805_length_1700_cov_20.003123	1184	1263	187	3	79	0.0379747
NODE_1805_length_1700_cov_20.003123	1184	1263	189	1	79	0.0126582
NODE_1805_length_1700_cov_20.003123	1184	1263	191	1	79	0.0126582
NODE_1805_length_1700_cov_20.003123	1184	1263	192	1	79	0.0126582
NODE_1805_length_1700_cov_20.003123	1184	1263	193	3	79	0.0379747
NODE_1805_length_1700_cov_20.003123	1184	1263	194	1	79	0.0126582
NODE_1805_length_1700_cov_20.003123	1184	1263	195	2	79	0.0253165
NODE_1805_length_1700_cov_20.003123	1184	1263	196	5	79	0.0632911
NODE_1805_length_1700_cov_20.003123	1184	1263	197	1	79	0.0126582
NODE_1805_length_1700_cov_20.003123	1184	1263	198	1	79	0.0126582
NODE_1805_length_1700_cov_20.003123	1184	1263	199	1	79	0.0126582
NODE_1805_length_1700_cov_20.003123	1184	1263	200	1	79	0.0126582
NODE_1805_length_1700_cov_20.003123	1184	1263	202	1	79	0.0126582
NODE_1805_length_1700_cov_20.003123	1184	1263	203	2	79	0.0253165
NODE_1805_length_1700_cov_20.003123	1184	1263	204	1	79	0.0126582
NODE_1805_length_1700_cov_20.003123	1184	1263	205	2	79	0.0253165
NODE_1805_length_1700_cov_20.003123	1184	1263	206	2	79	0.0253165
NODE_1805_length_1700_cov_20.003123	1184	1263	207	2	79	0.0253165
NODE_1805_length_1700_cov_20.003123	1184	1263	208	1	79	0.0126582
NODE_1805_length_1700_cov_20.003123	1184	1263	209	2	79	0.0253165
NODE_1805_length_1700_cov_20.003123	1184	1263	210	2	79	0.0253165
NODE_1805_length_1700_cov_20.003123	1184	1263	222	1	79	0.0126582
NODE_1805_length_1700_cov_20.003123	1184	1263	225	2	79	0.0253165
NODE_1805_length_1700_cov_20.003123	1184	1263	232	1	79	0.0126582
NODE_1805_length_1700_cov_20.003123	1184	1263	233	1	79	0.0126582
NODE_1805_length_1700_cov_20.003123	1184	1263	234	3	79	0.0379747
NODE_1805_length_1700_cov_20.003123	1184	1263	236	1	79	0.0126582
NODE_1805_length_1700_cov_20.003123	1184	1263	237	1	79	0.0126582
NODE_1805_length_1700_cov_20.003123	1184	1263	238	4	79	0.0506329
NODE_1805_length_1700_cov_20.003123	1184	1263	240	2	79	0.0253165
NODE_1805_length_1700_cov_20.003123	1184	1263	241	1	79	0.0126582
NODE_1805_length_1700_cov_20.003123	1184	1263	242	1	79	0.0126582
NODE_1805_length_1700_cov_20.003123	1184	1263	244	3	79	0.0379747
NODE_1805_length_1700_cov_20.003123	1184	1263	246	1	79	0.0126582
NODE_1805_length_1700_cov_20.003123	1184	1263	248	1	79	0.0126582
NODE_1805_length_1700_cov_20.003123	1184	1263	249	1	79	0.0126582
NODE_1805_length_1700_cov_20.003123	1184	1263	252	3	79	0.0379747
NODE_1805_length_1700_cov_20.003123	1184	1263	257	3	79	0.0379747
NODE_1805_length_1700_cov_20.003123	1184	1263	258	1	79	0.0126582
NODE_1805_length_1700_cov_20.003123	1184	1263	259	1	79	0.0126582
NODE_1805_length_1700_cov_20.003123	1184	1263	260	3	79	0.0379747
NODE_1805_length_1700_cov_20.003123	1184	1263	262	1	79	0.0126582
NODE_1805_length_1700_cov_20.003123	1184	1263	263	1	79	0.0126582
NODE_1805_length_1700_cov_20.003123	1184	1263	266	2	79	0.0253165
NODE_1805_length_1700_cov_20.003123	1184	1263	267	2	79	0.0253165
NODE_1810_length_1698_cov_19.175735	1001	1081	0	49	80	0.6125000
NODE_1810_length_1698_cov_19.175735	1001	1081	2	31	80	0.3875000
NODE_1810_length_1698_cov_19.175735	1054	1134	0	11	80	0.1375000
NODE_1810_length_1698_cov_19.175735	1054	1134	2	69	80	0.8625000
NODE_1814_length_1696_cov_11.494678	590	670	0	80	80	1.0000000
NODE_1814_length_1696_cov_11.494678	643	723	0	80	80	1.0000000
NODE_1815_length_1696_cov_6.620539	369	449	0	22	80	0.2750000
NODE_1815_length_1696_cov_6.620539	369	449	2	58	80	0.7250000
NODE_1815_length_1696_cov_6.620539	422	502	0	43	80	0.5375000
NODE_1815_length_1696_cov_6.620539	422	502	2	37	80	0.4625000
NODE_1816_length_1695_cov_27.783208	399	479	0	2	80	0.0250000
NODE_1816_length_1695_cov_27.783208	399	479	2	4	80	0.0500000
NODE_1816_length_1695_cov_27.783208	399	479	4	10	80	0.1250000
NODE_1816_length_1695_cov_27.783208	399	479	6	64	80	0.8000000
NODE_1816_length_1695_cov_27.783208	452	532	0	2	80	0.0250000
NODE_1816_length_1695_cov_27.783208	452	532	2	40	80	0.5000000
NODE_1816_length_1695_cov_27.783208	452	532	4	9	80	0.1125000
NODE_1816_length_1695_cov_27.783208	452	532	6	29	80	0.3625000
NODE_1817_length_1695_cov_12.084586	1047	1127	0	80	80	1.0000000
NODE_1817_length_1695_cov_12.084586	1100	1180	0	65	80	0.8125000
NODE_1817_length_1695_cov_12.084586	1100	1180	2	15	80	0.1875000
NODE_1825_length_1692_cov_4.557439	727	807	0	80	80	1.0000000
NODE_1825_length_1692_cov_4.557439	780	860	0	80	80	1.0000000
NODE_1830_length_1689_cov_5.844025	1210	1285	0	6	75	0.0800000
NODE_1830_length_1689_cov_5.844025	1210	1285	2	7	75	0.0933333
NODE_1830_length_1689_cov_5.844025	1210	1285	4	62	75	0.8266667
NODE_1830_length_1689_cov_5.844025	1260	1338	2	6	78	0.0769231
NODE_1830_length_1689_cov_5.844025	1260	1338	4	44	78	0.5641026
NODE_1830_length_1689_cov_5.844025	1260	1338	6	28	78	0.3589744
NODE_1837_length_1682_cov_14.416930	1183	1263	2	22	80	0.2750000
NODE_1837_length_1682_cov_14.416930	1183	1263	4	58	80	0.7250000
NODE_1837_length_1682_cov_14.416930	1236	1315	0	8	79	0.1012658
NODE_1837_length_1682_cov_14.416930	1236	1315	1	8	79	0.1012658
NODE_1837_length_1682_cov_14.416930	1236	1315	2	58	79	0.7341772
NODE_1837_length_1682_cov_14.416930	1236	1315	4	5	79	0.0632911
NODE_1843_length_1678_cov_23.965168	636	716	0	80	80	1.0000000
NODE_1843_length_1678_cov_23.965168	689	769	0	80	80	1.0000000
NODE_1843_length_1678_cov_23.965168	1145	1225	0	80	80	1.0000000
NODE_1843_length_1678_cov_23.965168	1198	1278	0	80	80	1.0000000
NODE_1846_length_1677_cov_3.578580	407	487	0	80	80	1.0000000
NODE_1846_length_1677_cov_3.578580	460	530	0	70	70	1.0000000
NODE_1846_length_1677_cov_3.578580	666	724	0	58	58	1.0000000
NODE_1856_length_1670_cov_29.264163	741	821	0	80	80	1.0000000
NODE_1856_length_1670_cov_29.264163	794	874	0	80	80	1.0000000
NODE_1857_length_1669_cov_5.913376	246	326	0	7	80	0.0875000
NODE_1857_length_1669_cov_5.913376	246	326	2	73	80	0.9125000
NODE_1857_length_1669_cov_5.913376	299	379	0	60	80	0.7500000
NODE_1857_length_1669_cov_5.913376	299	379	2	20	80	0.2500000
NODE_1860_length_1668_cov_18.372212	1100	1180	0	80	80	1.0000000
NODE_1860_length_1668_cov_18.372212	1153	1233	0	80	80	1.0000000
NODE_1861_length_1667_cov_15.651786	902	982	0	80	80	1.0000000
NODE_1861_length_1667_cov_15.651786	955	1035	0	80	80	1.0000000
NODE_1862_length_1667_cov_3.661352	649	679	0	30	30	1.0000000
NODE_1865_length_1666_cov_4.601149	1541	1623	2	23	82	0.2804878
NODE_1865_length_1666_cov_4.601149	1541	1623	6	59	82	0.7195122
NODE_1865_length_1666_cov_4.601149	1553	1613	2	11	60	0.1833333
NODE_1865_length_1666_cov_4.601149	1553	1613	6	49	60	0.8166667
NODE_1865_length_1666_cov_4.601149	1553	1613	2	11	60	0.1833333
NODE_1865_length_1666_cov_4.601149	1553	1613	6	49	60	0.8166667
NODE_1865_length_1666_cov_4.601149	1557	1623	2	7	66	0.1060606
NODE_1865_length_1666_cov_4.601149	1557	1623	6	59	66	0.8939394
NODE_1865_length_1666_cov_4.601149	1596	1666	0	5	70	0.0714286
NODE_1865_length_1666_cov_4.601149	1596	1666	4	20	70	0.2857143
NODE_1865_length_1666_cov_4.601149	1596	1666	6	45	70	0.6428571
NODE_1865_length_1666_cov_4.601149	1596	1666	0	5	70	0.0714286
NODE_1865_length_1666_cov_4.601149	1596	1666	4	20	70	0.2857143
NODE_1865_length_1666_cov_4.601149	1596	1666	6	45	70	0.6428571
NODE_1865_length_1666_cov_4.601149	1596	1666	0	5	70	0.0714286
NODE_1865_length_1666_cov_4.601149	1596	1666	4	20	70	0.2857143
NODE_1865_length_1666_cov_4.601149	1596	1666	6	45	70	0.6428571
NODE_1872_length_1662_cov_16.638516	538	618	0	53	80	0.6625000
NODE_1872_length_1662_cov_16.638516	538	618	2	3	80	0.0375000
NODE_1872_length_1662_cov_16.638516	538	618	8	24	80	0.3000000
NODE_1872_length_1662_cov_16.638516	591	671	2	3	80	0.0375000
NODE_1872_length_1662_cov_16.638516	591	671	8	77	80	0.9625000
NODE_1872_length_1662_cov_16.638516	667	747	2	5	80	0.0625000
NODE_1872_length_1662_cov_16.638516	667	747	8	20	80	0.2500000
NODE_1872_length_1662_cov_16.638516	667	747	9	9	80	0.1125000
NODE_1872_length_1662_cov_16.638516	667	747	10	46	80	0.5750000
NODE_1872_length_1662_cov_16.638516	720	800	0	19	80	0.2375000
NODE_1872_length_1662_cov_16.638516	720	800	2	39	80	0.4875000
NODE_1872_length_1662_cov_16.638516	720	800	8	7	80	0.0875000
NODE_1872_length_1662_cov_16.638516	720	800	9	9	80	0.1125000
NODE_1872_length_1662_cov_16.638516	720	800	10	6	80	0.0750000
NODE_1876_length_1660_cov_28.297886	415	495	0	80	80	1.0000000
NODE_1876_length_1660_cov_28.297886	468	548	0	80	80	1.0000000
NODE_1886_length_1654_cov_17.245016	631	711	0	60	80	0.7500000
NODE_1886_length_1654_cov_17.245016	631	711	2	20	80	0.2500000
NODE_1886_length_1654_cov_17.245016	684	764	0	9	80	0.1125000
NODE_1886_length_1654_cov_17.245016	684	764	2	71	80	0.8875000
NODE_1888_length_1653_cov_34.827542	0	41	0	41	41	1.0000000
NODE_1888_length_1653_cov_34.827542	14	44	0	30	30	1.0000000
NODE_1888_length_1653_cov_34.827542	1081	1161	0	80	80	1.0000000
NODE_1888_length_1653_cov_34.827542	1134	1214	0	80	80	1.0000000
NODE_1888_length_1653_cov_34.827542	1210	1290	0	15	80	0.1875000
NODE_1888_length_1653_cov_34.827542	1210	1290	2	13	80	0.1625000
NODE_1888_length_1653_cov_34.827542	1210	1290	9	52	80	0.6500000
NODE_1888_length_1653_cov_34.827542	1263	1339	7	6	76	0.0789474
NODE_1888_length_1653_cov_34.827542	1263	1339	8	34	76	0.4473684
NODE_1888_length_1653_cov_34.827542	1263	1339	9	36	76	0.4736842
NODE_1892_length_1652_cov_23.939472	1352	1432	0	80	80	1.0000000
NODE_1892_length_1652_cov_23.939472	1405	1485	0	80	80	1.0000000
NODE_1894_length_1651_cov_3.916881	1552	1617	12	65	65	1.0000000
NODE_1899_length_1649_cov_7.480000	774	854	0	80	80	1.0000000
NODE_1899_length_1649_cov_7.480000	827	907	0	80	80	1.0000000
NODE_1903_length_1647_cov_3.534238	1012	1075	0	42	63	0.6666667
NODE_1903_length_1647_cov_3.534238	1012	1075	2	18	63	0.2857143
NODE_1903_length_1647_cov_3.534238	1012	1075	4	3	63	0.0476190
NODE_1906_length_1645_cov_16.040103	155	235	0	80	80	1.0000000
NODE_1906_length_1645_cov_16.040103	208	288	0	80	80	1.0000000
NODE_1906_length_1645_cov_16.040103	1090	1170	0	64	80	0.8000000
NODE_1906_length_1645_cov_16.040103	1090	1170	2	16	80	0.2000000
NODE_1906_length_1645_cov_16.040103	1143	1222	0	79	79	1.0000000
NODE_1908_length_1644_cov_2.902913	1160	1240	6	30	80	0.3750000
NODE_1908_length_1644_cov_2.902913	1160	1240	8	26	80	0.3250000
NODE_1908_length_1644_cov_2.902913	1160	1240	10	7	80	0.0875000
NODE_1908_length_1644_cov_2.902913	1160	1240	12	17	80	0.2125000
NODE_1917_length_1641_cov_34.032425	487	567	0	80	80	1.0000000
NODE_1917_length_1641_cov_34.032425	540	620	0	80	80	1.0000000
NODE_1917_length_1641_cov_34.032425	616	696	0	62	80	0.7750000
NODE_1917_length_1641_cov_34.032425	616	696	4	2	80	0.0250000
NODE_1917_length_1641_cov_34.032425	616	696	8	16	80	0.2000000
NODE_1917_length_1641_cov_34.032425	669	749	0	9	80	0.1125000
NODE_1917_length_1641_cov_34.032425	669	749	4	2	80	0.0250000
NODE_1917_length_1641_cov_34.032425	669	749	8	69	80	0.8625000
NODE_1917_length_1641_cov_34.032425	1168	1248	0	35	80	0.4375000
NODE_1917_length_1641_cov_34.032425	1168	1248	2	45	80	0.5625000
NODE_1917_length_1641_cov_34.032425	1219	1301	0	9	82	0.1097561
NODE_1917_length_1641_cov_34.032425	1219	1301	2	24	82	0.2926829
NODE_1917_length_1641_cov_34.032425	1219	1301	4	49	82	0.5975610
NODE_1918_length_1641_cov_7.042802	339	390	0	50	51	0.9803922
NODE_1918_length_1641_cov_7.042802	339	390	4	1	51	0.0196078
NODE_1922_length_1640_cov_33.097339	943	1023	0	17	80	0.2125000
NODE_1922_length_1640_cov_33.097339	943	1023	2	63	80	0.7875000
NODE_1922_length_1640_cov_33.097339	996	1076	0	31	80	0.3875000
NODE_1922_length_1640_cov_33.097339	996	1076	2	32	80	0.4000000
NODE_1922_length_1640_cov_33.097339	996	1076	6	1	80	0.0125000
NODE_1922_length_1640_cov_33.097339	996	1076	7	16	80	0.2000000
NODE_1922_length_1640_cov_33.097339	1072	1152	7	28	80	0.3500000
NODE_1922_length_1640_cov_33.097339	1072	1152	8	52	80	0.6500000
NODE_1922_length_1640_cov_33.097339	1125	1206	0	46	81	0.5679013
NODE_1922_length_1640_cov_33.097339	1125	1206	7	6	81	0.0740741
NODE_1922_length_1640_cov_33.097339	1125	1206	8	29	81	0.3580247
NODE_1923_length_1640_cov_18.519143	471	551	0	52	80	0.6500000
NODE_1923_length_1640_cov_18.519143	471	551	2	26	80	0.3250000
NODE_1923_length_1640_cov_18.519143	471	551	6	2	80	0.0250000
NODE_1923_length_1640_cov_18.519143	524	604	2	25	80	0.3125000
NODE_1923_length_1640_cov_18.519143	524	604	6	55	80	0.6875000
NODE_1925_length_1639_cov_6.585714	975	1056	0	16	81	0.1975309
NODE_1925_length_1639_cov_6.585714	975	1056	2	17	81	0.2098765
NODE_1925_length_1639_cov_6.585714	975	1056	4	1	81	0.0123457
NODE_1925_length_1639_cov_6.585714	975	1056	6	47	81	0.5802469
NODE_1925_length_1639_cov_6.585714	1028	1109	0	69	81	0.8518519
NODE_1925_length_1639_cov_6.585714	1028	1109	2	12	81	0.1481481
NODE_1926_length_1639_cov_2.163636	1260	1334	0	23	74	0.3108108
NODE_1926_length_1639_cov_2.163636	1260	1334	4	51	74	0.6891892
NODE_1926_length_1639_cov_2.163636	1312	1387	0	75	75	1.0000000
NODE_1928_length_1638_cov_18.598441	443	523	2	35	80	0.4375000
NODE_1928_length_1638_cov_18.598441	443	523	4	8	80	0.1000000
NODE_1928_length_1638_cov_18.598441	443	523	5	37	80	0.4625000
NODE_1928_length_1638_cov_18.598441	496	576	0	30	80	0.3750000
NODE_1928_length_1638_cov_18.598441	496	576	2	37	80	0.4625000
NODE_1928_length_1638_cov_18.598441	496	576	4	1	80	0.0125000
NODE_1928_length_1638_cov_18.598441	496	576	5	12	80	0.1500000
NODE_1928_length_1638_cov_18.598441	1157	1237	2	80	80	1.0000000
NODE_1928_length_1638_cov_18.598441	1210	1290	0	49	80	0.6125000
NODE_1928_length_1638_cov_18.598441	1210	1290	2	31	80	0.3875000
NODE_1932_length_1637_cov_12.048765	410	490	0	80	80	1.0000000
NODE_1932_length_1637_cov_12.048765	463	543	0	80	80	1.0000000
NODE_1932_length_1637_cov_12.048765	1081	1161	0	80	80	1.0000000
NODE_1932_length_1637_cov_12.048765	1134	1214	0	80	80	1.0000000
NODE_1934_length_1635_cov_21.022786	958	1038	0	80	80	1.0000000
NODE_1934_length_1635_cov_21.022786	1011	1091	0	80	80	1.0000000
NODE_1934_length_1635_cov_21.022786	1087	1167	0	80	80	1.0000000
NODE_1934_length_1635_cov_21.022786	1140	1220	0	80	80	1.0000000
NODE_1936_length_1633_cov_16.743807	1067	1147	0	80	80	1.0000000
NODE_1936_length_1633_cov_16.743807	1120	1200	0	80	80	1.0000000
NODE_1937_length_1633_cov_14.271838	977	1057	0	80	80	1.0000000
NODE_1937_length_1633_cov_14.271838	1030	1110	0	80	80	1.0000000
NODE_1937_length_1633_cov_14.271838	1106	1186	0	80	80	1.0000000
NODE_1937_length_1633_cov_14.271838	1159	1239	0	80	80	1.0000000
NODE_1939_length_1631_cov_25.881201	424	504	0	32	80	0.4000000
NODE_1939_length_1631_cov_25.881201	424	504	2	48	80	0.6000000
NODE_1939_length_1631_cov_25.881201	477	557	0	80	80	1.0000000
NODE_1939_length_1631_cov_25.881201	553	633	0	37	80	0.4625000
NODE_1939_length_1631_cov_25.881201	553	633	2	43	80	0.5375000
NODE_1939_length_1631_cov_25.881201	606	686	2	80	80	1.0000000
NODE_1943_length_1629_cov_32.733987	518	598	0	80	80	1.0000000
NODE_1943_length_1629_cov_32.733987	635	715	0	5	80	0.0625000
NODE_1943_length_1629_cov_32.733987	635	715	2	6	80	0.0750000
NODE_1943_length_1629_cov_32.733987	635	715	4	14	80	0.1750000
NODE_1943_length_1629_cov_32.733987	635	715	8	3	80	0.0375000
NODE_1943_length_1629_cov_32.733987	635	715	9	1	80	0.0125000
NODE_1943_length_1629_cov_32.733987	635	715	10	51	80	0.6375000
NODE_1943_length_1629_cov_32.733987	688	768	0	19	80	0.2375000
NODE_1943_length_1629_cov_32.733987	688	768	2	2	80	0.0250000
NODE_1943_length_1629_cov_32.733987	688	768	4	6	80	0.0750000
NODE_1943_length_1629_cov_32.733987	688	768	6	14	80	0.1750000
NODE_1943_length_1629_cov_32.733987	688	768	10	39	80	0.4875000
NODE_1946_length_1628_cov_15.551995	1454	1518	315	1	64	0.0156250
NODE_1946_length_1628_cov_15.551995	1454	1518	325	1	64	0.0156250
NODE_1946_length_1628_cov_15.551995	1454	1518	336	1	64	0.0156250
NODE_1946_length_1628_cov_15.551995	1454	1518	353	1	64	0.0156250
NODE_1946_length_1628_cov_15.551995	1454	1518	392	1	64	0.0156250
NODE_1946_length_1628_cov_15.551995	1454	1518	423	1	64	0.0156250
NODE_1946_length_1628_cov_15.551995	1454	1518	434	1	64	0.0156250
NODE_1946_length_1628_cov_15.551995	1454	1518	441	1	64	0.0156250
NODE_1946_length_1628_cov_15.551995	1454	1518	451	1	64	0.0156250
NODE_1946_length_1628_cov_15.551995	1454	1518	470	1	64	0.0156250
NODE_1946_length_1628_cov_15.551995	1454	1518	471	1	64	0.0156250
NODE_1946_length_1628_cov_15.551995	1454	1518	487	1	64	0.0156250
NODE_1946_length_1628_cov_15.551995	1454	1518	494	1	64	0.0156250
NODE_1946_length_1628_cov_15.551995	1454	1518	508	1	64	0.0156250
NODE_1946_length_1628_cov_15.551995	1454	1518	512	1	64	0.0156250
NODE_1946_length_1628_cov_15.551995	1454	1518	516	1	64	0.0156250
NODE_1946_length_1628_cov_15.551995	1454	1518	539	1	64	0.0156250
NODE_1946_length_1628_cov_15.551995	1454	1518	564	1	64	0.0156250
NODE_1946_length_1628_cov_15.551995	1454	1518	574	1	64	0.0156250
NODE_1946_length_1628_cov_15.551995	1454	1518	580	1	64	0.0156250
NODE_1946_length_1628_cov_15.551995	1454	1518	598	1	64	0.0156250
NODE_1946_length_1628_cov_15.551995	1454	1518	600	1	64	0.0156250
NODE_1946_length_1628_cov_15.551995	1454	1518	617	1	64	0.0156250
NODE_1946_length_1628_cov_15.551995	1454	1518	634	1	64	0.0156250
NODE_1946_length_1628_cov_15.551995	1454	1518	635	1	64	0.0156250
NODE_1946_length_1628_cov_15.551995	1454	1518	643	1	64	0.0156250
NODE_1946_length_1628_cov_15.551995	1454	1518	650	1	64	0.0156250
NODE_1946_length_1628_cov_15.551995	1454	1518	667	1	64	0.0156250
NODE_1946_length_1628_cov_15.551995	1454	1518	677	1	64	0.0156250
NODE_1946_length_1628_cov_15.551995	1454	1518	681	1	64	0.0156250
NODE_1946_length_1628_cov_15.551995	1454	1518	701	1	64	0.0156250
NODE_1946_length_1628_cov_15.551995	1454	1518	705	1	64	0.0156250
NODE_1946_length_1628_cov_15.551995	1454	1518	713	1	64	0.0156250
NODE_1946_length_1628_cov_15.551995	1454	1518	722	1	64	0.0156250
NODE_1946_length_1628_cov_15.551995	1454	1518	729	1	64	0.0156250
NODE_1946_length_1628_cov_15.551995	1454	1518	733	1	64	0.0156250
NODE_1946_length_1628_cov_15.551995	1454	1518	735	1	64	0.0156250
NODE_1946_length_1628_cov_15.551995	1454	1518	745	1	64	0.0156250
NODE_1946_length_1628_cov_15.551995	1454	1518	746	2	64	0.0312500
NODE_1946_length_1628_cov_15.551995	1454	1518	754	1	64	0.0156250
NODE_1946_length_1628_cov_15.551995	1454	1518	760	1	64	0.0156250
NODE_1946_length_1628_cov_15.551995	1454	1518	770	1	64	0.0156250
NODE_1946_length_1628_cov_15.551995	1454	1518	772	1	64	0.0156250
NODE_1946_length_1628_cov_15.551995	1454	1518	776	1	64	0.0156250
NODE_1946_length_1628_cov_15.551995	1454	1518	782	1	64	0.0156250
NODE_1946_length_1628_cov_15.551995	1454	1518	790	1	64	0.0156250
NODE_1946_length_1628_cov_15.551995	1454	1518	809	1	64	0.0156250
NODE_1946_length_1628_cov_15.551995	1454	1518	815	1	64	0.0156250
NODE_1946_length_1628_cov_15.551995	1454	1518	817	1	64	0.0156250
NODE_1946_length_1628_cov_15.551995	1454	1518	819	1	64	0.0156250
NODE_1946_length_1628_cov_15.551995	1454	1518	829	4	64	0.0625000
NODE_1946_length_1628_cov_15.551995	1454	1518	834	1	64	0.0156250
NODE_1946_length_1628_cov_15.551995	1454	1518	850	1	64	0.0156250
NODE_1946_length_1628_cov_15.551995	1454	1518	856	1	64	0.0156250
NODE_1946_length_1628_cov_15.551995	1454	1518	864	1	64	0.0156250
NODE_1946_length_1628_cov_15.551995	1454	1518	872	1	64	0.0156250
NODE_1946_length_1628_cov_15.551995	1454	1518	876	1	64	0.0156250
NODE_1946_length_1628_cov_15.551995	1454	1518	879	1	64	0.0156250
NODE_1946_length_1628_cov_15.551995	1454	1518	884	1	64	0.0156250
NODE_1946_length_1628_cov_15.551995	1454	1518	886	1	64	0.0156250
NODE_1947_length_1628_cov_4.852845	81	163	14	6	82	0.0731707
NODE_1947_length_1628_cov_4.852845	81	163	16	4	82	0.0487805
NODE_1947_length_1628_cov_4.852845	81	163	20	16	82	0.1951219
NODE_1947_length_1628_cov_4.852845	81	163	22	5	82	0.0609756
NODE_1947_length_1628_cov_4.852845	81	163	24	24	82	0.2926829
NODE_1947_length_1628_cov_4.852845	81	163	26	24	82	0.2926829
NODE_1947_length_1628_cov_4.852845	81	163	28	3	82	0.0365854
NODE_1952_length_1626_cov_20.549443	495	575	0	80	80	1.0000000
NODE_1952_length_1626_cov_20.549443	548	628	0	80	80	1.0000000
NODE_1953_length_1626_cov_6.552718	1189	1269	0	2	80	0.0250000
NODE_1953_length_1626_cov_6.552718	1189	1269	2	78	80	0.9750000
NODE_1953_length_1626_cov_6.552718	1242	1321	0	53	79	0.6708861
NODE_1953_length_1626_cov_6.552718	1242	1321	2	26	79	0.3291139
NODE_1954_length_1626_cov_4.728880	247	329	4	29	82	0.3536585
NODE_1954_length_1626_cov_4.728880	247	329	5	1	82	0.0121951
NODE_1954_length_1626_cov_4.728880	247	329	6	3	82	0.0365854
NODE_1954_length_1626_cov_4.728880	247	329	8	1	82	0.0121951
NODE_1954_length_1626_cov_4.728880	247	329	10	48	82	0.5853658
NODE_1954_length_1626_cov_4.728880	302	382	2	5	80	0.0625000
NODE_1954_length_1626_cov_4.728880	302	382	4	13	80	0.1625000
NODE_1954_length_1626_cov_4.728880	302	382	6	31	80	0.3875000
NODE_1954_length_1626_cov_4.728880	302	382	10	31	80	0.3875000
NODE_1956_length_1625_cov_20.598952	938	1018	0	17	80	0.2125000
NODE_1956_length_1625_cov_20.598952	938	1018	4	63	80	0.7875000
NODE_1956_length_1625_cov_20.598952	991	1071	0	25	80	0.3125000
NODE_1956_length_1625_cov_20.598952	991	1071	4	55	80	0.6875000
NODE_1962_length_1623_cov_28.551181	416	486	30	1	70	0.0142857
NODE_1962_length_1623_cov_28.551181	416	486	32	1	70	0.0142857
NODE_1962_length_1623_cov_28.551181	416	486	33	1	70	0.0142857
NODE_1962_length_1623_cov_28.551181	416	486	35	4	70	0.0571429
NODE_1962_length_1623_cov_28.551181	416	486	36	1	70	0.0142857
NODE_1962_length_1623_cov_28.551181	416	486	38	3	70	0.0428571
NODE_1962_length_1623_cov_28.551181	416	486	39	3	70	0.0428571
NODE_1962_length_1623_cov_28.551181	416	486	41	1	70	0.0142857
NODE_1962_length_1623_cov_28.551181	416	486	42	14	70	0.2000000
NODE_1962_length_1623_cov_28.551181	416	486	44	2	70	0.0285714
NODE_1962_length_1623_cov_28.551181	416	486	46	6	70	0.0857143
NODE_1962_length_1623_cov_28.551181	416	486	48	30	70	0.4285714
NODE_1962_length_1623_cov_28.551181	416	486	50	3	70	0.0428571
NODE_1962_length_1623_cov_28.551181	459	507	14	3	48	0.0625000
NODE_1962_length_1623_cov_28.551181	459	507	15	3	48	0.0625000
NODE_1962_length_1623_cov_28.551181	459	507	16	1	48	0.0208333
NODE_1962_length_1623_cov_28.551181	459	507	19	2	48	0.0416667
NODE_1962_length_1623_cov_28.551181	459	507	21	1	48	0.0208333
NODE_1962_length_1623_cov_28.551181	459	507	22	1	48	0.0208333
NODE_1962_length_1623_cov_28.551181	459	507	23	5	48	0.1041667
NODE_1962_length_1623_cov_28.551181	459	507	25	2	48	0.0416667
NODE_1962_length_1623_cov_28.551181	459	507	26	2	48	0.0416667
NODE_1962_length_1623_cov_28.551181	459	507	28	1	48	0.0208333
NODE_1962_length_1623_cov_28.551181	459	507	30	1	48	0.0208333
NODE_1962_length_1623_cov_28.551181	459	507	32	1	48	0.0208333
NODE_1962_length_1623_cov_28.551181	459	507	33	1	48	0.0208333
NODE_1962_length_1623_cov_28.551181	459	507	35	4	48	0.0833333
NODE_1962_length_1623_cov_28.551181	459	507	36	1	48	0.0208333
NODE_1962_length_1623_cov_28.551181	459	507	38	3	48	0.0625000
NODE_1962_length_1623_cov_28.551181	459	507	39	3	48	0.0625000
NODE_1962_length_1623_cov_28.551181	459	507	41	1	48	0.0208333
NODE_1962_length_1623_cov_28.551181	459	507	42	12	48	0.2500000
NODE_1965_length_1622_cov_7.969140	645	725	2	62	80	0.7750000
NODE_1965_length_1622_cov_7.969140	645	725	4	18	80	0.2250000
NODE_1965_length_1622_cov_7.969140	698	778	2	55	80	0.6875000
NODE_1965_length_1622_cov_7.969140	698	778	4	25	80	0.3125000
NODE_1970_length_1621_cov_2.192510	330	401	4	71	71	1.0000000
NODE_1975_length_1618_cov_44.138907	361	441	0	8	80	0.1000000
NODE_1975_length_1618_cov_44.138907	361	441	2	72	80	0.9000000
NODE_1975_length_1618_cov_44.138907	414	494	0	33	80	0.4125000
NODE_1975_length_1618_cov_44.138907	414	494	2	47	80	0.5875000
NODE_1975_length_1618_cov_44.138907	1063	1143	0	80	80	1.0000000
NODE_1975_length_1618_cov_44.138907	1116	1196	0	55	80	0.6875000
NODE_1975_length_1618_cov_44.138907	1116	1196	2	25	80	0.3125000
NODE_1976_length_1618_cov_5.779460	332	414	0	7	82	0.0853659
NODE_1976_length_1618_cov_5.779460	332	414	2	1	82	0.0121951
NODE_1976_length_1618_cov_5.779460	332	414	4	20	82	0.2439024
NODE_1976_length_1618_cov_5.779460	332	414	8	20	82	0.2439024
NODE_1976_length_1618_cov_5.779460	332	414	10	34	82	0.4146341
NODE_1976_length_1618_cov_5.779460	387	467	0	3	80	0.0375000
NODE_1976_length_1618_cov_5.779460	387	467	2	3	80	0.0375000
NODE_1976_length_1618_cov_5.779460	387	467	4	25	80	0.3125000
NODE_1976_length_1618_cov_5.779460	387	467	6	3	80	0.0375000
NODE_1976_length_1618_cov_5.779460	387	467	10	46	80	0.5750000
NODE_1976_length_1618_cov_5.779460	972	1028	0	21	56	0.3750000
NODE_1976_length_1618_cov_5.779460	972	1028	2	35	56	0.6250000
NODE_1980_length_1616_cov_5.313777	589	669	0	80	80	1.0000000
NODE_1980_length_1616_cov_5.313777	642	722	0	80	80	1.0000000
NODE_1981_length_1615_cov_12.575858	1032	1112	2	80	80	1.0000000
NODE_1981_length_1615_cov_12.575858	1085	1162	0	39	77	0.5064935
NODE_1981_length_1615_cov_12.575858	1085	1162	2	38	77	0.4935065
NODE_1981_length_1615_cov_12.575858	1158	1238	0	40	80	0.5000000
NODE_1981_length_1615_cov_12.575858	1158	1238	2	40	80	0.5000000
NODE_1981_length_1615_cov_12.575858	1211	1291	2	80	80	1.0000000
NODE_1983_length_1614_cov_94.900990	0	46	0	3	46	0.0652174
NODE_1983_length_1614_cov_94.900990	0	46	4	14	46	0.3043478
NODE_1983_length_1614_cov_94.900990	0	46	6	29	46	0.6304348
NODE_1983_length_1614_cov_94.900990	23	99	6	76	76	1.0000000
NODE_1984_length_1614_cov_18.799340	655	735	0	14	80	0.1750000
NODE_1984_length_1614_cov_18.799340	655	735	5	1	80	0.0125000
NODE_1984_length_1614_cov_18.799340	655	735	6	65	80	0.8125000
NODE_1984_length_1614_cov_18.799340	708	788	0	47	80	0.5875000
NODE_1984_length_1614_cov_18.799340	708	788	6	33	80	0.4125000
NODE_1986_length_1613_cov_6.865258	1128	1203	5	6	75	0.0800000
NODE_1986_length_1613_cov_6.865258	1128	1203	6	2	75	0.0266667
NODE_1986_length_1613_cov_6.865258	1128	1203	8	10	75	0.1333333
NODE_1986_length_1613_cov_6.865258	1128	1203	10	53	75	0.7066666
NODE_1986_length_1613_cov_6.865258	1128	1203	12	4	75	0.0533333
NODE_1986_length_1613_cov_6.865258	1176	1256	6	16	80	0.2000000
NODE_1986_length_1613_cov_6.865258	1176	1256	7	12	80	0.1500000
NODE_1986_length_1613_cov_6.865258	1176	1256	8	30	80	0.3750000
NODE_1986_length_1613_cov_6.865258	1176	1256	10	18	80	0.2250000
NODE_1986_length_1613_cov_6.865258	1176	1256	12	4	80	0.0500000
NODE_1993_length_1610_cov_18.014560	1035	1115	0	46	80	0.5750000
NODE_1993_length_1610_cov_18.014560	1035	1115	2	34	80	0.4250000
NODE_1993_length_1610_cov_18.014560	1088	1168	2	80	80	1.0000000
NODE_2001_length_1603_cov_9.128324	1109	1189	2	43	80	0.5375000
NODE_2001_length_1603_cov_9.128324	1109	1189	4	37	80	0.4625000
NODE_2001_length_1603_cov_9.128324	1162	1242	0	1	80	0.0125000
NODE_2001_length_1603_cov_9.128324	1162	1242	2	30	80	0.3750000
NODE_2001_length_1603_cov_9.128324	1162	1242	4	49	80	0.6125000
NODE_2003_length_1602_cov_79.840319	1378	1445	32	3	67	0.0447761
NODE_2003_length_1602_cov_79.840319	1378	1445	33	2	67	0.0298507
NODE_2003_length_1602_cov_79.840319	1378	1445	35	6	67	0.0895522
NODE_2003_length_1602_cov_79.840319	1378	1445	37	1	67	0.0149254
NODE_2003_length_1602_cov_79.840319	1378	1445	39	5	67	0.0746269
NODE_2003_length_1602_cov_79.840319	1378	1445	41	2	67	0.0298507
NODE_2003_length_1602_cov_79.840319	1378	1445	43	4	67	0.0597015
NODE_2003_length_1602_cov_79.840319	1378	1445	44	1	67	0.0149254
NODE_2003_length_1602_cov_79.840319	1378	1445	46	1	67	0.0149254
NODE_2003_length_1602_cov_79.840319	1378	1445	50	1	67	0.0149254
NODE_2003_length_1602_cov_79.840319	1378	1445	56	2	67	0.0298507
NODE_2003_length_1602_cov_79.840319	1378	1445	59	1	67	0.0149254
NODE_2003_length_1602_cov_79.840319	1378	1445	61	1	67	0.0149254
NODE_2003_length_1602_cov_79.840319	1378	1445	64	1	67	0.0149254
NODE_2003_length_1602_cov_79.840319	1378	1445	66	1	67	0.0149254
NODE_2003_length_1602_cov_79.840319	1378	1445	70	1	67	0.0149254
NODE_2003_length_1602_cov_79.840319	1378	1445	72	3	67	0.0447761
NODE_2003_length_1602_cov_79.840319	1378	1445	74	5	67	0.0746269
NODE_2003_length_1602_cov_79.840319	1378	1445	75	2	67	0.0298507
NODE_2003_length_1602_cov_79.840319	1378	1445	76	2	67	0.0298507
NODE_2003_length_1602_cov_79.840319	1378	1445	77	1	67	0.0149254
NODE_2003_length_1602_cov_79.840319	1378	1445	80	7	67	0.1044776
NODE_2003_length_1602_cov_79.840319	1378	1445	82	1	67	0.0149254
NODE_2003_length_1602_cov_79.840319	1378	1445	86	1	67	0.0149254
NODE_2003_length_1602_cov_79.840319	1378	1445	88	1	67	0.0149254
NODE_2003_length_1602_cov_79.840319	1378	1445	91	3	67	0.0447761
NODE_2003_length_1602_cov_79.840319	1378	1445	92	1	67	0.0149254
NODE_2003_length_1602_cov_79.840319	1378	1445	98	2	67	0.0298507
NODE_2003_length_1602_cov_79.840319	1378	1445	102	1	67	0.0149254
NODE_2003_length_1602_cov_79.840319	1378	1445	103	2	67	0.0298507
NODE_2003_length_1602_cov_79.840319	1378	1445	105	2	67	0.0298507
NODE_2003_length_1602_cov_79.840319	1462	1508	16	3	46	0.0652174
NODE_2003_length_1602_cov_79.840319	1462	1508	18	5	46	0.1086956
NODE_2003_length_1602_cov_79.840319	1462	1508	19	8	46	0.1739130
NODE_2003_length_1602_cov_79.840319	1462	1508	20	1	46	0.0217391
NODE_2003_length_1602_cov_79.840319	1462	1508	21	1	46	0.0217391
NODE_2003_length_1602_cov_79.840319	1462	1508	22	4	46	0.0869565
NODE_2003_length_1602_cov_79.840319	1462	1508	24	2	46	0.0434783
NODE_2003_length_1602_cov_79.840319	1462	1508	25	4	46	0.0869565
NODE_2003_length_1602_cov_79.840319	1462	1508	26	11	46	0.2391304
NODE_2003_length_1602_cov_79.840319	1462	1508	27	4	46	0.0869565
NODE_2003_length_1602_cov_79.840319	1462	1508	28	1	46	0.0217391
NODE_2003_length_1602_cov_79.840319	1462	1508	30	2	46	0.0434783
NODE_2004_length_1602_cov_2.701264	1490	1570	11	11	80	0.1375000
NODE_2004_length_1602_cov_2.701264	1490	1570	12	3	80	0.0375000
NODE_2004_length_1602_cov_2.701264	1490	1570	14	19	80	0.2375000
NODE_2004_length_1602_cov_2.701264	1490	1570	16	47	80	0.5875000
NODE_2009_length_1600_cov_34.988008	785	865	0	41	80	0.5125000
NODE_2009_length_1600_cov_34.988008	785	865	2	4	80	0.0500000
NODE_2009_length_1600_cov_34.988008	785	865	4	35	80	0.4375000
NODE_2009_length_1600_cov_34.988008	838	918	2	37	80	0.4625000
NODE_2009_length_1600_cov_34.988008	838	918	4	35	80	0.4375000
NODE_2009_length_1600_cov_34.988008	838	918	5	8	80	0.1000000
NODE_2009_length_1600_cov_34.988008	914	994	3	13	80	0.1625000
NODE_2009_length_1600_cov_34.988008	914	994	5	8	80	0.1000000
NODE_2009_length_1600_cov_34.988008	914	994	8	59	80	0.7375000
NODE_2009_length_1600_cov_34.988008	967	1047	6	14	80	0.1750000
NODE_2009_length_1600_cov_34.988008	967	1047	7	1	80	0.0125000
NODE_2009_length_1600_cov_34.988008	967	1047	8	65	80	0.8125000
NODE_2011_length_1600_cov_11.383744	0	72	0	72	72	1.0000000
NODE_2011_length_1600_cov_11.383744	45	99	0	54	54	1.0000000
NODE_2011_length_1600_cov_11.383744	891	971	5	8	80	0.1000000
NODE_2011_length_1600_cov_11.383744	891	971	7	7	80	0.0875000
NODE_2011_length_1600_cov_11.383744	891	971	8	44	80	0.5500000
NODE_2011_length_1600_cov_11.383744	891	971	9	21	80	0.2625000
NODE_2011_length_1600_cov_11.383744	944	1024	3	6	80	0.0750000
NODE_2011_length_1600_cov_11.383744	944	1024	4	4	80	0.0500000
NODE_2011_length_1600_cov_11.383744	944	1024	8	9	80	0.1125000
NODE_2011_length_1600_cov_11.383744	944	1024	9	21	80	0.2625000
NODE_2011_length_1600_cov_11.383744	944	1024	10	40	80	0.5000000
NODE_2013_length_1600_cov_7.236509	1037	1109	0	72	72	1.0000000
NODE_2013_length_1600_cov_7.236509	1090	1160	0	70	70	1.0000000
NODE_2018_length_1598_cov_29.337558	335	415	0	1	80	0.0125000
NODE_2018_length_1598_cov_29.337558	335	415	4	33	80	0.4125000
NODE_2018_length_1598_cov_29.337558	335	415	8	46	80	0.5750000
NODE_2018_length_1598_cov_29.337558	388	468	0	20	80	0.2500000
NODE_2018_length_1598_cov_29.337558	388	468	4	1	80	0.0125000
NODE_2018_length_1598_cov_29.337558	388	468	7	1	80	0.0125000
NODE_2018_length_1598_cov_29.337558	388	468	8	51	80	0.6375000
NODE_2018_length_1598_cov_29.337558	388	468	14	1	80	0.0125000
NODE_2018_length_1598_cov_29.337558	388	468	16	6	80	0.0750000
NODE_2018_length_1598_cov_29.337558	464	516	16	6	52	0.1153846
NODE_2018_length_1598_cov_29.337558	464	516	19	1	52	0.0192308
NODE_2018_length_1598_cov_29.337558	464	516	21	8	52	0.1538462
NODE_2018_length_1598_cov_29.337558	464	516	26	21	52	0.4038461
NODE_2018_length_1598_cov_29.337558	464	516	30	16	52	0.3076923
NODE_2018_length_1598_cov_29.337558	1026	1106	0	80	80	1.0000000
NODE_2018_length_1598_cov_29.337558	1079	1159	0	80	80	1.0000000
NODE_2019_length_1598_cov_3.730487	1117	1197	0	80	80	1.0000000
NODE_2021_length_1597_cov_7.434579	1373	1453	18	1	80	0.0125000
NODE_2021_length_1597_cov_7.434579	1373	1453	20	6	80	0.0750000
NODE_2021_length_1597_cov_7.434579	1373	1453	22	19	80	0.2375000
NODE_2021_length_1597_cov_7.434579	1373	1453	24	10	80	0.1250000
NODE_2021_length_1597_cov_7.434579	1373	1453	26	7	80	0.0875000
NODE_2021_length_1597_cov_7.434579	1373	1453	28	5	80	0.0625000
NODE_2021_length_1597_cov_7.434579	1373	1453	31	2	80	0.0250000
NODE_2021_length_1597_cov_7.434579	1373	1453	33	2	80	0.0250000
NODE_2021_length_1597_cov_7.434579	1373	1453	35	1	80	0.0125000
NODE_2021_length_1597_cov_7.434579	1373	1453	37	2	80	0.0250000
NODE_2021_length_1597_cov_7.434579	1373	1453	39	6	80	0.0750000
NODE_2021_length_1597_cov_7.434579	1373	1453	45	2	80	0.0250000
NODE_2021_length_1597_cov_7.434579	1373	1453	52	2	80	0.0250000
NODE_2021_length_1597_cov_7.434579	1373	1453	56	2	80	0.0250000
NODE_2021_length_1597_cov_7.434579	1373	1453	60	1	80	0.0125000
NODE_2021_length_1597_cov_7.434579	1373	1453	64	1	80	0.0125000
NODE_2021_length_1597_cov_7.434579	1373	1453	75	1	80	0.0125000
NODE_2021_length_1597_cov_7.434579	1373	1453	83	2	80	0.0250000
NODE_2021_length_1597_cov_7.434579	1373	1453	85	1	80	0.0125000
NODE_2021_length_1597_cov_7.434579	1373	1453	92	1	80	0.0125000
NODE_2021_length_1597_cov_7.434579	1373	1453	94	1	80	0.0125000
NODE_2021_length_1597_cov_7.434579	1373	1453	99	1	80	0.0125000
NODE_2021_length_1597_cov_7.434579	1373	1453	106	1	80	0.0125000
NODE_2021_length_1597_cov_7.434579	1373	1453	114	1	80	0.0125000
NODE_2021_length_1597_cov_7.434579	1373	1453	117	2	80	0.0250000
NODE_2021_length_1597_cov_7.434579	1382	1453	22	17	71	0.2394366
NODE_2021_length_1597_cov_7.434579	1382	1453	24	10	71	0.1408451
NODE_2021_length_1597_cov_7.434579	1382	1453	26	7	71	0.0985916
NODE_2021_length_1597_cov_7.434579	1382	1453	28	5	71	0.0704225
NODE_2021_length_1597_cov_7.434579	1382	1453	31	2	71	0.0281690
NODE_2021_length_1597_cov_7.434579	1382	1453	33	2	71	0.0281690
NODE_2021_length_1597_cov_7.434579	1382	1453	35	1	71	0.0140845
NODE_2021_length_1597_cov_7.434579	1382	1453	37	2	71	0.0281690
NODE_2021_length_1597_cov_7.434579	1382	1453	39	6	71	0.0845070
NODE_2021_length_1597_cov_7.434579	1382	1453	45	2	71	0.0281690
NODE_2021_length_1597_cov_7.434579	1382	1453	52	2	71	0.0281690
NODE_2021_length_1597_cov_7.434579	1382	1453	56	2	71	0.0281690
NODE_2021_length_1597_cov_7.434579	1382	1453	60	1	71	0.0140845
NODE_2021_length_1597_cov_7.434579	1382	1453	64	1	71	0.0140845
NODE_2021_length_1597_cov_7.434579	1382	1453	75	1	71	0.0140845
NODE_2021_length_1597_cov_7.434579	1382	1453	83	2	71	0.0281690
NODE_2021_length_1597_cov_7.434579	1382	1453	85	1	71	0.0140845
NODE_2021_length_1597_cov_7.434579	1382	1453	92	1	71	0.0140845
NODE_2021_length_1597_cov_7.434579	1382	1453	94	1	71	0.0140845
NODE_2021_length_1597_cov_7.434579	1382	1453	99	1	71	0.0140845
NODE_2021_length_1597_cov_7.434579	1382	1453	106	1	71	0.0140845
NODE_2021_length_1597_cov_7.434579	1382	1453	114	1	71	0.0140845
NODE_2021_length_1597_cov_7.434579	1382	1453	117	2	71	0.0281690
NODE_2022_length_1595_cov_16.788770	215	267	2	52	52	1.0000000
NODE_2022_length_1595_cov_16.788770	614	673	38	9	59	0.1525424
NODE_2022_length_1595_cov_16.788770	614	673	42	3	59	0.0508475
NODE_2022_length_1595_cov_16.788770	614	673	46	47	59	0.7966102
NODE_2025_length_1593_cov_22.412316	144	224	0	80	80	1.0000000
NODE_2025_length_1593_cov_22.412316	197	277	0	80	80	1.0000000
NODE_2025_length_1593_cov_22.412316	1192	1272	0	21	80	0.2625000
NODE_2025_length_1593_cov_22.412316	1192	1272	2	59	80	0.7375000
NODE_2025_length_1593_cov_22.412316	1245	1325	0	24	80	0.3000000
NODE_2025_length_1593_cov_22.412316	1245	1325	2	44	80	0.5500000
NODE_2025_length_1593_cov_22.412316	1245	1325	4	12	80	0.1500000
NODE_2026_length_1593_cov_14.092369	357	437	2	44	80	0.5500000
NODE_2026_length_1593_cov_14.092369	357	437	4	36	80	0.4500000
NODE_2026_length_1593_cov_14.092369	410	490	0	48	80	0.6000000
NODE_2026_length_1593_cov_14.092369	410	490	2	32	80	0.4000000
NODE_2026_length_1593_cov_14.092369	1061	1141	0	80	80	1.0000000
NODE_2026_length_1593_cov_14.092369	1114	1194	0	80	80	1.0000000
NODE_2031_length_1592_cov_4.576691	277	357	6	80	80	1.0000000
NODE_2031_length_1592_cov_4.576691	330	410	0	24	80	0.3000000
NODE_2031_length_1592_cov_4.576691	330	410	6	56	80	0.7000000
NODE_2034_length_1591_cov_15.481233	841	921	0	17	80	0.2125000
NODE_2034_length_1591_cov_15.481233	841	921	4	25	80	0.3125000
NODE_2034_length_1591_cov_15.481233	841	921	6	2	80	0.0250000
NODE_2034_length_1591_cov_15.481233	841	921	8	10	80	0.1250000
NODE_2034_length_1591_cov_15.481233	841	921	10	26	80	0.3250000
NODE_2034_length_1591_cov_15.481233	894	974	8	22	80	0.2750000
NODE_2034_length_1591_cov_15.481233	894	974	10	58	80	0.7250000
NODE_2035_length_1591_cov_4.040885	35	65	0	30	30	1.0000000
NODE_2035_length_1591_cov_4.040885	38	99	0	56	61	0.9180328
NODE_2035_length_1591_cov_4.040885	38	99	4	3	61	0.0491803
NODE_2035_length_1591_cov_4.040885	38	99	6	2	61	0.0327869
NODE_2042_length_1589_cov_10.184564	379	459	0	80	80	1.0000000
NODE_2042_length_1589_cov_10.184564	432	512	0	80	80	1.0000000
NODE_2042_length_1589_cov_10.184564	473	512	0	39	39	1.0000000
NODE_2042_length_1589_cov_10.184564	508	588	0	80	80	1.0000000
NODE_2042_length_1589_cov_10.184564	561	641	0	80	80	1.0000000
NODE_2043_length_1588_cov_9.955675	415	495	0	80	80	1.0000000
NODE_2043_length_1588_cov_9.955675	468	548	0	80	80	1.0000000
NODE_2046_length_1587_cov_7.942204	710	790	2	30	80	0.3750000
NODE_2046_length_1587_cov_7.942204	710	790	8	2	80	0.0250000
NODE_2046_length_1587_cov_7.942204	710	790	10	1	80	0.0125000
NODE_2046_length_1587_cov_7.942204	710	790	12	2	80	0.0250000
NODE_2046_length_1587_cov_7.942204	710	790	13	1	80	0.0125000
NODE_2046_length_1587_cov_7.942204	710	790	14	3	80	0.0375000
NODE_2046_length_1587_cov_7.942204	710	790	16	2	80	0.0250000
NODE_2046_length_1587_cov_7.942204	710	790	18	7	80	0.0875000
NODE_2046_length_1587_cov_7.942204	710	790	20	12	80	0.1500000
NODE_2046_length_1587_cov_7.942204	710	790	22	12	80	0.1500000
NODE_2046_length_1587_cov_7.942204	710	790	24	8	80	0.1000000
NODE_2046_length_1587_cov_7.942204	763	843	0	51	80	0.6375000
NODE_2046_length_1587_cov_7.942204	763	843	2	29	80	0.3625000
NODE_2049_length_1586_cov_6.488231	447	474	0	27	27	1.0000000
NODE_2049_length_1586_cov_6.488231	447	527	0	80	80	1.0000000
NODE_2049_length_1586_cov_6.488231	500	580	0	80	80	1.0000000
NODE_2056_length_1583_cov_27.825472	800	880	0	80	80	1.0000000
NODE_2056_length_1583_cov_27.825472	853	933	0	80	80	1.0000000
NODE_2056_length_1583_cov_27.825472	929	1009	0	4	80	0.0500000
NODE_2056_length_1583_cov_27.825472	929	1009	1	76	80	0.9500000
NODE_2056_length_1583_cov_27.825472	982	1062	1	80	80	1.0000000
NODE_2060_length_1581_cov_10.610661	457	537	0	19	80	0.2375000
NODE_2060_length_1581_cov_10.610661	457	537	2	61	80	0.7625000
NODE_2060_length_1581_cov_10.610661	510	590	0	72	80	0.9000000
NODE_2060_length_1581_cov_10.610661	510	590	2	8	80	0.1000000
NODE_2065_length_1579_cov_7.395946	5	80	0	75	75	1.0000000
NODE_2065_length_1579_cov_7.395946	58	126	0	68	68	1.0000000
NODE_2066_length_1579_cov_7.152027	1331	1409	0	78	78	1.0000000
NODE_2066_length_1579_cov_7.152027	1382	1462	0	80	80	1.0000000
NODE_2067_length_1579_cov_6.741892	4	52	28	3	48	0.0625000
NODE_2067_length_1579_cov_6.741892	4	52	31	1	48	0.0208333
NODE_2067_length_1579_cov_6.741892	4	52	32	2	48	0.0416667
NODE_2067_length_1579_cov_6.741892	4	52	35	3	48	0.0625000
NODE_2067_length_1579_cov_6.741892	4	52	42	16	48	0.3333333
NODE_2067_length_1579_cov_6.741892	4	52	55	2	48	0.0416667
NODE_2067_length_1579_cov_6.741892	4	52	56	1	48	0.0208333
NODE_2067_length_1579_cov_6.741892	4	52	61	5	48	0.1041667
NODE_2067_length_1579_cov_6.741892	4	52	62	2	48	0.0416667
NODE_2067_length_1579_cov_6.741892	4	52	63	3	48	0.0625000
NODE_2067_length_1579_cov_6.741892	4	52	66	9	48	0.1875000
NODE_2067_length_1579_cov_6.741892	4	52	68	1	48	0.0208333
NODE_2067_length_1579_cov_6.741892	4	52	28	3	48	0.0625000
NODE_2067_length_1579_cov_6.741892	4	52	31	1	48	0.0208333
NODE_2067_length_1579_cov_6.741892	4	52	32	2	48	0.0416667
NODE_2067_length_1579_cov_6.741892	4	52	35	3	48	0.0625000
NODE_2067_length_1579_cov_6.741892	4	52	42	16	48	0.3333333
NODE_2067_length_1579_cov_6.741892	4	52	55	2	48	0.0416667
NODE_2067_length_1579_cov_6.741892	4	52	56	1	48	0.0208333
NODE_2067_length_1579_cov_6.741892	4	52	61	5	48	0.1041667
NODE_2067_length_1579_cov_6.741892	4	52	62	2	48	0.0416667
NODE_2067_length_1579_cov_6.741892	4	52	63	3	48	0.0625000
NODE_2067_length_1579_cov_6.741892	4	52	66	9	48	0.1875000
NODE_2067_length_1579_cov_6.741892	4	52	68	1	48	0.0208333
NODE_2067_length_1579_cov_6.741892	4	52	28	3	48	0.0625000
NODE_2067_length_1579_cov_6.741892	4	52	31	1	48	0.0208333
NODE_2067_length_1579_cov_6.741892	4	52	32	2	48	0.0416667
NODE_2067_length_1579_cov_6.741892	4	52	35	3	48	0.0625000
NODE_2067_length_1579_cov_6.741892	4	52	42	16	48	0.3333333
NODE_2067_length_1579_cov_6.741892	4	52	55	2	48	0.0416667
NODE_2067_length_1579_cov_6.741892	4	52	56	1	48	0.0208333
NODE_2067_length_1579_cov_6.741892	4	52	61	5	48	0.1041667
NODE_2067_length_1579_cov_6.741892	4	52	62	2	48	0.0416667
NODE_2067_length_1579_cov_6.741892	4	52	63	3	48	0.0625000
NODE_2067_length_1579_cov_6.741892	4	52	66	9	48	0.1875000
NODE_2067_length_1579_cov_6.741892	4	52	68	1	48	0.0208333
NODE_2067_length_1579_cov_6.741892	25	105	42	4	80	0.0500000
NODE_2067_length_1579_cov_6.741892	25	105	55	2	80	0.0250000
NODE_2067_length_1579_cov_6.741892	25	105	56	1	80	0.0125000
NODE_2067_length_1579_cov_6.741892	25	105	61	5	80	0.0625000
NODE_2067_length_1579_cov_6.741892	25	105	62	2	80	0.0250000
NODE_2067_length_1579_cov_6.741892	25	105	63	3	80	0.0375000
NODE_2067_length_1579_cov_6.741892	25	105	66	9	80	0.1125000
NODE_2067_length_1579_cov_6.741892	25	105	68	12	80	0.1500000
NODE_2067_length_1579_cov_6.741892	25	105	69	4	80	0.0500000
NODE_2067_length_1579_cov_6.741892	25	105	70	7	80	0.0875000
NODE_2067_length_1579_cov_6.741892	25	105	73	9	80	0.1125000
NODE_2067_length_1579_cov_6.741892	25	105	74	3	80	0.0375000
NODE_2067_length_1579_cov_6.741892	25	105	76	2	80	0.0250000
NODE_2067_length_1579_cov_6.741892	25	105	80	15	80	0.1875000
NODE_2067_length_1579_cov_6.741892	25	105	81	2	80	0.0250000
NODE_2067_length_1579_cov_6.741892	25	91	42	4	66	0.0606061
NODE_2067_length_1579_cov_6.741892	25	91	55	2	66	0.0303030
NODE_2067_length_1579_cov_6.741892	25	91	56	1	66	0.0151515
NODE_2067_length_1579_cov_6.741892	25	91	61	5	66	0.0757576
NODE_2067_length_1579_cov_6.741892	25	91	62	2	66	0.0303030
NODE_2067_length_1579_cov_6.741892	25	91	63	3	66	0.0454545
NODE_2067_length_1579_cov_6.741892	25	91	66	9	66	0.1363636
NODE_2067_length_1579_cov_6.741892	25	91	68	12	66	0.1818182
NODE_2067_length_1579_cov_6.741892	25	91	69	4	66	0.0606061
NODE_2067_length_1579_cov_6.741892	25	91	70	7	66	0.1060606
NODE_2067_length_1579_cov_6.741892	25	91	73	9	66	0.1363636
NODE_2067_length_1579_cov_6.741892	25	91	74	3	66	0.0454545
NODE_2067_length_1579_cov_6.741892	25	91	76	2	66	0.0303030
NODE_2067_length_1579_cov_6.741892	25	91	80	3	66	0.0454545
NODE_2067_length_1579_cov_6.741892	25	96	42	4	71	0.0563380
NODE_2067_length_1579_cov_6.741892	25	96	55	2	71	0.0281690
NODE_2067_length_1579_cov_6.741892	25	96	56	1	71	0.0140845
NODE_2067_length_1579_cov_6.741892	25	96	61	5	71	0.0704225
NODE_2067_length_1579_cov_6.741892	25	96	62	2	71	0.0281690
NODE_2067_length_1579_cov_6.741892	25	96	63	3	71	0.0422535
NODE_2067_length_1579_cov_6.741892	25	96	66	9	71	0.1267606
NODE_2067_length_1579_cov_6.741892	25	96	68	12	71	0.1690141
NODE_2067_length_1579_cov_6.741892	25	96	69	4	71	0.0563380
NODE_2067_length_1579_cov_6.741892	25	96	70	7	71	0.0985916
NODE_2067_length_1579_cov_6.741892	25	96	73	9	71	0.1267606
NODE_2067_length_1579_cov_6.741892	25	96	74	3	71	0.0422535
NODE_2067_length_1579_cov_6.741892	25	96	76	2	71	0.0281690
NODE_2067_length_1579_cov_6.741892	25	96	80	8	71	0.1126761
NODE_2076_length_1575_cov_4.250000	993	1073	0	80	80	1.0000000
NODE_2076_length_1575_cov_4.250000	1046	1126	0	80	80	1.0000000
NODE_2078_length_1574_cov_40.682034	551	631	0	3	80	0.0375000
NODE_2078_length_1574_cov_40.682034	551	631	4	77	80	0.9625000
NODE_2078_length_1574_cov_40.682034	604	684	0	51	80	0.6375000
NODE_2078_length_1574_cov_40.682034	604	684	4	29	80	0.3625000
NODE_2078_length_1574_cov_40.682034	680	760	0	80	80	1.0000000
NODE_2078_length_1574_cov_40.682034	733	813	0	80	80	1.0000000
NODE_2079_length_1574_cov_7.572203	1306	1386	0	49	80	0.6125000
NODE_2079_length_1574_cov_7.572203	1306	1386	2	31	80	0.3875000
NODE_2079_length_1574_cov_7.572203	1359	1439	0	10	80	0.1250000
NODE_2079_length_1574_cov_7.572203	1359	1439	2	70	80	0.8750000
NODE_2081_length_1573_cov_16.107191	437	512	0	75	75	1.0000000
NODE_2081_length_1573_cov_16.107191	485	565	0	80	80	1.0000000
NODE_2081_length_1573_cov_16.107191	561	639	0	44	78	0.5641026
NODE_2081_length_1573_cov_16.107191	561	639	2	34	78	0.4358974
NODE_2081_length_1573_cov_16.107191	612	692	2	80	80	1.0000000
NODE_2085_length_1572_cov_25.966735	359	404	194	3	45	0.0666667
NODE_2085_length_1572_cov_25.966735	359	404	195	1	45	0.0222222
NODE_2085_length_1572_cov_25.966735	359	404	196	2	45	0.0444444
NODE_2085_length_1572_cov_25.966735	359	404	197	3	45	0.0666667
NODE_2085_length_1572_cov_25.966735	359	404	198	4	45	0.0888889
NODE_2085_length_1572_cov_25.966735	359	404	203	2	45	0.0444444
NODE_2085_length_1572_cov_25.966735	359	404	205	1	45	0.0222222
NODE_2085_length_1572_cov_25.966735	359	404	215	1	45	0.0222222
NODE_2085_length_1572_cov_25.966735	359	404	218	1	45	0.0222222
NODE_2085_length_1572_cov_25.966735	359	404	223	1	45	0.0222222
NODE_2085_length_1572_cov_25.966735	359	404	237	1	45	0.0222222
NODE_2085_length_1572_cov_25.966735	359	404	239	1	45	0.0222222
NODE_2085_length_1572_cov_25.966735	359	404	240	1	45	0.0222222
NODE_2085_length_1572_cov_25.966735	359	404	244	1	45	0.0222222
NODE_2085_length_1572_cov_25.966735	359	404	246	1	45	0.0222222
NODE_2085_length_1572_cov_25.966735	359	404	248	1	45	0.0222222
NODE_2085_length_1572_cov_25.966735	359	404	249	1	45	0.0222222
NODE_2085_length_1572_cov_25.966735	359	404	250	2	45	0.0444444
NODE_2085_length_1572_cov_25.966735	359	404	251	1	45	0.0222222
NODE_2085_length_1572_cov_25.966735	359	404	252	1	45	0.0222222
NODE_2085_length_1572_cov_25.966735	359	404	253	1	45	0.0222222
NODE_2085_length_1572_cov_25.966735	359	404	256	3	45	0.0666667
NODE_2085_length_1572_cov_25.966735	359	404	258	1	45	0.0222222
NODE_2085_length_1572_cov_25.966735	359	404	259	1	45	0.0222222
NODE_2085_length_1572_cov_25.966735	359	404	260	3	45	0.0666667
NODE_2085_length_1572_cov_25.966735	359	404	265	1	45	0.0222222
NODE_2085_length_1572_cov_25.966735	359	404	266	1	45	0.0222222
NODE_2085_length_1572_cov_25.966735	359	404	267	1	45	0.0222222
NODE_2085_length_1572_cov_25.966735	359	404	273	1	45	0.0222222
NODE_2085_length_1572_cov_25.966735	359	404	284	1	45	0.0222222
NODE_2085_length_1572_cov_25.966735	359	404	289	1	45	0.0222222
NODE_2085_length_1572_cov_25.966735	405	477	139	1	72	0.0138889
NODE_2085_length_1572_cov_25.966735	405	477	141	2	72	0.0277778
NODE_2085_length_1572_cov_25.966735	405	477	143	3	72	0.0416667
NODE_2085_length_1572_cov_25.966735	405	477	145	1	72	0.0138889
NODE_2085_length_1572_cov_25.966735	405	477	149	2	72	0.0277778
NODE_2085_length_1572_cov_25.966735	405	477	152	4	72	0.0555556
NODE_2085_length_1572_cov_25.966735	405	477	153	1	72	0.0138889
NODE_2085_length_1572_cov_25.966735	405	477	154	1	72	0.0138889
NODE_2085_length_1572_cov_25.966735	405	477	156	3	72	0.0416667
NODE_2085_length_1572_cov_25.966735	405	477	157	2	72	0.0277778
NODE_2085_length_1572_cov_25.966735	405	477	158	4	72	0.0555556
NODE_2085_length_1572_cov_25.966735	405	477	159	2	72	0.0277778
NODE_2085_length_1572_cov_25.966735	405	477	160	1	72	0.0138889
NODE_2085_length_1572_cov_25.966735	405	477	161	4	72	0.0555556
NODE_2085_length_1572_cov_25.966735	405	477	162	1	72	0.0138889
NODE_2085_length_1572_cov_25.966735	405	477	163	3	72	0.0416667
NODE_2085_length_1572_cov_25.966735	405	477	164	1	72	0.0138889
NODE_2085_length_1572_cov_25.966735	405	477	165	1	72	0.0138889
NODE_2085_length_1572_cov_25.966735	405	477	166	3	72	0.0416667
NODE_2085_length_1572_cov_25.966735	405	477	168	4	72	0.0555556
NODE_2085_length_1572_cov_25.966735	405	477	169	3	72	0.0416667
NODE_2085_length_1572_cov_25.966735	405	477	170	1	72	0.0138889
NODE_2085_length_1572_cov_25.966735	405	477	171	2	72	0.0277778
NODE_2085_length_1572_cov_25.966735	405	477	172	1	72	0.0138889
NODE_2085_length_1572_cov_25.966735	405	477	173	1	72	0.0138889
NODE_2085_length_1572_cov_25.966735	405	477	175	1	72	0.0138889
NODE_2085_length_1572_cov_25.966735	405	477	176	1	72	0.0138889
NODE_2085_length_1572_cov_25.966735	405	477	177	4	72	0.0555556
NODE_2085_length_1572_cov_25.966735	405	477	178	3	72	0.0416667
NODE_2085_length_1572_cov_25.966735	405	477	180	2	72	0.0277778
NODE_2085_length_1572_cov_25.966735	405	477	187	1	72	0.0138889
NODE_2085_length_1572_cov_25.966735	405	477	188	5	72	0.0694444
NODE_2085_length_1572_cov_25.966735	405	477	192	1	72	0.0138889
NODE_2085_length_1572_cov_25.966735	405	477	194	2	72	0.0277778
NODE_2085_length_1572_cov_25.966735	1016	1096	0	80	80	1.0000000
NODE_2085_length_1572_cov_25.966735	1069	1149	0	80	80	1.0000000
NODE_2086_length_1572_cov_3.513238	1386	1462	2	43	76	0.5657895
NODE_2086_length_1572_cov_3.513238	1386	1462	4	33	76	0.4342105
NODE_2090_length_1570_cov_21.745071	700	780	0	15	80	0.1875000
NODE_2090_length_1570_cov_21.745071	700	780	2	7	80	0.0875000
NODE_2090_length_1570_cov_21.745071	700	780	4	4	80	0.0500000
NODE_2090_length_1570_cov_21.745071	700	780	6	29	80	0.3625000
NODE_2090_length_1570_cov_21.745071	700	780	8	25	80	0.3125000
NODE_2090_length_1570_cov_21.745071	753	833	2	15	80	0.1875000
NODE_2090_length_1570_cov_21.745071	753	833	4	18	80	0.2250000
NODE_2090_length_1570_cov_21.745071	753	833	6	5	80	0.0625000
NODE_2090_length_1570_cov_21.745071	753	833	8	42	80	0.5250000
NODE_2091_length_1570_cov_3.276003	387	467	0	80	80	1.0000000
NODE_2091_length_1570_cov_3.276003	440	520	0	80	80	1.0000000
NODE_2093_length_1569_cov_53.941497	741	821	0	34	80	0.4250000
NODE_2093_length_1569_cov_53.941497	741	821	4	46	80	0.5750000
NODE_2093_length_1569_cov_53.941497	794	874	4	80	80	1.0000000
NODE_2093_length_1569_cov_53.941497	870	950	0	55	80	0.6875000
NODE_2093_length_1569_cov_53.941497	870	950	4	25	80	0.3125000
NODE_2093_length_1569_cov_53.941497	923	1003	0	80	80	1.0000000
NODE_2094_length_1569_cov_12.426531	640	720	0	80	80	1.0000000
NODE_2094_length_1569_cov_12.426531	693	773	0	80	80	1.0000000
NODE_2094_length_1569_cov_12.426531	769	849	0	80	80	1.0000000
NODE_2094_length_1569_cov_12.426531	822	902	0	80	80	1.0000000
NODE_2095_length_1569_cov_12.365986	450	530	0	4	80	0.0500000
NODE_2095_length_1569_cov_12.365986	450	530	2	37	80	0.4625000
NODE_2095_length_1569_cov_12.365986	450	530	4	5	80	0.0625000
NODE_2095_length_1569_cov_12.365986	450	530	9	7	80	0.0875000
NODE_2095_length_1569_cov_12.365986	450	530	10	27	80	0.3375000
NODE_2095_length_1569_cov_12.365986	450	530	0	4	80	0.0500000
NODE_2095_length_1569_cov_12.365986	450	530	2	37	80	0.4625000
NODE_2095_length_1569_cov_12.365986	450	530	4	5	80	0.0625000
NODE_2095_length_1569_cov_12.365986	450	530	9	7	80	0.0875000
NODE_2095_length_1569_cov_12.365986	450	530	10	27	80	0.3375000
NODE_2095_length_1569_cov_12.365986	503	564	8	10	61	0.1639344
NODE_2095_length_1569_cov_12.365986	503	564	10	51	61	0.8360656
NODE_2095_length_1569_cov_12.365986	503	556	8	2	53	0.0377358
NODE_2095_length_1569_cov_12.365986	503	556	10	51	53	0.9622642
NODE_2096_length_1569_cov_11.599320	798	878	0	80	80	1.0000000
NODE_2096_length_1569_cov_11.599320	851	931	0	80	80	1.0000000
NODE_2097_length_1569_cov_10.917687	521	601	0	80	80	1.0000000
NODE_2097_length_1569_cov_10.917687	574	654	0	80	80	1.0000000
NODE_2108_length_1563_cov_15.357240	590	670	0	80	80	1.0000000
NODE_2108_length_1563_cov_15.357240	643	723	0	80	80	1.0000000
NODE_2110_length_1561_cov_18.420657	354	434	0	80	80	1.0000000
NODE_2110_length_1561_cov_18.420657	407	487	0	80	80	1.0000000
NODE_2110_length_1561_cov_18.420657	483	563	0	80	80	1.0000000
NODE_2110_length_1561_cov_18.420657	536	616	0	80	80	1.0000000
NODE_2116_length_1559_cov_7.071233	347	427	0	80	80	1.0000000
NODE_2116_length_1559_cov_7.071233	400	478	0	78	78	1.0000000
NODE_2116_length_1559_cov_7.071233	1187	1238	0	51	51	1.0000000
NODE_2118_length_1558_cov_3.486635	338	418	0	80	80	1.0000000
NODE_2118_length_1558_cov_3.486635	391	471	0	80	80	1.0000000
NODE_2119_length_1557_cov_17.089163	542	622	0	80	80	1.0000000
NODE_2119_length_1557_cov_17.089163	595	675	0	80	80	1.0000000
NODE_2120_length_1557_cov_4.639918	0	56	0	56	56	1.0000000
NODE_2120_length_1557_cov_4.639918	49	112	0	63	63	1.0000000
NODE_2120_length_1557_cov_4.639918	85	161	0	76	76	1.0000000
NODE_2123_length_1556_cov_23.289636	456	536	0	29	80	0.3625000
NODE_2123_length_1556_cov_23.289636	456	536	4	51	80	0.6375000
NODE_2123_length_1556_cov_23.289636	509	589	0	80	80	1.0000000
NODE_2123_length_1556_cov_23.289636	681	761	0	73	80	0.9125000
NODE_2123_length_1556_cov_23.289636	681	761	2	7	80	0.0875000
NODE_2123_length_1556_cov_23.289636	734	814	0	20	80	0.2500000
NODE_2123_length_1556_cov_23.289636	734	814	2	60	80	0.7500000
NODE_2123_length_1556_cov_23.289636	1445	1525	55	3	80	0.0375000
NODE_2123_length_1556_cov_23.289636	1445	1525	58	1	80	0.0125000
NODE_2123_length_1556_cov_23.289636	1445	1525	61	4	80	0.0500000
NODE_2123_length_1556_cov_23.289636	1445	1525	62	72	80	0.9000000
NODE_2124_length_1556_cov_7.494166	300	380	0	21	80	0.2625000
NODE_2124_length_1556_cov_7.494166	300	380	4	50	80	0.6250000
NODE_2124_length_1556_cov_7.494166	300	380	6	9	80	0.1125000
NODE_2124_length_1556_cov_7.494166	353	433	2	11	80	0.1375000
NODE_2124_length_1556_cov_7.494166	353	433	4	18	80	0.2250000
NODE_2124_length_1556_cov_7.494166	353	433	5	1	80	0.0125000
NODE_2124_length_1556_cov_7.494166	353	433	6	50	80	0.6250000
NODE_2126_length_1555_cov_13.461538	666	746	0	15	80	0.1875000
NODE_2126_length_1555_cov_13.461538	666	746	2	65	80	0.8125000
NODE_2126_length_1555_cov_13.461538	719	799	0	68	80	0.8500000
NODE_2126_length_1555_cov_13.461538	719	799	2	12	80	0.1500000
NODE_2127_length_1554_cov_30.239175	144	226	4	66	82	0.8048781
NODE_2127_length_1554_cov_30.239175	144	226	6	11	82	0.1341463
NODE_2127_length_1554_cov_30.239175	144	226	8	5	82	0.0609756
NODE_2127_length_1554_cov_30.239175	199	279	4	21	80	0.2625000
NODE_2127_length_1554_cov_30.239175	199	279	6	1	80	0.0125000
NODE_2127_length_1554_cov_30.239175	199	279	8	7	80	0.0875000
NODE_2127_length_1554_cov_30.239175	199	279	9	9	80	0.1125000
NODE_2127_length_1554_cov_30.239175	199	279	10	12	80	0.1500000
NODE_2127_length_1554_cov_30.239175	199	279	12	6	80	0.0750000
NODE_2127_length_1554_cov_30.239175	199	279	14	3	80	0.0375000
NODE_2127_length_1554_cov_30.239175	199	279	15	3	80	0.0375000
NODE_2127_length_1554_cov_30.239175	199	279	17	1	80	0.0125000
NODE_2127_length_1554_cov_30.239175	199	279	19	1	80	0.0125000
NODE_2127_length_1554_cov_30.239175	199	279	23	1	80	0.0125000
NODE_2127_length_1554_cov_30.239175	199	279	25	1	80	0.0125000
NODE_2127_length_1554_cov_30.239175	199	279	27	1	80	0.0125000
NODE_2127_length_1554_cov_30.239175	199	279	29	1	80	0.0125000
NODE_2127_length_1554_cov_30.239175	199	279	31	7	80	0.0875000
NODE_2127_length_1554_cov_30.239175	199	279	37	3	80	0.0375000
NODE_2127_length_1554_cov_30.239175	199	279	40	1	80	0.0125000
NODE_2127_length_1554_cov_30.239175	199	279	42	1	80	0.0125000
NODE_2127_length_1554_cov_30.239175	877	903	0	26	26	1.0000000
NODE_2127_length_1554_cov_30.239175	930	1010	0	80	80	1.0000000
NODE_2127_length_1554_cov_30.239175	983	1063	0	80	80	1.0000000
NODE_2128_length_1554_cov_5.381443	1494	1554	8	1	60	0.0166667
NODE_2128_length_1554_cov_5.381443	1494	1554	12	1	60	0.0166667
NODE_2128_length_1554_cov_5.381443	1494	1554	19	1	60	0.0166667
NODE_2128_length_1554_cov_5.381443	1494	1554	25	1	60	0.0166667
NODE_2128_length_1554_cov_5.381443	1494	1554	31	1	60	0.0166667
NODE_2128_length_1554_cov_5.381443	1494	1554	33	2	60	0.0333333
NODE_2128_length_1554_cov_5.381443	1494	1554	35	5	60	0.0833333
NODE_2128_length_1554_cov_5.381443	1494	1554	37	1	60	0.0166667
NODE_2128_length_1554_cov_5.381443	1494	1554	39	13	60	0.2166667
NODE_2128_length_1554_cov_5.381443	1494	1554	40	34	60	0.5666667
NODE_2132_length_1552_cov_11.367515	379	445	0	66	66	1.0000000
NODE_2132_length_1552_cov_11.367515	418	484	0	66	66	1.0000000
NODE_2138_length_1549_cov_15.480000	1288	1368	0	80	80	1.0000000
NODE_2138_length_1549_cov_15.480000	1341	1421	0	80	80	1.0000000
NODE_2142_length_1548_cov_12.789510	770	850	0	80	80	1.0000000
NODE_2142_length_1548_cov_12.789510	823	903	0	80	80	1.0000000
NODE_2149_length_1546_cov_24.069800	775	855	0	22	80	0.2750000
NODE_2149_length_1546_cov_24.069800	775	855	2	58	80	0.7250000
NODE_2149_length_1546_cov_24.069800	828	908	0	14	80	0.1750000
NODE_2149_length_1546_cov_24.069800	828	908	2	66	80	0.8250000
NODE_2150_length_1546_cov_10.911541	417	497	0	53	80	0.6625000
NODE_2150_length_1546_cov_10.911541	417	497	2	15	80	0.1875000
NODE_2150_length_1546_cov_10.911541	417	497	6	12	80	0.1500000
NODE_2150_length_1546_cov_10.911541	470	550	2	15	80	0.1875000
NODE_2150_length_1546_cov_10.911541	470	550	6	65	80	0.8125000
NODE_2150_length_1546_cov_10.911541	1065	1145	0	80	80	1.0000000
NODE_2150_length_1546_cov_10.911541	1118	1198	0	80	80	1.0000000
NODE_2155_length_1543_cov_10.400970	480	560	0	51	80	0.6375000
NODE_2155_length_1543_cov_10.400970	480	560	2	29	80	0.3625000
NODE_2155_length_1543_cov_10.400970	533	613	0	20	80	0.2500000
NODE_2155_length_1543_cov_10.400970	533	613	2	60	80	0.7500000
NODE_2156_length_1543_cov_4.532548	43	98	0	55	55	1.0000000
NODE_2162_length_1541_cov_7.316921	523	603	4	13	80	0.1625000
NODE_2162_length_1541_cov_7.316921	523	603	10	27	80	0.3375000
NODE_2162_length_1541_cov_7.316921	523	603	14	30	80	0.3750000
NODE_2162_length_1541_cov_7.316921	523	603	15	10	80	0.1250000
NODE_2162_length_1541_cov_7.316921	576	658	2	22	82	0.2682927
NODE_2162_length_1541_cov_7.316921	576	658	4	8	82	0.0975610
NODE_2162_length_1541_cov_7.316921	576	658	14	17	82	0.2073171
NODE_2162_length_1541_cov_7.316921	576	658	15	13	82	0.1585366
NODE_2162_length_1541_cov_7.316921	576	658	16	22	82	0.2682927
NODE_2165_length_1539_cov_19.067361	334	414	0	80	80	1.0000000
NODE_2165_length_1539_cov_19.067361	387	467	0	80	80	1.0000000
NODE_2165_length_1539_cov_19.067361	463	543	0	80	80	1.0000000
NODE_2165_length_1539_cov_19.067361	516	596	0	80	80	1.0000000
NODE_2171_length_1538_cov_68.273801	604	684	0	80	80	1.0000000
NODE_2171_length_1538_cov_68.273801	657	737	0	80	80	1.0000000
NODE_2172_length_1538_cov_2.402363	1456	1499	4	43	43	1.0000000
NODE_2173_length_1537_cov_39.413074	782	862	0	80	80	1.0000000
NODE_2173_length_1537_cov_39.413074	835	915	0	80	80	1.0000000
NODE_2173_length_1537_cov_39.413074	911	991	0	5	80	0.0625000
NODE_2173_length_1537_cov_39.413074	911	991	2	75	80	0.9375000
NODE_2173_length_1537_cov_39.413074	964	1044	0	44	80	0.5500000
NODE_2173_length_1537_cov_39.413074	964	1044	2	36	80	0.4500000
NODE_2174_length_1537_cov_30.412378	739	819	0	42	80	0.5250000
NODE_2174_length_1537_cov_30.412378	739	819	2	38	80	0.4750000
NODE_2174_length_1537_cov_30.412378	792	872	0	16	80	0.2000000
NODE_2174_length_1537_cov_30.412378	792	872	2	64	80	0.8000000
NODE_2174_length_1537_cov_30.412378	868	948	0	80	80	1.0000000
NODE_2174_length_1537_cov_30.412378	921	1001	0	80	80	1.0000000
NODE_2175_length_1537_cov_18.707232	669	749	0	80	80	1.0000000
NODE_2175_length_1537_cov_18.707232	722	802	0	80	80	1.0000000
NODE_2176_length_1536_cov_24.991649	832	912	0	80	80	1.0000000
NODE_2176_length_1536_cov_24.991649	885	965	0	80	80	1.0000000
NODE_2176_length_1536_cov_24.991649	961	1041	0	80	80	1.0000000
NODE_2176_length_1536_cov_24.991649	1014	1094	0	80	80	1.0000000
NODE_2183_length_1535_cov_46.662256	992	1072	0	80	80	1.0000000
NODE_2183_length_1535_cov_46.662256	1045	1125	0	80	80	1.0000000
NODE_2183_length_1535_cov_46.662256	1127	1203	0	76	76	1.0000000
NODE_2183_length_1535_cov_46.662256	1176	1256	0	80	80	1.0000000
NODE_2184_length_1535_cov_32.610724	992	1072	0	80	80	1.0000000
NODE_2184_length_1535_cov_32.610724	1045	1125	0	80	80	1.0000000
NODE_2184_length_1535_cov_32.610724	1121	1201	0	80	80	1.0000000
NODE_2184_length_1535_cov_32.610724	1174	1254	0	80	80	1.0000000
NODE_2185_length_1535_cov_25.406685	619	699	2	49	80	0.6125000
NODE_2185_length_1535_cov_25.406685	619	699	4	17	80	0.2125000
NODE_2185_length_1535_cov_25.406685	619	699	8	14	80	0.1750000
NODE_2185_length_1535_cov_25.406685	672	752	4	13	80	0.1625000
NODE_2185_length_1535_cov_25.406685	672	752	6	9	80	0.1125000
NODE_2185_length_1535_cov_25.406685	672	752	7	14	80	0.1750000
NODE_2185_length_1535_cov_25.406685	672	752	8	22	80	0.2750000
NODE_2185_length_1535_cov_25.406685	672	752	9	5	80	0.0625000
NODE_2185_length_1535_cov_25.406685	672	752	10	17	80	0.2125000
NODE_2190_length_1534_cov_13.542857	439	519	0	80	80	1.0000000
NODE_2190_length_1534_cov_13.542857	492	567	0	75	75	1.0000000
NODE_2197_length_1531_cov_17.336592	324	404	0	27	80	0.3375000
NODE_2197_length_1531_cov_17.336592	324	404	2	25	80	0.3125000
NODE_2197_length_1531_cov_17.336592	324	404	5	11	80	0.1375000
NODE_2197_length_1531_cov_17.336592	324	404	6	17	80	0.2125000
NODE_2198_length_1531_cov_6.267458	606	686	0	80	80	1.0000000
NODE_2198_length_1531_cov_6.267458	659	739	0	62	80	0.7750000
NODE_2198_length_1531_cov_6.267458	659	739	2	18	80	0.2250000
NODE_2199_length_1530_cov_13.514326	323	403	0	14	80	0.1750000
NODE_2199_length_1530_cov_13.514326	323	403	2	66	80	0.8250000
NODE_2199_length_1530_cov_13.514326	376	456	2	80	80	1.0000000
NODE_2199_length_1530_cov_13.514326	1465	1513	0	48	48	1.0000000
NODE_2200_length_1530_cov_9.012579	637	717	0	42	80	0.5250000
NODE_2200_length_1530_cov_9.012579	637	717	2	38	80	0.4750000
NODE_2200_length_1530_cov_9.012579	690	770	0	39	80	0.4875000
NODE_2200_length_1530_cov_9.012579	690	770	2	41	80	0.5125000
NODE_2203_length_1529_cov_21.061538	983	1063	0	44	80	0.5500000
NODE_2203_length_1529_cov_21.061538	983	1063	2	36	80	0.4500000
NODE_2203_length_1529_cov_21.061538	1036	1116	0	80	80	1.0000000
NODE_2205_length_1529_cov_1.380420	219	282	0	7	63	0.1111111
NODE_2205_length_1529_cov_1.380420	219	282	2	13	63	0.2063492
NODE_2205_length_1529_cov_1.380420	219	282	4	43	63	0.6825397
NODE_2205_length_1529_cov_1.380420	272	323	0	10	51	0.1960784
NODE_2205_length_1529_cov_1.380420	272	323	2	4	51	0.0784314
NODE_2205_length_1529_cov_1.380420	272	323	4	37	51	0.7254902
NODE_2206_length_1528_cov_8.578027	449	529	0	25	80	0.3125000
NODE_2206_length_1528_cov_8.578027	449	529	4	55	80	0.6875000
NODE_2206_length_1528_cov_8.578027	502	582	0	78	80	0.9750000
NODE_2206_length_1528_cov_8.578027	502	582	4	2	80	0.0250000
NODE_2210_length_1526_cov_92.265592	986	1066	2	30	80	0.3750000
NODE_2210_length_1526_cov_92.265592	986	1066	4	3	80	0.0375000
NODE_2210_length_1526_cov_92.265592	986	1066	6	47	80	0.5875000
NODE_2210_length_1526_cov_92.265592	1039	1119	4	41	80	0.5125000
NODE_2210_length_1526_cov_92.265592	1039	1119	6	39	80	0.4875000
NODE_2211_length_1526_cov_4.051857	291	370	0	77	79	0.9746835
NODE_2211_length_1526_cov_4.051857	291	370	2	2	79	0.0253165
NODE_2213_length_1525_cov_20.232118	1014	1090	101	1	76	0.0131579
NODE_2213_length_1525_cov_20.232118	1014	1090	108	5	76	0.0657895
NODE_2213_length_1525_cov_20.232118	1014	1090	110	1	76	0.0131579
NODE_2213_length_1525_cov_20.232118	1014	1090	111	1	76	0.0131579
NODE_2213_length_1525_cov_20.232118	1014	1090	115	1	76	0.0131579
NODE_2213_length_1525_cov_20.232118	1014	1090	116	2	76	0.0263158
NODE_2213_length_1525_cov_20.232118	1014	1090	117	5	76	0.0657895
NODE_2213_length_1525_cov_20.232118	1014	1090	118	2	76	0.0263158
NODE_2213_length_1525_cov_20.232118	1014	1090	119	2	76	0.0263158
NODE_2213_length_1525_cov_20.232118	1014	1090	121	2	76	0.0263158
NODE_2213_length_1525_cov_20.232118	1014	1090	125	1	76	0.0131579
NODE_2213_length_1525_cov_20.232118	1014	1090	127	3	76	0.0394737
NODE_2213_length_1525_cov_20.232118	1014	1090	129	2	76	0.0263158
NODE_2213_length_1525_cov_20.232118	1014	1090	131	3	76	0.0394737
NODE_2213_length_1525_cov_20.232118	1014	1090	133	8	76	0.1052632
NODE_2213_length_1525_cov_20.232118	1014	1090	135	4	76	0.0526316
NODE_2213_length_1525_cov_20.232118	1014	1090	137	2	76	0.0263158
NODE_2213_length_1525_cov_20.232118	1014	1090	139	2	76	0.0263158
NODE_2213_length_1525_cov_20.232118	1014	1090	141	2	76	0.0263158
NODE_2213_length_1525_cov_20.232118	1014	1090	143	3	76	0.0394737
NODE_2213_length_1525_cov_20.232118	1014	1090	145	7	76	0.0921053
NODE_2213_length_1525_cov_20.232118	1014	1090	147	7	76	0.0921053
NODE_2213_length_1525_cov_20.232118	1014	1090	149	2	76	0.0263158
NODE_2213_length_1525_cov_20.232118	1014	1090	151	4	76	0.0526316
NODE_2213_length_1525_cov_20.232118	1014	1090	153	4	76	0.0526316
NODE_2213_length_1525_cov_20.232118	1281	1338	0	57	57	1.0000000
NODE_2214_length_1525_cov_11.421459	804	884	0	80	80	1.0000000
NODE_2214_length_1525_cov_11.421459	857	937	0	80	80	1.0000000
NODE_2217_length_1524_cov_130.874386	171	243	310	1	72	0.0138889
NODE_2217_length_1524_cov_130.874386	171	243	311	1	72	0.0138889
NODE_2217_length_1524_cov_130.874386	171	243	319	1	72	0.0138889
NODE_2217_length_1524_cov_130.874386	171	243	324	2	72	0.0277778
NODE_2217_length_1524_cov_130.874386	171	243	327	2	72	0.0277778
NODE_2217_length_1524_cov_130.874386	171	243	329	1	72	0.0138889
NODE_2217_length_1524_cov_130.874386	171	243	331	1	72	0.0138889
NODE_2217_length_1524_cov_130.874386	171	243	339	1	72	0.0138889
NODE_2217_length_1524_cov_130.874386	171	243	346	1	72	0.0138889
NODE_2217_length_1524_cov_130.874386	171	243	358	1	72	0.0138889
NODE_2217_length_1524_cov_130.874386	171	243	360	2	72	0.0277778
NODE_2217_length_1524_cov_130.874386	171	243	361	1	72	0.0138889
NODE_2217_length_1524_cov_130.874386	171	243	362	1	72	0.0138889
NODE_2217_length_1524_cov_130.874386	171	243	364	1	72	0.0138889
NODE_2217_length_1524_cov_130.874386	171	243	369	1	72	0.0138889
NODE_2217_length_1524_cov_130.874386	171	243	377	1	72	0.0138889
NODE_2217_length_1524_cov_130.874386	171	243	385	1	72	0.0138889
NODE_2217_length_1524_cov_130.874386	171	243	399	1	72	0.0138889
NODE_2217_length_1524_cov_130.874386	171	243	405	1	72	0.0138889
NODE_2217_length_1524_cov_130.874386	171	243	417	1	72	0.0138889
NODE_2217_length_1524_cov_130.874386	171	243	435	1	72	0.0138889
NODE_2217_length_1524_cov_130.874386	171	243	437	1	72	0.0138889
NODE_2217_length_1524_cov_130.874386	171	243	449	1	72	0.0138889
NODE_2217_length_1524_cov_130.874386	171	243	453	1	72	0.0138889
NODE_2217_length_1524_cov_130.874386	171	243	468	1	72	0.0138889
NODE_2217_length_1524_cov_130.874386	171	243	476	1	72	0.0138889
NODE_2217_length_1524_cov_130.874386	171	243	486	1	72	0.0138889
NODE_2217_length_1524_cov_130.874386	171	243	487	1	72	0.0138889
NODE_2217_length_1524_cov_130.874386	171	243	490	1	72	0.0138889
NODE_2217_length_1524_cov_130.874386	171	243	491	1	72	0.0138889
NODE_2217_length_1524_cov_130.874386	171	243	492	7	72	0.0972222
NODE_2217_length_1524_cov_130.874386	171	243	493	4	72	0.0555556
NODE_2217_length_1524_cov_130.874386	171	243	494	1	72	0.0138889
NODE_2217_length_1524_cov_130.874386	171	243	495	1	72	0.0138889
NODE_2217_length_1524_cov_130.874386	171	243	498	1	72	0.0138889
NODE_2217_length_1524_cov_130.874386	171	243	500	1	72	0.0138889
NODE_2217_length_1524_cov_130.874386	171	243	501	2	72	0.0277778
NODE_2217_length_1524_cov_130.874386	171	243	502	2	72	0.0277778
NODE_2217_length_1524_cov_130.874386	171	243	506	1	72	0.0138889
NODE_2217_length_1524_cov_130.874386	171	243	508	1	72	0.0138889
NODE_2217_length_1524_cov_130.874386	171	243	511	3	72	0.0416667
NODE_2217_length_1524_cov_130.874386	171	243	512	2	72	0.0277778
NODE_2217_length_1524_cov_130.874386	171	243	516	1	72	0.0138889
NODE_2217_length_1524_cov_130.874386	171	243	520	1	72	0.0138889
NODE_2217_length_1524_cov_130.874386	171	243	521	2	72	0.0277778
NODE_2217_length_1524_cov_130.874386	171	243	522	4	72	0.0555556
NODE_2217_length_1524_cov_130.874386	171	243	523	4	72	0.0555556
NODE_2217_length_1524_cov_130.874386	171	243	524	1	72	0.0138889
NODE_2217_length_1524_cov_130.874386	191	247	399	1	56	0.0178571
NODE_2217_length_1524_cov_130.874386	191	247	405	1	56	0.0178571
NODE_2217_length_1524_cov_130.874386	191	247	417	1	56	0.0178571
NODE_2217_length_1524_cov_130.874386	191	247	435	1	56	0.0178571
NODE_2217_length_1524_cov_130.874386	191	247	437	1	56	0.0178571
NODE_2217_length_1524_cov_130.874386	191	247	449	1	56	0.0178571
NODE_2217_length_1524_cov_130.874386	191	247	453	1	56	0.0178571
NODE_2217_length_1524_cov_130.874386	191	247	468	1	56	0.0178571
NODE_2217_length_1524_cov_130.874386	191	247	473	1	56	0.0178571
NODE_2217_length_1524_cov_130.874386	191	247	476	1	56	0.0178571
NODE_2217_length_1524_cov_130.874386	191	247	481	1	56	0.0178571
NODE_2217_length_1524_cov_130.874386	191	247	483	1	56	0.0178571
NODE_2217_length_1524_cov_130.874386	191	247	484	1	56	0.0178571
NODE_2217_length_1524_cov_130.874386	191	247	486	1	56	0.0178571
NODE_2217_length_1524_cov_130.874386	191	247	487	1	56	0.0178571
NODE_2217_length_1524_cov_130.874386	191	247	490	1	56	0.0178571
NODE_2217_length_1524_cov_130.874386	191	247	491	1	56	0.0178571
NODE_2217_length_1524_cov_130.874386	191	247	492	7	56	0.1250000
NODE_2217_length_1524_cov_130.874386	191	247	493	4	56	0.0714286
NODE_2217_length_1524_cov_130.874386	191	247	494	1	56	0.0178571
NODE_2217_length_1524_cov_130.874386	191	247	495	1	56	0.0178571
NODE_2217_length_1524_cov_130.874386	191	247	498	1	56	0.0178571
NODE_2217_length_1524_cov_130.874386	191	247	500	1	56	0.0178571
NODE_2217_length_1524_cov_130.874386	191	247	501	2	56	0.0357143
NODE_2217_length_1524_cov_130.874386	191	247	502	2	56	0.0357143
NODE_2217_length_1524_cov_130.874386	191	247	506	1	56	0.0178571
NODE_2217_length_1524_cov_130.874386	191	247	508	1	56	0.0178571
NODE_2217_length_1524_cov_130.874386	191	247	511	3	56	0.0535714
NODE_2217_length_1524_cov_130.874386	191	247	512	2	56	0.0357143
NODE_2217_length_1524_cov_130.874386	191	247	516	1	56	0.0178571
NODE_2217_length_1524_cov_130.874386	191	247	520	1	56	0.0178571
NODE_2217_length_1524_cov_130.874386	191	247	521	2	56	0.0357143
NODE_2217_length_1524_cov_130.874386	191	247	522	4	56	0.0714286
NODE_2217_length_1524_cov_130.874386	191	247	523	4	56	0.0714286
NODE_2217_length_1524_cov_130.874386	191	247	524	1	56	0.0178571
NODE_2217_length_1524_cov_130.874386	219	296	244	1	77	0.0129870
NODE_2217_length_1524_cov_130.874386	219	296	257	1	77	0.0129870
NODE_2217_length_1524_cov_130.874386	219	296	263	1	77	0.0129870
NODE_2217_length_1524_cov_130.874386	219	296	275	1	77	0.0129870
NODE_2217_length_1524_cov_130.874386	219	296	287	1	77	0.0129870
NODE_2217_length_1524_cov_130.874386	219	296	315	1	77	0.0129870
NODE_2217_length_1524_cov_130.874386	219	296	322	1	77	0.0129870
NODE_2217_length_1524_cov_130.874386	219	296	324	1	77	0.0129870
NODE_2217_length_1524_cov_130.874386	219	296	326	1	77	0.0129870
NODE_2217_length_1524_cov_130.874386	219	296	337	1	77	0.0129870
NODE_2217_length_1524_cov_130.874386	219	296	345	1	77	0.0129870
NODE_2217_length_1524_cov_130.874386	219	296	352	1	77	0.0129870
NODE_2217_length_1524_cov_130.874386	219	296	358	1	77	0.0129870
NODE_2217_length_1524_cov_130.874386	219	296	360	1	77	0.0129870
NODE_2217_length_1524_cov_130.874386	219	296	366	1	77	0.0129870
NODE_2217_length_1524_cov_130.874386	219	296	369	1	77	0.0129870
NODE_2217_length_1524_cov_130.874386	219	296	371	1	77	0.0129870
NODE_2217_length_1524_cov_130.874386	219	296	373	1	77	0.0129870
NODE_2217_length_1524_cov_130.874386	219	296	378	1	77	0.0129870
NODE_2217_length_1524_cov_130.874386	219	296	383	1	77	0.0129870
NODE_2217_length_1524_cov_130.874386	219	296	384	1	77	0.0129870
NODE_2217_length_1524_cov_130.874386	219	296	387	2	77	0.0259740
NODE_2217_length_1524_cov_130.874386	219	296	390	1	77	0.0129870
NODE_2217_length_1524_cov_130.874386	219	296	392	1	77	0.0129870
NODE_2217_length_1524_cov_130.874386	219	296	395	1	77	0.0129870
NODE_2217_length_1524_cov_130.874386	219	296	402	1	77	0.0129870
NODE_2217_length_1524_cov_130.874386	219	296	406	1	77	0.0129870
NODE_2217_length_1524_cov_130.874386	219	296	407	2	77	0.0259740
NODE_2217_length_1524_cov_130.874386	219	296	408	1	77	0.0129870
NODE_2217_length_1524_cov_130.874386	219	296	411	2	77	0.0259740
NODE_2217_length_1524_cov_130.874386	219	296	412	3	77	0.0389610
NODE_2217_length_1524_cov_130.874386	219	296	413	1	77	0.0129870
NODE_2217_length_1524_cov_130.874386	219	296	421	1	77	0.0129870
NODE_2217_length_1524_cov_130.874386	219	296	428	1	77	0.0129870
NODE_2217_length_1524_cov_130.874386	219	296	433	1	77	0.0129870
NODE_2217_length_1524_cov_130.874386	219	296	435	2	77	0.0259740
NODE_2217_length_1524_cov_130.874386	219	296	440	1	77	0.0129870
NODE_2217_length_1524_cov_130.874386	219	296	447	1	77	0.0129870
NODE_2217_length_1524_cov_130.874386	219	296	449	1	77	0.0129870
NODE_2217_length_1524_cov_130.874386	219	296	450	1	77	0.0129870
NODE_2217_length_1524_cov_130.874386	219	296	453	1	77	0.0129870
NODE_2217_length_1524_cov_130.874386	219	296	458	2	77	0.0259740
NODE_2217_length_1524_cov_130.874386	219	296	473	1	77	0.0129870
NODE_2217_length_1524_cov_130.874386	219	296	481	1	77	0.0129870
NODE_2217_length_1524_cov_130.874386	219	296	483	1	77	0.0129870
NODE_2217_length_1524_cov_130.874386	219	296	484	1	77	0.0129870
NODE_2217_length_1524_cov_130.874386	219	296	486	1	77	0.0129870
NODE_2217_length_1524_cov_130.874386	219	296	487	1	77	0.0129870
NODE_2217_length_1524_cov_130.874386	219	296	490	1	77	0.0129870
NODE_2217_length_1524_cov_130.874386	219	296	492	6	77	0.0779221
NODE_2217_length_1524_cov_130.874386	219	296	493	4	77	0.0519481
NODE_2217_length_1524_cov_130.874386	219	296	495	1	77	0.0129870
NODE_2217_length_1524_cov_130.874386	219	296	498	1	77	0.0129870
NODE_2217_length_1524_cov_130.874386	219	296	500	1	77	0.0129870
NODE_2217_length_1524_cov_130.874386	219	296	501	1	77	0.0129870
NODE_2217_length_1524_cov_130.874386	219	296	502	2	77	0.0259740
NODE_2217_length_1524_cov_130.874386	219	296	508	1	77	0.0129870
NODE_2217_length_1524_cov_130.874386	219	296	511	2	77	0.0259740
NODE_2217_length_1524_cov_130.874386	219	296	512	2	77	0.0259740
NODE_2217_length_1524_cov_130.874386	253	333	115	1	80	0.0125000
NODE_2217_length_1524_cov_130.874386	253	333	117	1	80	0.0125000
NODE_2217_length_1524_cov_130.874386	253	333	118	1	80	0.0125000
NODE_2217_length_1524_cov_130.874386	253	333	122	2	80	0.0250000
NODE_2217_length_1524_cov_130.874386	253	333	124	1	80	0.0125000
NODE_2217_length_1524_cov_130.874386	253	333	126	1	80	0.0125000
NODE_2217_length_1524_cov_130.874386	253	333	128	1	80	0.0125000
NODE_2217_length_1524_cov_130.874386	253	333	131	1	80	0.0125000
NODE_2217_length_1524_cov_130.874386	253	333	133	1	80	0.0125000
NODE_2217_length_1524_cov_130.874386	253	333	137	1	80	0.0125000
NODE_2217_length_1524_cov_130.874386	253	333	141	2	80	0.0250000
NODE_2217_length_1524_cov_130.874386	253	333	145	2	80	0.0250000
NODE_2217_length_1524_cov_130.874386	253	333	148	1	80	0.0125000
NODE_2217_length_1524_cov_130.874386	253	333	151	2	80	0.0250000
NODE_2217_length_1524_cov_130.874386	253	333	155	1	80	0.0125000
NODE_2217_length_1524_cov_130.874386	253	333	158	2	80	0.0250000
NODE_2217_length_1524_cov_130.874386	253	333	162	1	80	0.0125000
NODE_2217_length_1524_cov_130.874386	253	333	169	1	80	0.0125000
NODE_2217_length_1524_cov_130.874386	253	333	171	1	80	0.0125000
NODE_2217_length_1524_cov_130.874386	253	333	172	1	80	0.0125000
NODE_2217_length_1524_cov_130.874386	253	333	180	1	80	0.0125000
NODE_2217_length_1524_cov_130.874386	253	333	182	1	80	0.0125000
NODE_2217_length_1524_cov_130.874386	253	333	194	1	80	0.0125000
NODE_2217_length_1524_cov_130.874386	253	333	197	1	80	0.0125000
NODE_2217_length_1524_cov_130.874386	253	333	211	1	80	0.0125000
NODE_2217_length_1524_cov_130.874386	253	333	213	1	80	0.0125000
NODE_2217_length_1524_cov_130.874386	253	333	221	1	80	0.0125000
NODE_2217_length_1524_cov_130.874386	253	333	227	3	80	0.0375000
NODE_2217_length_1524_cov_130.874386	253	333	231	1	80	0.0125000
NODE_2217_length_1524_cov_130.874386	253	333	232	1	80	0.0125000
NODE_2217_length_1524_cov_130.874386	253	333	244	1	80	0.0125000
NODE_2217_length_1524_cov_130.874386	253	333	257	1	80	0.0125000
NODE_2217_length_1524_cov_130.874386	253	333	263	1	80	0.0125000
NODE_2217_length_1524_cov_130.874386	253	333	275	1	80	0.0125000
NODE_2217_length_1524_cov_130.874386	253	333	287	1	80	0.0125000
NODE_2217_length_1524_cov_130.874386	253	333	315	1	80	0.0125000
NODE_2217_length_1524_cov_130.874386	253	333	322	1	80	0.0125000
NODE_2217_length_1524_cov_130.874386	253	333	324	1	80	0.0125000
NODE_2217_length_1524_cov_130.874386	253	333	326	1	80	0.0125000
NODE_2217_length_1524_cov_130.874386	253	333	337	1	80	0.0125000
NODE_2217_length_1524_cov_130.874386	253	333	345	1	80	0.0125000
NODE_2217_length_1524_cov_130.874386	253	333	352	1	80	0.0125000
NODE_2217_length_1524_cov_130.874386	253	333	358	1	80	0.0125000
NODE_2217_length_1524_cov_130.874386	253	333	360	1	80	0.0125000
NODE_2217_length_1524_cov_130.874386	253	333	366	1	80	0.0125000
NODE_2217_length_1524_cov_130.874386	253	333	369	1	80	0.0125000
NODE_2217_length_1524_cov_130.874386	253	333	371	1	80	0.0125000
NODE_2217_length_1524_cov_130.874386	253	333	373	1	80	0.0125000
NODE_2217_length_1524_cov_130.874386	253	333	378	1	80	0.0125000
NODE_2217_length_1524_cov_130.874386	253	333	383	1	80	0.0125000
NODE_2217_length_1524_cov_130.874386	253	333	384	1	80	0.0125000
NODE_2217_length_1524_cov_130.874386	253	333	387	2	80	0.0250000
NODE_2217_length_1524_cov_130.874386	253	333	390	1	80	0.0125000
NODE_2217_length_1524_cov_130.874386	253	333	392	1	80	0.0125000
NODE_2217_length_1524_cov_130.874386	253	333	395	1	80	0.0125000
NODE_2217_length_1524_cov_130.874386	253	333	402	1	80	0.0125000
NODE_2217_length_1524_cov_130.874386	253	333	406	1	80	0.0125000
NODE_2217_length_1524_cov_130.874386	253	333	407	2	80	0.0250000
NODE_2217_length_1524_cov_130.874386	253	333	408	1	80	0.0125000
NODE_2217_length_1524_cov_130.874386	253	333	411	2	80	0.0250000
NODE_2217_length_1524_cov_130.874386	253	333	412	3	80	0.0375000
NODE_2217_length_1524_cov_130.874386	253	333	413	1	80	0.0125000
NODE_2217_length_1524_cov_130.874386	253	333	421	1	80	0.0125000
NODE_2217_length_1524_cov_130.874386	253	333	428	1	80	0.0125000
NODE_2217_length_1524_cov_130.874386	253	333	433	1	80	0.0125000
NODE_2217_length_1524_cov_130.874386	253	333	435	2	80	0.0250000
NODE_2217_length_1524_cov_130.874386	253	333	440	1	80	0.0125000
NODE_2217_length_1524_cov_130.874386	306	386	46	2	80	0.0250000
NODE_2217_length_1524_cov_130.874386	306	386	54	2	80	0.0250000
NODE_2217_length_1524_cov_130.874386	306	386	55	6	80	0.0750000
NODE_2217_length_1524_cov_130.874386	306	386	56	2	80	0.0250000
NODE_2217_length_1524_cov_130.874386	306	386	57	1	80	0.0125000
NODE_2217_length_1524_cov_130.874386	306	386	63	1	80	0.0125000
NODE_2217_length_1524_cov_130.874386	306	386	64	2	80	0.0250000
NODE_2217_length_1524_cov_130.874386	306	386	65	4	80	0.0500000
NODE_2217_length_1524_cov_130.874386	306	386	66	2	80	0.0250000
NODE_2217_length_1524_cov_130.874386	306	386	67	4	80	0.0500000
NODE_2217_length_1524_cov_130.874386	306	386	68	4	80	0.0500000
NODE_2217_length_1524_cov_130.874386	306	386	71	1	80	0.0125000
NODE_2217_length_1524_cov_130.874386	306	386	75	1	80	0.0125000
NODE_2217_length_1524_cov_130.874386	306	386	77	1	80	0.0125000
NODE_2217_length_1524_cov_130.874386	306	386	80	2	80	0.0250000
NODE_2217_length_1524_cov_130.874386	306	386	82	1	80	0.0125000
NODE_2217_length_1524_cov_130.874386	306	386	89	1	80	0.0125000
NODE_2217_length_1524_cov_130.874386	306	386	92	2	80	0.0250000
NODE_2217_length_1524_cov_130.874386	306	386	94	2	80	0.0250000
NODE_2217_length_1524_cov_130.874386	306	386	99	1	80	0.0125000
NODE_2217_length_1524_cov_130.874386	306	386	100	1	80	0.0125000
NODE_2217_length_1524_cov_130.874386	306	386	105	4	80	0.0500000
NODE_2217_length_1524_cov_130.874386	306	386	108	2	80	0.0250000
NODE_2217_length_1524_cov_130.874386	306	386	113	2	80	0.0250000
NODE_2217_length_1524_cov_130.874386	306	386	115	3	80	0.0375000
NODE_2217_length_1524_cov_130.874386	306	386	117	1	80	0.0125000
NODE_2217_length_1524_cov_130.874386	306	386	118	1	80	0.0125000
NODE_2217_length_1524_cov_130.874386	306	386	122	2	80	0.0250000
NODE_2217_length_1524_cov_130.874386	306	386	124	1	80	0.0125000
NODE_2217_length_1524_cov_130.874386	306	386	126	1	80	0.0125000
NODE_2217_length_1524_cov_130.874386	306	386	128	1	80	0.0125000
NODE_2217_length_1524_cov_130.874386	306	386	131	1	80	0.0125000
NODE_2217_length_1524_cov_130.874386	306	386	133	1	80	0.0125000
NODE_2217_length_1524_cov_130.874386	306	386	137	1	80	0.0125000
NODE_2217_length_1524_cov_130.874386	306	386	141	2	80	0.0250000
NODE_2217_length_1524_cov_130.874386	306	386	145	2	80	0.0250000
NODE_2217_length_1524_cov_130.874386	306	386	148	1	80	0.0125000
NODE_2217_length_1524_cov_130.874386	306	386	151	2	80	0.0250000
NODE_2217_length_1524_cov_130.874386	306	386	155	1	80	0.0125000
NODE_2217_length_1524_cov_130.874386	306	386	158	2	80	0.0250000
NODE_2217_length_1524_cov_130.874386	306	386	162	1	80	0.0125000
NODE_2217_length_1524_cov_130.874386	306	386	169	1	80	0.0125000
NODE_2217_length_1524_cov_130.874386	306	386	171	1	80	0.0125000
NODE_2217_length_1524_cov_130.874386	306	386	172	1	80	0.0125000
NODE_2217_length_1524_cov_130.874386	306	386	180	1	80	0.0125000
NODE_2217_length_1524_cov_130.874386	306	386	182	1	80	0.0125000
NODE_2219_length_1523_cov_24.115169	366	446	0	14	80	0.1750000
NODE_2219_length_1523_cov_24.115169	366	446	2	66	80	0.8250000
NODE_2219_length_1523_cov_24.115169	419	499	0	31	80	0.3875000
NODE_2219_length_1523_cov_24.115169	419	499	2	36	80	0.4500000
NODE_2219_length_1523_cov_24.115169	419	499	6	13	80	0.1625000
NODE_2219_length_1523_cov_24.115169	495	575	6	37	80	0.4625000
NODE_2219_length_1523_cov_24.115169	495	575	8	43	80	0.5375000
NODE_2219_length_1523_cov_24.115169	548	628	0	35	80	0.4375000
NODE_2219_length_1523_cov_24.115169	548	628	2	1	80	0.0125000
NODE_2219_length_1523_cov_24.115169	548	628	8	44	80	0.5500000
NODE_2223_length_1522_cov_13.278988	361	441	0	66	80	0.8250000
NODE_2223_length_1522_cov_13.278988	361	441	2	1	80	0.0125000
NODE_2223_length_1522_cov_13.278988	361	441	4	13	80	0.1625000
NODE_2223_length_1522_cov_13.278988	414	494	0	13	80	0.1625000
NODE_2223_length_1522_cov_13.278988	414	494	2	1	80	0.0125000
NODE_2223_length_1522_cov_13.278988	414	494	4	66	80	0.8250000
NODE_2225_length_1521_cov_20.965541	772	852	0	80	80	1.0000000
NODE_2225_length_1521_cov_20.965541	825	905	0	80	80	1.0000000
NODE_2226_length_1521_cov_15.381153	907	987	0	80	80	1.0000000
NODE_2226_length_1521_cov_15.381153	960	1040	0	80	80	1.0000000
NODE_2226_length_1521_cov_15.381153	988	1040	0	52	52	1.0000000
NODE_2227_length_1521_cov_7.682138	525	605	2	80	80	1.0000000
NODE_2227_length_1521_cov_7.682138	578	658	0	15	80	0.1875000
NODE_2227_length_1521_cov_7.682138	578	658	2	65	80	0.8125000
NODE_2236_length_1519_cov_20.792958	714	794	0	9	80	0.1125000
NODE_2236_length_1519_cov_20.792958	714	794	2	15	80	0.1875000
NODE_2236_length_1519_cov_20.792958	714	794	4	56	80	0.7000000
NODE_2236_length_1519_cov_20.792958	767	847	0	18	80	0.2250000
NODE_2236_length_1519_cov_20.792958	767	847	2	28	80	0.3500000
NODE_2236_length_1519_cov_20.792958	767	847	4	34	80	0.4250000
NODE_2239_length_1517_cov_24.074048	413	450	0	2	37	0.0540541
NODE_2239_length_1517_cov_24.074048	413	450	2	35	37	0.9459459
NODE_2239_length_1517_cov_24.074048	842	922	0	80	80	1.0000000
NODE_2239_length_1517_cov_24.074048	895	975	0	80	80	1.0000000
NODE_2240_length_1517_cov_22.897743	383	463	0	31	80	0.3875000
NODE_2240_length_1517_cov_22.897743	383	463	2	36	80	0.4500000
NODE_2240_length_1517_cov_22.897743	383	463	4	13	80	0.1625000
NODE_2240_length_1517_cov_22.897743	436	516	2	49	80	0.6125000
NODE_2240_length_1517_cov_22.897743	436	516	4	31	80	0.3875000
NODE_2241_length_1517_cov_11.781382	381	461	0	38	80	0.4750000
NODE_2241_length_1517_cov_11.781382	381	461	2	42	80	0.5250000
NODE_2241_length_1517_cov_11.781382	434	514	0	80	80	1.0000000
NODE_2243_length_1517_cov_4.944993	393	473	0	80	80	1.0000000
NODE_2243_length_1517_cov_4.944993	446	526	0	80	80	1.0000000
NODE_2247_length_1516_cov_11.177135	230	310	2	32	80	0.4000000
NODE_2247_length_1516_cov_11.177135	230	310	4	1	80	0.0125000
NODE_2247_length_1516_cov_11.177135	230	310	6	47	80	0.5875000
NODE_2247_length_1516_cov_11.177135	283	363	0	1	80	0.0125000
NODE_2247_length_1516_cov_11.177135	283	363	2	19	80	0.2375000
NODE_2247_length_1516_cov_11.177135	283	363	4	9	80	0.1125000
NODE_2247_length_1516_cov_11.177135	283	363	6	51	80	0.6375000
NODE_2248_length_1516_cov_8.608327	580	660	0	7	80	0.0875000
NODE_2248_length_1516_cov_8.608327	580	660	6	1	80	0.0125000
NODE_2248_length_1516_cov_8.608327	580	660	12	72	80	0.9000000
NODE_2248_length_1516_cov_8.608327	633	713	0	14	80	0.1750000
NODE_2248_length_1516_cov_8.608327	633	713	6	10	80	0.1250000
NODE_2248_length_1516_cov_8.608327	633	713	12	56	80	0.7000000
NODE_2250_length_1515_cov_16.990819	333	413	4	1	80	0.0125000
NODE_2250_length_1515_cov_16.990819	333	413	6	32	80	0.4000000
NODE_2250_length_1515_cov_16.990819	333	413	8	1	80	0.0125000
NODE_2250_length_1515_cov_16.990819	333	413	10	5	80	0.0625000
NODE_2250_length_1515_cov_16.990819	333	413	12	3	80	0.0375000
NODE_2250_length_1515_cov_16.990819	333	413	14	2	80	0.0250000
NODE_2250_length_1515_cov_16.990819	333	413	16	2	80	0.0250000
NODE_2250_length_1515_cov_16.990819	333	413	20	8	80	0.1000000
NODE_2250_length_1515_cov_16.990819	333	413	22	8	80	0.1000000
NODE_2250_length_1515_cov_16.990819	333	413	24	4	80	0.0500000
NODE_2250_length_1515_cov_16.990819	333	413	26	3	80	0.0375000
NODE_2250_length_1515_cov_16.990819	333	413	28	1	80	0.0125000
NODE_2250_length_1515_cov_16.990819	333	413	34	2	80	0.0250000
NODE_2250_length_1515_cov_16.990819	333	413	36	4	80	0.0500000
NODE_2250_length_1515_cov_16.990819	333	413	38	2	80	0.0250000
NODE_2250_length_1515_cov_16.990819	333	413	40	1	80	0.0125000
NODE_2250_length_1515_cov_16.990819	333	413	42	1	80	0.0125000
NODE_2250_length_1515_cov_16.990819	386	448	2	22	62	0.3548387
NODE_2250_length_1515_cov_16.990819	386	448	4	14	62	0.2258064
NODE_2250_length_1515_cov_16.990819	386	448	6	26	62	0.4193548
NODE_2258_length_1512_cov_5.111819	506	560	0	54	54	1.0000000
NODE_2258_length_1512_cov_5.111819	677	698	0	21	21	1.0000000
NODE_2258_length_1512_cov_5.111819	677	698	0	21	21	1.0000000
NODE_2258_length_1512_cov_5.111819	1057	1137	0	80	80	1.0000000
NODE_2258_length_1512_cov_5.111819	1110	1190	0	80	80	1.0000000
NODE_2258_length_1512_cov_5.111819	1144	1190	0	46	46	1.0000000
NODE_2259_length_1512_cov_4.251946	132	204	0	59	72	0.8194444
NODE_2259_length_1512_cov_4.251946	132	204	2	13	72	0.1805556
NODE_2262_length_1511_cov_30.963173	787	867	0	80	80	1.0000000
NODE_2262_length_1511_cov_30.963173	840	920	0	80	80	1.0000000
NODE_2262_length_1511_cov_30.963173	916	996	0	80	80	1.0000000
NODE_2262_length_1511_cov_30.963173	969	1059	0	90	90	1.0000000
NODE_2265_length_1510_cov_24.184975	434	514	0	23	80	0.2875000
NODE_2265_length_1510_cov_24.184975	434	514	4	7	80	0.0875000
NODE_2265_length_1510_cov_24.184975	434	514	6	23	80	0.2875000
NODE_2265_length_1510_cov_24.184975	434	514	12	27	80	0.3375000
NODE_2265_length_1510_cov_24.184975	487	567	10	15	80	0.1875000
NODE_2265_length_1510_cov_24.184975	487	567	12	65	80	0.8125000
NODE_2265_length_1510_cov_24.184975	563	643	0	38	80	0.4750000
NODE_2265_length_1510_cov_24.184975	563	643	4	2	80	0.0250000
NODE_2265_length_1510_cov_24.184975	563	643	10	40	80	0.5000000
NODE_2265_length_1510_cov_24.184975	616	696	0	80	80	1.0000000
NODE_2269_length_1509_cov_51.836170	655	735	0	80	80	1.0000000
NODE_2269_length_1509_cov_51.836170	708	788	0	80	80	1.0000000
NODE_2269_length_1509_cov_51.836170	784	864	0	80	80	1.0000000
NODE_2269_length_1509_cov_51.836170	837	917	0	58	80	0.7250000
NODE_2269_length_1509_cov_51.836170	837	917	2	22	80	0.2750000
NODE_2270_length_1509_cov_16.010638	497	577	4	70	80	0.8750000
NODE_2270_length_1509_cov_16.010638	497	577	8	10	80	0.1250000
NODE_2270_length_1509_cov_16.010638	550	630	4	70	80	0.8750000
NODE_2270_length_1509_cov_16.010638	550	630	8	10	80	0.1250000
NODE_2270_length_1509_cov_16.010638	626	706	0	63	80	0.7875000
NODE_2270_length_1509_cov_16.010638	626	706	4	17	80	0.2125000
NODE_2270_length_1509_cov_16.010638	679	759	0	80	80	1.0000000
NODE_2271_length_1509_cov_8.883688	252	332	0	80	80	1.0000000
NODE_2271_length_1509_cov_8.883688	305	385	0	80	80	1.0000000
NODE_2271_length_1509_cov_8.883688	327	385	0	58	58	1.0000000
NODE_2271_length_1509_cov_8.883688	381	461	0	4	80	0.0500000
NODE_2271_length_1509_cov_8.883688	381	461	2	22	80	0.2750000
NODE_2271_length_1509_cov_8.883688	381	461	4	54	80	0.6750000
NODE_2271_length_1509_cov_8.883688	434	514	0	53	80	0.6625000
NODE_2271_length_1509_cov_8.883688	434	514	2	20	80	0.2500000
NODE_2271_length_1509_cov_8.883688	434	514	4	7	80	0.0875000
NODE_2272_length_1509_cov_5.826950	1029	1109	0	2	80	0.0250000
NODE_2272_length_1509_cov_5.826950	1029	1109	2	39	80	0.4875000
NODE_2272_length_1509_cov_5.826950	1029	1109	4	4	80	0.0500000
NODE_2272_length_1509_cov_5.826950	1029	1109	6	35	80	0.4375000
NODE_2272_length_1509_cov_5.826950	1082	1162	0	1	80	0.0125000
NODE_2272_length_1509_cov_5.826950	1082	1162	4	56	80	0.7000000
NODE_2272_length_1509_cov_5.826950	1082	1162	6	23	80	0.2875000
NODE_2277_length_1508_cov_24.176011	765	845	2	12	80	0.1500000
NODE_2277_length_1508_cov_24.176011	765	845	4	11	80	0.1375000
NODE_2277_length_1508_cov_24.176011	765	845	6	57	80	0.7125000
NODE_2277_length_1508_cov_24.176011	818	898	0	29	80	0.3625000
NODE_2277_length_1508_cov_24.176011	818	898	4	35	80	0.4375000
NODE_2277_length_1508_cov_24.176011	818	898	6	16	80	0.2000000
NODE_2290_length_1504_cov_17.449822	596	676	0	53	80	0.6625000
NODE_2290_length_1504_cov_17.449822	596	676	2	27	80	0.3375000
NODE_2290_length_1504_cov_17.449822	649	729	0	13	80	0.1625000
NODE_2290_length_1504_cov_17.449822	649	729	2	67	80	0.8375000
NODE_2293_length_1502_cov_42.989309	559	639	0	49	80	0.6125000
NODE_2293_length_1502_cov_42.989309	559	639	2	31	80	0.3875000
NODE_2293_length_1502_cov_42.989309	612	692	2	80	80	1.0000000
NODE_2294_length_1501_cov_22.828816	421	500	0	58	79	0.7341772
NODE_2294_length_1501_cov_22.828816	421	500	2	21	79	0.2658228
NODE_2294_length_1501_cov_22.828816	473	553	0	6	80	0.0750000
NODE_2294_length_1501_cov_22.828816	473	553	2	74	80	0.9250000
NODE_2294_length_1501_cov_22.828816	549	629	0	42	80	0.5250000
NODE_2294_length_1501_cov_22.828816	549	629	2	38	80	0.4750000
NODE_2294_length_1501_cov_22.828816	602	682	0	80	80	1.0000000
NODE_2295_length_1501_cov_14.422254	973	1053	0	56	80	0.7000000
NODE_2295_length_1501_cov_14.422254	973	1053	2	24	80	0.3000000
NODE_2295_length_1501_cov_14.422254	1026	1106	0	3	80	0.0375000
NODE_2295_length_1501_cov_14.422254	1026	1106	2	77	80	0.9625000
NODE_2296_length_1501_cov_14.060628	225	305	0	8	80	0.1000000
NODE_2296_length_1501_cov_14.060628	225	305	2	72	80	0.9000000
NODE_2296_length_1501_cov_14.060628	278	358	0	61	80	0.7625000
NODE_2296_length_1501_cov_14.060628	278	358	2	19	80	0.2375000
NODE_2296_length_1501_cov_14.060628	986	1066	0	80	80	1.0000000
NODE_2296_length_1501_cov_14.060628	1039	1119	0	80	80	1.0000000
NODE_2300_length_1500_cov_40.056388	619	699	0	14	80	0.1750000
NODE_2300_length_1500_cov_40.056388	619	699	2	66	80	0.8250000
NODE_2300_length_1500_cov_40.056388	672	752	0	42	80	0.5250000
NODE_2300_length_1500_cov_40.056388	672	752	2	38	80	0.4750000
NODE_2305_length_1497_cov_38.344063	1401	1481	51	2	80	0.0250000
NODE_2305_length_1497_cov_38.344063	1401	1481	65	1	80	0.0125000
NODE_2305_length_1497_cov_38.344063	1401	1481	72	1	80	0.0125000
NODE_2305_length_1497_cov_38.344063	1401	1481	73	1	80	0.0125000
NODE_2305_length_1497_cov_38.344063	1401	1481	77	4	80	0.0500000
NODE_2305_length_1497_cov_38.344063	1401	1481	79	1	80	0.0125000
NODE_2305_length_1497_cov_38.344063	1401	1481	81	5	80	0.0625000
NODE_2305_length_1497_cov_38.344063	1401	1481	83	2	80	0.0250000
NODE_2305_length_1497_cov_38.344063	1401	1481	84	2	80	0.0250000
NODE_2305_length_1497_cov_38.344063	1401	1481	87	1	80	0.0125000
NODE_2305_length_1497_cov_38.344063	1401	1481	88	12	80	0.1500000
NODE_2305_length_1497_cov_38.344063	1401	1481	89	4	80	0.0500000
NODE_2305_length_1497_cov_38.344063	1401	1481	94	1	80	0.0125000
NODE_2305_length_1497_cov_38.344063	1401	1481	95	2	80	0.0250000
NODE_2305_length_1497_cov_38.344063	1401	1481	97	7	80	0.0875000
NODE_2305_length_1497_cov_38.344063	1401	1481	98	4	80	0.0500000
NODE_2305_length_1497_cov_38.344063	1401	1481	102	4	80	0.0500000
NODE_2305_length_1497_cov_38.344063	1401	1481	104	1	80	0.0125000
NODE_2305_length_1497_cov_38.344063	1401	1481	105	1	80	0.0125000
NODE_2305_length_1497_cov_38.344063	1401	1481	107	1	80	0.0125000
NODE_2305_length_1497_cov_38.344063	1401	1481	111	1	80	0.0125000
NODE_2305_length_1497_cov_38.344063	1401	1481	112	2	80	0.0250000
NODE_2305_length_1497_cov_38.344063	1401	1481	113	1	80	0.0125000
NODE_2305_length_1497_cov_38.344063	1401	1481	115	7	80	0.0875000
NODE_2305_length_1497_cov_38.344063	1401	1481	117	4	80	0.0500000
NODE_2305_length_1497_cov_38.344063	1401	1481	121	3	80	0.0375000
NODE_2305_length_1497_cov_38.344063	1401	1481	123	2	80	0.0250000
NODE_2305_length_1497_cov_38.344063	1401	1481	125	2	80	0.0250000
NODE_2305_length_1497_cov_38.344063	1401	1481	127	1	80	0.0125000
NODE_2308_length_1496_cov_3.936292	0	44	0	44	44	1.0000000
NODE_2308_length_1496_cov_3.936292	17	97	0	80	80	1.0000000
NODE_2311_length_1496_cov_1.103794	405	428	0	23	23	1.0000000
NODE_2313_length_1494_cov_65.437276	460	540	0	80	80	1.0000000
NODE_2313_length_1494_cov_65.437276	513	594	0	81	81	1.0000000
NODE_2313_length_1494_cov_65.437276	787	854	8	27	67	0.4029851
NODE_2313_length_1494_cov_65.437276	787	854	10	29	67	0.4328358
NODE_2313_length_1494_cov_65.437276	787	854	12	11	67	0.1641791
NODE_2313_length_1494_cov_65.437276	827	907	8	57	80	0.7125000
NODE_2313_length_1494_cov_65.437276	827	907	10	6	80	0.0750000
NODE_2313_length_1494_cov_65.437276	827	907	12	17	80	0.2125000
NODE_2316_length_1493_cov_100.467719	947	1028	60	2	81	0.0246914
NODE_2316_length_1493_cov_100.467719	947	1028	64	2	81	0.0246914
NODE_2316_length_1493_cov_100.467719	947	1028	66	5	81	0.0617284
NODE_2316_length_1493_cov_100.467719	947	1028	68	4	81	0.0493827
NODE_2316_length_1493_cov_100.467719	947	1028	72	1	81	0.0123457
NODE_2316_length_1493_cov_100.467719	947	1028	75	1	81	0.0123457
NODE_2316_length_1493_cov_100.467719	947	1028	79	1	81	0.0123457
NODE_2316_length_1493_cov_100.467719	947	1028	81	1	81	0.0123457
NODE_2316_length_1493_cov_100.467719	947	1028	86	1	81	0.0123457
NODE_2316_length_1493_cov_100.467719	947	1028	88	1	81	0.0123457
NODE_2316_length_1493_cov_100.467719	947	1028	91	2	81	0.0246914
NODE_2316_length_1493_cov_100.467719	947	1028	93	1	81	0.0123457
NODE_2316_length_1493_cov_100.467719	947	1028	95	2	81	0.0246914
NODE_2316_length_1493_cov_100.467719	947	1028	99	1	81	0.0123457
NODE_2316_length_1493_cov_100.467719	947	1028	105	1	81	0.0123457
NODE_2316_length_1493_cov_100.467719	947	1028	107	1	81	0.0123457
NODE_2316_length_1493_cov_100.467719	947	1028	109	1	81	0.0123457
NODE_2316_length_1493_cov_100.467719	947	1028	111	1	81	0.0123457
NODE_2316_length_1493_cov_100.467719	947	1028	114	1	81	0.0123457
NODE_2316_length_1493_cov_100.467719	947	1028	116	2	81	0.0246914
NODE_2316_length_1493_cov_100.467719	947	1028	118	1	81	0.0123457
NODE_2316_length_1493_cov_100.467719	947	1028	122	1	81	0.0123457
NODE_2316_length_1493_cov_100.467719	947	1028	125	1	81	0.0123457
NODE_2316_length_1493_cov_100.467719	947	1028	132	1	81	0.0123457
NODE_2316_length_1493_cov_100.467719	947	1028	138	1	81	0.0123457
NODE_2316_length_1493_cov_100.467719	947	1028	139	1	81	0.0123457
NODE_2316_length_1493_cov_100.467719	947	1028	142	3	81	0.0370370
NODE_2316_length_1493_cov_100.467719	947	1028	143	1	81	0.0123457
NODE_2316_length_1493_cov_100.467719	947	1028	144	1	81	0.0123457
NODE_2316_length_1493_cov_100.467719	947	1028	149	1	81	0.0123457
NODE_2316_length_1493_cov_100.467719	947	1028	150	2	81	0.0246914
NODE_2316_length_1493_cov_100.467719	947	1028	151	2	81	0.0246914
NODE_2316_length_1493_cov_100.467719	947	1028	152	1	81	0.0123457
NODE_2316_length_1493_cov_100.467719	947	1028	154	1	81	0.0123457
NODE_2316_length_1493_cov_100.467719	947	1028	157	2	81	0.0246914
NODE_2316_length_1493_cov_100.467719	947	1028	159	1	81	0.0123457
NODE_2316_length_1493_cov_100.467719	947	1028	160	1	81	0.0123457
NODE_2316_length_1493_cov_100.467719	947	1028	161	1	81	0.0123457
NODE_2316_length_1493_cov_100.467719	947	1028	163	1	81	0.0123457
NODE_2316_length_1493_cov_100.467719	947	1028	167	1	81	0.0123457
NODE_2316_length_1493_cov_100.467719	947	1028	170	4	81	0.0493827
NODE_2316_length_1493_cov_100.467719	947	1028	172	1	81	0.0123457
NODE_2316_length_1493_cov_100.467719	947	1028	176	1	81	0.0123457
NODE_2316_length_1493_cov_100.467719	947	1028	179	1	81	0.0123457
NODE_2316_length_1493_cov_100.467719	947	1028	181	1	81	0.0123457
NODE_2316_length_1493_cov_100.467719	947	1028	187	1	81	0.0123457
NODE_2316_length_1493_cov_100.467719	947	1028	189	1	81	0.0123457
NODE_2316_length_1493_cov_100.467719	947	1028	193	2	81	0.0246914
NODE_2316_length_1493_cov_100.467719	947	1028	196	2	81	0.0246914
NODE_2316_length_1493_cov_100.467719	947	1028	209	2	81	0.0246914
NODE_2316_length_1493_cov_100.467719	947	1028	210	1	81	0.0123457
NODE_2316_length_1493_cov_100.467719	947	1028	211	1	81	0.0123457
NODE_2316_length_1493_cov_100.467719	947	1028	214	1	81	0.0123457
NODE_2316_length_1493_cov_100.467719	947	1028	220	1	81	0.0123457
NODE_2316_length_1493_cov_100.467719	947	1028	228	3	81	0.0370370
NODE_2316_length_1493_cov_100.467719	947	1028	230	1	81	0.0123457
NODE_2316_length_1493_cov_100.467719	1001	1071	161	1	70	0.0142857
NODE_2316_length_1493_cov_100.467719	1001	1071	163	1	70	0.0142857
NODE_2316_length_1493_cov_100.467719	1001	1071	167	1	70	0.0142857
NODE_2316_length_1493_cov_100.467719	1001	1071	170	4	70	0.0571429
NODE_2316_length_1493_cov_100.467719	1001	1071	172	1	70	0.0142857
NODE_2316_length_1493_cov_100.467719	1001	1071	176	1	70	0.0142857
NODE_2316_length_1493_cov_100.467719	1001	1071	179	1	70	0.0142857
NODE_2316_length_1493_cov_100.467719	1001	1071	181	1	70	0.0142857
NODE_2316_length_1493_cov_100.467719	1001	1071	187	1	70	0.0142857
NODE_2316_length_1493_cov_100.467719	1001	1071	189	1	70	0.0142857
NODE_2316_length_1493_cov_100.467719	1001	1071	193	2	70	0.0285714
NODE_2316_length_1493_cov_100.467719	1001	1071	196	2	70	0.0285714
NODE_2316_length_1493_cov_100.467719	1001	1071	209	2	70	0.0285714
NODE_2316_length_1493_cov_100.467719	1001	1071	210	1	70	0.0142857
NODE_2316_length_1493_cov_100.467719	1001	1071	211	1	70	0.0142857
NODE_2316_length_1493_cov_100.467719	1001	1071	214	1	70	0.0142857
NODE_2316_length_1493_cov_100.467719	1001	1071	220	1	70	0.0142857
NODE_2316_length_1493_cov_100.467719	1001	1071	228	3	70	0.0428571
NODE_2316_length_1493_cov_100.467719	1001	1071	230	1	70	0.0142857
NODE_2316_length_1493_cov_100.467719	1001	1071	231	1	70	0.0142857
NODE_2316_length_1493_cov_100.467719	1001	1071	240	1	70	0.0142857
NODE_2316_length_1493_cov_100.467719	1001	1071	244	2	70	0.0285714
NODE_2316_length_1493_cov_100.467719	1001	1071	247	1	70	0.0142857
NODE_2316_length_1493_cov_100.467719	1001	1071	248	2	70	0.0285714
NODE_2316_length_1493_cov_100.467719	1001	1071	250	1	70	0.0142857
NODE_2316_length_1493_cov_100.467719	1001	1071	253	1	70	0.0142857
NODE_2316_length_1493_cov_100.467719	1001	1071	254	2	70	0.0285714
NODE_2316_length_1493_cov_100.467719	1001	1071	255	2	70	0.0285714
NODE_2316_length_1493_cov_100.467719	1001	1071	256	1	70	0.0142857
NODE_2316_length_1493_cov_100.467719	1001	1071	258	1	70	0.0142857
NODE_2316_length_1493_cov_100.467719	1001	1071	259	1	70	0.0142857
NODE_2316_length_1493_cov_100.467719	1001	1071	274	1	70	0.0142857
NODE_2316_length_1493_cov_100.467719	1001	1071	288	1	70	0.0142857
NODE_2316_length_1493_cov_100.467719	1001	1071	291	1	70	0.0142857
NODE_2316_length_1493_cov_100.467719	1001	1071	304	1	70	0.0142857
NODE_2316_length_1493_cov_100.467719	1001	1071	306	1	70	0.0142857
NODE_2316_length_1493_cov_100.467719	1001	1071	325	1	70	0.0142857
NODE_2316_length_1493_cov_100.467719	1001	1071	330	1	70	0.0142857
NODE_2316_length_1493_cov_100.467719	1001	1071	333	1	70	0.0142857
NODE_2316_length_1493_cov_100.467719	1001	1071	347	2	70	0.0285714
NODE_2316_length_1493_cov_100.467719	1001	1071	350	1	70	0.0142857
NODE_2316_length_1493_cov_100.467719	1001	1071	351	2	70	0.0285714
NODE_2316_length_1493_cov_100.467719	1001	1071	353	2	70	0.0285714
NODE_2316_length_1493_cov_100.467719	1001	1071	355	1	70	0.0142857
NODE_2316_length_1493_cov_100.467719	1001	1071	357	1	70	0.0142857
NODE_2316_length_1493_cov_100.467719	1001	1071	358	1	70	0.0142857
NODE_2316_length_1493_cov_100.467719	1001	1071	365	1	70	0.0142857
NODE_2316_length_1493_cov_100.467719	1001	1071	370	1	70	0.0142857
NODE_2316_length_1493_cov_100.467719	1001	1071	376	2	70	0.0285714
NODE_2316_length_1493_cov_100.467719	1001	1071	380	1	70	0.0142857
NODE_2316_length_1493_cov_100.467719	1001	1071	384	3	70	0.0428571
NODE_2316_length_1493_cov_100.467719	1001	1071	386	1	70	0.0142857
NODE_2316_length_1493_cov_100.467719	1077	1157	407	1	80	0.0125000
NODE_2316_length_1493_cov_100.467719	1077	1157	409	1	80	0.0125000
NODE_2316_length_1493_cov_100.467719	1077	1157	414	1	80	0.0125000
NODE_2316_length_1493_cov_100.467719	1077	1157	418	1	80	0.0125000
NODE_2316_length_1493_cov_100.467719	1077	1157	426	1	80	0.0125000
NODE_2316_length_1493_cov_100.467719	1077	1157	439	1	80	0.0125000
NODE_2316_length_1493_cov_100.467719	1077	1157	443	2	80	0.0250000
NODE_2316_length_1493_cov_100.467719	1077	1157	445	1	80	0.0125000
NODE_2316_length_1493_cov_100.467719	1077	1157	446	2	80	0.0250000
NODE_2316_length_1493_cov_100.467719	1077	1157	447	1	80	0.0125000
NODE_2316_length_1493_cov_100.467719	1077	1157	449	2	80	0.0250000
NODE_2316_length_1493_cov_100.467719	1077	1157	451	1	80	0.0125000
NODE_2316_length_1493_cov_100.467719	1077	1157	453	4	80	0.0500000
NODE_2316_length_1493_cov_100.467719	1077	1157	455	1	80	0.0125000
NODE_2316_length_1493_cov_100.467719	1077	1157	457	2	80	0.0250000
NODE_2316_length_1493_cov_100.467719	1077	1157	464	1	80	0.0125000
NODE_2316_length_1493_cov_100.467719	1077	1157	467	1	80	0.0125000
NODE_2316_length_1493_cov_100.467719	1077	1157	482	1	80	0.0125000
NODE_2316_length_1493_cov_100.467719	1077	1157	484	2	80	0.0250000
NODE_2316_length_1493_cov_100.467719	1077	1157	492	1	80	0.0125000
NODE_2316_length_1493_cov_100.467719	1077	1157	503	2	80	0.0250000
NODE_2316_length_1493_cov_100.467719	1077	1157	504	1	80	0.0125000
NODE_2316_length_1493_cov_100.467719	1077	1157	507	1	80	0.0125000
NODE_2316_length_1493_cov_100.467719	1077	1157	509	1	80	0.0125000
NODE_2316_length_1493_cov_100.467719	1077	1157	511	2	80	0.0250000
NODE_2316_length_1493_cov_100.467719	1077	1157	513	2	80	0.0250000
NODE_2316_length_1493_cov_100.467719	1077	1157	514	1	80	0.0125000
NODE_2316_length_1493_cov_100.467719	1077	1157	523	1	80	0.0125000
NODE_2316_length_1493_cov_100.467719	1077	1157	527	1	80	0.0125000
NODE_2316_length_1493_cov_100.467719	1077	1157	538	1	80	0.0125000
NODE_2316_length_1493_cov_100.467719	1077	1157	541	1	80	0.0125000
NODE_2316_length_1493_cov_100.467719	1077	1157	543	1	80	0.0125000
NODE_2316_length_1493_cov_100.467719	1077	1157	544	1	80	0.0125000
NODE_2316_length_1493_cov_100.467719	1077	1157	545	2	80	0.0250000
NODE_2316_length_1493_cov_100.467719	1077	1157	551	1	80	0.0125000
NODE_2316_length_1493_cov_100.467719	1077	1157	553	1	80	0.0125000
NODE_2316_length_1493_cov_100.467719	1077	1157	555	1	80	0.0125000
NODE_2316_length_1493_cov_100.467719	1077	1157	561	2	80	0.0250000
NODE_2316_length_1493_cov_100.467719	1077	1157	575	1	80	0.0125000
NODE_2316_length_1493_cov_100.467719	1077	1157	577	1	80	0.0125000
NODE_2316_length_1493_cov_100.467719	1077	1157	586	1	80	0.0125000
NODE_2316_length_1493_cov_100.467719	1077	1157	587	2	80	0.0250000
NODE_2316_length_1493_cov_100.467719	1077	1157	588	2	80	0.0250000
NODE_2316_length_1493_cov_100.467719	1077	1157	593	1	80	0.0125000
NODE_2316_length_1493_cov_100.467719	1077	1157	594	1	80	0.0125000
NODE_2316_length_1493_cov_100.467719	1077	1157	597	1	80	0.0125000
NODE_2316_length_1493_cov_100.467719	1077	1157	598	1	80	0.0125000
NODE_2316_length_1493_cov_100.467719	1077	1157	604	1	80	0.0125000
NODE_2316_length_1493_cov_100.467719	1077	1157	605	1	80	0.0125000
NODE_2316_length_1493_cov_100.467719	1077	1157	606	1	80	0.0125000
NODE_2316_length_1493_cov_100.467719	1077	1157	608	1	80	0.0125000
NODE_2316_length_1493_cov_100.467719	1077	1157	610	2	80	0.0250000
NODE_2316_length_1493_cov_100.467719	1077	1157	616	1	80	0.0125000
NODE_2316_length_1493_cov_100.467719	1077	1157	626	1	80	0.0125000
NODE_2316_length_1493_cov_100.467719	1077	1157	631	1	80	0.0125000
NODE_2316_length_1493_cov_100.467719	1077	1157	642	1	80	0.0125000
NODE_2316_length_1493_cov_100.467719	1077	1157	643	1	80	0.0125000
NODE_2316_length_1493_cov_100.467719	1077	1157	647	1	80	0.0125000
NODE_2316_length_1493_cov_100.467719	1077	1157	649	1	80	0.0125000
NODE_2316_length_1493_cov_100.467719	1077	1157	657	1	80	0.0125000
NODE_2316_length_1493_cov_100.467719	1077	1157	665	1	80	0.0125000
NODE_2316_length_1493_cov_100.467719	1077	1157	667	1	80	0.0125000
NODE_2316_length_1493_cov_100.467719	1077	1157	668	1	80	0.0125000
NODE_2316_length_1493_cov_100.467719	1077	1157	669	1	80	0.0125000
NODE_2316_length_1493_cov_100.467719	1130	1210	586	1	80	0.0125000
NODE_2316_length_1493_cov_100.467719	1130	1210	587	2	80	0.0250000
NODE_2316_length_1493_cov_100.467719	1130	1210	588	2	80	0.0250000
NODE_2316_length_1493_cov_100.467719	1130	1210	593	1	80	0.0125000
NODE_2316_length_1493_cov_100.467719	1130	1210	594	1	80	0.0125000
NODE_2316_length_1493_cov_100.467719	1130	1210	597	1	80	0.0125000
NODE_2316_length_1493_cov_100.467719	1130	1210	598	1	80	0.0125000
NODE_2316_length_1493_cov_100.467719	1130	1210	604	1	80	0.0125000
NODE_2316_length_1493_cov_100.467719	1130	1210	605	1	80	0.0125000
NODE_2316_length_1493_cov_100.467719	1130	1210	606	1	80	0.0125000
NODE_2316_length_1493_cov_100.467719	1130	1210	608	1	80	0.0125000
NODE_2316_length_1493_cov_100.467719	1130	1210	610	2	80	0.0250000
NODE_2316_length_1493_cov_100.467719	1130	1210	616	1	80	0.0125000
NODE_2316_length_1493_cov_100.467719	1130	1210	626	1	80	0.0125000
NODE_2316_length_1493_cov_100.467719	1130	1210	631	1	80	0.0125000
NODE_2316_length_1493_cov_100.467719	1130	1210	642	1	80	0.0125000
NODE_2316_length_1493_cov_100.467719	1130	1210	643	1	80	0.0125000
NODE_2316_length_1493_cov_100.467719	1130	1210	647	1	80	0.0125000
NODE_2316_length_1493_cov_100.467719	1130	1210	649	1	80	0.0125000
NODE_2316_length_1493_cov_100.467719	1130	1210	657	1	80	0.0125000
NODE_2316_length_1493_cov_100.467719	1130	1210	665	1	80	0.0125000
NODE_2316_length_1493_cov_100.467719	1130	1210	667	2	80	0.0250000
NODE_2316_length_1493_cov_100.467719	1130	1210	668	1	80	0.0125000
NODE_2316_length_1493_cov_100.467719	1130	1210	669	1	80	0.0125000
NODE_2316_length_1493_cov_100.467719	1130	1210	671	1	80	0.0125000
NODE_2316_length_1493_cov_100.467719	1130	1210	675	1	80	0.0125000
NODE_2316_length_1493_cov_100.467719	1130	1210	679	1	80	0.0125000
NODE_2316_length_1493_cov_100.467719	1130	1210	685	1	80	0.0125000
NODE_2316_length_1493_cov_100.467719	1130	1210	697	2	80	0.0250000
NODE_2316_length_1493_cov_100.467719	1130	1210	698	1	80	0.0125000
NODE_2316_length_1493_cov_100.467719	1130	1210	702	1	80	0.0125000
NODE_2316_length_1493_cov_100.467719	1130	1210	706	1	80	0.0125000
NODE_2316_length_1493_cov_100.467719	1130	1210	708	1	80	0.0125000
NODE_2316_length_1493_cov_100.467719	1130	1210	710	1	80	0.0125000
NODE_2316_length_1493_cov_100.467719	1130	1210	715	1	80	0.0125000
NODE_2316_length_1493_cov_100.467719	1130	1210	716	2	80	0.0250000
NODE_2316_length_1493_cov_100.467719	1130	1210	721	1	80	0.0125000
NODE_2316_length_1493_cov_100.467719	1130	1210	722	2	80	0.0250000
NODE_2316_length_1493_cov_100.467719	1130	1210	728	1	80	0.0125000
NODE_2316_length_1493_cov_100.467719	1130	1210	729	1	80	0.0125000
NODE_2316_length_1493_cov_100.467719	1130	1210	733	1	80	0.0125000
NODE_2316_length_1493_cov_100.467719	1130	1210	736	1	80	0.0125000
NODE_2316_length_1493_cov_100.467719	1130	1210	737	1	80	0.0125000
NODE_2316_length_1493_cov_100.467719	1130	1210	743	1	80	0.0125000
NODE_2316_length_1493_cov_100.467719	1130	1210	744	1	80	0.0125000
NODE_2316_length_1493_cov_100.467719	1130	1210	747	1	80	0.0125000
NODE_2316_length_1493_cov_100.467719	1130	1210	748	2	80	0.0250000
NODE_2316_length_1493_cov_100.467719	1130	1210	749	1	80	0.0125000
NODE_2316_length_1493_cov_100.467719	1130	1210	750	1	80	0.0125000
NODE_2316_length_1493_cov_100.467719	1130	1210	753	2	80	0.0250000
NODE_2316_length_1493_cov_100.467719	1130	1210	754	3	80	0.0375000
NODE_2316_length_1493_cov_100.467719	1130	1210	756	1	80	0.0125000
NODE_2316_length_1493_cov_100.467719	1130	1210	757	1	80	0.0125000
NODE_2316_length_1493_cov_100.467719	1130	1210	758	1	80	0.0125000
NODE_2316_length_1493_cov_100.467719	1130	1210	759	3	80	0.0375000
NODE_2316_length_1493_cov_100.467719	1130	1210	760	1	80	0.0125000
NODE_2316_length_1493_cov_100.467719	1130	1210	762	2	80	0.0250000
NODE_2316_length_1493_cov_100.467719	1130	1210	763	1	80	0.0125000
NODE_2316_length_1493_cov_100.467719	1130	1210	766	1	80	0.0125000
NODE_2316_length_1493_cov_100.467719	1130	1210	767	1	80	0.0125000
NODE_2316_length_1493_cov_100.467719	1130	1210	769	1	80	0.0125000
NODE_2316_length_1493_cov_100.467719	1130	1210	770	1	80	0.0125000
NODE_2316_length_1493_cov_100.467719	1130	1210	773	1	80	0.0125000
NODE_2316_length_1493_cov_100.467719	1130	1210	775	1	80	0.0125000
NODE_2316_length_1493_cov_100.467719	1130	1210	776	1	80	0.0125000
NODE_2316_length_1493_cov_100.467719	1130	1210	783	1	80	0.0125000
NODE_2321_length_1493_cov_1.138451	1341	1420	0	7	79	0.0886076
NODE_2321_length_1493_cov_1.138451	1341	1420	2	38	79	0.4810127
NODE_2321_length_1493_cov_1.138451	1341	1420	8	2	79	0.0253165
NODE_2321_length_1493_cov_1.138451	1341	1420	10	32	79	0.4050633
NODE_2321_length_1493_cov_1.138451	1341	1420	0	7	79	0.0886076
NODE_2321_length_1493_cov_1.138451	1341	1420	2	38	79	0.4810127
NODE_2321_length_1493_cov_1.138451	1341	1420	8	2	79	0.0253165
NODE_2321_length_1493_cov_1.138451	1341	1420	10	32	79	0.4050633
NODE_2321_length_1493_cov_1.138451	1393	1459	6	5	66	0.0757576
NODE_2321_length_1493_cov_1.138451	1393	1459	8	3	66	0.0454545
NODE_2321_length_1493_cov_1.138451	1393	1459	10	58	66	0.8787879
NODE_2332_length_1490_cov_5.726096	233	295	1	37	62	0.5967742
NODE_2332_length_1490_cov_5.726096	233	295	2	25	62	0.4032258
NODE_2332_length_1490_cov_5.726096	1065	1149	0	84	84	1.0000000
NODE_2333_length_1490_cov_4.687275	318	399	0	7	81	0.0864198
NODE_2333_length_1490_cov_4.687275	318	399	1	1	81	0.0123457
NODE_2333_length_1490_cov_4.687275	318	399	2	73	81	0.9012346
NODE_2333_length_1490_cov_4.687275	372	452	0	60	80	0.7500000
NODE_2333_length_1490_cov_4.687275	372	452	1	1	80	0.0125000
NODE_2333_length_1490_cov_4.687275	372	452	2	19	80	0.2375000
NODE_2338_length_1488_cov_3.734341	1141	1221	0	80	80	1.0000000
NODE_2340_length_1487_cov_19.332133	673	753	0	67	80	0.8375000
NODE_2340_length_1487_cov_19.332133	673	753	2	13	80	0.1625000
NODE_2340_length_1487_cov_19.332133	726	806	0	14	80	0.1750000
NODE_2340_length_1487_cov_19.332133	726	806	2	66	80	0.8250000
NODE_2348_length_1484_cov_38.342960	706	786	2	13	80	0.1625000
NODE_2348_length_1484_cov_38.342960	706	786	4	26	80	0.3250000
NODE_2348_length_1484_cov_38.342960	706	786	6	41	80	0.5125000
NODE_2348_length_1484_cov_38.342960	759	839	0	22	80	0.2750000
NODE_2348_length_1484_cov_38.342960	759	839	4	37	80	0.4625000
NODE_2348_length_1484_cov_38.342960	759	839	6	21	80	0.2625000
NODE_2349_length_1484_cov_21.260650	348	428	0	76	80	0.9500000
NODE_2349_length_1484_cov_21.260650	348	428	2	4	80	0.0500000
NODE_2349_length_1484_cov_21.260650	401	481	0	23	80	0.2875000
NODE_2349_length_1484_cov_21.260650	401	481	2	57	80	0.7125000
NODE_2349_length_1484_cov_21.260650	978	1058	0	80	80	1.0000000
NODE_2349_length_1484_cov_21.260650	1031	1111	0	80	80	1.0000000
NODE_2350_length_1484_cov_19.243321	952	1032	2	36	80	0.4500000
NODE_2350_length_1484_cov_19.243321	952	1032	4	13	80	0.1625000
NODE_2350_length_1484_cov_19.243321	952	1032	6	30	80	0.3750000
NODE_2350_length_1484_cov_19.243321	952	1032	8	1	80	0.0125000
NODE_2350_length_1484_cov_19.243321	1005	1085	0	5	80	0.0625000
NODE_2350_length_1484_cov_19.243321	1005	1085	2	11	80	0.1375000
NODE_2350_length_1484_cov_19.243321	1005	1085	4	43	80	0.5375000
NODE_2350_length_1484_cov_19.243321	1005	1085	6	21	80	0.2625000
NODE_2351_length_1484_cov_9.085199	314	394	2	69	80	0.8625000
NODE_2351_length_1484_cov_9.085199	314	394	4	11	80	0.1375000
NODE_2351_length_1484_cov_9.085199	367	447	2	69	80	0.8625000
NODE_2351_length_1484_cov_9.085199	367	447	4	11	80	0.1375000
NODE_2353_length_1483_cov_21.207370	555	635	9	5	80	0.0625000
NODE_2353_length_1483_cov_21.207370	555	635	16	3	80	0.0375000
NODE_2353_length_1483_cov_21.207370	555	635	20	72	80	0.9000000
NODE_2353_length_1483_cov_21.207370	608	688	0	37	80	0.4625000
NODE_2353_length_1483_cov_21.207370	608	688	7	10	80	0.1250000
NODE_2353_length_1483_cov_21.207370	608	688	9	11	80	0.1375000
NODE_2353_length_1483_cov_21.207370	608	688	16	3	80	0.0375000
NODE_2353_length_1483_cov_21.207370	608	688	20	19	80	0.2375000
NODE_2359_length_1482_cov_20.177874	430	510	0	80	80	1.0000000
NODE_2359_length_1482_cov_20.177874	483	563	0	80	80	1.0000000
NODE_2359_length_1482_cov_20.177874	559	639	0	80	80	1.0000000
NODE_2359_length_1482_cov_20.177874	612	692	0	80	80	1.0000000
NODE_2360_length_1482_cov_13.644252	1000	1080	0	80	80	1.0000000
NODE_2360_length_1482_cov_13.644252	1053	1133	0	59	80	0.7375000
NODE_2360_length_1482_cov_13.644252	1053	1133	2	21	80	0.2625000
NODE_2361_length_1482_cov_6.157628	525	605	2	4	80	0.0500000
NODE_2361_length_1482_cov_6.157628	525	605	4	76	80	0.9500000
NODE_2361_length_1482_cov_6.157628	578	658	0	38	80	0.4750000
NODE_2361_length_1482_cov_6.157628	578	658	2	19	80	0.2375000
NODE_2361_length_1482_cov_6.157628	578	658	4	23	80	0.2875000
NODE_2361_length_1482_cov_6.157628	1306	1388	16	2	82	0.0243902
NODE_2361_length_1482_cov_6.157628	1306	1388	18	1	82	0.0121951
NODE_2361_length_1482_cov_6.157628	1306	1388	20	9	82	0.1097561
NODE_2361_length_1482_cov_6.157628	1306	1388	22	70	82	0.8536586
NODE_2364_length_1481_cov_19.238784	480	560	2	80	80	1.0000000
NODE_2364_length_1481_cov_19.238784	533	613	0	45	80	0.5625000
NODE_2364_length_1481_cov_19.238784	533	613	2	35	80	0.4375000
NODE_2365_length_1481_cov_18.139653	706	786	0	10	80	0.1250000
NODE_2365_length_1481_cov_18.139653	706	786	2	34	80	0.4250000
NODE_2365_length_1481_cov_18.139653	706	786	7	16	80	0.2000000
NODE_2365_length_1481_cov_18.139653	706	786	11	1	80	0.0125000
NODE_2365_length_1481_cov_18.139653	706	786	12	19	80	0.2375000
NODE_2365_length_1481_cov_18.139653	759	839	4	15	80	0.1875000
NODE_2365_length_1481_cov_18.139653	759	839	7	7	80	0.0875000
NODE_2365_length_1481_cov_18.139653	759	839	9	1	80	0.0125000
NODE_2365_length_1481_cov_18.139653	759	839	10	8	80	0.1000000
NODE_2365_length_1481_cov_18.139653	759	839	11	1	80	0.0125000
NODE_2365_length_1481_cov_18.139653	759	839	12	48	80	0.6000000
NODE_2367_length_1480_cov_27.552498	762	842	0	66	80	0.8250000
NODE_2367_length_1480_cov_27.552498	762	842	2	14	80	0.1750000
NODE_2367_length_1480_cov_27.552498	815	895	0	16	80	0.2000000
NODE_2367_length_1480_cov_27.552498	815	895	2	64	80	0.8000000
NODE_2367_length_1480_cov_27.552498	891	971	0	79	80	0.9875000
NODE_2367_length_1480_cov_27.552498	891	971	2	1	80	0.0125000
NODE_2367_length_1480_cov_27.552498	944	1024	0	80	80	1.0000000
NODE_2367_length_1480_cov_27.552498	1171	1222	16	3	51	0.0588235
NODE_2367_length_1480_cov_27.552498	1171	1222	17	4	51	0.0784314
NODE_2367_length_1480_cov_27.552498	1171	1222	21	3	51	0.0588235
NODE_2367_length_1480_cov_27.552498	1171	1222	23	1	51	0.0196078
NODE_2367_length_1480_cov_27.552498	1171	1222	25	5	51	0.0980392
NODE_2367_length_1480_cov_27.552498	1171	1222	29	1	51	0.0196078
NODE_2367_length_1480_cov_27.552498	1171	1222	31	1	51	0.0196078
NODE_2367_length_1480_cov_27.552498	1171	1222	39	1	51	0.0196078
NODE_2367_length_1480_cov_27.552498	1171	1222	59	2	51	0.0392157
NODE_2367_length_1480_cov_27.552498	1171	1222	68	1	51	0.0196078
NODE_2367_length_1480_cov_27.552498	1171	1222	70	1	51	0.0196078
NODE_2367_length_1480_cov_27.552498	1171	1222	84	3	51	0.0588235
NODE_2367_length_1480_cov_27.552498	1171	1222	88	3	51	0.0588235
NODE_2367_length_1480_cov_27.552498	1171	1222	90	2	51	0.0392157
NODE_2367_length_1480_cov_27.552498	1171	1222	96	1	51	0.0196078
NODE_2367_length_1480_cov_27.552498	1171	1222	98	2	51	0.0392157
NODE_2367_length_1480_cov_27.552498	1171	1222	100	2	51	0.0392157
NODE_2367_length_1480_cov_27.552498	1171	1222	102	5	51	0.0980392
NODE_2367_length_1480_cov_27.552498	1171	1222	104	4	51	0.0784314
NODE_2367_length_1480_cov_27.552498	1171	1222	106	6	51	0.1176471
NODE_2369_length_1480_cov_12.535844	466	546	0	80	80	1.0000000
NODE_2369_length_1480_cov_12.535844	519	599	0	80	80	1.0000000
NODE_2373_length_1479_cov_17.035507	708	788	0	29	80	0.3625000
NODE_2373_length_1479_cov_17.035507	708	788	2	51	80	0.6375000
NODE_2373_length_1479_cov_17.035507	761	841	0	2	80	0.0250000
NODE_2373_length_1479_cov_17.035507	761	841	2	78	80	0.9750000
NODE_2373_length_1479_cov_17.035507	837	917	0	44	80	0.5500000
NODE_2373_length_1479_cov_17.035507	837	917	2	10	80	0.1250000
NODE_2373_length_1479_cov_17.035507	837	917	4	26	80	0.3250000
NODE_2373_length_1479_cov_17.035507	890	970	2	22	80	0.2750000
NODE_2373_length_1479_cov_17.035507	890	970	4	58	80	0.7250000
NODE_2374_length_1479_cov_16.448551	908	988	4	27	80	0.3375000
NODE_2374_length_1479_cov_16.448551	908	988	6	53	80	0.6625000
NODE_2374_length_1479_cov_16.448551	961	1041	2	50	80	0.6250000
NODE_2374_length_1479_cov_16.448551	961	1041	4	2	80	0.0250000
NODE_2374_length_1479_cov_16.448551	961	1041	6	28	80	0.3500000
NODE_2375_length_1479_cov_5.285507	123	185	4	5	62	0.0806452
NODE_2375_length_1479_cov_5.285507	123	185	6	24	62	0.3870968
NODE_2375_length_1479_cov_5.285507	123	185	8	1	62	0.0161290
NODE_2375_length_1479_cov_5.285507	123	185	9	16	62	0.2580645
NODE_2375_length_1479_cov_5.285507	123	185	11	8	62	0.1290323
NODE_2375_length_1479_cov_5.285507	123	185	12	8	62	0.1290323
NODE_2376_length_1479_cov_2.018841	881	967	0	57	86	0.6627907
NODE_2376_length_1479_cov_2.018841	881	967	2	29	86	0.3372093
NODE_2377_length_1478_cov_32.050761	411	491	0	27	80	0.3375000
NODE_2377_length_1478_cov_32.050761	411	491	8	53	80	0.6625000
NODE_2377_length_1478_cov_32.050761	464	544	8	34	80	0.4250000
NODE_2377_length_1478_cov_32.050761	464	544	10	46	80	0.5750000
NODE_2377_length_1478_cov_32.050761	540	620	0	7	80	0.0875000
NODE_2377_length_1478_cov_32.050761	540	620	2	29	80	0.3625000
NODE_2377_length_1478_cov_32.050761	540	620	8	1	80	0.0125000
NODE_2377_length_1478_cov_32.050761	540	620	9	3	80	0.0375000
NODE_2377_length_1478_cov_32.050761	540	620	10	40	80	0.5000000
NODE_2377_length_1478_cov_32.050761	593	673	0	60	80	0.7500000
NODE_2377_length_1478_cov_32.050761	593	673	2	20	80	0.2500000
NODE_2378_length_1478_cov_27.414793	817	897	0	6	80	0.0750000
NODE_2378_length_1478_cov_27.414793	817	897	2	74	80	0.9250000
NODE_2378_length_1478_cov_27.414793	870	950	0	50	80	0.6250000
NODE_2378_length_1478_cov_27.414793	870	950	2	30	80	0.3750000
NODE_2379_length_1478_cov_23.472081	1212	1241	30	2	29	0.0689655
NODE_2379_length_1478_cov_23.472081	1212	1241	32	1	29	0.0344828
NODE_2379_length_1478_cov_23.472081	1212	1241	35	1	29	0.0344828
NODE_2379_length_1478_cov_23.472081	1212	1241	37	6	29	0.2068966
NODE_2379_length_1478_cov_23.472081	1212	1241	38	2	29	0.0689655
NODE_2379_length_1478_cov_23.472081	1212	1241	39	3	29	0.1034483
NODE_2379_length_1478_cov_23.472081	1212	1241	40	2	29	0.0689655
NODE_2379_length_1478_cov_23.472081	1212	1241	44	1	29	0.0344828
NODE_2379_length_1478_cov_23.472081	1212	1241	52	1	29	0.0344828
NODE_2379_length_1478_cov_23.472081	1212	1241	56	2	29	0.0689655
NODE_2379_length_1478_cov_23.472081	1212	1241	58	1	29	0.0344828
NODE_2379_length_1478_cov_23.472081	1212	1241	60	1	29	0.0344828
NODE_2379_length_1478_cov_23.472081	1212	1241	62	1	29	0.0344828
NODE_2379_length_1478_cov_23.472081	1212	1241	64	1	29	0.0344828
NODE_2379_length_1478_cov_23.472081	1212	1241	67	1	29	0.0344828
NODE_2379_length_1478_cov_23.472081	1212	1241	68	2	29	0.0689655
NODE_2379_length_1478_cov_23.472081	1212	1241	70	1	29	0.0344828
NODE_2380_length_1478_cov_10.746193	678	758	0	43	80	0.5375000
NODE_2380_length_1478_cov_10.746193	678	758	1	37	80	0.4625000
NODE_2380_length_1478_cov_10.746193	731	811	0	80	80	1.0000000
NODE_2380_length_1478_cov_10.746193	807	892	0	5	85	0.0588235
NODE_2380_length_1478_cov_10.746193	807	892	1	17	85	0.2000000
NODE_2380_length_1478_cov_10.746193	807	892	3	63	85	0.7411765
NODE_2380_length_1478_cov_10.746193	860	945	1	26	85	0.3058824
NODE_2380_length_1478_cov_10.746193	860	945	3	59	85	0.6941177
NODE_2384_length_1476_cov_6.522150	791	871	0	80	80	1.0000000
NODE_2384_length_1476_cov_6.522150	844	924	0	80	80	1.0000000
NODE_2392_length_1474_cov_11.209455	515	595	0	33	80	0.4125000
NODE_2392_length_1474_cov_11.209455	515	595	2	47	80	0.5875000
NODE_2392_length_1474_cov_11.209455	568	648	2	35	80	0.4375000
NODE_2392_length_1474_cov_11.209455	568	648	4	5	80	0.0625000
NODE_2392_length_1474_cov_11.209455	568	648	6	13	80	0.1625000
NODE_2392_length_1474_cov_11.209455	568	648	8	7	80	0.0875000
NODE_2392_length_1474_cov_11.209455	568	648	10	20	80	0.2500000
NODE_2397_length_1472_cov_22.159505	428	508	0	24	80	0.3000000
NODE_2397_length_1472_cov_22.159505	428	508	2	56	80	0.7000000
NODE_2397_length_1472_cov_22.159505	428	508	0	24	80	0.3000000
NODE_2397_length_1472_cov_22.159505	428	508	2	56	80	0.7000000
NODE_2397_length_1472_cov_22.159505	481	561	0	13	80	0.1625000
NODE_2397_length_1472_cov_22.159505	481	561	2	51	80	0.6375000
NODE_2397_length_1472_cov_22.159505	481	561	5	1	80	0.0125000
NODE_2397_length_1472_cov_22.159505	481	561	6	1	80	0.0125000
NODE_2397_length_1472_cov_22.159505	481	561	8	7	80	0.0875000
NODE_2397_length_1472_cov_22.159505	481	561	10	6	80	0.0750000
NODE_2397_length_1472_cov_22.159505	481	561	12	1	80	0.0125000
NODE_2397_length_1472_cov_22.159505	913	993	0	50	80	0.6250000
NODE_2397_length_1472_cov_22.159505	913	993	2	30	80	0.3750000
NODE_2397_length_1472_cov_22.159505	966	1046	0	13	80	0.1625000
NODE_2397_length_1472_cov_22.159505	966	1046	2	67	80	0.8375000
NODE_2397_length_1472_cov_22.159505	1042	1122	0	80	80	1.0000000
NODE_2397_length_1472_cov_22.159505	1095	1175	0	80	80	1.0000000
NODE_2398_length_1472_cov_22.018208	523	590	0	12	67	0.1791045
NODE_2398_length_1472_cov_22.018208	523	590	2	15	67	0.2238806
NODE_2398_length_1472_cov_22.018208	523	590	4	40	67	0.5970149
NODE_2398_length_1472_cov_22.018208	563	643	0	65	80	0.8125000
NODE_2398_length_1472_cov_22.018208	563	643	2	15	80	0.1875000
NODE_2398_length_1472_cov_22.018208	639	719	0	80	80	1.0000000
NODE_2398_length_1472_cov_22.018208	692	772	0	80	80	1.0000000
NODE_2404_length_1470_cov_7.042305	5	57	38	1	52	0.0192308
NODE_2404_length_1470_cov_7.042305	5	57	44	3	52	0.0576923
NODE_2404_length_1470_cov_7.042305	5	57	62	3	52	0.0576923
NODE_2404_length_1470_cov_7.042305	5	57	64	1	52	0.0192308
NODE_2404_length_1470_cov_7.042305	5	57	66	1	52	0.0192308
NODE_2404_length_1470_cov_7.042305	5	57	70	1	52	0.0192308
NODE_2404_length_1470_cov_7.042305	5	57	74	3	52	0.0576923
NODE_2404_length_1470_cov_7.042305	5	57	80	1	52	0.0192308
NODE_2404_length_1470_cov_7.042305	5	57	84	1	52	0.0192308
NODE_2404_length_1470_cov_7.042305	5	57	92	1	52	0.0192308
NODE_2404_length_1470_cov_7.042305	5	57	94	1	52	0.0192308
NODE_2404_length_1470_cov_7.042305	5	57	96	13	52	0.2500000
NODE_2404_length_1470_cov_7.042305	5	57	100	17	52	0.3269231
NODE_2404_length_1470_cov_7.042305	5	57	102	5	52	0.0961538
NODE_2405_length_1470_cov_2.185266	199	245	0	46	46	1.0000000
NODE_2407_length_1469_cov_5.683942	834	914	0	80	80	1.0000000
NODE_2407_length_1469_cov_5.683942	887	967	0	80	80	1.0000000
NODE_2410_length_1467_cov_31.231725	1048	1131	0	83	83	1.0000000
NODE_2411_length_1467_cov_19.731725	485	565	0	12	80	0.1500000
NODE_2411_length_1467_cov_19.731725	485	565	12	21	80	0.2625000
NODE_2411_length_1467_cov_19.731725	485	565	13	2	80	0.0250000
NODE_2411_length_1467_cov_19.731725	485	565	14	1	80	0.0125000
NODE_2411_length_1467_cov_19.731725	485	565	15	20	80	0.2500000
NODE_2411_length_1467_cov_19.731725	485	565	16	24	80	0.3000000
NODE_2411_length_1467_cov_19.731725	538	618	0	65	80	0.8125000
NODE_2411_length_1467_cov_19.731725	538	618	12	15	80	0.1875000
NODE_2412_length_1467_cov_11.807749	180	242	14	6	62	0.0967742
NODE_2412_length_1467_cov_11.807749	180	242	18	13	62	0.2096774
NODE_2412_length_1467_cov_11.807749	180	242	20	6	62	0.0967742
NODE_2412_length_1467_cov_11.807749	180	242	22	7	62	0.1129032
NODE_2412_length_1467_cov_11.807749	180	242	24	30	62	0.4838710
NODE_2412_length_1467_cov_11.807749	264	293	8	1	29	0.0344828
NODE_2412_length_1467_cov_11.807749	264	293	10	5	29	0.1724138
NODE_2412_length_1467_cov_11.807749	264	293	12	8	29	0.2758621
NODE_2412_length_1467_cov_11.807749	264	293	18	7	29	0.2413793
NODE_2412_length_1467_cov_11.807749	264	293	20	8	29	0.2758621
NODE_2412_length_1467_cov_11.807749	930	1010	0	17	80	0.2125000
NODE_2412_length_1467_cov_11.807749	930	1010	1	27	80	0.3375000
NODE_2412_length_1467_cov_11.807749	930	1010	5	14	80	0.1750000
NODE_2412_length_1467_cov_11.807749	930	1010	6	22	80	0.2750000
NODE_2412_length_1467_cov_11.807749	983	1063	2	9	80	0.1125000
NODE_2412_length_1467_cov_11.807749	983	1063	5	5	80	0.0625000
NODE_2412_length_1467_cov_11.807749	983	1063	6	66	80	0.8250000
NODE_2414_length_1466_cov_41.326993	664	744	12	9	80	0.1125000
NODE_2414_length_1466_cov_41.326993	664	744	14	24	80	0.3000000
NODE_2414_length_1466_cov_41.326993	664	744	16	28	80	0.3500000
NODE_2414_length_1466_cov_41.326993	664	744	18	19	80	0.2375000
NODE_2414_length_1466_cov_41.326993	717	797	6	6	80	0.0750000
NODE_2414_length_1466_cov_41.326993	717	797	8	9	80	0.1125000
NODE_2414_length_1466_cov_41.326993	717	797	10	36	80	0.4500000
NODE_2414_length_1466_cov_41.326993	717	797	12	11	80	0.1375000
NODE_2414_length_1466_cov_41.326993	717	797	14	18	80	0.2250000
NODE_2414_length_1466_cov_41.326993	793	873	0	11	80	0.1375000
NODE_2414_length_1466_cov_41.326993	793	873	2	18	80	0.2250000
NODE_2414_length_1466_cov_41.326993	793	873	6	26	80	0.3250000
NODE_2414_length_1466_cov_41.326993	793	873	10	1	80	0.0125000
NODE_2414_length_1466_cov_41.326993	793	873	12	24	80	0.3000000
NODE_2414_length_1466_cov_41.326993	846	926	4	2	80	0.0250000
NODE_2414_length_1466_cov_41.326993	846	926	6	3	80	0.0375000
NODE_2414_length_1466_cov_41.326993	846	926	10	1	80	0.0125000
NODE_2414_length_1466_cov_41.326993	846	926	12	74	80	0.9250000
NODE_2420_length_1464_cov_6.726740	137	204	6	42	67	0.6268657
NODE_2420_length_1464_cov_6.726740	137	204	8	3	67	0.0447761
NODE_2420_length_1464_cov_6.726740	137	204	10	11	67	0.1641791
NODE_2420_length_1464_cov_6.726740	137	204	14	11	67	0.1641791
NODE_2422_length_1464_cov_2.198535	1301	1363	24	4	62	0.0645161
NODE_2422_length_1464_cov_2.198535	1301	1363	25	1	62	0.0161290
NODE_2422_length_1464_cov_2.198535	1301	1363	28	1	62	0.0161290
NODE_2422_length_1464_cov_2.198535	1301	1363	29	1	62	0.0161290
NODE_2422_length_1464_cov_2.198535	1301	1363	32	1	62	0.0161290
NODE_2422_length_1464_cov_2.198535	1301	1363	39	1	62	0.0161290
NODE_2422_length_1464_cov_2.198535	1301	1363	41	1	62	0.0161290
NODE_2422_length_1464_cov_2.198535	1301	1363	43	1	62	0.0161290
NODE_2422_length_1464_cov_2.198535	1301	1363	44	1	62	0.0161290
NODE_2422_length_1464_cov_2.198535	1301	1363	45	1	62	0.0161290
NODE_2422_length_1464_cov_2.198535	1301	1363	48	1	62	0.0161290
NODE_2422_length_1464_cov_2.198535	1301	1363	49	1	62	0.0161290
NODE_2422_length_1464_cov_2.198535	1301	1363	50	1	62	0.0161290
NODE_2422_length_1464_cov_2.198535	1301	1363	54	1	62	0.0161290
NODE_2422_length_1464_cov_2.198535	1301	1363	58	2	62	0.0322581
NODE_2422_length_1464_cov_2.198535	1301	1363	60	2	62	0.0322581
NODE_2422_length_1464_cov_2.198535	1301	1363	64	2	62	0.0322581
NODE_2422_length_1464_cov_2.198535	1301	1363	68	1	62	0.0161290
NODE_2422_length_1464_cov_2.198535	1301	1363	70	5	62	0.0806452
NODE_2422_length_1464_cov_2.198535	1301	1363	76	3	62	0.0483871
NODE_2422_length_1464_cov_2.198535	1301	1363	78	3	62	0.0483871
NODE_2422_length_1464_cov_2.198535	1301	1363	80	11	62	0.1774193
NODE_2422_length_1464_cov_2.198535	1301	1363	82	5	62	0.0806452
NODE_2422_length_1464_cov_2.198535	1301	1363	84	1	62	0.0161290
NODE_2422_length_1464_cov_2.198535	1301	1363	88	3	62	0.0483871
NODE_2422_length_1464_cov_2.198535	1301	1363	92	7	62	0.1129032
NODE_2425_length_1463_cov_15.345308	314	394	0	80	80	1.0000000
NODE_2425_length_1463_cov_15.345308	367	447	0	80	80	1.0000000
NODE_2427_length_1462_cov_18.082172	418	498	0	80	80	1.0000000
NODE_2427_length_1462_cov_18.082172	471	551	0	80	80	1.0000000
NODE_2427_length_1462_cov_18.082172	1036	1116	0	5	80	0.0625000
NODE_2427_length_1462_cov_18.082172	1036	1116	2	24	80	0.3000000
NODE_2427_length_1462_cov_18.082172	1036	1116	4	51	80	0.6375000
NODE_2427_length_1462_cov_18.082172	1089	1169	0	58	80	0.7250000
NODE_2427_length_1462_cov_18.082172	1089	1169	2	22	80	0.2750000
NODE_2428_length_1462_cov_1.792370	1247	1319	0	72	72	1.0000000
NODE_2428_length_1462_cov_1.792370	1305	1374	0	69	69	1.0000000
NODE_2433_length_1460_cov_23.927994	852	932	2	17	80	0.2125000
NODE_2433_length_1460_cov_23.927994	852	932	4	31	80	0.3875000
NODE_2433_length_1460_cov_23.927994	852	932	6	32	80	0.4000000
NODE_2433_length_1460_cov_23.927994	905	985	0	31	80	0.3875000
NODE_2433_length_1460_cov_23.927994	905	985	2	1	80	0.0125000
NODE_2433_length_1460_cov_23.927994	905	985	4	33	80	0.4125000
NODE_2433_length_1460_cov_23.927994	905	985	6	15	80	0.1875000
NODE_2436_length_1459_cov_43.600000	535	615	0	45	80	0.5625000
NODE_2436_length_1459_cov_43.600000	535	615	2	9	80	0.1125000
NODE_2436_length_1459_cov_43.600000	535	615	4	26	80	0.3250000
NODE_2436_length_1459_cov_43.600000	588	668	2	12	80	0.1500000
NODE_2436_length_1459_cov_43.600000	588	668	4	68	80	0.8500000
NODE_2436_length_1459_cov_43.600000	664	744	2	7	80	0.0875000
NODE_2436_length_1459_cov_43.600000	664	744	4	19	80	0.2375000
NODE_2436_length_1459_cov_43.600000	664	744	6	54	80	0.6750000
NODE_2436_length_1459_cov_43.600000	717	797	6	78	80	0.9750000
NODE_2436_length_1459_cov_43.600000	717	797	8	2	80	0.0250000
NODE_2437_length_1459_cov_32.276471	865	945	0	80	80	1.0000000
NODE_2437_length_1459_cov_32.276471	918	998	0	80	80	1.0000000
NODE_2437_length_1459_cov_32.276471	994	1074	0	80	80	1.0000000
NODE_2437_length_1459_cov_32.276471	1047	1127	0	80	80	1.0000000
NODE_2441_length_1458_cov_2.184695	1361	1441	4	54	80	0.6750000
NODE_2441_length_1458_cov_2.184695	1361	1441	6	26	80	0.3250000
NODE_2442_length_1457_cov_19.687040	834	914	0	80	80	1.0000000
NODE_2442_length_1457_cov_19.687040	887	967	0	80	80	1.0000000
NODE_2442_length_1457_cov_19.687040	963	1043	0	80	80	1.0000000
NODE_2442_length_1457_cov_19.687040	1016	1096	0	80	80	1.0000000
NODE_2444_length_1457_cov_14.944772	754	834	4	3	80	0.0375000
NODE_2444_length_1457_cov_14.944772	754	834	6	27	80	0.3375000
NODE_2444_length_1457_cov_14.944772	754	834	10	39	80	0.4875000
NODE_2444_length_1457_cov_14.944772	754	834	12	11	80	0.1375000
NODE_2444_length_1457_cov_14.944772	807	887	3	8	80	0.1000000
NODE_2444_length_1457_cov_14.944772	807	887	4	29	80	0.3625000
NODE_2444_length_1457_cov_14.944772	807	887	10	18	80	0.2250000
NODE_2444_length_1457_cov_14.944772	807	887	12	12	80	0.1500000
NODE_2444_length_1457_cov_14.944772	807	887	13	1	80	0.0125000
NODE_2444_length_1457_cov_14.944772	807	887	14	12	80	0.1500000
NODE_2445_length_1457_cov_10.168630	827	907	0	41	80	0.5125000
NODE_2445_length_1457_cov_10.168630	827	907	2	39	80	0.4875000
NODE_2445_length_1457_cov_10.168630	880	960	0	80	80	1.0000000
NODE_2445_length_1457_cov_10.168630	956	1036	0	80	80	1.0000000
NODE_2445_length_1457_cov_10.168630	1009	1089	0	80	80	1.0000000
NODE_2448_length_1456_cov_13.675755	557	637	0	80	80	1.0000000
NODE_2448_length_1456_cov_13.675755	610	690	0	80	80	1.0000000
NODE_2449_length_1456_cov_11.109064	951	1031	4	43	80	0.5375000
NODE_2449_length_1456_cov_11.109064	951	1031	6	37	80	0.4625000
NODE_2449_length_1456_cov_11.109064	1004	1084	0	50	80	0.6250000
NODE_2449_length_1456_cov_11.109064	1004	1084	4	30	80	0.3750000
NODE_2452_length_1456_cov_3.137067	374	410	2	14	36	0.3888889
NODE_2452_length_1456_cov_3.137067	374	410	6	22	36	0.6111111
NODE_2454_length_1456_cov_1.889462	35	99	0	63	64	0.9843750
NODE_2454_length_1456_cov_1.889462	35	99	4	1	64	0.0156250
NODE_2456_length_1455_cov_60.874631	369	449	0	1	80	0.0125000
NODE_2456_length_1455_cov_60.874631	369	449	2	79	80	0.9875000
NODE_2456_length_1455_cov_60.874631	422	502	0	17	80	0.2125000
NODE_2456_length_1455_cov_60.874631	422	502	2	63	80	0.7875000
NODE_2456_length_1455_cov_60.874631	498	578	2	34	80	0.4250000
NODE_2456_length_1455_cov_60.874631	498	578	4	42	80	0.5250000
NODE_2456_length_1455_cov_60.874631	498	578	6	4	80	0.0500000
NODE_2456_length_1455_cov_60.874631	551	631	0	37	80	0.4625000
NODE_2456_length_1455_cov_60.874631	551	631	4	43	80	0.5375000
NODE_2458_length_1455_cov_35.253687	615	695	0	80	80	1.0000000
NODE_2458_length_1455_cov_35.253687	668	748	0	80	80	1.0000000
NODE_2458_length_1455_cov_35.253687	744	824	0	30	80	0.3750000
NODE_2458_length_1455_cov_35.253687	744	824	2	5	80	0.0625000
NODE_2458_length_1455_cov_35.253687	744	824	4	45	80	0.5625000
NODE_2458_length_1455_cov_35.253687	797	877	2	20	80	0.2500000
NODE_2458_length_1455_cov_35.253687	797	877	4	60	80	0.7500000
NODE_2465_length_1452_cov_7.101256	976	1056	0	80	80	1.0000000
NODE_2465_length_1452_cov_7.101256	1029	1109	0	80	80	1.0000000
NODE_2465_length_1452_cov_7.101256	1105	1185	0	80	80	1.0000000
NODE_2465_length_1452_cov_7.101256	1158	1238	0	80	80	1.0000000
NODE_2470_length_1451_cov_23.880178	439	520	0	29	81	0.3580247
NODE_2470_length_1451_cov_23.880178	439	520	3	16	81	0.1975309
NODE_2470_length_1451_cov_23.880178	439	520	5	25	81	0.3086420
NODE_2470_length_1451_cov_23.880178	439	520	6	11	81	0.1358025
NODE_2470_length_1451_cov_23.880178	493	573	4	18	80	0.2250000
NODE_2470_length_1451_cov_23.880178	493	573	5	16	80	0.2000000
NODE_2470_length_1451_cov_23.880178	493	573	6	46	80	0.5750000
NODE_2471_length_1451_cov_16.249260	422	502	0	80	80	1.0000000
NODE_2471_length_1451_cov_16.249260	475	555	0	80	80	1.0000000
NODE_2472_length_1451_cov_8.663462	908	988	0	80	80	1.0000000
NODE_2472_length_1451_cov_8.663462	961	1040	0	79	79	1.0000000
NODE_2474_length_1451_cov_5.219675	897	977	0	80	80	1.0000000
NODE_2474_length_1451_cov_5.219675	950	1030	0	80	80	1.0000000
NODE_2477_length_1450_cov_20.371577	611	691	0	41	80	0.5125000
NODE_2477_length_1450_cov_20.371577	611	691	4	39	80	0.4875000
NODE_2477_length_1450_cov_20.371577	664	744	4	80	80	1.0000000
NODE_2482_length_1449_cov_24.665926	432	512	0	80	80	1.0000000
NODE_2482_length_1449_cov_24.665926	485	565	0	80	80	1.0000000
NODE_2482_length_1449_cov_24.665926	561	643	0	82	82	1.0000000
NODE_2482_length_1449_cov_24.665926	616	696	0	80	80	1.0000000
NODE_2485_length_1448_cov_20.587102	904	984	0	80	80	1.0000000
NODE_2485_length_1448_cov_20.587102	957	1037	0	80	80	1.0000000
NODE_2487_length_1448_cov_8.693847	537	617	0	76	80	0.9500000
NODE_2487_length_1448_cov_8.693847	537	617	4	4	80	0.0500000
NODE_2487_length_1448_cov_8.693847	590	670	0	23	80	0.2875000
NODE_2487_length_1448_cov_8.693847	590	670	4	57	80	0.7125000
NODE_2488_length_1447_cov_21.391691	519	599	0	80	80	1.0000000
NODE_2488_length_1447_cov_21.391691	572	652	0	80	80	1.0000000
NODE_2488_length_1447_cov_21.391691	648	728	0	80	80	1.0000000
NODE_2488_length_1447_cov_21.391691	701	781	0	59	80	0.7375000
NODE_2488_length_1447_cov_21.391691	701	781	2	21	80	0.2625000
NODE_2491_length_1447_cov_2.262611	1268	1325	12	1	57	0.0175439
NODE_2491_length_1447_cov_2.262611	1268	1325	14	1	57	0.0175439
NODE_2491_length_1447_cov_2.262611	1268	1325	16	1	57	0.0175439
NODE_2491_length_1447_cov_2.262611	1268	1325	18	3	57	0.0526316
NODE_2491_length_1447_cov_2.262611	1268	1325	19	8	57	0.1403509
NODE_2491_length_1447_cov_2.262611	1268	1325	21	4	57	0.0701754
NODE_2491_length_1447_cov_2.262611	1268	1325	25	7	57	0.1228070
NODE_2491_length_1447_cov_2.262611	1268	1325	26	1	57	0.0175439
NODE_2491_length_1447_cov_2.262611	1268	1325	27	2	57	0.0350877
NODE_2491_length_1447_cov_2.262611	1268	1325	30	4	57	0.0701754
NODE_2491_length_1447_cov_2.262611	1268	1325	32	4	57	0.0701754
NODE_2491_length_1447_cov_2.262611	1268	1325	38	8	57	0.1403509
NODE_2491_length_1447_cov_2.262611	1268	1325	40	3	57	0.0526316
NODE_2491_length_1447_cov_2.262611	1268	1325	42	5	57	0.0877193
NODE_2491_length_1447_cov_2.262611	1268	1325	44	5	57	0.0877193
NODE_2491_length_1447_cov_2.262611	1321	1378	27	1	57	0.0175439
NODE_2491_length_1447_cov_2.262611	1321	1378	29	3	57	0.0526316
NODE_2491_length_1447_cov_2.262611	1321	1378	30	1	57	0.0175439
NODE_2491_length_1447_cov_2.262611	1321	1378	36	5	57	0.0877193
NODE_2491_length_1447_cov_2.262611	1321	1378	40	3	57	0.0526316
NODE_2491_length_1447_cov_2.262611	1321	1378	44	17	57	0.2982456
NODE_2491_length_1447_cov_2.262611	1321	1378	46	8	57	0.1403509
NODE_2491_length_1447_cov_2.262611	1321	1378	48	19	57	0.3333333
NODE_2494_length_1445_cov_22.052006	759	839	0	17	80	0.2125000
NODE_2494_length_1445_cov_22.052006	759	839	2	63	80	0.7875000
NODE_2494_length_1445_cov_22.052006	812	892	0	23	80	0.2875000
NODE_2494_length_1445_cov_22.052006	812	892	2	57	80	0.7125000
NODE_2494_length_1445_cov_22.052006	888	968	0	80	80	1.0000000
NODE_2494_length_1445_cov_22.052006	941	1021	0	80	80	1.0000000
NODE_2495_length_1445_cov_13.378900	584	664	0	80	80	1.0000000
NODE_2495_length_1445_cov_13.378900	637	717	0	80	80	1.0000000
NODE_2501_length_1443_cov_7.628720	480	560	0	80	80	1.0000000
NODE_2501_length_1443_cov_7.628720	533	613	0	80	80	1.0000000
NODE_2501_length_1443_cov_7.628720	609	689	0	80	80	1.0000000
NODE_2501_length_1443_cov_7.628720	662	742	0	80	80	1.0000000
NODE_2502_length_1443_cov_4.843006	924	1004	0	80	80	1.0000000
NODE_2502_length_1443_cov_4.843006	977	1057	0	80	80	1.0000000
NODE_2508_length_1442_cov_24.551750	427	507	0	80	80	1.0000000
NODE_2508_length_1442_cov_24.551750	480	560	0	80	80	1.0000000
NODE_2508_length_1442_cov_24.551750	556	636	0	24	80	0.3000000
NODE_2508_length_1442_cov_24.551750	556	636	4	38	80	0.4750000
NODE_2508_length_1442_cov_24.551750	556	636	6	18	80	0.2250000
NODE_2508_length_1442_cov_24.551750	609	689	4	17	80	0.2125000
NODE_2508_length_1442_cov_24.551750	609	689	6	63	80	0.7875000
NODE_2509_length_1442_cov_24.032762	424	504	0	12	80	0.1500000
NODE_2509_length_1442_cov_24.032762	424	504	4	68	80	0.8500000
NODE_2509_length_1442_cov_24.032762	477	557	0	65	80	0.8125000
NODE_2509_length_1442_cov_24.032762	477	557	4	15	80	0.1875000
NODE_2511_length_1441_cov_16.528316	963	1043	23	1	80	0.0125000
NODE_2511_length_1441_cov_16.528316	963	1043	25	6	80	0.0750000
NODE_2511_length_1441_cov_16.528316	963	1043	27	9	80	0.1125000
NODE_2511_length_1441_cov_16.528316	963	1043	29	10	80	0.1250000
NODE_2511_length_1441_cov_16.528316	963	1043	31	1	80	0.0125000
NODE_2511_length_1441_cov_16.528316	963	1043	32	5	80	0.0625000
NODE_2511_length_1441_cov_16.528316	963	1043	36	23	80	0.2875000
NODE_2511_length_1441_cov_16.528316	963	1043	42	11	80	0.1375000
NODE_2511_length_1441_cov_16.528316	963	1043	44	14	80	0.1750000
NODE_2511_length_1441_cov_16.528316	1016	1096	12	2	80	0.0250000
NODE_2511_length_1441_cov_16.528316	1016	1096	14	4	80	0.0500000
NODE_2511_length_1441_cov_16.528316	1016	1096	18	12	80	0.1500000
NODE_2511_length_1441_cov_16.528316	1016	1096	20	2	80	0.0250000
NODE_2511_length_1441_cov_16.528316	1016	1096	22	4	80	0.0500000
NODE_2511_length_1441_cov_16.528316	1016	1096	24	11	80	0.1375000
NODE_2511_length_1441_cov_16.528316	1016	1096	26	1	80	0.0125000
NODE_2511_length_1441_cov_16.528316	1016	1096	28	1	80	0.0125000
NODE_2511_length_1441_cov_16.528316	1016	1096	36	11	80	0.1375000
NODE_2511_length_1441_cov_16.528316	1016	1096	42	12	80	0.1500000
NODE_2511_length_1441_cov_16.528316	1016	1096	44	20	80	0.2500000
NODE_2512_length_1441_cov_3.781669	80	156	0	61	76	0.8026316
NODE_2512_length_1441_cov_3.781669	80	156	2	15	76	0.1973684
NODE_2512_length_1441_cov_3.781669	129	209	0	12	80	0.1500000
NODE_2512_length_1441_cov_3.781669	129	209	2	61	80	0.7625000
NODE_2512_length_1441_cov_3.781669	129	209	7	7	80	0.0875000
NODE_2515_length_1440_cov_34.523490	446	526	0	80	80	1.0000000
NODE_2515_length_1440_cov_34.523490	499	576	0	77	77	1.0000000
NODE_2515_length_1440_cov_34.523490	576	654	0	22	78	0.2820513
NODE_2515_length_1440_cov_34.523490	576	654	2	22	78	0.2820513
NODE_2515_length_1440_cov_34.523490	576	654	4	8	78	0.1025641
NODE_2515_length_1440_cov_34.523490	576	654	6	16	78	0.2051282
NODE_2515_length_1440_cov_34.523490	576	654	8	5	78	0.0641026
NODE_2515_length_1440_cov_34.523490	576	654	10	5	78	0.0641026
NODE_2515_length_1440_cov_34.523490	627	707	4	1	80	0.0125000
NODE_2515_length_1440_cov_34.523490	627	707	6	16	80	0.2000000
NODE_2515_length_1440_cov_34.523490	627	707	8	5	80	0.0625000
NODE_2515_length_1440_cov_34.523490	627	707	10	14	80	0.1750000
NODE_2515_length_1440_cov_34.523490	627	707	15	10	80	0.1250000
NODE_2515_length_1440_cov_34.523490	627	707	16	11	80	0.1375000
NODE_2515_length_1440_cov_34.523490	627	707	17	23	80	0.2875000
NODE_2516_length_1440_cov_20.372110	776	856	0	80	80	1.0000000
NODE_2516_length_1440_cov_20.372110	829	909	0	42	80	0.5250000
NODE_2516_length_1440_cov_20.372110	829	909	2	38	80	0.4750000
NODE_2516_length_1440_cov_20.372110	905	985	0	40	80	0.5000000
NODE_2516_length_1440_cov_20.372110	905	985	2	40	80	0.5000000
NODE_2516_length_1440_cov_20.372110	958	1038	0	80	80	1.0000000
NODE_2517_length_1440_cov_14.476510	586	615	2	1	29	0.0344828
NODE_2517_length_1440_cov_14.476510	586	615	6	22	29	0.7586207
NODE_2517_length_1440_cov_14.476510	586	615	8	6	29	0.2068966
NODE_2517_length_1440_cov_14.476510	666	695	4	25	29	0.8620690
NODE_2517_length_1440_cov_14.476510	666	695	6	4	29	0.1379310
NODE_2517_length_1440_cov_14.476510	1295	1359	158	1	64	0.0156250
NODE_2517_length_1440_cov_14.476510	1295	1359	167	1	64	0.0156250
NODE_2517_length_1440_cov_14.476510	1295	1359	169	1	64	0.0156250
NODE_2517_length_1440_cov_14.476510	1295	1359	171	2	64	0.0312500
NODE_2517_length_1440_cov_14.476510	1295	1359	174	3	64	0.0468750
NODE_2517_length_1440_cov_14.476510	1295	1359	179	3	64	0.0468750
NODE_2517_length_1440_cov_14.476510	1295	1359	181	2	64	0.0312500
NODE_2517_length_1440_cov_14.476510	1295	1359	187	1	64	0.0156250
NODE_2517_length_1440_cov_14.476510	1295	1359	191	1	64	0.0156250
NODE_2517_length_1440_cov_14.476510	1295	1359	199	2	64	0.0312500
NODE_2517_length_1440_cov_14.476510	1295	1359	201	6	64	0.0937500
NODE_2517_length_1440_cov_14.476510	1295	1359	203	2	64	0.0312500
NODE_2517_length_1440_cov_14.476510	1295	1359	205	3	64	0.0468750
NODE_2517_length_1440_cov_14.476510	1295	1359	207	2	64	0.0312500
NODE_2517_length_1440_cov_14.476510	1295	1359	209	3	64	0.0468750
NODE_2517_length_1440_cov_14.476510	1295	1359	211	1	64	0.0156250
NODE_2517_length_1440_cov_14.476510	1295	1359	212	8	64	0.1250000
NODE_2517_length_1440_cov_14.476510	1295	1359	216	2	64	0.0312500
NODE_2517_length_1440_cov_14.476510	1295	1359	218	3	64	0.0468750
NODE_2517_length_1440_cov_14.476510	1295	1359	220	17	64	0.2656250
NODE_2518_length_1440_cov_9.049217	384	464	0	80	80	1.0000000
NODE_2518_length_1440_cov_9.049217	437	517	0	80	80	1.0000000
NODE_2520_length_1439_cov_11.784328	898	978	0	36	80	0.4500000
NODE_2520_length_1439_cov_11.784328	898	978	2	44	80	0.5500000
NODE_2520_length_1439_cov_11.784328	951	1031	0	27	80	0.3375000
NODE_2520_length_1439_cov_11.784328	951	1031	2	53	80	0.6625000
NODE_2525_length_1438_cov_41.481703	671	751	0	44	80	0.5500000
NODE_2525_length_1438_cov_41.481703	671	751	2	28	80	0.3500000
NODE_2525_length_1438_cov_41.481703	671	751	4	8	80	0.1000000
NODE_2525_length_1438_cov_41.481703	724	804	2	59	80	0.7375000
NODE_2525_length_1438_cov_41.481703	724	804	4	21	80	0.2625000
NODE_2529_length_1437_cov_14.449178	815	895	0	29	80	0.3625000
NODE_2529_length_1437_cov_14.449178	815	895	2	51	80	0.6375000
NODE_2529_length_1437_cov_14.449178	868	948	0	14	80	0.1750000
NODE_2529_length_1437_cov_14.449178	868	948	2	66	80	0.8250000
NODE_2529_length_1437_cov_14.449178	944	1024	0	80	80	1.0000000
NODE_2529_length_1437_cov_14.449178	997	1077	0	80	80	1.0000000
NODE_2532_length_1436_cov_96.256545	1145	1225	10	3	80	0.0375000
NODE_2532_length_1436_cov_96.256545	1145	1225	20	1	80	0.0125000
NODE_2532_length_1436_cov_96.256545	1145	1225	21	1	80	0.0125000
NODE_2532_length_1436_cov_96.256545	1145	1225	22	28	80	0.3500000
NODE_2532_length_1436_cov_96.256545	1145	1225	24	25	80	0.3125000
NODE_2532_length_1436_cov_96.256545	1145	1225	25	3	80	0.0375000
NODE_2532_length_1436_cov_96.256545	1145	1225	26	19	80	0.2375000
NODE_2532_length_1436_cov_96.256545	1198	1278	17	8	80	0.1000000
NODE_2532_length_1436_cov_96.256545	1198	1278	19	14	80	0.1750000
NODE_2532_length_1436_cov_96.256545	1198	1278	24	41	80	0.5125000
NODE_2532_length_1436_cov_96.256545	1198	1278	25	8	80	0.1000000
NODE_2532_length_1436_cov_96.256545	1198	1278	26	9	80	0.1125000
NODE_2532_length_1436_cov_96.256545	1274	1354	0	54	80	0.6750000
NODE_2532_length_1436_cov_96.256545	1274	1354	4	16	80	0.2000000
NODE_2532_length_1436_cov_96.256545	1274	1354	16	3	80	0.0375000
NODE_2532_length_1436_cov_96.256545	1274	1354	17	7	80	0.0875000
NODE_2532_length_1436_cov_96.256545	1327	1407	0	80	80	1.0000000
NODE_2536_length_1435_cov_21.468563	783	863	0	80	80	1.0000000
NODE_2536_length_1435_cov_21.468563	836	916	0	80	80	1.0000000
NODE_2536_length_1435_cov_21.468563	912	992	0	23	80	0.2875000
NODE_2536_length_1435_cov_21.468563	912	992	2	13	80	0.1625000
NODE_2536_length_1435_cov_21.468563	912	992	4	21	80	0.2625000
NODE_2536_length_1435_cov_21.468563	912	992	6	23	80	0.2875000
NODE_2536_length_1435_cov_21.468563	965	1045	4	22	80	0.2750000
NODE_2536_length_1435_cov_21.468563	965	1045	6	58	80	0.7250000
NODE_2537_length_1435_cov_18.593563	1123	1203	0	11	80	0.1375000
NODE_2537_length_1435_cov_18.593563	1123	1203	2	37	80	0.4625000
NODE_2537_length_1435_cov_18.593563	1123	1203	6	1	80	0.0125000
NODE_2537_length_1435_cov_18.593563	1123	1203	10	6	80	0.0750000
NODE_2537_length_1435_cov_18.593563	1123	1203	11	1	80	0.0125000
NODE_2537_length_1435_cov_18.593563	1123	1203	12	5	80	0.0625000
NODE_2537_length_1435_cov_18.593563	1123	1203	16	6	80	0.0750000
NODE_2537_length_1435_cov_18.593563	1123	1203	18	7	80	0.0875000
NODE_2537_length_1435_cov_18.593563	1123	1203	19	6	80	0.0750000
NODE_2537_length_1435_cov_18.593563	1176	1256	0	45	80	0.5625000
NODE_2537_length_1435_cov_18.593563	1176	1256	2	23	80	0.2875000
NODE_2537_length_1435_cov_18.593563	1176	1256	3	2	80	0.0250000
NODE_2537_length_1435_cov_18.593563	1176	1256	4	10	80	0.1250000
NODE_2538_length_1435_cov_5.828593	299	379	0	80	80	1.0000000
NODE_2538_length_1435_cov_5.828593	352	432	0	80	80	1.0000000
NODE_2540_length_1434_cov_17.610487	1023	1103	0	18	80	0.2250000
NODE_2540_length_1434_cov_17.610487	1023	1103	4	62	80	0.7750000
NODE_2540_length_1434_cov_17.610487	1076	1156	0	16	80	0.2000000
NODE_2540_length_1434_cov_17.610487	1076	1156	4	64	80	0.8000000
NODE_2540_length_1434_cov_17.610487	1152	1232	0	63	80	0.7875000
NODE_2540_length_1434_cov_17.610487	1152	1232	4	17	80	0.2125000
NODE_2540_length_1434_cov_17.610487	1205	1285	0	10	80	0.1250000
NODE_2540_length_1434_cov_17.610487	1205	1285	4	70	80	0.8750000
NODE_2541_length_1434_cov_9.845693	846	926	0	14	80	0.1750000
NODE_2541_length_1434_cov_9.845693	846	926	2	8	80	0.1000000
NODE_2541_length_1434_cov_9.845693	846	926	6	39	80	0.4875000
NODE_2541_length_1434_cov_9.845693	846	926	7	2	80	0.0250000
NODE_2541_length_1434_cov_9.845693	846	926	10	17	80	0.2125000
NODE_2541_length_1434_cov_9.845693	899	978	4	19	79	0.2405063
NODE_2541_length_1434_cov_9.845693	899	978	6	8	79	0.1012658
NODE_2541_length_1434_cov_9.845693	899	978	7	2	79	0.0253165
NODE_2541_length_1434_cov_9.845693	899	978	10	50	79	0.6329114
NODE_2544_length_1433_cov_36.452774	538	618	0	80	80	1.0000000
NODE_2544_length_1433_cov_36.452774	591	671	0	64	80	0.8000000
NODE_2544_length_1433_cov_36.452774	591	671	4	16	80	0.2000000
NODE_2544_length_1433_cov_36.452774	667	747	4	80	80	1.0000000
NODE_2544_length_1433_cov_36.452774	720	800	0	22	80	0.2750000
NODE_2544_length_1433_cov_36.452774	720	800	4	58	80	0.7250000
NODE_2550_length_1431_cov_7.409159	513	593	0	19	80	0.2375000
NODE_2550_length_1431_cov_7.409159	513	593	2	61	80	0.7625000
NODE_2550_length_1431_cov_7.409159	566	646	0	72	80	0.9000000
NODE_2550_length_1431_cov_7.409159	566	646	2	8	80	0.1000000
NODE_2551_length_1431_cov_6.721471	1074	1154	0	80	80	1.0000000
NODE_2551_length_1431_cov_6.721471	1127	1207	0	80	80	1.0000000
NODE_2552_length_1430_cov_32.643877	753	833	0	80	80	1.0000000
NODE_2552_length_1430_cov_32.643877	806	886	0	80	80	1.0000000
NODE_2552_length_1430_cov_32.643877	882	962	0	33	80	0.4125000
NODE_2552_length_1430_cov_32.643877	882	962	2	37	80	0.4625000
NODE_2552_length_1430_cov_32.643877	882	962	6	10	80	0.1250000
NODE_2552_length_1430_cov_32.643877	935	1016	2	17	81	0.2098765
NODE_2552_length_1430_cov_32.643877	935	1016	4	23	81	0.2839506
NODE_2552_length_1430_cov_32.643877	935	1016	6	41	81	0.5061728
NODE_2557_length_1428_cov_5.895410	340	416	0	76	76	1.0000000
NODE_2557_length_1428_cov_5.895410	393	476	0	83	83	1.0000000
NODE_2560_length_1427_cov_38.919428	707	787	0	80	80	1.0000000
NODE_2560_length_1427_cov_38.919428	760	840	0	80	80	1.0000000
NODE_2560_length_1427_cov_38.919428	836	916	0	80	80	1.0000000
NODE_2560_length_1427_cov_38.919428	889	969	0	80	80	1.0000000
NODE_2561_length_1427_cov_19.442771	808	888	2	56	80	0.7000000
NODE_2561_length_1427_cov_19.442771	808	888	4	24	80	0.3000000
NODE_2561_length_1427_cov_19.442771	861	941	0	18	80	0.2250000
NODE_2561_length_1427_cov_19.442771	861	941	2	58	80	0.7250000
NODE_2561_length_1427_cov_19.442771	861	941	4	4	80	0.0500000
NODE_2561_length_1427_cov_19.442771	937	1017	0	11	80	0.1375000
NODE_2561_length_1427_cov_19.442771	937	1017	2	69	80	0.8625000
NODE_2561_length_1427_cov_19.442771	990	1070	0	64	80	0.8000000
NODE_2561_length_1427_cov_19.442771	990	1070	2	16	80	0.2000000
NODE_2562_length_1427_cov_10.490964	728	808	0	80	80	1.0000000
NODE_2562_length_1427_cov_10.490964	781	861	0	80	80	1.0000000
NODE_2562_length_1427_cov_10.490964	857	937	0	80	80	1.0000000
NODE_2562_length_1427_cov_10.490964	910	990	0	80	80	1.0000000
NODE_2563_length_1427_cov_9.929217	646	726	0	80	80	1.0000000
NODE_2563_length_1427_cov_9.929217	699	779	0	80	80	1.0000000
NODE_2563_length_1427_cov_9.929217	775	855	0	80	80	1.0000000
NODE_2563_length_1427_cov_9.929217	828	908	0	80	80	1.0000000
NODE_2563_length_1427_cov_9.929217	1248	1324	0	76	76	1.0000000
NODE_2563_length_1427_cov_9.929217	1301	1376	0	75	75	1.0000000
NODE_2564_length_1427_cov_3.122741	1336	1399	0	63	63	1.0000000
NODE_2570_length_1426_cov_36.580256	422	502	0	80	80	1.0000000
NODE_2570_length_1426_cov_36.580256	475	555	0	80	80	1.0000000
NODE_2570_length_1426_cov_36.580256	551	631	0	80	80	1.0000000
NODE_2570_length_1426_cov_36.580256	604	684	0	80	80	1.0000000
NODE_2574_length_1425_cov_25.524133	561	641	16	80	80	1.0000000
NODE_2574_length_1425_cov_25.524133	614	694	0	40	80	0.5000000
NODE_2574_length_1425_cov_25.524133	614	694	4	8	80	0.1000000
NODE_2574_length_1425_cov_25.524133	614	694	8	1	80	0.0125000
NODE_2574_length_1425_cov_25.524133	614	694	15	1	80	0.0125000
NODE_2574_length_1425_cov_25.524133	614	694	16	30	80	0.3750000
NODE_2575_length_1425_cov_10.175716	361	441	0	80	80	1.0000000
NODE_2575_length_1425_cov_10.175716	414	494	0	80	80	1.0000000
NODE_2587_length_1423_cov_31.158610	862	942	4	80	80	1.0000000
NODE_2587_length_1423_cov_31.158610	915	995	0	11	80	0.1375000
NODE_2587_length_1423_cov_31.158610	915	995	2	6	80	0.0750000
NODE_2587_length_1423_cov_31.158610	915	995	4	63	80	0.7875000
NODE_2588_length_1423_cov_30.731873	764	844	0	28	80	0.3500000
NODE_2588_length_1423_cov_30.731873	764	844	2	52	80	0.6500000
NODE_2588_length_1423_cov_30.731873	817	897	2	80	80	1.0000000
NODE_2596_length_1421_cov_8.285930	136	212	76	2	76	0.0263158
NODE_2596_length_1421_cov_8.285930	136	212	78	4	76	0.0526316
NODE_2596_length_1421_cov_8.285930	136	212	80	2	76	0.0263158
NODE_2596_length_1421_cov_8.285930	136	212	82	1	76	0.0131579
NODE_2596_length_1421_cov_8.285930	136	212	84	5	76	0.0657895
NODE_2596_length_1421_cov_8.285930	136	212	85	1	76	0.0131579
NODE_2596_length_1421_cov_8.285930	136	212	86	1	76	0.0131579
NODE_2596_length_1421_cov_8.285930	136	212	88	4	76	0.0526316
NODE_2596_length_1421_cov_8.285930	136	212	92	1	76	0.0131579
NODE_2596_length_1421_cov_8.285930	136	212	94	1	76	0.0131579
NODE_2596_length_1421_cov_8.285930	136	212	97	1	76	0.0131579
NODE_2596_length_1421_cov_8.285930	136	212	98	1	76	0.0131579
NODE_2596_length_1421_cov_8.285930	136	212	99	1	76	0.0131579
NODE_2596_length_1421_cov_8.285930	136	212	100	3	76	0.0394737
NODE_2596_length_1421_cov_8.285930	136	212	102	1	76	0.0131579
NODE_2596_length_1421_cov_8.285930	136	212	106	1	76	0.0131579
NODE_2596_length_1421_cov_8.285930	136	212	108	1	76	0.0131579
NODE_2596_length_1421_cov_8.285930	136	212	117	1	76	0.0131579
NODE_2596_length_1421_cov_8.285930	136	212	123	1	76	0.0131579
NODE_2596_length_1421_cov_8.285930	136	212	125	1	76	0.0131579
NODE_2596_length_1421_cov_8.285930	136	212	127	5	76	0.0657895
NODE_2596_length_1421_cov_8.285930	136	212	129	3	76	0.0394737
NODE_2596_length_1421_cov_8.285930	136	212	135	2	76	0.0263158
NODE_2596_length_1421_cov_8.285930	136	212	136	1	76	0.0131579
NODE_2596_length_1421_cov_8.285930	136	212	137	2	76	0.0263158
NODE_2596_length_1421_cov_8.285930	136	212	138	1	76	0.0131579
NODE_2596_length_1421_cov_8.285930	136	212	139	3	76	0.0394737
NODE_2596_length_1421_cov_8.285930	136	212	140	1	76	0.0131579
NODE_2596_length_1421_cov_8.285930	136	212	141	3	76	0.0394737
NODE_2596_length_1421_cov_8.285930	136	212	142	2	76	0.0263158
NODE_2596_length_1421_cov_8.285930	136	212	143	4	76	0.0526316
NODE_2596_length_1421_cov_8.285930	136	212	144	4	76	0.0526316
NODE_2596_length_1421_cov_8.285930	136	212	145	4	76	0.0526316
NODE_2596_length_1421_cov_8.285930	136	212	146	4	76	0.0526316
NODE_2596_length_1421_cov_8.285930	136	212	147	1	76	0.0131579
NODE_2596_length_1421_cov_8.285930	136	212	149	1	76	0.0131579
NODE_2596_length_1421_cov_8.285930	136	212	151	1	76	0.0131579
NODE_2598_length_1421_cov_2.574130	22	102	4	2	80	0.0250000
NODE_2598_length_1421_cov_2.574130	22	102	6	13	80	0.1625000
NODE_2598_length_1421_cov_2.574130	22	102	8	65	80	0.8125000
NODE_2598_length_1421_cov_2.574130	75	132	4	20	57	0.3508772
NODE_2598_length_1421_cov_2.574130	75	132	6	8	57	0.1403509
NODE_2598_length_1421_cov_2.574130	75	132	8	29	57	0.5087720
NODE_2599_length_1420_cov_256.442846	60	140	2	16	80	0.2000000
NODE_2599_length_1420_cov_256.442846	60	140	6	10	80	0.1250000
NODE_2599_length_1420_cov_256.442846	60	140	8	54	80	0.6750000
NODE_2599_length_1420_cov_256.442846	1294	1360	0	6	66	0.0909091
NODE_2599_length_1420_cov_256.442846	1294	1360	8	2	66	0.0303030
NODE_2599_length_1420_cov_256.442846	1294	1360	12	4	66	0.0606061
NODE_2599_length_1420_cov_256.442846	1294	1360	14	5	66	0.0757576
NODE_2599_length_1420_cov_256.442846	1294	1360	16	49	66	0.7424242
NODE_2600_length_1420_cov_7.547313	628	708	0	80	80	1.0000000
NODE_2600_length_1420_cov_7.547313	681	761	0	49	80	0.6125000
NODE_2600_length_1420_cov_7.547313	681	761	2	31	80	0.3875000
NODE_2602_length_1420_cov_2.051476	972	1039	2	6	67	0.0895522
NODE_2602_length_1420_cov_2.051476	972	1039	4	61	67	0.9104478
NODE_2604_length_1419_cov_46.997727	1230	1305	0	23	75	0.3066667
NODE_2604_length_1419_cov_46.997727	1230	1305	4	13	75	0.1733333
NODE_2604_length_1419_cov_46.997727	1230	1305	6	39	75	0.5200000
NODE_2604_length_1419_cov_46.997727	1278	1332	6	54	54	1.0000000
NODE_2609_length_1418_cov_11.373010	432	512	0	46	80	0.5750000
NODE_2609_length_1418_cov_11.373010	432	512	2	34	80	0.4250000
NODE_2609_length_1418_cov_11.373010	485	556	2	71	71	1.0000000
NODE_2615_length_1417_cov_12.477997	354	399	0	45	45	1.0000000
NODE_2616_length_1417_cov_11.120637	794	874	0	51	80	0.6375000
NODE_2616_length_1417_cov_11.120637	794	874	2	29	80	0.3625000
NODE_2616_length_1417_cov_11.120637	847	927	2	80	80	1.0000000
NODE_2625_length_1415_cov_51.375380	423	503	0	80	80	1.0000000
NODE_2625_length_1415_cov_51.375380	476	556	0	80	80	1.0000000
NODE_2625_length_1415_cov_51.375380	552	632	0	80	80	1.0000000
NODE_2625_length_1415_cov_51.375380	605	683	0	78	78	1.0000000
NODE_2626_length_1415_cov_38.272036	513	593	0	23	80	0.2875000
NODE_2626_length_1415_cov_38.272036	513	593	2	57	80	0.7125000
NODE_2626_length_1415_cov_38.272036	566	646	0	43	80	0.5375000
NODE_2626_length_1415_cov_38.272036	566	646	2	37	80	0.4625000
NODE_2627_length_1415_cov_17.232523	642	722	0	80	80	1.0000000
NODE_2627_length_1415_cov_17.232523	695	775	0	80	80	1.0000000
NODE_2629_length_1414_cov_5.307985	1026	1106	2	80	80	1.0000000
NODE_2629_length_1414_cov_5.307985	1079	1159	2	55	80	0.6875000
NODE_2629_length_1414_cov_5.307985	1079	1159	4	25	80	0.3125000
NODE_2637_length_1412_cov_17.723534	875	955	0	80	80	1.0000000
NODE_2637_length_1412_cov_17.723534	928	1008	0	80	80	1.0000000
NODE_2641_length_1411_cov_34.004573	516	596	0	80	80	1.0000000
NODE_2641_length_1411_cov_34.004573	569	649	0	80	80	1.0000000
NODE_2641_length_1411_cov_34.004573	645	725	0	38	80	0.4750000
NODE_2641_length_1411_cov_34.004573	645	725	2	42	80	0.5250000
NODE_2641_length_1411_cov_34.004573	698	778	0	9	80	0.1125000
NODE_2641_length_1411_cov_34.004573	698	778	2	71	80	0.8875000
NODE_2643_length_1409_cov_25.380153	828	908	2	11	80	0.1375000
NODE_2643_length_1409_cov_25.380153	828	908	4	16	80	0.2000000
NODE_2643_length_1409_cov_25.380153	828	908	6	53	80	0.6625000
NODE_2643_length_1409_cov_25.380153	881	961	4	8	80	0.1000000
NODE_2643_length_1409_cov_25.380153	881	961	6	38	80	0.4750000
NODE_2643_length_1409_cov_25.380153	881	961	7	4	80	0.0500000
NODE_2643_length_1409_cov_25.380153	881	961	8	20	80	0.2500000
NODE_2643_length_1409_cov_25.380153	881	961	9	10	80	0.1250000
NODE_2644_length_1409_cov_13.028244	349	405	49	7	56	0.1250000
NODE_2644_length_1409_cov_13.028244	349	405	53	11	56	0.1964286
NODE_2644_length_1409_cov_13.028244	349	405	55	5	56	0.0892857
NODE_2644_length_1409_cov_13.028244	349	405	56	11	56	0.1964286
NODE_2644_length_1409_cov_13.028244	349	405	58	2	56	0.0357143
NODE_2644_length_1409_cov_13.028244	349	405	60	9	56	0.1607143
NODE_2644_length_1409_cov_13.028244	349	405	63	2	56	0.0357143
NODE_2644_length_1409_cov_13.028244	349	405	64	9	56	0.1607143
NODE_2644_length_1409_cov_13.028244	416	482	28	1	66	0.0151515
NODE_2644_length_1409_cov_13.028244	416	482	30	29	66	0.4393939
NODE_2644_length_1409_cov_13.028244	416	482	34	7	66	0.1060606
NODE_2644_length_1409_cov_13.028244	416	482	35	4	66	0.0606061
NODE_2644_length_1409_cov_13.028244	416	482	36	3	66	0.0454545
NODE_2644_length_1409_cov_13.028244	416	482	38	1	66	0.0151515
NODE_2644_length_1409_cov_13.028244	416	482	40	13	66	0.1969697
NODE_2644_length_1409_cov_13.028244	416	482	42	8	66	0.1212121
NODE_2648_length_1408_cov_6.261268	492	572	0	80	80	1.0000000
NODE_2648_length_1408_cov_6.261268	545	625	0	80	80	1.0000000
NODE_2652_length_1407_cov_27.711009	772	852	2	6	80	0.0750000
NODE_2652_length_1407_cov_27.711009	772	852	6	46	80	0.5750000
NODE_2652_length_1407_cov_27.711009	772	852	8	14	80	0.1750000
NODE_2652_length_1407_cov_27.711009	772	852	10	14	80	0.1750000
NODE_2652_length_1407_cov_27.711009	825	905	0	49	80	0.6125000
NODE_2652_length_1407_cov_27.711009	825	905	2	10	80	0.1250000
NODE_2652_length_1407_cov_27.711009	825	905	6	21	80	0.2625000
NODE_2653_length_1407_cov_24.387615	586	666	0	26	80	0.3250000
NODE_2653_length_1407_cov_24.387615	586	666	2	54	80	0.6750000
NODE_2653_length_1407_cov_24.387615	639	719	0	19	80	0.2375000
NODE_2653_length_1407_cov_24.387615	639	719	2	61	80	0.7625000
NODE_2653_length_1407_cov_24.387615	715	795	0	1	80	0.0125000
NODE_2653_length_1407_cov_24.387615	715	795	2	79	80	0.9875000
NODE_2653_length_1407_cov_24.387615	768	848	0	39	80	0.4875000
NODE_2653_length_1407_cov_24.387615	768	848	2	41	80	0.5125000
NODE_2654_length_1407_cov_19.022936	551	629	4	1	78	0.0128205
NODE_2654_length_1407_cov_19.022936	551	629	8	8	78	0.1025641
NODE_2654_length_1407_cov_19.022936	551	629	18	7	78	0.0897436
NODE_2654_length_1407_cov_19.022936	551	629	20	7	78	0.0897436
NODE_2654_length_1407_cov_19.022936	551	629	27	5	78	0.0641026
NODE_2654_length_1407_cov_19.022936	551	629	28	2	78	0.0256410
NODE_2654_length_1407_cov_19.022936	551	629	29	3	78	0.0384615
NODE_2654_length_1407_cov_19.022936	551	629	33	3	78	0.0384615
NODE_2654_length_1407_cov_19.022936	551	629	34	35	78	0.4487180
NODE_2654_length_1407_cov_19.022936	551	629	37	7	78	0.0897436
NODE_2654_length_1407_cov_19.022936	602	665	4	37	63	0.5873016
NODE_2654_length_1407_cov_19.022936	602	665	8	8	63	0.1269841
NODE_2654_length_1407_cov_19.022936	602	665	18	7	63	0.1111111
NODE_2654_length_1407_cov_19.022936	602	665	20	7	63	0.1111111
NODE_2654_length_1407_cov_19.022936	602	665	27	4	63	0.0634921
NODE_2655_length_1407_cov_11.266820	813	893	0	80	80	1.0000000
NODE_2655_length_1407_cov_11.266820	866	946	0	80	80	1.0000000
NODE_2655_length_1407_cov_11.266820	942	1022	0	80	80	1.0000000
NODE_2655_length_1407_cov_11.266820	995	1075	0	80	80	1.0000000
NODE_2657_length_1406_cov_7.247896	761	841	0	6	80	0.0750000
NODE_2657_length_1406_cov_7.247896	761	841	8	74	80	0.9250000
NODE_2657_length_1406_cov_7.247896	814	894	8	80	80	1.0000000
NODE_2659_length_1404_cov_23.406130	826	906	0	80	80	1.0000000
NODE_2659_length_1404_cov_23.406130	879	959	0	80	80	1.0000000
NODE_2659_length_1404_cov_23.406130	955	1035	0	80	80	1.0000000
NODE_2659_length_1404_cov_23.406130	1008	1088	0	80	80	1.0000000
NODE_2666_length_1403_cov_14.331288	325	405	0	80	80	1.0000000
NODE_2666_length_1403_cov_14.331288	378	458	0	80	80	1.0000000
NODE_2666_length_1403_cov_14.331288	454	534	0	68	80	0.8500000
NODE_2666_length_1403_cov_14.331288	454	534	2	12	80	0.1500000
NODE_2666_length_1403_cov_14.331288	454	534	0	68	80	0.8500000
NODE_2666_length_1403_cov_14.331288	454	534	2	12	80	0.1500000
NODE_2666_length_1403_cov_14.331288	454	524	0	68	70	0.9714286
NODE_2666_length_1403_cov_14.331288	454	524	2	2	70	0.0285714
NODE_2666_length_1403_cov_14.331288	507	587	0	15	80	0.1875000
NODE_2666_length_1403_cov_14.331288	507	587	2	65	80	0.8125000
NODE_2666_length_1403_cov_14.331288	507	579	0	15	72	0.2083333
NODE_2666_length_1403_cov_14.331288	507	579	2	57	72	0.7916667
NODE_2668_length_1402_cov_29.095165	610	690	6	29	80	0.3625000
NODE_2668_length_1402_cov_29.095165	610	690	7	30	80	0.3750000
NODE_2668_length_1402_cov_29.095165	610	690	11	2	80	0.0250000
NODE_2668_length_1402_cov_29.095165	610	690	12	19	80	0.2375000
NODE_2668_length_1402_cov_29.095165	663	743	0	19	80	0.2375000
NODE_2668_length_1402_cov_29.095165	663	743	2	13	80	0.1625000
NODE_2668_length_1402_cov_29.095165	663	743	6	13	80	0.1625000
NODE_2668_length_1402_cov_29.095165	663	743	7	35	80	0.4375000
NODE_2669_length_1402_cov_23.411358	528	608	0	80	80	1.0000000
NODE_2669_length_1402_cov_23.411358	581	661	0	80	80	1.0000000
NODE_2669_length_1402_cov_23.411358	657	737	0	19	80	0.2375000
NODE_2669_length_1402_cov_23.411358	657	737	5	1	80	0.0125000
NODE_2669_length_1402_cov_23.411358	657	737	6	42	80	0.5250000
NODE_2669_length_1402_cov_23.411358	657	737	8	18	80	0.2250000
NODE_2669_length_1402_cov_23.411358	710	790	0	2	80	0.0250000
NODE_2669_length_1402_cov_23.411358	710	790	2	21	80	0.2625000
NODE_2669_length_1402_cov_23.411358	710	790	6	9	80	0.1125000
NODE_2669_length_1402_cov_23.411358	710	790	8	48	80	0.6000000
NODE_2670_length_1402_cov_11.732924	661	741	0	15	80	0.1875000
NODE_2670_length_1402_cov_11.732924	661	741	2	38	80	0.4750000
NODE_2670_length_1402_cov_11.732924	661	741	4	1	80	0.0125000
NODE_2670_length_1402_cov_11.732924	661	741	6	26	80	0.3250000
NODE_2670_length_1402_cov_11.732924	714	794	4	1	80	0.0125000
NODE_2670_length_1402_cov_11.732924	714	794	6	79	80	0.9875000
NODE_2671_length_1402_cov_9.929394	766	846	0	80	80	1.0000000
NODE_2671_length_1402_cov_9.929394	819	899	0	80	80	1.0000000
NODE_2677_length_1401_cov_35.754992	825	905	0	80	80	1.0000000
NODE_2677_length_1401_cov_35.754992	878	958	0	39	80	0.4875000
NODE_2677_length_1401_cov_35.754992	878	958	2	41	80	0.5125000
NODE_2678_length_1401_cov_10.811828	539	619	0	80	80	1.0000000
NODE_2678_length_1401_cov_10.811828	592	672	0	80	80	1.0000000
NODE_2679_length_1401_cov_5.438556	241	321	0	80	80	1.0000000
NODE_2679_length_1401_cov_5.438556	294	374	0	80	80	1.0000000
NODE_2683_length_1400_cov_16.680246	813	893	0	57	80	0.7125000
NODE_2683_length_1400_cov_16.680246	813	893	2	23	80	0.2875000
NODE_2683_length_1400_cov_16.680246	866	946	0	8	80	0.1000000
NODE_2683_length_1400_cov_16.680246	866	946	2	72	80	0.9000000
NODE_2684_length_1400_cov_8.166795	53	133	0	14	80	0.1750000
NODE_2684_length_1400_cov_8.166795	53	133	2	30	80	0.3750000
NODE_2684_length_1400_cov_8.166795	53	133	4	36	80	0.4500000
NODE_2684_length_1400_cov_8.166795	106	186	2	28	80	0.3500000
NODE_2684_length_1400_cov_8.166795	106	186	4	52	80	0.6500000
NODE_2694_length_1397_cov_25.549307	869	918	0	49	49	1.0000000
NODE_2694_length_1397_cov_25.549307	891	971	0	80	80	1.0000000
NODE_2695_length_1397_cov_14.395223	672	752	0	80	80	1.0000000
NODE_2695_length_1397_cov_14.395223	725	805	0	80	80	1.0000000
NODE_2695_length_1397_cov_14.395223	801	881	0	80	80	1.0000000
NODE_2695_length_1397_cov_14.395223	854	934	0	41	80	0.5125000
NODE_2695_length_1397_cov_14.395223	854	934	2	39	80	0.4875000
NODE_2699_length_1396_cov_21.656130	825	905	0	80	80	1.0000000
NODE_2699_length_1396_cov_21.656130	878	958	0	80	80	1.0000000
NODE_2700_length_1396_cov_18.108712	560	640	6	76	80	0.9500000
NODE_2700_length_1396_cov_18.108712	560	640	12	4	80	0.0500000
NODE_2700_length_1396_cov_18.108712	613	693	6	23	80	0.2875000
NODE_2700_length_1396_cov_18.108712	613	693	8	7	80	0.0875000
NODE_2700_length_1396_cov_18.108712	613	693	11	14	80	0.1750000
NODE_2700_length_1396_cov_18.108712	613	693	12	13	80	0.1625000
NODE_2700_length_1396_cov_18.108712	613	693	14	23	80	0.2875000
NODE_2701_length_1396_cov_16.208944	136	198	36	2	62	0.0322581
NODE_2701_length_1396_cov_16.208944	136	198	38	4	62	0.0645161
NODE_2701_length_1396_cov_16.208944	136	198	39	1	62	0.0161290
NODE_2701_length_1396_cov_16.208944	136	198	43	1	62	0.0161290
NODE_2701_length_1396_cov_16.208944	136	198	49	3	62	0.0483871
NODE_2701_length_1396_cov_16.208944	136	198	51	2	62	0.0322581
NODE_2701_length_1396_cov_16.208944	136	198	56	1	62	0.0161290
NODE_2701_length_1396_cov_16.208944	136	198	63	2	62	0.0322581
NODE_2701_length_1396_cov_16.208944	136	198	65	1	62	0.0161290
NODE_2701_length_1396_cov_16.208944	136	198	66	4	62	0.0645161
NODE_2701_length_1396_cov_16.208944	136	198	68	1	62	0.0161290
NODE_2701_length_1396_cov_16.208944	136	198	70	4	62	0.0645161
NODE_2701_length_1396_cov_16.208944	136	198	74	1	62	0.0161290
NODE_2701_length_1396_cov_16.208944	136	198	75	2	62	0.0322581
NODE_2701_length_1396_cov_16.208944	136	198	82	2	62	0.0322581
NODE_2701_length_1396_cov_16.208944	136	198	84	1	62	0.0161290
NODE_2701_length_1396_cov_16.208944	136	198	86	1	62	0.0161290
NODE_2701_length_1396_cov_16.208944	136	198	90	1	62	0.0161290
NODE_2701_length_1396_cov_16.208944	136	198	91	2	62	0.0322581
NODE_2701_length_1396_cov_16.208944	136	198	96	2	62	0.0322581
NODE_2701_length_1396_cov_16.208944	136	198	98	1	62	0.0161290
NODE_2701_length_1396_cov_16.208944	136	198	99	1	62	0.0161290
NODE_2701_length_1396_cov_16.208944	136	198	102	1	62	0.0161290
NODE_2701_length_1396_cov_16.208944	136	198	103	2	62	0.0322581
NODE_2701_length_1396_cov_16.208944	136	198	106	1	62	0.0161290
NODE_2701_length_1396_cov_16.208944	136	198	108	3	62	0.0483871
NODE_2701_length_1396_cov_16.208944	136	198	110	1	62	0.0161290
NODE_2701_length_1396_cov_16.208944	136	198	118	1	62	0.0161290
NODE_2701_length_1396_cov_16.208944	136	198	120	3	62	0.0483871
NODE_2701_length_1396_cov_16.208944	136	198	124	1	62	0.0161290
NODE_2701_length_1396_cov_16.208944	136	198	128	1	62	0.0161290
NODE_2701_length_1396_cov_16.208944	136	198	130	3	62	0.0483871
NODE_2701_length_1396_cov_16.208944	136	198	131	2	62	0.0322581
NODE_2701_length_1396_cov_16.208944	136	198	135	1	62	0.0161290
NODE_2701_length_1396_cov_16.208944	136	198	137	2	62	0.0322581
NODE_2701_length_1396_cov_16.208944	848	928	0	13	80	0.1625000
NODE_2701_length_1396_cov_16.208944	848	928	2	67	80	0.8375000
NODE_2701_length_1396_cov_16.208944	901	981	0	66	80	0.8250000
NODE_2701_length_1396_cov_16.208944	901	981	2	14	80	0.1750000
NODE_2701_length_1396_cov_16.208944	977	1057	0	51	80	0.6375000
NODE_2701_length_1396_cov_16.208944	977	1057	4	29	80	0.3625000
NODE_2701_length_1396_cov_16.208944	1030	1110	0	22	80	0.2750000
NODE_2701_length_1396_cov_16.208944	1030	1110	4	58	80	0.7250000
NODE_2702_length_1396_cov_9.196608	428	508	0	80	80	1.0000000
NODE_2702_length_1396_cov_9.196608	481	561	0	80	80	1.0000000
NODE_2712_length_1394_cov_29.602317	349	415	0	24	66	0.3636364
NODE_2712_length_1394_cov_29.602317	349	415	3	9	66	0.1363636
NODE_2712_length_1394_cov_29.602317	349	415	4	33	66	0.5000000
NODE_2712_length_1394_cov_29.602317	349	416	0	25	67	0.3731343
NODE_2712_length_1394_cov_29.602317	349	416	3	9	67	0.1343284
NODE_2712_length_1394_cov_29.602317	349	416	4	33	67	0.4925373
NODE_2712_length_1394_cov_29.602317	1117	1197	0	63	80	0.7875000
NODE_2712_length_1394_cov_29.602317	1117	1197	2	17	80	0.2125000
NODE_2712_length_1394_cov_29.602317	1170	1250	0	33	80	0.4125000
NODE_2712_length_1394_cov_29.602317	1170	1250	2	47	80	0.5875000
NODE_2713_length_1394_cov_6.291892	313	393	0	29	80	0.3625000
NODE_2713_length_1394_cov_6.291892	313	393	2	16	80	0.2000000
NODE_2713_length_1394_cov_6.291892	313	393	4	35	80	0.4375000
NODE_2713_length_1394_cov_6.291892	366	446	4	80	80	1.0000000
NODE_2716_length_1393_cov_14.635240	1286	1339	2	2	53	0.0377358
NODE_2716_length_1393_cov_14.635240	1286	1339	4	1	53	0.0188679
NODE_2716_length_1393_cov_14.635240	1286	1339	6	1	53	0.0188679
NODE_2716_length_1393_cov_14.635240	1286	1339	8	49	53	0.9245283
NODE_2717_length_1393_cov_12.032457	737	817	0	22	80	0.2750000
NODE_2717_length_1393_cov_12.032457	737	817	4	58	80	0.7250000
NODE_2717_length_1393_cov_12.032457	790	870	0	16	80	0.2000000
NODE_2717_length_1393_cov_12.032457	790	870	3	2	80	0.0250000
NODE_2717_length_1393_cov_12.032457	790	870	4	62	80	0.7750000
NODE_2720_length_1392_cov_5.898685	270	350	0	40	80	0.5000000
NODE_2720_length_1392_cov_5.898685	270	350	2	40	80	0.5000000
NODE_2720_length_1392_cov_5.898685	323	399	2	76	76	1.0000000
NODE_2723_length_1391_cov_35.921827	415	495	0	26	80	0.3250000
NODE_2723_length_1391_cov_35.921827	415	495	2	54	80	0.6750000
NODE_2723_length_1391_cov_35.921827	468	548	0	79	80	0.9875000
NODE_2723_length_1391_cov_35.921827	468	548	2	1	80	0.0125000
NODE_2723_length_1391_cov_35.921827	544	624	0	80	80	1.0000000
NODE_2723_length_1391_cov_35.921827	597	677	0	80	80	1.0000000
NODE_2729_length_1390_cov_16.326878	550	630	0	25	80	0.3125000
NODE_2729_length_1390_cov_16.326878	550	630	4	55	80	0.6875000
NODE_2729_length_1390_cov_16.326878	603	683	0	1	80	0.0125000
NODE_2729_length_1390_cov_16.326878	603	683	4	79	80	0.9875000
NODE_2731_length_1389_cov_29.772093	780	860	0	80	80	1.0000000
NODE_2731_length_1389_cov_29.772093	833	913	0	80	80	1.0000000
NODE_2732_length_1389_cov_12.858140	821	901	0	17	80	0.2125000
NODE_2732_length_1389_cov_12.858140	821	901	2	46	80	0.5750000
NODE_2732_length_1389_cov_12.858140	821	901	4	17	80	0.2125000
NODE_2732_length_1389_cov_12.858140	874	954	0	70	80	0.8750000
NODE_2732_length_1389_cov_12.858140	874	954	2	10	80	0.1250000
NODE_2735_length_1388_cov_14.641583	529	610	0	81	81	1.0000000
NODE_2735_length_1388_cov_14.641583	583	660	0	77	77	1.0000000
NODE_2736_length_1388_cov_5.168348	427	499	26	1	72	0.0138889
NODE_2736_length_1388_cov_5.168348	427	499	27	2	72	0.0277778
NODE_2736_length_1388_cov_5.168348	427	499	28	21	72	0.2916667
NODE_2736_length_1388_cov_5.168348	427	499	29	4	72	0.0555556
NODE_2736_length_1388_cov_5.168348	427	499	30	19	72	0.2638889
NODE_2736_length_1388_cov_5.168348	427	499	31	10	72	0.1388889
NODE_2736_length_1388_cov_5.168348	427	499	32	6	72	0.0833333
NODE_2736_length_1388_cov_5.168348	427	499	33	8	72	0.1111111
NODE_2736_length_1388_cov_5.168348	427	499	35	1	72	0.0138889
NODE_2742_length_1386_cov_55.384615	559	639	0	15	80	0.1875000
NODE_2742_length_1386_cov_55.384615	559	639	4	19	80	0.2375000
NODE_2742_length_1386_cov_55.384615	559	639	5	46	80	0.5750000
NODE_2742_length_1386_cov_55.384615	612	692	1	16	80	0.2000000
NODE_2742_length_1386_cov_55.384615	612	692	2	33	80	0.4125000
NODE_2742_length_1386_cov_55.384615	612	692	5	31	80	0.3875000
NODE_2742_length_1386_cov_55.384615	688	768	0	70	80	0.8750000
NODE_2742_length_1386_cov_55.384615	688	768	2	10	80	0.1250000
NODE_2742_length_1386_cov_55.384615	741	821	0	80	80	1.0000000
NODE_2744_length_1386_cov_13.181041	549	629	0	80	80	1.0000000
NODE_2744_length_1386_cov_13.181041	602	682	0	80	80	1.0000000
NODE_2748_length_1385_cov_41.636081	968	1048	0	16	80	0.2000000
NODE_2748_length_1385_cov_41.636081	968	1048	2	1	80	0.0125000
NODE_2748_length_1385_cov_41.636081	968	1048	4	63	80	0.7875000
NODE_2748_length_1385_cov_41.636081	1021	1101	4	80	80	1.0000000
NODE_2749_length_1385_cov_38.877138	707	787	0	7	80	0.0875000
NODE_2749_length_1385_cov_38.877138	707	787	6	14	80	0.1750000
NODE_2749_length_1385_cov_38.877138	707	787	8	9	80	0.1125000
NODE_2749_length_1385_cov_38.877138	707	787	13	50	80	0.6250000
NODE_2749_length_1385_cov_38.877138	760	840	11	1	80	0.0125000
NODE_2749_length_1385_cov_38.877138	760	840	13	37	80	0.4625000
NODE_2749_length_1385_cov_38.877138	760	840	15	22	80	0.2750000
NODE_2749_length_1385_cov_38.877138	760	840	16	20	80	0.2500000
NODE_2749_length_1385_cov_38.877138	836	916	4	5	80	0.0625000
NODE_2749_length_1385_cov_38.877138	836	916	8	24	80	0.3000000
NODE_2749_length_1385_cov_38.877138	836	916	14	23	80	0.2875000
NODE_2749_length_1385_cov_38.877138	836	916	16	27	80	0.3375000
NODE_2749_length_1385_cov_38.877138	836	916	17	1	80	0.0125000
NODE_2749_length_1385_cov_38.877138	889	969	2	23	80	0.2875000
NODE_2749_length_1385_cov_38.877138	889	969	4	35	80	0.4375000
NODE_2749_length_1385_cov_38.877138	889	969	8	22	80	0.2750000
NODE_2751_length_1385_cov_4.608865	844	904	0	60	60	1.0000000
NODE_2758_length_1384_cov_10.574319	865	922	0	57	57	1.0000000
NODE_2758_length_1384_cov_10.574319	933	1013	0	25	80	0.3125000
NODE_2758_length_1384_cov_10.574319	933	1013	2	55	80	0.6875000
NODE_2758_length_1384_cov_10.574319	986	1066	2	49	80	0.6125000
NODE_2758_length_1384_cov_10.574319	986	1066	4	31	80	0.3875000
NODE_2759_length_1383_cov_10.710280	414	493	5	38	79	0.4810127
NODE_2759_length_1383_cov_10.710280	414	493	6	41	79	0.5189874
NODE_2759_length_1383_cov_10.710280	466	546	0	36	80	0.4500000
NODE_2759_length_1383_cov_10.710280	466	546	4	1	80	0.0125000
NODE_2759_length_1383_cov_10.710280	466	546	5	43	80	0.5375000
NODE_2763_length_1382_cov_12.521434	837	917	0	80	80	1.0000000
NODE_2763_length_1382_cov_12.521434	890	970	0	80	80	1.0000000
NODE_2764_length_1382_cov_5.074045	1028	1108	0	17	80	0.2125000
NODE_2764_length_1382_cov_5.074045	1028	1108	6	63	80	0.7875000
NODE_2764_length_1382_cov_5.074045	1081	1161	6	36	80	0.4500000
NODE_2764_length_1382_cov_5.074045	1081	1161	8	44	80	0.5500000
NODE_2771_length_1381_cov_7.796412	307	387	0	80	80	1.0000000
NODE_2771_length_1381_cov_7.796412	360	440	0	80	80	1.0000000
NODE_2775_length_1380_cov_12.804059	835	915	0	18	80	0.2250000
NODE_2775_length_1380_cov_12.804059	835	915	2	10	80	0.1250000
NODE_2775_length_1380_cov_12.804059	835	915	4	52	80	0.6500000
NODE_2775_length_1380_cov_12.804059	888	968	0	17	80	0.2125000
NODE_2775_length_1380_cov_12.804059	888	968	2	63	80	0.7875000
NODE_2782_length_1378_cov_25.362002	368	448	0	65	80	0.8125000
NODE_2782_length_1378_cov_25.362002	368	448	1	15	80	0.1875000
NODE_2782_length_1378_cov_25.362002	421	501	0	80	80	1.0000000
NODE_2782_length_1378_cov_25.362002	497	577	0	80	80	1.0000000
NODE_2782_length_1378_cov_25.362002	550	630	0	80	80	1.0000000
NODE_2783_length_1378_cov_20.508210	318	338	4	2	20	0.1000000
NODE_2783_length_1378_cov_20.508210	318	338	6	6	20	0.3000000
NODE_2783_length_1378_cov_20.508210	318	338	8	12	20	0.6000000
NODE_2783_length_1378_cov_20.508210	318	391	4	2	73	0.0273973
NODE_2783_length_1378_cov_20.508210	318	391	6	6	73	0.0821918
NODE_2783_length_1378_cov_20.508210	318	391	8	21	73	0.2876712
NODE_2783_length_1378_cov_20.508210	318	391	12	13	73	0.1780822
NODE_2783_length_1378_cov_20.508210	318	391	14	3	73	0.0410959
NODE_2783_length_1378_cov_20.508210	318	391	16	3	73	0.0410959
NODE_2783_length_1378_cov_20.508210	318	391	18	6	73	0.0821918
NODE_2783_length_1378_cov_20.508210	318	391	20	3	73	0.0410959
NODE_2783_length_1378_cov_20.508210	318	391	22	9	73	0.1232877
NODE_2783_length_1378_cov_20.508210	318	391	24	5	73	0.0684932
NODE_2783_length_1378_cov_20.508210	318	391	26	2	73	0.0273973
NODE_2785_length_1377_cov_103.832551	1259	1299	42	4	40	0.1000000
NODE_2785_length_1377_cov_103.832551	1259	1299	44	4	40	0.1000000
NODE_2785_length_1377_cov_103.832551	1259	1299	46	5	40	0.1250000
NODE_2785_length_1377_cov_103.832551	1259	1299	50	1	40	0.0250000
NODE_2785_length_1377_cov_103.832551	1259	1299	52	26	40	0.6500000
NODE_2788_length_1376_cov_7.967110	904	984	0	17	80	0.2125000
NODE_2788_length_1376_cov_7.967110	904	984	4	63	80	0.7875000
NODE_2788_length_1376_cov_7.967110	957	1037	0	70	80	0.8750000
NODE_2788_length_1376_cov_7.967110	957	1037	4	10	80	0.1250000
NODE_2798_length_1373_cov_52.691523	524	606	0	50	82	0.6097561
NODE_2798_length_1373_cov_52.691523	524	606	2	32	82	0.3902439
NODE_2798_length_1373_cov_52.691523	579	659	2	80	80	1.0000000
NODE_2799_length_1373_cov_20.880691	987	1067	2	4	80	0.0500000
NODE_2799_length_1373_cov_20.880691	987	1067	4	76	80	0.9500000
NODE_2799_length_1373_cov_20.880691	1116	1195	6	17	79	0.2151899
NODE_2799_length_1373_cov_20.880691	1116	1195	8	17	79	0.2151899
NODE_2799_length_1373_cov_20.880691	1116	1195	10	6	79	0.0759494
NODE_2799_length_1373_cov_20.880691	1116	1195	12	5	79	0.0632911
NODE_2799_length_1373_cov_20.880691	1116	1195	14	31	79	0.3924051
NODE_2799_length_1373_cov_20.880691	1116	1195	16	3	79	0.0379747
NODE_2799_length_1373_cov_20.880691	1168	1248	2	7	80	0.0875000
NODE_2799_length_1373_cov_20.880691	1168	1248	4	6	80	0.0750000
NODE_2799_length_1373_cov_20.880691	1168	1248	9	1	80	0.0125000
NODE_2799_length_1373_cov_20.880691	1168	1248	10	7	80	0.0875000
NODE_2799_length_1373_cov_20.880691	1168	1248	12	1	80	0.0125000
NODE_2799_length_1373_cov_20.880691	1168	1248	14	55	80	0.6875000
NODE_2799_length_1373_cov_20.880691	1168	1248	16	3	80	0.0375000
NODE_2800_length_1373_cov_12.694662	94	167	10	9	73	0.1232877
NODE_2800_length_1373_cov_12.694662	94	167	12	13	73	0.1780822
NODE_2800_length_1373_cov_12.694662	94	167	14	1	73	0.0136986
NODE_2800_length_1373_cov_12.694662	94	167	16	6	73	0.0821918
NODE_2800_length_1373_cov_12.694662	94	167	17	1	73	0.0136986
NODE_2800_length_1373_cov_12.694662	94	167	18	4	73	0.0547945
NODE_2800_length_1373_cov_12.694662	94	167	19	4	73	0.0547945
NODE_2800_length_1373_cov_12.694662	94	167	21	3	73	0.0410959
NODE_2800_length_1373_cov_12.694662	94	167	22	2	73	0.0273973
NODE_2800_length_1373_cov_12.694662	94	167	24	4	73	0.0547945
NODE_2800_length_1373_cov_12.694662	94	167	37	1	73	0.0136986
NODE_2800_length_1373_cov_12.694662	94	167	39	2	73	0.0273973
NODE_2800_length_1373_cov_12.694662	94	167	41	1	73	0.0136986
NODE_2800_length_1373_cov_12.694662	94	167	43	4	73	0.0547945
NODE_2800_length_1373_cov_12.694662	94	167	47	3	73	0.0410959
NODE_2800_length_1373_cov_12.694662	94	167	48	5	73	0.0684932
NODE_2800_length_1373_cov_12.694662	94	167	49	1	73	0.0136986
NODE_2800_length_1373_cov_12.694662	94	167	52	1	73	0.0136986
NODE_2800_length_1373_cov_12.694662	94	167	55	1	73	0.0136986
NODE_2800_length_1373_cov_12.694662	94	167	57	2	73	0.0273973
NODE_2800_length_1373_cov_12.694662	94	167	59	2	73	0.0273973
NODE_2800_length_1373_cov_12.694662	94	167	61	1	73	0.0136986
NODE_2800_length_1373_cov_12.694662	94	167	71	2	73	0.0273973
NODE_2800_length_1373_cov_12.694662	140	224	22	1	84	0.0119048
NODE_2800_length_1373_cov_12.694662	140	224	37	1	84	0.0119048
NODE_2800_length_1373_cov_12.694662	140	224	39	2	84	0.0238095
NODE_2800_length_1373_cov_12.694662	140	224	41	1	84	0.0119048
NODE_2800_length_1373_cov_12.694662	140	224	43	4	84	0.0476190
NODE_2800_length_1373_cov_12.694662	140	224	47	3	84	0.0357143
NODE_2800_length_1373_cov_12.694662	140	224	48	5	84	0.0595238
NODE_2800_length_1373_cov_12.694662	140	224	49	1	84	0.0119048
NODE_2800_length_1373_cov_12.694662	140	224	52	1	84	0.0119048
NODE_2800_length_1373_cov_12.694662	140	224	55	1	84	0.0119048
NODE_2800_length_1373_cov_12.694662	140	224	57	2	84	0.0238095
NODE_2800_length_1373_cov_12.694662	140	224	59	2	84	0.0238095
NODE_2800_length_1373_cov_12.694662	140	224	61	1	84	0.0119048
NODE_2800_length_1373_cov_12.694662	140	224	71	4	84	0.0476190
NODE_2800_length_1373_cov_12.694662	140	224	73	1	84	0.0119048
NODE_2800_length_1373_cov_12.694662	140	224	75	2	84	0.0238095
NODE_2800_length_1373_cov_12.694662	140	224	76	6	84	0.0714286
NODE_2800_length_1373_cov_12.694662	140	224	77	2	84	0.0238095
NODE_2800_length_1373_cov_12.694662	140	224	79	10	84	0.1190476
NODE_2800_length_1373_cov_12.694662	140	224	80	1	84	0.0119048
NODE_2800_length_1373_cov_12.694662	140	224	81	4	84	0.0476190
NODE_2800_length_1373_cov_12.694662	140	224	83	2	84	0.0238095
NODE_2800_length_1373_cov_12.694662	140	224	85	9	84	0.1071429
NODE_2800_length_1373_cov_12.694662	140	224	87	9	84	0.1071429
NODE_2800_length_1373_cov_12.694662	140	224	89	8	84	0.0952381
NODE_2800_length_1373_cov_12.694662	140	224	91	1	84	0.0119048
NODE_2800_length_1373_cov_12.694662	1214	1286	4	13	72	0.1805556
NODE_2800_length_1373_cov_12.694662	1214	1286	6	2	72	0.0277778
NODE_2800_length_1373_cov_12.694662	1214	1286	8	2	72	0.0277778
NODE_2800_length_1373_cov_12.694662	1214	1286	12	11	72	0.1527778
NODE_2800_length_1373_cov_12.694662	1214	1286	14	44	72	0.6111111
NODE_2800_length_1373_cov_12.694662	1267	1339	0	2	72	0.0277778
NODE_2800_length_1373_cov_12.694662	1267	1339	2	14	72	0.1944444
NODE_2800_length_1373_cov_12.694662	1267	1339	4	50	72	0.6944444
NODE_2800_length_1373_cov_12.694662	1267	1339	6	2	72	0.0277778
NODE_2800_length_1373_cov_12.694662	1267	1339	8	2	72	0.0277778
NODE_2800_length_1373_cov_12.694662	1267	1339	14	2	72	0.0277778
NODE_2801_length_1372_cov_25.408484	665	745	2	59	80	0.7375000
NODE_2801_length_1372_cov_25.408484	665	745	4	21	80	0.2625000
NODE_2801_length_1372_cov_25.408484	718	798	0	20	80	0.2500000
NODE_2801_length_1372_cov_25.408484	718	798	2	60	80	0.7500000
NODE_2802_length_1372_cov_17.123331	647	727	0	80	80	1.0000000
NODE_2802_length_1372_cov_17.123331	700	780	0	80	80	1.0000000
NODE_2802_length_1372_cov_17.123331	776	856	0	80	80	1.0000000
NODE_2802_length_1372_cov_17.123331	829	909	0	35	80	0.4375000
NODE_2802_length_1372_cov_17.123331	829	909	2	45	80	0.5625000
NODE_2803_length_1372_cov_14.418696	211	291	0	9	80	0.1125000
NODE_2803_length_1372_cov_14.418696	211	291	4	71	80	0.8875000
NODE_2803_length_1372_cov_14.418696	264	344	0	32	80	0.4000000
NODE_2803_length_1372_cov_14.418696	264	344	4	48	80	0.6000000
NODE_2806_length_1371_cov_39.366352	715	795	5	7	80	0.0875000
NODE_2806_length_1371_cov_39.366352	715	795	6	2	80	0.0250000
NODE_2806_length_1371_cov_39.366352	715	795	7	1	80	0.0125000
NODE_2806_length_1371_cov_39.366352	715	795	15	5	80	0.0625000
NODE_2806_length_1371_cov_39.366352	715	795	22	1	80	0.0125000
NODE_2806_length_1371_cov_39.366352	715	795	23	8	80	0.1000000
NODE_2806_length_1371_cov_39.366352	715	795	25	5	80	0.0625000
NODE_2806_length_1371_cov_39.366352	715	795	28	7	80	0.0875000
NODE_2806_length_1371_cov_39.366352	715	795	29	30	80	0.3750000
NODE_2806_length_1371_cov_39.366352	715	795	30	2	80	0.0250000
NODE_2806_length_1371_cov_39.366352	715	795	35	12	80	0.1500000
NODE_2806_length_1371_cov_39.366352	768	848	28	7	80	0.0875000
NODE_2806_length_1371_cov_39.366352	768	848	29	6	80	0.0750000
NODE_2806_length_1371_cov_39.366352	768	848	30	2	80	0.0250000
NODE_2806_length_1371_cov_39.366352	768	848	34	10	80	0.1250000
NODE_2806_length_1371_cov_39.366352	768	848	35	14	80	0.1750000
NODE_2806_length_1371_cov_39.366352	768	848	37	3	80	0.0375000
NODE_2806_length_1371_cov_39.366352	768	848	38	17	80	0.2125000
NODE_2806_length_1371_cov_39.366352	768	848	40	21	80	0.2625000
NODE_2807_length_1371_cov_36.961478	371	455	0	39	84	0.4642857
NODE_2807_length_1371_cov_36.961478	371	455	6	45	84	0.5357143
NODE_2807_length_1371_cov_36.961478	424	508	0	12	84	0.1428571
NODE_2807_length_1371_cov_36.961478	424	508	6	72	84	0.8571429
NODE_2807_length_1371_cov_36.961478	504	584	0	80	80	1.0000000
NODE_2807_length_1371_cov_36.961478	557	637	0	80	80	1.0000000
NODE_2808_length_1371_cov_16.944182	459	539	0	80	80	1.0000000
NODE_2808_length_1371_cov_16.944182	512	592	0	80	80	1.0000000
NODE_2808_length_1371_cov_16.944182	588	668	0	80	80	1.0000000
NODE_2808_length_1371_cov_16.944182	641	721	0	80	80	1.0000000
NODE_2812_length_1370_cov_11.627065	502	582	0	79	80	0.9875000
NODE_2812_length_1370_cov_11.627065	502	582	2	1	80	0.0125000
NODE_2812_length_1370_cov_11.627065	555	635	0	80	80	1.0000000
NODE_2812_length_1370_cov_11.627065	631	711	0	80	80	1.0000000
NODE_2812_length_1370_cov_11.627065	684	764	0	80	80	1.0000000
NODE_2813_length_1369_cov_27.937795	597	677	0	48	80	0.6000000
NODE_2813_length_1369_cov_27.937795	597	677	2	21	80	0.2625000
NODE_2813_length_1369_cov_27.937795	597	677	6	11	80	0.1375000
NODE_2813_length_1369_cov_27.937795	650	730	2	16	80	0.2000000
NODE_2813_length_1369_cov_27.937795	650	730	4	23	80	0.2875000
NODE_2813_length_1369_cov_27.937795	650	730	6	41	80	0.5125000
NODE_2820_length_1368_cov_35.148148	546	626	0	53	80	0.6625000
NODE_2820_length_1368_cov_35.148148	546	626	2	12	80	0.1500000
NODE_2820_length_1368_cov_35.148148	546	626	6	15	80	0.1875000
NODE_2820_length_1368_cov_35.148148	599	679	2	12	80	0.1500000
NODE_2820_length_1368_cov_35.148148	599	679	4	6	80	0.0750000
NODE_2820_length_1368_cov_35.148148	599	679	6	62	80	0.7750000
NODE_2821_length_1368_cov_27.847912	486	559	0	28	73	0.3835616
NODE_2821_length_1368_cov_27.847912	486	559	2	45	73	0.6164383
NODE_2821_length_1368_cov_27.847912	532	612	0	80	80	1.0000000
NODE_2821_length_1368_cov_27.847912	608	688	0	80	80	1.0000000
NODE_2821_length_1368_cov_27.847912	661	741	0	80	80	1.0000000
NODE_2822_length_1368_cov_26.832151	458	538	0	80	80	1.0000000
NODE_2822_length_1368_cov_26.832151	511	591	0	80	80	1.0000000
NODE_2822_length_1368_cov_26.832151	587	667	0	80	80	1.0000000
NODE_2822_length_1368_cov_26.832151	640	720	0	80	80	1.0000000
NODE_2823_length_1368_cov_18.205674	603	683	0	26	80	0.3250000
NODE_2823_length_1368_cov_18.205674	603	683	2	54	80	0.6750000
NODE_2823_length_1368_cov_18.205674	656	736	0	73	80	0.9125000
NODE_2823_length_1368_cov_18.205674	656	736	2	7	80	0.0875000
NODE_2826_length_1367_cov_576.769716	799	879	471	1	80	0.0125000
NODE_2826_length_1367_cov_576.769716	799	879	472	1	80	0.0125000
NODE_2826_length_1367_cov_576.769716	799	879	476	2	80	0.0250000
NODE_2826_length_1367_cov_576.769716	799	879	477	1	80	0.0125000
NODE_2826_length_1367_cov_576.769716	799	879	479	1	80	0.0125000
NODE_2826_length_1367_cov_576.769716	799	879	484	1	80	0.0125000
NODE_2826_length_1367_cov_576.769716	799	879	485	2	80	0.0250000
NODE_2826_length_1367_cov_576.769716	799	879	493	2	80	0.0250000
NODE_2826_length_1367_cov_576.769716	799	879	494	2	80	0.0250000
NODE_2826_length_1367_cov_576.769716	799	879	495	1	80	0.0125000
NODE_2826_length_1367_cov_576.769716	799	879	499	1	80	0.0125000
NODE_2826_length_1367_cov_576.769716	799	879	501	1	80	0.0125000
NODE_2826_length_1367_cov_576.769716	799	879	508	1	80	0.0125000
NODE_2826_length_1367_cov_576.769716	799	879	509	1	80	0.0125000
NODE_2826_length_1367_cov_576.769716	799	879	511	1	80	0.0125000
NODE_2826_length_1367_cov_576.769716	799	879	512	1	80	0.0125000
NODE_2826_length_1367_cov_576.769716	799	879	513	1	80	0.0125000
NODE_2826_length_1367_cov_576.769716	799	879	518	1	80	0.0125000
NODE_2826_length_1367_cov_576.769716	799	879	520	1	80	0.0125000
NODE_2826_length_1367_cov_576.769716	799	879	522	2	80	0.0250000
NODE_2826_length_1367_cov_576.769716	799	879	523	1	80	0.0125000
NODE_2826_length_1367_cov_576.769716	799	879	524	2	80	0.0250000
NODE_2826_length_1367_cov_576.769716	799	879	525	2	80	0.0250000
NODE_2826_length_1367_cov_576.769716	799	879	529	1	80	0.0125000
NODE_2826_length_1367_cov_576.769716	799	879	530	1	80	0.0125000
NODE_2826_length_1367_cov_576.769716	799	879	531	1	80	0.0125000
NODE_2826_length_1367_cov_576.769716	799	879	533	2	80	0.0250000
NODE_2826_length_1367_cov_576.769716	799	879	537	2	80	0.0250000
NODE_2826_length_1367_cov_576.769716	799	879	538	1	80	0.0125000
NODE_2826_length_1367_cov_576.769716	799	879	545	1	80	0.0125000
NODE_2826_length_1367_cov_576.769716	799	879	546	1	80	0.0125000
NODE_2826_length_1367_cov_576.769716	799	879	586	1	80	0.0125000
NODE_2826_length_1367_cov_576.769716	799	879	591	1	80	0.0125000
NODE_2826_length_1367_cov_576.769716	799	879	603	1	80	0.0125000
NODE_2826_length_1367_cov_576.769716	799	879	756	1	80	0.0125000
NODE_2826_length_1367_cov_576.769716	799	879	757	1	80	0.0125000
NODE_2826_length_1367_cov_576.769716	799	879	759	1	80	0.0125000
NODE_2826_length_1367_cov_576.769716	799	879	760	1	80	0.0125000
NODE_2826_length_1367_cov_576.769716	799	879	761	2	80	0.0250000
NODE_2826_length_1367_cov_576.769716	799	879	762	1	80	0.0125000
NODE_2826_length_1367_cov_576.769716	799	879	763	1	80	0.0125000
NODE_2826_length_1367_cov_576.769716	799	879	779	1	80	0.0125000
NODE_2826_length_1367_cov_576.769716	799	879	788	1	80	0.0125000
NODE_2826_length_1367_cov_576.769716	799	879	792	1	80	0.0125000
NODE_2826_length_1367_cov_576.769716	799	879	822	1	80	0.0125000
NODE_2826_length_1367_cov_576.769716	799	879	844	1	80	0.0125000
NODE_2826_length_1367_cov_576.769716	799	879	864	1	80	0.0125000
NODE_2826_length_1367_cov_576.769716	799	879	892	1	80	0.0125000
NODE_2826_length_1367_cov_576.769716	799	879	907	1	80	0.0125000
NODE_2826_length_1367_cov_576.769716	799	879	936	1	80	0.0125000
NODE_2826_length_1367_cov_576.769716	799	879	967	1	80	0.0125000
NODE_2826_length_1367_cov_576.769716	799	879	1077	1	80	0.0125000
NODE_2826_length_1367_cov_576.769716	799	879	1094	1	80	0.0125000
NODE_2826_length_1367_cov_576.769716	799	879	1111	1	80	0.0125000
NODE_2826_length_1367_cov_576.769716	799	879	1113	1	80	0.0125000
NODE_2826_length_1367_cov_576.769716	799	879	1179	1	80	0.0125000
NODE_2826_length_1367_cov_576.769716	799	879	1180	1	80	0.0125000
NODE_2826_length_1367_cov_576.769716	799	879	1213	1	80	0.0125000
NODE_2826_length_1367_cov_576.769716	799	879	1301	1	80	0.0125000
NODE_2826_length_1367_cov_576.769716	799	879	1310	1	80	0.0125000
NODE_2826_length_1367_cov_576.769716	799	879	1397	1	80	0.0125000
NODE_2826_length_1367_cov_576.769716	799	879	1428	1	80	0.0125000
NODE_2826_length_1367_cov_576.769716	799	879	1430	1	80	0.0125000
NODE_2826_length_1367_cov_576.769716	799	879	1439	1	80	0.0125000
NODE_2826_length_1367_cov_576.769716	799	879	1528	1	80	0.0125000
NODE_2826_length_1367_cov_576.769716	799	879	1585	1	80	0.0125000
NODE_2826_length_1367_cov_576.769716	799	879	1597	1	80	0.0125000
NODE_2826_length_1367_cov_576.769716	799	879	1616	3	80	0.0375000
NODE_2826_length_1367_cov_576.769716	852	932	792	1	80	0.0125000
NODE_2826_length_1367_cov_576.769716	852	932	822	1	80	0.0125000
NODE_2826_length_1367_cov_576.769716	852	932	844	1	80	0.0125000
NODE_2826_length_1367_cov_576.769716	852	932	864	1	80	0.0125000
NODE_2826_length_1367_cov_576.769716	852	932	892	1	80	0.0125000
NODE_2826_length_1367_cov_576.769716	852	932	907	1	80	0.0125000
NODE_2826_length_1367_cov_576.769716	852	932	936	1	80	0.0125000
NODE_2826_length_1367_cov_576.769716	852	932	967	1	80	0.0125000
NODE_2826_length_1367_cov_576.769716	852	932	1077	1	80	0.0125000
NODE_2826_length_1367_cov_576.769716	852	932	1094	1	80	0.0125000
NODE_2826_length_1367_cov_576.769716	852	932	1111	1	80	0.0125000
NODE_2826_length_1367_cov_576.769716	852	932	1113	1	80	0.0125000
NODE_2826_length_1367_cov_576.769716	852	932	1179	1	80	0.0125000
NODE_2826_length_1367_cov_576.769716	852	932	1180	1	80	0.0125000
NODE_2826_length_1367_cov_576.769716	852	932	1213	1	80	0.0125000
NODE_2826_length_1367_cov_576.769716	852	932	1301	1	80	0.0125000
NODE_2826_length_1367_cov_576.769716	852	932	1310	1	80	0.0125000
NODE_2826_length_1367_cov_576.769716	852	932	1397	1	80	0.0125000
NODE_2826_length_1367_cov_576.769716	852	932	1428	1	80	0.0125000
NODE_2826_length_1367_cov_576.769716	852	932	1430	1	80	0.0125000
NODE_2826_length_1367_cov_576.769716	852	932	1439	1	80	0.0125000
NODE_2826_length_1367_cov_576.769716	852	932	1528	1	80	0.0125000
NODE_2826_length_1367_cov_576.769716	852	932	1585	1	80	0.0125000
NODE_2826_length_1367_cov_576.769716	852	932	1597	1	80	0.0125000
NODE_2826_length_1367_cov_576.769716	852	932	1616	3	80	0.0375000
NODE_2826_length_1367_cov_576.769716	852	932	1618	1	80	0.0125000
NODE_2826_length_1367_cov_576.769716	852	932	1619	1	80	0.0125000
NODE_2826_length_1367_cov_576.769716	852	932	1622	1	80	0.0125000
NODE_2826_length_1367_cov_576.769716	852	932	1659	1	80	0.0125000
NODE_2826_length_1367_cov_576.769716	852	932	1669	1	80	0.0125000
NODE_2826_length_1367_cov_576.769716	852	932	1670	1	80	0.0125000
NODE_2826_length_1367_cov_576.769716	852	932	1694	1	80	0.0125000
NODE_2826_length_1367_cov_576.769716	852	932	1697	1	80	0.0125000
NODE_2826_length_1367_cov_576.769716	852	932	1704	1	80	0.0125000
NODE_2826_length_1367_cov_576.769716	852	932	1727	1	80	0.0125000
NODE_2826_length_1367_cov_576.769716	852	932	1746	1	80	0.0125000
NODE_2826_length_1367_cov_576.769716	852	932	1778	1	80	0.0125000
NODE_2826_length_1367_cov_576.769716	852	932	1800	1	80	0.0125000
NODE_2826_length_1367_cov_576.769716	852	932	1804	1	80	0.0125000
NODE_2826_length_1367_cov_576.769716	852	932	1806	1	80	0.0125000
NODE_2826_length_1367_cov_576.769716	852	932	1816	1	80	0.0125000
NODE_2826_length_1367_cov_576.769716	852	932	1819	1	80	0.0125000
NODE_2826_length_1367_cov_576.769716	852	932	1821	1	80	0.0125000
NODE_2826_length_1367_cov_576.769716	852	932	1823	2	80	0.0250000
NODE_2826_length_1367_cov_576.769716	852	932	1824	1	80	0.0125000
NODE_2826_length_1367_cov_576.769716	852	932	1825	1	80	0.0125000
NODE_2826_length_1367_cov_576.769716	852	932	1826	1	80	0.0125000
NODE_2826_length_1367_cov_576.769716	852	932	1830	3	80	0.0375000
NODE_2826_length_1367_cov_576.769716	852	932	1832	2	80	0.0250000
NODE_2826_length_1367_cov_576.769716	852	932	1834	1	80	0.0125000
NODE_2826_length_1367_cov_576.769716	852	932	1835	1	80	0.0125000
NODE_2826_length_1367_cov_576.769716	852	932	1836	1	80	0.0125000
NODE_2826_length_1367_cov_576.769716	852	932	1837	2	80	0.0250000
NODE_2826_length_1367_cov_576.769716	852	932	1838	1	80	0.0125000
NODE_2826_length_1367_cov_576.769716	852	932	1840	1	80	0.0125000
NODE_2826_length_1367_cov_576.769716	852	932	1841	1	80	0.0125000
NODE_2826_length_1367_cov_576.769716	852	932	1842	2	80	0.0250000
NODE_2826_length_1367_cov_576.769716	852	932	1844	2	80	0.0250000
NODE_2826_length_1367_cov_576.769716	852	932	1845	2	80	0.0250000
NODE_2826_length_1367_cov_576.769716	852	932	1846	1	80	0.0125000
NODE_2826_length_1367_cov_576.769716	852	932	1847	1	80	0.0125000
NODE_2826_length_1367_cov_576.769716	852	932	1848	2	80	0.0250000
NODE_2826_length_1367_cov_576.769716	852	932	1851	4	80	0.0500000
NODE_2826_length_1367_cov_576.769716	852	932	1852	2	80	0.0250000
NODE_2826_length_1367_cov_576.769716	852	932	1855	1	80	0.0125000
NODE_2826_length_1367_cov_576.769716	900	980	1211	1	80	0.0125000
NODE_2826_length_1367_cov_576.769716	900	980	1244	1	80	0.0125000
NODE_2826_length_1367_cov_576.769716	900	980	1449	1	80	0.0125000
NODE_2826_length_1367_cov_576.769716	900	980	1467	1	80	0.0125000
NODE_2826_length_1367_cov_576.769716	900	980	1488	1	80	0.0125000
NODE_2826_length_1367_cov_576.769716	900	980	1515	1	80	0.0125000
NODE_2826_length_1367_cov_576.769716	900	980	1557	1	80	0.0125000
NODE_2826_length_1367_cov_576.769716	900	980	1566	1	80	0.0125000
NODE_2826_length_1367_cov_576.769716	900	980	1581	1	80	0.0125000
NODE_2826_length_1367_cov_576.769716	900	980	1612	1	80	0.0125000
NODE_2826_length_1367_cov_576.769716	900	980	1622	2	80	0.0250000
NODE_2826_length_1367_cov_576.769716	900	980	1629	1	80	0.0125000
NODE_2826_length_1367_cov_576.769716	900	980	1635	2	80	0.0250000
NODE_2826_length_1367_cov_576.769716	900	980	1648	1	80	0.0125000
NODE_2826_length_1367_cov_576.769716	900	980	1655	1	80	0.0125000
NODE_2826_length_1367_cov_576.769716	900	980	1658	1	80	0.0125000
NODE_2826_length_1367_cov_576.769716	900	980	1660	1	80	0.0125000
NODE_2826_length_1367_cov_576.769716	900	980	1668	1	80	0.0125000
NODE_2826_length_1367_cov_576.769716	900	980	1674	1	80	0.0125000
NODE_2826_length_1367_cov_576.769716	900	980	1680	1	80	0.0125000
NODE_2826_length_1367_cov_576.769716	900	980	1683	1	80	0.0125000
NODE_2826_length_1367_cov_576.769716	900	980	1689	1	80	0.0125000
NODE_2826_length_1367_cov_576.769716	900	980	1699	1	80	0.0125000
NODE_2826_length_1367_cov_576.769716	900	980	1702	1	80	0.0125000
NODE_2826_length_1367_cov_576.769716	900	980	1715	1	80	0.0125000
NODE_2826_length_1367_cov_576.769716	900	980	1716	1	80	0.0125000
NODE_2826_length_1367_cov_576.769716	900	980	1723	1	80	0.0125000
NODE_2826_length_1367_cov_576.769716	900	980	1724	1	80	0.0125000
NODE_2826_length_1367_cov_576.769716	900	980	1725	1	80	0.0125000
NODE_2826_length_1367_cov_576.769716	900	980	1726	3	80	0.0375000
NODE_2826_length_1367_cov_576.769716	900	980	1736	1	80	0.0125000
NODE_2826_length_1367_cov_576.769716	900	980	1741	1	80	0.0125000
NODE_2826_length_1367_cov_576.769716	900	980	1758	1	80	0.0125000
NODE_2826_length_1367_cov_576.769716	900	980	1763	2	80	0.0250000
NODE_2826_length_1367_cov_576.769716	900	980	1783	1	80	0.0125000
NODE_2826_length_1367_cov_576.769716	900	980	1786	2	80	0.0250000
NODE_2826_length_1367_cov_576.769716	900	980	1787	2	80	0.0250000
NODE_2826_length_1367_cov_576.769716	900	980	1791	1	80	0.0125000
NODE_2826_length_1367_cov_576.769716	900	980	1792	1	80	0.0125000
NODE_2826_length_1367_cov_576.769716	900	980	1796	1	80	0.0125000
NODE_2826_length_1367_cov_576.769716	900	980	1800	2	80	0.0250000
NODE_2826_length_1367_cov_576.769716	900	980	1804	1	80	0.0125000
NODE_2826_length_1367_cov_576.769716	900	980	1816	1	80	0.0125000
NODE_2826_length_1367_cov_576.769716	900	980	1819	1	80	0.0125000
NODE_2826_length_1367_cov_576.769716	900	980	1821	1	80	0.0125000
NODE_2826_length_1367_cov_576.769716	900	980	1823	2	80	0.0250000
NODE_2826_length_1367_cov_576.769716	900	980	1825	1	80	0.0125000
NODE_2826_length_1367_cov_576.769716	900	980	1826	1	80	0.0125000
NODE_2826_length_1367_cov_576.769716	900	980	1830	2	80	0.0250000
NODE_2826_length_1367_cov_576.769716	900	980	1832	2	80	0.0250000
NODE_2826_length_1367_cov_576.769716	900	980	1834	1	80	0.0125000
NODE_2826_length_1367_cov_576.769716	900	980	1835	1	80	0.0125000
NODE_2826_length_1367_cov_576.769716	900	980	1836	1	80	0.0125000
NODE_2826_length_1367_cov_576.769716	900	980	1837	2	80	0.0250000
NODE_2826_length_1367_cov_576.769716	900	980	1838	1	80	0.0125000
NODE_2826_length_1367_cov_576.769716	900	980	1840	1	80	0.0125000
NODE_2826_length_1367_cov_576.769716	900	980	1841	1	80	0.0125000
NODE_2826_length_1367_cov_576.769716	900	980	1842	2	80	0.0250000
NODE_2826_length_1367_cov_576.769716	900	980	1844	2	80	0.0250000
NODE_2826_length_1367_cov_576.769716	900	980	1845	2	80	0.0250000
NODE_2826_length_1367_cov_576.769716	900	980	1848	2	80	0.0250000
NODE_2826_length_1367_cov_576.769716	900	980	1851	2	80	0.0250000
NODE_2826_length_1367_cov_576.769716	900	980	1852	1	80	0.0125000
NODE_2826_length_1367_cov_576.769716	905	927	1819	1	22	0.0454545
NODE_2826_length_1367_cov_576.769716	905	927	1821	1	22	0.0454545
NODE_2826_length_1367_cov_576.769716	905	927	1823	1	22	0.0454545
NODE_2826_length_1367_cov_576.769716	905	927	1825	1	22	0.0454545
NODE_2826_length_1367_cov_576.769716	905	927	1826	1	22	0.0454545
NODE_2826_length_1367_cov_576.769716	905	927	1830	1	22	0.0454545
NODE_2826_length_1367_cov_576.769716	905	927	1832	2	22	0.0909091
NODE_2826_length_1367_cov_576.769716	905	927	1834	1	22	0.0454545
NODE_2826_length_1367_cov_576.769716	905	927	1835	1	22	0.0454545
NODE_2826_length_1367_cov_576.769716	905	927	1836	1	22	0.0454545
NODE_2826_length_1367_cov_576.769716	905	927	1837	2	22	0.0909091
NODE_2826_length_1367_cov_576.769716	905	927	1838	1	22	0.0454545
NODE_2826_length_1367_cov_576.769716	905	927	1840	1	22	0.0454545
NODE_2826_length_1367_cov_576.769716	905	927	1841	1	22	0.0454545
NODE_2826_length_1367_cov_576.769716	905	927	1842	2	22	0.0909091
NODE_2826_length_1367_cov_576.769716	905	927	1844	2	22	0.0909091
NODE_2826_length_1367_cov_576.769716	905	927	1845	2	22	0.0909091
NODE_2826_length_1367_cov_576.769716	1051	1131	42	3	80	0.0375000
NODE_2826_length_1367_cov_576.769716	1051	1131	43	4	80	0.0500000
NODE_2826_length_1367_cov_576.769716	1051	1131	47	1	80	0.0125000
NODE_2826_length_1367_cov_576.769716	1051	1131	49	5	80	0.0625000
NODE_2826_length_1367_cov_576.769716	1051	1131	51	6	80	0.0750000
NODE_2826_length_1367_cov_576.769716	1051	1131	53	2	80	0.0250000
NODE_2826_length_1367_cov_576.769716	1051	1131	54	2	80	0.0250000
NODE_2826_length_1367_cov_576.769716	1051	1131	58	2	80	0.0250000
NODE_2826_length_1367_cov_576.769716	1051	1131	61	2	80	0.0250000
NODE_2826_length_1367_cov_576.769716	1051	1131	65	1	80	0.0125000
NODE_2826_length_1367_cov_576.769716	1051	1131	69	2	80	0.0250000
NODE_2826_length_1367_cov_576.769716	1051	1131	73	1	80	0.0125000
NODE_2826_length_1367_cov_576.769716	1051	1131	79	4	80	0.0500000
NODE_2826_length_1367_cov_576.769716	1051	1131	80	2	80	0.0250000
NODE_2826_length_1367_cov_576.769716	1051	1131	82	3	80	0.0375000
NODE_2826_length_1367_cov_576.769716	1051	1131	84	2	80	0.0250000
NODE_2826_length_1367_cov_576.769716	1051	1131	96	1	80	0.0125000
NODE_2826_length_1367_cov_576.769716	1051	1131	100	1	80	0.0125000
NODE_2826_length_1367_cov_576.769716	1051	1131	105	7	80	0.0875000
NODE_2826_length_1367_cov_576.769716	1051	1131	106	1	80	0.0125000
NODE_2826_length_1367_cov_576.769716	1051	1131	107	4	80	0.0500000
NODE_2826_length_1367_cov_576.769716	1051	1131	108	3	80	0.0375000
NODE_2826_length_1367_cov_576.769716	1051	1131	109	3	80	0.0375000
NODE_2826_length_1367_cov_576.769716	1051	1131	110	1	80	0.0125000
NODE_2826_length_1367_cov_576.769716	1051	1131	111	4	80	0.0500000
NODE_2826_length_1367_cov_576.769716	1051	1131	112	2	80	0.0250000
NODE_2826_length_1367_cov_576.769716	1051	1131	113	2	80	0.0250000
NODE_2826_length_1367_cov_576.769716	1051	1131	114	1	80	0.0125000
NODE_2826_length_1367_cov_576.769716	1051	1131	115	2	80	0.0250000
NODE_2826_length_1367_cov_576.769716	1051	1131	116	1	80	0.0125000
NODE_2826_length_1367_cov_576.769716	1051	1131	117	1	80	0.0125000
NODE_2826_length_1367_cov_576.769716	1051	1131	118	2	80	0.0250000
NODE_2826_length_1367_cov_576.769716	1051	1131	119	1	80	0.0125000
NODE_2826_length_1367_cov_576.769716	1051	1131	125	1	80	0.0125000
NODE_2826_length_1367_cov_576.769716	1104	1184	105	3	80	0.0375000
NODE_2826_length_1367_cov_576.769716	1104	1184	106	1	80	0.0125000
NODE_2826_length_1367_cov_576.769716	1104	1184	107	1	80	0.0125000
NODE_2826_length_1367_cov_576.769716	1104	1184	108	3	80	0.0375000
NODE_2826_length_1367_cov_576.769716	1104	1184	109	1	80	0.0125000
NODE_2826_length_1367_cov_576.769716	1104	1184	110	1	80	0.0125000
NODE_2826_length_1367_cov_576.769716	1104	1184	111	4	80	0.0500000
NODE_2826_length_1367_cov_576.769716	1104	1184	112	2	80	0.0250000
NODE_2826_length_1367_cov_576.769716	1104	1184	113	2	80	0.0250000
NODE_2826_length_1367_cov_576.769716	1104	1184	114	1	80	0.0125000
NODE_2826_length_1367_cov_576.769716	1104	1184	115	2	80	0.0250000
NODE_2826_length_1367_cov_576.769716	1104	1184	116	1	80	0.0125000
NODE_2826_length_1367_cov_576.769716	1104	1184	117	1	80	0.0125000
NODE_2826_length_1367_cov_576.769716	1104	1184	118	2	80	0.0250000
NODE_2826_length_1367_cov_576.769716	1104	1184	119	1	80	0.0125000
NODE_2826_length_1367_cov_576.769716	1104	1184	125	1	80	0.0125000
NODE_2826_length_1367_cov_576.769716	1104	1184	127	1	80	0.0125000
NODE_2826_length_1367_cov_576.769716	1104	1184	131	1	80	0.0125000
NODE_2826_length_1367_cov_576.769716	1104	1184	133	3	80	0.0375000
NODE_2826_length_1367_cov_576.769716	1104	1184	136	1	80	0.0125000
NODE_2826_length_1367_cov_576.769716	1104	1184	140	1	80	0.0125000
NODE_2826_length_1367_cov_576.769716	1104	1184	142	1	80	0.0125000
NODE_2826_length_1367_cov_576.769716	1104	1184	145	1	80	0.0125000
NODE_2826_length_1367_cov_576.769716	1104	1184	148	1	80	0.0125000
NODE_2826_length_1367_cov_576.769716	1104	1184	152	3	80	0.0375000
NODE_2826_length_1367_cov_576.769716	1104	1184	154	1	80	0.0125000
NODE_2826_length_1367_cov_576.769716	1104	1184	158	1	80	0.0125000
NODE_2826_length_1367_cov_576.769716	1104	1184	162	1	80	0.0125000
NODE_2826_length_1367_cov_576.769716	1104	1184	174	2	80	0.0250000
NODE_2826_length_1367_cov_576.769716	1104	1184	178	2	80	0.0250000
NODE_2826_length_1367_cov_576.769716	1104	1184	179	1	80	0.0125000
NODE_2826_length_1367_cov_576.769716	1104	1184	180	1	80	0.0125000
NODE_2826_length_1367_cov_576.769716	1104	1184	184	1	80	0.0125000
NODE_2826_length_1367_cov_576.769716	1104	1184	186	1	80	0.0125000
NODE_2826_length_1367_cov_576.769716	1104	1184	188	2	80	0.0250000
NODE_2826_length_1367_cov_576.769716	1104	1184	192	1	80	0.0125000
NODE_2826_length_1367_cov_576.769716	1104	1184	194	3	80	0.0375000
NODE_2826_length_1367_cov_576.769716	1104	1184	196	2	80	0.0250000
NODE_2826_length_1367_cov_576.769716	1104	1184	203	1	80	0.0125000
NODE_2826_length_1367_cov_576.769716	1104	1184	205	1	80	0.0125000
NODE_2826_length_1367_cov_576.769716	1104	1184	209	2	80	0.0250000
NODE_2826_length_1367_cov_576.769716	1104	1184	219	1	80	0.0125000
NODE_2826_length_1367_cov_576.769716	1104	1184	221	1	80	0.0125000
NODE_2826_length_1367_cov_576.769716	1104	1184	227	1	80	0.0125000
NODE_2826_length_1367_cov_576.769716	1104	1184	243	1	80	0.0125000
NODE_2826_length_1367_cov_576.769716	1104	1184	246	2	80	0.0250000
NODE_2826_length_1367_cov_576.769716	1104	1184	247	1	80	0.0125000
NODE_2826_length_1367_cov_576.769716	1104	1184	250	1	80	0.0125000
NODE_2826_length_1367_cov_576.769716	1104	1184	256	1	80	0.0125000
NODE_2826_length_1367_cov_576.769716	1104	1184	260	1	80	0.0125000
NODE_2826_length_1367_cov_576.769716	1104	1184	266	1	80	0.0125000
NODE_2826_length_1367_cov_576.769716	1104	1184	268	2	80	0.0250000
NODE_2826_length_1367_cov_576.769716	1104	1184	269	1	80	0.0125000
NODE_2826_length_1367_cov_576.769716	1104	1184	272	3	80	0.0375000
NODE_2827_length_1367_cov_152.824921	513	593	10	45	80	0.5625000
NODE_2827_length_1367_cov_152.824921	513	593	11	31	80	0.3875000
NODE_2827_length_1367_cov_152.824921	513	593	12	4	80	0.0500000
NODE_2827_length_1367_cov_152.824921	566	646	11	23	80	0.2875000
NODE_2827_length_1367_cov_152.824921	566	646	12	19	80	0.2375000
NODE_2827_length_1367_cov_152.824921	566	646	25	16	80	0.2000000
NODE_2827_length_1367_cov_152.824921	566	646	37	22	80	0.2750000
NODE_2827_length_1367_cov_152.824921	642	722	0	10	80	0.1250000
NODE_2827_length_1367_cov_152.824921	642	722	25	22	80	0.2750000
NODE_2827_length_1367_cov_152.824921	642	722	26	7	80	0.0875000
NODE_2827_length_1367_cov_152.824921	642	722	28	3	80	0.0375000
NODE_2827_length_1367_cov_152.824921	642	722	31	5	80	0.0625000
NODE_2827_length_1367_cov_152.824921	642	722	32	33	80	0.4125000
NODE_2827_length_1367_cov_152.824921	695	775	0	63	80	0.7875000
NODE_2827_length_1367_cov_152.824921	695	775	32	17	80	0.2125000
NODE_2829_length_1367_cov_2.947161	250	326	13	4	76	0.0526316
NODE_2829_length_1367_cov_2.947161	250	326	15	12	76	0.1578947
NODE_2829_length_1367_cov_2.947161	250	326	16	7	76	0.0921053
NODE_2829_length_1367_cov_2.947161	250	326	18	3	76	0.0394737
NODE_2829_length_1367_cov_2.947161	250	326	20	32	76	0.4210526
NODE_2829_length_1367_cov_2.947161	250	326	22	13	76	0.1710526
NODE_2829_length_1367_cov_2.947161	250	326	24	5	76	0.0657895
NODE_2831_length_1366_cov_82.742699	198	278	0	74	80	0.9250000
NODE_2831_length_1366_cov_82.742699	198	278	2	6	80	0.0750000
NODE_2831_length_1366_cov_82.742699	251	331	0	21	80	0.2625000
NODE_2831_length_1366_cov_82.742699	251	331	2	12	80	0.1500000
NODE_2831_length_1366_cov_82.742699	251	331	4	47	80	0.5875000
NODE_2832_length_1366_cov_36.659037	577	657	0	23	80	0.2875000
NODE_2832_length_1366_cov_36.659037	577	657	2	57	80	0.7125000
NODE_2832_length_1366_cov_36.659037	630	710	0	76	80	0.9500000
NODE_2832_length_1366_cov_36.659037	630	710	2	4	80	0.0500000
NODE_2834_length_1366_cov_2.320442	47	116	4	13	69	0.1884058
NODE_2834_length_1366_cov_2.320442	47	116	6	56	69	0.8115942
NODE_2834_length_1366_cov_2.320442	1122	1202	2	34	80	0.4250000
NODE_2834_length_1366_cov_2.320442	1122	1202	4	11	80	0.1375000
NODE_2834_length_1366_cov_2.320442	1122	1202	6	28	80	0.3500000
NODE_2834_length_1366_cov_2.320442	1122	1202	7	7	80	0.0875000
NODE_2834_length_1366_cov_2.320442	1175	1255	4	3	80	0.0375000
NODE_2834_length_1366_cov_2.320442	1175	1255	5	1	80	0.0125000
NODE_2834_length_1366_cov_2.320442	1175	1255	6	24	80	0.3000000
NODE_2834_length_1366_cov_2.320442	1175	1255	9	3	80	0.0375000
NODE_2834_length_1366_cov_2.320442	1175	1255	11	1	80	0.0125000
NODE_2834_length_1366_cov_2.320442	1175	1255	15	3	80	0.0375000
NODE_2834_length_1366_cov_2.320442	1175	1255	19	1	80	0.0125000
NODE_2834_length_1366_cov_2.320442	1175	1255	23	1	80	0.0125000
NODE_2834_length_1366_cov_2.320442	1175	1255	25	1	80	0.0125000
NODE_2834_length_1366_cov_2.320442	1175	1255	29	1	80	0.0125000
NODE_2834_length_1366_cov_2.320442	1175	1255	32	1	80	0.0125000
NODE_2834_length_1366_cov_2.320442	1175	1255	34	9	80	0.1125000
NODE_2834_length_1366_cov_2.320442	1175	1255	35	15	80	0.1875000
NODE_2834_length_1366_cov_2.320442	1175	1255	40	1	80	0.0125000
NODE_2834_length_1366_cov_2.320442	1175	1255	42	2	80	0.0250000
NODE_2834_length_1366_cov_2.320442	1175	1255	44	6	80	0.0750000
NODE_2834_length_1366_cov_2.320442	1175	1255	46	1	80	0.0125000
NODE_2834_length_1366_cov_2.320442	1175	1255	48	1	80	0.0125000
NODE_2834_length_1366_cov_2.320442	1175	1255	50	5	80	0.0625000
NODE_2834_length_1366_cov_2.320442	1251	1331	24	2	80	0.0250000
NODE_2834_length_1366_cov_2.320442	1251	1331	26	2	80	0.0250000
NODE_2834_length_1366_cov_2.320442	1251	1331	28	3	80	0.0375000
NODE_2834_length_1366_cov_2.320442	1251	1331	30	1	80	0.0125000
NODE_2834_length_1366_cov_2.320442	1251	1331	32	3	80	0.0375000
NODE_2834_length_1366_cov_2.320442	1251	1331	36	2	80	0.0250000
NODE_2834_length_1366_cov_2.320442	1251	1331	38	1	80	0.0125000
NODE_2834_length_1366_cov_2.320442	1251	1331	40	7	80	0.0875000
NODE_2834_length_1366_cov_2.320442	1251	1331	44	3	80	0.0375000
NODE_2834_length_1366_cov_2.320442	1251	1331	46	3	80	0.0375000
NODE_2834_length_1366_cov_2.320442	1251	1331	48	13	80	0.1625000
NODE_2834_length_1366_cov_2.320442	1251	1331	50	40	80	0.5000000
NODE_2835_length_1365_cov_25.540284	432	509	0	17	77	0.2207792
NODE_2835_length_1365_cov_25.540284	432	509	2	31	77	0.4025974
NODE_2835_length_1365_cov_25.540284	432	509	4	29	77	0.3766234
NODE_2835_length_1365_cov_25.540284	482	562	4	80	80	1.0000000
NODE_2835_length_1365_cov_25.540284	558	635	0	56	77	0.7272727
NODE_2835_length_1365_cov_25.540284	558	635	2	8	77	0.1038961
NODE_2835_length_1365_cov_25.540284	558	635	4	13	77	0.1688312
NODE_2835_length_1365_cov_25.540284	625	688	0	63	63	1.0000000
NODE_2838_length_1364_cov_15.222134	120	191	6	9	71	0.1267606
NODE_2838_length_1364_cov_15.222134	120	191	7	10	71	0.1408451
NODE_2838_length_1364_cov_15.222134	120	191	9	6	71	0.0845070
NODE_2838_length_1364_cov_15.222134	120	191	11	1	71	0.0140845
NODE_2838_length_1364_cov_15.222134	120	191	12	3	71	0.0422535
NODE_2838_length_1364_cov_15.222134	120	191	13	1	71	0.0140845
NODE_2838_length_1364_cov_15.222134	120	191	14	1	71	0.0140845
NODE_2838_length_1364_cov_15.222134	120	191	15	1	71	0.0140845
NODE_2838_length_1364_cov_15.222134	120	191	19	1	71	0.0140845
NODE_2838_length_1364_cov_15.222134	120	191	21	2	71	0.0281690
NODE_2838_length_1364_cov_15.222134	120	191	22	4	71	0.0563380
NODE_2838_length_1364_cov_15.222134	120	191	24	1	71	0.0140845
NODE_2838_length_1364_cov_15.222134	120	191	27	3	71	0.0422535
NODE_2838_length_1364_cov_15.222134	120	191	36	1	71	0.0140845
NODE_2838_length_1364_cov_15.222134	120	191	37	1	71	0.0140845
NODE_2838_length_1364_cov_15.222134	120	191	38	5	71	0.0704225
NODE_2838_length_1364_cov_15.222134	120	191	40	2	71	0.0281690
NODE_2838_length_1364_cov_15.222134	120	191	42	2	71	0.0281690
NODE_2838_length_1364_cov_15.222134	120	191	46	2	71	0.0281690
NODE_2838_length_1364_cov_15.222134	120	191	48	1	71	0.0140845
NODE_2838_length_1364_cov_15.222134	120	191	50	8	71	0.1126761
NODE_2838_length_1364_cov_15.222134	120	191	52	6	71	0.0845070
NODE_2839_length_1364_cov_7.456917	843	923	0	16	80	0.2000000
NODE_2839_length_1364_cov_7.456917	843	923	4	5	80	0.0625000
NODE_2839_length_1364_cov_7.456917	843	923	8	59	80	0.7375000
NODE_2839_length_1364_cov_7.456917	896	976	4	28	80	0.3500000
NODE_2839_length_1364_cov_7.456917	896	976	8	52	80	0.6500000
NODE_2840_length_1364_cov_5.055336	239	290	0	51	51	1.0000000
NODE_2840_length_1364_cov_5.055336	263	343	0	80	80	1.0000000
NODE_2846_length_1363_cov_19.442247	615	695	0	8	80	0.1000000
NODE_2846_length_1363_cov_19.442247	615	695	2	35	80	0.4375000
NODE_2846_length_1363_cov_19.442247	615	695	4	28	80	0.3500000
NODE_2846_length_1363_cov_19.442247	615	695	6	9	80	0.1125000
NODE_2846_length_1363_cov_19.442247	668	748	4	55	80	0.6875000
NODE_2846_length_1363_cov_19.442247	668	748	6	25	80	0.3125000
NODE_2847_length_1363_cov_13.575949	619	699	0	80	80	1.0000000
NODE_2847_length_1363_cov_13.575949	672	752	0	80	80	1.0000000
NODE_2850_length_1362_cov_15.796516	898	978	0	80	80	1.0000000
NODE_2850_length_1362_cov_15.796516	951	1031	0	80	80	1.0000000
NODE_2855_length_1361_cov_24.574485	528	608	0	80	80	1.0000000
NODE_2855_length_1361_cov_24.574485	581	661	0	80	80	1.0000000
NODE_2856_length_1361_cov_20.148970	866	946	0	20	80	0.2500000
NODE_2856_length_1361_cov_20.148970	866	946	2	60	80	0.7500000
NODE_2856_length_1361_cov_20.148970	919	999	0	73	80	0.9125000
NODE_2856_length_1361_cov_20.148970	919	999	2	7	80	0.0875000
NODE_2858_length_1361_cov_10.530903	1139	1219	0	15	80	0.1875000
NODE_2858_length_1361_cov_10.530903	1139	1219	4	65	80	0.8125000
NODE_2858_length_1361_cov_10.530903	1139	1219	0	15	80	0.1875000
NODE_2858_length_1361_cov_10.530903	1139	1219	4	65	80	0.8125000
NODE_2858_length_1361_cov_10.530903	1192	1277	0	56	85	0.6588235
NODE_2858_length_1361_cov_10.530903	1192	1277	4	29	85	0.3411765
NODE_2858_length_1361_cov_10.530903	1273	1353	0	80	80	1.0000000
NODE_2858_length_1361_cov_10.530903	1273	1353	0	80	80	1.0000000
NODE_2858_length_1361_cov_10.530903	1273	1353	0	80	80	1.0000000
NODE_2858_length_1361_cov_10.530903	1273	1353	0	80	80	1.0000000
NODE_2858_length_1361_cov_10.530903	1273	1353	0	80	80	1.0000000
NODE_2858_length_1361_cov_10.530903	1273	1353	0	80	80	1.0000000
NODE_2859_length_1360_cov_42.789056	351	431	6	80	80	1.0000000
NODE_2859_length_1360_cov_42.789056	404	484	0	40	80	0.5000000
NODE_2859_length_1360_cov_42.789056	404	484	6	40	80	0.5000000
NODE_2860_length_1360_cov_26.407613	531	611	2	47	80	0.5875000
NODE_2860_length_1360_cov_26.407613	531	611	6	33	80	0.4125000
NODE_2860_length_1360_cov_26.407613	584	669	0	16	85	0.1882353
NODE_2860_length_1360_cov_26.407613	584	669	4	25	85	0.2941177
NODE_2860_length_1360_cov_26.407613	584	669	6	44	85	0.5176471
NODE_2861_length_1360_cov_16.182395	796	876	4	11	80	0.1375000
NODE_2861_length_1360_cov_16.182395	796	876	12	14	80	0.1750000
NODE_2861_length_1360_cov_16.182395	796	876	13	14	80	0.1750000
NODE_2861_length_1360_cov_16.182395	796	876	15	11	80	0.1375000
NODE_2861_length_1360_cov_16.182395	796	876	16	30	80	0.3750000
NODE_2861_length_1360_cov_16.182395	849	929	7	21	80	0.2625000
NODE_2861_length_1360_cov_16.182395	849	929	11	1	80	0.0125000
NODE_2861_length_1360_cov_16.182395	849	929	13	45	80	0.5625000
NODE_2861_length_1360_cov_16.182395	849	929	15	11	80	0.1375000
NODE_2861_length_1360_cov_16.182395	849	929	16	2	80	0.0250000
NODE_2861_length_1360_cov_16.182395	925	1005	0	53	80	0.6625000
NODE_2861_length_1360_cov_16.182395	925	1005	6	2	80	0.0250000
NODE_2861_length_1360_cov_16.182395	925	1005	7	25	80	0.3125000
NODE_2861_length_1360_cov_16.182395	978	1058	0	80	80	1.0000000
NODE_2862_length_1360_cov_12.763680	582	662	0	80	80	1.0000000
NODE_2862_length_1360_cov_12.763680	635	715	0	80	80	1.0000000
NODE_2866_length_1359_cov_41.324603	674	754	0	3	80	0.0375000
NODE_2866_length_1359_cov_41.324603	674	754	2	77	80	0.9625000
NODE_2866_length_1359_cov_41.324603	727	807	0	14	80	0.1750000
NODE_2866_length_1359_cov_41.324603	727	807	2	53	80	0.6625000
NODE_2866_length_1359_cov_41.324603	727	807	4	13	80	0.1625000
NODE_2866_length_1359_cov_41.324603	803	883	4	80	80	1.0000000
NODE_2866_length_1359_cov_41.324603	856	936	0	53	80	0.6625000
NODE_2866_length_1359_cov_41.324603	856	936	4	27	80	0.3375000
NODE_2871_length_1358_cov_23.427323	292	372	0	80	80	1.0000000
NODE_2871_length_1358_cov_23.427323	345	425	0	80	80	1.0000000
NODE_2872_length_1358_cov_19.489277	411	491	0	80	80	1.0000000
NODE_2872_length_1358_cov_19.489277	464	544	0	80	80	1.0000000
NODE_2875_length_1357_cov_15.962639	732	812	0	80	80	1.0000000
NODE_2875_length_1357_cov_15.962639	785	865	0	80	80	1.0000000
NODE_2879_length_1354_cov_9.854980	735	815	0	80	80	1.0000000
NODE_2879_length_1354_cov_9.854980	788	868	0	80	80	1.0000000
NODE_2882_length_1353_cov_32.982456	708	788	0	80	80	1.0000000
NODE_2882_length_1353_cov_32.982456	761	841	0	80	80	1.0000000
NODE_2883_length_1353_cov_21.775120	493	573	4	80	80	1.0000000
NODE_2883_length_1353_cov_21.775120	546	626	0	15	80	0.1875000
NODE_2883_length_1353_cov_21.775120	546	626	2	31	80	0.3875000
NODE_2883_length_1353_cov_21.775120	546	626	4	34	80	0.4250000
NODE_2884_length_1353_cov_18.201754	696	776	0	30	80	0.3750000
NODE_2884_length_1353_cov_18.201754	696	776	2	50	80	0.6250000
NODE_2884_length_1353_cov_18.201754	749	829	0	80	80	1.0000000
NODE_2888_length_1352_cov_26.942538	455	535	0	20	80	0.2500000
NODE_2888_length_1352_cov_26.942538	455	535	2	39	80	0.4875000
NODE_2888_length_1352_cov_26.942538	455	535	6	21	80	0.2625000
NODE_2888_length_1352_cov_26.942538	508	588	2	6	80	0.0750000
NODE_2888_length_1352_cov_26.942538	508	588	4	17	80	0.2125000
NODE_2888_length_1352_cov_26.942538	508	588	6	57	80	0.7125000
NODE_2889_length_1352_cov_17.189944	717	797	2	80	80	1.0000000
NODE_2889_length_1352_cov_17.189944	770	850	0	42	80	0.5250000
NODE_2889_length_1352_cov_17.189944	770	850	2	38	80	0.4750000
NODE_2890_length_1352_cov_15.752594	640	720	0	5	80	0.0625000
NODE_2890_length_1352_cov_15.752594	640	720	2	8	80	0.1000000
NODE_2890_length_1352_cov_15.752594	640	720	8	67	80	0.8375000
NODE_2890_length_1352_cov_15.752594	693	773	0	20	80	0.2500000
NODE_2890_length_1352_cov_15.752594	693	773	6	3	80	0.0375000
NODE_2890_length_1352_cov_15.752594	693	773	8	57	80	0.7125000
NODE_2891_length_1352_cov_10.699920	237	317	0	80	80	1.0000000
NODE_2891_length_1352_cov_10.699920	290	370	0	80	80	1.0000000
NODE_2894_length_1351_cov_32.325879	561	641	0	80	80	1.0000000
NODE_2894_length_1351_cov_32.325879	614	694	0	80	80	1.0000000
NODE_2895_length_1351_cov_16.861022	97	162	29	1	65	0.0153846
NODE_2895_length_1351_cov_16.861022	97	162	31	1	65	0.0153846
NODE_2895_length_1351_cov_16.861022	97	162	36	1	65	0.0153846
NODE_2895_length_1351_cov_16.861022	97	162	44	2	65	0.0307692
NODE_2895_length_1351_cov_16.861022	97	162	54	7	65	0.1076923
NODE_2895_length_1351_cov_16.861022	97	162	56	1	65	0.0153846
NODE_2895_length_1351_cov_16.861022	97	162	58	7	65	0.1076923
NODE_2895_length_1351_cov_16.861022	97	162	60	8	65	0.1230769
NODE_2895_length_1351_cov_16.861022	97	162	61	37	65	0.5692308
NODE_2896_length_1351_cov_9.894569	331	411	0	18	80	0.2250000
NODE_2896_length_1351_cov_9.894569	331	411	2	62	80	0.7750000
NODE_2896_length_1351_cov_9.894569	384	464	2	80	80	1.0000000
NODE_2897_length_1351_cov_8.699681	1055	1137	0	1	82	0.0121951
NODE_2897_length_1351_cov_8.699681	1055	1137	2	74	82	0.9024390
NODE_2897_length_1351_cov_8.699681	1055	1137	8	3	82	0.0365854
NODE_2897_length_1351_cov_8.699681	1055	1137	10	4	82	0.0487805
NODE_2897_length_1351_cov_8.699681	1110	1175	0	11	65	0.1692308
NODE_2897_length_1351_cov_8.699681	1110	1175	2	54	65	0.8307692
NODE_2898_length_1351_cov_2.931310	68	148	14	2	80	0.0250000
NODE_2898_length_1351_cov_2.931310	68	148	16	20	80	0.2500000
NODE_2898_length_1351_cov_2.931310	68	148	18	2	80	0.0250000
NODE_2898_length_1351_cov_2.931310	68	148	20	5	80	0.0625000
NODE_2898_length_1351_cov_2.931310	68	148	22	8	80	0.1000000
NODE_2898_length_1351_cov_2.931310	68	148	24	20	80	0.2500000
NODE_2898_length_1351_cov_2.931310	68	148	26	13	80	0.1625000
NODE_2898_length_1351_cov_2.931310	68	148	28	5	80	0.0625000
NODE_2898_length_1351_cov_2.931310	68	148	30	1	80	0.0125000
NODE_2898_length_1351_cov_2.931310	68	148	32	1	80	0.0125000
NODE_2898_length_1351_cov_2.931310	68	148	33	1	80	0.0125000
NODE_2898_length_1351_cov_2.931310	68	148	35	1	80	0.0125000
NODE_2898_length_1351_cov_2.931310	68	148	36	1	80	0.0125000
NODE_2898_length_1351_cov_2.931310	495	528	0	33	33	1.0000000
NODE_2899_length_1350_cov_18.274181	424	504	2	52	80	0.6500000
NODE_2899_length_1350_cov_18.274181	424	504	4	28	80	0.3500000
NODE_2899_length_1350_cov_18.274181	477	557	2	42	80	0.5250000
NODE_2899_length_1350_cov_18.274181	477	557	4	38	80	0.4750000
NODE_2899_length_1350_cov_18.274181	553	633	2	17	80	0.2125000
NODE_2899_length_1350_cov_18.274181	553	633	4	17	80	0.2125000
NODE_2899_length_1350_cov_18.274181	553	633	6	46	80	0.5750000
NODE_2899_length_1350_cov_18.274181	606	686	2	13	80	0.1625000
NODE_2899_length_1350_cov_18.274181	606	686	4	20	80	0.2500000
NODE_2899_length_1350_cov_18.274181	606	686	6	47	80	0.5875000
NODE_2900_length_1350_cov_8.053557	737	817	0	80	80	1.0000000
NODE_2900_length_1350_cov_8.053557	790	870	0	80	80	1.0000000
NODE_2903_length_1349_cov_23.782400	839	919	0	44	80	0.5500000
NODE_2903_length_1349_cov_23.782400	839	919	2	36	80	0.4500000
NODE_2903_length_1349_cov_23.782400	892	972	0	2	80	0.0250000
NODE_2903_length_1349_cov_23.782400	892	972	2	78	80	0.9750000
NODE_2903_length_1349_cov_23.782400	968	1048	0	78	80	0.9750000
NODE_2903_length_1349_cov_23.782400	968	1048	2	2	80	0.0250000
NODE_2903_length_1349_cov_23.782400	1021	1101	0	80	80	1.0000000
NODE_2904_length_1349_cov_17.776800	811	891	0	80	80	1.0000000
NODE_2904_length_1349_cov_17.776800	864	944	0	80	80	1.0000000
NODE_2905_length_1349_cov_16.468800	828	908	0	14	80	0.1750000
NODE_2905_length_1349_cov_16.468800	828	908	2	29	80	0.3625000
NODE_2905_length_1349_cov_16.468800	828	908	4	37	80	0.4625000
NODE_2905_length_1349_cov_16.468800	881	961	0	13	80	0.1625000
NODE_2905_length_1349_cov_16.468800	881	961	2	27	80	0.3375000
NODE_2905_length_1349_cov_16.468800	881	961	4	40	80	0.5000000
NODE_2908_length_1348_cov_22.731785	468	548	0	10	80	0.1250000
NODE_2908_length_1348_cov_22.731785	468	548	2	70	80	0.8750000
NODE_2908_length_1348_cov_22.731785	521	601	0	63	80	0.7875000
NODE_2908_length_1348_cov_22.731785	521	601	2	17	80	0.2125000
NODE_2909_length_1348_cov_20.778223	517	597	0	65	80	0.8125000
NODE_2909_length_1348_cov_20.778223	517	597	2	15	80	0.1875000
NODE_2909_length_1348_cov_20.778223	570	650	0	80	80	1.0000000
NODE_2910_length_1348_cov_11.180144	673	753	0	20	80	0.2500000
NODE_2910_length_1348_cov_11.180144	673	753	2	60	80	0.7500000
NODE_2910_length_1348_cov_11.180144	726	806	0	73	80	0.9125000
NODE_2910_length_1348_cov_11.180144	726	806	2	7	80	0.0875000
NODE_2916_length_1347_cov_45.906250	683	763	0	80	80	1.0000000
NODE_2916_length_1347_cov_45.906250	736	816	0	27	80	0.3375000
NODE_2916_length_1347_cov_45.906250	736	816	2	53	80	0.6625000
NODE_2916_length_1347_cov_45.906250	812	892	0	57	80	0.7125000
NODE_2916_length_1347_cov_45.906250	812	892	2	23	80	0.2875000
NODE_2916_length_1347_cov_45.906250	865	945	0	80	80	1.0000000
NODE_2917_length_1347_cov_41.643429	439	519	7	7	80	0.0875000
NODE_2917_length_1347_cov_41.643429	439	519	9	4	80	0.0500000
NODE_2917_length_1347_cov_41.643429	439	519	10	8	80	0.1000000
NODE_2917_length_1347_cov_41.643429	439	519	11	4	80	0.0500000
NODE_2917_length_1347_cov_41.643429	439	519	12	28	80	0.3500000
NODE_2917_length_1347_cov_41.643429	439	519	13	7	80	0.0875000
NODE_2917_length_1347_cov_41.643429	439	519	14	16	80	0.2000000
NODE_2917_length_1347_cov_41.643429	439	519	18	6	80	0.0750000
NODE_2917_length_1347_cov_41.643429	492	572	7	7	80	0.0875000
NODE_2917_length_1347_cov_41.643429	492	572	9	4	80	0.0500000
NODE_2917_length_1347_cov_41.643429	492	572	10	5	80	0.0625000
NODE_2917_length_1347_cov_41.643429	492	572	11	4	80	0.0500000
NODE_2917_length_1347_cov_41.643429	492	572	13	7	80	0.0875000
NODE_2917_length_1347_cov_41.643429	492	572	14	4	80	0.0500000
NODE_2917_length_1347_cov_41.643429	492	572	15	43	80	0.5375000
NODE_2917_length_1347_cov_41.643429	492	572	16	6	80	0.0750000
NODE_2918_length_1347_cov_19.941506	458	538	0	80	80	1.0000000
NODE_2918_length_1347_cov_19.941506	511	591	0	80	80	1.0000000
NODE_2918_length_1347_cov_19.941506	587	667	0	8	80	0.1000000
NODE_2918_length_1347_cov_19.941506	587	667	6	72	80	0.9000000
NODE_2918_length_1347_cov_19.941506	640	720	6	66	80	0.8250000
NODE_2918_length_1347_cov_19.941506	640	720	8	14	80	0.1750000
NODE_2919_length_1347_cov_16.520833	713	793	0	80	80	1.0000000
NODE_2919_length_1347_cov_16.520833	766	846	0	80	80	1.0000000
NODE_2920_length_1347_cov_15.967147	638	718	0	53	80	0.6625000
NODE_2920_length_1347_cov_15.967147	638	718	2	27	80	0.3375000
NODE_2920_length_1347_cov_15.967147	691	771	2	80	80	1.0000000
NODE_2925_length_1346_cov_13.112269	429	509	22	6	80	0.0750000
NODE_2925_length_1346_cov_13.112269	429	509	23	31	80	0.3875000
NODE_2925_length_1346_cov_13.112269	429	509	24	43	80	0.5375000
NODE_2925_length_1346_cov_13.112269	482	562	0	14	80	0.1750000
NODE_2925_length_1346_cov_13.112269	482	562	6	19	80	0.2375000
NODE_2925_length_1346_cov_13.112269	482	562	12	1	80	0.0125000
NODE_2925_length_1346_cov_13.112269	482	562	14	1	80	0.0125000
NODE_2925_length_1346_cov_13.112269	482	562	18	1	80	0.0125000
NODE_2925_length_1346_cov_13.112269	482	562	19	14	80	0.1750000
NODE_2925_length_1346_cov_13.112269	482	562	23	30	80	0.3750000
NODE_2928_length_1345_cov_32.099518	629	709	0	7	80	0.0875000
NODE_2928_length_1345_cov_32.099518	629	709	4	53	80	0.6625000
NODE_2928_length_1345_cov_32.099518	629	709	6	20	80	0.2500000
NODE_2928_length_1345_cov_32.099518	682	762	0	8	80	0.1000000
NODE_2928_length_1345_cov_32.099518	682	762	2	29	80	0.3625000
NODE_2928_length_1345_cov_32.099518	682	762	4	7	80	0.0875000
NODE_2928_length_1345_cov_32.099518	682	762	6	36	80	0.4500000
NODE_2929_length_1345_cov_19.837881	723	803	0	80	80	1.0000000
NODE_2929_length_1345_cov_19.837881	776	856	0	80	80	1.0000000
NODE_2930_length_1345_cov_14.262440	361	441	0	80	80	1.0000000
NODE_2930_length_1345_cov_14.262440	414	494	0	80	80	1.0000000
NODE_2930_length_1345_cov_14.262440	490	570	0	80	80	1.0000000
NODE_2930_length_1345_cov_14.262440	543	623	0	80	80	1.0000000
NODE_2931_length_1345_cov_14.103531	950	1030	2	10	80	0.1250000
NODE_2931_length_1345_cov_14.103531	950	1030	4	70	80	0.8750000
NODE_2931_length_1345_cov_14.103531	1003	1083	0	40	80	0.5000000
NODE_2931_length_1345_cov_14.103531	1003	1083	2	23	80	0.2875000
NODE_2931_length_1345_cov_14.103531	1003	1083	4	17	80	0.2125000
NODE_2934_length_1344_cov_15.013655	345	425	0	80	80	1.0000000
NODE_2934_length_1344_cov_15.013655	398	478	0	50	80	0.6250000
NODE_2934_length_1344_cov_15.013655	398	478	2	30	80	0.3750000
NODE_2935_length_1344_cov_11.383133	519	599	0	4	80	0.0500000
NODE_2935_length_1344_cov_11.383133	519	599	2	76	80	0.9500000
NODE_2935_length_1344_cov_11.383133	572	652	0	22	80	0.2750000
NODE_2935_length_1344_cov_11.383133	572	652	2	58	80	0.7250000
NODE_2935_length_1344_cov_11.383133	648	728	0	80	80	1.0000000
NODE_2935_length_1344_cov_11.383133	701	781	0	46	80	0.5750000
NODE_2935_length_1344_cov_11.383133	701	781	2	34	80	0.4250000
NODE_2936_length_1344_cov_10.924498	529	609	0	80	80	1.0000000
NODE_2936_length_1344_cov_10.924498	582	662	0	80	80	1.0000000
NODE_2937_length_1344_cov_5.531727	920	975	0	28	55	0.5090909
NODE_2937_length_1344_cov_5.531727	920	975	2	27	55	0.4909091
NODE_2942_length_1343_cov_36.005627	150	230	60	3	80	0.0375000
NODE_2942_length_1343_cov_36.005627	150	230	63	1	80	0.0125000
NODE_2942_length_1343_cov_36.005627	150	230	65	1	80	0.0125000
NODE_2942_length_1343_cov_36.005627	150	230	66	1	80	0.0125000
NODE_2942_length_1343_cov_36.005627	150	230	70	1	80	0.0125000
NODE_2942_length_1343_cov_36.005627	150	230	72	2	80	0.0250000
NODE_2942_length_1343_cov_36.005627	150	230	74	3	80	0.0375000
NODE_2942_length_1343_cov_36.005627	150	230	77	1	80	0.0125000
NODE_2942_length_1343_cov_36.005627	150	230	80	2	80	0.0250000
NODE_2942_length_1343_cov_36.005627	150	230	82	1	80	0.0125000
NODE_2942_length_1343_cov_36.005627	150	230	84	1	80	0.0125000
NODE_2942_length_1343_cov_36.005627	150	230	86	3	80	0.0375000
NODE_2942_length_1343_cov_36.005627	150	230	88	7	80	0.0875000
NODE_2942_length_1343_cov_36.005627	150	230	90	10	80	0.1250000
NODE_2942_length_1343_cov_36.005627	150	230	92	16	80	0.2000000
NODE_2942_length_1343_cov_36.005627	150	230	93	4	80	0.0500000
NODE_2942_length_1343_cov_36.005627	150	230	94	3	80	0.0375000
NODE_2942_length_1343_cov_36.005627	150	230	95	7	80	0.0875000
NODE_2942_length_1343_cov_36.005627	150	230	96	7	80	0.0875000
NODE_2942_length_1343_cov_36.005627	150	230	99	1	80	0.0125000
NODE_2942_length_1343_cov_36.005627	150	230	100	1	80	0.0125000
NODE_2942_length_1343_cov_36.005627	150	230	102	4	80	0.0500000
NODE_2942_length_1343_cov_36.005627	286	366	3	1	80	0.0125000
NODE_2942_length_1343_cov_36.005627	286	366	4	59	80	0.7375000
NODE_2942_length_1343_cov_36.005627	286	366	8	20	80	0.2500000
NODE_2942_length_1343_cov_36.005627	339	419	0	14	80	0.1750000
NODE_2942_length_1343_cov_36.005627	339	419	4	55	80	0.6875000
NODE_2942_length_1343_cov_36.005627	339	419	8	11	80	0.1375000
NODE_2942_length_1343_cov_36.005627	415	495	0	80	80	1.0000000
NODE_2942_length_1343_cov_36.005627	468	548	0	80	80	1.0000000
NODE_2943_length_1343_cov_26.826367	782	862	0	80	80	1.0000000
NODE_2943_length_1343_cov_26.826367	835	915	0	80	80	1.0000000
NODE_2944_length_1343_cov_19.353698	799	879	0	80	80	1.0000000
NODE_2944_length_1343_cov_19.353698	852	932	0	80	80	1.0000000
NODE_2944_length_1343_cov_19.353698	928	1008	0	9	80	0.1125000
NODE_2944_length_1343_cov_19.353698	928	1008	2	9	80	0.1125000
NODE_2944_length_1343_cov_19.353698	928	1008	5	1	80	0.0125000
NODE_2944_length_1343_cov_19.353698	928	1008	6	61	80	0.7625000
NODE_2944_length_1343_cov_19.353698	981	1061	4	39	80	0.4875000
NODE_2944_length_1343_cov_19.353698	981	1061	6	41	80	0.5125000
NODE_2945_length_1343_cov_15.717846	745	825	0	80	80	1.0000000
NODE_2945_length_1343_cov_15.717846	798	878	0	80	80	1.0000000
NODE_2949_length_1342_cov_30.491553	456	536	0	80	80	1.0000000
NODE_2949_length_1342_cov_30.491553	509	589	0	80	80	1.0000000
NODE_2949_length_1342_cov_30.491553	585	665	0	80	80	1.0000000
NODE_2949_length_1342_cov_30.491553	638	718	0	80	80	1.0000000
NODE_2950_length_1342_cov_26.796460	538	618	0	15	80	0.1875000
NODE_2950_length_1342_cov_26.796460	538	618	2	65	80	0.8125000
NODE_2950_length_1342_cov_26.796460	591	671	0	68	80	0.8500000
NODE_2950_length_1342_cov_26.796460	591	671	2	12	80	0.1500000
NODE_2950_length_1342_cov_26.796460	667	747	0	80	80	1.0000000
NODE_2950_length_1342_cov_26.796460	720	800	0	80	80	1.0000000
NODE_2951_length_1342_cov_22.769912	298	378	0	80	80	1.0000000
NODE_2951_length_1342_cov_22.769912	351	431	0	80	80	1.0000000
NODE_2951_length_1342_cov_22.769912	427	507	0	80	80	1.0000000
NODE_2951_length_1342_cov_22.769912	480	560	0	80	80	1.0000000
NODE_2953_length_1341_cov_22.449275	494	574	0	80	80	1.0000000
NODE_2953_length_1341_cov_22.449275	547	627	0	80	80	1.0000000
NODE_2953_length_1341_cov_22.449275	623	703	0	34	80	0.4250000
NODE_2953_length_1341_cov_22.449275	623	703	2	46	80	0.5750000
NODE_2953_length_1341_cov_22.449275	676	755	0	6	79	0.0759494
NODE_2953_length_1341_cov_22.449275	676	755	2	73	79	0.9240506
NODE_2954_length_1341_cov_14.497585	415	495	0	50	80	0.6250000
NODE_2954_length_1341_cov_14.497585	415	495	2	10	80	0.1250000
NODE_2954_length_1341_cov_14.497585	415	495	4	20	80	0.2500000
NODE_2954_length_1341_cov_14.497585	468	548	0	26	80	0.3250000
NODE_2954_length_1341_cov_14.497585	468	548	2	47	80	0.5875000
NODE_2954_length_1341_cov_14.497585	468	548	4	7	80	0.0875000
NODE_2954_length_1341_cov_14.497585	544	624	2	11	80	0.1375000
NODE_2954_length_1341_cov_14.497585	544	624	4	69	80	0.8625000
NODE_2954_length_1341_cov_14.497585	597	677	0	38	80	0.4750000
NODE_2954_length_1341_cov_14.497585	597	677	2	26	80	0.3250000
NODE_2954_length_1341_cov_14.497585	597	677	4	16	80	0.2000000
NODE_2960_length_1340_cov_9.460113	531	611	0	80	80	1.0000000
NODE_2960_length_1340_cov_9.460113	584	664	0	34	80	0.4250000
NODE_2960_length_1340_cov_9.460113	584	664	1	37	80	0.4625000
NODE_2960_length_1340_cov_9.460113	584	664	2	9	80	0.1125000
NODE_2961_length_1340_cov_6.511684	735	815	0	80	80	1.0000000
NODE_2961_length_1340_cov_6.511684	788	868	0	80	80	1.0000000
NODE_2966_length_1339_cov_22.725000	751	831	0	80	80	1.0000000
NODE_2966_length_1339_cov_22.725000	804	884	0	80	80	1.0000000
NODE_2967_length_1339_cov_9.322581	329	409	4	80	80	1.0000000
NODE_2967_length_1339_cov_9.322581	382	462	0	44	80	0.5500000
NODE_2967_length_1339_cov_9.322581	382	462	4	36	80	0.4500000
NODE_2970_length_1338_cov_31.740920	527	607	0	78	80	0.9750000
NODE_2970_length_1338_cov_31.740920	527	607	2	2	80	0.0250000
NODE_2970_length_1338_cov_31.740920	580	660	0	25	80	0.3125000
NODE_2970_length_1338_cov_31.740920	580	660	2	55	80	0.6875000
NODE_2970_length_1338_cov_31.740920	656	736	2	21	80	0.2625000
NODE_2970_length_1338_cov_31.740920	656	736	4	55	80	0.6875000
NODE_2970_length_1338_cov_31.740920	656	736	6	4	80	0.0500000
NODE_2970_length_1338_cov_31.740920	709	789	0	4	80	0.0500000
NODE_2970_length_1338_cov_31.740920	709	789	4	76	80	0.9500000
NODE_2971_length_1338_cov_21.254237	639	719	0	75	80	0.9375000
NODE_2971_length_1338_cov_21.254237	639	719	2	5	80	0.0625000
NODE_2971_length_1338_cov_21.254237	692	772	0	22	80	0.2750000
NODE_2971_length_1338_cov_21.254237	692	772	2	58	80	0.7250000
NODE_2974_length_1337_cov_32.307754	739	819	2	69	80	0.8625000
NODE_2974_length_1337_cov_32.307754	739	819	3	11	80	0.1375000
NODE_2974_length_1337_cov_32.307754	792	872	0	35	80	0.4375000
NODE_2974_length_1337_cov_32.307754	792	872	2	45	80	0.5625000
NODE_2975_length_1337_cov_30.412763	465	545	0	28	80	0.3500000
NODE_2975_length_1337_cov_30.412763	465	545	7	1	80	0.0125000
NODE_2975_length_1337_cov_30.412763	465	545	8	13	80	0.1625000
NODE_2975_length_1337_cov_30.412763	465	545	10	38	80	0.4750000
NODE_2975_length_1337_cov_30.412763	518	598	7	7	80	0.0875000
NODE_2975_length_1337_cov_30.412763	518	598	8	7	80	0.0875000
NODE_2975_length_1337_cov_30.412763	518	598	10	51	80	0.6375000
NODE_2975_length_1337_cov_30.412763	518	598	19	1	80	0.0125000
NODE_2975_length_1337_cov_30.412763	518	598	28	1	80	0.0125000
NODE_2975_length_1337_cov_30.412763	518	598	30	1	80	0.0125000
NODE_2975_length_1337_cov_30.412763	518	598	35	4	80	0.0500000
NODE_2975_length_1337_cov_30.412763	518	598	36	2	80	0.0250000
NODE_2975_length_1337_cov_30.412763	518	598	38	3	80	0.0375000
NODE_2975_length_1337_cov_30.412763	518	598	40	3	80	0.0375000
NODE_2976_length_1337_cov_12.760905	560	640	0	57	80	0.7125000
NODE_2976_length_1337_cov_12.760905	560	640	2	23	80	0.2875000
NODE_2976_length_1337_cov_12.760905	613	693	0	4	80	0.0500000
NODE_2976_length_1337_cov_12.760905	613	693	2	76	80	0.9500000
NODE_2977_length_1337_cov_9.463651	724	804	0	80	80	1.0000000
NODE_2977_length_1337_cov_9.463651	777	857	0	80	80	1.0000000
NODE_2979_length_1337_cov_4.540388	216	296	0	80	80	1.0000000
NODE_2979_length_1337_cov_4.540388	272	349	0	77	77	1.0000000
NODE_2981_length_1336_cov_28.161681	394	474	0	80	80	1.0000000
NODE_2981_length_1336_cov_28.161681	447	527	0	80	80	1.0000000
NODE_2981_length_1336_cov_28.161681	523	603	0	80	80	1.0000000
NODE_2981_length_1336_cov_28.161681	576	656	0	80	80	1.0000000
NODE_2982_length_1336_cov_7.860954	17	98	6	50	81	0.6172839
NODE_2982_length_1336_cov_7.860954	17	98	10	10	81	0.1234568
NODE_2982_length_1336_cov_7.860954	17	98	12	21	81	0.2592593
NODE_2984_length_1336_cov_1.689572	1229	1289	2	51	60	0.8500000
NODE_2984_length_1336_cov_1.689572	1229	1289	4	8	60	0.1333333
NODE_2984_length_1336_cov_1.689572	1229	1289	8	1	60	0.0166667
NODE_2984_length_1336_cov_1.689572	1262	1336	0	6	74	0.0810811
NODE_2984_length_1336_cov_1.689572	1262	1336	2	68	74	0.9189189
NODE_2985_length_1335_cov_19.547735	530	607	0	77	77	1.0000000
NODE_2985_length_1335_cov_19.547735	582	660	0	78	78	1.0000000
NODE_2985_length_1335_cov_19.547735	656	736	0	80	80	1.0000000
NODE_2985_length_1335_cov_19.547735	709	789	0	80	80	1.0000000
NODE_2986_length_1335_cov_15.383495	419	499	0	80	80	1.0000000
NODE_2986_length_1335_cov_15.383495	472	552	0	80	80	1.0000000
NODE_2986_length_1335_cov_15.383495	548	628	0	80	80	1.0000000
NODE_2986_length_1335_cov_15.383495	601	681	0	80	80	1.0000000
NODE_2991_length_1333_cov_27.372771	493	573	0	27	80	0.3375000
NODE_2991_length_1333_cov_27.372771	493	573	2	53	80	0.6625000
NODE_2991_length_1333_cov_27.372771	546	626	0	27	80	0.3375000
NODE_2991_length_1333_cov_27.372771	546	626	2	53	80	0.6625000
NODE_2996_length_1332_cov_18.978913	648	728	0	80	80	1.0000000
NODE_2996_length_1332_cov_18.978913	701	781	0	80	80	1.0000000
NODE_2996_length_1332_cov_18.978913	777	857	0	37	80	0.4625000
NODE_2996_length_1332_cov_18.978913	777	857	2	43	80	0.5375000
NODE_2996_length_1332_cov_18.978913	830	910	2	80	80	1.0000000
NODE_2997_length_1332_cov_3.112733	87	151	2	28	64	0.4375000
NODE_2997_length_1332_cov_3.112733	87	151	4	2	64	0.0312500
NODE_2997_length_1332_cov_3.112733	87	151	6	9	64	0.1406250
NODE_2997_length_1332_cov_3.112733	87	151	8	20	64	0.3125000
NODE_2997_length_1332_cov_3.112733	87	151	12	1	64	0.0156250
NODE_2997_length_1332_cov_3.112733	87	151	16	4	64	0.0625000
NODE_3000_length_1331_cov_16.831981	392	472	0	60	80	0.7500000
NODE_3000_length_1331_cov_16.831981	392	472	2	20	80	0.2500000
NODE_3000_length_1331_cov_16.831981	445	525	0	7	80	0.0875000
NODE_3000_length_1331_cov_16.831981	445	525	2	73	80	0.9125000
NODE_3000_length_1331_cov_16.831981	521	601	0	67	80	0.8375000
NODE_3000_length_1331_cov_16.831981	521	601	2	13	80	0.1625000
NODE_3000_length_1331_cov_16.831981	574	654	0	80	80	1.0000000
NODE_3001_length_1331_cov_12.841721	871	951	0	8	80	0.1000000
NODE_3001_length_1331_cov_12.841721	871	951	4	72	80	0.9000000
NODE_3001_length_1331_cov_12.841721	924	1004	0	24	80	0.3000000
NODE_3001_length_1331_cov_12.841721	924	1004	4	56	80	0.7000000
NODE_3004_length_1331_cov_2.090097	0	76	0	76	76	1.0000000
NODE_3004_length_1331_cov_2.090097	49	98	0	49	49	1.0000000
NODE_3007_length_1330_cov_48.993501	278	358	0	69	80	0.8625000
NODE_3007_length_1330_cov_48.993501	278	358	2	11	80	0.1375000
NODE_3007_length_1330_cov_48.993501	331	411	0	80	80	1.0000000
NODE_3007_length_1330_cov_48.993501	742	822	0	80	80	1.0000000
NODE_3007_length_1330_cov_48.993501	795	875	0	29	80	0.3625000
NODE_3007_length_1330_cov_48.993501	795	875	2	51	80	0.6375000
NODE_3008_length_1330_cov_11.037368	407	487	0	39	80	0.4875000
NODE_3008_length_1330_cov_11.037368	407	487	2	15	80	0.1875000
NODE_3008_length_1330_cov_11.037368	407	487	4	26	80	0.3250000
NODE_3008_length_1330_cov_11.037368	460	540	2	1	80	0.0125000
NODE_3008_length_1330_cov_11.037368	460	540	4	79	80	0.9875000
NODE_3008_length_1330_cov_11.037368	536	617	0	24	81	0.2962963
NODE_3008_length_1330_cov_11.037368	536	617	2	47	81	0.5802469
NODE_3008_length_1330_cov_11.037368	536	617	4	10	81	0.1234568
NODE_3008_length_1330_cov_11.037368	590	670	0	77	80	0.9625000
NODE_3008_length_1330_cov_11.037368	590	670	2	3	80	0.0375000
NODE_3009_length_1330_cov_9.026807	551	631	0	38	80	0.4750000
NODE_3009_length_1330_cov_9.026807	551	631	2	42	80	0.5250000
NODE_3009_length_1330_cov_9.026807	604	684	2	34	80	0.4250000
NODE_3009_length_1330_cov_9.026807	604	684	4	46	80	0.5750000
NODE_3011_length_1329_cov_17.036585	691	771	0	80	80	1.0000000
NODE_3011_length_1329_cov_17.036585	744	824	0	80	80	1.0000000
NODE_3011_length_1329_cov_17.036585	820	900	0	72	80	0.9000000
NODE_3011_length_1329_cov_17.036585	820	900	2	8	80	0.1000000
NODE_3011_length_1329_cov_17.036585	873	953	0	19	80	0.2375000
NODE_3011_length_1329_cov_17.036585	873	953	2	61	80	0.7625000
NODE_3012_length_1329_cov_16.341463	428	476	19	2	48	0.0416667
NODE_3012_length_1329_cov_16.341463	428	476	21	4	48	0.0833333
NODE_3012_length_1329_cov_16.341463	428	476	22	1	48	0.0208333
NODE_3012_length_1329_cov_16.341463	428	476	24	9	48	0.1875000
NODE_3012_length_1329_cov_16.341463	428	476	26	3	48	0.0625000
NODE_3012_length_1329_cov_16.341463	428	476	27	1	48	0.0208333
NODE_3012_length_1329_cov_16.341463	428	476	28	1	48	0.0208333
NODE_3012_length_1329_cov_16.341463	428	476	31	7	48	0.1458333
NODE_3012_length_1329_cov_16.341463	428	476	33	1	48	0.0208333
NODE_3012_length_1329_cov_16.341463	428	476	35	2	48	0.0416667
NODE_3012_length_1329_cov_16.341463	428	476	41	3	48	0.0625000
NODE_3012_length_1329_cov_16.341463	428	476	43	1	48	0.0208333
NODE_3012_length_1329_cov_16.341463	428	476	44	1	48	0.0208333
NODE_3012_length_1329_cov_16.341463	428	476	47	3	48	0.0625000
NODE_3012_length_1329_cov_16.341463	428	476	49	1	48	0.0208333
NODE_3012_length_1329_cov_16.341463	428	476	52	1	48	0.0208333
NODE_3012_length_1329_cov_16.341463	428	476	58	1	48	0.0208333
NODE_3012_length_1329_cov_16.341463	428	476	59	1	48	0.0208333
NODE_3012_length_1329_cov_16.341463	428	476	60	1	48	0.0208333
NODE_3012_length_1329_cov_16.341463	428	476	62	3	48	0.0625000
NODE_3012_length_1329_cov_16.341463	428	476	64	1	48	0.0208333
NODE_3013_length_1329_cov_5.620325	888	955	0	21	67	0.3134328
NODE_3013_length_1329_cov_5.620325	888	955	2	2	67	0.0298507
NODE_3013_length_1329_cov_5.620325	888	955	6	30	67	0.4477612
NODE_3013_length_1329_cov_5.620325	888	955	7	1	67	0.0149254
NODE_3013_length_1329_cov_5.620325	888	955	8	13	67	0.1940299
NODE_3013_length_1329_cov_5.620325	941	999	7	1	58	0.0172414
NODE_3013_length_1329_cov_5.620325	941	999	8	24	58	0.4137931
NODE_3013_length_1329_cov_5.620325	941	999	10	2	58	0.0344828
NODE_3013_length_1329_cov_5.620325	941	999	11	2	58	0.0344828
NODE_3013_length_1329_cov_5.620325	941	999	12	29	58	0.5000000
NODE_3017_length_1328_cov_12.954434	794	874	0	80	80	1.0000000
NODE_3017_length_1328_cov_12.954434	847	927	0	80	80	1.0000000
NODE_3018_length_1328_cov_8.810415	762	842	2	36	80	0.4500000
NODE_3018_length_1328_cov_8.810415	762	842	3	44	80	0.5500000
NODE_3018_length_1328_cov_8.810415	815	895	0	10	80	0.1250000
NODE_3018_length_1328_cov_8.810415	815	895	2	70	80	0.8750000
NODE_3021_length_1327_cov_15.938925	260	340	0	26	80	0.3250000
NODE_3021_length_1327_cov_15.938925	260	340	6	41	80	0.5125000
NODE_3021_length_1327_cov_15.938925	260	340	8	13	80	0.1625000
NODE_3021_length_1327_cov_15.938925	313	393	0	2	80	0.0250000
NODE_3021_length_1327_cov_15.938925	313	393	2	10	80	0.1250000
NODE_3021_length_1327_cov_15.938925	313	393	6	14	80	0.1750000
NODE_3021_length_1327_cov_15.938925	313	393	7	38	80	0.4750000
NODE_3021_length_1327_cov_15.938925	313	393	8	16	80	0.2000000
NODE_3022_length_1327_cov_7.274430	159	235	0	76	76	1.0000000
NODE_3022_length_1327_cov_7.274430	774	854	0	16	80	0.2000000
NODE_3022_length_1327_cov_7.274430	774	854	2	64	80	0.8000000
NODE_3022_length_1327_cov_7.274430	827	890	0	52	63	0.8253968
NODE_3022_length_1327_cov_7.274430	827	890	2	11	63	0.1746032
NODE_3023_length_1327_cov_6.486156	896	976	0	80	80	1.0000000
NODE_3023_length_1327_cov_6.486156	949	1029	0	80	80	1.0000000
NODE_3029_length_1326_cov_32.382233	571	651	0	68	80	0.8500000
NODE_3029_length_1326_cov_32.382233	571	651	4	6	80	0.0750000
NODE_3029_length_1326_cov_32.382233	571	651	8	6	80	0.0750000
NODE_3029_length_1326_cov_32.382233	624	704	0	15	80	0.1875000
NODE_3029_length_1326_cov_32.382233	624	704	4	6	80	0.0750000
NODE_3029_length_1326_cov_32.382233	624	704	8	59	80	0.7375000
NODE_3030_length_1326_cov_30.614507	760	840	2	12	80	0.1500000
NODE_3030_length_1326_cov_30.614507	760	840	4	42	80	0.5250000
NODE_3030_length_1326_cov_30.614507	760	840	5	13	80	0.1625000
NODE_3030_length_1326_cov_30.614507	760	840	6	13	80	0.1625000
NODE_3030_length_1326_cov_30.614507	813	893	2	15	80	0.1875000
NODE_3030_length_1326_cov_30.614507	813	893	3	5	80	0.0625000
NODE_3030_length_1326_cov_30.614507	813	893	4	1	80	0.0125000
NODE_3030_length_1326_cov_30.614507	813	893	5	30	80	0.3750000
NODE_3030_length_1326_cov_30.614507	813	893	6	29	80	0.3625000
NODE_3031_length_1326_cov_30.304808	488	568	0	3	80	0.0375000
NODE_3031_length_1326_cov_30.304808	488	568	2	13	80	0.1625000
NODE_3031_length_1326_cov_30.304808	488	568	4	64	80	0.8000000
NODE_3031_length_1326_cov_30.304808	541	621	0	56	80	0.7000000
NODE_3031_length_1326_cov_30.304808	541	621	2	13	80	0.1625000
NODE_3031_length_1326_cov_30.304808	541	621	4	11	80	0.1375000
NODE_3031_length_1326_cov_30.304808	617	697	0	55	80	0.6875000
NODE_3031_length_1326_cov_30.304808	617	697	2	25	80	0.3125000
NODE_3031_length_1326_cov_30.304808	670	750	0	2	80	0.0250000
NODE_3031_length_1326_cov_30.304808	670	750	2	78	80	0.9750000
NODE_3032_length_1326_cov_10.913610	238	318	0	80	80	1.0000000
NODE_3032_length_1326_cov_10.913610	291	371	0	80	80	1.0000000
NODE_3036_length_1325_cov_38.136215	0	46	0	46	46	1.0000000
NODE_3036_length_1325_cov_38.136215	19	99	0	77	80	0.9625000
NODE_3036_length_1325_cov_38.136215	19	99	2	3	80	0.0375000
NODE_3036_length_1325_cov_38.136215	948	1022	12	1	74	0.0135135
NODE_3036_length_1325_cov_38.136215	948	1022	14	30	74	0.4054054
NODE_3036_length_1325_cov_38.136215	948	1022	15	30	74	0.4054054
NODE_3036_length_1325_cov_38.136215	948	1022	16	1	74	0.0135135
NODE_3036_length_1325_cov_38.136215	948	1022	17	8	74	0.1081081
NODE_3036_length_1325_cov_38.136215	948	1022	18	3	74	0.0405405
NODE_3036_length_1325_cov_38.136215	948	1022	20	1	74	0.0135135
NODE_3036_length_1325_cov_38.136215	1001	1063	15	11	62	0.1774193
NODE_3036_length_1325_cov_38.136215	1001	1063	16	5	62	0.0806452
NODE_3036_length_1325_cov_38.136215	1001	1063	17	8	62	0.1290323
NODE_3036_length_1325_cov_38.136215	1001	1063	18	14	62	0.2258064
NODE_3036_length_1325_cov_38.136215	1001	1063	20	5	62	0.0806452
NODE_3036_length_1325_cov_38.136215	1001	1063	24	1	62	0.0161290
NODE_3036_length_1325_cov_38.136215	1001	1063	38	2	62	0.0322581
NODE_3036_length_1325_cov_38.136215	1001	1063	42	8	62	0.1290323
NODE_3036_length_1325_cov_38.136215	1001	1063	44	8	62	0.1290323
NODE_3037_length_1325_cov_29.201468	613	693	6	14	80	0.1750000
NODE_3037_length_1325_cov_29.201468	613	693	7	1	80	0.0125000
NODE_3037_length_1325_cov_29.201468	613	693	8	65	80	0.8125000
NODE_3037_length_1325_cov_29.201468	666	746	2	37	80	0.4625000
NODE_3037_length_1325_cov_29.201468	666	746	6	11	80	0.1375000
NODE_3037_length_1325_cov_29.201468	666	746	7	6	80	0.0750000
NODE_3037_length_1325_cov_29.201468	666	746	8	26	80	0.3250000
NODE_3038_length_1325_cov_11.902121	697	777	0	80	80	1.0000000
NODE_3038_length_1325_cov_11.902121	750	830	0	80	80	1.0000000
NODE_3039_length_1325_cov_7.876835	645	725	0	5	80	0.0625000
NODE_3039_length_1325_cov_7.876835	645	725	6	75	80	0.9375000
NODE_3039_length_1325_cov_7.876835	698	778	0	37	80	0.4625000
NODE_3039_length_1325_cov_7.876835	698	778	6	43	80	0.5375000
NODE_3040_length_1325_cov_3.774062	1157	1218	2	14	61	0.2295082
NODE_3040_length_1325_cov_3.774062	1157	1218	4	47	61	0.7704918
NODE_3040_length_1325_cov_3.774062	1191	1271	2	31	80	0.3875000
NODE_3040_length_1325_cov_3.774062	1191	1271	4	49	80	0.6125000
NODE_3041_length_1325_cov_2.896411	0	58	0	4	58	0.0689655
NODE_3041_length_1325_cov_2.896411	0	58	4	1	58	0.0172414
NODE_3041_length_1325_cov_2.896411	0	58	6	10	58	0.1724138
NODE_3041_length_1325_cov_2.896411	0	58	8	5	58	0.0862069
NODE_3041_length_1325_cov_2.896411	0	58	10	5	58	0.0862069
NODE_3041_length_1325_cov_2.896411	0	58	12	2	58	0.0344828
NODE_3041_length_1325_cov_2.896411	0	58	13	5	58	0.0862069
NODE_3041_length_1325_cov_2.896411	0	58	15	1	58	0.0172414
NODE_3041_length_1325_cov_2.896411	0	58	18	16	58	0.2758621
NODE_3041_length_1325_cov_2.896411	0	58	22	9	58	0.1551724
NODE_3041_length_1325_cov_2.896411	8	67	6	7	59	0.1186441
NODE_3041_length_1325_cov_2.896411	8	67	8	5	59	0.0847458
NODE_3041_length_1325_cov_2.896411	8	67	10	5	59	0.0847458
NODE_3041_length_1325_cov_2.896411	8	67	12	2	59	0.0338983
NODE_3041_length_1325_cov_2.896411	8	67	13	5	59	0.0847458
NODE_3041_length_1325_cov_2.896411	8	67	15	1	59	0.0169492
NODE_3041_length_1325_cov_2.896411	8	67	18	16	59	0.2711864
NODE_3041_length_1325_cov_2.896411	8	67	22	18	59	0.3050847
NODE_3046_length_1324_cov_30.340408	939	1019	8	80	80	1.0000000
NODE_3046_length_1324_cov_30.340408	992	1072	6	51	80	0.6375000
NODE_3046_length_1324_cov_30.340408	992	1072	8	29	80	0.3625000
NODE_3047_length_1324_cov_7.391020	742	822	2	35	80	0.4375000
NODE_3047_length_1324_cov_7.391020	742	822	4	40	80	0.5000000
NODE_3047_length_1324_cov_7.391020	742	822	5	4	80	0.0500000
NODE_3047_length_1324_cov_7.391020	742	822	6	1	80	0.0125000
NODE_3047_length_1324_cov_7.391020	795	875	2	20	80	0.2500000
NODE_3047_length_1324_cov_7.391020	795	875	4	42	80	0.5250000
NODE_3047_length_1324_cov_7.391020	795	875	6	8	80	0.1000000
NODE_3047_length_1324_cov_7.391020	795	875	8	10	80	0.1250000
NODE_3053_length_1323_cov_30.600490	392	472	0	80	80	1.0000000
NODE_3053_length_1323_cov_30.600490	445	525	0	80	80	1.0000000
NODE_3053_length_1323_cov_30.600490	521	601	0	63	80	0.7875000
NODE_3053_length_1323_cov_30.600490	521	601	1	1	80	0.0125000
NODE_3053_length_1323_cov_30.600490	521	601	2	2	80	0.0250000
NODE_3053_length_1323_cov_30.600490	521	601	4	14	80	0.1750000
NODE_3053_length_1323_cov_30.600490	574	654	0	10	80	0.1250000
NODE_3053_length_1323_cov_30.600490	574	654	1	1	80	0.0125000
NODE_3053_length_1323_cov_30.600490	574	654	2	2	80	0.0250000
NODE_3053_length_1323_cov_30.600490	574	654	4	67	80	0.8375000
NODE_3054_length_1323_cov_20.888889	758	838	0	70	80	0.8750000
NODE_3054_length_1323_cov_20.888889	758	838	2	10	80	0.1250000
NODE_3054_length_1323_cov_20.888889	811	891	0	80	80	1.0000000
NODE_3061_length_1322_cov_8.988553	287	368	0	43	81	0.5308642
NODE_3061_length_1322_cov_8.988553	287	368	2	38	81	0.4691358
NODE_3061_length_1322_cov_8.988553	341	421	2	80	80	1.0000000
NODE_3061_length_1322_cov_8.988553	417	497	0	52	80	0.6500000
NODE_3061_length_1322_cov_8.988553	417	497	2	28	80	0.3500000
NODE_3061_length_1322_cov_8.988553	470	550	0	80	80	1.0000000
NODE_3068_length_1321_cov_57.885434	359	439	0	80	80	1.0000000
NODE_3068_length_1321_cov_57.885434	412	492	0	80	80	1.0000000
NODE_3068_length_1321_cov_57.885434	488	568	0	80	80	1.0000000
NODE_3068_length_1321_cov_57.885434	541	621	0	80	80	1.0000000
NODE_3071_length_1320_cov_70.753481	432	512	0	15	80	0.1875000
NODE_3071_length_1320_cov_70.753481	432	512	2	65	80	0.8125000
NODE_3071_length_1320_cov_70.753481	485	565	0	20	80	0.2500000
NODE_3071_length_1320_cov_70.753481	485	565	2	60	80	0.7500000
NODE_3071_length_1320_cov_70.753481	561	641	0	59	80	0.7375000
NODE_3071_length_1320_cov_70.753481	561	641	2	21	80	0.2625000
NODE_3071_length_1320_cov_70.753481	614	694	0	10	80	0.1250000
NODE_3071_length_1320_cov_70.753481	614	694	2	70	80	0.8750000
NODE_3072_length_1320_cov_39.149058	715	795	0	22	80	0.2750000
NODE_3072_length_1320_cov_39.149058	715	795	2	41	80	0.5125000
NODE_3072_length_1320_cov_39.149058	715	795	8	17	80	0.2125000
NODE_3072_length_1320_cov_39.149058	768	848	2	10	80	0.1250000
NODE_3072_length_1320_cov_39.149058	768	848	6	30	80	0.3750000
NODE_3072_length_1320_cov_39.149058	768	848	7	13	80	0.1625000
NODE_3072_length_1320_cov_39.149058	768	848	8	27	80	0.3375000
NODE_3072_length_1320_cov_39.149058	844	924	1	16	80	0.2000000
NODE_3072_length_1320_cov_39.149058	844	924	7	64	80	0.8000000
NODE_3072_length_1320_cov_39.149058	897	977	1	66	80	0.8250000
NODE_3072_length_1320_cov_39.149058	897	977	2	3	80	0.0375000
NODE_3072_length_1320_cov_39.149058	897	977	7	11	80	0.1375000
NODE_3073_length_1320_cov_19.175266	707	783	0	76	76	1.0000000
NODE_3073_length_1320_cov_19.175266	760	840	0	80	80	1.0000000
NODE_3074_length_1320_cov_11.224406	860	940	0	80	80	1.0000000
NODE_3074_length_1320_cov_11.224406	913	993	0	80	80	1.0000000
NODE_3075_length_1320_cov_11.036036	760	840	0	27	80	0.3375000
NODE_3075_length_1320_cov_11.036036	760	840	6	53	80	0.6625000
NODE_3075_length_1320_cov_11.036036	813	893	0	20	80	0.2500000
NODE_3075_length_1320_cov_11.036036	813	893	6	60	80	0.7500000
NODE_3076_length_1320_cov_8.357084	800	880	0	3	80	0.0375000
NODE_3076_length_1320_cov_8.357084	800	880	2	35	80	0.4375000
NODE_3076_length_1320_cov_8.357084	800	880	4	30	80	0.3750000
NODE_3076_length_1320_cov_8.357084	800	880	6	1	80	0.0125000
NODE_3076_length_1320_cov_8.357084	800	880	8	11	80	0.1375000
NODE_3076_length_1320_cov_8.357084	853	933	4	38	80	0.4750000
NODE_3076_length_1320_cov_8.357084	853	933	6	31	80	0.3875000
NODE_3076_length_1320_cov_8.357084	853	933	8	11	80	0.1375000
NODE_3080_length_1319_cov_27.098361	630	710	2	78	80	0.9750000
NODE_3080_length_1319_cov_27.098361	630	710	4	2	80	0.0250000
NODE_3080_length_1319_cov_27.098361	683	763	0	37	80	0.4625000
NODE_3080_length_1319_cov_27.098361	683	763	2	41	80	0.5125000
NODE_3080_length_1319_cov_27.098361	683	763	4	2	80	0.0250000
NODE_3081_length_1319_cov_22.992623	490	570	0	26	80	0.3250000
NODE_3081_length_1319_cov_22.992623	490	570	2	5	80	0.0625000
NODE_3081_length_1319_cov_22.992623	490	570	6	46	80	0.5750000
NODE_3081_length_1319_cov_22.992623	490	570	9	3	80	0.0375000
NODE_3081_length_1319_cov_22.992623	543	623	6	24	80	0.3000000
NODE_3081_length_1319_cov_22.992623	543	623	9	22	80	0.2750000
NODE_3081_length_1319_cov_22.992623	543	623	11	1	80	0.0125000
NODE_3081_length_1319_cov_22.992623	543	623	13	24	80	0.3000000
NODE_3081_length_1319_cov_22.992623	543	623	14	9	80	0.1125000
NODE_3086_length_1318_cov_13.624282	642	722	0	80	80	1.0000000
NODE_3086_length_1318_cov_13.624282	695	775	0	80	80	1.0000000
NODE_3086_length_1318_cov_13.624282	771	851	0	80	80	1.0000000
NODE_3086_length_1318_cov_13.624282	824	904	0	80	80	1.0000000
NODE_3089_length_1317_cov_162.041872	66	143	0	5	77	0.0649351
NODE_3089_length_1317_cov_162.041872	66	143	2	10	77	0.1298701
NODE_3089_length_1317_cov_162.041872	66	143	4	5	77	0.0649351
NODE_3089_length_1317_cov_162.041872	66	143	5	2	77	0.0259740
NODE_3089_length_1317_cov_162.041872	66	143	6	2	77	0.0259740
NODE_3089_length_1317_cov_162.041872	66	143	8	11	77	0.1428571
NODE_3089_length_1317_cov_162.041872	66	143	10	39	77	0.5064935
NODE_3089_length_1317_cov_162.041872	66	143	37	1	77	0.0129870
NODE_3089_length_1317_cov_162.041872	66	143	61	1	77	0.0129870
NODE_3089_length_1317_cov_162.041872	66	143	92	1	77	0.0129870
NODE_3090_length_1317_cov_19.736453	675	755	0	4	80	0.0500000
NODE_3090_length_1317_cov_19.736453	675	755	2	76	80	0.9500000
NODE_3090_length_1317_cov_19.736453	728	808	0	42	80	0.5250000
NODE_3090_length_1317_cov_19.736453	728	808	2	38	80	0.4750000
NODE_3090_length_1317_cov_19.736453	804	884	0	13	80	0.1625000
NODE_3090_length_1317_cov_19.736453	804	884	2	19	80	0.2375000
NODE_3090_length_1317_cov_19.736453	804	884	4	37	80	0.4625000
NODE_3090_length_1317_cov_19.736453	804	884	10	11	80	0.1375000
NODE_3090_length_1317_cov_19.736453	857	937	4	16	80	0.2000000
NODE_3090_length_1317_cov_19.736453	857	937	6	2	80	0.0250000
NODE_3090_length_1317_cov_19.736453	857	937	8	19	80	0.2375000
NODE_3090_length_1317_cov_19.736453	857	937	10	43	80	0.5375000
NODE_3092_length_1317_cov_2.203612	779	859	2	5	80	0.0625000
NODE_3092_length_1317_cov_2.203612	779	859	4	2	80	0.0250000
NODE_3092_length_1317_cov_2.203612	779	859	11	11	80	0.1375000
NODE_3092_length_1317_cov_2.203612	779	859	13	14	80	0.1750000
NODE_3092_length_1317_cov_2.203612	779	859	14	27	80	0.3375000
NODE_3092_length_1317_cov_2.203612	779	859	16	21	80	0.2625000
NODE_3095_length_1316_cov_25.377157	557	637	0	80	80	1.0000000
NODE_3095_length_1316_cov_25.377157	610	690	0	48	80	0.6000000
NODE_3095_length_1316_cov_25.377157	610	690	2	32	80	0.4000000
NODE_3096_length_1316_cov_15.891537	446	526	2	80	80	1.0000000
NODE_3096_length_1316_cov_15.891537	499	579	0	49	80	0.6125000
NODE_3096_length_1316_cov_15.891537	499	579	2	31	80	0.3875000
NODE_3096_length_1316_cov_15.891537	575	655	0	80	80	1.0000000
NODE_3096_length_1316_cov_15.891537	628	708	0	80	80	1.0000000
NODE_3101_length_1315_cov_24.136513	592	672	0	80	80	1.0000000
NODE_3101_length_1315_cov_24.136513	645	725	0	80	80	1.0000000
NODE_3105_length_1314_cov_38.391770	647	727	0	47	80	0.5875000
NODE_3105_length_1314_cov_38.391770	647	727	2	33	80	0.4125000
NODE_3105_length_1314_cov_38.391770	700	780	0	80	80	1.0000000
NODE_3105_length_1314_cov_38.391770	776	856	0	80	80	1.0000000
NODE_3105_length_1314_cov_38.391770	829	909	0	80	80	1.0000000
NODE_3106_length_1314_cov_30.167078	736	816	0	28	80	0.3500000
NODE_3106_length_1314_cov_30.167078	736	816	2	52	80	0.6500000
NODE_3106_length_1314_cov_30.167078	789	869	0	32	80	0.4000000
NODE_3106_length_1314_cov_30.167078	789	869	2	48	80	0.6000000
NODE_3107_length_1314_cov_11.221399	523	603	0	80	80	1.0000000
NODE_3107_length_1314_cov_11.221399	576	656	0	80	80	1.0000000
NODE_3114_length_1313_cov_29.315486	463	543	0	80	80	1.0000000
NODE_3114_length_1313_cov_29.315486	516	596	0	80	80	1.0000000
NODE_3115_length_1313_cov_25.144975	709	789	0	13	80	0.1625000
NODE_3115_length_1313_cov_25.144975	709	789	3	1	80	0.0125000
NODE_3115_length_1313_cov_25.144975	709	789	4	48	80	0.6000000
NODE_3115_length_1313_cov_25.144975	709	789	6	18	80	0.2250000
NODE_3115_length_1313_cov_25.144975	762	842	2	46	80	0.5750000
NODE_3115_length_1313_cov_25.144975	762	842	4	9	80	0.1125000
NODE_3115_length_1313_cov_25.144975	762	842	6	25	80	0.3125000
NODE_3115_length_1313_cov_25.144975	838	918	2	6	80	0.0750000
NODE_3115_length_1313_cov_25.144975	838	918	4	42	80	0.5250000
NODE_3115_length_1313_cov_25.144975	838	918	6	32	80	0.4000000
NODE_3115_length_1313_cov_25.144975	891	971	0	19	80	0.2375000
NODE_3115_length_1313_cov_25.144975	891	971	2	8	80	0.1000000
NODE_3115_length_1313_cov_25.144975	891	971	4	43	80	0.5375000
NODE_3115_length_1313_cov_25.144975	891	971	6	10	80	0.1250000
NODE_3118_length_1312_cov_20.378401	138	218	0	29	80	0.3625000
NODE_3118_length_1312_cov_20.378401	138	218	4	51	80	0.6375000
NODE_3118_length_1312_cov_20.378401	191	271	0	5	80	0.0625000
NODE_3118_length_1312_cov_20.378401	191	271	4	75	80	0.9375000
NODE_3121_length_1311_cov_38.468647	584	664	2	44	80	0.5500000
NODE_3121_length_1311_cov_38.468647	584	664	4	36	80	0.4500000
NODE_3121_length_1311_cov_38.468647	637	717	2	2	80	0.0250000
NODE_3121_length_1311_cov_38.468647	637	717	4	45	80	0.5625000
NODE_3121_length_1311_cov_38.468647	637	717	6	33	80	0.4125000
NODE_3121_length_1311_cov_38.468647	713	793	2	53	80	0.6625000
NODE_3121_length_1311_cov_38.468647	713	793	4	5	80	0.0625000
NODE_3121_length_1311_cov_38.468647	713	793	6	22	80	0.2750000
NODE_3121_length_1311_cov_38.468647	766	846	0	51	80	0.6375000
NODE_3121_length_1311_cov_38.468647	766	846	2	29	80	0.3625000
NODE_3125_length_1310_cov_37.739884	679	759	0	77	80	0.9625000
NODE_3125_length_1310_cov_37.739884	679	759	2	3	80	0.0375000
NODE_3125_length_1310_cov_37.739884	683	763	0	73	80	0.9125000
NODE_3125_length_1310_cov_37.739884	683	763	2	7	80	0.0875000
NODE_3125_length_1310_cov_37.739884	732	816	0	34	84	0.4047619
NODE_3125_length_1310_cov_37.739884	732	816	2	50	84	0.5952381
NODE_3125_length_1310_cov_37.739884	736	816	0	30	80	0.3750000
NODE_3125_length_1310_cov_37.739884	736	816	2	50	80	0.6250000
NODE_3125_length_1310_cov_37.739884	812	892	0	22	80	0.2750000
NODE_3125_length_1310_cov_37.739884	812	892	3	1	80	0.0125000
NODE_3125_length_1310_cov_37.739884	812	892	4	23	80	0.2875000
NODE_3125_length_1310_cov_37.739884	812	892	6	5	80	0.0625000
NODE_3125_length_1310_cov_37.739884	812	892	8	1	80	0.0125000
NODE_3125_length_1310_cov_37.739884	812	892	13	28	80	0.3500000
NODE_3125_length_1310_cov_37.739884	865	945	11	19	80	0.2375000
NODE_3125_length_1310_cov_37.739884	865	945	13	56	80	0.7000000
NODE_3125_length_1310_cov_37.739884	865	945	14	1	80	0.0125000
NODE_3125_length_1310_cov_37.739884	865	945	15	3	80	0.0375000
NODE_3125_length_1310_cov_37.739884	865	945	17	1	80	0.0125000
NODE_3126_length_1310_cov_12.245252	615	695	0	1	80	0.0125000
NODE_3126_length_1310_cov_12.245252	615	695	2	17	80	0.2125000
NODE_3126_length_1310_cov_12.245252	615	695	4	62	80	0.7750000
NODE_3126_length_1310_cov_12.245252	668	748	0	24	80	0.3000000
NODE_3126_length_1310_cov_12.245252	668	748	2	7	80	0.0875000
NODE_3126_length_1310_cov_12.245252	668	748	4	49	80	0.6125000
NODE_3127_length_1310_cov_10.184971	422	502	0	80	80	1.0000000
NODE_3127_length_1310_cov_10.184971	475	555	0	80	80	1.0000000
NODE_3128_length_1310_cov_3.186623	876	956	0	80	80	1.0000000
NODE_3128_length_1310_cov_3.186623	929	1009	0	80	80	1.0000000
NODE_3131_length_1310_cov_0.757225	1255	1310	0	9	55	0.1636364
NODE_3131_length_1310_cov_0.757225	1255	1310	4	11	55	0.2000000
NODE_3131_length_1310_cov_0.757225	1255	1310	6	4	55	0.0727273
NODE_3131_length_1310_cov_0.757225	1255	1310	8	9	55	0.1636364
NODE_3131_length_1310_cov_0.757225	1255	1310	10	3	55	0.0545455
NODE_3131_length_1310_cov_0.757225	1255	1310	12	16	55	0.2909091
NODE_3131_length_1310_cov_0.757225	1255	1310	14	3	55	0.0545455
NODE_3132_length_1309_cov_34.942149	474	554	0	80	80	1.0000000
NODE_3132_length_1309_cov_34.942149	527	607	0	80	80	1.0000000
NODE_3132_length_1309_cov_34.942149	603	683	0	80	80	1.0000000
NODE_3132_length_1309_cov_34.942149	656	736	0	80	80	1.0000000
NODE_3133_length_1309_cov_10.571074	839	921	0	22	82	0.2682927
NODE_3133_length_1309_cov_10.571074	839	921	2	16	82	0.1951219
NODE_3133_length_1309_cov_10.571074	839	921	4	17	82	0.2073171
NODE_3133_length_1309_cov_10.571074	839	921	6	27	82	0.3292683
NODE_3133_length_1309_cov_10.571074	894	974	2	23	80	0.2875000
NODE_3133_length_1309_cov_10.571074	894	974	4	3	80	0.0375000
NODE_3133_length_1309_cov_10.571074	894	974	6	54	80	0.6750000
NODE_3135_length_1308_cov_43.461538	330	410	2	67	80	0.8375000
NODE_3135_length_1308_cov_43.461538	330	410	4	13	80	0.1625000
NODE_3135_length_1308_cov_43.461538	383	463	0	6	80	0.0750000
NODE_3135_length_1308_cov_43.461538	383	463	2	62	80	0.7750000
NODE_3135_length_1308_cov_43.461538	383	463	4	12	80	0.1500000
NODE_3145_length_1307_cov_11.290563	595	673	0	78	78	1.0000000
NODE_3145_length_1307_cov_11.290563	646	726	0	80	80	1.0000000
NODE_3146_length_1307_cov_8.653146	430	510	0	80	80	1.0000000
NODE_3146_length_1307_cov_8.653146	483	563	0	80	80	1.0000000
NODE_3153_length_1306_cov_26.813587	369	449	0	1	80	0.0125000
NODE_3153_length_1306_cov_26.813587	369	449	7	1	80	0.0125000
NODE_3153_length_1306_cov_26.813587	369	449	8	78	80	0.9750000
NODE_3153_length_1306_cov_26.813587	422	502	0	25	80	0.3125000
NODE_3153_length_1306_cov_26.813587	422	502	2	29	80	0.3625000
NODE_3153_length_1306_cov_26.813587	422	502	7	1	80	0.0125000
NODE_3153_length_1306_cov_26.813587	422	502	8	25	80	0.3125000
NODE_3153_length_1306_cov_26.813587	498	578	2	12	80	0.1500000
NODE_3153_length_1306_cov_26.813587	498	578	4	39	80	0.4875000
NODE_3153_length_1306_cov_26.813587	498	578	6	21	80	0.2625000
NODE_3153_length_1306_cov_26.813587	498	578	7	1	80	0.0125000
NODE_3153_length_1306_cov_26.813587	498	578	8	7	80	0.0875000
NODE_3153_length_1306_cov_26.813587	551	631	6	68	80	0.8500000
NODE_3153_length_1306_cov_26.813587	551	631	8	12	80	0.1500000
NODE_3154_length_1306_cov_24.904722	634	714	0	80	80	1.0000000
NODE_3154_length_1306_cov_24.904722	687	767	0	80	80	1.0000000
NODE_3155_length_1306_cov_18.274234	388	468	0	80	80	1.0000000
NODE_3155_length_1306_cov_18.274234	441	521	0	80	80	1.0000000
NODE_3156_length_1306_cov_15.176471	1214	1294	0	80	80	1.0000000
NODE_3157_length_1306_cov_12.699254	458	538	0	47	80	0.5875000
NODE_3157_length_1306_cov_12.699254	458	538	2	33	80	0.4125000
NODE_3157_length_1306_cov_12.699254	511	591	2	80	80	1.0000000
NODE_3158_length_1306_cov_9.958575	630	710	0	61	80	0.7625000
NODE_3158_length_1306_cov_9.958575	630	710	2	19	80	0.2375000
NODE_3158_length_1306_cov_9.958575	683	764	0	81	81	1.0000000
NODE_3159_length_1306_cov_2.739851	1206	1246	0	40	40	1.0000000
NODE_3168_length_1304_cov_28.444813	511	591	0	80	80	1.0000000
NODE_3168_length_1304_cov_28.444813	564	644	0	80	80	1.0000000
NODE_3168_length_1304_cov_28.444813	640	720	0	46	80	0.5750000
NODE_3168_length_1304_cov_28.444813	640	720	2	13	80	0.1625000
NODE_3168_length_1304_cov_28.444813	640	720	4	8	80	0.1000000
NODE_3168_length_1304_cov_28.444813	640	720	6	13	80	0.1625000
NODE_3168_length_1304_cov_28.444813	693	773	2	6	80	0.0750000
NODE_3168_length_1304_cov_28.444813	693	773	4	22	80	0.2750000
NODE_3168_length_1304_cov_28.444813	693	773	5	1	80	0.0125000
NODE_3168_length_1304_cov_28.444813	693	773	6	51	80	0.6375000
NODE_3169_length_1304_cov_27.137759	575	655	0	80	80	1.0000000
NODE_3169_length_1304_cov_27.137759	628	708	0	80	80	1.0000000
NODE_3169_length_1304_cov_27.137759	704	784	0	23	80	0.2875000
NODE_3169_length_1304_cov_27.137759	704	784	4	6	80	0.0750000
NODE_3169_length_1304_cov_27.137759	704	784	9	1	80	0.0125000
NODE_3169_length_1304_cov_27.137759	704	784	10	31	80	0.3875000
NODE_3169_length_1304_cov_27.137759	704	784	12	19	80	0.2375000
NODE_3169_length_1304_cov_27.137759	757	837	2	11	80	0.1375000
NODE_3169_length_1304_cov_27.137759	757	837	7	1	80	0.0125000
NODE_3169_length_1304_cov_27.137759	757	837	8	28	80	0.3500000
NODE_3169_length_1304_cov_27.137759	757	837	10	8	80	0.1000000
NODE_3169_length_1304_cov_27.137759	757	837	12	32	80	0.4000000
NODE_3171_length_1303_cov_36.546512	458	538	2	7	80	0.0875000
NODE_3171_length_1303_cov_36.546512	458	538	4	31	80	0.3875000
NODE_3171_length_1303_cov_36.546512	458	538	6	42	80	0.5250000
NODE_3171_length_1303_cov_36.546512	511	591	2	27	80	0.3375000
NODE_3171_length_1303_cov_36.546512	511	591	4	15	80	0.1875000
NODE_3171_length_1303_cov_36.546512	511	591	6	38	80	0.4750000
NODE_3171_length_1303_cov_36.546512	587	667	2	60	80	0.7500000
NODE_3171_length_1303_cov_36.546512	587	667	4	11	80	0.1375000
NODE_3171_length_1303_cov_36.546512	587	667	6	9	80	0.1125000
NODE_3171_length_1303_cov_36.546512	640	720	2	78	80	0.9750000
NODE_3171_length_1303_cov_36.546512	640	720	4	2	80	0.0250000
NODE_3174_length_1302_cov_22.265170	747	827	0	80	80	1.0000000
NODE_3174_length_1302_cov_22.265170	800	880	0	80	80	1.0000000
NODE_3175_length_1302_cov_16.199501	480	560	0	80	80	1.0000000
NODE_3175_length_1302_cov_16.199501	533	613	0	80	80	1.0000000
NODE_3176_length_1302_cov_6.953450	687	767	0	10	80	0.1250000
NODE_3176_length_1302_cov_6.953450	687	767	2	70	80	0.8750000
NODE_3176_length_1302_cov_6.953450	740	820	0	11	80	0.1375000
NODE_3176_length_1302_cov_6.953450	740	820	2	69	80	0.8625000
NODE_3179_length_1301_cov_31.711314	401	481	0	6	80	0.0750000
NODE_3179_length_1301_cov_31.711314	401	481	7	3	80	0.0375000
NODE_3179_length_1301_cov_31.711314	401	481	8	71	80	0.8875000
NODE_3179_length_1301_cov_31.711314	454	534	0	16	80	0.2000000
NODE_3179_length_1301_cov_31.711314	454	534	8	64	80	0.8000000
NODE_3181_length_1301_cov_5.529950	246	326	0	20	80	0.2500000
NODE_3181_length_1301_cov_5.529950	246	326	2	60	80	0.7500000
NODE_3181_length_1301_cov_5.529950	299	379	0	48	80	0.6000000
NODE_3181_length_1301_cov_5.529950	299	379	2	32	80	0.4000000
NODE_3186_length_1300_cov_39.109908	602	682	6	80	80	1.0000000
NODE_3186_length_1300_cov_39.109908	655	735	0	23	80	0.2875000
NODE_3186_length_1300_cov_39.109908	655	735	6	57	80	0.7125000
NODE_3187_length_1300_cov_34.360533	586	666	0	80	80	1.0000000
NODE_3187_length_1300_cov_34.360533	639	719	0	80	80	1.0000000
NODE_3188_length_1300_cov_4.659450	454	535	0	29	81	0.3580247
NODE_3188_length_1300_cov_4.659450	454	535	2	52	81	0.6419753
NODE_3188_length_1300_cov_4.659450	508	588	2	80	80	1.0000000
NODE_3189_length_1299_cov_29.071667	452	532	8	2	80	0.0250000
NODE_3189_length_1299_cov_29.071667	452	532	12	7	80	0.0875000
NODE_3189_length_1299_cov_29.071667	452	532	14	2	80	0.0250000
NODE_3189_length_1299_cov_29.071667	452	532	18	6	80	0.0750000
NODE_3189_length_1299_cov_29.071667	452	532	22	10	80	0.1250000
NODE_3189_length_1299_cov_29.071667	452	532	24	9	80	0.1125000
NODE_3189_length_1299_cov_29.071667	452	532	26	12	80	0.1500000
NODE_3189_length_1299_cov_29.071667	452	532	28	12	80	0.1500000
NODE_3189_length_1299_cov_29.071667	452	532	30	20	80	0.2500000
NODE_3190_length_1299_cov_23.600833	818	898	0	26	80	0.3250000
NODE_3190_length_1299_cov_23.600833	818	898	2	14	80	0.1750000
NODE_3190_length_1299_cov_23.600833	818	898	9	1	80	0.0125000
NODE_3190_length_1299_cov_23.600833	818	898	10	39	80	0.4875000
NODE_3190_length_1299_cov_23.600833	871	951	8	4	80	0.0500000
NODE_3190_length_1299_cov_23.600833	871	951	10	76	80	0.9500000
NODE_3191_length_1299_cov_23.169167	625	705	0	52	80	0.6500000
NODE_3191_length_1299_cov_23.169167	625	705	2	28	80	0.3500000
NODE_3191_length_1299_cov_23.169167	678	758	2	80	80	1.0000000
NODE_3191_length_1299_cov_23.169167	754	834	0	49	80	0.6125000
NODE_3191_length_1299_cov_23.169167	754	834	2	31	80	0.3875000
NODE_3191_length_1299_cov_23.169167	807	887	0	80	80	1.0000000
NODE_3192_length_1299_cov_19.315000	306	386	0	2	80	0.0250000
NODE_3192_length_1299_cov_19.315000	306	386	2	78	80	0.9750000
NODE_3192_length_1299_cov_19.315000	359	439	0	47	80	0.5875000
NODE_3192_length_1299_cov_19.315000	359	439	1	2	80	0.0250000
NODE_3192_length_1299_cov_19.315000	359	439	2	31	80	0.3875000
NODE_3192_length_1299_cov_19.315000	435	515	0	2	80	0.0250000
NODE_3192_length_1299_cov_19.315000	435	515	1	10	80	0.1250000
NODE_3192_length_1299_cov_19.315000	435	515	2	68	80	0.8500000
NODE_3192_length_1299_cov_19.315000	488	568	2	80	80	1.0000000
NODE_3193_length_1299_cov_13.691667	540	620	0	68	80	0.8500000
NODE_3193_length_1299_cov_13.691667	540	620	2	12	80	0.1500000
NODE_3193_length_1299_cov_13.691667	593	673	0	15	80	0.1875000
NODE_3193_length_1299_cov_13.691667	593	673	2	65	80	0.8125000
NODE_3195_length_1298_cov_58.277731	679	759	12	80	80	1.0000000
NODE_3195_length_1298_cov_58.277731	732	812	0	8	80	0.1000000
NODE_3195_length_1298_cov_58.277731	732	812	12	72	80	0.9000000
NODE_3195_length_1298_cov_58.277731	808	888	0	80	80	1.0000000
NODE_3195_length_1298_cov_58.277731	861	941	0	80	80	1.0000000
NODE_3196_length_1298_cov_31.319433	375	455	0	80	80	1.0000000
NODE_3196_length_1298_cov_31.319433	428	508	0	80	80	1.0000000
NODE_3196_length_1298_cov_31.319433	504	584	0	80	80	1.0000000
NODE_3196_length_1298_cov_31.319433	557	637	0	80	80	1.0000000
NODE_3197_length_1298_cov_2.158465	294	360	2	66	66	1.0000000
NODE_3201_length_1296_cov_34.778613	620	700	0	80	80	1.0000000
NODE_3201_length_1296_cov_34.778613	673	753	0	27	80	0.3375000
NODE_3201_length_1296_cov_34.778613	673	753	2	53	80	0.6625000
NODE_3202_length_1296_cov_28.726817	671	751	0	80	80	1.0000000
NODE_3202_length_1296_cov_28.726817	724	804	0	80	80	1.0000000
NODE_3202_length_1296_cov_28.726817	800	880	0	80	80	1.0000000
NODE_3202_length_1296_cov_28.726817	853	933	0	80	80	1.0000000
NODE_3205_length_1295_cov_10.661371	818	898	0	80	80	1.0000000
NODE_3205_length_1295_cov_10.661371	871	951	0	80	80	1.0000000
NODE_3211_length_1294_cov_15.098745	353	433	0	24	80	0.3000000
NODE_3211_length_1294_cov_15.098745	353	433	2	56	80	0.7000000
NODE_3211_length_1294_cov_15.098745	406	486	0	17	80	0.2125000
NODE_3211_length_1294_cov_15.098745	406	486	2	63	80	0.7875000
NODE_3216_length_1293_cov_26.580402	595	675	0	36	80	0.4500000
NODE_3216_length_1293_cov_26.580402	595	675	2	44	80	0.5500000
NODE_3216_length_1293_cov_26.580402	648	728	0	25	80	0.3125000
NODE_3216_length_1293_cov_26.580402	648	728	2	55	80	0.6875000
NODE_3216_length_1293_cov_26.580402	724	804	0	80	80	1.0000000
NODE_3216_length_1293_cov_26.580402	777	857	0	80	80	1.0000000
NODE_3217_length_1293_cov_9.252094	1187	1207	0	20	20	1.0000000
NODE_3220_length_1293_cov_2.118090	1131	1195	2	64	64	1.0000000
NODE_3220_length_1293_cov_2.118090	1184	1248	0	7	64	0.1093750
NODE_3220_length_1293_cov_2.118090	1184	1248	2	57	64	0.8906250
NODE_3224_length_1292_cov_50.158424	402	482	4	33	80	0.4125000
NODE_3224_length_1292_cov_50.158424	402	482	6	24	80	0.3000000
NODE_3224_length_1292_cov_50.158424	402	482	8	23	80	0.2875000
NODE_3224_length_1292_cov_50.158424	455	535	2	14	80	0.1750000
NODE_3224_length_1292_cov_50.158424	455	535	4	3	80	0.0375000
NODE_3224_length_1292_cov_50.158424	455	535	6	63	80	0.7875000
NODE_3224_length_1292_cov_50.158424	531	611	2	8	80	0.1000000
NODE_3224_length_1292_cov_50.158424	531	611	4	44	80	0.5500000
NODE_3224_length_1292_cov_50.158424	531	611	6	28	80	0.3500000
NODE_3224_length_1292_cov_50.158424	584	664	4	58	80	0.7250000
NODE_3224_length_1292_cov_50.158424	584	664	6	22	80	0.2750000
NODE_3225_length_1292_cov_36.535624	670	750	0	53	80	0.6625000
NODE_3225_length_1292_cov_36.535624	670	750	6	27	80	0.3375000
NODE_3225_length_1292_cov_36.535624	723	803	6	53	80	0.6625000
NODE_3225_length_1292_cov_36.535624	723	803	8	27	80	0.3375000
NODE_3226_length_1292_cov_24.523889	420	500	0	16	80	0.2000000
NODE_3226_length_1292_cov_24.523889	420	500	2	64	80	0.8000000
NODE_3226_length_1292_cov_24.523889	473	553	0	18	80	0.2250000
NODE_3226_length_1292_cov_24.523889	473	553	2	62	80	0.7750000
NODE_3232_length_1291_cov_8.734060	623	703	2	22	80	0.2750000
NODE_3232_length_1291_cov_8.734060	623	703	4	58	80	0.7250000
NODE_3232_length_1291_cov_8.734060	676	756	0	40	80	0.5000000
NODE_3232_length_1291_cov_8.734060	676	756	2	1	80	0.0125000
NODE_3232_length_1291_cov_8.734060	676	756	4	39	80	0.4875000
NODE_3233_length_1291_cov_8.625839	756	836	0	80	80	1.0000000
NODE_3233_length_1291_cov_8.625839	809	889	0	80	80	1.0000000
NODE_3236_length_1290_cov_24.120067	497	577	0	80	80	1.0000000
NODE_3236_length_1290_cov_24.120067	550	630	0	80	80	1.0000000
NODE_3236_length_1290_cov_24.120067	626	706	0	15	80	0.1875000
NODE_3236_length_1290_cov_24.120067	626	706	2	65	80	0.8125000
NODE_3236_length_1290_cov_24.120067	679	759	2	80	80	1.0000000
NODE_3237_length_1290_cov_18.874895	671	751	0	80	80	1.0000000
NODE_3237_length_1290_cov_18.874895	724	804	0	80	80	1.0000000
NODE_3238_length_1290_cov_11.627204	573	653	0	80	80	1.0000000
NODE_3238_length_1290_cov_11.627204	626	706	0	80	80	1.0000000
NODE_3239_length_1290_cov_11.215785	373	453	0	45	80	0.5625000
NODE_3239_length_1290_cov_11.215785	373	453	2	35	80	0.4375000
NODE_3239_length_1290_cov_11.215785	426	506	2	37	80	0.4625000
NODE_3239_length_1290_cov_11.215785	426	506	4	43	80	0.5375000
NODE_3240_length_1290_cov_8.752309	788	868	0	43	80	0.5375000
NODE_3240_length_1290_cov_8.752309	788	868	2	37	80	0.4625000
NODE_3240_length_1290_cov_8.752309	841	921	0	11	80	0.1375000
NODE_3240_length_1290_cov_8.752309	841	921	2	69	80	0.8625000
NODE_3242_length_1289_cov_47.476471	919	999	12	12	80	0.1500000
NODE_3242_length_1289_cov_47.476471	919	999	14	68	80	0.8500000
NODE_3242_length_1289_cov_47.476471	972	1052	0	23	80	0.2875000
NODE_3242_length_1289_cov_47.476471	972	1052	2	18	80	0.2250000
NODE_3242_length_1289_cov_47.476471	972	1052	12	19	80	0.2375000
NODE_3242_length_1289_cov_47.476471	972	1052	14	20	80	0.2500000
NODE_3243_length_1289_cov_18.497479	688	768	0	80	80	1.0000000
NODE_3243_length_1289_cov_18.497479	741	821	0	80	80	1.0000000
NODE_3243_length_1289_cov_18.497479	817	893	0	76	76	1.0000000
NODE_3243_length_1289_cov_18.497479	878	958	0	80	80	1.0000000
NODE_3244_length_1289_cov_11.692437	574	654	0	16	80	0.2000000
NODE_3244_length_1289_cov_11.692437	574	654	2	64	80	0.8000000
NODE_3244_length_1289_cov_11.692437	627	707	0	69	80	0.8625000
NODE_3244_length_1289_cov_11.692437	627	707	2	11	80	0.1375000
NODE_3244_length_1289_cov_11.692437	703	783	0	49	80	0.6125000
NODE_3244_length_1289_cov_11.692437	703	783	2	31	80	0.3875000
NODE_3244_length_1289_cov_11.692437	756	836	0	6	80	0.0750000
NODE_3244_length_1289_cov_11.692437	756	836	2	74	80	0.9250000
NODE_3249_length_1288_cov_29.369218	711	791	0	62	80	0.7750000
NODE_3249_length_1288_cov_29.369218	711	791	4	18	80	0.2250000
NODE_3249_length_1288_cov_29.369218	764	844	0	9	80	0.1125000
NODE_3249_length_1288_cov_29.369218	764	844	4	71	80	0.8875000
NODE_3250_length_1288_cov_6.207738	735	815	0	20	80	0.2500000
NODE_3250_length_1288_cov_6.207738	735	815	4	60	80	0.7500000
NODE_3250_length_1288_cov_6.207738	788	868	0	11	80	0.1375000
NODE_3250_length_1288_cov_6.207738	788	868	4	69	80	0.8625000
NODE_3255_length_1288_cov_1.731707	1017	1095	0	7	78	0.0897436
NODE_3255_length_1288_cov_1.731707	1017	1095	2	5	78	0.0641026
NODE_3255_length_1288_cov_1.731707	1017	1095	4	25	78	0.3205128
NODE_3255_length_1288_cov_1.731707	1017	1095	7	6	78	0.0769231
NODE_3255_length_1288_cov_1.731707	1017	1095	8	12	78	0.1538462
NODE_3255_length_1288_cov_1.731707	1017	1095	9	23	78	0.2948718
NODE_3261_length_1287_cov_29.186027	730	810	0	80	80	1.0000000
NODE_3261_length_1287_cov_29.186027	783	863	0	80	80	1.0000000
NODE_3262_length_1287_cov_22.747475	168	248	0	80	80	1.0000000
NODE_3262_length_1287_cov_22.747475	221	301	0	80	80	1.0000000
NODE_3263_length_1287_cov_19.478956	575	655	0	80	80	1.0000000
NODE_3263_length_1287_cov_19.478956	628	708	0	80	80	1.0000000
NODE_3266_length_1286_cov_27.128054	428	508	0	46	80	0.5750000
NODE_3266_length_1286_cov_27.128054	428	508	2	34	80	0.4250000
NODE_3266_length_1286_cov_27.128054	481	561	0	37	80	0.4625000
NODE_3266_length_1286_cov_27.128054	481	561	2	43	80	0.5375000
NODE_3266_length_1286_cov_27.128054	557	637	2	48	80	0.6000000
NODE_3266_length_1286_cov_27.128054	557	637	4	13	80	0.1625000
NODE_3266_length_1286_cov_27.128054	557	637	5	8	80	0.1000000
NODE_3266_length_1286_cov_27.128054	557	637	10	3	80	0.0375000
NODE_3266_length_1286_cov_27.128054	557	637	11	2	80	0.0250000
NODE_3266_length_1286_cov_27.128054	557	637	12	6	80	0.0750000
NODE_3266_length_1286_cov_27.128054	610	690	4	8	80	0.1000000
NODE_3266_length_1286_cov_27.128054	610	690	5	8	80	0.1000000
NODE_3266_length_1286_cov_27.128054	610	690	10	20	80	0.2500000
NODE_3266_length_1286_cov_27.128054	610	690	11	2	80	0.0250000
NODE_3266_length_1286_cov_27.128054	610	690	12	6	80	0.0750000
NODE_3266_length_1286_cov_27.128054	610	690	14	7	80	0.0875000
NODE_3266_length_1286_cov_27.128054	610	690	16	29	80	0.3625000
NODE_3267_length_1286_cov_12.192081	647	727	0	80	80	1.0000000
NODE_3267_length_1286_cov_12.192081	700	780	0	80	80	1.0000000
NODE_3267_length_1286_cov_12.192081	776	856	0	80	80	1.0000000
NODE_3267_length_1286_cov_12.192081	829	909	0	80	80	1.0000000
NODE_3268_length_1286_cov_8.338669	577	657	0	80	80	1.0000000
NODE_3268_length_1286_cov_8.338669	630	710	0	80	80	1.0000000
NODE_3273_length_1285_cov_40.282462	751	831	0	9	80	0.1125000
NODE_3273_length_1285_cov_40.282462	751	831	6	4	80	0.0500000
NODE_3273_length_1285_cov_40.282462	751	831	10	3	80	0.0375000
NODE_3273_length_1285_cov_40.282462	751	831	11	58	80	0.7250000
NODE_3273_length_1285_cov_40.282462	751	831	12	1	80	0.0125000
NODE_3273_length_1285_cov_40.282462	751	831	13	5	80	0.0625000
NODE_3273_length_1285_cov_40.282462	804	884	10	3	80	0.0375000
NODE_3273_length_1285_cov_40.282462	804	884	11	18	80	0.2250000
NODE_3273_length_1285_cov_40.282462	804	884	12	2	80	0.0250000
NODE_3273_length_1285_cov_40.282462	804	884	13	57	80	0.7125000
NODE_3274_length_1285_cov_15.422428	647	727	2	8	80	0.1000000
NODE_3274_length_1285_cov_15.422428	647	727	8	13	80	0.1625000
NODE_3274_length_1285_cov_15.422428	647	727	10	59	80	0.7375000
NODE_3274_length_1285_cov_15.422428	700	780	8	11	80	0.1375000
NODE_3274_length_1285_cov_15.422428	700	780	10	69	80	0.8625000
NODE_3275_length_1285_cov_6.620573	589	669	0	13	80	0.1625000
NODE_3275_length_1285_cov_6.620573	589	669	6	67	80	0.8375000
NODE_3275_length_1285_cov_6.620573	642	722	6	80	80	1.0000000
NODE_3279_length_1284_cov_5.637975	294	374	0	80	80	1.0000000
NODE_3279_length_1284_cov_5.637975	347	427	0	80	80	1.0000000
NODE_3283_length_1283_cov_10.070101	408	488	2	9	80	0.1125000
NODE_3283_length_1283_cov_10.070101	408	488	4	30	80	0.3750000
NODE_3283_length_1283_cov_10.070101	408	488	6	30	80	0.3750000
NODE_3283_length_1283_cov_10.070101	408	488	10	4	80	0.0500000
NODE_3283_length_1283_cov_10.070101	408	488	12	7	80	0.0875000
NODE_3283_length_1283_cov_10.070101	461	541	6	16	80	0.2000000
NODE_3283_length_1283_cov_10.070101	461	541	8	7	80	0.0875000
NODE_3283_length_1283_cov_10.070101	461	541	9	13	80	0.1625000
NODE_3283_length_1283_cov_10.070101	461	541	10	30	80	0.3750000
NODE_3283_length_1283_cov_10.070101	461	541	12	14	80	0.1750000
NODE_3288_length_1282_cov_37.786137	649	729	10	62	80	0.7750000
NODE_3288_length_1282_cov_37.786137	649	729	12	18	80	0.2250000
NODE_3288_length_1282_cov_37.786137	702	782	0	35	80	0.4375000
NODE_3288_length_1282_cov_37.786137	702	782	8	15	80	0.1875000
NODE_3288_length_1282_cov_37.786137	702	782	10	30	80	0.3750000
NODE_3288_length_1282_cov_37.786137	778	858	0	49	80	0.6125000
NODE_3288_length_1282_cov_37.786137	778	858	2	31	80	0.3875000
NODE_3288_length_1282_cov_37.786137	831	911	2	80	80	1.0000000
NODE_3289_length_1282_cov_25.900254	85	167	6	2	82	0.0243902
NODE_3289_length_1282_cov_25.900254	85	167	8	2	82	0.0243902
NODE_3289_length_1282_cov_25.900254	85	167	10	4	82	0.0487805
NODE_3289_length_1282_cov_25.900254	85	167	12	1	82	0.0121951
NODE_3289_length_1282_cov_25.900254	85	167	14	8	82	0.0975610
NODE_3289_length_1282_cov_25.900254	85	167	22	5	82	0.0609756
NODE_3289_length_1282_cov_25.900254	85	167	24	8	82	0.0975610
NODE_3289_length_1282_cov_25.900254	85	167	26	7	82	0.0853659
NODE_3289_length_1282_cov_25.900254	85	167	28	2	82	0.0243902
NODE_3289_length_1282_cov_25.900254	85	167	32	17	82	0.2073171
NODE_3289_length_1282_cov_25.900254	85	167	34	13	82	0.1585366
NODE_3289_length_1282_cov_25.900254	85	167	35	1	82	0.0121951
NODE_3289_length_1282_cov_25.900254	85	167	36	12	82	0.1463415
NODE_3289_length_1282_cov_25.900254	140	183	0	3	43	0.0697674
NODE_3289_length_1282_cov_25.900254	140	183	6	15	43	0.3488372
NODE_3289_length_1282_cov_25.900254	140	183	8	2	43	0.0465116
NODE_3289_length_1282_cov_25.900254	140	183	10	4	43	0.0930233
NODE_3289_length_1282_cov_25.900254	140	183	12	1	43	0.0232558
NODE_3289_length_1282_cov_25.900254	140	183	14	8	43	0.1860465
NODE_3289_length_1282_cov_25.900254	140	183	22	5	43	0.1162791
NODE_3289_length_1282_cov_25.900254	140	183	24	5	43	0.1162791
NODE_3289_length_1282_cov_25.900254	1006	1086	7	8	80	0.1000000
NODE_3289_length_1282_cov_25.900254	1006	1086	9	6	80	0.0750000
NODE_3289_length_1282_cov_25.900254	1006	1086	11	28	80	0.3500000
NODE_3289_length_1282_cov_25.900254	1006	1086	12	14	80	0.1750000
NODE_3289_length_1282_cov_25.900254	1006	1086	13	9	80	0.1125000
NODE_3289_length_1282_cov_25.900254	1006	1086	15	15	80	0.1875000
NODE_3289_length_1282_cov_25.900254	1006	1086	7	8	80	0.1000000
NODE_3289_length_1282_cov_25.900254	1006	1086	9	6	80	0.0750000
NODE_3289_length_1282_cov_25.900254	1006	1086	11	28	80	0.3500000
NODE_3289_length_1282_cov_25.900254	1006	1086	12	14	80	0.1750000
NODE_3289_length_1282_cov_25.900254	1006	1086	13	9	80	0.1125000
NODE_3289_length_1282_cov_25.900254	1006	1086	15	15	80	0.1875000
NODE_3289_length_1282_cov_25.900254	1015	1086	7	8	71	0.1126761
NODE_3289_length_1282_cov_25.900254	1015	1086	9	6	71	0.0845070
NODE_3289_length_1282_cov_25.900254	1015	1086	11	28	71	0.3943662
NODE_3289_length_1282_cov_25.900254	1015	1086	12	14	71	0.1971831
NODE_3289_length_1282_cov_25.900254	1015	1086	13	9	71	0.1267606
NODE_3289_length_1282_cov_25.900254	1015	1086	15	6	71	0.0845070
NODE_3290_length_1282_cov_14.600169	429	477	0	48	48	1.0000000
NODE_3290_length_1282_cov_14.600169	708	788	0	80	80	1.0000000
NODE_3291_length_1282_cov_8.017751	343	420	0	77	77	1.0000000
NODE_3292_length_1282_cov_5.092984	239	319	0	80	80	1.0000000
NODE_3292_length_1282_cov_5.092984	292	372	0	80	80	1.0000000
NODE_3295_length_1281_cov_31.342640	470	550	8	30	80	0.3750000
NODE_3295_length_1281_cov_31.342640	470	550	10	23	80	0.2875000
NODE_3295_length_1281_cov_31.342640	470	550	12	27	80	0.3375000
NODE_3295_length_1281_cov_31.342640	523	603	0	29	80	0.3625000
NODE_3295_length_1281_cov_31.342640	523	603	6	7	80	0.0875000
NODE_3295_length_1281_cov_31.342640	523	603	8	44	80	0.5500000
NODE_3295_length_1281_cov_31.342640	599	679	0	80	80	1.0000000
NODE_3295_length_1281_cov_31.342640	652	732	0	80	80	1.0000000
NODE_3296_length_1281_cov_25.482234	474	554	0	19	80	0.2375000
NODE_3296_length_1281_cov_25.482234	474	554	2	61	80	0.7625000
NODE_3296_length_1281_cov_25.482234	527	607	2	80	80	1.0000000
NODE_3297_length_1281_cov_14.617597	809	887	6	61	78	0.7820513
NODE_3297_length_1281_cov_14.617597	809	887	10	17	78	0.2179487
NODE_3297_length_1281_cov_14.617597	860	940	0	47	80	0.5875000
NODE_3297_length_1281_cov_14.617597	860	940	6	33	80	0.4125000
NODE_3298_length_1281_cov_12.065144	655	735	2	31	80	0.3875000
NODE_3298_length_1281_cov_12.065144	655	735	4	11	80	0.1375000
NODE_3298_length_1281_cov_12.065144	655	735	6	35	80	0.4375000
NODE_3298_length_1281_cov_12.065144	655	735	8	3	80	0.0375000
NODE_3298_length_1281_cov_12.065144	708	788	4	13	80	0.1625000
NODE_3298_length_1281_cov_12.065144	708	788	6	49	80	0.6125000
NODE_3298_length_1281_cov_12.065144	708	788	8	18	80	0.2250000
NODE_3299_length_1281_cov_9.235195	408	488	3	2	80	0.0250000
NODE_3299_length_1281_cov_9.235195	408	488	4	78	80	0.9750000
NODE_3299_length_1281_cov_9.235195	461	541	0	53	80	0.6625000
NODE_3299_length_1281_cov_9.235195	461	541	3	2	80	0.0250000
NODE_3299_length_1281_cov_9.235195	461	541	4	25	80	0.3125000
NODE_3300_length_1281_cov_7.153976	469	549	0	80	80	1.0000000
NODE_3300_length_1281_cov_7.153976	522	602	0	80	80	1.0000000
NODE_3307_length_1280_cov_24.231160	418	498	0	80	80	1.0000000
NODE_3307_length_1280_cov_24.231160	471	551	0	80	80	1.0000000
NODE_3307_length_1280_cov_24.231160	547	627	0	40	80	0.5000000
NODE_3307_length_1280_cov_24.231160	547	627	8	12	80	0.1500000
NODE_3307_length_1280_cov_24.231160	547	627	10	28	80	0.3500000
NODE_3307_length_1280_cov_24.231160	600	680	10	80	80	1.0000000
NODE_3308_length_1280_cov_5.908552	1077	1138	9	1	61	0.0163934
NODE_3308_length_1280_cov_5.908552	1077	1138	15	1	61	0.0163934
NODE_3308_length_1280_cov_5.908552	1077	1138	17	1	61	0.0163934
NODE_3308_length_1280_cov_5.908552	1077	1138	21	3	61	0.0491803
NODE_3308_length_1280_cov_5.908552	1077	1138	23	2	61	0.0327869
NODE_3308_length_1280_cov_5.908552	1077	1138	28	2	61	0.0327869
NODE_3308_length_1280_cov_5.908552	1077	1138	32	1	61	0.0163934
NODE_3308_length_1280_cov_5.908552	1077	1138	36	1	61	0.0163934
NODE_3308_length_1280_cov_5.908552	1077	1138	38	2	61	0.0327869
NODE_3308_length_1280_cov_5.908552	1077	1138	40	1	61	0.0163934
NODE_3308_length_1280_cov_5.908552	1077	1138	43	1	61	0.0163934
NODE_3308_length_1280_cov_5.908552	1077	1138	45	1	61	0.0163934
NODE_3308_length_1280_cov_5.908552	1077	1138	47	3	61	0.0491803
NODE_3308_length_1280_cov_5.908552	1077	1138	55	1	61	0.0163934
NODE_3308_length_1280_cov_5.908552	1077	1138	60	3	61	0.0491803
NODE_3308_length_1280_cov_5.908552	1077	1138	62	2	61	0.0327869
NODE_3308_length_1280_cov_5.908552	1077	1138	63	1	61	0.0163934
NODE_3308_length_1280_cov_5.908552	1077	1138	64	3	61	0.0491803
NODE_3308_length_1280_cov_5.908552	1077	1138	66	1	61	0.0163934
NODE_3308_length_1280_cov_5.908552	1077	1138	68	1	61	0.0163934
NODE_3308_length_1280_cov_5.908552	1077	1138	71	4	61	0.0655738
NODE_3308_length_1280_cov_5.908552	1077	1138	75	1	61	0.0163934
NODE_3308_length_1280_cov_5.908552	1077	1138	76	2	61	0.0327869
NODE_3308_length_1280_cov_5.908552	1077	1138	80	4	61	0.0655738
NODE_3308_length_1280_cov_5.908552	1077	1138	82	1	61	0.0163934
NODE_3308_length_1280_cov_5.908552	1077	1138	87	1	61	0.0163934
NODE_3308_length_1280_cov_5.908552	1077	1138	90	1	61	0.0163934
NODE_3308_length_1280_cov_5.908552	1077	1138	97	1	61	0.0163934
NODE_3308_length_1280_cov_5.908552	1077	1138	103	2	61	0.0327869
NODE_3308_length_1280_cov_5.908552	1077	1138	121	1	61	0.0163934
NODE_3308_length_1280_cov_5.908552	1077	1138	122	1	61	0.0163934
NODE_3308_length_1280_cov_5.908552	1077	1138	126	1	61	0.0163934
NODE_3308_length_1280_cov_5.908552	1077	1138	128	1	61	0.0163934
NODE_3308_length_1280_cov_5.908552	1077	1138	132	3	61	0.0491803
NODE_3308_length_1280_cov_5.908552	1077	1138	139	1	61	0.0163934
NODE_3308_length_1280_cov_5.908552	1077	1138	143	1	61	0.0163934
NODE_3308_length_1280_cov_5.908552	1077	1138	145	1	61	0.0163934
NODE_3308_length_1280_cov_5.908552	1077	1138	147	2	61	0.0327869
NODE_3311_length_1279_cov_16.840678	749	829	0	7	80	0.0875000
NODE_3311_length_1279_cov_16.840678	749	829	2	29	80	0.3625000
NODE_3311_length_1279_cov_16.840678	749	829	4	44	80	0.5500000
NODE_3311_length_1279_cov_16.840678	802	882	2	33	80	0.4125000
NODE_3311_length_1279_cov_16.840678	802	882	4	47	80	0.5875000
NODE_3312_length_1279_cov_3.772881	951	981	4	30	30	1.0000000
NODE_3317_length_1278_cov_45.991518	411	491	0	28	80	0.3500000
NODE_3317_length_1278_cov_45.991518	411	491	2	52	80	0.6500000
NODE_3317_length_1278_cov_45.991518	464	530	0	53	66	0.8030303
NODE_3317_length_1278_cov_45.991518	464	530	2	13	66	0.1969697
NODE_3318_length_1278_cov_37.164546	447	527	0	80	80	1.0000000
NODE_3318_length_1278_cov_37.164546	500	580	0	80	80	1.0000000
NODE_3318_length_1278_cov_37.164546	576	656	0	80	80	1.0000000
NODE_3318_length_1278_cov_37.164546	629	709	0	80	80	1.0000000
NODE_3319_length_1278_cov_12.505513	522	602	0	80	80	1.0000000
NODE_3319_length_1278_cov_12.505513	575	655	0	80	80	1.0000000
NODE_3320_length_1278_cov_12.171332	212	292	0	46	80	0.5750000
NODE_3320_length_1278_cov_12.171332	212	292	4	29	80	0.3625000
NODE_3320_length_1278_cov_12.171332	212	292	6	5	80	0.0625000
NODE_3320_length_1278_cov_12.171332	265	344	4	22	79	0.2784810
NODE_3320_length_1278_cov_12.171332	265	344	6	57	79	0.7215190
NODE_3329_length_1277_cov_21.407470	667	717	0	50	50	1.0000000
NODE_3329_length_1277_cov_21.407470	690	770	0	80	80	1.0000000
NODE_3330_length_1277_cov_18.111205	834	914	0	80	80	1.0000000
NODE_3330_length_1277_cov_18.111205	887	967	0	80	80	1.0000000
NODE_3331_length_1277_cov_12.449066	276	356	0	78	80	0.9750000
NODE_3331_length_1277_cov_12.449066	276	356	2	2	80	0.0250000
NODE_3331_length_1277_cov_12.449066	329	409	0	25	80	0.3125000
NODE_3331_length_1277_cov_12.449066	329	409	2	55	80	0.6875000
NODE_3331_length_1277_cov_12.449066	405	485	2	10	80	0.1250000
NODE_3331_length_1277_cov_12.449066	405	485	4	2	80	0.0250000
NODE_3331_length_1277_cov_12.449066	405	485	6	2	80	0.0250000
NODE_3331_length_1277_cov_12.449066	405	485	7	25	80	0.3125000
NODE_3331_length_1277_cov_12.449066	405	485	8	34	80	0.4250000
NODE_3331_length_1277_cov_12.449066	405	485	10	7	80	0.0875000
NODE_3331_length_1277_cov_12.449066	458	538	8	70	80	0.8750000
NODE_3331_length_1277_cov_12.449066	458	538	10	10	80	0.1250000
NODE_3337_length_1276_cov_21.446899	526	606	0	80	80	1.0000000
NODE_3337_length_1276_cov_21.446899	579	659	0	80	80	1.0000000
NODE_3337_length_1276_cov_21.446899	655	735	0	80	80	1.0000000
NODE_3337_length_1276_cov_21.446899	708	788	0	57	80	0.7125000
NODE_3337_length_1276_cov_21.446899	708	788	2	23	80	0.2875000
NODE_3346_length_1275_cov_35.471939	632	712	0	6	80	0.0750000
NODE_3346_length_1275_cov_35.471939	632	712	4	74	80	0.9250000
NODE_3346_length_1275_cov_35.471939	685	765	0	59	80	0.7375000
NODE_3346_length_1275_cov_35.471939	685	765	4	21	80	0.2625000
NODE_3347_length_1275_cov_19.910714	361	441	0	80	80	1.0000000
NODE_3347_length_1275_cov_19.910714	414	494	0	80	80	1.0000000
NODE_3347_length_1275_cov_19.910714	879	949	12	6	70	0.0857143
NODE_3347_length_1275_cov_19.910714	879	949	14	64	70	0.9142857
NODE_3351_length_1274_cov_23.404255	427	507	0	80	80	1.0000000
NODE_3351_length_1274_cov_23.404255	480	560	0	80	80	1.0000000
NODE_3351_length_1274_cov_23.404255	556	636	0	80	80	1.0000000
NODE_3351_length_1274_cov_23.404255	609	689	0	80	80	1.0000000
NODE_3352_length_1274_cov_20.178723	545	625	2	80	80	1.0000000
NODE_3352_length_1274_cov_20.178723	598	678	0	41	80	0.5125000
NODE_3352_length_1274_cov_20.178723	598	678	1	8	80	0.1000000
NODE_3352_length_1274_cov_20.178723	598	678	2	31	80	0.3875000
NODE_3354_length_1274_cov_2.019574	841	907	4	14	66	0.2121212
NODE_3354_length_1274_cov_2.019574	841	907	8	52	66	0.7878788
NODE_3354_length_1274_cov_2.019574	894	961	0	53	67	0.7910448
NODE_3354_length_1274_cov_2.019574	894	961	4	14	67	0.2089552
NODE_3361_length_1273_cov_42.349233	337	417	0	80	80	1.0000000
NODE_3361_length_1273_cov_42.349233	390	470	0	63	80	0.7875000
NODE_3361_length_1273_cov_42.349233	390	470	10	17	80	0.2125000
NODE_3361_length_1273_cov_42.349233	466	546	10	20	80	0.2500000
NODE_3361_length_1273_cov_42.349233	466	546	12	60	80	0.7500000
NODE_3361_length_1273_cov_42.349233	519	599	0	14	80	0.1750000
NODE_3361_length_1273_cov_42.349233	519	599	10	6	80	0.0750000
NODE_3361_length_1273_cov_42.349233	519	599	12	60	80	0.7500000
NODE_3364_length_1273_cov_4.404600	407	487	4	80	80	1.0000000
NODE_3364_length_1273_cov_4.404600	460	540	0	29	80	0.3625000
NODE_3364_length_1273_cov_4.404600	460	540	4	51	80	0.6375000
NODE_3368_length_1272_cov_28.887468	588	668	4	71	80	0.8875000
NODE_3368_length_1272_cov_28.887468	588	668	8	9	80	0.1125000
NODE_3368_length_1272_cov_28.887468	641	721	4	30	80	0.3750000
NODE_3368_length_1272_cov_28.887468	641	721	6	22	80	0.2750000
NODE_3368_length_1272_cov_28.887468	641	721	8	9	80	0.1125000
NODE_3368_length_1272_cov_28.887468	641	721	10	19	80	0.2375000
NODE_3369_length_1272_cov_11.290708	366	447	2	37	81	0.4567901
NODE_3369_length_1272_cov_11.290708	366	447	4	37	81	0.4567901
NODE_3369_length_1272_cov_11.290708	366	447	6	7	81	0.0864198
NODE_3375_length_1270_cov_13.617421	365	445	0	80	80	1.0000000
NODE_3375_length_1270_cov_13.617421	396	473	0	77	77	1.0000000
NODE_3375_length_1270_cov_13.617421	418	498	0	80	80	1.0000000
NODE_3375_length_1270_cov_13.617421	449	473	0	24	24	1.0000000
NODE_3375_length_1270_cov_13.617421	465	498	0	33	33	1.0000000
NODE_3376_length_1270_cov_11.645602	294	374	0	36	80	0.4500000
NODE_3376_length_1270_cov_11.645602	294	374	12	44	80	0.5500000
NODE_3376_length_1270_cov_11.645602	347	427	12	80	80	1.0000000
NODE_3377_length_1270_cov_2.495303	74	131	16	1	57	0.0175439
NODE_3377_length_1270_cov_2.495303	74	131	18	1	57	0.0175439
NODE_3377_length_1270_cov_2.495303	74	131	20	1	57	0.0175439
NODE_3377_length_1270_cov_2.495303	74	131	22	5	57	0.0877193
NODE_3377_length_1270_cov_2.495303	74	131	26	3	57	0.0526316
NODE_3377_length_1270_cov_2.495303	74	131	27	1	57	0.0175439
NODE_3377_length_1270_cov_2.495303	74	131	28	14	57	0.2456140
NODE_3377_length_1270_cov_2.495303	74	131	29	20	57	0.3508772
NODE_3377_length_1270_cov_2.495303	74	131	30	11	57	0.1929825
NODE_3378_length_1269_cov_55.070940	492	569	2	16	77	0.2077922
NODE_3378_length_1269_cov_55.070940	492	569	4	26	77	0.3376623
NODE_3378_length_1269_cov_55.070940	492	569	5	1	77	0.0129870
NODE_3378_length_1269_cov_55.070940	492	569	6	34	77	0.4415585
NODE_3378_length_1269_cov_55.070940	545	625	0	49	80	0.6125000
NODE_3378_length_1269_cov_55.070940	545	625	4	31	80	0.3875000
NODE_3378_length_1269_cov_55.070940	621	701	0	12	80	0.1500000
NODE_3378_length_1269_cov_55.070940	621	701	2	68	80	0.8500000
NODE_3378_length_1269_cov_55.070940	674	754	2	58	80	0.7250000
NODE_3378_length_1269_cov_55.070940	674	754	4	18	80	0.2250000
NODE_3378_length_1269_cov_55.070940	674	754	6	4	80	0.0500000
NODE_3379_length_1269_cov_22.154701	1152	1216	18	64	64	1.0000000
NODE_3379_length_1269_cov_22.154701	1152	1216	18	64	64	1.0000000
NODE_3379_length_1269_cov_22.154701	1152	1216	18	64	64	1.0000000
NODE_3379_length_1269_cov_22.154701	1189	1269	5	1	80	0.0125000
NODE_3379_length_1269_cov_22.154701	1189	1269	7	3	80	0.0375000
NODE_3379_length_1269_cov_22.154701	1189	1269	9	7	80	0.0875000
NODE_3379_length_1269_cov_22.154701	1189	1269	15	4	80	0.0500000
NODE_3379_length_1269_cov_22.154701	1189	1269	17	20	80	0.2500000
NODE_3379_length_1269_cov_22.154701	1189	1269	18	45	80	0.5625000
NODE_3379_length_1269_cov_22.154701	1189	1269	5	1	80	0.0125000
NODE_3379_length_1269_cov_22.154701	1189	1269	7	3	80	0.0375000
NODE_3379_length_1269_cov_22.154701	1189	1269	9	7	80	0.0875000
NODE_3379_length_1269_cov_22.154701	1189	1269	15	4	80	0.0500000
NODE_3379_length_1269_cov_22.154701	1189	1269	17	20	80	0.2500000
NODE_3379_length_1269_cov_22.154701	1189	1269	18	45	80	0.5625000
NODE_3380_length_1269_cov_18.753846	317	398	0	4	81	0.0493827
NODE_3380_length_1269_cov_18.753846	317	398	6	32	81	0.3950617
NODE_3380_length_1269_cov_18.753846	317	398	8	38	81	0.4691358
NODE_3380_length_1269_cov_18.753846	317	398	10	7	81	0.0864198
NODE_3381_length_1269_cov_12.637607	580	660	0	80	80	1.0000000
NODE_3381_length_1269_cov_12.637607	633	713	0	80	80	1.0000000
NODE_3381_length_1269_cov_12.637607	709	729	0	20	20	1.0000000
NODE_3381_length_1269_cov_12.637607	709	789	0	47	80	0.5875000
NODE_3381_length_1269_cov_12.637607	709	789	2	4	80	0.0500000
NODE_3381_length_1269_cov_12.637607	709	789	4	29	80	0.3625000
NODE_3381_length_1269_cov_12.637607	762	842	2	19	80	0.2375000
NODE_3381_length_1269_cov_12.637607	762	842	4	61	80	0.7625000
NODE_3382_length_1269_cov_10.552137	765	845	0	80	80	1.0000000
NODE_3382_length_1269_cov_10.552137	818	898	0	80	80	1.0000000
NODE_3391_length_1268_cov_12.862275	300	350	14	1	50	0.0200000
NODE_3391_length_1268_cov_12.862275	300	350	16	1	50	0.0200000
NODE_3391_length_1268_cov_12.862275	300	350	20	1	50	0.0200000
NODE_3391_length_1268_cov_12.862275	300	350	28	2	50	0.0400000
NODE_3391_length_1268_cov_12.862275	300	350	30	2	50	0.0400000
NODE_3391_length_1268_cov_12.862275	300	350	32	1	50	0.0200000
NODE_3391_length_1268_cov_12.862275	300	350	34	6	50	0.1200000
NODE_3391_length_1268_cov_12.862275	300	350	36	7	50	0.1400000
NODE_3391_length_1268_cov_12.862275	300	350	37	1	50	0.0200000
NODE_3391_length_1268_cov_12.862275	300	350	39	2	50	0.0400000
NODE_3391_length_1268_cov_12.862275	300	350	40	1	50	0.0200000
NODE_3391_length_1268_cov_12.862275	300	350	42	1	50	0.0200000
NODE_3391_length_1268_cov_12.862275	300	350	46	2	50	0.0400000
NODE_3391_length_1268_cov_12.862275	300	350	48	2	50	0.0400000
NODE_3391_length_1268_cov_12.862275	300	350	53	2	50	0.0400000
NODE_3391_length_1268_cov_12.862275	300	350	54	1	50	0.0200000
NODE_3391_length_1268_cov_12.862275	300	350	58	1	50	0.0200000
NODE_3391_length_1268_cov_12.862275	300	350	62	7	50	0.1400000
NODE_3391_length_1268_cov_12.862275	300	350	64	1	50	0.0200000
NODE_3391_length_1268_cov_12.862275	300	350	66	4	50	0.0800000
NODE_3391_length_1268_cov_12.862275	300	350	68	4	50	0.0800000
NODE_3392_length_1268_cov_9.523524	265	345	0	80	80	1.0000000
NODE_3392_length_1268_cov_9.523524	318	398	0	80	80	1.0000000
NODE_3393_length_1267_cov_21.315068	299	379	0	53	80	0.6625000
NODE_3393_length_1267_cov_21.315068	299	379	2	27	80	0.3375000
NODE_3393_length_1267_cov_21.315068	352	432	0	80	80	1.0000000
NODE_3393_length_1267_cov_21.315068	698	778	0	35	80	0.4375000
NODE_3393_length_1267_cov_21.315068	698	778	2	11	80	0.1375000
NODE_3393_length_1267_cov_21.315068	698	778	4	34	80	0.4250000
NODE_3393_length_1267_cov_21.315068	751	831	2	5	80	0.0625000
NODE_3393_length_1267_cov_21.315068	751	831	4	75	80	0.9375000
NODE_3394_length_1267_cov_14.880137	606	686	0	56	80	0.7000000
NODE_3394_length_1267_cov_14.880137	606	686	3	1	80	0.0125000
NODE_3394_length_1267_cov_14.880137	606	686	4	23	80	0.2875000
NODE_3394_length_1267_cov_14.880137	659	739	0	3	80	0.0375000
NODE_3394_length_1267_cov_14.880137	659	739	3	1	80	0.0125000
NODE_3394_length_1267_cov_14.880137	659	739	4	76	80	0.9500000
NODE_3397_length_1266_cov_20.584404	357	437	0	17	80	0.2125000
NODE_3397_length_1266_cov_20.584404	357	437	1	1	80	0.0125000
NODE_3397_length_1266_cov_20.584404	357	437	2	62	80	0.7750000
NODE_3397_length_1266_cov_20.584404	410	490	0	22	80	0.2750000
NODE_3397_length_1266_cov_20.584404	410	490	2	58	80	0.7250000
NODE_3398_length_1266_cov_16.571551	359	435	0	76	76	1.0000000
NODE_3398_length_1266_cov_16.571551	408	488	0	80	80	1.0000000
NODE_3399_length_1266_cov_14.218509	517	595	0	29	78	0.3717949
NODE_3399_length_1266_cov_14.218509	517	595	2	49	78	0.6282051
NODE_3399_length_1266_cov_14.218509	568	648	0	80	80	1.0000000
NODE_3399_length_1266_cov_14.218509	644	724	0	49	80	0.6125000
NODE_3399_length_1266_cov_14.218509	644	724	4	11	80	0.1375000
NODE_3399_length_1266_cov_14.218509	644	724	6	20	80	0.2500000
NODE_3399_length_1266_cov_14.218509	697	777	4	21	80	0.2625000
NODE_3399_length_1266_cov_14.218509	697	777	6	59	80	0.7375000
NODE_3403_length_1265_cov_9.807890	429	509	0	29	80	0.3625000
NODE_3403_length_1265_cov_9.807890	429	509	1	2	80	0.0250000
NODE_3403_length_1265_cov_9.807890	429	509	2	35	80	0.4375000
NODE_3403_length_1265_cov_9.807890	429	509	4	6	80	0.0750000
NODE_3403_length_1265_cov_9.807890	429	509	6	8	80	0.1000000
NODE_3403_length_1265_cov_9.807890	482	562	2	13	80	0.1625000
NODE_3403_length_1265_cov_9.807890	482	562	4	6	80	0.0750000
NODE_3403_length_1265_cov_9.807890	482	562	6	18	80	0.2250000
NODE_3403_length_1265_cov_9.807890	482	562	10	43	80	0.5375000
NODE_3404_length_1265_cov_8.233276	160	207	2	5	47	0.1063830
NODE_3404_length_1265_cov_8.233276	160	207	4	7	47	0.1489362
NODE_3404_length_1265_cov_8.233276	160	207	6	12	47	0.2553191
NODE_3404_length_1265_cov_8.233276	160	207	10	3	47	0.0638298
NODE_3404_length_1265_cov_8.233276	160	207	12	1	47	0.0212766
NODE_3404_length_1265_cov_8.233276	160	207	14	6	47	0.1276596
NODE_3404_length_1265_cov_8.233276	160	207	16	1	47	0.0212766
NODE_3404_length_1265_cov_8.233276	160	207	17	7	47	0.1489362
NODE_3404_length_1265_cov_8.233276	160	207	19	5	47	0.1063830
NODE_3404_length_1265_cov_8.233276	1004	1058	0	54	54	1.0000000
NODE_3406_length_1265_cov_3.941681	503	583	0	7	80	0.0875000
NODE_3406_length_1265_cov_3.941681	503	583	2	73	80	0.9125000
NODE_3406_length_1265_cov_3.941681	556	636	0	60	80	0.7500000
NODE_3406_length_1265_cov_3.941681	556	636	2	20	80	0.2500000
NODE_3408_length_1264_cov_8.024034	290	370	0	80	80	1.0000000
NODE_3408_length_1264_cov_8.024034	343	423	0	80	80	1.0000000
NODE_3413_length_1263_cov_8.566151	698	778	0	17	80	0.2125000
NODE_3413_length_1263_cov_8.566151	698	778	2	63	80	0.7875000
NODE_3413_length_1263_cov_8.566151	751	831	0	17	80	0.2125000
NODE_3413_length_1263_cov_8.566151	751	831	2	63	80	0.7875000
NODE_3413_length_1263_cov_8.566151	833	910	0	46	77	0.5974026
NODE_3413_length_1263_cov_8.566151	833	910	2	31	77	0.4025974
NODE_3413_length_1263_cov_8.566151	883	963	2	80	80	1.0000000
NODE_3414_length_1263_cov_7.376289	1060	1140	0	80	80	1.0000000
NODE_3414_length_1263_cov_7.376289	1113	1213	0	100	100	1.0000000
NODE_3416_length_1263_cov_1.827320	227	307	0	80	80	1.0000000
NODE_3416_length_1263_cov_1.827320	280	360	0	80	80	1.0000000
NODE_3418_length_1262_cov_17.416165	404	484	0	6	80	0.0750000
NODE_3418_length_1262_cov_17.416165	404	484	4	32	80	0.4000000
NODE_3418_length_1262_cov_17.416165	404	484	7	1	80	0.0125000
NODE_3418_length_1262_cov_17.416165	404	484	8	41	80	0.5125000
NODE_3418_length_1262_cov_17.416165	457	537	0	4	80	0.0500000
NODE_3418_length_1262_cov_17.416165	457	537	4	49	80	0.6125000
NODE_3418_length_1262_cov_17.416165	457	537	7	1	80	0.0125000
NODE_3418_length_1262_cov_17.416165	457	537	8	26	80	0.3250000
NODE_3419_length_1262_cov_15.268272	648	728	0	80	80	1.0000000
NODE_3419_length_1262_cov_15.268272	701	781	0	80	80	1.0000000
NODE_3419_length_1262_cov_15.268272	777	857	0	80	80	1.0000000
NODE_3419_length_1262_cov_15.268272	830	910	0	80	80	1.0000000
NODE_3424_length_1261_cov_1.777969	272	318	0	46	46	1.0000000
NODE_3425_length_1260_cov_55.640827	499	579	0	80	80	1.0000000
NODE_3425_length_1260_cov_55.640827	552	632	0	80	80	1.0000000
NODE_3425_length_1260_cov_55.640827	628	708	0	80	80	1.0000000
NODE_3425_length_1260_cov_55.640827	681	761	0	80	80	1.0000000
NODE_3426_length_1260_cov_12.242894	427	507	0	11	80	0.1375000
NODE_3426_length_1260_cov_12.242894	427	507	8	10	80	0.1250000
NODE_3426_length_1260_cov_12.242894	427	507	10	59	80	0.7375000
NODE_3426_length_1260_cov_12.242894	480	560	0	64	80	0.8000000
NODE_3426_length_1260_cov_12.242894	480	560	8	10	80	0.1250000
NODE_3426_length_1260_cov_12.242894	480	560	10	6	80	0.0750000
NODE_3436_length_1259_cov_15.381897	509	589	0	74	80	0.9250000
NODE_3436_length_1259_cov_15.381897	509	589	4	6	80	0.0750000
NODE_3436_length_1259_cov_15.381897	562	642	0	80	80	1.0000000
NODE_3439_length_1258_cov_33.519413	608	688	0	80	80	1.0000000
NODE_3439_length_1258_cov_33.519413	661	741	0	80	80	1.0000000
NODE_3440_length_1258_cov_22.569456	583	663	2	5	80	0.0625000
NODE_3440_length_1258_cov_22.569456	583	663	6	75	80	0.9375000
NODE_3440_length_1258_cov_22.569456	636	716	0	45	80	0.5625000
NODE_3440_length_1258_cov_22.569456	636	716	4	8	80	0.1000000
NODE_3440_length_1258_cov_22.569456	636	716	6	27	80	0.3375000
NODE_3441_length_1258_cov_18.747196	308	388	0	80	80	1.0000000
NODE_3441_length_1258_cov_18.747196	361	441	0	80	80	1.0000000
NODE_3441_length_1258_cov_18.747196	437	517	0	64	80	0.8000000
NODE_3441_length_1258_cov_18.747196	437	517	1	16	80	0.2000000
NODE_3441_length_1258_cov_18.747196	490	570	0	11	80	0.1375000
NODE_3441_length_1258_cov_18.747196	490	570	1	41	80	0.5125000
NODE_3441_length_1258_cov_18.747196	490	570	2	28	80	0.3500000
NODE_3442_length_1258_cov_13.699741	332	412	0	80	80	1.0000000
NODE_3442_length_1258_cov_13.699741	385	465	0	80	80	1.0000000
NODE_3447_length_1257_cov_34.029361	567	647	0	80	80	1.0000000
NODE_3447_length_1257_cov_34.029361	620	700	0	80	80	1.0000000
NODE_3447_length_1257_cov_34.029361	696	776	0	80	80	1.0000000
NODE_3447_length_1257_cov_34.029361	749	829	0	80	80	1.0000000
NODE_3449_length_1257_cov_7.892919	317	397	0	80	80	1.0000000
NODE_3449_length_1257_cov_7.892919	370	450	0	30	80	0.3750000
NODE_3449_length_1257_cov_7.892919	370	450	2	50	80	0.6250000
NODE_3452_length_1256_cov_50.506482	389	469	0	80	80	1.0000000
NODE_3452_length_1256_cov_50.506482	442	522	0	74	80	0.9250000
NODE_3452_length_1256_cov_50.506482	442	522	2	6	80	0.0750000
NODE_3452_length_1256_cov_50.506482	518	598	2	26	80	0.3250000
NODE_3452_length_1256_cov_50.506482	518	598	4	21	80	0.2625000
NODE_3452_length_1256_cov_50.506482	518	598	8	33	80	0.4125000
NODE_3452_length_1256_cov_50.506482	571	651	0	12	80	0.1500000
NODE_3452_length_1256_cov_50.506482	571	651	4	1	80	0.0125000
NODE_3452_length_1256_cov_50.506482	571	651	5	1	80	0.0125000
NODE_3452_length_1256_cov_50.506482	571	651	6	3	80	0.0375000
NODE_3452_length_1256_cov_50.506482	571	651	8	63	80	0.7875000
NODE_3453_length_1256_cov_25.944685	754	834	0	15	80	0.1875000
NODE_3453_length_1256_cov_25.944685	754	834	2	65	80	0.8125000
NODE_3453_length_1256_cov_25.944685	807	887	0	28	80	0.3500000
NODE_3453_length_1256_cov_25.944685	807	887	2	52	80	0.6500000
NODE_3455_length_1256_cov_21.720830	713	793	0	33	80	0.4125000
NODE_3455_length_1256_cov_21.720830	713	793	2	47	80	0.5875000
NODE_3455_length_1256_cov_21.720830	766	846	0	80	80	1.0000000
NODE_3456_length_1256_cov_14.242005	595	675	0	80	80	1.0000000
NODE_3456_length_1256_cov_14.242005	648	728	0	80	80	1.0000000
NODE_3457_length_1256_cov_5.870354	879	959	0	80	80	1.0000000
NODE_3463_length_1255_cov_37.271626	458	538	0	80	80	1.0000000
NODE_3463_length_1255_cov_37.271626	511	591	0	80	80	1.0000000
NODE_3463_length_1255_cov_37.271626	587	667	0	80	80	1.0000000
NODE_3463_length_1255_cov_37.271626	640	720	0	47	80	0.5875000
NODE_3463_length_1255_cov_37.271626	640	720	4	33	80	0.4125000
NODE_3464_length_1255_cov_21.374567	516	596	0	15	80	0.1875000
NODE_3464_length_1255_cov_21.374567	516	596	2	65	80	0.8125000
NODE_3464_length_1255_cov_21.374567	569	649	0	68	80	0.8500000
NODE_3464_length_1255_cov_21.374567	569	649	2	12	80	0.1500000
NODE_3464_length_1255_cov_21.374567	645	725	0	80	80	1.0000000
NODE_3464_length_1255_cov_21.374567	698	778	0	80	80	1.0000000
NODE_3465_length_1255_cov_18.391869	521	601	0	80	80	1.0000000
NODE_3465_length_1255_cov_18.391869	574	654	0	80	80	1.0000000
NODE_3466_length_1255_cov_4.096021	1194	1242	0	48	48	1.0000000
NODE_3469_length_1254_cov_32.470996	612	692	0	80	80	1.0000000
NODE_3469_length_1254_cov_32.470996	665	745	0	80	80	1.0000000
NODE_3470_length_1254_cov_26.449351	488	568	0	55	80	0.6875000
NODE_3470_length_1254_cov_26.449351	488	568	2	25	80	0.3125000
NODE_3470_length_1254_cov_26.449351	541	621	0	11	80	0.1375000
NODE_3470_length_1254_cov_26.449351	541	621	2	69	80	0.8625000
NODE_3471_length_1254_cov_22.032035	531	611	0	80	80	1.0000000
NODE_3471_length_1254_cov_22.032035	584	664	0	80	80	1.0000000
NODE_3479_length_1253_cov_16.916811	651	731	0	80	80	1.0000000
NODE_3479_length_1253_cov_16.916811	704	784	0	80	80	1.0000000
NODE_3479_length_1253_cov_16.916811	780	860	0	73	80	0.9125000
NODE_3479_length_1253_cov_16.916811	780	860	2	7	80	0.0875000
NODE_3479_length_1253_cov_16.916811	833	913	0	20	80	0.2500000
NODE_3479_length_1253_cov_16.916811	833	913	2	60	80	0.7500000
NODE_3480_length_1253_cov_13.816291	811	891	0	80	80	1.0000000
NODE_3481_length_1253_cov_9.067591	306	386	0	80	80	1.0000000
NODE_3481_length_1253_cov_9.067591	359	439	0	80	80	1.0000000
NODE_3487_length_1252_cov_57.745880	477	557	0	80	80	1.0000000
NODE_3487_length_1252_cov_57.745880	530	610	0	80	80	1.0000000
NODE_3487_length_1252_cov_57.745880	606	686	0	58	80	0.7250000
NODE_3487_length_1252_cov_57.745880	606	686	2	22	80	0.2750000
NODE_3487_length_1252_cov_57.745880	659	739	0	5	80	0.0625000
NODE_3487_length_1252_cov_57.745880	659	739	2	75	80	0.9375000
NODE_3488_length_1252_cov_56.694709	594	674	2	1	80	0.0125000
NODE_3488_length_1252_cov_56.694709	594	674	6	79	80	0.9875000
NODE_3488_length_1252_cov_56.694709	647	727	0	51	80	0.6375000
NODE_3488_length_1252_cov_56.694709	647	727	2	3	80	0.0375000
NODE_3488_length_1252_cov_56.694709	647	727	6	26	80	0.3250000
NODE_3488_length_1252_cov_56.694709	723	803	0	76	80	0.9500000
NODE_3488_length_1252_cov_56.694709	723	803	2	2	80	0.0250000
NODE_3488_length_1252_cov_56.694709	723	803	4	2	80	0.0250000
NODE_3488_length_1252_cov_56.694709	785	847	0	14	62	0.2258064
NODE_3488_length_1252_cov_56.694709	785	847	2	2	62	0.0322581
NODE_3488_length_1252_cov_56.694709	785	847	4	46	62	0.7419355
NODE_3489_length_1252_cov_34.023417	468	548	4	26	80	0.3250000
NODE_3489_length_1252_cov_34.023417	468	548	6	54	80	0.6750000
NODE_3489_length_1252_cov_34.023417	521	601	0	34	80	0.4250000
NODE_3489_length_1252_cov_34.023417	521	601	2	15	80	0.1875000
NODE_3489_length_1252_cov_34.023417	521	601	4	1	80	0.0125000
NODE_3489_length_1252_cov_34.023417	521	601	6	30	80	0.3750000
NODE_3489_length_1252_cov_34.023417	597	677	0	10	80	0.1250000
NODE_3489_length_1252_cov_34.023417	597	677	6	44	80	0.5500000
NODE_3489_length_1252_cov_34.023417	597	677	8	4	80	0.0500000
NODE_3489_length_1252_cov_34.023417	597	677	10	22	80	0.2750000
NODE_3489_length_1252_cov_34.023417	650	730	4	15	80	0.1875000
NODE_3489_length_1252_cov_34.023417	650	730	6	1	80	0.0125000
NODE_3489_length_1252_cov_34.023417	650	730	8	4	80	0.0500000
NODE_3489_length_1252_cov_34.023417	650	730	10	60	80	0.7500000
NODE_3490_length_1252_cov_9.316565	573	653	8	16	80	0.2000000
NODE_3490_length_1252_cov_9.316565	573	653	10	6	80	0.0750000
NODE_3490_length_1252_cov_9.316565	573	653	12	17	80	0.2125000
NODE_3490_length_1252_cov_9.316565	573	653	14	5	80	0.0625000
NODE_3490_length_1252_cov_9.316565	573	653	16	15	80	0.1875000
NODE_3490_length_1252_cov_9.316565	573	653	18	16	80	0.2000000
NODE_3490_length_1252_cov_9.316565	573	653	20	5	80	0.0625000
NODE_3490_length_1252_cov_9.316565	626	706	14	14	80	0.1750000
NODE_3490_length_1252_cov_9.316565	626	706	16	29	80	0.3625000
NODE_3490_length_1252_cov_9.316565	626	706	18	32	80	0.4000000
NODE_3490_length_1252_cov_9.316565	626	706	20	5	80	0.0625000
NODE_3491_length_1252_cov_8.295750	602	682	0	80	80	1.0000000
NODE_3491_length_1252_cov_8.295750	655	735	0	80	80	1.0000000
NODE_3494_length_1251_cov_17.513889	579	659	0	80	80	1.0000000
NODE_3494_length_1251_cov_17.513889	632	712	0	80	80	1.0000000
NODE_3494_length_1251_cov_17.513889	708	788	0	80	80	1.0000000
NODE_3494_length_1251_cov_17.513889	761	841	0	80	80	1.0000000
NODE_3497_length_1251_cov_3.139757	0	76	0	34	76	0.4473684
NODE_3497_length_1251_cov_3.139757	0	76	2	24	76	0.3157895
NODE_3497_length_1251_cov_3.139757	0	76	4	18	76	0.2368421
NODE_3497_length_1251_cov_3.139757	49	98	2	9	49	0.1836735
NODE_3497_length_1251_cov_3.139757	49	98	4	20	49	0.4081633
NODE_3497_length_1251_cov_3.139757	49	98	8	18	49	0.3673469
NODE_3497_length_1251_cov_3.139757	49	98	16	2	49	0.0408163
NODE_3501_length_1250_cov_25.133797	325	405	0	80	80	1.0000000
NODE_3501_length_1250_cov_25.133797	378	458	0	80	80	1.0000000
NODE_3503_length_1250_cov_11.471764	652	733	4	5	81	0.0617284
NODE_3503_length_1250_cov_11.471764	652	733	8	76	81	0.9382716
NODE_3503_length_1250_cov_11.471764	706	786	0	28	80	0.3500000
NODE_3503_length_1250_cov_11.471764	706	786	4	9	80	0.1125000
NODE_3503_length_1250_cov_11.471764	706	786	8	43	80	0.5375000
NODE_3505_length_1249_cov_45.772174	543	623	0	80	80	1.0000000
NODE_3505_length_1249_cov_45.772174	596	676	0	80	80	1.0000000
NODE_3505_length_1249_cov_45.772174	672	749	0	23	77	0.2987013
NODE_3505_length_1249_cov_45.772174	672	749	4	40	77	0.5194805
NODE_3505_length_1249_cov_45.772174	672	749	12	14	77	0.1818182
NODE_3505_length_1249_cov_45.772174	729	802	4	6	73	0.0821918
NODE_3505_length_1249_cov_45.772174	729	802	8	3	73	0.0410959
NODE_3505_length_1249_cov_45.772174	729	802	12	64	73	0.8767123
NODE_3506_length_1249_cov_35.670435	515	595	0	80	80	1.0000000
NODE_3506_length_1249_cov_35.670435	568	648	0	80	80	1.0000000
NODE_3506_length_1249_cov_35.670435	644	724	0	80	80	1.0000000
NODE_3506_length_1249_cov_35.670435	697	777	0	80	80	1.0000000
NODE_3507_length_1249_cov_34.616522	576	656	4	25	80	0.3125000
NODE_3507_length_1249_cov_34.616522	576	656	6	1	80	0.0125000
NODE_3507_length_1249_cov_34.616522	576	656	8	54	80	0.6750000
NODE_3507_length_1249_cov_34.616522	629	709	0	6	80	0.0750000
NODE_3507_length_1249_cov_34.616522	629	709	4	54	80	0.6750000
NODE_3507_length_1249_cov_34.616522	629	709	8	20	80	0.2500000
NODE_3507_length_1249_cov_34.616522	705	785	0	80	80	1.0000000
NODE_3507_length_1249_cov_34.616522	758	838	0	80	80	1.0000000
NODE_3508_length_1249_cov_19.592174	461	541	0	23	80	0.2875000
NODE_3508_length_1249_cov_19.592174	461	541	2	57	80	0.7125000
NODE_3508_length_1249_cov_19.592174	514	594	0	40	80	0.5000000
NODE_3508_length_1249_cov_19.592174	514	594	2	40	80	0.5000000
NODE_3508_length_1249_cov_19.592174	860	940	0	18	80	0.2250000
NODE_3508_length_1249_cov_19.592174	860	940	2	62	80	0.7750000
NODE_3508_length_1249_cov_19.592174	913	993	0	32	80	0.4000000
NODE_3508_length_1249_cov_19.592174	913	993	2	48	80	0.6000000
NODE_3509_length_1249_cov_14.926957	1153	1219	0	25	66	0.3787879
NODE_3509_length_1249_cov_14.926957	1153	1219	2	41	66	0.6212121
NODE_3509_length_1249_cov_14.926957	1192	1249	0	55	57	0.9649123
NODE_3509_length_1249_cov_14.926957	1192	1249	2	2	57	0.0350877
NODE_3509_length_1249_cov_14.926957	1192	1247	0	53	55	0.9636363
NODE_3509_length_1249_cov_14.926957	1192	1247	2	2	55	0.0363636
NODE_3509_length_1249_cov_14.926957	1192	1249	0	55	57	0.9649123
NODE_3509_length_1249_cov_14.926957	1192	1249	2	2	57	0.0350877
NODE_3510_length_1249_cov_7.682609	757	837	0	80	80	1.0000000
NODE_3510_length_1249_cov_7.682609	810	890	0	80	80	1.0000000
NODE_3514_length_1248_cov_14.351610	469	549	0	14	80	0.1750000
NODE_3514_length_1248_cov_14.351610	469	549	4	22	80	0.2750000
NODE_3514_length_1248_cov_14.351610	469	549	8	44	80	0.5500000
NODE_3514_length_1248_cov_14.351610	522	602	5	8	80	0.1000000
NODE_3514_length_1248_cov_14.351610	522	602	8	64	80	0.8000000
NODE_3514_length_1248_cov_14.351610	522	602	9	8	80	0.1000000
NODE_3514_length_1248_cov_14.351610	598	678	2	68	80	0.8500000
NODE_3514_length_1248_cov_14.351610	598	678	5	12	80	0.1500000
NODE_3514_length_1248_cov_14.351610	651	731	2	80	80	1.0000000
NODE_3515_length_1248_cov_11.181027	303	383	0	80	80	1.0000000
NODE_3515_length_1248_cov_11.181027	356	436	0	80	80	1.0000000
NODE_3515_length_1248_cov_11.181027	432	512	0	80	80	1.0000000
NODE_3515_length_1248_cov_11.181027	485	565	0	80	80	1.0000000
NODE_3516_length_1248_cov_4.372498	17	98	0	81	81	1.0000000
NODE_3516_length_1248_cov_4.372498	94	152	0	58	58	1.0000000
NODE_3517_length_1248_cov_2.356832	952	1032	0	80	80	1.0000000
NODE_3517_length_1248_cov_2.356832	1005	1085	0	80	80	1.0000000
NODE_3518_length_1248_cov_2.283725	1102	1151	0	6	49	0.1224490
NODE_3518_length_1248_cov_2.283725	1102	1151	2	43	49	0.8775510
NODE_3522_length_1247_cov_25.355401	487	567	0	80	80	1.0000000
NODE_3522_length_1247_cov_25.355401	540	620	0	80	80	1.0000000
NODE_3522_length_1247_cov_25.355401	616	696	0	80	80	1.0000000
NODE_3522_length_1247_cov_25.355401	669	749	0	80	80	1.0000000
NODE_3528_length_1246_cov_30.231909	433	513	0	80	80	1.0000000
NODE_3528_length_1246_cov_30.231909	486	566	0	80	80	1.0000000
NODE_3528_length_1246_cov_30.231909	562	642	0	27	80	0.3375000
NODE_3528_length_1246_cov_30.231909	562	642	2	53	80	0.6625000
NODE_3528_length_1246_cov_30.231909	615	695	0	36	80	0.4500000
NODE_3528_length_1246_cov_30.231909	615	695	2	44	80	0.5500000
NODE_3529_length_1246_cov_13.847428	497	577	2	80	80	1.0000000
NODE_3529_length_1246_cov_13.847428	550	630	2	77	80	0.9625000
NODE_3529_length_1246_cov_13.847428	550	630	4	3	80	0.0375000
NODE_3535_length_1245_cov_31.472949	443	523	0	35	80	0.4375000
NODE_3535_length_1245_cov_31.472949	443	523	2	45	80	0.5625000
NODE_3535_length_1245_cov_31.472949	496	576	0	17	80	0.2125000
NODE_3535_length_1245_cov_31.472949	496	576	2	63	80	0.7875000
NODE_3536_length_1245_cov_30.068935	771	841	0	33	70	0.4714286
NODE_3536_length_1245_cov_30.068935	771	841	2	37	70	0.5285714
NODE_3537_length_1245_cov_24.765271	668	748	0	80	80	1.0000000
NODE_3537_length_1245_cov_24.765271	721	801	0	80	80	1.0000000
NODE_3537_length_1245_cov_24.765271	797	877	0	80	80	1.0000000
NODE_3537_length_1245_cov_24.765271	850	930	0	80	80	1.0000000
NODE_3538_length_1245_cov_16.854276	655	735	0	80	80	1.0000000
NODE_3538_length_1245_cov_16.854276	701	771	0	70	70	1.0000000
NODE_3538_length_1245_cov_16.854276	708	788	0	80	80	1.0000000
NODE_3540_length_1245_cov_1.187609	1148	1194	0	46	46	1.0000000
NODE_3540_length_1245_cov_1.187609	1167	1245	0	78	78	1.0000000
NODE_3541_length_1244_cov_52.633188	501	581	0	80	80	1.0000000
NODE_3541_length_1244_cov_52.633188	554	634	0	80	80	1.0000000
NODE_3541_length_1244_cov_52.633188	630	710	0	80	80	1.0000000
NODE_3541_length_1244_cov_52.633188	683	763	0	80	80	1.0000000
NODE_3542_length_1244_cov_33.889956	445	525	2	80	80	1.0000000
NODE_3542_length_1244_cov_33.889956	498	578	0	27	80	0.3375000
NODE_3542_length_1244_cov_33.889956	498	578	2	53	80	0.6625000
NODE_3542_length_1244_cov_33.889956	574	654	0	80	80	1.0000000
NODE_3542_length_1244_cov_33.889956	627	707	0	80	80	1.0000000
NODE_3543_length_1244_cov_16.798253	644	724	0	80	80	1.0000000
NODE_3543_length_1244_cov_16.798253	697	777	0	80	80	1.0000000
NODE_3544_length_1244_cov_1.735371	276	347	0	71	71	1.0000000
NODE_3544_length_1244_cov_1.735371	276	347	0	71	71	1.0000000
NODE_3544_length_1244_cov_1.735371	320	400	0	80	80	1.0000000
NODE_3544_length_1244_cov_1.735371	320	400	0	80	80	1.0000000
NODE_3548_length_1243_cov_34.284965	774	854	0	80	80	1.0000000
NODE_3548_length_1243_cov_34.284965	827	907	0	80	80	1.0000000
NODE_3552_length_1242_cov_29.665792	539	619	0	80	80	1.0000000
NODE_3552_length_1242_cov_29.665792	592	672	0	80	80	1.0000000
NODE_3553_length_1242_cov_28.304462	506	586	0	80	80	1.0000000
NODE_3553_length_1242_cov_28.304462	559	639	0	80	80	1.0000000
NODE_3553_length_1242_cov_28.304462	635	715	0	44	80	0.5500000
NODE_3553_length_1242_cov_28.304462	635	715	2	5	80	0.0625000
NODE_3553_length_1242_cov_28.304462	635	715	4	31	80	0.3875000
NODE_3553_length_1242_cov_28.304462	688	768	4	45	80	0.5625000
NODE_3553_length_1242_cov_28.304462	688	768	6	35	80	0.4375000
NODE_3554_length_1242_cov_16.383202	704	784	2	6	80	0.0750000
NODE_3554_length_1242_cov_16.383202	704	784	4	36	80	0.4500000
NODE_3554_length_1242_cov_16.383202	704	784	6	8	80	0.1000000
NODE_3554_length_1242_cov_16.383202	704	784	8	30	80	0.3750000
NODE_3554_length_1242_cov_16.383202	757	837	6	7	80	0.0875000
NODE_3554_length_1242_cov_16.383202	757	837	8	73	80	0.9125000
NODE_3555_length_1242_cov_8.081365	688	768	0	80	80	1.0000000
NODE_3555_length_1242_cov_8.081365	741	821	0	80	80	1.0000000
NODE_3561_length_1241_cov_36.544658	602	682	0	80	80	1.0000000
NODE_3561_length_1241_cov_36.544658	655	735	0	80	80	1.0000000
NODE_3562_length_1241_cov_19.894921	676	756	0	27	80	0.3375000
NODE_3562_length_1241_cov_19.894921	676	756	2	53	80	0.6625000
NODE_3562_length_1241_cov_19.894921	729	809	2	80	80	1.0000000
NODE_3569_length_1240_cov_38.375110	483	563	0	21	80	0.2625000
NODE_3569_length_1240_cov_38.375110	483	563	2	59	80	0.7375000
NODE_3569_length_1240_cov_38.375110	536	616	0	30	80	0.3750000
NODE_3569_length_1240_cov_38.375110	536	616	2	23	80	0.2875000
NODE_3569_length_1240_cov_38.375110	536	616	5	2	80	0.0250000
NODE_3569_length_1240_cov_38.375110	536	616	6	25	80	0.3125000
NODE_3569_length_1240_cov_38.375110	612	692	6	80	80	1.0000000
NODE_3569_length_1240_cov_38.375110	665	745	0	33	80	0.4125000
NODE_3569_length_1240_cov_38.375110	665	745	6	47	80	0.5875000
NODE_3570_length_1240_cov_24.975460	625	705	0	80	80	1.0000000
NODE_3570_length_1240_cov_24.975460	678	758	0	80	80	1.0000000
NODE_3571_length_1240_cov_23.812445	731	811	0	46	80	0.5750000
NODE_3571_length_1240_cov_23.812445	731	811	2	34	80	0.4250000
NODE_3571_length_1240_cov_23.812445	784	864	2	74	80	0.9250000
NODE_3571_length_1240_cov_23.812445	784	864	4	6	80	0.0750000
NODE_3576_length_1239_cov_37.657895	399	479	2	71	80	0.8875000
NODE_3576_length_1239_cov_37.657895	399	479	4	9	80	0.1125000
NODE_3576_length_1239_cov_37.657895	452	532	0	7	80	0.0875000
NODE_3576_length_1239_cov_37.657895	452	532	2	73	80	0.9125000
NODE_3576_length_1239_cov_37.657895	528	608	0	15	80	0.1875000
NODE_3576_length_1239_cov_37.657895	528	608	2	65	80	0.8125000
NODE_3576_length_1239_cov_37.657895	581	661	0	53	80	0.6625000
NODE_3576_length_1239_cov_37.657895	581	661	2	27	80	0.3375000
NODE_3577_length_1239_cov_14.984211	398	478	0	80	80	1.0000000
NODE_3577_length_1239_cov_14.984211	451	531	0	80	80	1.0000000
NODE_3577_length_1239_cov_14.984211	771	825	0	54	54	1.0000000
NODE_3577_length_1239_cov_14.984211	798	878	0	80	80	1.0000000
NODE_3578_length_1239_cov_13.312281	806	886	0	24	80	0.3000000
NODE_3578_length_1239_cov_13.312281	806	886	2	56	80	0.7000000
NODE_3578_length_1239_cov_13.312281	859	939	0	25	80	0.3125000
NODE_3578_length_1239_cov_13.312281	859	939	2	55	80	0.6875000
NODE_3579_length_1239_cov_7.116667	444	524	0	5	80	0.0625000
NODE_3579_length_1239_cov_7.116667	444	524	4	75	80	0.9375000
NODE_3579_length_1239_cov_7.116667	497	577	0	58	80	0.7250000
NODE_3579_length_1239_cov_7.116667	497	577	4	22	80	0.2750000
NODE_3582_length_1238_cov_33.830553	625	705	0	80	80	1.0000000
NODE_3582_length_1238_cov_33.830553	678	758	0	80	80	1.0000000
NODE_3583_length_1238_cov_8.163301	664	744	8	11	80	0.1375000
NODE_3583_length_1238_cov_8.163301	664	744	10	66	80	0.8250000
NODE_3583_length_1238_cov_8.163301	664	744	12	2	80	0.0250000
NODE_3583_length_1238_cov_8.163301	664	744	14	1	80	0.0125000
NODE_3583_length_1238_cov_8.163301	717	797	4	24	80	0.3000000
NODE_3583_length_1238_cov_8.163301	717	797	6	5	80	0.0625000
NODE_3583_length_1238_cov_8.163301	717	797	10	48	80	0.6000000
NODE_3583_length_1238_cov_8.163301	717	797	12	2	80	0.0250000
NODE_3583_length_1238_cov_8.163301	717	797	14	1	80	0.0125000
NODE_3586_length_1237_cov_24.562390	447	527	6	80	80	1.0000000
NODE_3586_length_1237_cov_24.562390	500	580	0	38	80	0.4750000
NODE_3586_length_1237_cov_24.562390	500	580	6	42	80	0.5250000
NODE_3587_length_1237_cov_9.297012	515	595	0	6	80	0.0750000
NODE_3587_length_1237_cov_9.297012	515	595	2	35	80	0.4375000
NODE_3587_length_1237_cov_9.297012	515	595	4	39	80	0.4875000
NODE_3587_length_1237_cov_9.297012	568	648	0	2	80	0.0250000
NODE_3587_length_1237_cov_9.297012	568	648	2	38	80	0.4750000
NODE_3587_length_1237_cov_9.297012	568	648	4	40	80	0.5000000
NODE_3594_length_1236_cov_46.661390	632	712	10	10	80	0.1250000
NODE_3594_length_1236_cov_46.661390	632	712	12	11	80	0.1375000
NODE_3594_length_1236_cov_46.661390	632	712	14	6	80	0.0750000
NODE_3594_length_1236_cov_46.661390	632	712	16	31	80	0.3875000
NODE_3594_length_1236_cov_46.661390	632	712	18	14	80	0.1750000
NODE_3594_length_1236_cov_46.661390	632	712	20	8	80	0.1000000
NODE_3594_length_1236_cov_46.661390	685	765	6	16	80	0.2000000
NODE_3594_length_1236_cov_46.661390	685	765	8	13	80	0.1625000
NODE_3594_length_1236_cov_46.661390	685	765	10	4	80	0.0500000
NODE_3594_length_1236_cov_46.661390	685	765	16	11	80	0.1375000
NODE_3594_length_1236_cov_46.661390	685	765	18	28	80	0.3500000
NODE_3594_length_1236_cov_46.661390	685	765	20	8	80	0.1000000
NODE_3595_length_1236_cov_8.625330	735	815	0	43	80	0.5375000
NODE_3595_length_1236_cov_8.625330	735	815	2	37	80	0.4625000
NODE_3595_length_1236_cov_8.625330	788	868	0	21	80	0.2625000
NODE_3595_length_1236_cov_8.625330	788	868	2	59	80	0.7375000
NODE_3597_length_1235_cov_31.619718	331	411	0	80	80	1.0000000
NODE_3597_length_1235_cov_31.619718	384	464	0	80	80	1.0000000
NODE_3598_length_1235_cov_20.252641	559	639	0	37	80	0.4625000
NODE_3598_length_1235_cov_20.252641	559	639	2	43	80	0.5375000
NODE_3598_length_1235_cov_20.252641	612	692	0	80	80	1.0000000
NODE_3598_length_1235_cov_20.252641	688	768	0	80	80	1.0000000
NODE_3598_length_1235_cov_20.252641	741	821	0	80	80	1.0000000
NODE_3599_length_1235_cov_18.462148	695	775	0	36	80	0.4500000
NODE_3599_length_1235_cov_18.462148	695	775	2	44	80	0.5500000
NODE_3599_length_1235_cov_18.462148	748	828	2	80	80	1.0000000
NODE_3600_length_1235_cov_8.696303	765	845	0	80	80	1.0000000
NODE_3600_length_1235_cov_8.696303	818	898	0	80	80	1.0000000
NODE_3601_length_1235_cov_5.580106	544	624	0	4	80	0.0500000
NODE_3601_length_1235_cov_5.580106	544	624	2	34	80	0.4250000
NODE_3601_length_1235_cov_5.580106	544	624	4	42	80	0.5250000
NODE_3601_length_1235_cov_5.580106	597	677	0	8	80	0.1000000
NODE_3601_length_1235_cov_5.580106	597	677	2	5	80	0.0625000
NODE_3601_length_1235_cov_5.580106	597	677	4	67	80	0.8375000
NODE_3608_length_1234_cov_27.136564	528	608	0	80	80	1.0000000
NODE_3608_length_1234_cov_27.136564	581	661	0	80	80	1.0000000
NODE_3611_length_1233_cov_64.374780	497	577	0	80	80	1.0000000
NODE_3611_length_1233_cov_64.374780	550	630	0	80	80	1.0000000
NODE_3611_length_1233_cov_64.374780	626	706	0	80	80	1.0000000
NODE_3611_length_1233_cov_64.374780	679	759	0	41	80	0.5125000
NODE_3611_length_1233_cov_64.374780	679	759	2	39	80	0.4875000
NODE_3612_length_1233_cov_52.833333	654	734	0	78	80	0.9750000
NODE_3612_length_1233_cov_52.833333	654	734	4	2	80	0.0250000
NODE_3612_length_1233_cov_52.833333	707	787	0	25	80	0.3125000
NODE_3612_length_1233_cov_52.833333	707	787	4	3	80	0.0375000
NODE_3612_length_1233_cov_52.833333	707	787	6	1	80	0.0125000
NODE_3612_length_1233_cov_52.833333	707	787	8	51	80	0.6375000
NODE_3613_length_1233_cov_18.096120	522	602	6	21	80	0.2625000
NODE_3613_length_1233_cov_18.096120	522	602	11	2	80	0.0250000
NODE_3613_length_1233_cov_18.096120	522	602	13	37	80	0.4625000
NODE_3613_length_1233_cov_18.096120	522	602	17	20	80	0.2500000
NODE_3613_length_1233_cov_18.096120	575	655	11	27	80	0.3375000
NODE_3613_length_1233_cov_18.096120	575	655	13	33	80	0.4125000
NODE_3613_length_1233_cov_18.096120	575	655	17	20	80	0.2500000
NODE_3613_length_1233_cov_18.096120	651	731	0	61	80	0.7625000
NODE_3613_length_1233_cov_18.096120	651	731	4	6	80	0.0750000
NODE_3613_length_1233_cov_18.096120	651	731	9	2	80	0.0250000
NODE_3613_length_1233_cov_18.096120	651	731	10	1	80	0.0125000
NODE_3613_length_1233_cov_18.096120	651	731	11	10	80	0.1250000
NODE_3613_length_1233_cov_18.096120	704	784	0	80	80	1.0000000
NODE_3614_length_1233_cov_15.360670	585	656	0	71	71	1.0000000
NODE_3614_length_1233_cov_15.360670	631	709	0	78	78	1.0000000
NODE_3620_length_1232_cov_62.112974	552	632	0	19	80	0.2375000
NODE_3620_length_1232_cov_62.112974	552	632	2	61	80	0.7625000
NODE_3620_length_1232_cov_62.112974	605	694	0	81	89	0.9101124
NODE_3620_length_1232_cov_62.112974	605	694	2	8	89	0.0898876
NODE_3620_length_1232_cov_62.112974	690	770	0	4	80	0.0500000
NODE_3620_length_1232_cov_62.112974	690	770	2	45	80	0.5625000
NODE_3620_length_1232_cov_62.112974	690	770	4	31	80	0.3875000
NODE_3620_length_1232_cov_62.112974	743	823	2	46	80	0.5750000
NODE_3620_length_1232_cov_62.112974	743	823	4	34	80	0.4250000
NODE_3621_length_1232_cov_34.635481	469	549	0	26	80	0.3250000
NODE_3621_length_1232_cov_34.635481	469	549	2	54	80	0.6750000
NODE_3621_length_1232_cov_34.635481	522	602	0	42	80	0.5250000
NODE_3621_length_1232_cov_34.635481	522	602	2	38	80	0.4750000
NODE_3622_length_1232_cov_16.362754	774	854	0	80	80	1.0000000
NODE_3622_length_1232_cov_16.362754	827	907	0	80	80	1.0000000
NODE_3623_length_1232_cov_13.395410	234	315	0	56	81	0.6913580
NODE_3623_length_1232_cov_13.395410	234	315	2	25	81	0.3086420
NODE_3623_length_1232_cov_13.395410	287	368	0	81	81	1.0000000
NODE_3623_length_1232_cov_13.395410	364	444	0	80	80	1.0000000
NODE_3623_length_1232_cov_13.395410	417	497	0	80	80	1.0000000
NODE_3625_length_1231_cov_47.606890	509	589	0	26	80	0.3250000
NODE_3625_length_1231_cov_47.606890	509	589	1	1	80	0.0125000
NODE_3625_length_1231_cov_47.606890	509	589	2	53	80	0.6625000
NODE_3625_length_1231_cov_47.606890	562	642	2	35	80	0.4375000
NODE_3625_length_1231_cov_47.606890	562	642	6	23	80	0.2875000
NODE_3625_length_1231_cov_47.606890	562	642	8	5	80	0.0625000
NODE_3625_length_1231_cov_47.606890	562	642	9	13	80	0.1625000
NODE_3625_length_1231_cov_47.606890	562	642	11	4	80	0.0500000
NODE_3625_length_1231_cov_47.606890	638	718	10	33	80	0.4125000
NODE_3625_length_1231_cov_47.606890	638	718	11	45	80	0.5625000
NODE_3625_length_1231_cov_47.606890	638	718	12	2	80	0.0250000
NODE_3625_length_1231_cov_47.606890	691	771	2	12	80	0.1500000
NODE_3625_length_1231_cov_47.606890	691	771	4	13	80	0.1625000
NODE_3625_length_1231_cov_47.606890	691	771	6	7	80	0.0875000
NODE_3625_length_1231_cov_47.606890	691	771	10	48	80	0.6000000
NODE_3626_length_1231_cov_27.498233	698	777	2	17	79	0.2151899
NODE_3626_length_1231_cov_27.498233	698	777	4	62	79	0.7848101
NODE_3626_length_1231_cov_27.498233	750	830	0	44	80	0.5500000
NODE_3626_length_1231_cov_27.498233	750	830	2	24	80	0.3000000
NODE_3626_length_1231_cov_27.498233	750	830	4	12	80	0.1500000
NODE_3627_length_1231_cov_21.245583	673	753	3	35	80	0.4375000
NODE_3627_length_1231_cov_21.245583	673	753	4	2	80	0.0250000
NODE_3627_length_1231_cov_21.245583	673	753	5	8	80	0.1000000
NODE_3627_length_1231_cov_21.245583	673	753	6	35	80	0.4375000
NODE_3627_length_1231_cov_21.245583	726	806	0	9	80	0.1125000
NODE_3627_length_1231_cov_21.245583	726	806	2	30	80	0.3750000
NODE_3627_length_1231_cov_21.245583	726	806	4	16	80	0.2000000
NODE_3627_length_1231_cov_21.245583	726	806	6	25	80	0.3125000
NODE_3627_length_1231_cov_21.245583	802	882	0	80	80	1.0000000
NODE_3627_length_1231_cov_21.245583	860	935	0	75	75	1.0000000
NODE_3628_length_1231_cov_9.895760	515	595	0	52	80	0.6500000
NODE_3628_length_1231_cov_9.895760	515	595	4	25	80	0.3125000
NODE_3628_length_1231_cov_9.895760	515	595	6	3	80	0.0375000
NODE_3628_length_1231_cov_9.895760	568	648	4	24	80	0.3000000
NODE_3628_length_1231_cov_9.895760	568	648	6	56	80	0.7000000
NODE_3630_length_1230_cov_43.705570	412	492	12	13	80	0.1625000
NODE_3630_length_1230_cov_43.705570	412	492	16	4	80	0.0500000
NODE_3630_length_1230_cov_43.705570	412	492	18	46	80	0.5750000
NODE_3630_length_1230_cov_43.705570	412	492	21	1	80	0.0125000
NODE_3630_length_1230_cov_43.705570	412	492	22	16	80	0.2000000
NODE_3630_length_1230_cov_43.705570	465	545	4	45	80	0.5625000
NODE_3630_length_1230_cov_43.705570	465	545	6	2	80	0.0250000
NODE_3630_length_1230_cov_43.705570	465	545	12	19	80	0.2375000
NODE_3630_length_1230_cov_43.705570	465	545	16	4	80	0.0500000
NODE_3630_length_1230_cov_43.705570	465	545	22	10	80	0.1250000
NODE_3631_length_1230_cov_43.663130	501	581	0	1	80	0.0125000
NODE_3631_length_1230_cov_43.663130	501	581	2	79	80	0.9875000
NODE_3631_length_1230_cov_43.663130	554	634	0	54	80	0.6750000
NODE_3631_length_1230_cov_43.663130	554	634	2	26	80	0.3250000
NODE_3632_length_1230_cov_33.173298	315	395	0	80	80	1.0000000
NODE_3632_length_1230_cov_33.173298	368	448	0	80	80	1.0000000
NODE_3633_length_1230_cov_12.939876	201	281	0	4	80	0.0500000
NODE_3633_length_1230_cov_12.939876	201	281	4	11	80	0.1375000
NODE_3633_length_1230_cov_12.939876	201	281	6	61	80	0.7625000
NODE_3633_length_1230_cov_12.939876	201	281	8	4	80	0.0500000
NODE_3633_length_1230_cov_12.939876	218	273	6	55	55	1.0000000
NODE_3633_length_1230_cov_12.939876	254	334	2	21	80	0.2625000
NODE_3633_length_1230_cov_12.939876	254	334	6	38	80	0.4750000
NODE_3633_length_1230_cov_12.939876	254	334	8	21	80	0.2625000
NODE_3633_length_1230_cov_12.939876	330	410	0	17	80	0.2125000
NODE_3633_length_1230_cov_12.939876	330	410	2	63	80	0.7875000
NODE_3633_length_1230_cov_12.939876	383	463	0	70	80	0.8750000
NODE_3633_length_1230_cov_12.939876	383	463	2	10	80	0.1250000
NODE_3634_length_1230_cov_5.155615	248	328	0	11	80	0.1375000
NODE_3634_length_1230_cov_5.155615	248	328	3	3	80	0.0375000
NODE_3634_length_1230_cov_5.155615	248	328	4	3	80	0.0375000
NODE_3634_length_1230_cov_5.155615	248	328	6	63	80	0.7875000
NODE_3634_length_1230_cov_5.155615	301	381	6	80	80	1.0000000
NODE_3640_length_1229_cov_30.214159	341	421	0	75	80	0.9375000
NODE_3640_length_1229_cov_30.214159	341	421	2	5	80	0.0625000
NODE_3640_length_1229_cov_30.214159	394	474	0	23	80	0.2875000
NODE_3640_length_1229_cov_30.214159	394	474	2	57	80	0.7125000
NODE_3641_length_1229_cov_23.165487	376	456	0	42	80	0.5250000
NODE_3641_length_1229_cov_23.165487	376	456	2	38	80	0.4750000
NODE_3641_length_1229_cov_23.165487	429	509	0	80	80	1.0000000
NODE_3641_length_1229_cov_23.165487	505	585	0	80	80	1.0000000
NODE_3641_length_1229_cov_23.165487	558	638	0	80	80	1.0000000
NODE_3642_length_1229_cov_19.376991	484	564	0	80	80	1.0000000
NODE_3642_length_1229_cov_19.376991	537	614	0	77	77	1.0000000
NODE_3643_length_1229_cov_11.799115	670	748	0	78	78	1.0000000
NODE_3643_length_1229_cov_11.799115	728	801	0	73	73	1.0000000
NODE_3644_length_1229_cov_8.140708	970	1050	0	80	80	1.0000000
NODE_3644_length_1229_cov_8.140708	1023	1103	0	80	80	1.0000000
NODE_3646_length_1229_cov_3.654867	765	840	0	75	75	1.0000000
NODE_3646_length_1229_cov_3.654867	813	893	0	80	80	1.0000000
NODE_3652_length_1229_cov_0.949558	1034	1079	6	25	45	0.5555556
NODE_3652_length_1229_cov_0.949558	1034	1079	8	18	45	0.4000000
NODE_3652_length_1229_cov_0.949558	1034	1079	10	2	45	0.0444444
NODE_3652_length_1229_cov_0.949558	1090	1130	8	40	40	1.0000000
NODE_3654_length_1228_cov_22.622675	604	684	0	56	80	0.7000000
NODE_3654_length_1228_cov_22.622675	604	684	4	24	80	0.3000000
NODE_3654_length_1228_cov_22.622675	657	738	0	3	81	0.0370370
NODE_3654_length_1228_cov_22.622675	657	738	4	78	81	0.9629630
NODE_3655_length_1228_cov_17.900797	423	503	0	46	80	0.5750000
NODE_3655_length_1228_cov_17.900797	423	503	4	34	80	0.4250000
NODE_3655_length_1228_cov_17.900797	423	503	0	46	80	0.5750000
NODE_3655_length_1228_cov_17.900797	423	503	4	34	80	0.4250000
NODE_3655_length_1228_cov_17.900797	423	503	0	46	80	0.5750000
NODE_3655_length_1228_cov_17.900797	423	503	4	34	80	0.4250000
NODE_3655_length_1228_cov_17.900797	476	538	4	62	62	1.0000000
NODE_3655_length_1228_cov_17.900797	476	538	4	62	62	1.0000000
NODE_3655_length_1228_cov_17.900797	476	538	4	62	62	1.0000000
NODE_3655_length_1228_cov_17.900797	476	556	4	80	80	1.0000000
NODE_3656_length_1228_cov_14.554473	367	447	0	80	80	1.0000000
NODE_3656_length_1228_cov_14.554473	420	500	0	80	80	1.0000000
NODE_3657_length_1228_cov_10.021258	661	741	0	11	80	0.1375000
NODE_3657_length_1228_cov_10.021258	661	741	2	69	80	0.8625000
NODE_3657_length_1228_cov_10.021258	714	794	0	64	80	0.8000000
NODE_3657_length_1228_cov_10.021258	714	794	2	16	80	0.2000000
NODE_3660_length_1228_cov_3.987600	1139	1219	0	80	80	1.0000000
NODE_3662_length_1227_cov_29.002660	423	503	0	80	80	1.0000000
NODE_3662_length_1227_cov_29.002660	476	556	0	80	80	1.0000000
NODE_3663_length_1227_cov_17.479610	759	839	0	80	80	1.0000000
NODE_3663_length_1227_cov_17.479610	812	892	0	80	80	1.0000000
NODE_3666_length_1227_cov_3.808511	120	186	7	3	66	0.0454545
NODE_3666_length_1227_cov_3.808511	120	186	12	24	66	0.3636364
NODE_3666_length_1227_cov_3.808511	120	186	14	15	66	0.2272727
NODE_3666_length_1227_cov_3.808511	120	186	16	24	66	0.3636364
NODE_3666_length_1227_cov_3.808511	173	239	14	10	66	0.1515152
NODE_3666_length_1227_cov_3.808511	173	239	16	34	66	0.5151515
NODE_3666_length_1227_cov_3.808511	173	239	18	2	66	0.0303030
NODE_3666_length_1227_cov_3.808511	173	239	20	20	66	0.3030303
NODE_3666_length_1227_cov_3.808511	229	299	0	14	70	0.2000000
NODE_3666_length_1227_cov_3.808511	229	299	2	7	70	0.1000000
NODE_3666_length_1227_cov_3.808511	229	299	4	7	70	0.1000000
NODE_3666_length_1227_cov_3.808511	229	299	7	2	70	0.0285714
NODE_3666_length_1227_cov_3.808511	229	299	10	1	70	0.0142857
NODE_3666_length_1227_cov_3.808511	229	299	12	21	70	0.3000000
NODE_3666_length_1227_cov_3.808511	229	299	14	18	70	0.2571429
NODE_3672_length_1226_cov_23.792369	579	659	0	10	80	0.1250000
NODE_3672_length_1226_cov_23.792369	579	659	2	70	80	0.8750000
NODE_3672_length_1226_cov_23.792369	632	712	0	21	80	0.2625000
NODE_3672_length_1226_cov_23.792369	632	712	2	59	80	0.7375000
NODE_3672_length_1226_cov_23.792369	708	788	0	39	80	0.4875000
NODE_3672_length_1226_cov_23.792369	708	788	1	41	80	0.5125000
NODE_3672_length_1226_cov_23.792369	761	839	1	28	78	0.3589744
NODE_3672_length_1226_cov_23.792369	761	839	2	50	78	0.6410257
NODE_3673_length_1226_cov_5.620231	463	543	2	53	80	0.6625000
NODE_3673_length_1226_cov_5.620231	463	543	4	27	80	0.3375000
NODE_3673_length_1226_cov_5.620231	516	596	2	54	80	0.6750000
NODE_3673_length_1226_cov_5.620231	516	596	4	26	80	0.3250000
NODE_3674_length_1226_cov_4.881988	582	662	0	80	80	1.0000000
NODE_3674_length_1226_cov_4.881988	635	715	0	80	80	1.0000000
NODE_3682_length_1225_cov_55.596803	637	717	4	80	80	1.0000000
NODE_3682_length_1225_cov_55.596803	690	770	4	67	80	0.8375000
NODE_3682_length_1225_cov_55.596803	690	770	6	6	80	0.0750000
NODE_3682_length_1225_cov_55.596803	690	770	10	7	80	0.0875000
NODE_3682_length_1225_cov_55.596803	766	846	6	47	80	0.5875000
NODE_3682_length_1225_cov_55.596803	766	846	10	33	80	0.4125000
NODE_3682_length_1225_cov_55.596803	819	899	4	1	80	0.0125000
NODE_3682_length_1225_cov_55.596803	819	899	10	79	80	0.9875000
NODE_3683_length_1225_cov_35.189165	661	742	2	43	81	0.5308642
NODE_3683_length_1225_cov_35.189165	661	742	6	20	81	0.2469136
NODE_3683_length_1225_cov_35.189165	661	742	8	18	81	0.2222222
NODE_3683_length_1225_cov_35.189165	714	795	2	15	81	0.1851852
NODE_3683_length_1225_cov_35.189165	714	795	6	30	81	0.3703704
NODE_3683_length_1225_cov_35.189165	714	795	7	1	81	0.0123457
NODE_3683_length_1225_cov_35.189165	714	795	8	35	81	0.4320988
NODE_3684_length_1225_cov_33.755773	456	535	0	68	79	0.8607595
NODE_3684_length_1225_cov_33.755773	456	535	2	11	79	0.1392405
NODE_3684_length_1225_cov_33.755773	508	588	0	16	80	0.2000000
NODE_3684_length_1225_cov_33.755773	508	588	2	64	80	0.8000000
NODE_3685_length_1225_cov_30.116341	566	646	0	61	80	0.7625000
NODE_3685_length_1225_cov_30.116341	566	646	5	19	80	0.2375000
NODE_3685_length_1225_cov_30.116341	619	699	0	8	80	0.1000000
NODE_3685_length_1225_cov_30.116341	619	699	5	45	80	0.5625000
NODE_3685_length_1225_cov_30.116341	619	699	10	27	80	0.3375000
NODE_3685_length_1225_cov_30.116341	695	775	10	80	80	1.0000000
NODE_3685_length_1225_cov_30.116341	748	828	0	6	80	0.0750000
NODE_3685_length_1225_cov_30.116341	748	828	5	45	80	0.5625000
NODE_3685_length_1225_cov_30.116341	748	828	10	29	80	0.3625000
NODE_3686_length_1225_cov_29.177620	195	275	0	42	80	0.5250000
NODE_3686_length_1225_cov_29.177620	195	275	4	38	80	0.4750000
NODE_3686_length_1225_cov_29.177620	248	328	0	13	80	0.1625000
NODE_3686_length_1225_cov_29.177620	248	328	4	67	80	0.8375000
NODE_3687_length_1225_cov_26.849023	588	668	0	80	80	1.0000000
NODE_3687_length_1225_cov_26.849023	641	721	0	80	80	1.0000000
NODE_3687_length_1225_cov_26.849023	717	797	0	80	80	1.0000000
NODE_3687_length_1225_cov_26.849023	770	850	0	80	80	1.0000000
NODE_3688_length_1225_cov_24.444938	386	466	0	80	80	1.0000000
NODE_3688_length_1225_cov_24.444938	439	519	0	80	80	1.0000000
NODE_3690_length_1225_cov_19.369449	491	571	0	80	80	1.0000000
NODE_3690_length_1225_cov_19.369449	544	624	0	80	80	1.0000000
NODE_3690_length_1225_cov_19.369449	620	700	0	80	80	1.0000000
NODE_3690_length_1225_cov_19.369449	673	753	0	80	80	1.0000000
NODE_3691_length_1225_cov_13.281528	462	542	0	80	80	1.0000000
NODE_3691_length_1225_cov_13.281528	515	595	0	80	80	1.0000000
NODE_3691_length_1225_cov_13.281528	591	671	0	39	80	0.4875000
NODE_3691_length_1225_cov_13.281528	591	671	2	41	80	0.5125000
NODE_3691_length_1225_cov_13.281528	644	724	2	57	80	0.7125000
NODE_3691_length_1225_cov_13.281528	644	724	4	23	80	0.2875000
NODE_3692_length_1225_cov_10.887211	566	646	0	35	80	0.4375000
NODE_3692_length_1225_cov_10.887211	566	646	2	45	80	0.5625000
NODE_3692_length_1225_cov_10.887211	619	699	2	80	80	1.0000000
NODE_3696_length_1224_cov_24.568889	613	693	0	79	80	0.9875000
NODE_3696_length_1224_cov_24.568889	613	693	2	1	80	0.0125000
NODE_3696_length_1224_cov_24.568889	666	746	0	26	80	0.3250000
NODE_3696_length_1224_cov_24.568889	666	746	2	5	80	0.0625000
NODE_3696_length_1224_cov_24.568889	666	746	7	18	80	0.2250000
NODE_3696_length_1224_cov_24.568889	666	746	8	31	80	0.3875000
NODE_3697_length_1224_cov_17.538667	762	842	0	80	80	1.0000000
NODE_3697_length_1224_cov_17.538667	815	895	0	80	80	1.0000000
NODE_3698_length_1224_cov_14.138667	389	469	4	20	80	0.2500000
NODE_3698_length_1224_cov_14.138667	389	469	6	53	80	0.6625000
NODE_3698_length_1224_cov_14.138667	389	469	8	3	80	0.0375000
NODE_3698_length_1224_cov_14.138667	389	469	10	4	80	0.0500000
NODE_3698_length_1224_cov_14.138667	442	522	4	73	80	0.9125000
NODE_3698_length_1224_cov_14.138667	442	522	6	3	80	0.0375000
NODE_3698_length_1224_cov_14.138667	442	522	8	3	80	0.0375000
NODE_3698_length_1224_cov_14.138667	442	522	10	1	80	0.0125000
NODE_3699_length_1224_cov_11.358222	704	784	0	80	80	1.0000000
NODE_3699_length_1224_cov_11.358222	757	837	0	80	80	1.0000000
NODE_3700_length_1224_cov_6.963556	516	581	0	17	65	0.2615385
NODE_3700_length_1224_cov_6.963556	516	581	10	48	65	0.7384616
NODE_3705_length_1223_cov_44.608541	548	630	2	56	82	0.6829268
NODE_3705_length_1223_cov_44.608541	548	630	4	26	82	0.3170732
NODE_3705_length_1223_cov_44.608541	601	683	0	28	82	0.3414634
NODE_3705_length_1223_cov_44.608541	601	683	2	54	82	0.6585366
NODE_3705_length_1223_cov_44.608541	679	759	0	80	80	1.0000000
NODE_3705_length_1223_cov_44.608541	732	812	0	80	80	1.0000000
NODE_3706_length_1223_cov_26.730427	508	588	0	80	80	1.0000000
NODE_3706_length_1223_cov_26.730427	561	641	0	80	80	1.0000000
NODE_3707_length_1223_cov_18.902135	460	540	0	19	80	0.2375000
NODE_3707_length_1223_cov_18.902135	460	540	2	61	80	0.7625000
NODE_3707_length_1223_cov_18.902135	513	593	0	68	80	0.8500000
NODE_3707_length_1223_cov_18.902135	513	593	2	12	80	0.1500000
NODE_3708_length_1223_cov_6.989324	707	778	10	13	71	0.1830986
NODE_3708_length_1223_cov_6.989324	707	778	12	58	71	0.8169014
NODE_3710_length_1223_cov_5.251779	666	746	0	77	80	0.9625000
NODE_3710_length_1223_cov_5.251779	666	746	4	3	80	0.0375000
NODE_3710_length_1223_cov_5.251779	719	799	0	80	80	1.0000000
NODE_3710_length_1223_cov_5.251779	795	875	0	80	80	1.0000000
NODE_3710_length_1223_cov_5.251779	848	928	0	32	80	0.4000000
NODE_3710_length_1223_cov_5.251779	848	928	2	25	80	0.3125000
NODE_3710_length_1223_cov_5.251779	848	928	4	23	80	0.2875000
NODE_3716_length_1222_cov_18.406946	273	353	0	27	80	0.3375000
NODE_3716_length_1222_cov_18.406946	273	353	2	53	80	0.6625000
NODE_3716_length_1222_cov_18.406946	326	406	0	14	80	0.1750000
NODE_3716_length_1222_cov_18.406946	326	406	2	66	80	0.8250000
NODE_3720_length_1221_cov_33.261141	505	577	2	10	72	0.1388889
NODE_3720_length_1221_cov_33.261141	505	577	5	7	72	0.0972222
NODE_3720_length_1221_cov_33.261141	505	577	9	33	72	0.4583333
NODE_3720_length_1221_cov_33.261141	505	577	10	22	72	0.3055556
NODE_3720_length_1221_cov_33.261141	558	637	2	12	79	0.1518987
NODE_3720_length_1221_cov_33.261141	558	637	4	1	79	0.0126582
NODE_3720_length_1221_cov_33.261141	558	637	6	4	79	0.0506329
NODE_3720_length_1221_cov_33.261141	558	637	8	1	79	0.0126582
NODE_3720_length_1221_cov_33.261141	558	637	9	1	79	0.0126582
NODE_3720_length_1221_cov_33.261141	558	637	10	60	79	0.7594936
NODE_3720_length_1221_cov_33.261141	633	713	0	2	80	0.0250000
NODE_3720_length_1221_cov_33.261141	633	713	2	78	80	0.9750000
NODE_3720_length_1221_cov_33.261141	686	766	0	55	80	0.6875000
NODE_3720_length_1221_cov_33.261141	686	766	2	25	80	0.3125000
NODE_3721_length_1221_cov_19.466132	541	621	0	80	80	1.0000000
NODE_3721_length_1221_cov_19.466132	594	674	0	80	80	1.0000000
NODE_3722_length_1221_cov_15.940285	788	868	0	80	80	1.0000000
NODE_3722_length_1221_cov_15.940285	841	921	0	80	80	1.0000000
NODE_3722_length_1221_cov_15.940285	917	997	0	80	80	1.0000000
NODE_3722_length_1221_cov_15.940285	970	1050	0	80	80	1.0000000
NODE_3723_length_1221_cov_15.796791	484	564	0	80	80	1.0000000
NODE_3723_length_1221_cov_15.796791	537	617	0	80	80	1.0000000
NODE_3724_length_1221_cov_15.312834	342	415	2	25	73	0.3424658
NODE_3724_length_1221_cov_15.312834	342	415	4	48	73	0.6575342
NODE_3724_length_1221_cov_15.312834	395	474	0	3	79	0.0379747
NODE_3724_length_1221_cov_15.312834	395	474	2	68	79	0.8607595
NODE_3724_length_1221_cov_15.312834	395	474	4	8	79	0.1012658
NODE_3725_length_1221_cov_9.695187	988	1068	2	60	80	0.7500000
NODE_3725_length_1221_cov_9.695187	988	1068	4	20	80	0.2500000
NODE_3725_length_1221_cov_9.695187	1041	1100	0	8	59	0.1355932
NODE_3725_length_1221_cov_9.695187	1041	1100	2	51	59	0.8644068
NODE_3726_length_1221_cov_9.043672	695	775	0	80	80	1.0000000
NODE_3726_length_1221_cov_9.043672	748	828	0	80	80	1.0000000
NODE_3727_length_1221_cov_7.946524	147	227	0	4	80	0.0500000
NODE_3727_length_1221_cov_7.946524	147	227	2	76	80	0.9500000
NODE_3727_length_1221_cov_7.946524	200	280	0	21	80	0.2625000
NODE_3727_length_1221_cov_7.946524	200	280	2	59	80	0.7375000
NODE_3728_length_1221_cov_5.122103	248	328	4	80	80	1.0000000
NODE_3728_length_1221_cov_5.122103	301	381	0	14	80	0.1750000
NODE_3728_length_1221_cov_5.122103	301	381	4	66	80	0.8250000
NODE_3736_length_1220_cov_44.501338	319	399	8	80	80	1.0000000
NODE_3736_length_1220_cov_44.501338	372	452	2	8	80	0.1000000
NODE_3736_length_1220_cov_44.501338	372	452	8	60	80	0.7500000
NODE_3736_length_1220_cov_44.501338	372	452	10	12	80	0.1500000
NODE_3736_length_1220_cov_44.501338	448	528	2	21	80	0.2625000
NODE_3736_length_1220_cov_44.501338	448	528	4	34	80	0.4250000
NODE_3736_length_1220_cov_44.501338	448	528	9	25	80	0.3125000
NODE_3736_length_1220_cov_44.501338	501	581	4	2	80	0.0250000
NODE_3736_length_1220_cov_44.501338	501	581	5	34	80	0.4250000
NODE_3736_length_1220_cov_44.501338	501	581	7	17	80	0.2125000
NODE_3736_length_1220_cov_44.501338	501	581	9	27	80	0.3375000
NODE_3737_length_1220_cov_43.868867	720	800	0	25	80	0.3125000
NODE_3737_length_1220_cov_43.868867	720	800	2	15	80	0.1875000
NODE_3737_length_1220_cov_43.868867	720	800	6	40	80	0.5000000
NODE_3737_length_1220_cov_43.868867	773	853	6	80	80	1.0000000
NODE_3738_length_1220_cov_41.900089	593	673	2	16	80	0.2000000
NODE_3738_length_1220_cov_41.900089	593	673	4	6	80	0.0750000
NODE_3738_length_1220_cov_41.900089	593	673	6	58	80	0.7250000
NODE_3738_length_1220_cov_41.900089	646	726	0	37	80	0.4625000
NODE_3738_length_1220_cov_41.900089	646	726	4	22	80	0.2750000
NODE_3738_length_1220_cov_41.900089	646	726	6	21	80	0.2625000
NODE_3738_length_1220_cov_41.900089	722	802	0	15	80	0.1875000
NODE_3738_length_1220_cov_41.900089	722	802	6	65	80	0.8125000
NODE_3738_length_1220_cov_41.900089	775	855	0	11	80	0.1375000
NODE_3738_length_1220_cov_41.900089	775	855	6	69	80	0.8625000
NODE_3739_length_1220_cov_15.485281	395	475	0	16	80	0.2000000
NODE_3739_length_1220_cov_15.485281	395	475	6	64	80	0.8000000
NODE_3739_length_1220_cov_15.485281	448	528	0	9	80	0.1125000
NODE_3739_length_1220_cov_15.485281	448	528	6	71	80	0.8875000
NODE_3745_length_1219_cov_30.493750	643	723	0	80	80	1.0000000
NODE_3745_length_1219_cov_30.493750	696	776	0	80	80	1.0000000
NODE_3745_length_1219_cov_30.493750	772	852	0	80	80	1.0000000
NODE_3745_length_1219_cov_30.493750	825	905	0	80	80	1.0000000
NODE_3746_length_1219_cov_24.991071	566	646	0	80	80	1.0000000
NODE_3746_length_1219_cov_24.991071	619	699	0	80	80	1.0000000
NODE_3746_length_1219_cov_24.991071	695	775	0	80	80	1.0000000
NODE_3746_length_1219_cov_24.991071	748	828	0	80	80	1.0000000
NODE_3747_length_1219_cov_24.728571	465	545	0	80	80	1.0000000
NODE_3747_length_1219_cov_24.728571	518	598	0	68	80	0.8500000
NODE_3747_length_1219_cov_24.728571	518	598	4	12	80	0.1500000
NODE_3747_length_1219_cov_24.728571	594	674	4	80	80	1.0000000
NODE_3747_length_1219_cov_24.728571	647	727	0	52	80	0.6500000
NODE_3747_length_1219_cov_24.728571	647	727	4	28	80	0.3500000
NODE_3748_length_1219_cov_11.130357	535	615	0	80	80	1.0000000
NODE_3748_length_1219_cov_11.130357	588	668	0	80	80	1.0000000
NODE_3749_length_1219_cov_9.696429	734	814	0	10	80	0.1250000
NODE_3749_length_1219_cov_9.696429	734	814	2	70	80	0.8750000
NODE_3749_length_1219_cov_9.696429	787	867	0	53	80	0.6625000
NODE_3749_length_1219_cov_9.696429	787	867	2	27	80	0.3375000
NODE_3754_length_1218_cov_40.159071	554	634	0	16	80	0.2000000
NODE_3754_length_1218_cov_40.159071	554	634	2	64	80	0.8000000
NODE_3754_length_1218_cov_40.159071	607	687	0	8	80	0.1000000
NODE_3754_length_1218_cov_40.159071	607	687	2	72	80	0.9000000
NODE_3754_length_1218_cov_40.159071	683	763	0	80	80	1.0000000
NODE_3754_length_1218_cov_40.159071	736	816	0	80	80	1.0000000
NODE_3765_length_1216_cov_99.538944	44	124	138	1	80	0.0125000
NODE_3765_length_1216_cov_99.538944	44	124	140	1	80	0.0125000
NODE_3765_length_1216_cov_99.538944	44	124	142	1	80	0.0125000
NODE_3765_length_1216_cov_99.538944	44	124	148	1	80	0.0125000
NODE_3765_length_1216_cov_99.538944	44	124	161	1	80	0.0125000
NODE_3765_length_1216_cov_99.538944	44	124	163	1	80	0.0125000
NODE_3765_length_1216_cov_99.538944	44	124	168	1	80	0.0125000
NODE_3765_length_1216_cov_99.538944	44	124	173	1	80	0.0125000
NODE_3765_length_1216_cov_99.538944	44	124	177	1	80	0.0125000
NODE_3765_length_1216_cov_99.538944	44	124	183	1	80	0.0125000
NODE_3765_length_1216_cov_99.538944	44	124	189	3	80	0.0375000
NODE_3765_length_1216_cov_99.538944	44	124	191	1	80	0.0125000
NODE_3765_length_1216_cov_99.538944	44	124	205	1	80	0.0125000
NODE_3765_length_1216_cov_99.538944	44	124	209	1	80	0.0125000
NODE_3765_length_1216_cov_99.538944	44	124	223	2	80	0.0250000
NODE_3765_length_1216_cov_99.538944	44	124	224	1	80	0.0125000
NODE_3765_length_1216_cov_99.538944	44	124	232	1	80	0.0125000
NODE_3765_length_1216_cov_99.538944	44	124	236	2	80	0.0250000
NODE_3765_length_1216_cov_99.538944	44	124	239	1	80	0.0125000
NODE_3765_length_1216_cov_99.538944	44	124	243	1	80	0.0125000
NODE_3765_length_1216_cov_99.538944	44	124	244	1	80	0.0125000
NODE_3765_length_1216_cov_99.538944	44	124	252	1	80	0.0125000
NODE_3765_length_1216_cov_99.538944	44	124	254	2	80	0.0250000
NODE_3765_length_1216_cov_99.538944	44	124	260	1	80	0.0125000
NODE_3765_length_1216_cov_99.538944	44	124	264	1	80	0.0125000
NODE_3765_length_1216_cov_99.538944	44	124	274	1	80	0.0125000
NODE_3765_length_1216_cov_99.538944	44	124	280	1	80	0.0125000
NODE_3765_length_1216_cov_99.538944	44	124	281	1	80	0.0125000
NODE_3765_length_1216_cov_99.538944	44	124	283	2	80	0.0250000
NODE_3765_length_1216_cov_99.538944	44	124	289	1	80	0.0125000
NODE_3765_length_1216_cov_99.538944	44	124	291	1	80	0.0125000
NODE_3765_length_1216_cov_99.538944	44	124	297	1	80	0.0125000
NODE_3765_length_1216_cov_99.538944	44	124	303	1	80	0.0125000
NODE_3765_length_1216_cov_99.538944	44	124	311	2	80	0.0250000
NODE_3765_length_1216_cov_99.538944	44	124	322	1	80	0.0125000
NODE_3765_length_1216_cov_99.538944	44	124	328	1	80	0.0125000
NODE_3765_length_1216_cov_99.538944	44	124	331	1	80	0.0125000
NODE_3765_length_1216_cov_99.538944	44	124	335	1	80	0.0125000
NODE_3765_length_1216_cov_99.538944	44	124	337	1	80	0.0125000
NODE_3765_length_1216_cov_99.538944	44	124	342	1	80	0.0125000
NODE_3765_length_1216_cov_99.538944	44	124	343	1	80	0.0125000
NODE_3765_length_1216_cov_99.538944	44	124	345	1	80	0.0125000
NODE_3765_length_1216_cov_99.538944	44	124	347	3	80	0.0375000
NODE_3765_length_1216_cov_99.538944	44	124	362	1	80	0.0125000
NODE_3765_length_1216_cov_99.538944	44	124	366	1	80	0.0125000
NODE_3765_length_1216_cov_99.538944	44	124	368	1	80	0.0125000
NODE_3765_length_1216_cov_99.538944	44	124	369	3	80	0.0375000
NODE_3765_length_1216_cov_99.538944	44	124	371	3	80	0.0375000
NODE_3765_length_1216_cov_99.538944	44	124	372	5	80	0.0625000
NODE_3765_length_1216_cov_99.538944	44	124	373	1	80	0.0125000
NODE_3765_length_1216_cov_99.538944	44	124	374	2	80	0.0250000
NODE_3765_length_1216_cov_99.538944	44	124	375	3	80	0.0375000
NODE_3765_length_1216_cov_99.538944	44	124	376	4	80	0.0500000
NODE_3765_length_1216_cov_99.538944	44	124	377	2	80	0.0250000
NODE_3765_length_1216_cov_99.538944	44	124	379	2	80	0.0250000
NODE_3765_length_1216_cov_99.538944	97	157	351	1	60	0.0166667
NODE_3765_length_1216_cov_99.538944	97	157	354	2	60	0.0333333
NODE_3765_length_1216_cov_99.538944	97	157	363	1	60	0.0166667
NODE_3765_length_1216_cov_99.538944	97	157	364	2	60	0.0333333
NODE_3765_length_1216_cov_99.538944	97	157	366	2	60	0.0333333
NODE_3765_length_1216_cov_99.538944	97	157	368	3	60	0.0500000
NODE_3765_length_1216_cov_99.538944	97	157	369	4	60	0.0666667
NODE_3765_length_1216_cov_99.538944	97	157	370	2	60	0.0333333
NODE_3765_length_1216_cov_99.538944	97	157	371	3	60	0.0500000
NODE_3765_length_1216_cov_99.538944	97	157	372	5	60	0.0833333
NODE_3765_length_1216_cov_99.538944	97	157	373	1	60	0.0166667
NODE_3765_length_1216_cov_99.538944	97	157	374	3	60	0.0500000
NODE_3765_length_1216_cov_99.538944	97	157	375	6	60	0.1000000
NODE_3765_length_1216_cov_99.538944	97	157	376	5	60	0.0833333
NODE_3765_length_1216_cov_99.538944	97	157	377	5	60	0.0833333
NODE_3765_length_1216_cov_99.538944	97	157	378	2	60	0.0333333
NODE_3765_length_1216_cov_99.538944	97	157	379	3	60	0.0500000
NODE_3765_length_1216_cov_99.538944	97	157	380	2	60	0.0333333
NODE_3765_length_1216_cov_99.538944	97	157	383	1	60	0.0166667
NODE_3765_length_1216_cov_99.538944	97	157	384	3	60	0.0500000
NODE_3765_length_1216_cov_99.538944	97	157	386	2	60	0.0333333
NODE_3765_length_1216_cov_99.538944	97	157	394	2	60	0.0333333
NODE_3765_length_1216_cov_99.538944	824	903	111	3	79	0.0379747
NODE_3765_length_1216_cov_99.538944	824	903	112	3	79	0.0379747
NODE_3765_length_1216_cov_99.538944	824	903	113	2	79	0.0253165
NODE_3765_length_1216_cov_99.538944	824	903	114	1	79	0.0126582
NODE_3765_length_1216_cov_99.538944	824	903	116	3	79	0.0379747
NODE_3765_length_1216_cov_99.538944	824	903	118	2	79	0.0253165
NODE_3765_length_1216_cov_99.538944	824	903	119	1	79	0.0126582
NODE_3765_length_1216_cov_99.538944	824	903	120	2	79	0.0253165
NODE_3765_length_1216_cov_99.538944	824	903	121	1	79	0.0126582
NODE_3765_length_1216_cov_99.538944	824	903	122	4	79	0.0506329
NODE_3765_length_1216_cov_99.538944	824	903	123	1	79	0.0126582
NODE_3765_length_1216_cov_99.538944	824	903	124	1	79	0.0126582
NODE_3765_length_1216_cov_99.538944	824	903	125	1	79	0.0126582
NODE_3765_length_1216_cov_99.538944	824	903	126	2	79	0.0253165
NODE_3765_length_1216_cov_99.538944	824	903	127	1	79	0.0126582
NODE_3765_length_1216_cov_99.538944	824	903	128	2	79	0.0253165
NODE_3765_length_1216_cov_99.538944	824	903	130	5	79	0.0632911
NODE_3765_length_1216_cov_99.538944	824	903	132	1	79	0.0126582
NODE_3765_length_1216_cov_99.538944	824	903	134	2	79	0.0253165
NODE_3765_length_1216_cov_99.538944	824	903	136	4	79	0.0506329
NODE_3765_length_1216_cov_99.538944	824	903	140	1	79	0.0126582
NODE_3765_length_1216_cov_99.538944	824	903	142	3	79	0.0379747
NODE_3765_length_1216_cov_99.538944	824	903	144	2	79	0.0253165
NODE_3765_length_1216_cov_99.538944	824	903	157	1	79	0.0126582
NODE_3765_length_1216_cov_99.538944	824	903	163	1	79	0.0126582
NODE_3765_length_1216_cov_99.538944	824	903	165	1	79	0.0126582
NODE_3765_length_1216_cov_99.538944	824	903	168	1	79	0.0126582
NODE_3765_length_1216_cov_99.538944	824	903	170	1	79	0.0126582
NODE_3765_length_1216_cov_99.538944	824	903	178	1	79	0.0126582
NODE_3765_length_1216_cov_99.538944	824	903	188	1	79	0.0126582
NODE_3765_length_1216_cov_99.538944	824	903	196	1	79	0.0126582
NODE_3765_length_1216_cov_99.538944	824	903	199	3	79	0.0379747
NODE_3765_length_1216_cov_99.538944	824	903	201	6	79	0.0759494
NODE_3765_length_1216_cov_99.538944	824	903	202	1	79	0.0126582
NODE_3765_length_1216_cov_99.538944	824	903	203	5	79	0.0632911
NODE_3765_length_1216_cov_99.538944	824	903	205	3	79	0.0379747
NODE_3765_length_1216_cov_99.538944	824	903	207	2	79	0.0253165
NODE_3765_length_1216_cov_99.538944	824	903	209	2	79	0.0253165
NODE_3765_length_1216_cov_99.538944	824	903	211	1	79	0.0126582
NODE_3766_length_1216_cov_15.855864	668	748	2	27	80	0.3375000
NODE_3766_length_1216_cov_15.855864	668	748	4	53	80	0.6625000
NODE_3766_length_1216_cov_15.855864	721	801	2	48	80	0.6000000
NODE_3766_length_1216_cov_15.855864	721	801	4	32	80	0.4000000
NODE_3767_length_1216_cov_4.128917	720	800	0	80	80	1.0000000
NODE_3767_length_1216_cov_4.128917	773	853	0	80	80	1.0000000
NODE_3774_length_1215_cov_32.293011	411	491	0	17	80	0.2125000
NODE_3774_length_1215_cov_32.293011	411	491	2	20	80	0.2500000
NODE_3774_length_1215_cov_32.293011	411	491	8	43	80	0.5375000
NODE_3774_length_1215_cov_32.293011	464	544	0	8	80	0.1000000
NODE_3774_length_1215_cov_32.293011	464	544	6	16	80	0.2000000
NODE_3774_length_1215_cov_32.293011	464	544	8	56	80	0.7000000
NODE_3775_length_1215_cov_24.177419	729	809	2	80	80	1.0000000
NODE_3775_length_1215_cov_24.177419	782	862	0	52	80	0.6500000
NODE_3775_length_1215_cov_24.177419	782	862	2	28	80	0.3500000
NODE_3776_length_1215_cov_21.566308	645	725	0	8	80	0.1000000
NODE_3776_length_1215_cov_21.566308	645	725	2	72	80	0.9000000
NODE_3776_length_1215_cov_21.566308	698	778	0	61	80	0.7625000
NODE_3776_length_1215_cov_21.566308	698	778	2	19	80	0.2375000
NODE_3777_length_1215_cov_19.278674	630	710	0	80	80	1.0000000
NODE_3777_length_1215_cov_19.278674	683	763	0	80	80	1.0000000
NODE_3778_length_1215_cov_15.074373	664	744	0	80	80	1.0000000
NODE_3778_length_1215_cov_15.074373	717	797	0	63	80	0.7875000
NODE_3778_length_1215_cov_15.074373	717	797	2	17	80	0.2125000
NODE_3779_length_1215_cov_5.932796	507	587	0	27	80	0.3375000
NODE_3779_length_1215_cov_5.932796	507	587	2	53	80	0.6625000
NODE_3779_length_1215_cov_5.932796	560	640	2	80	80	1.0000000
NODE_3787_length_1214_cov_26.771300	420	500	51	7	80	0.0875000
NODE_3787_length_1214_cov_26.771300	420	500	55	2	80	0.0250000
NODE_3787_length_1214_cov_26.771300	420	500	59	2	80	0.0250000
NODE_3787_length_1214_cov_26.771300	420	500	67	3	80	0.0375000
NODE_3787_length_1214_cov_26.771300	420	500	68	1	80	0.0125000
NODE_3787_length_1214_cov_26.771300	420	500	72	2	80	0.0250000
NODE_3787_length_1214_cov_26.771300	420	500	77	1	80	0.0125000
NODE_3787_length_1214_cov_26.771300	420	500	80	1	80	0.0125000
NODE_3787_length_1214_cov_26.771300	420	500	82	1	80	0.0125000
NODE_3787_length_1214_cov_26.771300	420	500	86	2	80	0.0250000
NODE_3787_length_1214_cov_26.771300	420	500	87	1	80	0.0125000
NODE_3787_length_1214_cov_26.771300	420	500	91	2	80	0.0250000
NODE_3787_length_1214_cov_26.771300	420	500	105	1	80	0.0125000
NODE_3787_length_1214_cov_26.771300	420	500	106	2	80	0.0250000
NODE_3787_length_1214_cov_26.771300	420	500	111	1	80	0.0125000
NODE_3787_length_1214_cov_26.771300	420	500	112	11	80	0.1375000
NODE_3787_length_1214_cov_26.771300	420	500	114	5	80	0.0625000
NODE_3787_length_1214_cov_26.771300	420	500	120	7	80	0.0875000
NODE_3787_length_1214_cov_26.771300	420	500	121	1	80	0.0125000
NODE_3787_length_1214_cov_26.771300	420	500	123	1	80	0.0125000
NODE_3787_length_1214_cov_26.771300	420	500	124	2	80	0.0250000
NODE_3787_length_1214_cov_26.771300	420	500	125	2	80	0.0250000
NODE_3787_length_1214_cov_26.771300	420	500	126	8	80	0.1000000
NODE_3787_length_1214_cov_26.771300	420	500	128	14	80	0.1750000
NODE_3787_length_1214_cov_26.771300	473	553	18	1	80	0.0125000
NODE_3787_length_1214_cov_26.771300	473	553	27	1	80	0.0125000
NODE_3787_length_1214_cov_26.771300	473	553	29	1	80	0.0125000
NODE_3787_length_1214_cov_26.771300	473	553	30	1	80	0.0125000
NODE_3787_length_1214_cov_26.771300	473	553	32	1	80	0.0125000
NODE_3787_length_1214_cov_26.771300	473	553	34	1	80	0.0125000
NODE_3787_length_1214_cov_26.771300	473	553	50	5	80	0.0625000
NODE_3787_length_1214_cov_26.771300	473	553	52	1	80	0.0125000
NODE_3787_length_1214_cov_26.771300	473	553	54	3	80	0.0375000
NODE_3787_length_1214_cov_26.771300	473	553	58	3	80	0.0375000
NODE_3787_length_1214_cov_26.771300	473	553	60	1	80	0.0125000
NODE_3787_length_1214_cov_26.771300	473	553	68	2	80	0.0250000
NODE_3787_length_1214_cov_26.771300	473	553	70	3	80	0.0375000
NODE_3787_length_1214_cov_26.771300	473	553	74	1	80	0.0125000
NODE_3787_length_1214_cov_26.771300	473	553	76	1	80	0.0125000
NODE_3787_length_1214_cov_26.771300	473	553	77	2	80	0.0250000
NODE_3787_length_1214_cov_26.771300	473	553	78	2	80	0.0250000
NODE_3787_length_1214_cov_26.771300	473	553	80	1	80	0.0125000
NODE_3787_length_1214_cov_26.771300	473	553	84	1	80	0.0125000
NODE_3787_length_1214_cov_26.771300	473	553	86	1	80	0.0125000
NODE_3787_length_1214_cov_26.771300	473	553	92	2	80	0.0250000
NODE_3787_length_1214_cov_26.771300	473	553	94	1	80	0.0125000
NODE_3787_length_1214_cov_26.771300	473	553	96	3	80	0.0375000
NODE_3787_length_1214_cov_26.771300	473	553	98	3	80	0.0375000
NODE_3787_length_1214_cov_26.771300	473	553	100	4	80	0.0500000
NODE_3787_length_1214_cov_26.771300	473	553	104	5	80	0.0625000
NODE_3787_length_1214_cov_26.771300	473	553	110	1	80	0.0125000
NODE_3787_length_1214_cov_26.771300	473	553	120	1	80	0.0125000
NODE_3787_length_1214_cov_26.771300	473	553	121	1	80	0.0125000
NODE_3787_length_1214_cov_26.771300	473	553	123	1	80	0.0125000
NODE_3787_length_1214_cov_26.771300	473	553	124	1	80	0.0125000
NODE_3787_length_1214_cov_26.771300	473	553	125	2	80	0.0250000
NODE_3787_length_1214_cov_26.771300	473	553	126	8	80	0.1000000
NODE_3787_length_1214_cov_26.771300	473	553	128	14	80	0.1750000
NODE_3788_length_1214_cov_24.555157	480	560	0	80	80	1.0000000
NODE_3788_length_1214_cov_24.555157	533	613	0	80	80	1.0000000
NODE_3789_length_1214_cov_23.167713	623	703	0	80	80	1.0000000
NODE_3789_length_1214_cov_23.167713	676	756	0	80	80	1.0000000
NODE_3790_length_1214_cov_18.452915	555	635	0	80	80	1.0000000
NODE_3790_length_1214_cov_18.452915	608	688	0	80	80	1.0000000
NODE_3790_length_1214_cov_18.452915	684	764	0	80	80	1.0000000
NODE_3790_length_1214_cov_18.452915	737	817	0	80	80	1.0000000
NODE_3791_length_1214_cov_8.906726	206	286	0	80	80	1.0000000
NODE_3791_length_1214_cov_8.906726	259	339	0	80	80	1.0000000
NODE_3792_length_1214_cov_3.686996	415	495	0	80	80	1.0000000
NODE_3792_length_1214_cov_3.686996	468	548	0	80	80	1.0000000
NODE_3799_length_1214_cov_0.967713	1049	1129	132	1	80	0.0125000
NODE_3799_length_1214_cov_0.967713	1049	1129	137	2	80	0.0250000
NODE_3799_length_1214_cov_0.967713	1049	1129	141	1	80	0.0125000
NODE_3799_length_1214_cov_0.967713	1049	1129	151	1	80	0.0125000
NODE_3799_length_1214_cov_0.967713	1049	1129	153	3	80	0.0375000
NODE_3799_length_1214_cov_0.967713	1049	1129	159	1	80	0.0125000
NODE_3799_length_1214_cov_0.967713	1049	1129	165	1	80	0.0125000
NODE_3799_length_1214_cov_0.967713	1049	1129	177	1	80	0.0125000
NODE_3799_length_1214_cov_0.967713	1049	1129	179	1	80	0.0125000
NODE_3799_length_1214_cov_0.967713	1049	1129	192	1	80	0.0125000
NODE_3799_length_1214_cov_0.967713	1049	1129	198	1	80	0.0125000
NODE_3799_length_1214_cov_0.967713	1049	1129	200	1	80	0.0125000
NODE_3799_length_1214_cov_0.967713	1049	1129	206	1	80	0.0125000
NODE_3799_length_1214_cov_0.967713	1049	1129	207	2	80	0.0250000
NODE_3799_length_1214_cov_0.967713	1049	1129	208	2	80	0.0250000
NODE_3799_length_1214_cov_0.967713	1049	1129	210	4	80	0.0500000
NODE_3799_length_1214_cov_0.967713	1049	1129	217	11	80	0.1375000
NODE_3799_length_1214_cov_0.967713	1049	1129	218	1	80	0.0125000
NODE_3799_length_1214_cov_0.967713	1049	1129	220	2	80	0.0250000
NODE_3799_length_1214_cov_0.967713	1049	1129	223	2	80	0.0250000
NODE_3799_length_1214_cov_0.967713	1049	1129	226	1	80	0.0125000
NODE_3799_length_1214_cov_0.967713	1049	1129	228	1	80	0.0125000
NODE_3799_length_1214_cov_0.967713	1049	1129	229	1	80	0.0125000
NODE_3799_length_1214_cov_0.967713	1049	1129	230	4	80	0.0500000
NODE_3799_length_1214_cov_0.967713	1049	1129	231	1	80	0.0125000
NODE_3799_length_1214_cov_0.967713	1049	1129	232	1	80	0.0125000
NODE_3799_length_1214_cov_0.967713	1049	1129	234	12	80	0.1500000
NODE_3799_length_1214_cov_0.967713	1049	1129	235	3	80	0.0375000
NODE_3799_length_1214_cov_0.967713	1049	1129	236	3	80	0.0375000
NODE_3799_length_1214_cov_0.967713	1049	1129	238	6	80	0.0750000
NODE_3799_length_1214_cov_0.967713	1049	1129	240	3	80	0.0375000
NODE_3799_length_1214_cov_0.967713	1049	1129	241	3	80	0.0375000
NODE_3799_length_1214_cov_0.967713	1049	1129	242	1	80	0.0125000
NODE_3800_length_1213_cov_19.524237	499	579	0	37	80	0.4625000
NODE_3800_length_1213_cov_19.524237	499	579	2	43	80	0.5375000
NODE_3800_length_1213_cov_19.524237	552	632	0	22	80	0.2750000
NODE_3800_length_1213_cov_19.524237	552	632	2	58	80	0.7250000
NODE_3806_length_1212_cov_32.663073	688	768	0	80	80	1.0000000
NODE_3806_length_1212_cov_32.663073	741	821	0	80	80	1.0000000
NODE_3807_length_1212_cov_15.981132	33	113	10	2	80	0.0250000
NODE_3807_length_1212_cov_15.981132	33	113	12	2	80	0.0250000
NODE_3807_length_1212_cov_15.981132	33	113	14	19	80	0.2375000
NODE_3807_length_1212_cov_15.981132	33	113	16	57	80	0.7125000
NODE_3807_length_1212_cov_15.981132	511	591	0	80	80	1.0000000
NODE_3807_length_1212_cov_15.981132	564	637	0	73	73	1.0000000
NODE_3813_length_1211_cov_30.513489	561	641	0	15	80	0.1875000
NODE_3813_length_1211_cov_30.513489	561	641	2	65	80	0.8125000
NODE_3813_length_1211_cov_30.513489	614	694	2	42	80	0.5250000
NODE_3813_length_1211_cov_30.513489	614	694	5	16	80	0.2000000
NODE_3813_length_1211_cov_30.513489	614	694	6	15	80	0.1875000
NODE_3813_length_1211_cov_30.513489	614	694	8	7	80	0.0875000
NODE_3813_length_1211_cov_30.513489	690	770	6	80	80	1.0000000
NODE_3813_length_1211_cov_30.513489	743	823	0	1	80	0.0125000
NODE_3813_length_1211_cov_30.513489	743	823	3	16	80	0.2000000
NODE_3813_length_1211_cov_30.513489	743	823	6	63	80	0.7875000
NODE_3815_length_1211_cov_10.073741	380	460	2	76	80	0.9500000
NODE_3815_length_1211_cov_10.073741	380	460	4	4	80	0.0500000
NODE_3815_length_1211_cov_10.073741	433	513	0	29	80	0.3625000
NODE_3815_length_1211_cov_10.073741	433	513	2	51	80	0.6375000
NODE_3816_length_1211_cov_7.561151	598	678	2	9	80	0.1125000
NODE_3816_length_1211_cov_7.561151	598	678	4	50	80	0.6250000
NODE_3816_length_1211_cov_7.561151	598	678	6	21	80	0.2625000
NODE_3816_length_1211_cov_7.561151	651	731	2	30	80	0.3750000
NODE_3816_length_1211_cov_7.561151	651	731	4	16	80	0.2000000
NODE_3816_length_1211_cov_7.561151	651	731	6	34	80	0.4250000
NODE_3820_length_1210_cov_49.743474	398	478	0	12	80	0.1500000
NODE_3820_length_1210_cov_49.743474	398	478	3	12	80	0.1500000
NODE_3820_length_1210_cov_49.743474	398	478	6	56	80	0.7000000
NODE_3820_length_1210_cov_49.743474	451	531	6	32	80	0.4000000
NODE_3820_length_1210_cov_49.743474	451	531	8	48	80	0.6000000
NODE_3821_length_1210_cov_15.647165	647	727	0	80	80	1.0000000
NODE_3821_length_1210_cov_15.647165	700	780	0	80	80	1.0000000
NODE_3822_length_1210_cov_11.194419	794	874	0	41	80	0.5125000
NODE_3822_length_1210_cov_11.194419	794	874	2	39	80	0.4875000
NODE_3822_length_1210_cov_11.194419	847	927	0	80	80	1.0000000
NODE_3826_length_1209_cov_24.504505	582	662	4	80	80	1.0000000
NODE_3826_length_1209_cov_24.504505	635	715	0	19	80	0.2375000
NODE_3826_length_1209_cov_24.504505	635	715	4	61	80	0.7625000
NODE_3826_length_1209_cov_24.504505	711	791	0	80	80	1.0000000
NODE_3826_length_1209_cov_24.504505	764	844	0	80	80	1.0000000
NODE_3827_length_1209_cov_21.846847	520	600	0	80	80	1.0000000
NODE_3827_length_1209_cov_21.846847	573	653	0	80	80	1.0000000
NODE_3827_length_1209_cov_21.846847	649	729	0	6	80	0.0750000
NODE_3827_length_1209_cov_21.846847	649	729	2	74	80	0.9250000
NODE_3827_length_1209_cov_21.846847	702	782	0	23	80	0.2875000
NODE_3827_length_1209_cov_21.846847	702	782	2	57	80	0.7125000
NODE_3828_length_1209_cov_9.026126	782	862	2	80	80	1.0000000
NODE_3828_length_1209_cov_9.026126	835	915	0	19	80	0.2375000
NODE_3828_length_1209_cov_9.026126	835	915	1	4	80	0.0500000
NODE_3828_length_1209_cov_9.026126	835	915	2	57	80	0.7125000
NODE_3830_length_1209_cov_5.721622	926	1006	0	53	80	0.6625000
NODE_3830_length_1209_cov_5.721622	926	1006	2	27	80	0.3375000
NODE_3830_length_1209_cov_5.721622	979	1059	2	80	80	1.0000000
NODE_3833_length_1208_cov_40.717764	886	966	56	1	80	0.0125000
NODE_3833_length_1208_cov_40.717764	886	966	58	2	80	0.0250000
NODE_3833_length_1208_cov_40.717764	886	966	60	3	80	0.0375000
NODE_3833_length_1208_cov_40.717764	886	966	62	3	80	0.0375000
NODE_3833_length_1208_cov_40.717764	886	966	64	4	80	0.0500000
NODE_3833_length_1208_cov_40.717764	886	966	66	2	80	0.0250000
NODE_3833_length_1208_cov_40.717764	886	966	67	2	80	0.0250000
NODE_3833_length_1208_cov_40.717764	886	966	68	1	80	0.0125000
NODE_3833_length_1208_cov_40.717764	886	966	69	1	80	0.0125000
NODE_3833_length_1208_cov_40.717764	886	966	70	2	80	0.0250000
NODE_3833_length_1208_cov_40.717764	886	966	71	1	80	0.0125000
NODE_3833_length_1208_cov_40.717764	886	966	78	1	80	0.0125000
NODE_3833_length_1208_cov_40.717764	886	966	79	2	80	0.0250000
NODE_3833_length_1208_cov_40.717764	886	966	81	1	80	0.0125000
NODE_3833_length_1208_cov_40.717764	886	966	83	5	80	0.0625000
NODE_3833_length_1208_cov_40.717764	886	966	85	1	80	0.0125000
NODE_3833_length_1208_cov_40.717764	886	966	87	5	80	0.0625000
NODE_3833_length_1208_cov_40.717764	886	966	89	1	80	0.0125000
NODE_3833_length_1208_cov_40.717764	886	966	91	4	80	0.0500000
NODE_3833_length_1208_cov_40.717764	886	966	92	1	80	0.0125000
NODE_3833_length_1208_cov_40.717764	886	966	93	1	80	0.0125000
NODE_3833_length_1208_cov_40.717764	886	966	94	2	80	0.0250000
NODE_3833_length_1208_cov_40.717764	886	966	96	1	80	0.0125000
NODE_3833_length_1208_cov_40.717764	886	966	98	1	80	0.0125000
NODE_3833_length_1208_cov_40.717764	886	966	100	2	80	0.0250000
NODE_3833_length_1208_cov_40.717764	886	966	102	3	80	0.0375000
NODE_3833_length_1208_cov_40.717764	886	966	112	1	80	0.0125000
NODE_3833_length_1208_cov_40.717764	886	966	120	1	80	0.0125000
NODE_3833_length_1208_cov_40.717764	886	966	124	1	80	0.0125000
NODE_3833_length_1208_cov_40.717764	886	966	129	3	80	0.0375000
NODE_3833_length_1208_cov_40.717764	886	966	135	1	80	0.0125000
NODE_3833_length_1208_cov_40.717764	886	966	136	1	80	0.0125000
NODE_3833_length_1208_cov_40.717764	886	966	139	1	80	0.0125000
NODE_3833_length_1208_cov_40.717764	886	966	141	1	80	0.0125000
NODE_3833_length_1208_cov_40.717764	886	966	142	4	80	0.0500000
NODE_3833_length_1208_cov_40.717764	886	966	154	1	80	0.0125000
NODE_3833_length_1208_cov_40.717764	886	966	156	1	80	0.0125000
NODE_3833_length_1208_cov_40.717764	886	966	160	1	80	0.0125000
NODE_3833_length_1208_cov_40.717764	886	966	162	2	80	0.0250000
NODE_3833_length_1208_cov_40.717764	886	966	168	1	80	0.0125000
NODE_3833_length_1208_cov_40.717764	886	966	178	1	80	0.0125000
NODE_3833_length_1208_cov_40.717764	886	966	179	1	80	0.0125000
NODE_3833_length_1208_cov_40.717764	886	966	190	1	80	0.0125000
NODE_3833_length_1208_cov_40.717764	886	966	197	2	80	0.0250000
NODE_3833_length_1208_cov_40.717764	886	966	215	1	80	0.0125000
NODE_3833_length_1208_cov_40.717764	886	966	219	1	80	0.0125000
NODE_3833_length_1208_cov_40.717764	939	985	112	1	46	0.0217391
NODE_3833_length_1208_cov_40.717764	939	985	120	1	46	0.0217391
NODE_3833_length_1208_cov_40.717764	939	985	124	1	46	0.0217391
NODE_3833_length_1208_cov_40.717764	939	985	129	3	46	0.0652174
NODE_3833_length_1208_cov_40.717764	939	985	135	1	46	0.0217391
NODE_3833_length_1208_cov_40.717764	939	985	136	1	46	0.0217391
NODE_3833_length_1208_cov_40.717764	939	985	139	1	46	0.0217391
NODE_3833_length_1208_cov_40.717764	939	985	141	1	46	0.0217391
NODE_3833_length_1208_cov_40.717764	939	985	142	4	46	0.0869565
NODE_3833_length_1208_cov_40.717764	939	985	154	1	46	0.0217391
NODE_3833_length_1208_cov_40.717764	939	985	156	1	46	0.0217391
NODE_3833_length_1208_cov_40.717764	939	985	160	1	46	0.0217391
NODE_3833_length_1208_cov_40.717764	939	985	162	2	46	0.0434783
NODE_3833_length_1208_cov_40.717764	939	985	168	1	46	0.0217391
NODE_3833_length_1208_cov_40.717764	939	985	178	1	46	0.0217391
NODE_3833_length_1208_cov_40.717764	939	985	179	1	46	0.0217391
NODE_3833_length_1208_cov_40.717764	939	985	190	1	46	0.0217391
NODE_3833_length_1208_cov_40.717764	939	985	197	2	46	0.0434783
NODE_3833_length_1208_cov_40.717764	939	985	215	1	46	0.0217391
NODE_3833_length_1208_cov_40.717764	939	985	219	1	46	0.0217391
NODE_3833_length_1208_cov_40.717764	939	985	227	1	46	0.0217391
NODE_3833_length_1208_cov_40.717764	939	985	233	1	46	0.0217391
NODE_3833_length_1208_cov_40.717764	939	985	249	1	46	0.0217391
NODE_3833_length_1208_cov_40.717764	939	985	253	1	46	0.0217391
NODE_3833_length_1208_cov_40.717764	939	985	255	1	46	0.0217391
NODE_3833_length_1208_cov_40.717764	939	985	268	1	46	0.0217391
NODE_3833_length_1208_cov_40.717764	939	985	271	1	46	0.0217391
NODE_3833_length_1208_cov_40.717764	939	985	278	1	46	0.0217391
NODE_3833_length_1208_cov_40.717764	939	985	286	1	46	0.0217391
NODE_3833_length_1208_cov_40.717764	939	985	289	1	46	0.0217391
NODE_3833_length_1208_cov_40.717764	939	985	293	1	46	0.0217391
NODE_3833_length_1208_cov_40.717764	939	985	300	2	46	0.0434783
NODE_3833_length_1208_cov_40.717764	939	985	310	1	46	0.0217391
NODE_3833_length_1208_cov_40.717764	939	985	312	2	46	0.0434783
NODE_3833_length_1208_cov_40.717764	939	985	315	1	46	0.0217391
NODE_3833_length_1208_cov_40.717764	939	985	317	1	46	0.0217391
NODE_3833_length_1208_cov_40.717764	939	985	318	1	46	0.0217391
NODE_3834_length_1208_cov_28.528404	614	694	0	3	80	0.0375000
NODE_3834_length_1208_cov_28.528404	614	694	4	17	80	0.2125000
NODE_3834_length_1208_cov_28.528404	614	694	6	60	80	0.7500000
NODE_3834_length_1208_cov_28.528404	667	747	0	56	80	0.7000000
NODE_3834_length_1208_cov_28.528404	667	747	4	17	80	0.2125000
NODE_3834_length_1208_cov_28.528404	667	747	6	7	80	0.0875000
NODE_3835_length_1208_cov_19.688007	682	762	0	41	80	0.5125000
NODE_3835_length_1208_cov_19.688007	682	762	2	39	80	0.4875000
NODE_3835_length_1208_cov_19.688007	735	815	0	80	80	1.0000000
NODE_3836_length_1208_cov_18.577096	455	535	4	62	80	0.7750000
NODE_3836_length_1208_cov_18.577096	455	535	6	18	80	0.2250000
NODE_3836_length_1208_cov_18.577096	508	588	0	15	80	0.1875000
NODE_3836_length_1208_cov_18.577096	508	588	4	65	80	0.8125000
NODE_3836_length_1208_cov_18.577096	584	664	0	26	80	0.3250000
NODE_3836_length_1208_cov_18.577096	584	664	2	54	80	0.6750000
NODE_3836_length_1208_cov_18.577096	637	717	0	18	80	0.2250000
NODE_3836_length_1208_cov_18.577096	637	717	2	62	80	0.7750000
NODE_3837_length_1208_cov_12.733995	766	846	0	80	80	1.0000000
NODE_3837_length_1208_cov_12.733995	819	899	0	80	80	1.0000000
NODE_3837_length_1208_cov_12.733995	895	975	0	9	80	0.1125000
NODE_3837_length_1208_cov_12.733995	895	975	2	58	80	0.7250000
NODE_3837_length_1208_cov_12.733995	895	975	4	13	80	0.1625000
NODE_3837_length_1208_cov_12.733995	948	1028	2	59	80	0.7375000
NODE_3837_length_1208_cov_12.733995	948	1028	4	21	80	0.2625000
NODE_3838_length_1207_cov_20.461191	874	954	0	80	80	1.0000000
NODE_3838_length_1207_cov_20.461191	927	1007	0	80	80	1.0000000
NODE_3846_length_1206_cov_59.851852	540	620	0	80	80	1.0000000
NODE_3846_length_1206_cov_59.851852	593	673	0	80	80	1.0000000
NODE_3846_length_1206_cov_59.851852	669	749	0	80	80	1.0000000
NODE_3846_length_1206_cov_59.851852	722	802	0	80	80	1.0000000
NODE_3847_length_1206_cov_23.752484	669	749	4	40	80	0.5000000
NODE_3847_length_1206_cov_23.752484	669	749	6	40	80	0.5000000
NODE_3847_length_1206_cov_23.752484	722	802	0	27	80	0.3375000
NODE_3847_length_1206_cov_23.752484	722	802	2	19	80	0.2375000
NODE_3847_length_1206_cov_23.752484	722	802	6	34	80	0.4250000
NODE_3848_length_1206_cov_21.226739	585	665	0	80	80	1.0000000
NODE_3848_length_1206_cov_21.226739	638	718	0	80	80	1.0000000
NODE_3855_length_1205_cov_23.990054	355	435	0	4	80	0.0500000
NODE_3855_length_1205_cov_23.990054	355	435	8	43	80	0.5375000
NODE_3855_length_1205_cov_23.990054	355	435	9	3	80	0.0375000
NODE_3855_length_1205_cov_23.990054	355	435	10	30	80	0.3750000
NODE_3855_length_1205_cov_23.990054	408	488	0	57	80	0.7125000
NODE_3855_length_1205_cov_23.990054	408	488	8	23	80	0.2875000
NODE_3856_length_1205_cov_10.473779	780	860	0	80	80	1.0000000
NODE_3856_length_1205_cov_10.473779	833	913	0	80	80	1.0000000
NODE_3863_length_1204_cov_19.396380	537	617	0	15	80	0.1875000
NODE_3863_length_1204_cov_19.396380	537	617	2	65	80	0.8125000
NODE_3863_length_1204_cov_19.396380	590	670	0	68	80	0.8500000
NODE_3863_length_1204_cov_19.396380	590	670	2	12	80	0.1500000
NODE_3864_length_1204_cov_17.716742	448	528	0	80	80	1.0000000
NODE_3864_length_1204_cov_17.716742	501	581	0	80	80	1.0000000
NODE_3865_length_1204_cov_15.206335	426	506	0	80	80	1.0000000
NODE_3865_length_1204_cov_15.206335	479	559	0	80	80	1.0000000
NODE_3866_length_1204_cov_14.097738	632	712	0	80	80	1.0000000
NODE_3866_length_1204_cov_14.097738	685	765	0	80	80	1.0000000
NODE_3867_length_1204_cov_11.971946	549	629	0	5	80	0.0625000
NODE_3867_length_1204_cov_11.971946	549	629	1	26	80	0.3250000
NODE_3867_length_1204_cov_11.971946	549	629	2	14	80	0.1750000
NODE_3867_length_1204_cov_11.971946	549	629	3	35	80	0.4375000
NODE_3867_length_1204_cov_11.971946	602	682	3	80	80	1.0000000
NODE_3867_length_1204_cov_11.971946	678	758	0	11	80	0.1375000
NODE_3867_length_1204_cov_11.971946	678	758	2	26	80	0.3250000
NODE_3867_length_1204_cov_11.971946	678	758	3	43	80	0.5375000
NODE_3867_length_1204_cov_11.971946	731	811	0	64	80	0.8000000
NODE_3867_length_1204_cov_11.971946	731	811	2	16	80	0.2000000
NODE_3868_length_1204_cov_11.665158	499	579	2	28	80	0.3500000
NODE_3868_length_1204_cov_11.665158	499	579	4	6	80	0.0750000
NODE_3868_length_1204_cov_11.665158	499	579	6	46	80	0.5750000
NODE_3868_length_1204_cov_11.665158	552	632	0	43	80	0.5375000
NODE_3868_length_1204_cov_11.665158	552	632	2	37	80	0.4625000
NODE_3869_length_1204_cov_7.028959	637	717	0	43	80	0.5375000
NODE_3869_length_1204_cov_7.028959	637	717	2	37	80	0.4625000
NODE_3869_length_1204_cov_7.028959	690	770	0	23	80	0.2875000
NODE_3869_length_1204_cov_7.028959	690	770	2	57	80	0.7125000
NODE_3870_length_1204_cov_4.677828	807	887	0	80	80	1.0000000
NODE_3870_length_1204_cov_4.677828	860	940	0	80	80	1.0000000
NODE_3873_length_1203_cov_46.789855	515	595	0	28	80	0.3500000
NODE_3873_length_1203_cov_46.789855	515	595	2	52	80	0.6500000
NODE_3873_length_1203_cov_46.789855	568	648	0	77	80	0.9625000
NODE_3873_length_1203_cov_46.789855	568	648	2	3	80	0.0375000
NODE_3873_length_1203_cov_46.789855	644	724	0	1	80	0.0125000
NODE_3873_length_1203_cov_46.789855	644	724	2	26	80	0.3250000
NODE_3873_length_1203_cov_46.789855	644	724	4	53	80	0.6625000
NODE_3873_length_1203_cov_46.789855	697	777	0	21	80	0.2625000
NODE_3873_length_1203_cov_46.789855	697	777	2	16	80	0.2000000
NODE_3873_length_1203_cov_46.789855	697	777	4	43	80	0.5375000
NODE_3874_length_1203_cov_44.029891	471	551	0	80	80	1.0000000
NODE_3874_length_1203_cov_44.029891	524	604	0	80	80	1.0000000
NODE_3874_length_1203_cov_44.029891	600	680	0	80	80	1.0000000
NODE_3874_length_1203_cov_44.029891	653	733	0	80	80	1.0000000
NODE_3875_length_1203_cov_23.790761	308	388	0	80	80	1.0000000
NODE_3875_length_1203_cov_23.790761	361	441	0	80	80	1.0000000
NODE_3875_length_1203_cov_23.790761	437	517	0	64	80	0.8000000
NODE_3875_length_1203_cov_23.790761	437	517	2	16	80	0.2000000
NODE_3875_length_1203_cov_23.790761	490	570	0	20	80	0.2500000
NODE_3875_length_1203_cov_23.790761	490	570	2	60	80	0.7500000
NODE_3876_length_1203_cov_19.498188	336	416	0	80	80	1.0000000
NODE_3876_length_1203_cov_19.498188	389	469	0	63	80	0.7875000
NODE_3876_length_1203_cov_19.498188	389	469	2	17	80	0.2125000
NODE_3877_length_1203_cov_10.996377	317	397	0	80	80	1.0000000
NODE_3877_length_1203_cov_10.996377	370	450	0	80	80	1.0000000
NODE_3878_length_1203_cov_5.747283	725	805	0	80	80	1.0000000
NODE_3878_length_1203_cov_5.747283	778	858	0	80	80	1.0000000
NODE_3881_length_1202_cov_39.333636	475	555	0	80	80	1.0000000
NODE_3881_length_1202_cov_39.333636	528	608	0	80	80	1.0000000
NODE_3881_length_1202_cov_39.333636	604	684	0	63	80	0.7875000
NODE_3881_length_1202_cov_39.333636	604	684	2	17	80	0.2125000
NODE_3881_length_1202_cov_39.333636	657	737	0	10	80	0.1250000
NODE_3881_length_1202_cov_39.333636	657	737	2	70	80	0.8750000
NODE_3882_length_1202_cov_17.556664	599	679	1	13	80	0.1625000
NODE_3882_length_1202_cov_17.556664	599	679	2	44	80	0.5500000
NODE_3882_length_1202_cov_17.556664	599	679	4	10	80	0.1250000
NODE_3882_length_1202_cov_17.556664	599	679	8	13	80	0.1625000
NODE_3882_length_1202_cov_17.556664	652	732	2	4	80	0.0500000
NODE_3882_length_1202_cov_17.556664	652	732	4	10	80	0.1250000
NODE_3882_length_1202_cov_17.556664	652	732	6	5	80	0.0625000
NODE_3882_length_1202_cov_17.556664	652	732	8	61	80	0.7625000
NODE_3883_length_1202_cov_12.338169	634	714	0	80	80	1.0000000
NODE_3883_length_1202_cov_12.338169	687	767	0	80	80	1.0000000
NODE_3884_length_1202_cov_11.800544	520	600	3	40	80	0.5000000
NODE_3884_length_1202_cov_11.800544	520	600	4	40	80	0.5000000
NODE_3884_length_1202_cov_11.800544	573	653	0	41	80	0.5125000
NODE_3884_length_1202_cov_11.800544	573	653	4	39	80	0.4875000
NODE_3887_length_1201_cov_12.161525	434	514	0	80	80	1.0000000
NODE_3887_length_1201_cov_12.161525	487	567	0	80	80	1.0000000
NODE_3888_length_1201_cov_12.046279	643	723	0	1	80	0.0125000
NODE_3888_length_1201_cov_12.046279	643	723	4	79	80	0.9875000
NODE_3888_length_1201_cov_12.046279	696	776	0	54	80	0.6750000
NODE_3888_length_1201_cov_12.046279	696	776	4	26	80	0.3250000
NODE_3891_length_1200_cov_76.694823	630	710	0	80	80	1.0000000
NODE_3891_length_1200_cov_76.694823	683	763	0	43	80	0.5375000
NODE_3891_length_1200_cov_76.694823	683	763	2	37	80	0.4625000
NODE_3891_length_1200_cov_76.694823	759	839	0	8	80	0.1000000
NODE_3891_length_1200_cov_76.694823	759	839	2	72	80	0.9000000
NODE_3891_length_1200_cov_76.694823	812	892	0	61	80	0.7625000
NODE_3891_length_1200_cov_76.694823	812	892	2	19	80	0.2375000
NODE_3892_length_1200_cov_16.881926	827	902	4	24	75	0.3200000
NODE_3892_length_1200_cov_16.881926	827	902	5	2	75	0.0266667
NODE_3892_length_1200_cov_16.881926	827	902	6	17	75	0.2266667
NODE_3892_length_1200_cov_16.881926	827	902	18	2	75	0.0266667
NODE_3892_length_1200_cov_16.881926	827	902	22	1	75	0.0133333
NODE_3892_length_1200_cov_16.881926	827	902	24	7	75	0.0933333
NODE_3892_length_1200_cov_16.881926	827	902	25	2	75	0.0266667
NODE_3892_length_1200_cov_16.881926	827	902	26	20	75	0.2666667
NODE_3892_length_1200_cov_16.881926	828	904	4	23	76	0.3026316
NODE_3892_length_1200_cov_16.881926	828	904	5	2	76	0.0263158
NODE_3892_length_1200_cov_16.881926	828	904	6	17	76	0.2236842
NODE_3892_length_1200_cov_16.881926	828	904	18	2	76	0.0263158
NODE_3892_length_1200_cov_16.881926	828	904	22	3	76	0.0394737
NODE_3892_length_1200_cov_16.881926	828	904	24	7	76	0.0921053
NODE_3892_length_1200_cov_16.881926	828	904	25	2	76	0.0263158
NODE_3892_length_1200_cov_16.881926	828	904	26	20	76	0.2631579
NODE_3892_length_1200_cov_16.881926	841	907	4	10	66	0.1515152
NODE_3892_length_1200_cov_16.881926	841	907	5	2	66	0.0303030
NODE_3892_length_1200_cov_16.881926	841	907	6	17	66	0.2575758
NODE_3892_length_1200_cov_16.881926	841	907	18	2	66	0.0303030
NODE_3892_length_1200_cov_16.881926	841	907	22	5	66	0.0757576
NODE_3892_length_1200_cov_16.881926	841	907	24	8	66	0.1212121
NODE_3892_length_1200_cov_16.881926	841	907	25	2	66	0.0303030
NODE_3892_length_1200_cov_16.881926	841	907	26	20	66	0.3030303
NODE_3892_length_1200_cov_16.881926	880	957	22	5	77	0.0649351
NODE_3892_length_1200_cov_16.881926	880	957	24	16	77	0.2077922
NODE_3892_length_1200_cov_16.881926	880	957	25	1	77	0.0129870
NODE_3892_length_1200_cov_16.881926	880	957	26	25	77	0.3246753
NODE_3892_length_1200_cov_16.881926	880	957	27	9	77	0.1168831
NODE_3892_length_1200_cov_16.881926	880	957	29	16	77	0.2077922
NODE_3892_length_1200_cov_16.881926	880	957	30	5	77	0.0649351
NODE_3892_length_1200_cov_16.881926	880	957	22	5	77	0.0649351
NODE_3892_length_1200_cov_16.881926	880	957	24	16	77	0.2077922
NODE_3892_length_1200_cov_16.881926	880	957	25	1	77	0.0129870
NODE_3892_length_1200_cov_16.881926	880	957	26	25	77	0.3246753
NODE_3892_length_1200_cov_16.881926	880	957	27	9	77	0.1168831
NODE_3892_length_1200_cov_16.881926	880	957	29	16	77	0.2077922
NODE_3892_length_1200_cov_16.881926	880	957	30	5	77	0.0649351
NODE_3892_length_1200_cov_16.881926	880	957	22	5	77	0.0649351
NODE_3892_length_1200_cov_16.881926	880	957	24	16	77	0.2077922
NODE_3892_length_1200_cov_16.881926	880	957	25	1	77	0.0129870
NODE_3892_length_1200_cov_16.881926	880	957	26	25	77	0.3246753
NODE_3892_length_1200_cov_16.881926	880	957	27	9	77	0.1168831
NODE_3892_length_1200_cov_16.881926	880	957	29	16	77	0.2077922
NODE_3892_length_1200_cov_16.881926	880	957	30	5	77	0.0649351
NODE_3893_length_1200_cov_15.374205	605	685	0	2	80	0.0250000
NODE_3893_length_1200_cov_15.374205	605	685	2	2	80	0.0250000
NODE_3893_length_1200_cov_15.374205	605	685	3	14	80	0.1750000
NODE_3893_length_1200_cov_15.374205	605	685	7	1	80	0.0125000
NODE_3893_length_1200_cov_15.374205	605	685	8	39	80	0.4875000
NODE_3893_length_1200_cov_15.374205	605	685	9	22	80	0.2750000
NODE_3893_length_1200_cov_15.374205	658	738	6	10	80	0.1250000
NODE_3893_length_1200_cov_15.374205	658	738	8	29	80	0.3625000
NODE_3893_length_1200_cov_15.374205	658	738	9	41	80	0.5125000
NODE_3894_length_1200_cov_12.953678	486	550	9	3	64	0.0468750
NODE_3894_length_1200_cov_12.953678	486	550	10	61	64	0.9531250
NODE_3899_length_1199_cov_14.843636	222	302	0	4	80	0.0500000
NODE_3899_length_1199_cov_14.843636	222	302	2	15	80	0.1875000
NODE_3899_length_1199_cov_14.843636	222	302	13	12	80	0.1500000
NODE_3899_length_1199_cov_14.843636	222	302	14	40	80	0.5000000
NODE_3899_length_1199_cov_14.843636	222	302	19	9	80	0.1125000
NODE_3899_length_1199_cov_14.843636	275	355	14	18	80	0.2250000
NODE_3899_length_1199_cov_14.843636	275	355	17	4	80	0.0500000
NODE_3899_length_1199_cov_14.843636	275	355	18	28	80	0.3500000
NODE_3899_length_1199_cov_14.843636	275	355	19	20	80	0.2500000
NODE_3899_length_1199_cov_14.843636	275	355	20	10	80	0.1250000
NODE_3900_length_1199_cov_12.005455	383	463	0	80	80	1.0000000
NODE_3900_length_1199_cov_12.005455	436	516	0	80	80	1.0000000
NODE_3900_length_1199_cov_12.005455	512	592	0	26	80	0.3250000
NODE_3900_length_1199_cov_12.005455	512	592	2	54	80	0.6750000
NODE_3900_length_1199_cov_12.005455	565	645	0	36	80	0.4500000
NODE_3900_length_1199_cov_12.005455	565	645	2	44	80	0.5500000
NODE_3902_length_1198_cov_36.830755	619	699	6	3	80	0.0375000
NODE_3902_length_1198_cov_36.830755	619	699	12	9	80	0.1125000
NODE_3902_length_1198_cov_36.830755	619	699	21	1	80	0.0125000
NODE_3902_length_1198_cov_36.830755	619	699	22	67	80	0.8375000
NODE_3902_length_1198_cov_36.830755	672	752	10	37	80	0.4625000
NODE_3902_length_1198_cov_36.830755	672	752	16	16	80	0.2000000
NODE_3902_length_1198_cov_36.830755	672	752	22	27	80	0.3375000
NODE_3903_length_1198_cov_22.864422	719	799	0	80	80	1.0000000
NODE_3903_length_1198_cov_22.864422	772	852	0	80	80	1.0000000
NODE_3904_length_1198_cov_17.619654	260	340	4	80	80	1.0000000
NODE_3904_length_1198_cov_17.619654	313	392	0	18	79	0.2278481
NODE_3904_length_1198_cov_17.619654	313	392	4	61	79	0.7721519
NODE_3905_length_1198_cov_10.148317	718	798	0	80	80	1.0000000
NODE_3905_length_1198_cov_10.148317	771	851	0	80	80	1.0000000
NODE_3906_length_1198_cov_6.733394	549	629	0	48	80	0.6000000
NODE_3906_length_1198_cov_6.733394	549	629	2	32	80	0.4000000
NODE_3906_length_1198_cov_6.733394	602	682	0	80	80	1.0000000
NODE_3912_length_1197_cov_27.653005	417	497	0	26	80	0.3250000
NODE_3912_length_1197_cov_27.653005	417	497	2	54	80	0.6750000
NODE_3912_length_1197_cov_27.653005	470	550	0	79	80	0.9875000
NODE_3912_length_1197_cov_27.653005	470	550	2	1	80	0.0125000
NODE_3912_length_1197_cov_27.653005	546	626	0	80	80	1.0000000
NODE_3912_length_1197_cov_27.653005	599	679	0	80	80	1.0000000
NODE_3913_length_1197_cov_14.653916	490	570	0	50	80	0.6250000
NODE_3913_length_1197_cov_14.653916	490	570	1	26	80	0.3250000
NODE_3913_length_1197_cov_14.653916	490	570	5	4	80	0.0500000
NODE_3913_length_1197_cov_14.653916	543	623	1	23	80	0.2875000
NODE_3913_length_1197_cov_14.653916	543	623	5	4	80	0.0500000
NODE_3913_length_1197_cov_14.653916	543	623	6	53	80	0.6625000
NODE_3921_length_1196_cov_26.169553	298	378	0	13	80	0.1625000
NODE_3921_length_1196_cov_26.169553	298	378	8	67	80	0.8375000
NODE_3921_length_1196_cov_26.169553	351	431	8	80	80	1.0000000
NODE_3921_length_1196_cov_26.169553	427	507	0	27	80	0.3375000
NODE_3921_length_1196_cov_26.169553	427	507	2	46	80	0.5750000
NODE_3921_length_1196_cov_26.169553	427	507	8	7	80	0.0875000
NODE_3921_length_1196_cov_26.169553	480	560	0	25	80	0.3125000
NODE_3921_length_1196_cov_26.169553	480	560	2	55	80	0.6875000
NODE_3922_length_1196_cov_21.755697	521	601	0	18	80	0.2250000
NODE_3922_length_1196_cov_21.755697	521	601	2	62	80	0.7750000
NODE_3922_length_1196_cov_21.755697	574	654	0	71	80	0.8875000
NODE_3922_length_1196_cov_21.755697	574	654	2	9	80	0.1125000
NODE_3922_length_1196_cov_21.755697	650	730	0	80	80	1.0000000
NODE_3922_length_1196_cov_21.755697	703	783	0	80	80	1.0000000
NODE_3923_length_1196_cov_5.966272	556	636	0	80	80	1.0000000
NODE_3923_length_1196_cov_5.966272	609	689	0	80	80	1.0000000
NODE_3927_length_1195_cov_69.056569	474	554	0	80	80	1.0000000
NODE_3927_length_1195_cov_69.056569	527	607	0	80	80	1.0000000
NODE_3927_length_1195_cov_69.056569	603	683	0	39	80	0.4875000
NODE_3927_length_1195_cov_69.056569	603	683	2	31	80	0.3875000
NODE_3927_length_1195_cov_69.056569	603	683	4	10	80	0.1250000
NODE_3927_length_1195_cov_69.056569	656	736	2	30	80	0.3750000
NODE_3927_length_1195_cov_69.056569	656	736	4	50	80	0.6250000
NODE_3928_length_1195_cov_65.062044	579	659	0	80	80	1.0000000
NODE_3928_length_1195_cov_65.062044	632	712	0	80	80	1.0000000
NODE_3928_length_1195_cov_65.062044	708	788	0	80	80	1.0000000
NODE_3928_length_1195_cov_65.062044	761	841	0	80	80	1.0000000
NODE_3929_length_1195_cov_23.187044	460	540	0	80	80	1.0000000
NODE_3929_length_1195_cov_23.187044	513	593	0	80	80	1.0000000
NODE_3930_length_1195_cov_18.983577	521	601	2	19	80	0.2375000
NODE_3930_length_1195_cov_18.983577	521	601	4	61	80	0.7625000
NODE_3930_length_1195_cov_18.983577	574	654	0	30	80	0.3750000
NODE_3930_length_1195_cov_18.983577	574	654	2	29	80	0.3625000
NODE_3930_length_1195_cov_18.983577	574	654	4	21	80	0.2625000
NODE_3931_length_1195_cov_14.119526	726	806	0	80	80	1.0000000
NODE_3931_length_1195_cov_14.119526	779	859	0	80	80	1.0000000
NODE_3931_length_1195_cov_14.119526	855	935	0	24	80	0.3000000
NODE_3931_length_1195_cov_14.119526	855	935	4	56	80	0.7000000
NODE_3931_length_1195_cov_14.119526	908	988	0	23	80	0.2875000
NODE_3931_length_1195_cov_14.119526	908	988	4	57	80	0.7125000
NODE_3932_length_1195_cov_13.805657	759	839	0	80	80	1.0000000
NODE_3932_length_1195_cov_13.805657	812	892	0	80	80	1.0000000
NODE_3938_length_1195_cov_1.969891	912	992	2	23	80	0.2875000
NODE_3938_length_1195_cov_1.969891	912	992	4	57	80	0.7125000
NODE_3938_length_1195_cov_1.969891	912	992	2	23	80	0.2875000
NODE_3938_length_1195_cov_1.969891	912	992	4	57	80	0.7125000
NODE_3941_length_1194_cov_40.157991	237	317	0	32	80	0.4000000
NODE_3941_length_1194_cov_40.157991	237	317	2	48	80	0.6000000
NODE_3941_length_1194_cov_40.157991	290	370	0	17	80	0.2125000
NODE_3941_length_1194_cov_40.157991	290	370	2	63	80	0.7875000
NODE_3946_length_1193_cov_34.295247	443	523	0	80	80	1.0000000
NODE_3946_length_1193_cov_34.295247	496	576	0	80	80	1.0000000
NODE_3947_length_1193_cov_16.930530	124	154	0	30	30	1.0000000
NODE_3947_length_1193_cov_16.930530	390	470	2	21	80	0.2625000
NODE_3947_length_1193_cov_16.930530	390	470	4	23	80	0.2875000
NODE_3947_length_1193_cov_16.930530	390	470	6	36	80	0.4500000
NODE_3947_length_1193_cov_16.930530	443	523	0	12	80	0.1500000
NODE_3947_length_1193_cov_16.930530	443	523	2	62	80	0.7750000
NODE_3947_length_1193_cov_16.930530	443	523	4	6	80	0.0750000
NODE_3949_length_1192_cov_26.803294	205	285	1	28	80	0.3500000
NODE_3949_length_1192_cov_26.803294	205	285	2	52	80	0.6500000
NODE_3949_length_1192_cov_26.803294	258	338	0	51	80	0.6375000
NODE_3949_length_1192_cov_26.803294	258	338	1	29	80	0.3625000
NODE_3949_length_1192_cov_26.803294	334	414	0	80	80	1.0000000
NODE_3949_length_1192_cov_26.803294	387	467	0	80	80	1.0000000
NODE_3950_length_1192_cov_23.228728	487	567	0	80	80	1.0000000
NODE_3950_length_1192_cov_23.228728	540	620	0	80	80	1.0000000
NODE_3950_length_1192_cov_23.228728	616	696	0	80	80	1.0000000
NODE_3950_length_1192_cov_23.228728	669	749	0	80	80	1.0000000
NODE_3951_length_1192_cov_18.314730	613	693	0	80	80	1.0000000
NODE_3951_length_1192_cov_18.314730	666	746	0	80	80	1.0000000
NODE_3951_length_1192_cov_18.314730	742	822	0	80	80	1.0000000
NODE_3951_length_1192_cov_18.314730	795	875	0	80	80	1.0000000
NODE_3952_length_1192_cov_14.888381	622	702	2	43	80	0.5375000
NODE_3952_length_1192_cov_14.888381	622	702	4	37	80	0.4625000
NODE_3952_length_1192_cov_14.888381	675	755	0	14	80	0.1750000
NODE_3952_length_1192_cov_14.888381	675	755	2	23	80	0.2875000
NODE_3952_length_1192_cov_14.888381	675	755	4	43	80	0.5375000
NODE_3952_length_1192_cov_14.888381	751	831	0	47	80	0.5875000
NODE_3952_length_1192_cov_14.888381	751	831	2	33	80	0.4125000
NODE_3952_length_1192_cov_14.888381	804	884	0	21	80	0.2625000
NODE_3952_length_1192_cov_14.888381	804	884	2	59	80	0.7375000
NODE_3953_length_1192_cov_9.995425	161	241	2	21	80	0.2625000
NODE_3953_length_1192_cov_9.995425	161	241	4	31	80	0.3875000
NODE_3953_length_1192_cov_9.995425	161	241	10	28	80	0.3500000
NODE_3953_length_1192_cov_9.995425	214	294	6	37	80	0.4625000
NODE_3953_length_1192_cov_9.995425	214	294	8	10	80	0.1250000
NODE_3953_length_1192_cov_9.995425	214	294	10	33	80	0.4125000
NODE_3954_length_1192_cov_5.078683	749	829	4	18	80	0.2250000
NODE_3954_length_1192_cov_5.078683	749	829	6	50	80	0.6250000
NODE_3954_length_1192_cov_5.078683	749	829	8	12	80	0.1500000
NODE_3954_length_1192_cov_5.078683	802	882	2	30	80	0.3750000
NODE_3954_length_1192_cov_5.078683	802	882	3	2	80	0.0250000
NODE_3954_length_1192_cov_5.078683	802	882	4	25	80	0.3125000
NODE_3954_length_1192_cov_5.078683	802	882	6	11	80	0.1375000
NODE_3954_length_1192_cov_5.078683	802	882	8	12	80	0.1500000
NODE_3960_length_1192_cov_0.614822	1046	1126	0	19	80	0.2375000
NODE_3960_length_1192_cov_0.614822	1046	1126	2	61	80	0.7625000
NODE_3961_length_1191_cov_55.466117	392	472	0	80	80	1.0000000
NODE_3961_length_1191_cov_55.466117	445	525	0	80	80	1.0000000
NODE_3961_length_1191_cov_55.466117	521	601	0	63	80	0.7875000
NODE_3961_length_1191_cov_55.466117	521	601	2	17	80	0.2125000
NODE_3961_length_1191_cov_55.466117	574	654	0	10	80	0.1250000
NODE_3961_length_1191_cov_55.466117	574	654	2	70	80	0.8750000
NODE_3963_length_1191_cov_20.677656	695	775	0	80	80	1.0000000
NODE_3963_length_1191_cov_20.677656	748	828	0	80	80	1.0000000
NODE_3964_length_1191_cov_9.074176	420	500	0	80	80	1.0000000
NODE_3964_length_1191_cov_9.074176	473	553	0	80	80	1.0000000
NODE_3968_length_1190_cov_40.916590	521	601	2	5	80	0.0625000
NODE_3968_length_1190_cov_40.916590	521	601	3	1	80	0.0125000
NODE_3968_length_1190_cov_40.916590	521	601	4	8	80	0.1000000
NODE_3968_length_1190_cov_40.916590	521	601	8	14	80	0.1750000
NODE_3968_length_1190_cov_40.916590	521	601	9	1	80	0.0125000
NODE_3968_length_1190_cov_40.916590	521	601	10	51	80	0.6375000
NODE_3968_length_1190_cov_40.916590	574	654	2	5	80	0.0625000
NODE_3968_length_1190_cov_40.916590	574	654	3	1	80	0.0125000
NODE_3968_length_1190_cov_40.916590	574	654	4	61	80	0.7625000
NODE_3968_length_1190_cov_40.916590	574	654	9	1	80	0.0125000
NODE_3968_length_1190_cov_40.916590	574	654	10	12	80	0.1500000
NODE_3968_length_1190_cov_40.916590	650	730	0	3	80	0.0375000
NODE_3968_length_1190_cov_40.916590	650	730	2	61	80	0.7625000
NODE_3968_length_1190_cov_40.916590	650	730	4	16	80	0.2000000
NODE_3968_length_1190_cov_40.916590	703	783	0	56	80	0.7000000
NODE_3968_length_1190_cov_40.916590	703	783	2	24	80	0.3000000
NODE_3969_length_1190_cov_20.715857	257	337	6	53	80	0.6625000
NODE_3969_length_1190_cov_20.715857	257	337	8	27	80	0.3375000
NODE_3969_length_1190_cov_20.715857	310	390	2	28	80	0.3500000
NODE_3969_length_1190_cov_20.715857	310	390	6	29	80	0.3625000
NODE_3969_length_1190_cov_20.715857	310	390	8	23	80	0.2875000
NODE_3970_length_1190_cov_19.724106	296	376	0	80	80	1.0000000
NODE_3970_length_1190_cov_19.724106	349	429	0	80	80	1.0000000
NODE_3973_length_1190_cov_2.698442	1022	1070	0	48	48	1.0000000
NODE_3973_length_1190_cov_2.698442	1075	1123	0	18	48	0.3750000
NODE_3973_length_1190_cov_2.698442	1075	1123	2	30	48	0.6250000
NODE_3977_length_1189_cov_29.193578	576	656	0	33	80	0.4125000
NODE_3977_length_1189_cov_29.193578	576	656	2	1	80	0.0125000
NODE_3977_length_1189_cov_29.193578	576	656	4	46	80	0.5750000
NODE_3977_length_1189_cov_29.193578	629	709	0	29	80	0.3625000
NODE_3977_length_1189_cov_29.193578	629	709	2	5	80	0.0625000
NODE_3977_length_1189_cov_29.193578	629	709	4	46	80	0.5750000
NODE_3978_length_1189_cov_13.484404	315	341	0	9	26	0.3461539
NODE_3978_length_1189_cov_13.484404	315	341	2	17	26	0.6538461
NODE_3978_length_1189_cov_13.484404	366	446	0	80	80	1.0000000
NODE_3984_length_1188_cov_19.278237	396	476	8	70	80	0.8750000
NODE_3984_length_1188_cov_19.278237	396	476	10	10	80	0.1250000
NODE_3984_length_1188_cov_19.278237	449	529	2	40	80	0.5000000
NODE_3984_length_1188_cov_19.278237	449	529	8	17	80	0.2125000
NODE_3984_length_1188_cov_19.278237	449	529	10	23	80	0.2875000
NODE_3990_length_1187_cov_63.185662	529	609	0	50	80	0.6250000
NODE_3990_length_1187_cov_63.185662	529	609	4	30	80	0.3750000
NODE_3990_length_1187_cov_63.185662	582	662	4	40	80	0.5000000
NODE_3990_length_1187_cov_63.185662	582	662	6	40	80	0.5000000
NODE_3990_length_1187_cov_63.185662	658	738	6	30	80	0.3750000
NODE_3990_length_1187_cov_63.185662	658	738	10	39	80	0.4875000
NODE_3990_length_1187_cov_63.185662	658	738	14	11	80	0.1375000
NODE_3990_length_1187_cov_63.185662	711	791	2	32	80	0.4000000
NODE_3990_length_1187_cov_63.185662	711	791	8	2	80	0.0250000
NODE_3990_length_1187_cov_63.185662	711	791	10	46	80	0.5750000
NODE_3991_length_1187_cov_36.926471	432	512	0	80	80	1.0000000
NODE_3991_length_1187_cov_36.926471	485	565	0	80	80	1.0000000
NODE_3991_length_1187_cov_36.926471	561	641	0	80	80	1.0000000
NODE_3991_length_1187_cov_36.926471	614	694	0	30	80	0.3750000
NODE_3991_length_1187_cov_36.926471	614	694	4	50	80	0.6250000
NODE_3992_length_1187_cov_20.383272	492	572	0	24	80	0.3000000
NODE_3992_length_1187_cov_20.383272	492	572	2	56	80	0.7000000
NODE_3992_length_1187_cov_20.383272	545	625	0	14	80	0.1750000
NODE_3992_length_1187_cov_20.383272	545	625	2	66	80	0.8250000
NODE_3993_length_1187_cov_17.941176	377	457	0	61	80	0.7625000
NODE_3993_length_1187_cov_17.941176	377	457	2	19	80	0.2375000
NODE_3993_length_1187_cov_17.941176	430	510	0	80	80	1.0000000
NODE_3993_length_1187_cov_17.941176	506	586	0	26	80	0.3250000
NODE_3993_length_1187_cov_17.941176	506	586	4	1	80	0.0125000
NODE_3993_length_1187_cov_17.941176	506	586	6	53	80	0.6625000
NODE_3993_length_1187_cov_17.941176	559	639	0	13	80	0.1625000
NODE_3993_length_1187_cov_17.941176	559	639	4	31	80	0.3875000
NODE_3993_length_1187_cov_17.941176	559	639	6	36	80	0.4500000
NODE_3997_length_1186_cov_59.606256	338	418	0	80	80	1.0000000
NODE_3997_length_1186_cov_59.606256	391	471	0	80	80	1.0000000
NODE_3997_length_1186_cov_59.606256	480	551	0	57	71	0.8028169
NODE_3997_length_1186_cov_59.606256	480	551	2	14	71	0.1971831
NODE_3997_length_1186_cov_59.606256	524	604	0	19	80	0.2375000
NODE_3997_length_1186_cov_59.606256	524	604	2	61	80	0.7625000
NODE_3998_length_1186_cov_34.937443	582	662	0	80	80	1.0000000
NODE_3998_length_1186_cov_34.937443	635	715	0	80	80	1.0000000
NODE_3998_length_1186_cov_34.937443	711	791	0	80	80	1.0000000
NODE_3998_length_1186_cov_34.937443	764	844	0	80	80	1.0000000
NODE_3999_length_1186_cov_29.840846	511	591	0	80	80	1.0000000
NODE_3999_length_1186_cov_29.840846	564	644	0	80	80	1.0000000
NODE_3999_length_1186_cov_29.840846	640	720	0	80	80	1.0000000
NODE_3999_length_1186_cov_29.840846	693	773	0	80	80	1.0000000
NODE_4000_length_1186_cov_13.108556	578	658	0	80	80	1.0000000
NODE_4000_length_1186_cov_13.108556	631	711	0	80	80	1.0000000
NODE_4001_length_1186_cov_12.867525	404	484	0	5	80	0.0625000
NODE_4001_length_1186_cov_12.867525	404	484	2	75	80	0.9375000
NODE_4001_length_1186_cov_12.867525	457	534	0	55	77	0.7142857
NODE_4001_length_1186_cov_12.867525	457	534	2	22	77	0.2857143
NODE_4001_length_1186_cov_12.867525	536	613	0	21	77	0.2727273
NODE_4001_length_1186_cov_12.867525	536	613	1	27	77	0.3506494
NODE_4001_length_1186_cov_12.867525	536	613	5	24	77	0.3116883
NODE_4001_length_1186_cov_12.867525	536	613	6	5	77	0.0649351
NODE_4001_length_1186_cov_12.867525	586	666	2	8	80	0.1000000
NODE_4001_length_1186_cov_12.867525	586	666	5	22	80	0.2750000
NODE_4001_length_1186_cov_12.867525	586	666	6	50	80	0.6250000
NODE_4002_length_1186_cov_12.135235	643	723	0	80	80	1.0000000
NODE_4002_length_1186_cov_12.135235	696	776	0	80	80	1.0000000
NODE_4012_length_1185_cov_36.974217	423	503	0	23	80	0.2875000
NODE_4012_length_1185_cov_36.974217	423	503	4	57	80	0.7125000
NODE_4012_length_1185_cov_36.974217	476	556	0	76	80	0.9500000
NODE_4012_length_1185_cov_36.974217	476	556	4	4	80	0.0500000
NODE_4013_length_1185_cov_28.410681	448	528	0	80	80	1.0000000
NODE_4013_length_1185_cov_28.410681	501	581	0	80	80	1.0000000
NODE_4014_length_1185_cov_19.768877	411	491	0	80	80	1.0000000
NODE_4014_length_1185_cov_19.768877	464	544	0	80	80	1.0000000
NODE_4014_length_1185_cov_19.768877	540	620	0	6	80	0.0750000
NODE_4014_length_1185_cov_19.768877	540	620	4	74	80	0.9250000
NODE_4014_length_1185_cov_19.768877	593	673	0	23	80	0.2875000
NODE_4014_length_1185_cov_19.768877	593	673	4	57	80	0.7125000
NODE_4015_length_1185_cov_14.490792	379	459	0	80	80	1.0000000
NODE_4015_length_1185_cov_14.490792	432	512	0	80	80	1.0000000
NODE_4016_length_1185_cov_13.686004	677	757	0	2	80	0.0250000
NODE_4016_length_1185_cov_13.686004	677	757	2	64	80	0.8000000
NODE_4016_length_1185_cov_13.686004	677	757	4	14	80	0.1750000
NODE_4016_length_1185_cov_13.686004	730	810	2	63	80	0.7875000
NODE_4016_length_1185_cov_13.686004	730	810	4	17	80	0.2125000
NODE_4017_length_1185_cov_12.362799	711	791	0	80	80	1.0000000
NODE_4017_length_1185_cov_12.362799	764	844	0	80	80	1.0000000
NODE_4024_length_1184_cov_30.061751	416	497	0	81	81	1.0000000
NODE_4024_length_1184_cov_30.061751	470	550	0	80	80	1.0000000
NODE_4024_length_1184_cov_30.061751	546	627	0	38	81	0.4691358
NODE_4024_length_1184_cov_30.061751	546	627	2	43	81	0.5308642
NODE_4024_length_1184_cov_30.061751	600	680	0	8	80	0.1000000
NODE_4024_length_1184_cov_30.061751	600	680	2	72	80	0.9000000
NODE_4025_length_1184_cov_19.544700	550	630	0	21	80	0.2625000
NODE_4025_length_1184_cov_19.544700	550	630	2	59	80	0.7375000
NODE_4025_length_1184_cov_19.544700	603	683	0	60	80	0.7500000
NODE_4025_length_1184_cov_19.544700	603	683	2	20	80	0.2500000
NODE_4025_length_1184_cov_19.544700	679	759	0	80	80	1.0000000
NODE_4025_length_1184_cov_19.544700	732	812	0	80	80	1.0000000
NODE_4026_length_1184_cov_9.129954	624	704	0	80	80	1.0000000
NODE_4026_length_1184_cov_9.129954	677	757	0	80	80	1.0000000
NODE_4031_length_1183_cov_17.260148	545	625	0	80	80	1.0000000
NODE_4031_length_1183_cov_17.260148	598	678	0	80	80	1.0000000
NODE_4031_length_1183_cov_17.260148	674	754	0	80	80	1.0000000
NODE_4031_length_1183_cov_17.260148	727	807	0	80	80	1.0000000
NODE_4032_length_1183_cov_9.777675	484	564	2	80	80	1.0000000
NODE_4032_length_1183_cov_9.777675	537	617	0	45	80	0.5625000
NODE_4032_length_1183_cov_9.777675	537	617	2	35	80	0.4375000
NODE_4033_length_1183_cov_6.847786	711	791	0	72	80	0.9000000
NODE_4033_length_1183_cov_6.847786	711	791	2	8	80	0.1000000
NODE_4033_length_1183_cov_6.847786	764	844	0	19	80	0.2375000
NODE_4033_length_1183_cov_6.847786	764	844	2	47	80	0.5875000
NODE_4033_length_1183_cov_6.847786	764	844	4	14	80	0.1750000
NODE_4033_length_1183_cov_6.847786	840	920	2	52	80	0.6500000
NODE_4033_length_1183_cov_6.847786	840	920	4	28	80	0.3500000
NODE_4033_length_1183_cov_6.847786	893	973	0	49	80	0.6125000
NODE_4033_length_1183_cov_6.847786	893	973	2	31	80	0.3875000
NODE_4035_length_1183_cov_2.680812	59	139	0	20	80	0.2500000
NODE_4035_length_1183_cov_2.680812	59	139	2	4	80	0.0500000
NODE_4035_length_1183_cov_2.680812	59	139	6	56	80	0.7000000
NODE_4040_length_1182_cov_64.600185	588	668	0	21	80	0.2625000
NODE_4040_length_1182_cov_64.600185	588	668	4	7	80	0.0875000
NODE_4040_length_1182_cov_64.600185	588	668	8	4	80	0.0500000
NODE_4040_length_1182_cov_64.600185	588	668	10	48	80	0.6000000
NODE_4040_length_1182_cov_64.600185	641	721	0	11	80	0.1375000
NODE_4040_length_1182_cov_64.600185	641	721	4	20	80	0.2500000
NODE_4040_length_1182_cov_64.600185	641	721	6	19	80	0.2375000
NODE_4040_length_1182_cov_64.600185	641	721	10	30	80	0.3750000
NODE_4040_length_1182_cov_64.600185	717	797	0	29	80	0.3625000
NODE_4040_length_1182_cov_64.600185	717	797	6	44	80	0.5500000
NODE_4040_length_1182_cov_64.600185	717	797	8	7	80	0.0875000
NODE_4040_length_1182_cov_64.600185	770	849	2	14	79	0.1772152
NODE_4040_length_1182_cov_64.600185	770	849	6	20	79	0.2531646
NODE_4040_length_1182_cov_64.600185	770	849	8	45	79	0.5696203
NODE_4041_length_1182_cov_18.584488	487	557	0	30	70	0.4285714
NODE_4041_length_1182_cov_18.584488	487	557	2	40	70	0.5714286
NODE_4041_length_1182_cov_18.584488	536	612	0	8	76	0.1052632
NODE_4041_length_1182_cov_18.584488	536	612	2	68	76	0.8947368
NODE_4041_length_1182_cov_18.584488	608	688	0	80	80	1.0000000
NODE_4041_length_1182_cov_18.584488	671	741	0	70	70	1.0000000
NODE_4042_length_1182_cov_18.075716	598	678	0	80	80	1.0000000
NODE_4042_length_1182_cov_18.075716	651	731	0	80	80	1.0000000
NODE_4042_length_1182_cov_18.075716	727	807	0	7	80	0.0875000
NODE_4042_length_1182_cov_18.075716	727	807	2	73	80	0.9125000
NODE_4042_length_1182_cov_18.075716	780	860	0	50	80	0.6250000
NODE_4042_length_1182_cov_18.075716	780	860	2	30	80	0.3750000
NODE_4043_length_1182_cov_8.716528	464	544	0	80	80	1.0000000
NODE_4043_length_1182_cov_8.716528	517	597	0	42	80	0.5250000
NODE_4043_length_1182_cov_8.716528	517	597	2	38	80	0.4750000
NODE_4044_length_1182_cov_4.109880	793	873	0	80	80	1.0000000
NODE_4044_length_1182_cov_4.109880	846	926	0	80	80	1.0000000
NODE_4045_length_1182_cov_3.433980	1052	1100	0	33	48	0.6875000
NODE_4045_length_1182_cov_3.433980	1052	1100	2	15	48	0.3125000
NODE_4050_length_1181_cov_13.856747	687	767	0	80	80	1.0000000
NODE_4050_length_1181_cov_13.856747	740	820	0	80	80	1.0000000
NODE_4051_length_1181_cov_8.239372	735	815	0	80	80	1.0000000
NODE_4059_length_1180_cov_46.345051	695	775	0	16	80	0.2000000
NODE_4059_length_1180_cov_46.345051	695	775	2	32	80	0.4000000
NODE_4059_length_1180_cov_46.345051	695	775	4	32	80	0.4000000
NODE_4059_length_1180_cov_46.345051	748	828	2	57	80	0.7125000
NODE_4059_length_1180_cov_46.345051	748	828	4	23	80	0.2875000
NODE_4066_length_1179_cov_93.272222	660	740	214	1	80	0.0125000
NODE_4066_length_1179_cov_93.272222	660	740	220	4	80	0.0500000
NODE_4066_length_1179_cov_93.272222	660	740	226	1	80	0.0125000
NODE_4066_length_1179_cov_93.272222	660	740	227	7	80	0.0875000
NODE_4066_length_1179_cov_93.272222	660	740	228	1	80	0.0125000
NODE_4066_length_1179_cov_93.272222	660	740	229	2	80	0.0250000
NODE_4066_length_1179_cov_93.272222	660	740	230	2	80	0.0250000
NODE_4066_length_1179_cov_93.272222	660	740	232	4	80	0.0500000
NODE_4066_length_1179_cov_93.272222	660	740	234	7	80	0.0875000
NODE_4066_length_1179_cov_93.272222	660	740	235	4	80	0.0500000
NODE_4066_length_1179_cov_93.272222	660	740	236	1	80	0.0125000
NODE_4066_length_1179_cov_93.272222	660	740	237	1	80	0.0125000
NODE_4066_length_1179_cov_93.272222	660	740	238	2	80	0.0250000
NODE_4066_length_1179_cov_93.272222	660	740	239	2	80	0.0250000
NODE_4066_length_1179_cov_93.272222	660	740	240	3	80	0.0375000
NODE_4066_length_1179_cov_93.272222	660	740	242	2	80	0.0250000
NODE_4066_length_1179_cov_93.272222	660	740	243	1	80	0.0125000
NODE_4066_length_1179_cov_93.272222	660	740	244	3	80	0.0375000
NODE_4066_length_1179_cov_93.272222	660	740	245	1	80	0.0125000
NODE_4066_length_1179_cov_93.272222	660	740	246	8	80	0.1000000
NODE_4066_length_1179_cov_93.272222	660	740	247	2	80	0.0250000
NODE_4066_length_1179_cov_93.272222	660	740	248	5	80	0.0625000
NODE_4066_length_1179_cov_93.272222	660	740	250	9	80	0.1125000
NODE_4066_length_1179_cov_93.272222	660	740	252	1	80	0.0125000
NODE_4066_length_1179_cov_93.272222	660	740	254	4	80	0.0500000
NODE_4066_length_1179_cov_93.272222	660	740	256	2	80	0.0250000
NODE_4066_length_1179_cov_93.272222	713	793	78	1	80	0.0125000
NODE_4066_length_1179_cov_93.272222	713	793	80	1	80	0.0125000
NODE_4066_length_1179_cov_93.272222	713	793	83	1	80	0.0125000
NODE_4066_length_1179_cov_93.272222	713	793	87	4	80	0.0500000
NODE_4066_length_1179_cov_93.272222	713	793	91	1	80	0.0125000
NODE_4066_length_1179_cov_93.272222	713	793	99	1	80	0.0125000
NODE_4066_length_1179_cov_93.272222	713	793	101	3	80	0.0375000
NODE_4066_length_1179_cov_93.272222	713	793	108	1	80	0.0125000
NODE_4066_length_1179_cov_93.272222	713	793	110	1	80	0.0125000
NODE_4066_length_1179_cov_93.272222	713	793	128	1	80	0.0125000
NODE_4066_length_1179_cov_93.272222	713	793	134	1	80	0.0125000
NODE_4066_length_1179_cov_93.272222	713	793	140	1	80	0.0125000
NODE_4066_length_1179_cov_93.272222	713	793	142	1	80	0.0125000
NODE_4066_length_1179_cov_93.272222	713	793	148	1	80	0.0125000
NODE_4066_length_1179_cov_93.272222	713	793	152	2	80	0.0250000
NODE_4066_length_1179_cov_93.272222	713	793	159	2	80	0.0250000
NODE_4066_length_1179_cov_93.272222	713	793	161	1	80	0.0125000
NODE_4066_length_1179_cov_93.272222	713	793	162	1	80	0.0125000
NODE_4066_length_1179_cov_93.272222	713	793	164	2	80	0.0250000
NODE_4066_length_1179_cov_93.272222	713	793	165	3	80	0.0375000
NODE_4066_length_1179_cov_93.272222	713	793	166	1	80	0.0125000
NODE_4066_length_1179_cov_93.272222	713	793	167	5	80	0.0625000
NODE_4066_length_1179_cov_93.272222	713	793	168	1	80	0.0125000
NODE_4066_length_1179_cov_93.272222	713	793	173	3	80	0.0375000
NODE_4066_length_1179_cov_93.272222	713	793	175	4	80	0.0500000
NODE_4066_length_1179_cov_93.272222	713	793	177	4	80	0.0500000
NODE_4066_length_1179_cov_93.272222	713	793	188	1	80	0.0125000
NODE_4066_length_1179_cov_93.272222	713	793	190	2	80	0.0250000
NODE_4066_length_1179_cov_93.272222	713	793	191	1	80	0.0125000
NODE_4066_length_1179_cov_93.272222	713	793	204	1	80	0.0125000
NODE_4066_length_1179_cov_93.272222	713	793	214	1	80	0.0125000
NODE_4066_length_1179_cov_93.272222	713	793	220	4	80	0.0500000
NODE_4066_length_1179_cov_93.272222	713	793	226	1	80	0.0125000
NODE_4066_length_1179_cov_93.272222	713	793	232	2	80	0.0250000
NODE_4066_length_1179_cov_93.272222	713	793	234	7	80	0.0875000
NODE_4066_length_1179_cov_93.272222	713	793	235	3	80	0.0375000
NODE_4066_length_1179_cov_93.272222	713	793	237	1	80	0.0125000
NODE_4066_length_1179_cov_93.272222	713	793	239	2	80	0.0250000
NODE_4066_length_1179_cov_93.272222	713	793	246	2	80	0.0250000
NODE_4066_length_1179_cov_93.272222	713	793	247	1	80	0.0125000
NODE_4066_length_1179_cov_93.272222	713	793	248	1	80	0.0125000
NODE_4066_length_1179_cov_93.272222	713	793	250	2	80	0.0250000
NODE_4067_length_1179_cov_55.355556	547	627	0	48	80	0.6000000
NODE_4067_length_1179_cov_55.355556	547	627	4	32	80	0.4000000
NODE_4067_length_1179_cov_55.355556	600	680	4	80	80	1.0000000
NODE_4068_length_1179_cov_29.712037	613	693	0	80	80	1.0000000
NODE_4068_length_1179_cov_29.712037	666	746	0	80	80	1.0000000
NODE_4069_length_1179_cov_26.767593	483	563	2	80	80	1.0000000
NODE_4069_length_1179_cov_26.767593	536	616	0	14	80	0.1750000
NODE_4069_length_1179_cov_26.767593	536	616	2	66	80	0.8250000
NODE_4069_length_1179_cov_26.767593	612	692	0	22	80	0.2750000
NODE_4069_length_1179_cov_26.767593	612	692	2	58	80	0.7250000
NODE_4069_length_1179_cov_26.767593	665	745	0	27	80	0.3375000
NODE_4069_length_1179_cov_26.767593	665	745	2	53	80	0.6625000
NODE_4070_length_1179_cov_22.249074	581	661	0	2	80	0.0250000
NODE_4070_length_1179_cov_22.249074	581	661	2	78	80	0.9750000
NODE_4070_length_1179_cov_22.249074	634	714	2	80	80	1.0000000
NODE_4071_length_1179_cov_16.538889	498	568	0	70	70	1.0000000
NODE_4072_length_1179_cov_15.442593	535	615	0	80	80	1.0000000
NODE_4072_length_1179_cov_15.442593	588	668	0	80	80	1.0000000
NODE_4076_length_1179_cov_2.419444	1108	1155	0	47	47	1.0000000
NODE_4078_length_1179_cov_1.009259	944	1024	0	80	80	1.0000000
NODE_4078_length_1179_cov_1.009259	997	1077	0	80	80	1.0000000
NODE_4079_length_1178_cov_42.484708	423	503	2	80	80	1.0000000
NODE_4079_length_1178_cov_42.484708	476	556	0	27	80	0.3375000
NODE_4079_length_1178_cov_42.484708	476	556	2	53	80	0.6625000
NODE_4079_length_1178_cov_42.484708	552	632	0	9	80	0.1125000
NODE_4079_length_1178_cov_42.484708	552	632	1	17	80	0.2125000
NODE_4079_length_1178_cov_42.484708	552	632	2	54	80	0.6750000
NODE_4079_length_1178_cov_42.484708	605	685	2	80	80	1.0000000
NODE_4080_length_1178_cov_15.332715	215	295	0	7	80	0.0875000
NODE_4080_length_1178_cov_15.332715	215	295	2	73	80	0.9125000
NODE_4080_length_1178_cov_15.332715	268	348	0	52	80	0.6500000
NODE_4080_length_1178_cov_15.332715	268	348	2	28	80	0.3500000
NODE_4081_length_1178_cov_11.403151	527	607	0	80	80	1.0000000
NODE_4081_length_1178_cov_11.403151	580	660	0	80	80	1.0000000
NODE_4084_length_1177_cov_34.920223	369	449	0	80	80	1.0000000
NODE_4084_length_1177_cov_34.920223	422	502	0	63	80	0.7875000
NODE_4084_length_1177_cov_34.920223	422	502	2	17	80	0.2125000
NODE_4084_length_1177_cov_34.920223	498	578	2	80	80	1.0000000
NODE_4084_length_1177_cov_34.920223	551	631	0	43	80	0.5375000
NODE_4084_length_1177_cov_34.920223	551	631	2	37	80	0.4625000
NODE_4085_length_1177_cov_12.186456	481	561	0	80	80	1.0000000
NODE_4085_length_1177_cov_12.186456	534	614	0	80	80	1.0000000
NODE_4085_length_1177_cov_12.186456	610	690	0	43	80	0.5375000
NODE_4085_length_1177_cov_12.186456	610	690	2	37	80	0.4625000
NODE_4085_length_1177_cov_12.186456	663	743	0	6	80	0.0750000
NODE_4085_length_1177_cov_12.186456	663	743	2	74	80	0.9250000
NODE_4086_length_1177_cov_11.926716	443	523	4	15	80	0.1875000
NODE_4086_length_1177_cov_11.926716	443	523	6	47	80	0.5875000
NODE_4086_length_1177_cov_11.926716	443	523	12	18	80	0.2250000
NODE_4086_length_1177_cov_11.926716	496	578	6	36	82	0.4390244
NODE_4086_length_1177_cov_11.926716	496	578	8	6	82	0.0731707
NODE_4086_length_1177_cov_11.926716	496	578	12	40	82	0.4878049
NODE_4088_length_1177_cov_5.923933	358	438	0	45	80	0.5625000
NODE_4088_length_1177_cov_5.923933	358	438	2	35	80	0.4375000
NODE_4088_length_1177_cov_5.923933	411	491	2	80	80	1.0000000
NODE_4089_length_1177_cov_5.775510	760	840	0	62	80	0.7750000
NODE_4089_length_1177_cov_5.775510	760	840	2	18	80	0.2250000
NODE_4089_length_1177_cov_5.775510	813	893	0	80	80	1.0000000
NODE_4096_length_1176_cov_26.994429	377	457	0	80	80	1.0000000
NODE_4096_length_1176_cov_26.994429	430	510	0	61	80	0.7625000
NODE_4096_length_1176_cov_26.994429	430	510	2	19	80	0.2375000
NODE_4096_length_1176_cov_26.994429	506	586	2	80	80	1.0000000
NODE_4096_length_1176_cov_26.994429	559	639	0	51	80	0.6375000
NODE_4096_length_1176_cov_26.994429	559	639	2	29	80	0.3625000
NODE_4097_length_1176_cov_15.766945	531	611	0	45	80	0.5625000
NODE_4097_length_1176_cov_15.766945	531	611	4	35	80	0.4375000
NODE_4097_length_1176_cov_15.766945	584	664	4	80	80	1.0000000
NODE_4098_length_1176_cov_14.882080	628	708	0	2	80	0.0250000
NODE_4098_length_1176_cov_14.882080	628	708	2	78	80	0.9750000
NODE_4098_length_1176_cov_14.882080	681	761	0	55	80	0.6875000
NODE_4098_length_1176_cov_14.882080	681	761	2	25	80	0.3125000
NODE_4099_length_1176_cov_10.692665	392	472	0	80	80	1.0000000
NODE_4099_length_1176_cov_10.692665	445	525	0	80	80	1.0000000
NODE_4106_length_1175_cov_50.754647	526	606	0	80	80	1.0000000
NODE_4106_length_1175_cov_50.754647	579	659	0	80	80	1.0000000
NODE_4107_length_1175_cov_42.638476	327	407	0	80	80	1.0000000
NODE_4107_length_1175_cov_42.638476	380	460	0	80	80	1.0000000
NODE_4107_length_1175_cov_42.638476	456	536	0	10	80	0.1250000
NODE_4107_length_1175_cov_42.638476	456	536	4	52	80	0.6500000
NODE_4107_length_1175_cov_42.638476	456	536	8	8	80	0.1000000
NODE_4107_length_1175_cov_42.638476	456	536	10	10	80	0.1250000
NODE_4107_length_1175_cov_42.638476	509	589	4	9	80	0.1125000
NODE_4107_length_1175_cov_42.638476	509	589	6	19	80	0.2375000
NODE_4107_length_1175_cov_42.638476	509	589	8	8	80	0.1000000
NODE_4107_length_1175_cov_42.638476	509	589	10	44	80	0.5500000
NODE_4108_length_1175_cov_40.217472	437	517	0	80	80	1.0000000
NODE_4108_length_1175_cov_40.217472	490	570	0	63	80	0.7875000
NODE_4108_length_1175_cov_40.217472	490	570	1	1	80	0.0125000
NODE_4108_length_1175_cov_40.217472	490	570	2	16	80	0.2000000
NODE_4108_length_1175_cov_40.217472	566	646	0	15	80	0.1875000
NODE_4108_length_1175_cov_40.217472	566	646	2	65	80	0.8125000
NODE_4108_length_1175_cov_40.217472	619	699	0	68	80	0.8500000
NODE_4108_length_1175_cov_40.217472	619	699	2	12	80	0.1500000
NODE_4109_length_1175_cov_12.834572	775	855	0	80	80	1.0000000
NODE_4109_length_1175_cov_12.834572	828	908	0	80	80	1.0000000
NODE_4115_length_1174_cov_20.569302	433	513	2	26	80	0.3250000
NODE_4115_length_1174_cov_20.569302	433	513	4	54	80	0.6750000
NODE_4115_length_1174_cov_20.569302	486	566	2	31	80	0.3875000
NODE_4115_length_1174_cov_20.569302	486	566	4	49	80	0.6125000
NODE_4115_length_1174_cov_20.569302	562	642	0	55	80	0.6875000
NODE_4115_length_1174_cov_20.569302	562	642	2	25	80	0.3125000
NODE_4115_length_1174_cov_20.569302	615	695	0	80	80	1.0000000
NODE_4116_length_1174_cov_18.797209	578	658	0	80	80	1.0000000
NODE_4116_length_1174_cov_18.797209	631	711	0	80	80	1.0000000
NODE_4117_length_1174_cov_17.486512	589	669	0	66	80	0.8250000
NODE_4117_length_1174_cov_17.486512	589	669	2	14	80	0.1750000
NODE_4117_length_1174_cov_17.486512	642	722	0	80	80	1.0000000
NODE_4118_length_1174_cov_15.888372	570	650	0	80	80	1.0000000
NODE_4118_length_1174_cov_15.888372	623	703	0	80	80	1.0000000
NODE_4118_length_1174_cov_15.888372	699	779	0	80	80	1.0000000
NODE_4118_length_1174_cov_15.888372	752	832	0	80	80	1.0000000
NODE_4124_length_1174_cov_1.536744	1066	1115	0	42	49	0.8571429
NODE_4124_length_1174_cov_1.536744	1066	1115	2	7	49	0.1428571
NODE_4124_length_1174_cov_1.536744	1088	1168	0	80	80	1.0000000
NODE_4128_length_1173_cov_29.562384	455	535	8	24	80	0.3000000
NODE_4128_length_1173_cov_29.562384	455	535	10	56	80	0.7000000
NODE_4128_length_1173_cov_29.562384	508	588	0	21	80	0.2625000
NODE_4128_length_1173_cov_29.562384	508	588	2	12	80	0.1500000
NODE_4128_length_1173_cov_29.562384	508	588	9	14	80	0.1750000
NODE_4128_length_1173_cov_29.562384	508	588	10	33	80	0.4125000
NODE_4128_length_1173_cov_29.562384	584	664	0	53	80	0.6625000
NODE_4128_length_1173_cov_29.562384	584	664	2	5	80	0.0625000
NODE_4128_length_1173_cov_29.562384	584	664	4	22	80	0.2750000
NODE_4128_length_1173_cov_29.562384	637	717	2	5	80	0.0625000
NODE_4128_length_1173_cov_29.562384	637	717	3	14	80	0.1750000
NODE_4128_length_1173_cov_29.562384	637	717	4	61	80	0.7625000
NODE_4129_length_1173_cov_25.206704	395	475	0	7	80	0.0875000
NODE_4129_length_1173_cov_25.206704	395	475	2	73	80	0.9125000
NODE_4129_length_1173_cov_25.206704	448	528	0	56	80	0.7000000
NODE_4129_length_1173_cov_25.206704	448	528	2	24	80	0.3000000
NODE_4130_length_1173_cov_9.486965	693	773	0	80	80	1.0000000
NODE_4130_length_1173_cov_9.486965	746	826	0	80	80	1.0000000
NODE_4131_length_1173_cov_7.946927	201	281	0	80	80	1.0000000
NODE_4131_length_1173_cov_7.946927	254	334	0	80	80	1.0000000
NODE_4136_length_1172_cov_37.177074	527	607	0	2	80	0.0250000
NODE_4136_length_1172_cov_37.177074	527	607	2	45	80	0.5625000
NODE_4136_length_1172_cov_37.177074	527	607	4	22	80	0.2750000
NODE_4136_length_1172_cov_37.177074	527	607	6	11	80	0.1375000
NODE_4136_length_1172_cov_37.177074	580	660	4	69	80	0.8625000
NODE_4136_length_1172_cov_37.177074	580	660	6	11	80	0.1375000
NODE_4137_length_1172_cov_20.397018	677	757	0	37	80	0.4625000
NODE_4137_length_1172_cov_20.397018	677	757	5	19	80	0.2375000
NODE_4137_length_1172_cov_20.397018	677	757	6	24	80	0.3000000
NODE_4137_length_1172_cov_20.397018	730	810	0	8	80	0.1000000
NODE_4137_length_1172_cov_20.397018	730	810	5	4	80	0.0500000
NODE_4137_length_1172_cov_20.397018	730	810	6	68	80	0.8500000
NODE_4138_length_1172_cov_15.018639	460	540	0	80	80	1.0000000
NODE_4138_length_1172_cov_15.018639	513	593	0	80	80	1.0000000
NODE_4139_length_1172_cov_13.199441	622	702	0	80	80	1.0000000
NODE_4139_length_1172_cov_13.199441	675	755	0	80	80	1.0000000
NODE_4140_length_1172_cov_10.720410	499	579	0	25	80	0.3125000
NODE_4140_length_1172_cov_10.720410	499	579	2	55	80	0.6875000
NODE_4140_length_1172_cov_10.720410	552	632	0	78	80	0.9750000
NODE_4140_length_1172_cov_10.720410	552	632	2	2	80	0.0250000
NODE_4140_length_1172_cov_10.720410	628	708	0	80	80	1.0000000
NODE_4140_length_1172_cov_10.720410	681	761	0	80	80	1.0000000
NODE_4141_length_1172_cov_10.574091	951	1021	8	4	70	0.0571429
NODE_4141_length_1172_cov_10.574091	951	1021	10	2	70	0.0285714
NODE_4141_length_1172_cov_10.574091	951	1021	12	9	70	0.1285714
NODE_4141_length_1172_cov_10.574091	951	1021	14	1	70	0.0142857
NODE_4141_length_1172_cov_10.574091	951	1021	16	3	70	0.0428571
NODE_4141_length_1172_cov_10.574091	951	1021	18	2	70	0.0285714
NODE_4141_length_1172_cov_10.574091	951	1021	20	6	70	0.0857143
NODE_4141_length_1172_cov_10.574091	951	1021	22	3	70	0.0428571
NODE_4141_length_1172_cov_10.574091	951	1021	24	29	70	0.4142857
NODE_4141_length_1172_cov_10.574091	951	1021	26	11	70	0.1571429
NODE_4142_length_1172_cov_9.204101	276	356	0	80	80	1.0000000
NODE_4142_length_1172_cov_9.204101	329	409	0	80	80	1.0000000
NODE_4148_length_1171_cov_13.311567	666	746	0	7	80	0.0875000
NODE_4148_length_1171_cov_13.311567	666	746	2	73	80	0.9125000
NODE_4148_length_1171_cov_13.311567	719	803	2	56	84	0.6666667
NODE_4148_length_1171_cov_13.311567	719	803	4	28	84	0.3333333
NODE_4149_length_1171_cov_9.154851	198	278	0	48	80	0.6000000
NODE_4149_length_1171_cov_9.154851	198	278	2	32	80	0.4000000
NODE_4149_length_1171_cov_9.154851	251	331	2	80	80	1.0000000
NODE_4157_length_1170_cov_65.480859	402	482	0	80	80	1.0000000
NODE_4157_length_1170_cov_65.480859	455	535	0	80	80	1.0000000
NODE_4158_length_1170_cov_35.283847	704	784	2	21	80	0.2625000
NODE_4158_length_1170_cov_35.283847	704	784	3	5	80	0.0625000
NODE_4158_length_1170_cov_35.283847	704	784	4	54	80	0.6750000
NODE_4158_length_1170_cov_35.283847	757	837	1	44	80	0.5500000
NODE_4158_length_1170_cov_35.283847	757	837	2	21	80	0.2625000
NODE_4158_length_1170_cov_35.283847	757	837	3	14	80	0.1750000
NODE_4158_length_1170_cov_35.283847	757	837	4	1	80	0.0125000
NODE_4159_length_1170_cov_23.600373	450	530	0	80	80	1.0000000
NODE_4159_length_1170_cov_23.600373	503	583	0	80	80	1.0000000
NODE_4159_length_1170_cov_23.600373	579	659	0	80	80	1.0000000
NODE_4159_length_1170_cov_23.600373	632	705	0	51	73	0.6986302
NODE_4159_length_1170_cov_23.600373	632	705	2	22	73	0.3013699
NODE_4160_length_1170_cov_19.783380	325	405	0	80	80	1.0000000
NODE_4160_length_1170_cov_19.783380	378	458	0	80	80	1.0000000
NODE_4168_length_1169_cov_61.689720	464	544	0	56	80	0.7000000
NODE_4168_length_1169_cov_61.689720	464	544	2	24	80	0.3000000
NODE_4168_length_1169_cov_61.689720	517	597	0	3	80	0.0375000
NODE_4168_length_1169_cov_61.689720	517	597	2	52	80	0.6500000
NODE_4168_length_1169_cov_61.689720	517	597	10	9	80	0.1125000
NODE_4168_length_1169_cov_61.689720	517	597	12	13	80	0.1625000
NODE_4168_length_1169_cov_61.689720	517	597	14	3	80	0.0375000
NODE_4168_length_1169_cov_61.689720	593	673	10	13	80	0.1625000
NODE_4168_length_1169_cov_61.689720	593	673	12	63	80	0.7875000
NODE_4168_length_1169_cov_61.689720	593	673	14	4	80	0.0500000
NODE_4168_length_1169_cov_61.689720	646	726	0	25	80	0.3125000
NODE_4168_length_1169_cov_61.689720	646	726	2	1	80	0.0125000
NODE_4168_length_1169_cov_61.689720	646	726	9	1	80	0.0125000
NODE_4168_length_1169_cov_61.689720	646	726	10	39	80	0.4875000
NODE_4168_length_1169_cov_61.689720	646	726	12	14	80	0.1750000
NODE_4169_length_1169_cov_55.247664	640	720	0	27	80	0.3375000
NODE_4169_length_1169_cov_55.247664	640	720	5	39	80	0.4875000
NODE_4169_length_1169_cov_55.247664	640	720	7	14	80	0.1750000
NODE_4169_length_1169_cov_55.247664	693	773	2	19	80	0.2375000
NODE_4169_length_1169_cov_55.247664	693	773	5	13	80	0.1625000
NODE_4169_length_1169_cov_55.247664	693	773	7	48	80	0.6000000
NODE_4170_length_1169_cov_39.016822	447	527	0	80	80	1.0000000
NODE_4170_length_1169_cov_39.016822	500	580	0	80	80	1.0000000
NODE_4170_length_1169_cov_39.016822	576	656	0	80	80	1.0000000
NODE_4170_length_1169_cov_39.016822	629	709	0	80	80	1.0000000
NODE_4171_length_1169_cov_35.383178	582	662	0	31	80	0.3875000
NODE_4171_length_1169_cov_35.383178	582	662	1	1	80	0.0125000
NODE_4171_length_1169_cov_35.383178	582	662	2	48	80	0.6000000
NODE_4171_length_1169_cov_35.383178	635	715	2	80	80	1.0000000
NODE_4173_length_1169_cov_12.010280	338	418	0	29	80	0.3625000
NODE_4173_length_1169_cov_12.010280	338	418	2	51	80	0.6375000
NODE_4173_length_1169_cov_12.010280	391	471	2	72	80	0.9000000
NODE_4173_length_1169_cov_12.010280	391	471	4	8	80	0.1000000
NODE_4175_length_1169_cov_4.172897	74	135	0	61	61	1.0000000
NODE_4175_length_1169_cov_4.172897	74	135	0	61	61	1.0000000
NODE_4175_length_1169_cov_4.172897	74	135	0	61	61	1.0000000
NODE_4183_length_1168_cov_27.350795	517	597	0	80	80	1.0000000
NODE_4183_length_1168_cov_27.350795	570	650	0	71	80	0.8875000
NODE_4183_length_1168_cov_27.350795	570	650	2	9	80	0.1125000
NODE_4183_length_1168_cov_27.350795	646	726	0	9	80	0.1125000
NODE_4183_length_1168_cov_27.350795	646	726	2	71	80	0.8875000
NODE_4183_length_1168_cov_27.350795	699	779	0	62	80	0.7750000
NODE_4183_length_1168_cov_27.350795	699	779	2	18	80	0.2250000
NODE_4184_length_1168_cov_25.777362	672	752	0	80	80	1.0000000
NODE_4184_length_1168_cov_25.777362	725	805	0	80	80	1.0000000
NODE_4185_length_1168_cov_25.295603	543	623	3	13	80	0.1625000
NODE_4185_length_1168_cov_25.295603	543	623	4	62	80	0.7750000
NODE_4185_length_1168_cov_25.295603	543	623	5	5	80	0.0625000
NODE_4185_length_1168_cov_25.295603	596	676	2	31	80	0.3875000
NODE_4185_length_1168_cov_25.295603	596	676	4	49	80	0.6125000
NODE_4185_length_1168_cov_25.295603	672	752	2	74	80	0.9250000
NODE_4185_length_1168_cov_25.295603	672	752	4	6	80	0.0750000
NODE_4185_length_1168_cov_25.295603	725	804	0	17	79	0.2151899
NODE_4185_length_1168_cov_25.295603	725	804	2	62	79	0.7848101
NODE_4186_length_1168_cov_20.202058	434	514	0	80	80	1.0000000
NODE_4186_length_1168_cov_20.202058	487	567	0	80	80	1.0000000
NODE_4187_length_1168_cov_16.787652	405	485	0	80	80	1.0000000
NODE_4187_length_1168_cov_16.787652	458	538	0	80	80	1.0000000
NODE_4188_length_1168_cov_10.079514	722	802	0	80	80	1.0000000
NODE_4188_length_1168_cov_10.079514	775	855	0	80	80	1.0000000
NODE_4198_length_1167_cov_27.961610	591	671	4	3	80	0.0375000
NODE_4198_length_1167_cov_27.961610	591	671	6	32	80	0.4000000
NODE_4198_length_1167_cov_27.961610	591	671	8	3	80	0.0375000
NODE_4198_length_1167_cov_27.961610	591	671	10	8	80	0.1000000
NODE_4198_length_1167_cov_27.961610	591	671	12	4	80	0.0500000
NODE_4198_length_1167_cov_27.961610	591	671	14	7	80	0.0875000
NODE_4198_length_1167_cov_27.961610	591	671	18	20	80	0.2500000
NODE_4198_length_1167_cov_27.961610	591	671	20	3	80	0.0375000
NODE_4198_length_1167_cov_27.961610	644	724	8	7	80	0.0875000
NODE_4198_length_1167_cov_27.961610	644	724	10	6	80	0.0750000
NODE_4198_length_1167_cov_27.961610	644	724	12	1	80	0.0125000
NODE_4198_length_1167_cov_27.961610	644	724	14	19	80	0.2375000
NODE_4198_length_1167_cov_27.961610	644	724	16	1	80	0.0125000
NODE_4198_length_1167_cov_27.961610	644	724	18	43	80	0.5375000
NODE_4198_length_1167_cov_27.961610	644	724	20	3	80	0.0375000
NODE_4199_length_1167_cov_12.393258	670	750	0	80	80	1.0000000
NODE_4199_length_1167_cov_12.393258	723	803	0	80	80	1.0000000
NODE_4200_length_1167_cov_11.189139	434	514	2	40	80	0.5000000
NODE_4200_length_1167_cov_11.189139	434	514	4	40	80	0.5000000
NODE_4200_length_1167_cov_11.189139	487	567	0	33	80	0.4125000
NODE_4200_length_1167_cov_11.189139	487	567	2	41	80	0.5125000
NODE_4200_length_1167_cov_11.189139	487	567	4	6	80	0.0750000
NODE_4201_length_1167_cov_7.998127	711	791	0	80	80	1.0000000
NODE_4201_length_1167_cov_7.998127	764	844	0	80	80	1.0000000
NODE_4206_length_1166_cov_313.815370	444	524	96	6	80	0.0750000
NODE_4206_length_1166_cov_313.815370	444	524	97	1	80	0.0125000
NODE_4206_length_1166_cov_313.815370	444	524	98	4	80	0.0500000
NODE_4206_length_1166_cov_313.815370	444	524	100	2	80	0.0250000
NODE_4206_length_1166_cov_313.815370	444	524	102	1	80	0.0125000
NODE_4206_length_1166_cov_313.815370	444	524	112	1	80	0.0125000
NODE_4206_length_1166_cov_313.815370	444	524	129	1	80	0.0125000
NODE_4206_length_1166_cov_313.815370	444	524	131	1	80	0.0125000
NODE_4206_length_1166_cov_313.815370	444	524	145	1	80	0.0125000
NODE_4206_length_1166_cov_313.815370	444	524	150	1	80	0.0125000
NODE_4206_length_1166_cov_313.815370	444	524	162	1	80	0.0125000
NODE_4206_length_1166_cov_313.815370	444	524	167	1	80	0.0125000
NODE_4206_length_1166_cov_313.815370	444	524	186	1	80	0.0125000
NODE_4206_length_1166_cov_313.815370	444	524	197	4	80	0.0500000
NODE_4206_length_1166_cov_313.815370	444	524	204	2	80	0.0250000
NODE_4206_length_1166_cov_313.815370	444	524	206	1	80	0.0125000
NODE_4206_length_1166_cov_313.815370	444	524	218	1	80	0.0125000
NODE_4206_length_1166_cov_313.815370	444	524	228	2	80	0.0250000
NODE_4206_length_1166_cov_313.815370	444	524	229	2	80	0.0250000
NODE_4206_length_1166_cov_313.815370	444	524	245	1	80	0.0125000
NODE_4206_length_1166_cov_313.815370	444	524	263	1	80	0.0125000
NODE_4206_length_1166_cov_313.815370	444	524	270	1	80	0.0125000
NODE_4206_length_1166_cov_313.815370	444	524	281	2	80	0.0250000
NODE_4206_length_1166_cov_313.815370	444	524	287	1	80	0.0125000
NODE_4206_length_1166_cov_313.815370	444	524	292	1	80	0.0125000
NODE_4206_length_1166_cov_313.815370	444	524	319	1	80	0.0125000
NODE_4206_length_1166_cov_313.815370	444	524	322	1	80	0.0125000
NODE_4206_length_1166_cov_313.815370	444	524	328	1	80	0.0125000
NODE_4206_length_1166_cov_313.815370	444	524	335	1	80	0.0125000
NODE_4206_length_1166_cov_313.815370	444	524	339	3	80	0.0375000
NODE_4206_length_1166_cov_313.815370	444	524	341	1	80	0.0125000
NODE_4206_length_1166_cov_313.815370	444	524	344	2	80	0.0250000
NODE_4206_length_1166_cov_313.815370	444	524	353	1	80	0.0125000
NODE_4206_length_1166_cov_313.815370	444	524	363	1	80	0.0125000
NODE_4206_length_1166_cov_313.815370	444	524	366	1	80	0.0125000
NODE_4206_length_1166_cov_313.815370	444	524	369	1	80	0.0125000
NODE_4206_length_1166_cov_313.815370	444	524	374	1	80	0.0125000
NODE_4206_length_1166_cov_313.815370	444	524	376	1	80	0.0125000
NODE_4206_length_1166_cov_313.815370	444	524	379	1	80	0.0125000
NODE_4206_length_1166_cov_313.815370	444	524	382	1	80	0.0125000
NODE_4206_length_1166_cov_313.815370	444	524	390	1	80	0.0125000
NODE_4206_length_1166_cov_313.815370	444	524	397	2	80	0.0250000
NODE_4206_length_1166_cov_313.815370	444	524	402	1	80	0.0125000
NODE_4206_length_1166_cov_313.815370	444	524	416	1	80	0.0125000
NODE_4206_length_1166_cov_313.815370	444	524	429	2	80	0.0250000
NODE_4206_length_1166_cov_313.815370	444	524	430	1	80	0.0125000
NODE_4206_length_1166_cov_313.815370	444	524	432	1	80	0.0125000
NODE_4206_length_1166_cov_313.815370	444	524	437	1	80	0.0125000
NODE_4206_length_1166_cov_313.815370	444	524	442	1	80	0.0125000
NODE_4206_length_1166_cov_313.815370	444	524	445	1	80	0.0125000
NODE_4206_length_1166_cov_313.815370	444	524	453	1	80	0.0125000
NODE_4206_length_1166_cov_313.815370	444	524	454	1	80	0.0125000
NODE_4206_length_1166_cov_313.815370	444	524	456	1	80	0.0125000
NODE_4206_length_1166_cov_313.815370	444	524	463	1	80	0.0125000
NODE_4206_length_1166_cov_313.815370	444	524	467	1	80	0.0125000
NODE_4206_length_1166_cov_313.815370	444	524	469	1	80	0.0125000
NODE_4206_length_1166_cov_313.815370	444	524	472	1	80	0.0125000
NODE_4206_length_1166_cov_313.815370	444	524	480	1	80	0.0125000
NODE_4206_length_1166_cov_313.815370	444	524	489	1	80	0.0125000
NODE_4206_length_1166_cov_313.815370	444	524	96	6	80	0.0750000
NODE_4206_length_1166_cov_313.815370	444	524	97	1	80	0.0125000
NODE_4206_length_1166_cov_313.815370	444	524	98	4	80	0.0500000
NODE_4206_length_1166_cov_313.815370	444	524	100	2	80	0.0250000
NODE_4206_length_1166_cov_313.815370	444	524	102	1	80	0.0125000
NODE_4206_length_1166_cov_313.815370	444	524	112	1	80	0.0125000
NODE_4206_length_1166_cov_313.815370	444	524	129	1	80	0.0125000
NODE_4206_length_1166_cov_313.815370	444	524	131	1	80	0.0125000
NODE_4206_length_1166_cov_313.815370	444	524	145	1	80	0.0125000
NODE_4206_length_1166_cov_313.815370	444	524	150	1	80	0.0125000
NODE_4206_length_1166_cov_313.815370	444	524	162	1	80	0.0125000
NODE_4206_length_1166_cov_313.815370	444	524	167	1	80	0.0125000
NODE_4206_length_1166_cov_313.815370	444	524	186	1	80	0.0125000
NODE_4206_length_1166_cov_313.815370	444	524	197	4	80	0.0500000
NODE_4206_length_1166_cov_313.815370	444	524	204	2	80	0.0250000
NODE_4206_length_1166_cov_313.815370	444	524	206	1	80	0.0125000
NODE_4206_length_1166_cov_313.815370	444	524	218	1	80	0.0125000
NODE_4206_length_1166_cov_313.815370	444	524	228	2	80	0.0250000
NODE_4206_length_1166_cov_313.815370	444	524	229	2	80	0.0250000
NODE_4206_length_1166_cov_313.815370	444	524	245	1	80	0.0125000
NODE_4206_length_1166_cov_313.815370	444	524	263	1	80	0.0125000
NODE_4206_length_1166_cov_313.815370	444	524	270	1	80	0.0125000
NODE_4206_length_1166_cov_313.815370	444	524	281	2	80	0.0250000
NODE_4206_length_1166_cov_313.815370	444	524	287	1	80	0.0125000
NODE_4206_length_1166_cov_313.815370	444	524	292	1	80	0.0125000
NODE_4206_length_1166_cov_313.815370	444	524	319	1	80	0.0125000
NODE_4206_length_1166_cov_313.815370	444	524	322	1	80	0.0125000
NODE_4206_length_1166_cov_313.815370	444	524	328	1	80	0.0125000
NODE_4206_length_1166_cov_313.815370	444	524	335	1	80	0.0125000
NODE_4206_length_1166_cov_313.815370	444	524	339	3	80	0.0375000
NODE_4206_length_1166_cov_313.815370	444	524	341	1	80	0.0125000
NODE_4206_length_1166_cov_313.815370	444	524	344	2	80	0.0250000
NODE_4206_length_1166_cov_313.815370	444	524	353	1	80	0.0125000
NODE_4206_length_1166_cov_313.815370	444	524	363	1	80	0.0125000
NODE_4206_length_1166_cov_313.815370	444	524	366	1	80	0.0125000
NODE_4206_length_1166_cov_313.815370	444	524	369	1	80	0.0125000
NODE_4206_length_1166_cov_313.815370	444	524	374	1	80	0.0125000
NODE_4206_length_1166_cov_313.815370	444	524	376	1	80	0.0125000
NODE_4206_length_1166_cov_313.815370	444	524	379	1	80	0.0125000
NODE_4206_length_1166_cov_313.815370	444	524	382	1	80	0.0125000
NODE_4206_length_1166_cov_313.815370	444	524	390	1	80	0.0125000
NODE_4206_length_1166_cov_313.815370	444	524	397	2	80	0.0250000
NODE_4206_length_1166_cov_313.815370	444	524	402	1	80	0.0125000
NODE_4206_length_1166_cov_313.815370	444	524	416	1	80	0.0125000
NODE_4206_length_1166_cov_313.815370	444	524	429	2	80	0.0250000
NODE_4206_length_1166_cov_313.815370	444	524	430	1	80	0.0125000
NODE_4206_length_1166_cov_313.815370	444	524	432	1	80	0.0125000
NODE_4206_length_1166_cov_313.815370	444	524	437	1	80	0.0125000
NODE_4206_length_1166_cov_313.815370	444	524	442	1	80	0.0125000
NODE_4206_length_1166_cov_313.815370	444	524	445	1	80	0.0125000
NODE_4206_length_1166_cov_313.815370	444	524	453	1	80	0.0125000
NODE_4206_length_1166_cov_313.815370	444	524	454	1	80	0.0125000
NODE_4206_length_1166_cov_313.815370	444	524	456	1	80	0.0125000
NODE_4206_length_1166_cov_313.815370	444	524	463	1	80	0.0125000
NODE_4206_length_1166_cov_313.815370	444	524	467	1	80	0.0125000
NODE_4206_length_1166_cov_313.815370	444	524	469	1	80	0.0125000
NODE_4206_length_1166_cov_313.815370	444	524	472	1	80	0.0125000
NODE_4206_length_1166_cov_313.815370	444	524	480	1	80	0.0125000
NODE_4206_length_1166_cov_313.815370	444	524	489	1	80	0.0125000
NODE_4206_length_1166_cov_313.815370	444	524	96	6	80	0.0750000
NODE_4206_length_1166_cov_313.815370	444	524	97	1	80	0.0125000
NODE_4206_length_1166_cov_313.815370	444	524	98	4	80	0.0500000
NODE_4206_length_1166_cov_313.815370	444	524	100	2	80	0.0250000
NODE_4206_length_1166_cov_313.815370	444	524	102	1	80	0.0125000
NODE_4206_length_1166_cov_313.815370	444	524	112	1	80	0.0125000
NODE_4206_length_1166_cov_313.815370	444	524	129	1	80	0.0125000
NODE_4206_length_1166_cov_313.815370	444	524	131	1	80	0.0125000
NODE_4206_length_1166_cov_313.815370	444	524	145	1	80	0.0125000
NODE_4206_length_1166_cov_313.815370	444	524	150	1	80	0.0125000
NODE_4206_length_1166_cov_313.815370	444	524	162	1	80	0.0125000
NODE_4206_length_1166_cov_313.815370	444	524	167	1	80	0.0125000
NODE_4206_length_1166_cov_313.815370	444	524	186	1	80	0.0125000
NODE_4206_length_1166_cov_313.815370	444	524	197	4	80	0.0500000
NODE_4206_length_1166_cov_313.815370	444	524	204	2	80	0.0250000
NODE_4206_length_1166_cov_313.815370	444	524	206	1	80	0.0125000
NODE_4206_length_1166_cov_313.815370	444	524	218	1	80	0.0125000
NODE_4206_length_1166_cov_313.815370	444	524	228	2	80	0.0250000
NODE_4206_length_1166_cov_313.815370	444	524	229	2	80	0.0250000
NODE_4206_length_1166_cov_313.815370	444	524	245	1	80	0.0125000
NODE_4206_length_1166_cov_313.815370	444	524	263	1	80	0.0125000
NODE_4206_length_1166_cov_313.815370	444	524	270	1	80	0.0125000
NODE_4206_length_1166_cov_313.815370	444	524	281	2	80	0.0250000
NODE_4206_length_1166_cov_313.815370	444	524	287	1	80	0.0125000
NODE_4206_length_1166_cov_313.815370	444	524	292	1	80	0.0125000
NODE_4206_length_1166_cov_313.815370	444	524	319	1	80	0.0125000
NODE_4206_length_1166_cov_313.815370	444	524	322	1	80	0.0125000
NODE_4206_length_1166_cov_313.815370	444	524	328	1	80	0.0125000
NODE_4206_length_1166_cov_313.815370	444	524	335	1	80	0.0125000
NODE_4206_length_1166_cov_313.815370	444	524	339	3	80	0.0375000
NODE_4206_length_1166_cov_313.815370	444	524	341	1	80	0.0125000
NODE_4206_length_1166_cov_313.815370	444	524	344	2	80	0.0250000
NODE_4206_length_1166_cov_313.815370	444	524	353	1	80	0.0125000
NODE_4206_length_1166_cov_313.815370	444	524	363	1	80	0.0125000
NODE_4206_length_1166_cov_313.815370	444	524	366	1	80	0.0125000
NODE_4206_length_1166_cov_313.815370	444	524	369	1	80	0.0125000
NODE_4206_length_1166_cov_313.815370	444	524	374	1	80	0.0125000
NODE_4206_length_1166_cov_313.815370	444	524	376	1	80	0.0125000
NODE_4206_length_1166_cov_313.815370	444	524	379	1	80	0.0125000
NODE_4206_length_1166_cov_313.815370	444	524	382	1	80	0.0125000
NODE_4206_length_1166_cov_313.815370	444	524	390	1	80	0.0125000
NODE_4206_length_1166_cov_313.815370	444	524	397	2	80	0.0250000
NODE_4206_length_1166_cov_313.815370	444	524	402	1	80	0.0125000
NODE_4206_length_1166_cov_313.815370	444	524	416	1	80	0.0125000
NODE_4206_length_1166_cov_313.815370	444	524	429	2	80	0.0250000
NODE_4206_length_1166_cov_313.815370	444	524	430	1	80	0.0125000
NODE_4206_length_1166_cov_313.815370	444	524	432	1	80	0.0125000
NODE_4206_length_1166_cov_313.815370	444	524	437	1	80	0.0125000
NODE_4206_length_1166_cov_313.815370	444	524	442	1	80	0.0125000
NODE_4206_length_1166_cov_313.815370	444	524	445	1	80	0.0125000
NODE_4206_length_1166_cov_313.815370	444	524	453	1	80	0.0125000
NODE_4206_length_1166_cov_313.815370	444	524	454	1	80	0.0125000
NODE_4206_length_1166_cov_313.815370	444	524	456	1	80	0.0125000
NODE_4206_length_1166_cov_313.815370	444	524	463	1	80	0.0125000
NODE_4206_length_1166_cov_313.815370	444	524	467	1	80	0.0125000
NODE_4206_length_1166_cov_313.815370	444	524	469	1	80	0.0125000
NODE_4206_length_1166_cov_313.815370	444	524	472	1	80	0.0125000
NODE_4206_length_1166_cov_313.815370	444	524	480	1	80	0.0125000
NODE_4206_length_1166_cov_313.815370	444	524	489	1	80	0.0125000
NODE_4206_length_1166_cov_313.815370	444	524	96	6	80	0.0750000
NODE_4206_length_1166_cov_313.815370	444	524	97	1	80	0.0125000
NODE_4206_length_1166_cov_313.815370	444	524	98	4	80	0.0500000
NODE_4206_length_1166_cov_313.815370	444	524	100	2	80	0.0250000
NODE_4206_length_1166_cov_313.815370	444	524	102	1	80	0.0125000
NODE_4206_length_1166_cov_313.815370	444	524	112	1	80	0.0125000
NODE_4206_length_1166_cov_313.815370	444	524	129	1	80	0.0125000
NODE_4206_length_1166_cov_313.815370	444	524	131	1	80	0.0125000
NODE_4206_length_1166_cov_313.815370	444	524	145	1	80	0.0125000
NODE_4206_length_1166_cov_313.815370	444	524	150	1	80	0.0125000
NODE_4206_length_1166_cov_313.815370	444	524	162	1	80	0.0125000
NODE_4206_length_1166_cov_313.815370	444	524	167	1	80	0.0125000
NODE_4206_length_1166_cov_313.815370	444	524	186	1	80	0.0125000
NODE_4206_length_1166_cov_313.815370	444	524	197	4	80	0.0500000
NODE_4206_length_1166_cov_313.815370	444	524	204	2	80	0.0250000
NODE_4206_length_1166_cov_313.815370	444	524	206	1	80	0.0125000
NODE_4206_length_1166_cov_313.815370	444	524	218	1	80	0.0125000
NODE_4206_length_1166_cov_313.815370	444	524	228	2	80	0.0250000
NODE_4206_length_1166_cov_313.815370	444	524	229	2	80	0.0250000
NODE_4206_length_1166_cov_313.815370	444	524	245	1	80	0.0125000
NODE_4206_length_1166_cov_313.815370	444	524	263	1	80	0.0125000
NODE_4206_length_1166_cov_313.815370	444	524	270	1	80	0.0125000
NODE_4206_length_1166_cov_313.815370	444	524	281	2	80	0.0250000
NODE_4206_length_1166_cov_313.815370	444	524	287	1	80	0.0125000
NODE_4206_length_1166_cov_313.815370	444	524	292	1	80	0.0125000
NODE_4206_length_1166_cov_313.815370	444	524	319	1	80	0.0125000
NODE_4206_length_1166_cov_313.815370	444	524	322	1	80	0.0125000
NODE_4206_length_1166_cov_313.815370	444	524	328	1	80	0.0125000
NODE_4206_length_1166_cov_313.815370	444	524	335	1	80	0.0125000
NODE_4206_length_1166_cov_313.815370	444	524	339	3	80	0.0375000
NODE_4206_length_1166_cov_313.815370	444	524	341	1	80	0.0125000
NODE_4206_length_1166_cov_313.815370	444	524	344	2	80	0.0250000
NODE_4206_length_1166_cov_313.815370	444	524	353	1	80	0.0125000
NODE_4206_length_1166_cov_313.815370	444	524	363	1	80	0.0125000
NODE_4206_length_1166_cov_313.815370	444	524	366	1	80	0.0125000
NODE_4206_length_1166_cov_313.815370	444	524	369	1	80	0.0125000
NODE_4206_length_1166_cov_313.815370	444	524	374	1	80	0.0125000
NODE_4206_length_1166_cov_313.815370	444	524	376	1	80	0.0125000
NODE_4206_length_1166_cov_313.815370	444	524	379	1	80	0.0125000
NODE_4206_length_1166_cov_313.815370	444	524	382	1	80	0.0125000
NODE_4206_length_1166_cov_313.815370	444	524	390	1	80	0.0125000
NODE_4206_length_1166_cov_313.815370	444	524	397	2	80	0.0250000
NODE_4206_length_1166_cov_313.815370	444	524	402	1	80	0.0125000
NODE_4206_length_1166_cov_313.815370	444	524	416	1	80	0.0125000
NODE_4206_length_1166_cov_313.815370	444	524	429	2	80	0.0250000
NODE_4206_length_1166_cov_313.815370	444	524	430	1	80	0.0125000
NODE_4206_length_1166_cov_313.815370	444	524	432	1	80	0.0125000
NODE_4206_length_1166_cov_313.815370	444	524	437	1	80	0.0125000
NODE_4206_length_1166_cov_313.815370	444	524	442	1	80	0.0125000
NODE_4206_length_1166_cov_313.815370	444	524	445	1	80	0.0125000
NODE_4206_length_1166_cov_313.815370	444	524	453	1	80	0.0125000
NODE_4206_length_1166_cov_313.815370	444	524	454	1	80	0.0125000
NODE_4206_length_1166_cov_313.815370	444	524	456	1	80	0.0125000
NODE_4206_length_1166_cov_313.815370	444	524	463	1	80	0.0125000
NODE_4206_length_1166_cov_313.815370	444	524	467	1	80	0.0125000
NODE_4206_length_1166_cov_313.815370	444	524	469	1	80	0.0125000
NODE_4206_length_1166_cov_313.815370	444	524	472	1	80	0.0125000
NODE_4206_length_1166_cov_313.815370	444	524	480	1	80	0.0125000
NODE_4206_length_1166_cov_313.815370	444	524	489	1	80	0.0125000
NODE_4206_length_1166_cov_313.815370	444	524	96	6	80	0.0750000
NODE_4206_length_1166_cov_313.815370	444	524	97	1	80	0.0125000
NODE_4206_length_1166_cov_313.815370	444	524	98	4	80	0.0500000
NODE_4206_length_1166_cov_313.815370	444	524	100	2	80	0.0250000
NODE_4206_length_1166_cov_313.815370	444	524	102	1	80	0.0125000
NODE_4206_length_1166_cov_313.815370	444	524	112	1	80	0.0125000
NODE_4206_length_1166_cov_313.815370	444	524	129	1	80	0.0125000
NODE_4206_length_1166_cov_313.815370	444	524	131	1	80	0.0125000
NODE_4206_length_1166_cov_313.815370	444	524	145	1	80	0.0125000
NODE_4206_length_1166_cov_313.815370	444	524	150	1	80	0.0125000
NODE_4206_length_1166_cov_313.815370	444	524	162	1	80	0.0125000
NODE_4206_length_1166_cov_313.815370	444	524	167	1	80	0.0125000
NODE_4206_length_1166_cov_313.815370	444	524	186	1	80	0.0125000
NODE_4206_length_1166_cov_313.815370	444	524	197	4	80	0.0500000
NODE_4206_length_1166_cov_313.815370	444	524	204	2	80	0.0250000
NODE_4206_length_1166_cov_313.815370	444	524	206	1	80	0.0125000
NODE_4206_length_1166_cov_313.815370	444	524	218	1	80	0.0125000
NODE_4206_length_1166_cov_313.815370	444	524	228	2	80	0.0250000
NODE_4206_length_1166_cov_313.815370	444	524	229	2	80	0.0250000
NODE_4206_length_1166_cov_313.815370	444	524	245	1	80	0.0125000
NODE_4206_length_1166_cov_313.815370	444	524	263	1	80	0.0125000
NODE_4206_length_1166_cov_313.815370	444	524	270	1	80	0.0125000
NODE_4206_length_1166_cov_313.815370	444	524	281	2	80	0.0250000
NODE_4206_length_1166_cov_313.815370	444	524	287	1	80	0.0125000
NODE_4206_length_1166_cov_313.815370	444	524	292	1	80	0.0125000
NODE_4206_length_1166_cov_313.815370	444	524	319	1	80	0.0125000
NODE_4206_length_1166_cov_313.815370	444	524	322	1	80	0.0125000
NODE_4206_length_1166_cov_313.815370	444	524	328	1	80	0.0125000
NODE_4206_length_1166_cov_313.815370	444	524	335	1	80	0.0125000
NODE_4206_length_1166_cov_313.815370	444	524	339	3	80	0.0375000
NODE_4206_length_1166_cov_313.815370	444	524	341	1	80	0.0125000
NODE_4206_length_1166_cov_313.815370	444	524	344	2	80	0.0250000
NODE_4206_length_1166_cov_313.815370	444	524	353	1	80	0.0125000
NODE_4206_length_1166_cov_313.815370	444	524	363	1	80	0.0125000
NODE_4206_length_1166_cov_313.815370	444	524	366	1	80	0.0125000
NODE_4206_length_1166_cov_313.815370	444	524	369	1	80	0.0125000
NODE_4206_length_1166_cov_313.815370	444	524	374	1	80	0.0125000
NODE_4206_length_1166_cov_313.815370	444	524	376	1	80	0.0125000
NODE_4206_length_1166_cov_313.815370	444	524	379	1	80	0.0125000
NODE_4206_length_1166_cov_313.815370	444	524	382	1	80	0.0125000
NODE_4206_length_1166_cov_313.815370	444	524	390	1	80	0.0125000
NODE_4206_length_1166_cov_313.815370	444	524	397	2	80	0.0250000
NODE_4206_length_1166_cov_313.815370	444	524	402	1	80	0.0125000
NODE_4206_length_1166_cov_313.815370	444	524	416	1	80	0.0125000
NODE_4206_length_1166_cov_313.815370	444	524	429	2	80	0.0250000
NODE_4206_length_1166_cov_313.815370	444	524	430	1	80	0.0125000
NODE_4206_length_1166_cov_313.815370	444	524	432	1	80	0.0125000
NODE_4206_length_1166_cov_313.815370	444	524	437	1	80	0.0125000
NODE_4206_length_1166_cov_313.815370	444	524	442	1	80	0.0125000
NODE_4206_length_1166_cov_313.815370	444	524	445	1	80	0.0125000
NODE_4206_length_1166_cov_313.815370	444	524	453	1	80	0.0125000
NODE_4206_length_1166_cov_313.815370	444	524	454	1	80	0.0125000
NODE_4206_length_1166_cov_313.815370	444	524	456	1	80	0.0125000
NODE_4206_length_1166_cov_313.815370	444	524	463	1	80	0.0125000
NODE_4206_length_1166_cov_313.815370	444	524	467	1	80	0.0125000
NODE_4206_length_1166_cov_313.815370	444	524	469	1	80	0.0125000
NODE_4206_length_1166_cov_313.815370	444	524	472	1	80	0.0125000
NODE_4206_length_1166_cov_313.815370	444	524	480	1	80	0.0125000
NODE_4206_length_1166_cov_313.815370	444	524	489	1	80	0.0125000
NODE_4206_length_1166_cov_313.815370	444	524	96	6	80	0.0750000
NODE_4206_length_1166_cov_313.815370	444	524	97	1	80	0.0125000
NODE_4206_length_1166_cov_313.815370	444	524	98	4	80	0.0500000
NODE_4206_length_1166_cov_313.815370	444	524	100	2	80	0.0250000
NODE_4206_length_1166_cov_313.815370	444	524	102	1	80	0.0125000
NODE_4206_length_1166_cov_313.815370	444	524	112	1	80	0.0125000
NODE_4206_length_1166_cov_313.815370	444	524	129	1	80	0.0125000
NODE_4206_length_1166_cov_313.815370	444	524	131	1	80	0.0125000
NODE_4206_length_1166_cov_313.815370	444	524	145	1	80	0.0125000
NODE_4206_length_1166_cov_313.815370	444	524	150	1	80	0.0125000
NODE_4206_length_1166_cov_313.815370	444	524	162	1	80	0.0125000
NODE_4206_length_1166_cov_313.815370	444	524	167	1	80	0.0125000
NODE_4206_length_1166_cov_313.815370	444	524	186	1	80	0.0125000
NODE_4206_length_1166_cov_313.815370	444	524	197	4	80	0.0500000
NODE_4206_length_1166_cov_313.815370	444	524	204	2	80	0.0250000
NODE_4206_length_1166_cov_313.815370	444	524	206	1	80	0.0125000
NODE_4206_length_1166_cov_313.815370	444	524	218	1	80	0.0125000
NODE_4206_length_1166_cov_313.815370	444	524	228	2	80	0.0250000
NODE_4206_length_1166_cov_313.815370	444	524	229	2	80	0.0250000
NODE_4206_length_1166_cov_313.815370	444	524	245	1	80	0.0125000
NODE_4206_length_1166_cov_313.815370	444	524	263	1	80	0.0125000
NODE_4206_length_1166_cov_313.815370	444	524	270	1	80	0.0125000
NODE_4206_length_1166_cov_313.815370	444	524	281	2	80	0.0250000
NODE_4206_length_1166_cov_313.815370	444	524	287	1	80	0.0125000
NODE_4206_length_1166_cov_313.815370	444	524	292	1	80	0.0125000
NODE_4206_length_1166_cov_313.815370	444	524	319	1	80	0.0125000
NODE_4206_length_1166_cov_313.815370	444	524	322	1	80	0.0125000
NODE_4206_length_1166_cov_313.815370	444	524	328	1	80	0.0125000
NODE_4206_length_1166_cov_313.815370	444	524	335	1	80	0.0125000
NODE_4206_length_1166_cov_313.815370	444	524	339	3	80	0.0375000
NODE_4206_length_1166_cov_313.815370	444	524	341	1	80	0.0125000
NODE_4206_length_1166_cov_313.815370	444	524	344	2	80	0.0250000
NODE_4206_length_1166_cov_313.815370	444	524	353	1	80	0.0125000
NODE_4206_length_1166_cov_313.815370	444	524	363	1	80	0.0125000
NODE_4206_length_1166_cov_313.815370	444	524	366	1	80	0.0125000
NODE_4206_length_1166_cov_313.815370	444	524	369	1	80	0.0125000
NODE_4206_length_1166_cov_313.815370	444	524	374	1	80	0.0125000
NODE_4206_length_1166_cov_313.815370	444	524	376	1	80	0.0125000
NODE_4206_length_1166_cov_313.815370	444	524	379	1	80	0.0125000
NODE_4206_length_1166_cov_313.815370	444	524	382	1	80	0.0125000
NODE_4206_length_1166_cov_313.815370	444	524	390	1	80	0.0125000
NODE_4206_length_1166_cov_313.815370	444	524	397	2	80	0.0250000
NODE_4206_length_1166_cov_313.815370	444	524	402	1	80	0.0125000
NODE_4206_length_1166_cov_313.815370	444	524	416	1	80	0.0125000
NODE_4206_length_1166_cov_313.815370	444	524	429	2	80	0.0250000
NODE_4206_length_1166_cov_313.815370	444	524	430	1	80	0.0125000
NODE_4206_length_1166_cov_313.815370	444	524	432	1	80	0.0125000
NODE_4206_length_1166_cov_313.815370	444	524	437	1	80	0.0125000
NODE_4206_length_1166_cov_313.815370	444	524	442	1	80	0.0125000
NODE_4206_length_1166_cov_313.815370	444	524	445	1	80	0.0125000
NODE_4206_length_1166_cov_313.815370	444	524	453	1	80	0.0125000
NODE_4206_length_1166_cov_313.815370	444	524	454	1	80	0.0125000
NODE_4206_length_1166_cov_313.815370	444	524	456	1	80	0.0125000
NODE_4206_length_1166_cov_313.815370	444	524	463	1	80	0.0125000
NODE_4206_length_1166_cov_313.815370	444	524	467	1	80	0.0125000
NODE_4206_length_1166_cov_313.815370	444	524	469	1	80	0.0125000
NODE_4206_length_1166_cov_313.815370	444	524	472	1	80	0.0125000
NODE_4206_length_1166_cov_313.815370	444	524	480	1	80	0.0125000
NODE_4206_length_1166_cov_313.815370	444	524	489	1	80	0.0125000
NODE_4206_length_1166_cov_313.815370	497	577	366	1	80	0.0125000
NODE_4206_length_1166_cov_313.815370	497	577	369	1	80	0.0125000
NODE_4206_length_1166_cov_313.815370	497	577	374	1	80	0.0125000
NODE_4206_length_1166_cov_313.815370	497	577	376	1	80	0.0125000
NODE_4206_length_1166_cov_313.815370	497	577	379	1	80	0.0125000
NODE_4206_length_1166_cov_313.815370	497	577	382	1	80	0.0125000
NODE_4206_length_1166_cov_313.815370	497	577	390	1	80	0.0125000
NODE_4206_length_1166_cov_313.815370	497	577	397	2	80	0.0250000
NODE_4206_length_1166_cov_313.815370	497	577	402	1	80	0.0125000
NODE_4206_length_1166_cov_313.815370	497	577	416	1	80	0.0125000
NODE_4206_length_1166_cov_313.815370	497	577	429	2	80	0.0250000
NODE_4206_length_1166_cov_313.815370	497	577	430	1	80	0.0125000
NODE_4206_length_1166_cov_313.815370	497	577	432	1	80	0.0125000
NODE_4206_length_1166_cov_313.815370	497	577	437	1	80	0.0125000
NODE_4206_length_1166_cov_313.815370	497	577	442	1	80	0.0125000
NODE_4206_length_1166_cov_313.815370	497	577	445	1	80	0.0125000
NODE_4206_length_1166_cov_313.815370	497	577	450	8	80	0.1000000
NODE_4206_length_1166_cov_313.815370	497	577	453	1	80	0.0125000
NODE_4206_length_1166_cov_313.815370	497	577	454	1	80	0.0125000
NODE_4206_length_1166_cov_313.815370	497	577	456	1	80	0.0125000
NODE_4206_length_1166_cov_313.815370	497	577	463	1	80	0.0125000
NODE_4206_length_1166_cov_313.815370	497	577	465	4	80	0.0500000
NODE_4206_length_1166_cov_313.815370	497	577	467	6	80	0.0750000
NODE_4206_length_1166_cov_313.815370	497	577	468	14	80	0.1750000
NODE_4206_length_1166_cov_313.815370	497	577	469	1	80	0.0125000
NODE_4206_length_1166_cov_313.815370	497	577	472	1	80	0.0125000
NODE_4206_length_1166_cov_313.815370	497	577	475	1	80	0.0125000
NODE_4206_length_1166_cov_313.815370	497	577	479	1	80	0.0125000
NODE_4206_length_1166_cov_313.815370	497	577	480	2	80	0.0250000
NODE_4206_length_1166_cov_313.815370	497	577	483	8	80	0.1000000
NODE_4206_length_1166_cov_313.815370	497	577	486	2	80	0.0250000
NODE_4206_length_1166_cov_313.815370	497	577	487	3	80	0.0375000
NODE_4206_length_1166_cov_313.815370	497	577	488	3	80	0.0375000
NODE_4206_length_1166_cov_313.815370	497	577	489	3	80	0.0375000
NODE_4206_length_1166_cov_313.815370	497	577	490	1	80	0.0125000
NODE_4206_length_1166_cov_313.815370	497	577	366	1	80	0.0125000
NODE_4206_length_1166_cov_313.815370	497	577	369	1	80	0.0125000
NODE_4206_length_1166_cov_313.815370	497	577	374	1	80	0.0125000
NODE_4206_length_1166_cov_313.815370	497	577	376	1	80	0.0125000
NODE_4206_length_1166_cov_313.815370	497	577	379	1	80	0.0125000
NODE_4206_length_1166_cov_313.815370	497	577	382	1	80	0.0125000
NODE_4206_length_1166_cov_313.815370	497	577	390	1	80	0.0125000
NODE_4206_length_1166_cov_313.815370	497	577	397	2	80	0.0250000
NODE_4206_length_1166_cov_313.815370	497	577	402	1	80	0.0125000
NODE_4206_length_1166_cov_313.815370	497	577	416	1	80	0.0125000
NODE_4206_length_1166_cov_313.815370	497	577	429	2	80	0.0250000
NODE_4206_length_1166_cov_313.815370	497	577	430	1	80	0.0125000
NODE_4206_length_1166_cov_313.815370	497	577	432	1	80	0.0125000
NODE_4206_length_1166_cov_313.815370	497	577	437	1	80	0.0125000
NODE_4206_length_1166_cov_313.815370	497	577	442	1	80	0.0125000
NODE_4206_length_1166_cov_313.815370	497	577	445	1	80	0.0125000
NODE_4206_length_1166_cov_313.815370	497	577	450	8	80	0.1000000
NODE_4206_length_1166_cov_313.815370	497	577	453	1	80	0.0125000
NODE_4206_length_1166_cov_313.815370	497	577	454	1	80	0.0125000
NODE_4206_length_1166_cov_313.815370	497	577	456	1	80	0.0125000
NODE_4206_length_1166_cov_313.815370	497	577	463	1	80	0.0125000
NODE_4206_length_1166_cov_313.815370	497	577	465	4	80	0.0500000
NODE_4206_length_1166_cov_313.815370	497	577	467	6	80	0.0750000
NODE_4206_length_1166_cov_313.815370	497	577	468	14	80	0.1750000
NODE_4206_length_1166_cov_313.815370	497	577	469	1	80	0.0125000
NODE_4206_length_1166_cov_313.815370	497	577	472	1	80	0.0125000
NODE_4206_length_1166_cov_313.815370	497	577	475	1	80	0.0125000
NODE_4206_length_1166_cov_313.815370	497	577	479	1	80	0.0125000
NODE_4206_length_1166_cov_313.815370	497	577	480	2	80	0.0250000
NODE_4206_length_1166_cov_313.815370	497	577	483	8	80	0.1000000
NODE_4206_length_1166_cov_313.815370	497	577	486	2	80	0.0250000
NODE_4206_length_1166_cov_313.815370	497	577	487	3	80	0.0375000
NODE_4206_length_1166_cov_313.815370	497	577	488	3	80	0.0375000
NODE_4206_length_1166_cov_313.815370	497	577	489	3	80	0.0375000
NODE_4206_length_1166_cov_313.815370	497	577	490	1	80	0.0125000
NODE_4206_length_1166_cov_313.815370	497	577	366	1	80	0.0125000
NODE_4206_length_1166_cov_313.815370	497	577	369	1	80	0.0125000
NODE_4206_length_1166_cov_313.815370	497	577	374	1	80	0.0125000
NODE_4206_length_1166_cov_313.815370	497	577	376	1	80	0.0125000
NODE_4206_length_1166_cov_313.815370	497	577	379	1	80	0.0125000
NODE_4206_length_1166_cov_313.815370	497	577	382	1	80	0.0125000
NODE_4206_length_1166_cov_313.815370	497	577	390	1	80	0.0125000
NODE_4206_length_1166_cov_313.815370	497	577	397	2	80	0.0250000
NODE_4206_length_1166_cov_313.815370	497	577	402	1	80	0.0125000
NODE_4206_length_1166_cov_313.815370	497	577	416	1	80	0.0125000
NODE_4206_length_1166_cov_313.815370	497	577	429	2	80	0.0250000
NODE_4206_length_1166_cov_313.815370	497	577	430	1	80	0.0125000
NODE_4206_length_1166_cov_313.815370	497	577	432	1	80	0.0125000
NODE_4206_length_1166_cov_313.815370	497	577	437	1	80	0.0125000
NODE_4206_length_1166_cov_313.815370	497	577	442	1	80	0.0125000
NODE_4206_length_1166_cov_313.815370	497	577	445	1	80	0.0125000
NODE_4206_length_1166_cov_313.815370	497	577	450	8	80	0.1000000
NODE_4206_length_1166_cov_313.815370	497	577	453	1	80	0.0125000
NODE_4206_length_1166_cov_313.815370	497	577	454	1	80	0.0125000
NODE_4206_length_1166_cov_313.815370	497	577	456	1	80	0.0125000
NODE_4206_length_1166_cov_313.815370	497	577	463	1	80	0.0125000
NODE_4206_length_1166_cov_313.815370	497	577	465	4	80	0.0500000
NODE_4206_length_1166_cov_313.815370	497	577	467	6	80	0.0750000
NODE_4206_length_1166_cov_313.815370	497	577	468	14	80	0.1750000
NODE_4206_length_1166_cov_313.815370	497	577	469	1	80	0.0125000
NODE_4206_length_1166_cov_313.815370	497	577	472	1	80	0.0125000
NODE_4206_length_1166_cov_313.815370	497	577	475	1	80	0.0125000
NODE_4206_length_1166_cov_313.815370	497	577	479	1	80	0.0125000
NODE_4206_length_1166_cov_313.815370	497	577	480	2	80	0.0250000
NODE_4206_length_1166_cov_313.815370	497	577	483	8	80	0.1000000
NODE_4206_length_1166_cov_313.815370	497	577	486	2	80	0.0250000
NODE_4206_length_1166_cov_313.815370	497	577	487	3	80	0.0375000
NODE_4206_length_1166_cov_313.815370	497	577	488	3	80	0.0375000
NODE_4206_length_1166_cov_313.815370	497	577	489	3	80	0.0375000
NODE_4206_length_1166_cov_313.815370	497	577	490	1	80	0.0125000
NODE_4206_length_1166_cov_313.815370	497	577	366	1	80	0.0125000
NODE_4206_length_1166_cov_313.815370	497	577	369	1	80	0.0125000
NODE_4206_length_1166_cov_313.815370	497	577	374	1	80	0.0125000
NODE_4206_length_1166_cov_313.815370	497	577	376	1	80	0.0125000
NODE_4206_length_1166_cov_313.815370	497	577	379	1	80	0.0125000
NODE_4206_length_1166_cov_313.815370	497	577	382	1	80	0.0125000
NODE_4206_length_1166_cov_313.815370	497	577	390	1	80	0.0125000
NODE_4206_length_1166_cov_313.815370	497	577	397	2	80	0.0250000
NODE_4206_length_1166_cov_313.815370	497	577	402	1	80	0.0125000
NODE_4206_length_1166_cov_313.815370	497	577	416	1	80	0.0125000
NODE_4206_length_1166_cov_313.815370	497	577	429	2	80	0.0250000
NODE_4206_length_1166_cov_313.815370	497	577	430	1	80	0.0125000
NODE_4206_length_1166_cov_313.815370	497	577	432	1	80	0.0125000
NODE_4206_length_1166_cov_313.815370	497	577	437	1	80	0.0125000
NODE_4206_length_1166_cov_313.815370	497	577	442	1	80	0.0125000
NODE_4206_length_1166_cov_313.815370	497	577	445	1	80	0.0125000
NODE_4206_length_1166_cov_313.815370	497	577	450	8	80	0.1000000
NODE_4206_length_1166_cov_313.815370	497	577	453	1	80	0.0125000
NODE_4206_length_1166_cov_313.815370	497	577	454	1	80	0.0125000
NODE_4206_length_1166_cov_313.815370	497	577	456	1	80	0.0125000
NODE_4206_length_1166_cov_313.815370	497	577	463	1	80	0.0125000
NODE_4206_length_1166_cov_313.815370	497	577	465	4	80	0.0500000
NODE_4206_length_1166_cov_313.815370	497	577	467	6	80	0.0750000
NODE_4206_length_1166_cov_313.815370	497	577	468	14	80	0.1750000
NODE_4206_length_1166_cov_313.815370	497	577	469	1	80	0.0125000
NODE_4206_length_1166_cov_313.815370	497	577	472	1	80	0.0125000
NODE_4206_length_1166_cov_313.815370	497	577	475	1	80	0.0125000
NODE_4206_length_1166_cov_313.815370	497	577	479	1	80	0.0125000
NODE_4206_length_1166_cov_313.815370	497	577	480	2	80	0.0250000
NODE_4206_length_1166_cov_313.815370	497	577	483	8	80	0.1000000
NODE_4206_length_1166_cov_313.815370	497	577	486	2	80	0.0250000
NODE_4206_length_1166_cov_313.815370	497	577	487	3	80	0.0375000
NODE_4206_length_1166_cov_313.815370	497	577	488	3	80	0.0375000
NODE_4206_length_1166_cov_313.815370	497	577	489	3	80	0.0375000
NODE_4206_length_1166_cov_313.815370	497	577	490	1	80	0.0125000
NODE_4206_length_1166_cov_313.815370	497	577	366	1	80	0.0125000
NODE_4206_length_1166_cov_313.815370	497	577	369	1	80	0.0125000
NODE_4206_length_1166_cov_313.815370	497	577	374	1	80	0.0125000
NODE_4206_length_1166_cov_313.815370	497	577	376	1	80	0.0125000
NODE_4206_length_1166_cov_313.815370	497	577	379	1	80	0.0125000
NODE_4206_length_1166_cov_313.815370	497	577	382	1	80	0.0125000
NODE_4206_length_1166_cov_313.815370	497	577	390	1	80	0.0125000
NODE_4206_length_1166_cov_313.815370	497	577	397	2	80	0.0250000
NODE_4206_length_1166_cov_313.815370	497	577	402	1	80	0.0125000
NODE_4206_length_1166_cov_313.815370	497	577	416	1	80	0.0125000
NODE_4206_length_1166_cov_313.815370	497	577	429	2	80	0.0250000
NODE_4206_length_1166_cov_313.815370	497	577	430	1	80	0.0125000
NODE_4206_length_1166_cov_313.815370	497	577	432	1	80	0.0125000
NODE_4206_length_1166_cov_313.815370	497	577	437	1	80	0.0125000
NODE_4206_length_1166_cov_313.815370	497	577	442	1	80	0.0125000
NODE_4206_length_1166_cov_313.815370	497	577	445	1	80	0.0125000
NODE_4206_length_1166_cov_313.815370	497	577	450	8	80	0.1000000
NODE_4206_length_1166_cov_313.815370	497	577	453	1	80	0.0125000
NODE_4206_length_1166_cov_313.815370	497	577	454	1	80	0.0125000
NODE_4206_length_1166_cov_313.815370	497	577	456	1	80	0.0125000
NODE_4206_length_1166_cov_313.815370	497	577	463	1	80	0.0125000
NODE_4206_length_1166_cov_313.815370	497	577	465	4	80	0.0500000
NODE_4206_length_1166_cov_313.815370	497	577	467	6	80	0.0750000
NODE_4206_length_1166_cov_313.815370	497	577	468	14	80	0.1750000
NODE_4206_length_1166_cov_313.815370	497	577	469	1	80	0.0125000
NODE_4206_length_1166_cov_313.815370	497	577	472	1	80	0.0125000
NODE_4206_length_1166_cov_313.815370	497	577	475	1	80	0.0125000
NODE_4206_length_1166_cov_313.815370	497	577	479	1	80	0.0125000
NODE_4206_length_1166_cov_313.815370	497	577	480	2	80	0.0250000
NODE_4206_length_1166_cov_313.815370	497	577	483	8	80	0.1000000
NODE_4206_length_1166_cov_313.815370	497	577	486	2	80	0.0250000
NODE_4206_length_1166_cov_313.815370	497	577	487	3	80	0.0375000
NODE_4206_length_1166_cov_313.815370	497	577	488	3	80	0.0375000
NODE_4206_length_1166_cov_313.815370	497	577	489	3	80	0.0375000
NODE_4206_length_1166_cov_313.815370	497	577	490	1	80	0.0125000
NODE_4206_length_1166_cov_313.815370	497	577	366	1	80	0.0125000
NODE_4206_length_1166_cov_313.815370	497	577	369	1	80	0.0125000
NODE_4206_length_1166_cov_313.815370	497	577	374	1	80	0.0125000
NODE_4206_length_1166_cov_313.815370	497	577	376	1	80	0.0125000
NODE_4206_length_1166_cov_313.815370	497	577	379	1	80	0.0125000
NODE_4206_length_1166_cov_313.815370	497	577	382	1	80	0.0125000
NODE_4206_length_1166_cov_313.815370	497	577	390	1	80	0.0125000
NODE_4206_length_1166_cov_313.815370	497	577	397	2	80	0.0250000
NODE_4206_length_1166_cov_313.815370	497	577	402	1	80	0.0125000
NODE_4206_length_1166_cov_313.815370	497	577	416	1	80	0.0125000
NODE_4206_length_1166_cov_313.815370	497	577	429	2	80	0.0250000
NODE_4206_length_1166_cov_313.815370	497	577	430	1	80	0.0125000
NODE_4206_length_1166_cov_313.815370	497	577	432	1	80	0.0125000
NODE_4206_length_1166_cov_313.815370	497	577	437	1	80	0.0125000
NODE_4206_length_1166_cov_313.815370	497	577	442	1	80	0.0125000
NODE_4206_length_1166_cov_313.815370	497	577	445	1	80	0.0125000
NODE_4206_length_1166_cov_313.815370	497	577	450	8	80	0.1000000
NODE_4206_length_1166_cov_313.815370	497	577	453	1	80	0.0125000
NODE_4206_length_1166_cov_313.815370	497	577	454	1	80	0.0125000
NODE_4206_length_1166_cov_313.815370	497	577	456	1	80	0.0125000
NODE_4206_length_1166_cov_313.815370	497	577	463	1	80	0.0125000
NODE_4206_length_1166_cov_313.815370	497	577	465	4	80	0.0500000
NODE_4206_length_1166_cov_313.815370	497	577	467	6	80	0.0750000
NODE_4206_length_1166_cov_313.815370	497	577	468	14	80	0.1750000
NODE_4206_length_1166_cov_313.815370	497	577	469	1	80	0.0125000
NODE_4206_length_1166_cov_313.815370	497	577	472	1	80	0.0125000
NODE_4206_length_1166_cov_313.815370	497	577	475	1	80	0.0125000
NODE_4206_length_1166_cov_313.815370	497	577	479	1	80	0.0125000
NODE_4206_length_1166_cov_313.815370	497	577	480	2	80	0.0250000
NODE_4206_length_1166_cov_313.815370	497	577	483	8	80	0.1000000
NODE_4206_length_1166_cov_313.815370	497	577	486	2	80	0.0250000
NODE_4206_length_1166_cov_313.815370	497	577	487	3	80	0.0375000
NODE_4206_length_1166_cov_313.815370	497	577	488	3	80	0.0375000
NODE_4206_length_1166_cov_313.815370	497	577	489	3	80	0.0375000
NODE_4206_length_1166_cov_313.815370	497	577	490	1	80	0.0125000
NODE_4206_length_1166_cov_313.815370	497	568	366	1	71	0.0140845
NODE_4206_length_1166_cov_313.815370	497	568	369	1	71	0.0140845
NODE_4206_length_1166_cov_313.815370	497	568	374	1	71	0.0140845
NODE_4206_length_1166_cov_313.815370	497	568	376	1	71	0.0140845
NODE_4206_length_1166_cov_313.815370	497	568	379	1	71	0.0140845
NODE_4206_length_1166_cov_313.815370	497	568	382	1	71	0.0140845
NODE_4206_length_1166_cov_313.815370	497	568	390	1	71	0.0140845
NODE_4206_length_1166_cov_313.815370	497	568	397	2	71	0.0281690
NODE_4206_length_1166_cov_313.815370	497	568	402	1	71	0.0140845
NODE_4206_length_1166_cov_313.815370	497	568	416	1	71	0.0140845
NODE_4206_length_1166_cov_313.815370	497	568	429	2	71	0.0281690
NODE_4206_length_1166_cov_313.815370	497	568	430	1	71	0.0140845
NODE_4206_length_1166_cov_313.815370	497	568	432	1	71	0.0140845
NODE_4206_length_1166_cov_313.815370	497	568	437	1	71	0.0140845
NODE_4206_length_1166_cov_313.815370	497	568	442	1	71	0.0140845
NODE_4206_length_1166_cov_313.815370	497	568	445	1	71	0.0140845
NODE_4206_length_1166_cov_313.815370	497	568	453	1	71	0.0140845
NODE_4206_length_1166_cov_313.815370	497	568	454	1	71	0.0140845
NODE_4206_length_1166_cov_313.815370	497	568	456	1	71	0.0140845
NODE_4206_length_1166_cov_313.815370	497	568	463	1	71	0.0140845
NODE_4206_length_1166_cov_313.815370	497	568	465	4	71	0.0563380
NODE_4206_length_1166_cov_313.815370	497	568	467	6	71	0.0845070
NODE_4206_length_1166_cov_313.815370	497	568	468	13	71	0.1830986
NODE_4206_length_1166_cov_313.815370	497	568	469	1	71	0.0140845
NODE_4206_length_1166_cov_313.815370	497	568	472	1	71	0.0140845
NODE_4206_length_1166_cov_313.815370	497	568	475	1	71	0.0140845
NODE_4206_length_1166_cov_313.815370	497	568	479	1	71	0.0140845
NODE_4206_length_1166_cov_313.815370	497	568	480	2	71	0.0281690
NODE_4206_length_1166_cov_313.815370	497	568	483	8	71	0.1126761
NODE_4206_length_1166_cov_313.815370	497	568	486	2	71	0.0281690
NODE_4206_length_1166_cov_313.815370	497	568	487	3	71	0.0422535
NODE_4206_length_1166_cov_313.815370	497	568	488	3	71	0.0422535
NODE_4206_length_1166_cov_313.815370	497	568	489	3	71	0.0422535
NODE_4206_length_1166_cov_313.815370	497	568	490	1	71	0.0140845
NODE_4206_length_1166_cov_313.815370	500	570	376	1	70	0.0142857
NODE_4206_length_1166_cov_313.815370	500	570	379	1	70	0.0142857
NODE_4206_length_1166_cov_313.815370	500	570	382	1	70	0.0142857
NODE_4206_length_1166_cov_313.815370	500	570	390	1	70	0.0142857
NODE_4206_length_1166_cov_313.815370	500	570	397	2	70	0.0285714
NODE_4206_length_1166_cov_313.815370	500	570	402	1	70	0.0142857
NODE_4206_length_1166_cov_313.815370	500	570	416	1	70	0.0142857
NODE_4206_length_1166_cov_313.815370	500	570	429	2	70	0.0285714
NODE_4206_length_1166_cov_313.815370	500	570	430	1	70	0.0142857
NODE_4206_length_1166_cov_313.815370	500	570	432	1	70	0.0142857
NODE_4206_length_1166_cov_313.815370	500	570	437	1	70	0.0142857
NODE_4206_length_1166_cov_313.815370	500	570	442	1	70	0.0142857
NODE_4206_length_1166_cov_313.815370	500	570	445	1	70	0.0142857
NODE_4206_length_1166_cov_313.815370	500	570	450	1	70	0.0142857
NODE_4206_length_1166_cov_313.815370	500	570	453	1	70	0.0142857
NODE_4206_length_1166_cov_313.815370	500	570	454	1	70	0.0142857
NODE_4206_length_1166_cov_313.815370	500	570	456	1	70	0.0142857
NODE_4206_length_1166_cov_313.815370	500	570	463	1	70	0.0142857
NODE_4206_length_1166_cov_313.815370	500	570	465	4	70	0.0571429
NODE_4206_length_1166_cov_313.815370	500	570	467	6	70	0.0857143
NODE_4206_length_1166_cov_313.815370	500	570	468	14	70	0.2000000
NODE_4206_length_1166_cov_313.815370	500	570	469	1	70	0.0142857
NODE_4206_length_1166_cov_313.815370	500	570	472	1	70	0.0142857
NODE_4206_length_1166_cov_313.815370	500	570	475	1	70	0.0142857
NODE_4206_length_1166_cov_313.815370	500	570	479	1	70	0.0142857
NODE_4206_length_1166_cov_313.815370	500	570	480	2	70	0.0285714
NODE_4206_length_1166_cov_313.815370	500	570	483	8	70	0.1142857
NODE_4206_length_1166_cov_313.815370	500	570	486	2	70	0.0285714
NODE_4206_length_1166_cov_313.815370	500	570	487	3	70	0.0428571
NODE_4206_length_1166_cov_313.815370	500	570	488	3	70	0.0428571
NODE_4206_length_1166_cov_313.815370	500	570	489	3	70	0.0428571
NODE_4206_length_1166_cov_313.815370	500	570	490	1	70	0.0142857
NODE_4206_length_1166_cov_313.815370	997	1077	0	80	80	1.0000000
NODE_4206_length_1166_cov_313.815370	1050	1130	0	80	80	1.0000000
NODE_4206_length_1166_cov_313.815370	1050	1130	0	80	80	1.0000000
NODE_4206_length_1166_cov_313.815370	1050	1121	0	71	71	1.0000000
NODE_4207_length_1166_cov_25.107779	561	641	0	80	80	1.0000000
NODE_4207_length_1166_cov_25.107779	614	694	0	80	80	1.0000000
NODE_4209_length_1166_cov_18.820056	325	405	2	42	80	0.5250000
NODE_4209_length_1166_cov_18.820056	325	405	4	38	80	0.4750000
NODE_4209_length_1166_cov_18.820056	378	458	0	13	80	0.1625000
NODE_4209_length_1166_cov_18.820056	378	458	2	42	80	0.5250000
NODE_4209_length_1166_cov_18.820056	378	458	4	25	80	0.3125000
NODE_4210_length_1166_cov_18.404873	676	756	0	26	80	0.3250000
NODE_4210_length_1166_cov_18.404873	676	756	2	18	80	0.2250000
NODE_4210_length_1166_cov_18.404873	676	756	4	36	80	0.4500000
NODE_4210_length_1166_cov_18.404873	729	809	2	52	80	0.6500000
NODE_4210_length_1166_cov_18.404873	729	809	4	28	80	0.3500000
NODE_4214_length_1166_cov_1.893158	0	71	0	71	71	1.0000000
NODE_4214_length_1166_cov_1.893158	44	99	0	55	55	1.0000000
NODE_4218_length_1165_cov_29.402439	497	577	0	18	80	0.2250000
NODE_4218_length_1165_cov_29.402439	497	577	6	19	80	0.2375000
NODE_4218_length_1165_cov_29.402439	497	577	8	43	80	0.5375000
NODE_4218_length_1165_cov_29.402439	550	630	0	11	80	0.1375000
NODE_4218_length_1165_cov_29.402439	550	630	2	2	80	0.0250000
NODE_4218_length_1165_cov_29.402439	550	630	5	21	80	0.2625000
NODE_4218_length_1165_cov_29.402439	550	630	6	25	80	0.3125000
NODE_4218_length_1165_cov_29.402439	550	630	8	21	80	0.2625000
NODE_4218_length_1165_cov_29.402439	626	706	0	2	80	0.0250000
NODE_4218_length_1165_cov_29.402439	626	706	2	11	80	0.1375000
NODE_4218_length_1165_cov_29.402439	626	706	7	2	80	0.0250000
NODE_4218_length_1165_cov_29.402439	626	706	9	65	80	0.8125000
NODE_4218_length_1165_cov_29.402439	679	759	9	32	80	0.4000000
NODE_4218_length_1165_cov_29.402439	679	759	10	11	80	0.1375000
NODE_4218_length_1165_cov_29.402439	679	759	11	6	80	0.0750000
NODE_4218_length_1165_cov_29.402439	679	759	12	31	80	0.3875000
NODE_4219_length_1165_cov_28.366792	663	743	6	15	80	0.1875000
NODE_4219_length_1165_cov_28.366792	663	743	8	54	80	0.6750000
NODE_4219_length_1165_cov_28.366792	663	743	10	4	80	0.0500000
NODE_4219_length_1165_cov_28.366792	663	743	11	1	80	0.0125000
NODE_4219_length_1165_cov_28.366792	663	743	12	6	80	0.0750000
NODE_4219_length_1165_cov_28.366792	716	796	2	6	80	0.0750000
NODE_4219_length_1165_cov_28.366792	716	796	6	20	80	0.2500000
NODE_4219_length_1165_cov_28.366792	716	796	8	16	80	0.2000000
NODE_4219_length_1165_cov_28.366792	716	796	9	1	80	0.0125000
NODE_4219_length_1165_cov_28.366792	716	796	10	20	80	0.2500000
NODE_4219_length_1165_cov_28.366792	716	796	11	1	80	0.0125000
NODE_4219_length_1165_cov_28.366792	716	796	12	16	80	0.2000000
NODE_4220_length_1165_cov_23.841463	631	711	0	58	80	0.7250000
NODE_4220_length_1165_cov_23.841463	631	711	2	22	80	0.2750000
NODE_4220_length_1165_cov_23.841463	684	765	0	81	81	1.0000000
NODE_4220_length_1165_cov_23.841463	761	841	0	14	80	0.1750000
NODE_4220_length_1165_cov_23.841463	761	841	2	34	80	0.4250000
NODE_4220_length_1165_cov_23.841463	761	841	4	32	80	0.4000000
NODE_4220_length_1165_cov_23.841463	814	894	2	49	80	0.6125000
NODE_4220_length_1165_cov_23.841463	814	894	4	31	80	0.3875000
NODE_4221_length_1165_cov_21.883677	482	562	0	80	80	1.0000000
NODE_4221_length_1165_cov_21.883677	535	615	0	80	80	1.0000000
NODE_4222_length_1165_cov_14.591932	295	375	0	31	80	0.3875000
NODE_4222_length_1165_cov_14.591932	295	375	2	49	80	0.6125000
NODE_4222_length_1165_cov_14.591932	348	428	0	80	80	1.0000000
NODE_4223_length_1165_cov_13.683865	502	582	0	80	80	1.0000000
NODE_4223_length_1165_cov_13.683865	555	635	0	80	80	1.0000000
NODE_4224_length_1165_cov_7.915572	383	463	0	19	80	0.2375000
NODE_4224_length_1165_cov_7.915572	383	463	2	25	80	0.3125000
NODE_4224_length_1165_cov_7.915572	383	463	4	36	80	0.4500000
NODE_4224_length_1165_cov_7.915572	436	516	2	31	80	0.3875000
NODE_4224_length_1165_cov_7.915572	436	516	4	49	80	0.6125000
NODE_4225_length_1165_cov_7.466229	552	632	0	80	80	1.0000000
NODE_4225_length_1165_cov_7.466229	605	685	0	80	80	1.0000000
NODE_4226_length_1165_cov_5.617261	676	756	0	80	80	1.0000000
NODE_4226_length_1165_cov_5.617261	729	809	0	80	80	1.0000000
NODE_4227_length_1165_cov_3.658537	554	602	0	48	48	1.0000000
NODE_4233_length_1164_cov_55.273239	459	539	0	23	80	0.2875000
NODE_4233_length_1164_cov_55.273239	459	539	2	57	80	0.7125000
NODE_4233_length_1164_cov_55.273239	512	592	0	25	80	0.3125000
NODE_4233_length_1164_cov_55.273239	512	592	2	55	80	0.6875000
NODE_4234_length_1164_cov_44.183099	571	651	0	18	80	0.2250000
NODE_4234_length_1164_cov_44.183099	571	651	2	62	80	0.7750000
NODE_4234_length_1164_cov_44.183099	624	704	0	71	80	0.8875000
NODE_4234_length_1164_cov_44.183099	624	704	2	9	80	0.1125000
NODE_4234_length_1164_cov_44.183099	700	780	0	80	80	1.0000000
NODE_4234_length_1164_cov_44.183099	753	833	0	80	80	1.0000000
NODE_4235_length_1164_cov_14.277934	1029	1109	29	1	80	0.0125000
NODE_4235_length_1164_cov_14.277934	1029	1109	32	1	80	0.0125000
NODE_4235_length_1164_cov_14.277934	1029	1109	35	2	80	0.0250000
NODE_4235_length_1164_cov_14.277934	1029	1109	49	1	80	0.0125000
NODE_4235_length_1164_cov_14.277934	1029	1109	50	15	80	0.1875000
NODE_4235_length_1164_cov_14.277934	1029	1109	52	2	80	0.0250000
NODE_4235_length_1164_cov_14.277934	1029	1109	54	2	80	0.0250000
NODE_4235_length_1164_cov_14.277934	1029	1109	55	4	80	0.0500000
NODE_4235_length_1164_cov_14.277934	1029	1109	56	3	80	0.0375000
NODE_4235_length_1164_cov_14.277934	1029	1109	59	6	80	0.0750000
NODE_4235_length_1164_cov_14.277934	1029	1109	62	16	80	0.2000000
NODE_4235_length_1164_cov_14.277934	1029	1109	63	13	80	0.1625000
NODE_4235_length_1164_cov_14.277934	1029	1109	64	14	80	0.1750000
NODE_4235_length_1164_cov_14.277934	1097	1162	0	23	65	0.3538462
NODE_4235_length_1164_cov_14.277934	1097	1162	2	3	65	0.0461538
NODE_4235_length_1164_cov_14.277934	1097	1162	6	15	65	0.2307692
NODE_4235_length_1164_cov_14.277934	1097	1162	10	4	65	0.0615385
NODE_4235_length_1164_cov_14.277934	1097	1162	14	1	65	0.0153846
NODE_4235_length_1164_cov_14.277934	1097	1162	16	2	65	0.0307692
NODE_4235_length_1164_cov_14.277934	1097	1162	22	3	65	0.0461538
NODE_4235_length_1164_cov_14.277934	1097	1162	28	2	65	0.0307692
NODE_4235_length_1164_cov_14.277934	1097	1162	29	1	65	0.0153846
NODE_4235_length_1164_cov_14.277934	1097	1162	32	1	65	0.0153846
NODE_4235_length_1164_cov_14.277934	1097	1162	35	2	65	0.0307692
NODE_4235_length_1164_cov_14.277934	1097	1162	49	1	65	0.0153846
NODE_4235_length_1164_cov_14.277934	1097	1162	50	7	65	0.1076923
NODE_4236_length_1164_cov_12.880751	415	495	0	21	80	0.2625000
NODE_4236_length_1164_cov_12.880751	415	495	2	41	80	0.5125000
NODE_4236_length_1164_cov_12.880751	415	495	4	18	80	0.2250000
NODE_4236_length_1164_cov_12.880751	468	548	2	9	80	0.1125000
NODE_4236_length_1164_cov_12.880751	468	548	4	68	80	0.8500000
NODE_4236_length_1164_cov_12.880751	468	548	6	3	80	0.0375000
NODE_4237_length_1164_cov_6.924883	415	495	0	58	80	0.7250000
NODE_4237_length_1164_cov_6.924883	415	495	2	22	80	0.2750000
NODE_4237_length_1164_cov_6.924883	468	548	0	43	80	0.5375000
NODE_4237_length_1164_cov_6.924883	468	548	2	37	80	0.4625000
NODE_4245_length_1163_cov_36.315789	458	538	0	76	80	0.9500000
NODE_4245_length_1163_cov_36.315789	458	538	2	4	80	0.0500000
NODE_4245_length_1163_cov_36.315789	511	591	0	28	80	0.3500000
NODE_4245_length_1163_cov_36.315789	511	591	12	52	80	0.6500000
NODE_4245_length_1163_cov_36.315789	587	667	0	11	80	0.1375000
NODE_4245_length_1163_cov_36.315789	587	667	12	69	80	0.8625000
NODE_4245_length_1163_cov_36.315789	640	720	0	64	80	0.8000000
NODE_4245_length_1163_cov_36.315789	640	720	12	16	80	0.2000000
NODE_4246_length_1163_cov_29.466165	542	622	0	80	80	1.0000000
NODE_4246_length_1163_cov_29.466165	595	675	0	80	80	1.0000000
NODE_4246_length_1163_cov_29.466165	671	751	0	80	80	1.0000000
NODE_4246_length_1163_cov_29.466165	724	804	0	80	80	1.0000000
NODE_4247_length_1163_cov_15.107143	668	748	0	6	80	0.0750000
NODE_4247_length_1163_cov_15.107143	668	748	2	74	80	0.9250000
NODE_4247_length_1163_cov_15.107143	721	801	0	36	80	0.4500000
NODE_4247_length_1163_cov_15.107143	721	801	2	44	80	0.5500000
NODE_4248_length_1163_cov_14.347744	540	620	0	80	80	1.0000000
NODE_4248_length_1163_cov_14.347744	593	673	0	80	80	1.0000000
NODE_4249_length_1163_cov_11.650376	354	434	0	80	80	1.0000000
NODE_4249_length_1163_cov_11.650376	407	487	0	80	80	1.0000000
NODE_4249_length_1163_cov_11.650376	738	818	0	34	80	0.4250000
NODE_4249_length_1163_cov_11.650376	738	818	4	46	80	0.5750000
NODE_4249_length_1163_cov_11.650376	791	871	4	80	80	1.0000000
NODE_4253_length_1162_cov_30.049859	359	439	0	80	80	1.0000000
NODE_4253_length_1162_cov_30.049859	412	492	0	80	80	1.0000000
NODE_4254_length_1162_cov_25.960489	440	520	0	80	80	1.0000000
NODE_4254_length_1162_cov_25.960489	493	573	0	80	80	1.0000000
NODE_4254_length_1162_cov_25.960489	569	649	0	80	80	1.0000000
NODE_4254_length_1162_cov_25.960489	622	702	0	80	80	1.0000000
NODE_4255_length_1162_cov_24.843838	523	603	0	51	80	0.6375000
NODE_4255_length_1162_cov_24.843838	523	603	4	3	80	0.0375000
NODE_4255_length_1162_cov_24.843838	523	603	6	26	80	0.3250000
NODE_4255_length_1162_cov_24.843838	576	656	4	1	80	0.0125000
NODE_4255_length_1162_cov_24.843838	576	656	6	79	80	0.9875000
NODE_4255_length_1162_cov_24.843838	652	732	0	61	80	0.7625000
NODE_4255_length_1162_cov_24.843838	652	732	4	6	80	0.0750000
NODE_4255_length_1162_cov_24.843838	652	732	6	13	80	0.1625000
NODE_4255_length_1162_cov_24.843838	705	785	0	80	80	1.0000000
NODE_4257_length_1162_cov_17.131703	302	382	0	51	80	0.6375000
NODE_4257_length_1162_cov_17.131703	302	382	2	29	80	0.3625000
NODE_4257_length_1162_cov_17.131703	355	435	2	80	80	1.0000000
NODE_4257_length_1162_cov_17.131703	431	511	0	64	80	0.8000000
NODE_4257_length_1162_cov_17.131703	431	511	2	16	80	0.2000000
NODE_4257_length_1162_cov_17.131703	484	564	0	80	80	1.0000000
NODE_4258_length_1162_cov_14.766698	630	710	0	11	80	0.1375000
NODE_4258_length_1162_cov_14.766698	630	710	5	53	80	0.6625000
NODE_4258_length_1162_cov_14.766698	630	710	6	16	80	0.2000000
NODE_4258_length_1162_cov_14.766698	683	763	0	19	80	0.2375000
NODE_4258_length_1162_cov_14.766698	683	763	5	12	80	0.1500000
NODE_4258_length_1162_cov_14.766698	683	763	6	49	80	0.6125000
NODE_4259_length_1162_cov_13.968015	423	503	0	80	80	1.0000000
NODE_4259_length_1162_cov_13.968015	476	556	0	80	80	1.0000000
NODE_4264_length_1162_cov_1.977422	855	926	0	71	71	1.0000000
NODE_4264_length_1162_cov_1.977422	908	977	0	69	69	1.0000000
NODE_4264_length_1162_cov_1.977422	908	977	0	69	69	1.0000000
NODE_4266_length_1161_cov_33.312618	456	536	0	80	80	1.0000000
NODE_4266_length_1161_cov_33.312618	509	587	0	78	78	1.0000000
NODE_4267_length_1161_cov_30.466102	594	674	0	80	80	1.0000000
NODE_4267_length_1161_cov_30.466102	647	727	0	80	80	1.0000000
NODE_4268_length_1161_cov_29.628060	426	506	0	55	80	0.6875000
NODE_4268_length_1161_cov_29.628060	426	506	2	13	80	0.1625000
NODE_4268_length_1161_cov_29.628060	426	506	4	12	80	0.1500000
NODE_4268_length_1161_cov_29.628060	479	559	0	2	80	0.0250000
NODE_4268_length_1161_cov_29.628060	479	559	2	13	80	0.1625000
NODE_4268_length_1161_cov_29.628060	479	559	4	27	80	0.3375000
NODE_4268_length_1161_cov_29.628060	479	559	6	38	80	0.4750000
NODE_4268_length_1161_cov_29.628060	603	683	4	14	80	0.1750000
NODE_4268_length_1161_cov_29.628060	603	683	6	66	80	0.8250000
NODE_4268_length_1161_cov_29.628060	656	736	0	11	80	0.1375000
NODE_4268_length_1161_cov_29.628060	656	736	2	38	80	0.4750000
NODE_4268_length_1161_cov_29.628060	656	736	6	31	80	0.3875000
NODE_4269_length_1161_cov_22.923729	492	572	0	80	80	1.0000000
NODE_4269_length_1161_cov_22.923729	545	625	0	80	80	1.0000000
NODE_4269_length_1161_cov_22.923729	621	701	0	61	80	0.7625000
NODE_4269_length_1161_cov_22.923729	621	701	7	1	80	0.0125000
NODE_4269_length_1161_cov_22.923729	621	701	8	18	80	0.2250000
NODE_4269_length_1161_cov_22.923729	674	754	0	8	80	0.1000000
NODE_4269_length_1161_cov_22.923729	674	754	7	1	80	0.0125000
NODE_4269_length_1161_cov_22.923729	674	754	8	71	80	0.8875000
NODE_4270_length_1161_cov_20.184557	480	560	0	68	80	0.8500000
NODE_4270_length_1161_cov_20.184557	480	560	4	12	80	0.1500000
NODE_4270_length_1161_cov_20.184557	533	613	0	15	80	0.1875000
NODE_4270_length_1161_cov_20.184557	533	613	4	65	80	0.8125000
NODE_4271_length_1161_cov_17.437853	375	455	0	80	80	1.0000000
NODE_4271_length_1161_cov_17.437853	428	508	0	80	80	1.0000000
NODE_4272_length_1161_cov_14.062147	375	455	0	73	80	0.9125000
NODE_4272_length_1161_cov_14.062147	375	455	2	7	80	0.0875000
NODE_4272_length_1161_cov_14.062147	428	508	0	20	80	0.2500000
NODE_4272_length_1161_cov_14.062147	428	508	2	8	80	0.1000000
NODE_4272_length_1161_cov_14.062147	428	508	4	52	80	0.6500000
NODE_4273_length_1161_cov_12.304143	381	461	0	5	80	0.0625000
NODE_4273_length_1161_cov_12.304143	381	461	2	50	80	0.6250000
NODE_4273_length_1161_cov_12.304143	381	461	4	25	80	0.3125000
NODE_4273_length_1161_cov_12.304143	434	514	0	11	80	0.1375000
NODE_4273_length_1161_cov_12.304143	434	514	2	21	80	0.2625000
NODE_4273_length_1161_cov_12.304143	434	514	4	48	80	0.6000000
NODE_4274_length_1161_cov_10.297552	598	678	0	80	80	1.0000000
NODE_4274_length_1161_cov_10.297552	651	731	0	80	80	1.0000000
NODE_4283_length_1160_cov_86.515551	613	693	2	80	80	1.0000000
NODE_4283_length_1160_cov_86.515551	666	746	0	11	80	0.1375000
NODE_4283_length_1160_cov_86.515551	666	746	2	69	80	0.8625000
NODE_4284_length_1160_cov_29.272385	526	606	0	20	80	0.2500000
NODE_4284_length_1160_cov_29.272385	526	606	4	34	80	0.4250000
NODE_4284_length_1160_cov_29.272385	526	606	8	26	80	0.3250000
NODE_4284_length_1160_cov_29.272385	579	659	4	2	80	0.0250000
NODE_4284_length_1160_cov_29.272385	579	659	7	1	80	0.0125000
NODE_4284_length_1160_cov_29.272385	579	659	8	77	80	0.9625000
NODE_4285_length_1160_cov_21.391140	767	847	3	4	80	0.0500000
NODE_4285_length_1160_cov_21.391140	767	847	5	43	80	0.5375000
NODE_4285_length_1160_cov_21.391140	767	847	7	33	80	0.4125000
NODE_4296_length_1159_cov_147.794340	911	991	61	7	80	0.0875000
NODE_4296_length_1159_cov_147.794340	911	991	65	5	80	0.0625000
NODE_4296_length_1159_cov_147.794340	911	991	70	1	80	0.0125000
NODE_4296_length_1159_cov_147.794340	911	991	71	6	80	0.0750000
NODE_4296_length_1159_cov_147.794340	911	991	72	4	80	0.0500000
NODE_4296_length_1159_cov_147.794340	911	991	73	2	80	0.0250000
NODE_4296_length_1159_cov_147.794340	911	991	82	1	80	0.0125000
NODE_4296_length_1159_cov_147.794340	911	991	84	2	80	0.0250000
NODE_4296_length_1159_cov_147.794340	911	991	86	1	80	0.0125000
NODE_4296_length_1159_cov_147.794340	911	991	88	3	80	0.0375000
NODE_4296_length_1159_cov_147.794340	911	991	90	1	80	0.0125000
NODE_4296_length_1159_cov_147.794340	911	991	96	2	80	0.0250000
NODE_4296_length_1159_cov_147.794340	911	991	102	1	80	0.0125000
NODE_4296_length_1159_cov_147.794340	911	991	104	1	80	0.0125000
NODE_4296_length_1159_cov_147.794340	911	991	108	2	80	0.0250000
NODE_4296_length_1159_cov_147.794340	911	991	114	1	80	0.0125000
NODE_4296_length_1159_cov_147.794340	911	991	115	1	80	0.0125000
NODE_4296_length_1159_cov_147.794340	911	991	116	1	80	0.0125000
NODE_4296_length_1159_cov_147.794340	911	991	117	2	80	0.0250000
NODE_4296_length_1159_cov_147.794340	911	991	118	1	80	0.0125000
NODE_4296_length_1159_cov_147.794340	911	991	120	4	80	0.0500000
NODE_4296_length_1159_cov_147.794340	911	991	126	2	80	0.0250000
NODE_4296_length_1159_cov_147.794340	911	991	127	2	80	0.0250000
NODE_4296_length_1159_cov_147.794340	911	991	128	1	80	0.0125000
NODE_4296_length_1159_cov_147.794340	911	991	130	2	80	0.0250000
NODE_4296_length_1159_cov_147.794340	911	991	131	3	80	0.0375000
NODE_4296_length_1159_cov_147.794340	911	991	132	2	80	0.0250000
NODE_4296_length_1159_cov_147.794340	911	991	133	1	80	0.0125000
NODE_4296_length_1159_cov_147.794340	911	991	134	1	80	0.0125000
NODE_4296_length_1159_cov_147.794340	911	991	135	13	80	0.1625000
NODE_4296_length_1159_cov_147.794340	911	991	138	4	80	0.0500000
NODE_4296_length_1159_cov_147.794340	964	1044	91	2	80	0.0250000
NODE_4296_length_1159_cov_147.794340	964	1044	93	4	80	0.0500000
NODE_4296_length_1159_cov_147.794340	964	1044	94	1	80	0.0125000
NODE_4296_length_1159_cov_147.794340	964	1044	95	2	80	0.0250000
NODE_4296_length_1159_cov_147.794340	964	1044	99	2	80	0.0250000
NODE_4296_length_1159_cov_147.794340	964	1044	103	1	80	0.0125000
NODE_4296_length_1159_cov_147.794340	964	1044	111	2	80	0.0250000
NODE_4296_length_1159_cov_147.794340	964	1044	113	1	80	0.0125000
NODE_4296_length_1159_cov_147.794340	964	1044	114	1	80	0.0125000
NODE_4296_length_1159_cov_147.794340	964	1044	115	10	80	0.1250000
NODE_4296_length_1159_cov_147.794340	964	1044	117	6	80	0.0750000
NODE_4296_length_1159_cov_147.794340	964	1044	119	4	80	0.0500000
NODE_4296_length_1159_cov_147.794340	964	1044	126	3	80	0.0375000
NODE_4296_length_1159_cov_147.794340	964	1044	128	1	80	0.0125000
NODE_4296_length_1159_cov_147.794340	964	1044	130	3	80	0.0375000
NODE_4296_length_1159_cov_147.794340	964	1044	131	3	80	0.0375000
NODE_4296_length_1159_cov_147.794340	964	1044	132	6	80	0.0750000
NODE_4296_length_1159_cov_147.794340	964	1044	133	1	80	0.0125000
NODE_4296_length_1159_cov_147.794340	964	1044	134	6	80	0.0750000
NODE_4296_length_1159_cov_147.794340	964	1044	135	13	80	0.1625000
NODE_4296_length_1159_cov_147.794340	964	1044	138	7	80	0.0875000
NODE_4296_length_1159_cov_147.794340	964	1044	140	1	80	0.0125000
NODE_4297_length_1159_cov_57.566981	457	537	0	9	80	0.1125000
NODE_4297_length_1159_cov_57.566981	457	537	2	19	80	0.2375000
NODE_4297_length_1159_cov_57.566981	457	537	4	52	80	0.6500000
NODE_4297_length_1159_cov_57.566981	510	590	0	18	80	0.2250000
NODE_4297_length_1159_cov_57.566981	510	590	2	5	80	0.0625000
NODE_4297_length_1159_cov_57.566981	510	590	4	57	80	0.7125000
NODE_4297_length_1159_cov_57.566981	586	666	0	80	80	1.0000000
NODE_4297_length_1159_cov_57.566981	639	719	0	79	80	0.9875000
NODE_4297_length_1159_cov_57.566981	639	719	2	1	80	0.0125000
NODE_4298_length_1159_cov_44.053774	329	409	0	22	80	0.2750000
NODE_4298_length_1159_cov_44.053774	329	409	2	58	80	0.7250000
NODE_4298_length_1159_cov_44.053774	382	462	2	66	80	0.8250000
NODE_4298_length_1159_cov_44.053774	382	462	4	14	80	0.1750000
NODE_4298_length_1159_cov_44.053774	458	538	2	9	80	0.1125000
NODE_4298_length_1159_cov_44.053774	458	538	4	16	80	0.2000000
NODE_4298_length_1159_cov_44.053774	458	538	6	55	80	0.6875000
NODE_4298_length_1159_cov_44.053774	511	591	2	14	80	0.1750000
NODE_4298_length_1159_cov_44.053774	511	591	4	6	80	0.0750000
NODE_4298_length_1159_cov_44.053774	511	591	6	60	80	0.7500000
NODE_4299_length_1159_cov_40.194340	391	471	2	10	80	0.1250000
NODE_4299_length_1159_cov_40.194340	391	471	9	2	80	0.0250000
NODE_4299_length_1159_cov_40.194340	391	471	10	36	80	0.4500000
NODE_4299_length_1159_cov_40.194340	391	471	11	24	80	0.3000000
NODE_4299_length_1159_cov_40.194340	391	471	12	8	80	0.1000000
NODE_4299_length_1159_cov_40.194340	444	524	9	2	80	0.0250000
NODE_4299_length_1159_cov_40.194340	444	524	10	1	80	0.0125000
NODE_4299_length_1159_cov_40.194340	444	524	11	39	80	0.4875000
NODE_4299_length_1159_cov_40.194340	444	524	13	38	80	0.4750000
NODE_4301_length_1159_cov_25.919811	456	536	0	80	80	1.0000000
NODE_4301_length_1159_cov_25.919811	509	591	0	73	82	0.8902439
NODE_4301_length_1159_cov_25.919811	509	591	4	9	82	0.1097561
NODE_4302_length_1159_cov_18.306604	538	618	0	14	80	0.1750000
NODE_4302_length_1159_cov_18.306604	538	618	2	4	80	0.0500000
NODE_4302_length_1159_cov_18.306604	538	618	4	62	80	0.7750000
NODE_4302_length_1159_cov_18.306604	591	671	0	4	80	0.0500000
NODE_4302_length_1159_cov_18.306604	591	671	2	24	80	0.3000000
NODE_4302_length_1159_cov_18.306604	591	671	4	52	80	0.6500000
NODE_4303_length_1159_cov_14.457547	358	438	0	59	80	0.7375000
NODE_4303_length_1159_cov_14.457547	358	438	2	21	80	0.2625000
NODE_4303_length_1159_cov_14.457547	411	491	0	6	80	0.0750000
NODE_4303_length_1159_cov_14.457547	411	491	2	74	80	0.9250000
NODE_4304_length_1159_cov_11.566981	625	705	0	32	80	0.4000000
NODE_4304_length_1159_cov_11.566981	625	705	2	48	80	0.6000000
NODE_4304_length_1159_cov_11.566981	678	758	0	38	80	0.4750000
NODE_4304_length_1159_cov_11.566981	678	758	2	42	80	0.5250000
NODE_4305_length_1159_cov_9.927358	278	358	0	80	80	1.0000000
NODE_4305_length_1159_cov_9.927358	331	411	0	80	80	1.0000000
NODE_4314_length_1159_cov_1.568868	513	562	0	49	49	1.0000000
NODE_4316_length_1158_cov_33.529745	357	437	0	80	80	1.0000000
NODE_4316_length_1158_cov_33.529745	410	490	0	80	80	1.0000000
NODE_4316_length_1158_cov_33.529745	486	566	0	33	80	0.4125000
NODE_4316_length_1158_cov_33.529745	486	566	5	47	80	0.5875000
NODE_4316_length_1158_cov_33.529745	539	619	5	33	80	0.4125000
NODE_4316_length_1158_cov_33.529745	539	619	6	47	80	0.5875000
NODE_4317_length_1158_cov_31.368272	416	496	0	80	80	1.0000000
NODE_4317_length_1158_cov_31.368272	469	549	0	80	80	1.0000000
NODE_4317_length_1158_cov_31.368272	545	626	0	81	81	1.0000000
NODE_4317_length_1158_cov_31.368272	599	679	0	80	80	1.0000000
NODE_4318_length_1158_cov_31.240793	430	510	0	38	80	0.4750000
NODE_4318_length_1158_cov_31.240793	430	510	4	42	80	0.5250000
NODE_4318_length_1158_cov_31.240793	483	563	4	80	80	1.0000000
NODE_4318_length_1158_cov_31.240793	559	639	4	53	80	0.6625000
NODE_4318_length_1158_cov_31.240793	559	639	8	27	80	0.3375000
NODE_4318_length_1158_cov_31.240793	612	692	0	51	80	0.6375000
NODE_4318_length_1158_cov_31.240793	612	692	4	29	80	0.3625000
NODE_4319_length_1158_cov_29.216242	405	485	4	15	80	0.1875000
NODE_4319_length_1158_cov_29.216242	405	485	6	9	80	0.1125000
NODE_4319_length_1158_cov_29.216242	405	485	10	56	80	0.7000000
NODE_4319_length_1158_cov_29.216242	458	538	0	1	80	0.0125000
NODE_4319_length_1158_cov_29.216242	458	538	3	33	80	0.4125000
NODE_4319_length_1158_cov_29.216242	458	538	6	22	80	0.2750000
NODE_4319_length_1158_cov_29.216242	458	538	10	24	80	0.3000000
NODE_4320_length_1158_cov_25.245515	500	580	0	80	80	1.0000000
NODE_4320_length_1158_cov_25.245515	553	633	0	47	80	0.5875000
NODE_4320_length_1158_cov_25.245515	553	633	2	33	80	0.4125000
NODE_4320_length_1158_cov_25.245515	629	709	0	29	80	0.3625000
NODE_4320_length_1158_cov_25.245515	629	709	2	51	80	0.6375000
NODE_4320_length_1158_cov_25.245515	682	762	0	80	80	1.0000000
NODE_4321_length_1158_cov_16.566572	396	476	0	34	80	0.4250000
NODE_4321_length_1158_cov_16.566572	396	476	2	22	80	0.2750000
NODE_4321_length_1158_cov_16.566572	396	476	4	24	80	0.3000000
NODE_4321_length_1158_cov_16.566572	449	529	2	10	80	0.1250000
NODE_4321_length_1158_cov_16.566572	449	529	4	70	80	0.8750000
NODE_4322_length_1158_cov_13.092540	372	452	0	80	80	1.0000000
NODE_4322_length_1158_cov_13.092540	425	505	0	80	80	1.0000000
NODE_4322_length_1158_cov_13.092540	735	815	0	12	80	0.1500000
NODE_4322_length_1158_cov_13.092540	735	815	2	68	80	0.8500000
NODE_4322_length_1158_cov_13.092540	788	868	0	65	80	0.8125000
NODE_4322_length_1158_cov_13.092540	788	868	2	15	80	0.1875000
NODE_4323_length_1158_cov_7.408876	656	736	0	27	80	0.3375000
NODE_4323_length_1158_cov_7.408876	656	736	2	53	80	0.6625000
NODE_4323_length_1158_cov_7.408876	709	789	0	10	80	0.1250000
NODE_4323_length_1158_cov_7.408876	709	789	2	70	80	0.8750000
NODE_4324_length_1158_cov_6.242682	239	310	0	71	71	1.0000000
NODE_4325_length_1158_cov_6.043437	531	611	2	23	80	0.2875000
NODE_4325_length_1158_cov_6.043437	531	611	4	16	80	0.2000000
NODE_4325_length_1158_cov_6.043437	531	611	6	41	80	0.5125000
NODE_4325_length_1158_cov_6.043437	584	634	0	8	50	0.1600000
NODE_4325_length_1158_cov_6.043437	584	634	2	38	50	0.7600000
NODE_4325_length_1158_cov_6.043437	584	634	6	4	50	0.0800000
NODE_4326_length_1158_cov_5.855524	324	404	0	80	80	1.0000000
NODE_4326_length_1158_cov_5.855524	377	457	0	80	80	1.0000000
NODE_4329_length_1157_cov_32.233459	472	552	0	19	80	0.2375000
NODE_4329_length_1157_cov_32.233459	472	552	2	61	80	0.7625000
NODE_4329_length_1157_cov_32.233459	525	605	0	9	80	0.1125000
NODE_4329_length_1157_cov_32.233459	525	605	2	71	80	0.8875000
NODE_4329_length_1157_cov_32.233459	601	681	0	20	80	0.2500000
NODE_4329_length_1157_cov_32.233459	601	681	2	60	80	0.7500000
NODE_4329_length_1157_cov_32.233459	654	734	0	5	80	0.0625000
NODE_4329_length_1157_cov_32.233459	654	734	2	75	80	0.9375000
NODE_4330_length_1157_cov_6.438563	765	788	4	5	23	0.2173913
NODE_4330_length_1157_cov_6.438563	765	788	6	18	23	0.7826087
NODE_4332_length_1157_cov_4.068053	221	292	0	71	71	1.0000000
NODE_4333_length_1156_cov_46.381268	328	408	0	29	80	0.3625000
NODE_4333_length_1156_cov_46.381268	328	408	2	51	80	0.6375000
NODE_4333_length_1156_cov_46.381268	381	461	0	80	80	1.0000000
NODE_4333_length_1156_cov_46.381268	457	537	0	50	80	0.6250000
NODE_4333_length_1156_cov_46.381268	457	537	4	12	80	0.1500000
NODE_4333_length_1156_cov_46.381268	457	537	6	14	80	0.1750000
NODE_4333_length_1156_cov_46.381268	457	537	8	4	80	0.0500000
NODE_4333_length_1156_cov_46.381268	510	590	4	9	80	0.1125000
NODE_4333_length_1156_cov_46.381268	510	590	6	14	80	0.1750000
NODE_4333_length_1156_cov_46.381268	510	590	8	57	80	0.7125000
NODE_4334_length_1156_cov_32.198675	378	458	0	80	80	1.0000000
NODE_4334_length_1156_cov_32.198675	431	511	0	47	80	0.5875000
NODE_4334_length_1156_cov_32.198675	431	511	7	1	80	0.0125000
NODE_4334_length_1156_cov_32.198675	431	511	8	32	80	0.4000000
NODE_4334_length_1156_cov_32.198675	507	587	0	2	80	0.0250000
NODE_4334_length_1156_cov_32.198675	507	587	8	78	80	0.9750000
NODE_4334_length_1156_cov_32.198675	560	641	0	56	81	0.6913580
NODE_4334_length_1156_cov_32.198675	560	641	8	25	81	0.3086420
NODE_4335_length_1156_cov_12.683065	593	673	0	35	80	0.4375000
NODE_4335_length_1156_cov_12.683065	593	673	2	45	80	0.5625000
NODE_4335_length_1156_cov_12.683065	646	726	0	26	80	0.3250000
NODE_4335_length_1156_cov_12.683065	646	726	2	54	80	0.6750000
NODE_4336_length_1156_cov_9.287606	680	760	0	40	80	0.5000000
NODE_4336_length_1156_cov_9.287606	680	760	1	10	80	0.1250000
NODE_4336_length_1156_cov_9.287606	680	760	2	30	80	0.3750000
NODE_4336_length_1156_cov_9.287606	733	813	2	80	80	1.0000000
NODE_4339_length_1155_cov_19.570076	437	517	0	30	80	0.3750000
NODE_4339_length_1155_cov_19.570076	437	517	5	1	80	0.0125000
NODE_4339_length_1155_cov_19.570076	437	517	6	13	80	0.1625000
NODE_4339_length_1155_cov_19.570076	437	517	8	36	80	0.4500000
NODE_4339_length_1155_cov_19.570076	490	570	8	66	80	0.8250000
NODE_4339_length_1155_cov_19.570076	490	570	10	1	80	0.0125000
NODE_4339_length_1155_cov_19.570076	490	570	12	5	80	0.0625000
NODE_4339_length_1155_cov_19.570076	490	570	14	8	80	0.1000000
NODE_4340_length_1155_cov_18.666667	332	412	0	7	80	0.0875000
NODE_4340_length_1155_cov_18.666667	332	412	2	73	80	0.9125000
NODE_4340_length_1155_cov_18.666667	385	465	0	6	80	0.0750000
NODE_4340_length_1155_cov_18.666667	385	465	2	74	80	0.9250000
NODE_4346_length_1154_cov_61.769668	488	568	8	67	80	0.8375000
NODE_4346_length_1154_cov_61.769668	488	568	12	13	80	0.1625000
NODE_4346_length_1154_cov_61.769668	541	621	2	1	80	0.0125000
NODE_4346_length_1154_cov_61.769668	541	621	4	38	80	0.4750000
NODE_4346_length_1154_cov_61.769668	541	621	8	14	80	0.1750000
NODE_4346_length_1154_cov_61.769668	541	621	12	27	80	0.3375000
NODE_4347_length_1154_cov_50.909005	409	489	0	80	80	1.0000000
NODE_4347_length_1154_cov_50.909005	462	542	0	80	80	1.0000000
NODE_4347_length_1154_cov_50.909005	538	618	0	7	80	0.0875000
NODE_4347_length_1154_cov_50.909005	538	618	2	73	80	0.9125000
NODE_4347_length_1154_cov_50.909005	591	671	2	80	80	1.0000000
NODE_4348_length_1154_cov_28.941232	695	775	0	57	80	0.7125000
NODE_4348_length_1154_cov_28.941232	695	775	5	23	80	0.2875000
NODE_4348_length_1154_cov_28.941232	748	828	0	80	80	1.0000000
NODE_4349_length_1154_cov_13.765877	322	402	0	9	80	0.1125000
NODE_4349_length_1154_cov_13.765877	322	402	2	71	80	0.8875000
NODE_4349_length_1154_cov_13.765877	375	455	0	62	80	0.7750000
NODE_4349_length_1154_cov_13.765877	375	455	2	18	80	0.2250000
NODE_4351_length_1154_cov_5.930806	497	577	0	80	80	1.0000000
NODE_4351_length_1154_cov_5.930806	550	622	0	72	72	1.0000000
NODE_4357_length_1153_cov_65.486717	416	496	0	16	80	0.2000000
NODE_4357_length_1153_cov_65.486717	416	496	8	24	80	0.3000000
NODE_4357_length_1153_cov_65.486717	416	496	12	40	80	0.5000000
NODE_4357_length_1153_cov_65.486717	469	549	12	57	80	0.7125000
NODE_4357_length_1153_cov_65.486717	469	549	16	18	80	0.2250000
NODE_4357_length_1153_cov_65.486717	469	549	18	5	80	0.0625000
NODE_4357_length_1153_cov_65.486717	545	625	6	72	80	0.9000000
NODE_4357_length_1153_cov_65.486717	545	625	10	2	80	0.0250000
NODE_4357_length_1153_cov_65.486717	545	625	18	6	80	0.0750000
NODE_4357_length_1153_cov_65.486717	598	678	0	4	80	0.0500000
NODE_4357_length_1153_cov_65.486717	598	678	2	29	80	0.3625000
NODE_4357_length_1153_cov_65.486717	598	678	6	47	80	0.5875000
NODE_4358_length_1153_cov_50.733397	404	484	0	80	80	1.0000000
NODE_4358_length_1153_cov_50.733397	457	537	0	80	80	1.0000000
NODE_4358_length_1153_cov_50.733397	533	613	0	80	80	1.0000000
NODE_4358_length_1153_cov_50.733397	586	666	0	80	80	1.0000000
NODE_4359_length_1153_cov_26.131879	493	573	0	80	80	1.0000000
NODE_4359_length_1153_cov_26.131879	546	626	0	80	80	1.0000000
NODE_4360_length_1153_cov_10.195446	500	580	0	1	80	0.0125000
NODE_4360_length_1153_cov_10.195446	500	580	4	10	80	0.1250000
NODE_4360_length_1153_cov_10.195446	500	580	6	69	80	0.8625000
NODE_4360_length_1153_cov_10.195446	553	633	0	54	80	0.6750000
NODE_4360_length_1153_cov_10.195446	553	633	4	10	80	0.1250000
NODE_4360_length_1153_cov_10.195446	553	633	6	16	80	0.2000000
NODE_4361_length_1153_cov_8.286528	558	638	0	44	80	0.5500000
NODE_4361_length_1153_cov_8.286528	558	638	2	36	80	0.4500000
NODE_4361_length_1153_cov_8.286528	611	691	2	80	80	1.0000000
NODE_4368_length_1152_cov_19.800570	553	633	0	11	80	0.1375000
NODE_4368_length_1152_cov_19.800570	553	633	2	69	80	0.8625000
NODE_4368_length_1152_cov_19.800570	606	686	0	35	80	0.4375000
NODE_4368_length_1152_cov_19.800570	606	686	2	45	80	0.5625000
NODE_4369_length_1152_cov_19.365622	490	570	2	39	80	0.4875000
NODE_4369_length_1152_cov_19.365622	490	570	4	41	80	0.5125000
NODE_4369_length_1152_cov_19.365622	543	623	0	17	80	0.2125000
NODE_4369_length_1152_cov_19.365622	543	623	2	63	80	0.7875000
NODE_4370_length_1152_cov_18.654321	594	674	0	22	80	0.2750000
NODE_4370_length_1152_cov_18.654321	594	674	2	58	80	0.7250000
NODE_4370_length_1152_cov_18.654321	647	727	0	48	80	0.6000000
NODE_4370_length_1152_cov_18.654321	647	727	2	32	80	0.4000000
NODE_4371_length_1152_cov_18.075024	377	457	8	18	80	0.2250000
NODE_4371_length_1152_cov_18.075024	377	457	12	5	80	0.0625000
NODE_4371_length_1152_cov_18.075024	377	457	14	14	80	0.1750000
NODE_4371_length_1152_cov_18.075024	377	457	16	1	80	0.0125000
NODE_4371_length_1152_cov_18.075024	377	457	18	6	80	0.0750000
NODE_4371_length_1152_cov_18.075024	377	457	22	36	80	0.4500000
NODE_4371_length_1152_cov_18.075024	430	510	4	8	80	0.1000000
NODE_4371_length_1152_cov_18.075024	430	510	6	13	80	0.1625000
NODE_4371_length_1152_cov_18.075024	430	510	8	10	80	0.1250000
NODE_4371_length_1152_cov_18.075024	430	510	16	1	80	0.0125000
NODE_4371_length_1152_cov_18.075024	430	510	18	13	80	0.1625000
NODE_4371_length_1152_cov_18.075024	430	510	22	35	80	0.4375000
NODE_4371_length_1152_cov_18.075024	506	586	0	46	80	0.5750000
NODE_4371_length_1152_cov_18.075024	506	586	2	19	80	0.2375000
NODE_4371_length_1152_cov_18.075024	506	586	4	15	80	0.1875000
NODE_4371_length_1152_cov_18.075024	559	639	0	80	80	1.0000000
NODE_4373_length_1152_cov_16.047483	543	623	0	80	80	1.0000000
NODE_4373_length_1152_cov_16.047483	596	676	0	80	80	1.0000000
NODE_4373_length_1152_cov_16.047483	672	752	0	8	80	0.1000000
NODE_4373_length_1152_cov_16.047483	672	752	2	69	80	0.8625000
NODE_4373_length_1152_cov_16.047483	672	752	4	3	80	0.0375000
NODE_4373_length_1152_cov_16.047483	725	805	2	34	80	0.4250000
NODE_4373_length_1152_cov_16.047483	725	805	4	46	80	0.5750000
NODE_4374_length_1152_cov_13.981007	583	663	0	23	80	0.2875000
NODE_4374_length_1152_cov_13.981007	583	663	2	57	80	0.7125000
NODE_4374_length_1152_cov_13.981007	636	716	0	76	80	0.9500000
NODE_4374_length_1152_cov_13.981007	636	716	2	4	80	0.0500000
NODE_4380_length_1151_cov_30.469582	479	559	0	61	80	0.7625000
NODE_4380_length_1151_cov_30.469582	479	559	1	11	80	0.1375000
NODE_4380_length_1151_cov_30.469582	479	559	2	8	80	0.1000000
NODE_4380_length_1151_cov_30.469582	532	612	0	80	80	1.0000000
NODE_4381_length_1151_cov_26.650190	567	647	0	29	80	0.3625000
NODE_4381_length_1151_cov_26.650190	567	647	1	37	80	0.4625000
NODE_4381_length_1151_cov_26.650190	567	647	5	14	80	0.1750000
NODE_4381_length_1151_cov_26.650190	620	700	1	13	80	0.1625000
NODE_4381_length_1151_cov_26.650190	620	700	5	46	80	0.5750000
NODE_4381_length_1151_cov_26.650190	620	700	6	21	80	0.2625000
NODE_4382_length_1151_cov_26.375475	441	521	0	15	80	0.1875000
NODE_4382_length_1151_cov_26.375475	441	521	2	65	80	0.8125000
NODE_4382_length_1151_cov_26.375475	494	574	0	68	80	0.8500000
NODE_4382_length_1151_cov_26.375475	494	574	2	12	80	0.1500000
NODE_4382_length_1151_cov_26.375475	570	650	0	80	80	1.0000000
NODE_4382_length_1151_cov_26.375475	623	703	0	80	80	1.0000000
NODE_4383_length_1151_cov_23.614068	590	670	2	80	80	1.0000000
NODE_4383_length_1151_cov_23.614068	643	721	1	18	78	0.2307692
NODE_4383_length_1151_cov_23.614068	643	721	2	60	78	0.7692308
NODE_4384_length_1151_cov_18.693916	355	435	0	80	80	1.0000000
NODE_4384_length_1151_cov_18.693916	408	491	0	83	83	1.0000000
NODE_4385_length_1151_cov_16.093156	474	554	0	80	80	1.0000000
NODE_4385_length_1151_cov_16.093156	527	607	0	80	80	1.0000000
NODE_4386_length_1151_cov_13.782319	400	482	0	22	82	0.2682927
NODE_4386_length_1151_cov_13.782319	400	482	2	60	82	0.7317073
NODE_4386_length_1151_cov_13.782319	450	535	0	75	85	0.8823529
NODE_4386_length_1151_cov_13.782319	450	535	2	10	85	0.1176471
NODE_4392_length_1150_cov_38.601332	563	643	0	12	80	0.1500000
NODE_4392_length_1150_cov_38.601332	563	643	2	68	80	0.8500000
NODE_4392_length_1150_cov_38.601332	616	696	0	59	80	0.7375000
NODE_4392_length_1150_cov_38.601332	616	696	2	21	80	0.2625000
NODE_4392_length_1150_cov_38.601332	692	772	0	80	80	1.0000000
NODE_4392_length_1150_cov_38.601332	745	825	0	80	80	1.0000000
NODE_4393_length_1150_cov_15.741199	497	578	0	51	81	0.6296296
NODE_4393_length_1150_cov_15.741199	497	578	6	19	81	0.2345679
NODE_4393_length_1150_cov_15.741199	497	578	12	11	81	0.1358025
NODE_4393_length_1150_cov_15.741199	550	631	6	17	81	0.2098765
NODE_4393_length_1150_cov_15.741199	550	631	12	64	81	0.7901235
NODE_4394_length_1150_cov_11.132255	795	875	0	80	80	1.0000000
NODE_4394_length_1150_cov_11.132255	848	928	0	80	80	1.0000000
NODE_4395_length_1150_cov_9.253092	583	663	0	80	80	1.0000000
NODE_4395_length_1150_cov_9.253092	636	716	0	80	80	1.0000000
NODE_4398_length_1149_cov_17.289524	644	695	0	7	51	0.1372549
NODE_4398_length_1149_cov_17.289524	644	695	2	44	51	0.8627451
NODE_4399_length_1149_cov_13.805714	584	664	0	80	80	1.0000000
NODE_4399_length_1149_cov_13.805714	637	717	0	64	80	0.8000000
NODE_4399_length_1149_cov_13.805714	637	717	1	16	80	0.2000000
NODE_4399_length_1149_cov_13.805714	713	793	1	15	80	0.1875000
NODE_4399_length_1149_cov_13.805714	713	793	2	65	80	0.8125000
NODE_4399_length_1149_cov_13.805714	766	846	2	80	80	1.0000000
NODE_4407_length_1148_cov_27.674929	387	467	0	16	80	0.2000000
NODE_4407_length_1148_cov_27.674929	387	467	2	21	80	0.2625000
NODE_4407_length_1148_cov_27.674929	387	467	4	43	80	0.5375000
NODE_4407_length_1148_cov_27.674929	440	520	0	7	80	0.0875000
NODE_4407_length_1148_cov_27.674929	440	520	4	73	80	0.9125000
NODE_4408_length_1148_cov_13.275500	136	216	9	26	80	0.3250000
NODE_4408_length_1148_cov_13.275500	136	216	10	2	80	0.0250000
NODE_4408_length_1148_cov_13.275500	136	216	11	11	80	0.1375000
NODE_4408_length_1148_cov_13.275500	136	216	12	1	80	0.0125000
NODE_4408_length_1148_cov_13.275500	136	216	13	38	80	0.4750000
NODE_4408_length_1148_cov_13.275500	136	216	15	2	80	0.0250000
NODE_4408_length_1148_cov_13.275500	189	268	8	3	79	0.0379747
NODE_4408_length_1148_cov_13.275500	189	268	9	8	79	0.1012658
NODE_4408_length_1148_cov_13.275500	189	268	10	48	79	0.6075949
NODE_4408_length_1148_cov_13.275500	189	268	11	4	79	0.0506329
NODE_4408_length_1148_cov_13.275500	189	268	12	3	79	0.0379747
NODE_4408_length_1148_cov_13.275500	189	268	13	11	79	0.1392405
NODE_4408_length_1148_cov_13.275500	189	268	15	2	79	0.0253165
NODE_4409_length_1148_cov_10.613918	506	586	0	8	80	0.1000000
NODE_4409_length_1148_cov_10.613918	506	586	6	65	80	0.8125000
NODE_4409_length_1148_cov_10.613918	506	586	8	7	80	0.0875000
NODE_4409_length_1148_cov_10.613918	559	639	2	16	80	0.2000000
NODE_4409_length_1148_cov_10.613918	559	639	6	20	80	0.2500000
NODE_4409_length_1148_cov_10.613918	559	639	8	44	80	0.5500000
NODE_4415_length_1147_cov_33.543893	378	458	0	58	80	0.7250000
NODE_4415_length_1147_cov_33.543893	378	458	4	22	80	0.2750000
NODE_4415_length_1147_cov_33.543893	431	511	0	5	80	0.0625000
NODE_4415_length_1147_cov_33.543893	431	511	4	75	80	0.9375000
NODE_4416_length_1147_cov_26.858779	254	334	0	80	80	1.0000000
NODE_4416_length_1147_cov_26.858779	307	387	0	80	80	1.0000000
NODE_4416_length_1147_cov_26.858779	383	463	0	48	80	0.6000000
NODE_4416_length_1147_cov_26.858779	383	463	2	2	80	0.0250000
NODE_4416_length_1147_cov_26.858779	383	463	4	30	80	0.3750000
NODE_4416_length_1147_cov_26.858779	436	516	4	80	80	1.0000000
NODE_4417_length_1147_cov_24.227099	606	686	2	80	80	1.0000000
NODE_4417_length_1147_cov_24.227099	659	739	0	36	80	0.4500000
NODE_4417_length_1147_cov_24.227099	659	739	2	44	80	0.5500000
NODE_4417_length_1147_cov_24.227099	735	815	0	80	80	1.0000000
NODE_4417_length_1147_cov_24.227099	788	868	0	80	80	1.0000000
NODE_4418_length_1147_cov_16.559160	417	497	0	80	80	1.0000000
NODE_4418_length_1147_cov_16.559160	470	550	0	80	80	1.0000000
NODE_4428_length_1146_cov_52.393505	411	491	0	44	80	0.5500000
NODE_4428_length_1146_cov_52.393505	411	491	2	36	80	0.4500000
NODE_4428_length_1146_cov_52.393505	464	544	2	54	80	0.6750000
NODE_4428_length_1146_cov_52.393505	464	544	4	26	80	0.3250000
NODE_4428_length_1146_cov_52.393505	540	620	2	48	80	0.6000000
NODE_4428_length_1146_cov_52.393505	540	620	4	32	80	0.4000000
NODE_4428_length_1146_cov_52.393505	593	673	2	37	80	0.4625000
NODE_4428_length_1146_cov_52.393505	593	673	4	43	80	0.5375000
NODE_4429_length_1146_cov_46.364852	233	313	34	42	80	0.5250000
NODE_4429_length_1146_cov_46.364852	233	313	38	26	80	0.3250000
NODE_4429_length_1146_cov_46.364852	233	313	40	12	80	0.1500000
NODE_4429_length_1146_cov_46.364852	286	366	23	2	80	0.0250000
NODE_4429_length_1146_cov_46.364852	286	366	38	15	80	0.1875000
NODE_4429_length_1146_cov_46.364852	286	366	40	60	80	0.7500000
NODE_4429_length_1146_cov_46.364852	286	366	42	3	80	0.0375000
NODE_4430_length_1146_cov_26.159503	476	556	0	80	80	1.0000000
NODE_4430_length_1146_cov_26.159503	529	609	0	80	80	1.0000000
NODE_4430_length_1146_cov_26.159503	605	685	0	39	80	0.4875000
NODE_4430_length_1146_cov_26.159503	605	685	2	41	80	0.5125000
NODE_4430_length_1146_cov_26.159503	658	738	2	80	80	1.0000000
NODE_4431_length_1146_cov_14.210124	343	423	0	17	80	0.2125000
NODE_4431_length_1146_cov_14.210124	343	423	2	63	80	0.7875000
NODE_4431_length_1146_cov_14.210124	396	476	2	80	80	1.0000000
NODE_4432_length_1146_cov_13.479465	425	501	0	54	76	0.7105263
NODE_4432_length_1146_cov_13.479465	425	501	2	22	76	0.2894737
NODE_4432_length_1146_cov_13.479465	505	565	0	34	60	0.5666667
NODE_4432_length_1146_cov_13.479465	505	565	2	26	60	0.4333333
NODE_4432_length_1146_cov_13.479465	561	641	2	36	80	0.4500000
NODE_4432_length_1146_cov_13.479465	561	641	4	44	80	0.5500000
NODE_4432_length_1146_cov_13.479465	614	694	0	50	80	0.6250000
NODE_4432_length_1146_cov_13.479465	614	694	2	30	80	0.3750000
NODE_4438_length_1145_cov_49.566922	395	470	0	75	75	1.0000000
NODE_4438_length_1145_cov_49.566922	443	523	0	80	80	1.0000000
NODE_4439_length_1145_cov_38.191205	497	576	0	62	79	0.7848101
NODE_4439_length_1145_cov_38.191205	497	576	2	17	79	0.2151899
NODE_4439_length_1145_cov_38.191205	549	629	0	31	80	0.3875000
NODE_4439_length_1145_cov_38.191205	549	629	2	49	80	0.6125000
NODE_4440_length_1145_cov_26.929254	468	548	0	14	80	0.1750000
NODE_4440_length_1145_cov_26.929254	468	548	2	66	80	0.8250000
NODE_4440_length_1145_cov_26.929254	521	601	0	8	80	0.1000000
NODE_4440_length_1145_cov_26.929254	521	601	2	72	80	0.9000000
NODE_4441_length_1145_cov_20.121415	508	588	0	80	80	1.0000000
NODE_4441_length_1145_cov_20.121415	561	641	0	80	80	1.0000000
NODE_4442_length_1145_cov_11.753346	527	605	0	42	78	0.5384616
NODE_4442_length_1145_cov_11.753346	527	605	2	36	78	0.4615385
NODE_4442_length_1145_cov_11.753346	578	659	0	81	81	1.0000000
NODE_4443_length_1145_cov_9.571702	93	173	0	80	80	1.0000000
NODE_4443_length_1145_cov_9.571702	146	226	0	80	80	1.0000000
NODE_4455_length_1143_cov_42.255747	380	460	0	80	80	1.0000000
NODE_4455_length_1143_cov_42.255747	433	513	0	80	80	1.0000000
NODE_4455_length_1143_cov_42.255747	509	589	0	4	80	0.0500000
NODE_4455_length_1143_cov_42.255747	509	589	2	4	80	0.0500000
NODE_4455_length_1143_cov_42.255747	509	589	6	21	80	0.2625000
NODE_4455_length_1143_cov_42.255747	509	589	7	9	80	0.1125000
NODE_4455_length_1143_cov_42.255747	509	589	8	42	80	0.5250000
NODE_4455_length_1143_cov_42.255747	562	642	2	55	80	0.6875000
NODE_4455_length_1143_cov_42.255747	562	642	6	4	80	0.0500000
NODE_4455_length_1143_cov_42.255747	562	642	8	21	80	0.2625000
NODE_4456_length_1143_cov_22.076628	526	606	0	80	80	1.0000000
NODE_4456_length_1143_cov_22.076628	579	659	0	80	80	1.0000000
NODE_4457_length_1143_cov_19.106322	565	645	0	80	80	1.0000000
NODE_4457_length_1143_cov_19.106322	618	698	0	80	80	1.0000000
NODE_4458_length_1143_cov_16.223180	638	719	0	25	81	0.3086420
NODE_4458_length_1143_cov_16.223180	638	719	2	56	81	0.6913580
NODE_4458_length_1143_cov_16.223180	692	772	0	78	80	0.9750000
NODE_4458_length_1143_cov_16.223180	692	772	2	2	80	0.0250000
NODE_4459_length_1143_cov_13.961686	634	714	2	20	80	0.2500000
NODE_4459_length_1143_cov_13.961686	634	714	4	50	80	0.6250000
NODE_4459_length_1143_cov_13.961686	634	714	6	8	80	0.1000000
NODE_4459_length_1143_cov_13.961686	634	714	8	2	80	0.0250000
NODE_4459_length_1143_cov_13.961686	687	767	4	17	80	0.2125000
NODE_4459_length_1143_cov_13.961686	687	767	6	61	80	0.7625000
NODE_4459_length_1143_cov_13.961686	687	767	8	2	80	0.0250000
NODE_4459_length_1143_cov_13.961686	763	843	0	12	80	0.1500000
NODE_4459_length_1143_cov_13.961686	763	843	2	13	80	0.1625000
NODE_4459_length_1143_cov_13.961686	763	843	4	37	80	0.4625000
NODE_4459_length_1143_cov_13.961686	763	843	6	18	80	0.2250000
NODE_4459_length_1143_cov_13.961686	816	896	0	25	80	0.3125000
NODE_4459_length_1143_cov_13.961686	816	896	2	13	80	0.1625000
NODE_4459_length_1143_cov_13.961686	816	896	4	2	80	0.0250000
NODE_4459_length_1143_cov_13.961686	816	896	5	40	80	0.5000000
NODE_4460_length_1143_cov_12.782567	328	409	2	36	81	0.4444444
NODE_4460_length_1143_cov_12.782567	328	409	4	45	81	0.5555556
NODE_4460_length_1143_cov_12.782567	381	462	0	16	81	0.1975309
NODE_4460_length_1143_cov_12.782567	381	462	2	40	81	0.4938272
NODE_4460_length_1143_cov_12.782567	381	462	4	25	81	0.3086420
NODE_4460_length_1143_cov_12.782567	458	538	0	80	80	1.0000000
NODE_4460_length_1143_cov_12.782567	511	591	0	80	80	1.0000000
NODE_4461_length_1143_cov_8.287356	692	772	0	11	80	0.1375000
NODE_4461_length_1143_cov_8.287356	692	772	2	4	80	0.0500000
NODE_4461_length_1143_cov_8.287356	692	772	4	65	80	0.8125000
NODE_4461_length_1143_cov_8.287356	745	825	0	30	80	0.3750000
NODE_4461_length_1143_cov_8.287356	745	825	2	8	80	0.1000000
NODE_4461_length_1143_cov_8.287356	745	825	4	42	80	0.5250000
NODE_4463_length_1143_cov_2.197318	988	1057	5	2	69	0.0289855
NODE_4463_length_1143_cov_2.197318	988	1057	6	8	69	0.1159420
NODE_4463_length_1143_cov_2.197318	988	1057	8	2	69	0.0289855
NODE_4463_length_1143_cov_2.197318	988	1057	10	11	69	0.1594203
NODE_4463_length_1143_cov_2.197318	988	1057	12	8	69	0.1159420
NODE_4463_length_1143_cov_2.197318	988	1057	14	7	69	0.1014493
NODE_4463_length_1143_cov_2.197318	988	1057	16	8	69	0.1159420
NODE_4463_length_1143_cov_2.197318	988	1057	20	23	69	0.3333333
NODE_4466_length_1142_cov_28.364334	613	693	4	24	80	0.3000000
NODE_4466_length_1142_cov_28.364334	613	693	6	11	80	0.1375000
NODE_4466_length_1142_cov_28.364334	613	693	11	6	80	0.0750000
NODE_4466_length_1142_cov_28.364334	613	693	12	27	80	0.3375000
NODE_4466_length_1142_cov_28.364334	613	693	13	12	80	0.1500000
NODE_4466_length_1142_cov_28.364334	666	746	3	1	80	0.0125000
NODE_4466_length_1142_cov_28.364334	666	746	5	4	80	0.0500000
NODE_4466_length_1142_cov_28.364334	666	746	9	18	80	0.2250000
NODE_4466_length_1142_cov_28.364334	666	746	11	36	80	0.4500000
NODE_4466_length_1142_cov_28.364334	666	746	12	9	80	0.1125000
NODE_4466_length_1142_cov_28.364334	666	746	13	12	80	0.1500000
NODE_4467_length_1142_cov_21.669223	518	598	0	34	80	0.4250000
NODE_4467_length_1142_cov_21.669223	518	598	3	1	80	0.0125000
NODE_4467_length_1142_cov_21.669223	518	598	4	17	80	0.2125000
NODE_4467_length_1142_cov_21.669223	518	598	5	28	80	0.3500000
NODE_4467_length_1142_cov_21.669223	571	651	2	14	80	0.1750000
NODE_4467_length_1142_cov_21.669223	571	651	5	49	80	0.6125000
NODE_4467_length_1142_cov_21.669223	571	651	6	17	80	0.2125000
NODE_4468_length_1142_cov_19.007670	411	491	2	20	80	0.2500000
NODE_4468_length_1142_cov_19.007670	411	491	4	60	80	0.7500000
NODE_4468_length_1142_cov_19.007670	464	544	0	15	80	0.1875000
NODE_4468_length_1142_cov_19.007670	464	544	2	58	80	0.7250000
NODE_4468_length_1142_cov_19.007670	464	544	4	7	80	0.0875000
NODE_4474_length_1141_cov_12.500960	17	97	4	14	80	0.1750000
NODE_4474_length_1141_cov_12.500960	17	97	6	4	80	0.0500000
NODE_4474_length_1141_cov_12.500960	17	97	8	2	80	0.0250000
NODE_4474_length_1141_cov_12.500960	17	97	10	32	80	0.4000000
NODE_4474_length_1141_cov_12.500960	17	97	12	28	80	0.3500000
NODE_4474_length_1141_cov_12.500960	17	97	4	14	80	0.1750000
NODE_4474_length_1141_cov_12.500960	17	97	6	4	80	0.0500000
NODE_4474_length_1141_cov_12.500960	17	97	8	2	80	0.0250000
NODE_4474_length_1141_cov_12.500960	17	97	10	32	80	0.4000000
NODE_4474_length_1141_cov_12.500960	17	97	12	28	80	0.3500000
NODE_4474_length_1141_cov_12.500960	17	97	4	14	80	0.1750000
NODE_4474_length_1141_cov_12.500960	17	97	6	4	80	0.0500000
NODE_4474_length_1141_cov_12.500960	17	97	8	2	80	0.0250000
NODE_4474_length_1141_cov_12.500960	17	97	10	32	80	0.4000000
NODE_4474_length_1141_cov_12.500960	17	97	12	28	80	0.3500000
NODE_4474_length_1141_cov_12.500960	17	97	4	14	80	0.1750000
NODE_4474_length_1141_cov_12.500960	17	97	6	4	80	0.0500000
NODE_4474_length_1141_cov_12.500960	17	97	8	2	80	0.0250000
NODE_4474_length_1141_cov_12.500960	17	97	10	32	80	0.4000000
NODE_4474_length_1141_cov_12.500960	17	97	12	28	80	0.3500000
NODE_4474_length_1141_cov_12.500960	70	132	4	1	62	0.0161290
NODE_4474_length_1141_cov_12.500960	70	132	6	7	62	0.1129032
NODE_4474_length_1141_cov_12.500960	70	132	8	11	62	0.1774193
NODE_4474_length_1141_cov_12.500960	70	132	10	5	62	0.0806452
NODE_4474_length_1141_cov_12.500960	70	132	12	38	62	0.6129032
NODE_4474_length_1141_cov_12.500960	70	132	4	1	62	0.0161290
NODE_4474_length_1141_cov_12.500960	70	132	6	7	62	0.1129032
NODE_4474_length_1141_cov_12.500960	70	132	8	11	62	0.1774193
NODE_4474_length_1141_cov_12.500960	70	132	10	5	62	0.0806452
NODE_4474_length_1141_cov_12.500960	70	132	12	38	62	0.6129032
NODE_4474_length_1141_cov_12.500960	70	132	4	1	62	0.0161290
NODE_4474_length_1141_cov_12.500960	70	132	6	7	62	0.1129032
NODE_4474_length_1141_cov_12.500960	70	132	8	11	62	0.1774193
NODE_4474_length_1141_cov_12.500960	70	132	10	5	62	0.0806452
NODE_4474_length_1141_cov_12.500960	70	132	12	38	62	0.6129032
NODE_4474_length_1141_cov_12.500960	70	132	4	1	62	0.0161290
NODE_4474_length_1141_cov_12.500960	70	132	6	7	62	0.1129032
NODE_4474_length_1141_cov_12.500960	70	132	8	11	62	0.1774193
NODE_4474_length_1141_cov_12.500960	70	132	10	5	62	0.0806452
NODE_4474_length_1141_cov_12.500960	70	132	12	38	62	0.6129032
NODE_4475_length_1141_cov_7.197697	54	134	0	80	80	1.0000000
NODE_4475_length_1141_cov_7.197697	107	187	0	80	80	1.0000000
NODE_4475_length_1141_cov_7.197697	573	653	0	2	80	0.0250000
NODE_4475_length_1141_cov_7.197697	573	653	4	61	80	0.7625000
NODE_4475_length_1141_cov_7.197697	573	653	12	17	80	0.2125000
NODE_4475_length_1141_cov_7.197697	626	707	4	34	81	0.4197531
NODE_4475_length_1141_cov_7.197697	626	707	5	3	81	0.0370370
NODE_4475_length_1141_cov_7.197697	626	707	8	19	81	0.2345679
NODE_4475_length_1141_cov_7.197697	626	707	10	6	81	0.0740741
NODE_4475_length_1141_cov_7.197697	626	707	12	19	81	0.2345679
NODE_4476_length_1141_cov_5.428023	411	491	0	34	80	0.4250000
NODE_4476_length_1141_cov_5.428023	411	491	2	46	80	0.5750000
NODE_4476_length_1141_cov_5.428023	464	544	0	80	80	1.0000000
NODE_4482_length_1140_cov_39.383285	451	531	2	8	80	0.1000000
NODE_4482_length_1140_cov_39.383285	451	531	6	25	80	0.3125000
NODE_4482_length_1140_cov_39.383285	451	531	8	2	80	0.0250000
NODE_4482_length_1140_cov_39.383285	451	531	10	14	80	0.1750000
NODE_4482_length_1140_cov_39.383285	451	531	12	12	80	0.1500000
NODE_4482_length_1140_cov_39.383285	451	531	14	5	80	0.0625000
NODE_4482_length_1140_cov_39.383285	451	531	15	3	80	0.0375000
NODE_4482_length_1140_cov_39.383285	451	531	16	11	80	0.1375000
NODE_4482_length_1140_cov_39.383285	504	584	6	29	80	0.3625000
NODE_4482_length_1140_cov_39.383285	504	584	8	15	80	0.1875000
NODE_4482_length_1140_cov_39.383285	504	584	10	18	80	0.2250000
NODE_4482_length_1140_cov_39.383285	504	584	14	5	80	0.0625000
NODE_4482_length_1140_cov_39.383285	504	584	15	3	80	0.0375000
NODE_4482_length_1140_cov_39.383285	504	584	16	10	80	0.1250000
NODE_4482_length_1140_cov_39.383285	580	660	0	59	80	0.7375000
NODE_4482_length_1140_cov_39.383285	580	660	6	21	80	0.2625000
NODE_4482_length_1140_cov_39.383285	633	713	0	34	80	0.4250000
NODE_4482_length_1140_cov_39.383285	633	713	2	6	80	0.0750000
NODE_4482_length_1140_cov_39.383285	633	713	3	14	80	0.1750000
NODE_4482_length_1140_cov_39.383285	633	713	4	26	80	0.3250000
NODE_4483_length_1140_cov_19.493756	543	623	0	29	80	0.3625000
NODE_4483_length_1140_cov_19.493756	543	623	2	26	80	0.3250000
NODE_4483_length_1140_cov_19.493756	543	623	6	25	80	0.3125000
NODE_4483_length_1140_cov_19.493756	596	676	2	2	80	0.0250000
NODE_4483_length_1140_cov_19.493756	596	676	4	8	80	0.1000000
NODE_4483_length_1140_cov_19.493756	596	676	6	70	80	0.8750000
NODE_4484_length_1140_cov_18.341018	347	427	2	25	80	0.3125000
NODE_4484_length_1140_cov_18.341018	347	427	4	23	80	0.2875000
NODE_4484_length_1140_cov_18.341018	347	427	6	32	80	0.4000000
NODE_4484_length_1140_cov_18.341018	400	480	0	33	80	0.4125000
NODE_4484_length_1140_cov_18.341018	400	480	2	45	80	0.5625000
NODE_4484_length_1140_cov_18.341018	400	480	6	2	80	0.0250000
NODE_4484_length_1140_cov_18.341018	476	556	0	29	80	0.3625000
NODE_4484_length_1140_cov_18.341018	476	556	3	1	80	0.0125000
NODE_4484_length_1140_cov_18.341018	476	556	4	40	80	0.5000000
NODE_4484_length_1140_cov_18.341018	476	556	6	10	80	0.1250000
NODE_4484_length_1140_cov_18.341018	529	609	4	17	80	0.2125000
NODE_4484_length_1140_cov_18.341018	529	609	6	13	80	0.1625000
NODE_4484_length_1140_cov_18.341018	529	609	7	34	80	0.4250000
NODE_4484_length_1140_cov_18.341018	529	609	8	16	80	0.2000000
NODE_4494_length_1139_cov_26.812500	410	490	0	80	80	1.0000000
NODE_4494_length_1139_cov_26.812500	463	543	0	80	80	1.0000000
NODE_4494_length_1139_cov_26.812500	539	619	0	19	80	0.2375000
NODE_4494_length_1139_cov_26.812500	539	619	11	1	80	0.0125000
NODE_4494_length_1139_cov_26.812500	539	619	12	60	80	0.7500000
NODE_4494_length_1139_cov_26.812500	592	672	12	40	80	0.5000000
NODE_4494_length_1139_cov_26.812500	592	672	14	40	80	0.5000000
NODE_4495_length_1139_cov_26.323077	308	388	0	58	80	0.7250000
NODE_4495_length_1139_cov_26.323077	308	388	1	1	80	0.0125000
NODE_4495_length_1139_cov_26.323077	308	388	2	21	80	0.2625000
NODE_4495_length_1139_cov_26.323077	361	441	0	80	80	1.0000000
NODE_4495_length_1139_cov_26.323077	437	517	0	80	80	1.0000000
NODE_4495_length_1139_cov_26.323077	490	570	0	80	80	1.0000000
NODE_4496_length_1139_cov_15.223077	530	610	0	71	80	0.8875000
NODE_4496_length_1139_cov_15.223077	530	610	2	9	80	0.1125000
NODE_4496_length_1139_cov_15.223077	583	663	0	80	80	1.0000000
NODE_4505_length_1138_cov_74.599615	480	560	0	24	80	0.3000000
NODE_4505_length_1138_cov_74.599615	480	560	17	15	80	0.1875000
NODE_4505_length_1138_cov_74.599615	480	560	18	41	80	0.5125000
NODE_4505_length_1138_cov_74.599615	533	613	0	77	80	0.9625000
NODE_4505_length_1138_cov_74.599615	533	613	17	3	80	0.0375000
NODE_4505_length_1138_cov_74.599615	609	689	0	80	80	1.0000000
NODE_4505_length_1138_cov_74.599615	662	742	0	45	80	0.5625000
NODE_4505_length_1138_cov_74.599615	662	742	2	35	80	0.4375000
NODE_4506_length_1138_cov_29.407122	559	639	0	3	80	0.0375000
NODE_4506_length_1138_cov_29.407122	559	639	4	48	80	0.6000000
NODE_4506_length_1138_cov_29.407122	559	639	8	29	80	0.3625000
NODE_4506_length_1138_cov_29.407122	612	692	4	60	80	0.7500000
NODE_4506_length_1138_cov_29.407122	612	692	8	20	80	0.2500000
NODE_4506_length_1138_cov_29.407122	688	768	2	43	80	0.5375000
NODE_4506_length_1138_cov_29.407122	688	768	4	31	80	0.3875000
NODE_4506_length_1138_cov_29.407122	688	768	6	6	80	0.0750000
NODE_4506_length_1138_cov_29.407122	741	821	0	11	80	0.1375000
NODE_4506_length_1138_cov_29.407122	741	821	2	69	80	0.8625000
NODE_4507_length_1138_cov_18.326275	454	534	0	80	80	1.0000000
NODE_4507_length_1138_cov_18.326275	507	587	0	80	80	1.0000000
NODE_4507_length_1138_cov_18.326275	583	663	0	7	80	0.0875000
NODE_4507_length_1138_cov_18.326275	583	663	2	73	80	0.9125000
NODE_4507_length_1138_cov_18.326275	636	716	0	49	80	0.6125000
NODE_4507_length_1138_cov_18.326275	636	716	2	31	80	0.3875000
NODE_4509_length_1138_cov_11.834456	291	371	0	25	80	0.3125000
NODE_4509_length_1138_cov_11.834456	291	371	2	55	80	0.6875000
NODE_4509_length_1138_cov_11.834456	344	424	0	33	80	0.4125000
NODE_4509_length_1138_cov_11.834456	344	424	2	47	80	0.5875000
NODE_4510_length_1138_cov_10.923003	318	398	0	58	80	0.7250000
NODE_4510_length_1138_cov_10.923003	318	398	4	22	80	0.2750000
NODE_4510_length_1138_cov_10.923003	371	451	0	5	80	0.0625000
NODE_4510_length_1138_cov_10.923003	371	451	4	75	80	0.9375000
NODE_4517_length_1137_cov_23.983622	470	550	0	80	80	1.0000000
NODE_4517_length_1137_cov_23.983622	523	603	0	80	80	1.0000000
NODE_4517_length_1137_cov_23.983622	599	679	0	80	80	1.0000000
NODE_4517_length_1137_cov_23.983622	652	732	0	33	80	0.4125000
NODE_4517_length_1137_cov_23.983622	652	732	4	47	80	0.5875000
NODE_4518_length_1137_cov_22.877649	405	485	8	39	80	0.4875000
NODE_4518_length_1137_cov_22.877649	405	485	10	26	80	0.3250000
NODE_4518_length_1137_cov_22.877649	405	485	12	1	80	0.0125000
NODE_4518_length_1137_cov_22.877649	405	485	13	1	80	0.0125000
NODE_4518_length_1137_cov_22.877649	405	485	14	13	80	0.1625000
NODE_4518_length_1137_cov_22.877649	458	538	6	4	80	0.0500000
NODE_4518_length_1137_cov_22.877649	458	538	8	49	80	0.6125000
NODE_4518_length_1137_cov_22.877649	458	538	10	12	80	0.1500000
NODE_4518_length_1137_cov_22.877649	458	538	12	1	80	0.0125000
NODE_4518_length_1137_cov_22.877649	458	538	13	1	80	0.0125000
NODE_4518_length_1137_cov_22.877649	458	538	14	13	80	0.1625000
NODE_4518_length_1137_cov_22.877649	534	614	6	46	80	0.5750000
NODE_4518_length_1137_cov_22.877649	534	614	8	16	80	0.2000000
NODE_4518_length_1137_cov_22.877649	534	614	10	5	80	0.0625000
NODE_4518_length_1137_cov_22.877649	534	614	12	13	80	0.1625000
NODE_4518_length_1137_cov_22.877649	587	667	8	9	80	0.1125000
NODE_4518_length_1137_cov_22.877649	587	667	10	20	80	0.2500000
NODE_4518_length_1137_cov_22.877649	587	667	11	38	80	0.4750000
NODE_4518_length_1137_cov_22.877649	587	667	12	13	80	0.1625000
NODE_4519_length_1137_cov_21.570328	383	463	0	80	80	1.0000000
NODE_4519_length_1137_cov_21.570328	436	516	0	80	80	1.0000000
NODE_4520_length_1137_cov_18.560694	665	745	2	15	80	0.1875000
NODE_4520_length_1137_cov_18.560694	665	745	4	54	80	0.6750000
NODE_4520_length_1137_cov_18.560694	665	745	6	11	80	0.1375000
NODE_4520_length_1137_cov_18.560694	718	798	2	68	80	0.8500000
NODE_4520_length_1137_cov_18.560694	718	798	4	1	80	0.0125000
NODE_4520_length_1137_cov_18.560694	718	798	6	11	80	0.1375000
NODE_4521_length_1137_cov_18.505780	557	637	2	80	80	1.0000000
NODE_4521_length_1137_cov_18.505780	610	690	0	49	80	0.6125000
NODE_4521_length_1137_cov_18.505780	610	690	2	31	80	0.3875000
NODE_4521_length_1137_cov_18.505780	686	766	0	76	80	0.9500000
NODE_4521_length_1137_cov_18.505780	686	766	2	4	80	0.0500000
NODE_4521_length_1137_cov_18.505780	739	819	0	23	80	0.2875000
NODE_4521_length_1137_cov_18.505780	739	819	2	57	80	0.7125000
NODE_4523_length_1137_cov_11.866089	313	393	0	80	80	1.0000000
NODE_4523_length_1137_cov_11.866089	366	446	0	80	80	1.0000000
NODE_4523_length_1137_cov_11.866089	442	522	0	39	80	0.4875000
NODE_4523_length_1137_cov_11.866089	442	522	2	41	80	0.5125000
NODE_4523_length_1137_cov_11.866089	495	575	0	19	80	0.2375000
NODE_4523_length_1137_cov_11.866089	495	575	2	61	80	0.7625000
NODE_4524_length_1137_cov_5.594412	144	224	0	80	80	1.0000000
NODE_4524_length_1137_cov_5.594412	197	277	0	80	80	1.0000000
NODE_4532_length_1136_cov_42.827387	445	525	0	5	80	0.0625000
NODE_4532_length_1136_cov_42.827387	445	525	2	61	80	0.7625000
NODE_4532_length_1136_cov_42.827387	445	525	4	14	80	0.1750000
NODE_4532_length_1136_cov_42.827387	498	578	0	58	80	0.7250000
NODE_4532_length_1136_cov_42.827387	498	578	2	22	80	0.2750000
NODE_4532_length_1136_cov_42.827387	574	654	0	80	80	1.0000000
NODE_4532_length_1136_cov_42.827387	627	707	0	80	80	1.0000000
NODE_4533_length_1136_cov_30.940212	534	614	0	80	80	1.0000000
NODE_4533_length_1136_cov_30.940212	587	667	0	80	80	1.0000000
NODE_4533_length_1136_cov_30.940212	663	743	0	40	80	0.5000000
NODE_4533_length_1136_cov_30.940212	663	743	2	40	80	0.5000000
NODE_4533_length_1136_cov_30.940212	716	796	0	26	80	0.3250000
NODE_4533_length_1136_cov_30.940212	716	796	2	54	80	0.6750000
NODE_4534_length_1136_cov_30.797493	557	637	0	80	80	1.0000000
NODE_4534_length_1136_cov_30.797493	610	691	0	81	81	1.0000000
NODE_4534_length_1136_cov_30.797493	687	767	0	23	80	0.2875000
NODE_4534_length_1136_cov_30.797493	687	767	2	57	80	0.7125000
NODE_4534_length_1136_cov_30.797493	740	820	2	80	80	1.0000000
NODE_4535_length_1136_cov_23.142719	704	784	0	29	80	0.3625000
NODE_4535_length_1136_cov_23.142719	704	784	8	18	80	0.2250000
NODE_4535_length_1136_cov_23.142719	704	784	14	33	80	0.4125000
NODE_4535_length_1136_cov_23.142719	757	837	0	31	80	0.3875000
NODE_4535_length_1136_cov_23.142719	757	837	9	3	80	0.0375000
NODE_4535_length_1136_cov_23.142719	757	837	10	4	80	0.0500000
NODE_4535_length_1136_cov_23.142719	757	837	14	42	80	0.5250000
NODE_4536_length_1136_cov_21.798457	570	651	0	69	81	0.8518519
NODE_4536_length_1136_cov_21.798457	570	651	4	12	81	0.1481481
NODE_4536_length_1136_cov_21.798457	624	704	0	80	80	1.0000000
NODE_4537_length_1136_cov_21.109932	460	532	0	72	72	1.0000000
NODE_4537_length_1136_cov_21.109932	505	585	0	80	80	1.0000000
NODE_4538_length_1136_cov_20.528447	19	99	9	23	80	0.2875000
NODE_4538_length_1136_cov_20.528447	19	99	13	20	80	0.2500000
NODE_4538_length_1136_cov_20.528447	19	99	14	1	80	0.0125000
NODE_4538_length_1136_cov_20.528447	19	99	15	9	80	0.1125000
NODE_4538_length_1136_cov_20.528447	19	99	16	27	80	0.3375000
NODE_4538_length_1136_cov_20.528447	19	99	9	23	80	0.2875000
NODE_4538_length_1136_cov_20.528447	19	99	13	20	80	0.2500000
NODE_4538_length_1136_cov_20.528447	19	99	14	1	80	0.0125000
NODE_4538_length_1136_cov_20.528447	19	99	15	9	80	0.1125000
NODE_4538_length_1136_cov_20.528447	19	99	16	27	80	0.3375000
NODE_4538_length_1136_cov_20.528447	28	99	9	14	71	0.1971831
NODE_4538_length_1136_cov_20.528447	28	99	13	20	71	0.2816902
NODE_4538_length_1136_cov_20.528447	28	99	14	1	71	0.0140845
NODE_4538_length_1136_cov_20.528447	28	99	15	9	71	0.1267606
NODE_4538_length_1136_cov_20.528447	28	99	16	27	71	0.3802817
NODE_4538_length_1136_cov_20.528447	877	912	0	35	35	1.0000000
NODE_4538_length_1136_cov_20.528447	879	921	0	42	42	1.0000000
NODE_4539_length_1136_cov_14.921890	657	737	0	80	80	1.0000000
NODE_4539_length_1136_cov_14.921890	710	790	0	80	80	1.0000000
NODE_4556_length_1135_cov_100.121622	454	534	0	25	80	0.3125000
NODE_4556_length_1135_cov_100.121622	454	534	2	55	80	0.6875000
NODE_4556_length_1135_cov_100.121622	507	587	0	22	80	0.2750000
NODE_4556_length_1135_cov_100.121622	507	587	2	58	80	0.7250000
NODE_4556_length_1135_cov_100.121622	583	663	0	80	80	1.0000000
NODE_4556_length_1135_cov_100.121622	636	719	0	31	83	0.3734940
NODE_4556_length_1135_cov_100.121622	636	719	2	52	83	0.6265060
NODE_4557_length_1135_cov_34.523166	313	393	0	7	80	0.0875000
NODE_4557_length_1135_cov_34.523166	313	393	2	16	80	0.2000000
NODE_4557_length_1135_cov_34.523166	313	393	4	9	80	0.1125000
NODE_4557_length_1135_cov_34.523166	313	393	6	48	80	0.6000000
NODE_4557_length_1135_cov_34.523166	366	446	0	33	80	0.4125000
NODE_4557_length_1135_cov_34.523166	366	446	4	29	80	0.3625000
NODE_4557_length_1135_cov_34.523166	366	446	6	18	80	0.2250000
NODE_4558_length_1135_cov_20.735521	484	564	0	80	80	1.0000000
NODE_4558_length_1135_cov_20.735521	537	617	0	80	80	1.0000000
NODE_4558_length_1135_cov_20.735521	613	693	0	54	80	0.6750000
NODE_4558_length_1135_cov_20.735521	613	693	2	26	80	0.3250000
NODE_4558_length_1135_cov_20.735521	666	746	0	1	80	0.0125000
NODE_4558_length_1135_cov_20.735521	666	746	2	79	80	0.9875000
NODE_4559_length_1135_cov_9.644788	620	700	0	71	80	0.8875000
NODE_4559_length_1135_cov_9.644788	620	700	2	9	80	0.1125000
NODE_4559_length_1135_cov_9.644788	673	753	0	18	80	0.2250000
NODE_4559_length_1135_cov_9.644788	673	753	2	62	80	0.7750000
NODE_4562_length_1135_cov_2.990347	349	429	0	80	80	1.0000000
NODE_4562_length_1135_cov_2.990347	402	482	0	80	80	1.0000000
NODE_4571_length_1134_cov_34.784541	478	558	2	24	80	0.3000000
NODE_4571_length_1134_cov_34.784541	478	558	4	12	80	0.1500000
NODE_4571_length_1134_cov_34.784541	478	558	6	44	80	0.5500000
NODE_4571_length_1134_cov_34.784541	531	611	0	52	80	0.6500000
NODE_4571_length_1134_cov_34.784541	531	611	2	25	80	0.3125000
NODE_4571_length_1134_cov_34.784541	531	611	4	3	80	0.0375000
NODE_4571_length_1134_cov_34.784541	607	687	0	42	80	0.5250000
NODE_4571_length_1134_cov_34.784541	607	687	4	13	80	0.1625000
NODE_4571_length_1134_cov_34.784541	607	687	8	25	80	0.3125000
NODE_4571_length_1134_cov_34.784541	660	740	0	1	80	0.0125000
NODE_4571_length_1134_cov_34.784541	660	740	4	4	80	0.0500000
NODE_4571_length_1134_cov_34.784541	660	740	6	5	80	0.0625000
NODE_4571_length_1134_cov_34.784541	660	740	8	70	80	0.8750000
NODE_4572_length_1134_cov_28.524638	511	591	8	80	80	1.0000000
NODE_4572_length_1134_cov_28.524638	564	644	8	78	80	0.9750000
NODE_4572_length_1134_cov_28.524638	564	644	10	2	80	0.0250000
NODE_4572_length_1134_cov_28.524638	640	720	2	74	80	0.9250000
NODE_4572_length_1134_cov_28.524638	640	720	8	2	80	0.0250000
NODE_4572_length_1134_cov_28.524638	640	720	10	4	80	0.0500000
NODE_4572_length_1134_cov_28.524638	693	773	0	39	80	0.4875000
NODE_4572_length_1134_cov_28.524638	693	773	2	41	80	0.5125000
NODE_4576_length_1134_cov_2.619324	606	686	0	80	80	1.0000000
NODE_4576_length_1134_cov_2.619324	659	739	0	80	80	1.0000000
NODE_4584_length_1133_cov_5.563830	292	372	0	80	80	1.0000000
NODE_4584_length_1133_cov_5.563830	345	425	0	80	80	1.0000000
NODE_4584_length_1133_cov_5.563830	904	966	4	9	62	0.1451613
NODE_4584_length_1133_cov_5.563830	904	966	6	6	62	0.0967742
NODE_4584_length_1133_cov_5.563830	904	966	8	29	62	0.4677419
NODE_4584_length_1133_cov_5.563830	904	966	10	18	62	0.2903226
NODE_4592_length_1132_cov_23.121007	485	565	0	47	80	0.5875000
NODE_4592_length_1132_cov_23.121007	485	565	2	23	80	0.2875000
NODE_4592_length_1132_cov_23.121007	485	565	4	10	80	0.1250000
NODE_4592_length_1132_cov_23.121007	538	618	2	17	80	0.2125000
NODE_4592_length_1132_cov_23.121007	538	618	4	63	80	0.7875000
NODE_4592_length_1132_cov_23.121007	618	664	0	23	46	0.5000000
NODE_4592_length_1132_cov_23.121007	618	664	2	10	46	0.2173913
NODE_4592_length_1132_cov_23.121007	618	664	4	13	46	0.2826087
NODE_4592_length_1132_cov_23.121007	700	751	0	51	51	1.0000000
NODE_4593_length_1132_cov_19.377541	595	675	0	80	80	1.0000000
NODE_4593_length_1132_cov_19.377541	648	728	0	30	80	0.3750000
NODE_4593_length_1132_cov_19.377541	648	728	2	50	80	0.6250000
NODE_4594_length_1132_cov_18.872217	363	443	0	80	80	1.0000000
NODE_4594_length_1132_cov_18.872217	416	496	0	80	80	1.0000000
NODE_4595_length_1132_cov_11.242982	474	554	0	70	80	0.8750000
NODE_4595_length_1132_cov_11.242982	474	554	4	10	80	0.1250000
NODE_4595_length_1132_cov_11.242982	527	607	0	17	80	0.2125000
NODE_4595_length_1132_cov_11.242982	527	607	4	25	80	0.3125000
NODE_4595_length_1132_cov_11.242982	527	607	6	38	80	0.4750000
NODE_4596_length_1132_cov_7.356244	354	434	0	3	80	0.0375000
NODE_4596_length_1132_cov_7.356244	354	434	2	52	80	0.6500000
NODE_4596_length_1132_cov_7.356244	354	434	4	25	80	0.3125000
NODE_4596_length_1132_cov_7.356244	407	487	0	56	80	0.7000000
NODE_4596_length_1132_cov_7.356244	407	487	2	9	80	0.1125000
NODE_4596_length_1132_cov_7.356244	407	487	4	15	80	0.1875000
NODE_4597_length_1132_cov_6.214908	269	349	0	80	80	1.0000000
NODE_4597_length_1132_cov_6.214908	322	402	0	80	80	1.0000000
NODE_4606_length_1131_cov_36.161822	478	558	0	80	80	1.0000000
NODE_4606_length_1131_cov_36.161822	531	611	0	80	80	1.0000000
NODE_4606_length_1131_cov_36.161822	607	687	0	22	80	0.2750000
NODE_4606_length_1131_cov_36.161822	607	687	2	1	80	0.0125000
NODE_4606_length_1131_cov_36.161822	607	687	3	16	80	0.2000000
NODE_4606_length_1131_cov_36.161822	607	687	7	41	80	0.5125000
NODE_4606_length_1131_cov_36.161822	660	740	0	4	80	0.0500000
NODE_4606_length_1131_cov_36.161822	660	740	4	21	80	0.2625000
NODE_4606_length_1131_cov_36.161822	660	740	7	55	80	0.6875000
NODE_4607_length_1131_cov_31.907946	390	470	0	80	80	1.0000000
NODE_4607_length_1131_cov_31.907946	443	523	0	66	80	0.8250000
NODE_4607_length_1131_cov_31.907946	443	523	2	14	80	0.1750000
NODE_4607_length_1131_cov_31.907946	519	599	0	1	80	0.0125000
NODE_4607_length_1131_cov_31.907946	519	599	2	79	80	0.9875000
NODE_4607_length_1131_cov_31.907946	572	652	0	54	80	0.6750000
NODE_4607_length_1131_cov_31.907946	572	652	2	26	80	0.3250000
NODE_4608_length_1131_cov_26.827519	464	544	0	51	80	0.6375000
NODE_4608_length_1131_cov_26.827519	464	544	2	13	80	0.1625000
NODE_4608_length_1131_cov_26.827519	464	544	4	16	80	0.2000000
NODE_4608_length_1131_cov_26.827519	517	597	2	11	80	0.1375000
NODE_4608_length_1131_cov_26.827519	517	597	4	69	80	0.8625000
NODE_4609_length_1131_cov_20.441860	555	635	0	80	80	1.0000000
NODE_4609_length_1131_cov_20.441860	608	688	0	80	80	1.0000000
NODE_4610_length_1131_cov_12.517442	420	500	0	80	80	1.0000000
NODE_4610_length_1131_cov_12.517442	473	553	0	80	80	1.0000000
NODE_4611_length_1131_cov_10.912791	429	509	0	80	80	1.0000000
NODE_4611_length_1131_cov_10.912791	482	562	0	80	80	1.0000000
NODE_4620_length_1130_cov_43.354995	742	822	0	20	80	0.2500000
NODE_4620_length_1130_cov_43.354995	742	822	4	11	80	0.1375000
NODE_4620_length_1130_cov_43.354995	742	822	5	40	80	0.5000000
NODE_4620_length_1130_cov_43.354995	742	822	7	9	80	0.1125000
NODE_4620_length_1130_cov_43.354995	795	875	2	25	80	0.3125000
NODE_4620_length_1130_cov_43.354995	795	875	4	10	80	0.1250000
NODE_4620_length_1130_cov_43.354995	795	875	5	8	80	0.1000000
NODE_4620_length_1130_cov_43.354995	795	875	7	37	80	0.4625000
NODE_4621_length_1130_cov_13.097963	642	722	0	11	80	0.1375000
NODE_4621_length_1130_cov_13.097963	642	722	2	34	80	0.4250000
NODE_4621_length_1130_cov_13.097963	642	722	4	3	80	0.0375000
NODE_4621_length_1130_cov_13.097963	642	722	6	20	80	0.2500000
NODE_4621_length_1130_cov_13.097963	642	722	8	12	80	0.1500000
NODE_4621_length_1130_cov_13.097963	695	775	6	16	80	0.2000000
NODE_4621_length_1130_cov_13.097963	695	775	8	64	80	0.8000000
NODE_4626_length_1129_cov_31.088350	396	476	0	5	80	0.0625000
NODE_4626_length_1129_cov_31.088350	396	476	4	75	80	0.9375000
NODE_4626_length_1129_cov_31.088350	449	529	0	13	80	0.1625000
NODE_4626_length_1129_cov_31.088350	449	529	4	67	80	0.8375000
NODE_4627_length_1129_cov_20.591262	450	530	0	27	80	0.3375000
NODE_4627_length_1129_cov_20.591262	450	530	6	53	80	0.6625000
NODE_4627_length_1129_cov_20.591262	503	583	0	14	80	0.1750000
NODE_4627_length_1129_cov_20.591262	503	583	6	66	80	0.8250000
NODE_4628_length_1129_cov_16.934951	261	341	0	50	80	0.6250000
NODE_4628_length_1129_cov_16.934951	261	341	6	3	80	0.0375000
NODE_4628_length_1129_cov_16.934951	261	341	10	27	80	0.3375000
NODE_4628_length_1129_cov_16.934951	314	394	4	9	80	0.1125000
NODE_4628_length_1129_cov_16.934951	314	394	10	71	80	0.8875000
NODE_4629_length_1129_cov_9.441748	665	738	2	9	73	0.1232877
NODE_4629_length_1129_cov_9.441748	665	738	6	64	73	0.8767123
NODE_4629_length_1129_cov_9.441748	711	791	0	35	80	0.4375000
NODE_4629_length_1129_cov_9.441748	711	791	2	27	80	0.3375000
NODE_4629_length_1129_cov_9.441748	711	791	6	18	80	0.2250000
NODE_4630_length_1129_cov_9.260194	658	738	0	80	80	1.0000000
NODE_4630_length_1129_cov_9.260194	711	791	0	80	80	1.0000000
NODE_4631_length_1129_cov_5.055340	759	839	0	9	80	0.1125000
NODE_4631_length_1129_cov_5.055340	759	839	4	3	80	0.0375000
NODE_4631_length_1129_cov_5.055340	759	839	8	26	80	0.3250000
NODE_4631_length_1129_cov_5.055340	759	839	10	4	80	0.0500000
NODE_4631_length_1129_cov_5.055340	759	839	12	38	80	0.4750000
NODE_4638_length_1128_cov_48.099125	588	668	7	20	80	0.2500000
NODE_4638_length_1128_cov_48.099125	588	668	9	2	80	0.0250000
NODE_4638_length_1128_cov_48.099125	588	668	10	2	80	0.0250000
NODE_4638_length_1128_cov_48.099125	588	668	11	11	80	0.1375000
NODE_4638_length_1128_cov_48.099125	588	668	12	45	80	0.5625000
NODE_4638_length_1128_cov_48.099125	641	721	0	45	80	0.5625000
NODE_4638_length_1128_cov_48.099125	641	721	7	28	80	0.3500000
NODE_4638_length_1128_cov_48.099125	641	721	9	2	80	0.0250000
NODE_4638_length_1128_cov_48.099125	641	721	11	5	80	0.0625000
NODE_4640_length_1128_cov_26.230321	455	535	6	56	80	0.7000000
NODE_4640_length_1128_cov_26.230321	455	535	8	4	80	0.0500000
NODE_4640_length_1128_cov_26.230321	455	535	10	20	80	0.2500000
NODE_4640_length_1128_cov_26.230321	508	588	4	6	80	0.0750000
NODE_4640_length_1128_cov_26.230321	508	588	5	1	80	0.0125000
NODE_4640_length_1128_cov_26.230321	508	588	6	23	80	0.2875000
NODE_4640_length_1128_cov_26.230321	508	588	8	44	80	0.5500000
NODE_4640_length_1128_cov_26.230321	508	588	10	6	80	0.0750000
NODE_4640_length_1128_cov_26.230321	584	664	4	20	80	0.2500000
NODE_4640_length_1128_cov_26.230321	584	664	12	45	80	0.5625000
NODE_4640_length_1128_cov_26.230321	584	664	13	1	80	0.0125000
NODE_4640_length_1128_cov_26.230321	584	664	14	14	80	0.1750000
NODE_4640_length_1128_cov_26.230321	637	718	10	43	81	0.5308642
NODE_4640_length_1128_cov_26.230321	637	718	12	38	81	0.4691358
NODE_4641_length_1128_cov_26.031098	594	674	0	80	80	1.0000000
NODE_4641_length_1128_cov_26.031098	647	727	0	80	80	1.0000000
NODE_4642_length_1128_cov_25.869776	465	538	0	73	73	1.0000000
NODE_4642_length_1128_cov_25.869776	601	674	0	73	73	1.0000000
NODE_4642_length_1128_cov_25.869776	647	723	0	76	76	1.0000000
NODE_4643_length_1128_cov_24.185617	350	430	0	66	80	0.8250000
NODE_4643_length_1128_cov_24.185617	350	430	8	14	80	0.1750000
NODE_4643_length_1128_cov_24.185617	403	483	0	13	80	0.1625000
NODE_4643_length_1128_cov_24.185617	403	483	8	67	80	0.8375000
NODE_4644_length_1128_cov_18.537415	335	415	0	80	80	1.0000000
NODE_4644_length_1128_cov_18.537415	388	468	0	80	80	1.0000000
NODE_4645_length_1128_cov_9.345967	690	770	0	13	80	0.1625000
NODE_4645_length_1128_cov_9.345967	690	770	2	67	80	0.8375000
NODE_4645_length_1128_cov_9.345967	743	823	2	80	80	1.0000000
NODE_4647_length_1128_cov_3.920311	675	725	0	50	50	1.0000000
NODE_4647_length_1128_cov_3.920311	698	778	0	80	80	1.0000000
NODE_4648_length_1128_cov_3.631681	613	693	2	29	80	0.3625000
NODE_4648_length_1128_cov_3.631681	613	693	4	51	80	0.6375000
NODE_4648_length_1128_cov_3.631681	666	746	0	53	80	0.6625000
NODE_4648_length_1128_cov_3.631681	666	746	2	19	80	0.2375000
NODE_4648_length_1128_cov_3.631681	666	746	4	8	80	0.1000000
NODE_4650_length_1128_cov_3.091351	519	599	0	80	80	1.0000000
NODE_4650_length_1128_cov_3.091351	572	652	0	80	80	1.0000000
NODE_4660_length_1127_cov_38.932879	405	485	0	56	80	0.7000000
NODE_4660_length_1127_cov_38.932879	405	485	2	24	80	0.3000000
NODE_4660_length_1127_cov_38.932879	458	538	0	3	80	0.0375000
NODE_4660_length_1127_cov_38.932879	458	538	2	77	80	0.9625000
NODE_4660_length_1127_cov_38.932879	534	614	0	17	80	0.2125000
NODE_4660_length_1127_cov_38.932879	534	614	2	63	80	0.7875000
NODE_4660_length_1127_cov_38.932879	587	667	0	70	80	0.8750000
NODE_4660_length_1127_cov_38.932879	587	667	2	10	80	0.1250000
NODE_4661_length_1127_cov_37.721790	236	316	0	80	80	1.0000000
NODE_4661_length_1127_cov_37.721790	289	369	0	80	80	1.0000000
NODE_4661_length_1127_cov_37.721790	365	445	0	7	80	0.0875000
NODE_4661_length_1127_cov_37.721790	365	445	2	18	80	0.2250000
NODE_4661_length_1127_cov_37.721790	365	445	4	55	80	0.6875000
NODE_4661_length_1127_cov_37.721790	418	498	4	40	80	0.5000000
NODE_4661_length_1127_cov_37.721790	418	498	6	14	80	0.1750000
NODE_4661_length_1127_cov_37.721790	418	498	8	4	80	0.0500000
NODE_4661_length_1127_cov_37.721790	418	498	10	22	80	0.2750000
NODE_4662_length_1127_cov_31.866732	444	523	0	79	79	1.0000000
NODE_4662_length_1127_cov_31.866732	496	576	0	80	80	1.0000000
NODE_4662_length_1127_cov_31.866732	572	652	0	80	80	1.0000000
NODE_4662_length_1127_cov_31.866732	625	705	0	80	80	1.0000000
NODE_4663_length_1127_cov_25.616732	430	510	0	80	80	1.0000000
NODE_4663_length_1127_cov_25.616732	483	563	0	80	80	1.0000000
NODE_4664_length_1127_cov_21.838521	338	418	0	80	80	1.0000000
NODE_4664_length_1127_cov_21.838521	391	471	0	80	80	1.0000000
NODE_4664_length_1127_cov_21.838521	467	547	0	49	80	0.6125000
NODE_4664_length_1127_cov_21.838521	467	547	2	31	80	0.3875000
NODE_4664_length_1127_cov_21.838521	520	600	2	47	80	0.5875000
NODE_4664_length_1127_cov_21.838521	520	600	4	33	80	0.4125000
NODE_4665_length_1127_cov_15.024319	711	800	0	30	89	0.3370787
NODE_4665_length_1127_cov_15.024319	711	800	2	59	89	0.6629214
NODE_4665_length_1127_cov_15.024319	773	853	0	75	80	0.9375000
NODE_4665_length_1127_cov_15.024319	773	853	2	5	80	0.0625000
NODE_4667_length_1127_cov_4.786965	386	466	0	7	80	0.0875000
NODE_4667_length_1127_cov_4.786965	386	466	2	29	80	0.3625000
NODE_4667_length_1127_cov_4.786965	386	466	4	12	80	0.1500000
NODE_4667_length_1127_cov_4.786965	386	466	6	15	80	0.1875000
NODE_4667_length_1127_cov_4.786965	386	466	8	17	80	0.2125000
NODE_4667_length_1127_cov_4.786965	439	519	0	60	80	0.7500000
NODE_4667_length_1127_cov_4.786965	439	519	2	20	80	0.2500000
NODE_4672_length_1126_cov_51.699124	448	528	0	64	80	0.8000000
NODE_4672_length_1126_cov_51.699124	448	528	1	9	80	0.1125000
NODE_4672_length_1126_cov_51.699124	448	528	2	7	80	0.0875000
NODE_4672_length_1126_cov_51.699124	501	581	0	18	80	0.2250000
NODE_4672_length_1126_cov_51.699124	501	581	1	9	80	0.1125000
NODE_4672_length_1126_cov_51.699124	501	581	2	53	80	0.6625000
NODE_4673_length_1126_cov_38.135346	427	507	2	10	80	0.1250000
NODE_4673_length_1126_cov_38.135346	427	507	4	25	80	0.3125000
NODE_4673_length_1126_cov_38.135346	427	507	6	45	80	0.5625000
NODE_4673_length_1126_cov_38.135346	480	560	2	58	80	0.7250000
NODE_4673_length_1126_cov_38.135346	480	560	4	5	80	0.0625000
NODE_4673_length_1126_cov_38.135346	480	560	6	17	80	0.2125000
NODE_4673_length_1126_cov_38.135346	556	638	2	82	82	1.0000000
NODE_4673_length_1126_cov_38.135346	611	691	0	39	80	0.4875000
NODE_4673_length_1126_cov_38.135346	611	691	2	41	80	0.5125000
NODE_4674_length_1126_cov_34.637780	23	97	36	4	74	0.0540541
NODE_4674_length_1126_cov_34.637780	23	97	43	4	74	0.0540541
NODE_4674_length_1126_cov_34.637780	23	97	45	2	74	0.0270270
NODE_4674_length_1126_cov_34.637780	23	97	49	10	74	0.1351351
NODE_4674_length_1126_cov_34.637780	23	97	51	1	74	0.0135135
NODE_4674_length_1126_cov_34.637780	23	97	53	1	74	0.0135135
NODE_4674_length_1126_cov_34.637780	23	97	57	16	74	0.2162162
NODE_4674_length_1126_cov_34.637780	23	97	61	22	74	0.2972973
NODE_4674_length_1126_cov_34.637780	23	97	62	14	74	0.1891892
NODE_4674_length_1126_cov_34.637780	146	226	10	3	80	0.0375000
NODE_4674_length_1126_cov_34.637780	146	226	12	10	80	0.1250000
NODE_4674_length_1126_cov_34.637780	146	226	14	30	80	0.3750000
NODE_4674_length_1126_cov_34.637780	146	226	16	2	80	0.0250000
NODE_4674_length_1126_cov_34.637780	146	226	24	6	80	0.0750000
NODE_4674_length_1126_cov_34.637780	146	226	26	8	80	0.1000000
NODE_4674_length_1126_cov_34.637780	146	226	28	2	80	0.0250000
NODE_4674_length_1126_cov_34.637780	146	226	30	2	80	0.0250000
NODE_4674_length_1126_cov_34.637780	146	226	32	2	80	0.0250000
NODE_4674_length_1126_cov_34.637780	146	226	36	2	80	0.0250000
NODE_4674_length_1126_cov_34.637780	146	226	47	1	80	0.0125000
NODE_4674_length_1126_cov_34.637780	146	226	77	1	80	0.0125000
NODE_4674_length_1126_cov_34.637780	146	226	78	5	80	0.0625000
NODE_4674_length_1126_cov_34.637780	146	226	80	5	80	0.0625000
NODE_4674_length_1126_cov_34.637780	146	226	82	1	80	0.0125000
NODE_4674_length_1126_cov_34.637780	146	226	10	3	80	0.0375000
NODE_4674_length_1126_cov_34.637780	146	226	12	10	80	0.1250000
NODE_4674_length_1126_cov_34.637780	146	226	14	30	80	0.3750000
NODE_4674_length_1126_cov_34.637780	146	226	16	2	80	0.0250000
NODE_4674_length_1126_cov_34.637780	146	226	24	6	80	0.0750000
NODE_4674_length_1126_cov_34.637780	146	226	26	8	80	0.1000000
NODE_4674_length_1126_cov_34.637780	146	226	28	2	80	0.0250000
NODE_4674_length_1126_cov_34.637780	146	226	30	2	80	0.0250000
NODE_4674_length_1126_cov_34.637780	146	226	32	2	80	0.0250000
NODE_4674_length_1126_cov_34.637780	146	226	36	2	80	0.0250000
NODE_4674_length_1126_cov_34.637780	146	226	47	1	80	0.0125000
NODE_4674_length_1126_cov_34.637780	146	226	77	1	80	0.0125000
NODE_4674_length_1126_cov_34.637780	146	226	78	5	80	0.0625000
NODE_4674_length_1126_cov_34.637780	146	226	80	5	80	0.0625000
NODE_4674_length_1126_cov_34.637780	146	226	82	1	80	0.0125000
NODE_4674_length_1126_cov_34.637780	146	208	10	3	62	0.0483871
NODE_4674_length_1126_cov_34.637780	146	208	12	4	62	0.0645161
NODE_4674_length_1126_cov_34.637780	146	208	14	18	62	0.2903226
NODE_4674_length_1126_cov_34.637780	146	208	16	2	62	0.0322581
NODE_4674_length_1126_cov_34.637780	146	208	24	6	62	0.0967742
NODE_4674_length_1126_cov_34.637780	146	208	26	8	62	0.1290323
NODE_4674_length_1126_cov_34.637780	146	208	28	2	62	0.0322581
NODE_4674_length_1126_cov_34.637780	146	208	30	2	62	0.0322581
NODE_4674_length_1126_cov_34.637780	146	208	32	2	62	0.0322581
NODE_4674_length_1126_cov_34.637780	146	208	36	2	62	0.0322581
NODE_4674_length_1126_cov_34.637780	146	208	47	1	62	0.0161290
NODE_4674_length_1126_cov_34.637780	146	208	77	1	62	0.0161290
NODE_4674_length_1126_cov_34.637780	146	208	78	5	62	0.0806452
NODE_4674_length_1126_cov_34.637780	146	208	80	5	62	0.0806452
NODE_4674_length_1126_cov_34.637780	146	208	82	1	62	0.0161290
NODE_4674_length_1126_cov_34.637780	146	217	10	3	71	0.0422535
NODE_4674_length_1126_cov_34.637780	146	217	12	4	71	0.0563380
NODE_4674_length_1126_cov_34.637780	146	217	14	27	71	0.3802817
NODE_4674_length_1126_cov_34.637780	146	217	16	2	71	0.0281690
NODE_4674_length_1126_cov_34.637780	146	217	24	6	71	0.0845070
NODE_4674_length_1126_cov_34.637780	146	217	26	8	71	0.1126761
NODE_4674_length_1126_cov_34.637780	146	217	28	2	71	0.0281690
NODE_4674_length_1126_cov_34.637780	146	217	30	2	71	0.0281690
NODE_4674_length_1126_cov_34.637780	146	217	32	2	71	0.0281690
NODE_4674_length_1126_cov_34.637780	146	217	36	2	71	0.0281690
NODE_4674_length_1126_cov_34.637780	146	217	47	1	71	0.0140845
NODE_4674_length_1126_cov_34.637780	146	217	77	1	71	0.0140845
NODE_4674_length_1126_cov_34.637780	146	217	78	5	71	0.0704225
NODE_4674_length_1126_cov_34.637780	146	217	80	5	71	0.0704225
NODE_4674_length_1126_cov_34.637780	146	217	82	1	71	0.0140845
NODE_4675_length_1126_cov_21.360273	595	675	0	80	80	1.0000000
NODE_4675_length_1126_cov_21.360273	648	728	0	80	80	1.0000000
NODE_4676_length_1126_cov_17.420643	422	502	2	17	80	0.2125000
NODE_4676_length_1126_cov_17.420643	422	502	4	16	80	0.2000000
NODE_4676_length_1126_cov_17.420643	422	502	6	47	80	0.5875000
NODE_4676_length_1126_cov_17.420643	475	555	0	8	80	0.1000000
NODE_4676_length_1126_cov_17.420643	475	555	2	62	80	0.7750000
NODE_4676_length_1126_cov_17.420643	475	555	6	10	80	0.1250000
NODE_4677_length_1126_cov_15.896787	383	463	0	80	80	1.0000000
NODE_4677_length_1126_cov_15.896787	436	516	0	80	80	1.0000000
NODE_4678_length_1126_cov_8.525803	174	254	0	80	80	1.0000000
NODE_4678_length_1126_cov_8.525803	227	307	0	80	80	1.0000000
NODE_4679_length_1126_cov_5.805258	463	543	3	10	80	0.1250000
NODE_4679_length_1126_cov_5.805258	463	543	5	2	80	0.0250000
NODE_4679_length_1126_cov_5.805258	463	543	6	68	80	0.8500000
NODE_4679_length_1126_cov_5.805258	516	596	6	80	80	1.0000000
NODE_4685_length_1126_cov_1.502434	6	86	0	4	80	0.0500000
NODE_4685_length_1126_cov_1.502434	6	86	2	76	80	0.9500000
NODE_4685_length_1126_cov_1.502434	59	108	2	49	49	1.0000000
NODE_4689_length_1125_cov_34.314815	405	485	0	80	80	1.0000000
NODE_4689_length_1125_cov_34.314815	458	538	0	80	80	1.0000000
NODE_4689_length_1125_cov_34.314815	534	614	0	80	80	1.0000000
NODE_4689_length_1125_cov_34.314815	587	667	0	80	80	1.0000000
NODE_4690_length_1125_cov_33.553606	458	538	0	80	80	1.0000000
NODE_4690_length_1125_cov_33.553606	511	591	0	80	80	1.0000000
NODE_4690_length_1125_cov_33.553606	587	667	0	80	80	1.0000000
NODE_4690_length_1125_cov_33.553606	640	720	0	80	80	1.0000000
NODE_4691_length_1125_cov_33.371345	408	488	0	80	80	1.0000000
NODE_4691_length_1125_cov_33.371345	461	541	0	80	80	1.0000000
NODE_4691_length_1125_cov_33.371345	537	617	0	4	80	0.0500000
NODE_4691_length_1125_cov_33.371345	537	617	2	67	80	0.8375000
NODE_4691_length_1125_cov_33.371345	537	617	6	1	80	0.0125000
NODE_4691_length_1125_cov_33.371345	537	617	8	8	80	0.1000000
NODE_4691_length_1125_cov_33.371345	590	670	2	18	80	0.2250000
NODE_4691_length_1125_cov_33.371345	590	670	6	10	80	0.1250000
NODE_4691_length_1125_cov_33.371345	590	670	8	52	80	0.6500000
NODE_4692_length_1125_cov_22.580897	279	359	0	5	80	0.0625000
NODE_4692_length_1125_cov_22.580897	279	359	2	75	80	0.9375000
NODE_4692_length_1125_cov_22.580897	332	412	0	15	80	0.1875000
NODE_4692_length_1125_cov_22.580897	332	412	2	65	80	0.8125000
NODE_4692_length_1125_cov_22.580897	408	488	0	80	80	1.0000000
NODE_4692_length_1125_cov_22.580897	461	541	0	80	80	1.0000000
NODE_4705_length_1124_cov_52.278049	616	696	0	80	80	1.0000000
NODE_4705_length_1124_cov_52.278049	669	749	0	80	80	1.0000000
NODE_4706_length_1124_cov_25.280000	444	524	0	80	80	1.0000000
NODE_4706_length_1124_cov_25.280000	497	577	0	80	80	1.0000000
NODE_4706_length_1124_cov_25.280000	573	653	0	33	80	0.4125000
NODE_4706_length_1124_cov_25.280000	573	653	2	47	80	0.5875000
NODE_4706_length_1124_cov_25.280000	626	706	0	50	80	0.6250000
NODE_4706_length_1124_cov_25.280000	626	706	2	30	80	0.3750000
NODE_4707_length_1124_cov_18.700488	114	194	0	80	80	1.0000000
NODE_4707_length_1124_cov_18.700488	167	247	0	45	80	0.5625000
NODE_4707_length_1124_cov_18.700488	167	247	2	35	80	0.4375000
NODE_4717_length_1123_cov_26.445312	388	468	0	80	80	1.0000000
NODE_4717_length_1123_cov_26.445312	441	521	0	47	80	0.5875000
NODE_4717_length_1123_cov_26.445312	441	521	2	33	80	0.4125000
NODE_4717_length_1123_cov_26.445312	517	597	0	22	80	0.2750000
NODE_4717_length_1123_cov_26.445312	517	597	2	58	80	0.7250000
NODE_4717_length_1123_cov_26.445312	570	650	0	75	80	0.9375000
NODE_4717_length_1123_cov_26.445312	570	650	2	5	80	0.0625000
NODE_4718_length_1123_cov_18.677734	522	602	0	80	80	1.0000000
NODE_4718_length_1123_cov_18.677734	575	655	0	80	80	1.0000000
NODE_4718_length_1123_cov_18.677734	651	731	0	80	80	1.0000000
NODE_4718_length_1123_cov_18.677734	704	784	0	80	80	1.0000000
NODE_4728_length_1122_cov_38.688172	295	375	0	80	80	1.0000000
NODE_4728_length_1122_cov_38.688172	348	428	0	80	80	1.0000000
NODE_4728_length_1122_cov_38.688172	424	504	0	69	80	0.8625000
NODE_4728_length_1122_cov_38.688172	424	504	4	11	80	0.1375000
NODE_4728_length_1122_cov_38.688172	477	557	0	16	80	0.2000000
NODE_4728_length_1122_cov_38.688172	477	557	4	64	80	0.8000000
NODE_4729_length_1122_cov_32.827957	232	312	0	80	80	1.0000000
NODE_4729_length_1122_cov_32.827957	285	365	0	80	80	1.0000000
NODE_4729_length_1122_cov_32.827957	361	441	0	42	80	0.5250000
NODE_4729_length_1122_cov_32.827957	361	441	2	38	80	0.4750000
NODE_4729_length_1122_cov_32.827957	414	494	0	13	80	0.1625000
NODE_4729_length_1122_cov_32.827957	414	494	2	67	80	0.8375000
NODE_4730_length_1122_cov_12.574780	396	476	0	80	80	1.0000000
NODE_4730_length_1122_cov_12.574780	449	529	0	80	80	1.0000000
NODE_4730_length_1122_cov_12.574780	525	605	0	80	80	1.0000000
NODE_4730_length_1122_cov_12.574780	578	658	0	80	80	1.0000000
NODE_4731_length_1122_cov_8.582600	586	666	0	32	80	0.4000000
NODE_4731_length_1122_cov_8.582600	586	666	2	48	80	0.6000000
NODE_4731_length_1122_cov_8.582600	639	719	2	80	80	1.0000000
NODE_4733_length_1122_cov_3.714565	284	364	0	80	80	1.0000000
NODE_4733_length_1122_cov_3.714565	337	417	0	75	80	0.9375000
NODE_4733_length_1122_cov_3.714565	337	417	1	5	80	0.0625000
NODE_4738_length_1122_cov_1.757576	25	87	0	62	62	1.0000000
NODE_4742_length_1121_cov_39.595890	507	587	12	35	80	0.4375000
NODE_4742_length_1121_cov_39.595890	507	587	16	45	80	0.5625000
NODE_4742_length_1121_cov_39.595890	560	640	0	3	80	0.0375000
NODE_4742_length_1121_cov_39.595890	560	640	1	1	80	0.0125000
NODE_4742_length_1121_cov_39.595890	560	640	11	1	80	0.0125000
NODE_4742_length_1121_cov_39.595890	560	640	12	5	80	0.0625000
NODE_4742_length_1121_cov_39.595890	560	640	16	70	80	0.8750000
NODE_4742_length_1121_cov_39.595890	636	716	0	7	80	0.0875000
NODE_4742_length_1121_cov_39.595890	636	716	1	1	80	0.0125000
NODE_4742_length_1121_cov_39.595890	636	716	2	72	80	0.9000000
NODE_4742_length_1121_cov_39.595890	689	769	0	24	80	0.3000000
NODE_4742_length_1121_cov_39.595890	689	769	2	56	80	0.7000000
NODE_4743_length_1121_cov_23.832681	525	605	0	22	80	0.2750000
NODE_4743_length_1121_cov_23.832681	525	605	11	1	80	0.0125000
NODE_4743_length_1121_cov_23.832681	525	605	12	9	80	0.1125000
NODE_4743_length_1121_cov_23.832681	525	605	16	8	80	0.1000000
NODE_4743_length_1121_cov_23.832681	525	605	18	40	80	0.5000000
NODE_4743_length_1121_cov_23.832681	578	658	18	40	80	0.5000000
NODE_4743_length_1121_cov_23.832681	578	658	20	40	80	0.5000000
NODE_4744_length_1121_cov_18.033268	1	42	0	41	41	1.0000000
NODE_4744_length_1121_cov_18.033268	671	751	0	80	80	1.0000000
NODE_4744_length_1121_cov_18.033268	724	804	0	80	80	1.0000000
NODE_4745_length_1121_cov_8.633072	610	690	0	80	80	1.0000000
NODE_4745_length_1121_cov_8.633072	663	743	0	80	80	1.0000000
NODE_4751_length_1120_cov_34.281097	377	457	0	80	80	1.0000000
NODE_4751_length_1120_cov_34.281097	430	510	0	80	80	1.0000000
NODE_4751_length_1120_cov_34.281097	506	586	0	80	80	1.0000000
NODE_4751_length_1120_cov_34.281097	559	639	0	80	80	1.0000000
NODE_4752_length_1120_cov_31.468168	401	481	0	80	80	1.0000000
NODE_4752_length_1120_cov_31.468168	454	534	0	80	80	1.0000000
NODE_4752_length_1120_cov_31.468168	530	610	0	80	80	1.0000000
NODE_4752_length_1120_cov_31.468168	583	663	0	80	80	1.0000000
NODE_4753_length_1120_cov_28.182174	418	498	0	80	80	1.0000000
NODE_4753_length_1120_cov_28.182174	471	551	0	80	80	1.0000000
NODE_4754_length_1120_cov_25.423115	405	485	0	65	80	0.8125000
NODE_4754_length_1120_cov_25.423115	405	485	2	15	80	0.1875000
NODE_4754_length_1120_cov_25.423115	458	538	0	80	80	1.0000000
NODE_4754_length_1120_cov_25.423115	534	614	0	43	80	0.5375000
NODE_4754_length_1120_cov_25.423115	534	614	2	27	80	0.3375000
NODE_4754_length_1120_cov_25.423115	534	614	6	10	80	0.1250000
NODE_4754_length_1120_cov_25.423115	587	667	2	17	80	0.2125000
NODE_4754_length_1120_cov_25.423115	587	667	6	37	80	0.4625000
NODE_4754_length_1120_cov_25.423115	587	667	8	26	80	0.3250000
NODE_4755_length_1120_cov_24.441724	589	662	8	68	73	0.9315069
NODE_4755_length_1120_cov_24.441724	589	662	9	2	73	0.0273973
NODE_4755_length_1120_cov_24.441724	589	662	10	3	73	0.0410959
NODE_4755_length_1120_cov_24.441724	636	716	0	5	80	0.0625000
NODE_4755_length_1120_cov_24.441724	636	716	6	28	80	0.3500000
NODE_4755_length_1120_cov_24.441724	636	716	8	47	80	0.5875000
NODE_4756_length_1120_cov_18.966699	406	486	0	80	80	1.0000000
NODE_4756_length_1120_cov_18.966699	459	539	0	80	80	1.0000000
NODE_4757_length_1120_cov_16.136141	508	588	0	15	80	0.1875000
NODE_4757_length_1120_cov_16.136141	508	588	2	65	80	0.8125000
NODE_4757_length_1120_cov_16.136141	561	641	0	36	80	0.4500000
NODE_4757_length_1120_cov_16.136141	561	641	2	44	80	0.5500000
NODE_4758_length_1120_cov_15.492654	460	540	0	80	80	1.0000000
NODE_4758_length_1120_cov_15.492654	460	540	0	80	80	1.0000000
NODE_4758_length_1120_cov_15.492654	513	593	0	80	80	1.0000000
NODE_4759_length_1120_cov_8.696376	646	726	0	80	80	1.0000000
NODE_4759_length_1120_cov_8.696376	699	779	0	80	80	1.0000000
NODE_4760_length_1120_cov_7.916748	304	384	0	80	80	1.0000000
NODE_4760_length_1120_cov_7.916748	357	437	0	80	80	1.0000000
NODE_4772_length_1119_cov_32.617647	425	505	0	21	80	0.2625000
NODE_4772_length_1119_cov_32.617647	425	505	2	59	80	0.7375000
NODE_4772_length_1119_cov_32.617647	478	558	0	45	80	0.5625000
NODE_4772_length_1119_cov_32.617647	478	558	2	35	80	0.4375000
NODE_4773_length_1119_cov_24.944118	455	535	0	7	80	0.0875000
NODE_4773_length_1119_cov_24.944118	455	535	2	73	80	0.9125000
NODE_4773_length_1119_cov_24.944118	508	588	0	50	80	0.6250000
NODE_4773_length_1119_cov_24.944118	508	588	2	30	80	0.3750000
NODE_4774_length_1119_cov_22.214706	614	694	0	42	80	0.5250000
NODE_4774_length_1119_cov_22.214706	614	694	3	1	80	0.0125000
NODE_4774_length_1119_cov_22.214706	614	694	4	9	80	0.1125000
NODE_4774_length_1119_cov_22.214706	614	694	6	28	80	0.3500000
NODE_4774_length_1119_cov_22.214706	667	747	4	15	80	0.1875000
NODE_4774_length_1119_cov_22.214706	667	747	6	40	80	0.5000000
NODE_4774_length_1119_cov_22.214706	667	747	8	25	80	0.3125000
NODE_4775_length_1119_cov_21.115686	431	511	2	18	80	0.2250000
NODE_4775_length_1119_cov_21.115686	431	511	4	62	80	0.7750000
NODE_4775_length_1119_cov_21.115686	484	564	2	64	80	0.8000000
NODE_4775_length_1119_cov_21.115686	484	564	4	16	80	0.2000000
NODE_4777_length_1119_cov_11.895098	565	645	0	80	80	1.0000000
NODE_4777_length_1119_cov_11.895098	618	698	0	80	80	1.0000000
NODE_4782_length_1119_cov_2.783333	37	99	0	62	62	1.0000000
NODE_4789_length_1118_cov_35.214917	555	635	0	79	80	0.9875000
NODE_4789_length_1118_cov_35.214917	555	635	4	1	80	0.0125000
NODE_4789_length_1118_cov_35.214917	608	688	0	26	80	0.3250000
NODE_4789_length_1118_cov_35.214917	608	688	4	54	80	0.6750000
NODE_4789_length_1118_cov_35.214917	684	764	4	15	80	0.1875000
NODE_4789_length_1118_cov_35.214917	684	764	6	12	80	0.1500000
NODE_4789_length_1118_cov_35.214917	684	764	8	53	80	0.6625000
NODE_4789_length_1118_cov_35.214917	737	817	0	29	80	0.3625000
NODE_4789_length_1118_cov_35.214917	737	817	2	21	80	0.2625000
NODE_4789_length_1118_cov_35.214917	737	817	4	12	80	0.1500000
NODE_4789_length_1118_cov_35.214917	737	817	8	18	80	0.2250000
NODE_4790_length_1118_cov_23.114818	602	682	0	80	80	1.0000000
NODE_4790_length_1118_cov_23.114818	655	735	0	59	80	0.7375000
NODE_4790_length_1118_cov_23.114818	655	735	8	12	80	0.1500000
NODE_4790_length_1118_cov_23.114818	655	735	12	9	80	0.1125000
NODE_4790_length_1118_cov_23.114818	731	811	8	1	80	0.0125000
NODE_4790_length_1118_cov_23.114818	731	811	12	79	80	0.9875000
NODE_4790_length_1118_cov_23.114818	784	864	0	34	80	0.4250000
NODE_4790_length_1118_cov_23.114818	784	864	8	20	80	0.2500000
NODE_4790_length_1118_cov_23.114818	784	864	12	26	80	0.3250000
NODE_4791_length_1118_cov_18.293425	388	463	0	75	75	1.0000000
NODE_4791_length_1118_cov_18.293425	436	516	0	80	80	1.0000000
NODE_4791_length_1118_cov_18.293425	512	592	0	80	80	1.0000000
NODE_4791_length_1118_cov_18.293425	565	645	0	80	80	1.0000000
NODE_4792_length_1118_cov_17.228656	480	560	0	80	80	1.0000000
NODE_4792_length_1118_cov_17.228656	533	613	0	80	80	1.0000000
NODE_4794_length_1118_cov_14.299313	468	548	0	80	80	1.0000000
NODE_4794_length_1118_cov_14.299313	521	601	0	80	80	1.0000000
NODE_4795_length_1118_cov_10.203140	306	386	0	80	80	1.0000000
NODE_4795_length_1118_cov_10.203140	359	439	0	80	80	1.0000000
NODE_4795_length_1118_cov_10.203140	435	515	0	80	80	1.0000000
NODE_4795_length_1118_cov_10.203140	488	568	0	80	80	1.0000000
NODE_4796_length_1118_cov_2.885182	471	551	0	80	80	1.0000000
NODE_4796_length_1118_cov_2.885182	524	604	0	80	80	1.0000000
NODE_4805_length_1117_cov_19.425344	541	621	10	80	80	1.0000000
NODE_4805_length_1117_cov_19.425344	594	674	0	5	80	0.0625000
NODE_4805_length_1117_cov_19.425344	594	674	10	75	80	0.9375000
NODE_4806_length_1117_cov_16.386051	385	465	0	80	80	1.0000000
NODE_4806_length_1117_cov_16.386051	438	518	0	80	80	1.0000000
NODE_4807_length_1117_cov_10.353635	294	374	0	20	80	0.2500000
NODE_4807_length_1117_cov_10.353635	294	374	2	15	80	0.1875000
NODE_4807_length_1117_cov_10.353635	294	374	4	9	80	0.1125000
NODE_4807_length_1117_cov_10.353635	294	374	10	36	80	0.4500000
NODE_4807_length_1117_cov_10.353635	347	427	8	3	80	0.0375000
NODE_4807_length_1117_cov_10.353635	347	427	10	77	80	0.9625000
NODE_4808_length_1117_cov_7.492141	417	497	0	80	80	1.0000000
NODE_4808_length_1117_cov_7.492141	470	550	0	80	80	1.0000000
NODE_4812_length_1117_cov_3.225933	666	728	0	61	62	0.9838710
NODE_4812_length_1117_cov_3.225933	666	728	3	1	62	0.0161290
NODE_4819_length_1116_cov_30.106195	457	537	0	80	80	1.0000000
NODE_4819_length_1116_cov_30.106195	510	590	0	80	80	1.0000000
NODE_4820_length_1116_cov_25.518191	831	911	0	80	80	1.0000000
NODE_4820_length_1116_cov_25.518191	884	964	0	80	80	1.0000000
NODE_4821_length_1116_cov_20.629302	500	580	0	80	80	1.0000000
NODE_4821_length_1116_cov_20.629302	553	633	0	80	80	1.0000000
NODE_4822_length_1116_cov_16.723697	345	425	0	15	80	0.1875000
NODE_4822_length_1116_cov_16.723697	345	425	2	65	80	0.8125000
NODE_4822_length_1116_cov_16.723697	398	478	0	49	80	0.6125000
NODE_4822_length_1116_cov_16.723697	398	478	2	31	80	0.3875000
NODE_4823_length_1116_cov_16.046214	735	815	0	80	80	1.0000000
NODE_4823_length_1116_cov_16.046214	788	868	0	80	80	1.0000000
NODE_4828_length_1116_cov_1.379548	800	880	0	80	80	1.0000000
NODE_4828_length_1116_cov_1.379548	853	933	0	80	80	1.0000000
NODE_4832_length_1115_cov_30.584646	549	629	0	6	80	0.0750000
NODE_4832_length_1115_cov_30.584646	549	629	2	29	80	0.3625000
NODE_4832_length_1115_cov_30.584646	549	629	4	10	80	0.1250000
NODE_4832_length_1115_cov_30.584646	549	629	8	2	80	0.0250000
NODE_4832_length_1115_cov_30.584646	549	629	18	33	80	0.4125000
NODE_4832_length_1115_cov_30.584646	602	682	12	16	80	0.2000000
NODE_4832_length_1115_cov_30.584646	602	682	16	6	80	0.0750000
NODE_4832_length_1115_cov_30.584646	602	682	18	46	80	0.5750000
NODE_4832_length_1115_cov_30.584646	602	682	20	12	80	0.1500000
NODE_4833_length_1115_cov_15.871063	454	534	0	80	80	1.0000000
NODE_4833_length_1115_cov_15.871063	507	587	0	80	80	1.0000000
NODE_4833_length_1115_cov_15.871063	583	663	0	80	80	1.0000000
NODE_4833_length_1115_cov_15.871063	636	716	0	80	80	1.0000000
NODE_4840_length_1114_cov_20.633498	1034	1114	0	80	80	1.0000000
NODE_4840_length_1114_cov_20.633498	1034	1114	0	80	80	1.0000000
NODE_4840_length_1114_cov_20.633498	1034	1114	0	80	80	1.0000000
NODE_4840_length_1114_cov_20.633498	1034	1114	0	80	80	1.0000000
NODE_4840_length_1114_cov_20.633498	1034	1114	0	80	80	1.0000000
NODE_4840_length_1114_cov_20.633498	1043	1114	0	71	71	1.0000000
NODE_4841_length_1114_cov_17.383251	516	601	0	85	85	1.0000000
NODE_4841_length_1114_cov_17.383251	574	653	0	79	79	1.0000000
NODE_4841_length_1114_cov_17.383251	649	729	0	80	80	1.0000000
NODE_4841_length_1114_cov_17.383251	702	782	0	80	80	1.0000000
NODE_4842_length_1114_cov_5.562562	563	643	0	80	80	1.0000000
NODE_4842_length_1114_cov_5.562562	616	696	0	80	80	1.0000000
NODE_4847_length_1113_cov_51.988166	343	423	0	80	80	1.0000000
NODE_4847_length_1113_cov_51.988166	396	476	0	80	80	1.0000000
NODE_4847_length_1113_cov_51.988166	472	552	0	80	80	1.0000000
NODE_4847_length_1113_cov_51.988166	525	605	0	80	80	1.0000000
NODE_4848_length_1113_cov_35.005917	359	439	0	80	80	1.0000000
NODE_4848_length_1113_cov_35.005917	412	492	0	80	80	1.0000000
NODE_4849_length_1113_cov_28.106509	570	650	2	13	80	0.1625000
NODE_4849_length_1113_cov_28.106509	570	650	4	67	80	0.8375000
NODE_4849_length_1113_cov_28.106509	623	703	0	30	80	0.3750000
NODE_4849_length_1113_cov_28.106509	623	703	2	3	80	0.0375000
NODE_4849_length_1113_cov_28.106509	623	703	4	47	80	0.5875000
NODE_4849_length_1113_cov_28.106509	699	779	0	21	80	0.2625000
NODE_4849_length_1113_cov_28.106509	699	779	2	59	80	0.7375000
NODE_4849_length_1113_cov_28.106509	752	832	0	24	80	0.3000000
NODE_4849_length_1113_cov_28.106509	752	832	2	56	80	0.7000000
NODE_4850_length_1113_cov_18.636095	512	592	0	80	80	1.0000000
NODE_4850_length_1113_cov_18.636095	565	645	0	80	80	1.0000000
NODE_4851_length_1113_cov_16.664694	352	432	0	80	80	1.0000000
NODE_4851_length_1113_cov_16.664694	405	485	0	78	80	0.9750000
NODE_4851_length_1113_cov_16.664694	405	485	2	2	80	0.0250000
NODE_4851_length_1113_cov_16.664694	481	561	0	2	80	0.0250000
NODE_4851_length_1113_cov_16.664694	481	561	2	78	80	0.9750000
NODE_4851_length_1113_cov_16.664694	534	614	0	33	80	0.4125000
NODE_4851_length_1113_cov_16.664694	534	614	2	47	80	0.5875000
NODE_4852_length_1113_cov_14.155819	454	512	0	58	58	1.0000000
NODE_4852_length_1113_cov_14.155819	511	575	0	64	64	1.0000000
NODE_4853_length_1113_cov_10.185404	494	574	0	80	80	1.0000000
NODE_4853_length_1113_cov_10.185404	547	627	0	70	80	0.8750000
NODE_4853_length_1113_cov_10.185404	547	627	1	10	80	0.1250000
NODE_4855_length_1113_cov_4.005917	700	780	2	27	80	0.3375000
NODE_4855_length_1113_cov_4.005917	700	780	4	5	80	0.0625000
NODE_4855_length_1113_cov_4.005917	700	780	6	32	80	0.4000000
NODE_4855_length_1113_cov_4.005917	700	780	8	2	80	0.0250000
NODE_4855_length_1113_cov_4.005917	700	780	10	14	80	0.1750000
NODE_4855_length_1113_cov_4.005917	753	833	2	61	80	0.7625000
NODE_4855_length_1113_cov_4.005917	753	833	4	19	80	0.2375000
NODE_4866_length_1112_cov_14.961500	427	507	0	6	80	0.0750000
NODE_4866_length_1112_cov_14.961500	427	507	4	4	80	0.0500000
NODE_4866_length_1112_cov_14.961500	427	507	12	70	80	0.8750000
NODE_4866_length_1112_cov_14.961500	480	560	0	2	80	0.0250000
NODE_4866_length_1112_cov_14.961500	480	560	5	1	80	0.0125000
NODE_4866_length_1112_cov_14.961500	480	560	6	39	80	0.4875000
NODE_4866_length_1112_cov_14.961500	480	560	8	6	80	0.0750000
NODE_4866_length_1112_cov_14.961500	480	560	12	32	80	0.4000000
NODE_4866_length_1112_cov_14.961500	556	636	0	78	80	0.9750000
NODE_4866_length_1112_cov_14.961500	556	636	5	1	80	0.0125000
NODE_4866_length_1112_cov_14.961500	556	636	6	1	80	0.0125000
NODE_4866_length_1112_cov_14.961500	609	689	0	80	80	1.0000000
NODE_4875_length_1112_cov_1.655479	45	123	0	13	78	0.1666667
NODE_4875_length_1112_cov_1.655479	45	123	2	65	78	0.8333333
NODE_4875_length_1112_cov_1.655479	98	166	0	56	68	0.8235294
NODE_4875_length_1112_cov_1.655479	98	166	2	12	68	0.1764706
NODE_4880_length_1111_cov_37.999012	473	553	0	80	80	1.0000000
NODE_4880_length_1111_cov_37.999012	526	606	0	80	80	1.0000000
NODE_4880_length_1111_cov_37.999012	602	682	0	80	80	1.0000000
NODE_4880_length_1111_cov_37.999012	655	735	0	80	80	1.0000000
NODE_4881_length_1111_cov_24.394269	644	724	0	4	80	0.0500000
NODE_4881_length_1111_cov_24.394269	644	724	1	13	80	0.1625000
NODE_4881_length_1111_cov_24.394269	644	724	2	55	80	0.6875000
NODE_4881_length_1111_cov_24.394269	644	724	4	8	80	0.1000000
NODE_4881_length_1111_cov_24.394269	697	777	2	19	80	0.2375000
NODE_4881_length_1111_cov_24.394269	697	777	4	61	80	0.7625000
NODE_4882_length_1111_cov_23.676877	374	454	0	80	80	1.0000000
NODE_4882_length_1111_cov_23.676877	427	507	0	80	80	1.0000000
NODE_4883_length_1111_cov_17.522727	383	463	0	80	80	1.0000000
NODE_4883_length_1111_cov_17.522727	436	516	0	80	80	1.0000000
NODE_4884_length_1111_cov_16.495059	388	468	0	80	80	1.0000000
NODE_4884_length_1111_cov_16.495059	441	521	0	80	80	1.0000000
NODE_4885_length_1111_cov_15.366601	555	635	0	47	80	0.5875000
NODE_4885_length_1111_cov_15.366601	555	635	4	1	80	0.0125000
NODE_4885_length_1111_cov_15.366601	555	635	5	11	80	0.1375000
NODE_4885_length_1111_cov_15.366601	555	635	6	21	80	0.2625000
NODE_4885_length_1111_cov_15.366601	608	688	5	6	80	0.0750000
NODE_4885_length_1111_cov_15.366601	608	688	6	74	80	0.9250000
NODE_4886_length_1111_cov_15.314229	809	889	0	80	80	1.0000000
NODE_4886_length_1111_cov_15.314229	862	942	0	80	80	1.0000000
NODE_4887_length_1111_cov_9.732213	443	523	0	65	80	0.8125000
NODE_4887_length_1111_cov_9.732213	443	523	2	15	80	0.1875000
NODE_4887_length_1111_cov_9.732213	496	576	0	12	80	0.1500000
NODE_4887_length_1111_cov_9.732213	496	576	2	68	80	0.8500000
NODE_4888_length_1111_cov_4.907115	606	686	2	80	80	1.0000000
NODE_4888_length_1111_cov_4.907115	659	739	0	19	80	0.2375000
NODE_4888_length_1111_cov_4.907115	659	739	2	61	80	0.7625000
NODE_4892_length_1110_cov_23.012859	453	533	0	24	80	0.3000000
NODE_4892_length_1110_cov_23.012859	453	533	2	2	80	0.0250000
NODE_4892_length_1110_cov_23.012859	453	533	4	1	80	0.0125000
NODE_4892_length_1110_cov_23.012859	453	533	6	6	80	0.0750000
NODE_4892_length_1110_cov_23.012859	453	533	8	47	80	0.5875000
NODE_4892_length_1110_cov_23.012859	506	586	0	2	80	0.0250000
NODE_4892_length_1110_cov_23.012859	506	586	2	11	80	0.1375000
NODE_4892_length_1110_cov_23.012859	506	586	4	2	80	0.0250000
NODE_4892_length_1110_cov_23.012859	506	586	6	3	80	0.0375000
NODE_4892_length_1110_cov_23.012859	506	586	8	62	80	0.7750000
NODE_4892_length_1110_cov_23.012859	582	662	0	78	80	0.9750000
NODE_4892_length_1110_cov_23.012859	582	662	2	2	80	0.0250000
NODE_4892_length_1110_cov_23.012859	635	715	0	80	80	1.0000000
NODE_4895_length_1110_cov_5.305638	754	834	0	80	80	1.0000000
NODE_4895_length_1110_cov_5.305638	807	887	0	80	80	1.0000000
NODE_4896_length_1110_cov_3.698318	642	685	0	43	43	1.0000000
NODE_4899_length_1110_cov_1.871414	15	86	8	59	71	0.8309859
NODE_4899_length_1110_cov_1.871414	15	86	10	1	71	0.0140845
NODE_4899_length_1110_cov_1.871414	15	86	12	1	71	0.0140845
NODE_4899_length_1110_cov_1.871414	15	86	18	5	71	0.0704225
NODE_4899_length_1110_cov_1.871414	15	86	22	3	71	0.0422535
NODE_4899_length_1110_cov_1.871414	15	86	24	2	71	0.0281690
NODE_4903_length_1109_cov_35.307921	413	493	0	65	80	0.8125000
NODE_4903_length_1109_cov_35.307921	413	493	4	15	80	0.1875000
NODE_4903_length_1109_cov_35.307921	466	546	0	12	80	0.1500000
NODE_4903_length_1109_cov_35.307921	466	546	4	68	80	0.8500000
NODE_4903_length_1109_cov_35.307921	542	622	0	46	80	0.5750000
NODE_4903_length_1109_cov_35.307921	542	622	4	34	80	0.4250000
NODE_4903_length_1109_cov_35.307921	595	675	0	56	80	0.7000000
NODE_4903_length_1109_cov_35.307921	595	675	2	24	80	0.3000000
NODE_4904_length_1109_cov_27.880198	501	581	0	80	80	1.0000000
NODE_4904_length_1109_cov_27.880198	554	634	0	80	80	1.0000000
NODE_4904_length_1109_cov_27.880198	630	710	0	80	80	1.0000000
NODE_4904_length_1109_cov_27.880198	683	763	0	80	80	1.0000000
NODE_4905_length_1109_cov_21.858416	571	651	0	80	80	1.0000000
NODE_4905_length_1109_cov_21.858416	624	704	0	80	80	1.0000000
NODE_4912_length_1108_cov_59.921705	386	466	2	53	80	0.6625000
NODE_4912_length_1108_cov_59.921705	386	466	4	27	80	0.3375000
NODE_4912_length_1108_cov_59.921705	439	519	4	80	80	1.0000000
NODE_4912_length_1108_cov_59.921705	515	595	0	5	80	0.0625000
NODE_4912_length_1108_cov_59.921705	515	595	4	75	80	0.9375000
NODE_4912_length_1108_cov_59.921705	568	648	0	30	80	0.3750000
NODE_4912_length_1108_cov_59.921705	568	648	4	50	80	0.6250000
NODE_4914_length_1108_cov_16.069376	513	593	0	80	80	1.0000000
NODE_4914_length_1108_cov_16.069376	566	646	0	80	80	1.0000000
NODE_4916_length_1108_cov_11.656095	333	413	0	49	80	0.6125000
NODE_4916_length_1108_cov_11.656095	333	413	2	31	80	0.3875000
NODE_4916_length_1108_cov_11.656095	386	466	0	29	80	0.3625000
NODE_4916_length_1108_cov_11.656095	386	466	2	51	80	0.6375000
NODE_4917_length_1108_cov_10.266601	431	511	6	68	80	0.8500000
NODE_4917_length_1108_cov_10.266601	431	511	7	5	80	0.0625000
NODE_4917_length_1108_cov_10.266601	431	511	8	7	80	0.0875000
NODE_4917_length_1108_cov_10.266601	484	564	2	38	80	0.4750000
NODE_4917_length_1108_cov_10.266601	484	564	4	11	80	0.1375000
NODE_4917_length_1108_cov_10.266601	484	564	6	31	80	0.3875000
NODE_4918_length_1108_cov_8.895937	635	715	0	80	80	1.0000000
NODE_4918_length_1108_cov_8.895937	688	768	0	80	80	1.0000000
NODE_4920_length_1108_cov_5.682854	577	657	4	59	80	0.7375000
NODE_4920_length_1108_cov_5.682854	577	657	6	21	80	0.2625000
NODE_4920_length_1108_cov_5.682854	630	710	2	51	80	0.6375000
NODE_4920_length_1108_cov_5.682854	630	710	4	7	80	0.0875000
NODE_4920_length_1108_cov_5.682854	630	710	6	22	80	0.2750000
NODE_4927_length_1107_cov_35.050595	423	503	2	76	80	0.9500000
NODE_4927_length_1107_cov_35.050595	423	503	4	4	80	0.0500000
NODE_4927_length_1107_cov_35.050595	476	556	2	80	80	1.0000000
NODE_4927_length_1107_cov_35.050595	552	632	0	25	80	0.3125000
NODE_4927_length_1107_cov_35.050595	552	632	2	55	80	0.6875000
NODE_4927_length_1107_cov_35.050595	605	685	0	78	80	0.9750000
NODE_4927_length_1107_cov_35.050595	605	685	2	2	80	0.0250000
NODE_4928_length_1107_cov_31.386905	422	502	0	54	80	0.6750000
NODE_4928_length_1107_cov_31.386905	422	502	2	26	80	0.3250000
NODE_4928_length_1107_cov_31.386905	475	555	0	1	80	0.0125000
NODE_4928_length_1107_cov_31.386905	475	555	2	79	80	0.9875000
NODE_4929_length_1107_cov_29.178571	577	657	0	27	80	0.3375000
NODE_4929_length_1107_cov_29.178571	577	657	4	53	80	0.6625000
NODE_4929_length_1107_cov_29.178571	630	710	0	80	80	1.0000000
NODE_4929_length_1107_cov_29.178571	934	1000	0	66	66	1.0000000
NODE_4929_length_1107_cov_29.178571	934	1005	0	71	71	1.0000000
NODE_4930_length_1107_cov_16.038690	574	654	0	80	80	1.0000000
NODE_4930_length_1107_cov_16.038690	627	707	0	80	80	1.0000000
NODE_4931_length_1107_cov_15.472222	78	158	90	1	80	0.0125000
NODE_4931_length_1107_cov_15.472222	78	158	92	3	80	0.0375000
NODE_4931_length_1107_cov_15.472222	78	158	93	1	80	0.0125000
NODE_4931_length_1107_cov_15.472222	78	158	97	1	80	0.0125000
NODE_4931_length_1107_cov_15.472222	78	158	98	1	80	0.0125000
NODE_4931_length_1107_cov_15.472222	78	158	113	2	80	0.0250000
NODE_4931_length_1107_cov_15.472222	78	158	121	5	80	0.0625000
NODE_4931_length_1107_cov_15.472222	78	158	129	1	80	0.0125000
NODE_4931_length_1107_cov_15.472222	78	158	131	5	80	0.0625000
NODE_4931_length_1107_cov_15.472222	78	158	133	2	80	0.0250000
NODE_4931_length_1107_cov_15.472222	78	158	137	1	80	0.0125000
NODE_4931_length_1107_cov_15.472222	78	158	139	3	80	0.0375000
NODE_4931_length_1107_cov_15.472222	78	158	143	6	80	0.0750000
NODE_4931_length_1107_cov_15.472222	78	158	145	8	80	0.1000000
NODE_4931_length_1107_cov_15.472222	78	158	147	2	80	0.0250000
NODE_4931_length_1107_cov_15.472222	78	158	149	1	80	0.0125000
NODE_4931_length_1107_cov_15.472222	78	158	156	2	80	0.0250000
NODE_4931_length_1107_cov_15.472222	78	158	157	1	80	0.0125000
NODE_4931_length_1107_cov_15.472222	78	158	158	2	80	0.0250000
NODE_4931_length_1107_cov_15.472222	78	158	159	1	80	0.0125000
NODE_4931_length_1107_cov_15.472222	78	158	163	2	80	0.0250000
NODE_4931_length_1107_cov_15.472222	78	158	164	1	80	0.0125000
NODE_4931_length_1107_cov_15.472222	78	158	165	2	80	0.0250000
NODE_4931_length_1107_cov_15.472222	78	158	166	1	80	0.0125000
NODE_4931_length_1107_cov_15.472222	78	158	167	1	80	0.0125000
NODE_4931_length_1107_cov_15.472222	78	158	170	2	80	0.0250000
NODE_4931_length_1107_cov_15.472222	78	158	172	3	80	0.0375000
NODE_4931_length_1107_cov_15.472222	78	158	173	3	80	0.0375000
NODE_4931_length_1107_cov_15.472222	78	158	174	5	80	0.0625000
NODE_4931_length_1107_cov_15.472222	78	158	176	11	80	0.1375000
NODE_4931_length_1107_cov_15.472222	131	194	20	3	63	0.0476190
NODE_4931_length_1107_cov_15.472222	131	194	22	2	63	0.0317460
NODE_4931_length_1107_cov_15.472222	131	194	27	3	63	0.0476190
NODE_4931_length_1107_cov_15.472222	131	194	28	1	63	0.0158730
NODE_4931_length_1107_cov_15.472222	131	194	34	1	63	0.0158730
NODE_4931_length_1107_cov_15.472222	131	194	39	1	63	0.0158730
NODE_4931_length_1107_cov_15.472222	131	194	47	3	63	0.0476190
NODE_4931_length_1107_cov_15.472222	131	194	49	4	63	0.0634921
NODE_4931_length_1107_cov_15.472222	131	194	51	2	63	0.0317460
NODE_4931_length_1107_cov_15.472222	131	194	53	2	63	0.0317460
NODE_4931_length_1107_cov_15.472222	131	194	55	2	63	0.0317460
NODE_4931_length_1107_cov_15.472222	131	194	59	2	63	0.0317460
NODE_4931_length_1107_cov_15.472222	131	194	61	1	63	0.0158730
NODE_4931_length_1107_cov_15.472222	131	194	63	1	63	0.0158730
NODE_4931_length_1107_cov_15.472222	131	194	65	1	63	0.0158730
NODE_4931_length_1107_cov_15.472222	131	194	81	2	63	0.0317460
NODE_4931_length_1107_cov_15.472222	131	194	88	1	63	0.0158730
NODE_4931_length_1107_cov_15.472222	131	194	90	5	63	0.0793651
NODE_4931_length_1107_cov_15.472222	131	194	92	3	63	0.0476190
NODE_4931_length_1107_cov_15.472222	131	194	93	1	63	0.0158730
NODE_4931_length_1107_cov_15.472222	131	194	97	1	63	0.0158730
NODE_4931_length_1107_cov_15.472222	131	194	98	1	63	0.0158730
NODE_4931_length_1107_cov_15.472222	131	194	113	2	63	0.0317460
NODE_4931_length_1107_cov_15.472222	131	194	121	5	63	0.0793651
NODE_4931_length_1107_cov_15.472222	131	194	129	1	63	0.0158730
NODE_4931_length_1107_cov_15.472222	131	194	131	5	63	0.0793651
NODE_4931_length_1107_cov_15.472222	131	194	133	2	63	0.0317460
NODE_4931_length_1107_cov_15.472222	131	194	137	1	63	0.0158730
NODE_4931_length_1107_cov_15.472222	131	194	139	3	63	0.0476190
NODE_4931_length_1107_cov_15.472222	131	194	143	1	63	0.0158730
NODE_4931_length_1107_cov_15.472222	952	995	0	15	43	0.3488372
NODE_4931_length_1107_cov_15.472222	952	995	1	2	43	0.0465116
NODE_4931_length_1107_cov_15.472222	952	995	2	24	43	0.5581396
NODE_4931_length_1107_cov_15.472222	952	995	4	2	43	0.0465116
NODE_4931_length_1107_cov_15.472222	968	1052	0	1	84	0.0119048
NODE_4931_length_1107_cov_15.472222	968	1052	2	24	84	0.2857143
NODE_4931_length_1107_cov_15.472222	968	1052	4	2	84	0.0238095
NODE_4931_length_1107_cov_15.472222	968	1052	6	9	84	0.1071429
NODE_4931_length_1107_cov_15.472222	968	1052	8	9	84	0.1071429
NODE_4931_length_1107_cov_15.472222	968	1052	10	39	84	0.4642857
NODE_4932_length_1107_cov_13.911706	502	582	0	73	80	0.9125000
NODE_4932_length_1107_cov_13.911706	502	582	2	7	80	0.0875000
NODE_4932_length_1107_cov_13.911706	555	635	0	20	80	0.2500000
NODE_4932_length_1107_cov_13.911706	555	635	2	7	80	0.0875000
NODE_4932_length_1107_cov_13.911706	555	635	4	53	80	0.6625000
NODE_4933_length_1107_cov_11.701389	520	600	0	80	80	1.0000000
NODE_4933_length_1107_cov_11.701389	573	653	0	80	80	1.0000000
NODE_4944_length_1106_cov_59.617676	452	532	2	80	80	1.0000000
NODE_4944_length_1106_cov_59.617676	505	585	0	33	80	0.4125000
NODE_4944_length_1106_cov_59.617676	505	585	2	47	80	0.5875000
NODE_4944_length_1106_cov_59.617676	581	661	0	80	80	1.0000000
NODE_4944_length_1106_cov_59.617676	634	714	0	80	80	1.0000000
NODE_4945_length_1106_cov_40.808342	439	504	0	65	65	1.0000000
NODE_4945_length_1106_cov_40.808342	471	511	0	40	40	1.0000000
NODE_4945_length_1106_cov_40.808342	503	569	0	66	66	1.0000000
NODE_4945_length_1106_cov_40.808342	536	601	0	65	65	1.0000000
NODE_4945_length_1106_cov_40.808342	568	648	0	80	80	1.0000000
NODE_4945_length_1106_cov_40.808342	621	682	0	61	61	1.0000000
NODE_4946_length_1106_cov_23.186693	560	640	0	80	80	1.0000000
NODE_4946_length_1106_cov_23.186693	613	693	0	80	80	1.0000000
NODE_4947_length_1106_cov_14.570010	466	546	0	80	80	1.0000000
NODE_4947_length_1106_cov_14.570010	519	599	0	80	80	1.0000000
NODE_4948_length_1106_cov_14.039722	487	567	0	80	80	1.0000000
NODE_4948_length_1106_cov_14.039722	540	620	0	80	80	1.0000000
NODE_4949_length_1106_cov_8.872890	328	408	0	25	80	0.3125000
NODE_4949_length_1106_cov_8.872890	328	408	2	55	80	0.6875000
NODE_4949_length_1106_cov_8.872890	381	461	2	80	80	1.0000000
NODE_4950_length_1106_cov_7.157895	332	412	0	80	80	1.0000000
NODE_4950_length_1106_cov_7.157895	385	465	0	80	80	1.0000000
NODE_4951_length_1106_cov_6.530288	513	593	0	80	80	1.0000000
NODE_4951_length_1106_cov_6.530288	566	646	0	80	80	1.0000000
NODE_4959_length_1105_cov_28.126243	253	333	0	80	80	1.0000000
NODE_4959_length_1105_cov_28.126243	306	386	0	80	80	1.0000000
NODE_4960_length_1105_cov_24.994036	549	629	0	80	80	1.0000000
NODE_4960_length_1105_cov_24.994036	602	682	0	80	80	1.0000000
NODE_4961_length_1105_cov_17.635189	442	522	2	17	80	0.2125000
NODE_4961_length_1105_cov_17.635189	442	522	8	40	80	0.5000000
NODE_4961_length_1105_cov_17.635189	442	522	10	23	80	0.2875000
NODE_4961_length_1105_cov_17.635189	495	575	8	80	80	1.0000000
NODE_4963_length_1105_cov_10.114314	438	518	0	80	80	1.0000000
NODE_4963_length_1105_cov_10.114314	491	571	0	80	80	1.0000000
NODE_4964_length_1105_cov_8.403579	507	587	0	80	80	1.0000000
NODE_4964_length_1105_cov_8.403579	560	640	0	80	80	1.0000000
NODE_4966_length_1105_cov_6.682903	467	547	0	80	80	1.0000000
NODE_4966_length_1105_cov_6.682903	520	600	0	80	80	1.0000000
NODE_4966_length_1105_cov_6.682903	596	676	0	29	80	0.3625000
NODE_4966_length_1105_cov_6.682903	596	676	2	51	80	0.6375000
NODE_4966_length_1105_cov_6.682903	649	729	2	80	80	1.0000000
NODE_4974_length_1104_cov_27.599005	388	468	0	27	80	0.3375000
NODE_4974_length_1104_cov_27.599005	388	468	2	53	80	0.6625000
NODE_4974_length_1104_cov_27.599005	441	521	2	80	80	1.0000000
NODE_4984_length_1103_cov_2.787849	620	682	0	62	62	1.0000000
NODE_4986_length_1102_cov_34.484546	667	747	2	49	80	0.6125000
NODE_4986_length_1102_cov_34.484546	667	747	4	31	80	0.3875000
NODE_4986_length_1102_cov_34.484546	720	800	0	34	80	0.4250000
NODE_4986_length_1102_cov_34.484546	720	800	2	30	80	0.3750000
NODE_4986_length_1102_cov_34.484546	720	800	4	16	80	0.2000000
NODE_4987_length_1102_cov_17.631107	511	587	0	76	76	1.0000000
NODE_4987_length_1102_cov_17.631107	560	640	0	80	80	1.0000000
NODE_4998_length_1101_cov_35.638723	414	491	0	73	77	0.9480519
NODE_4998_length_1101_cov_35.638723	414	491	4	4	77	0.0519481
NODE_4998_length_1101_cov_35.638723	414	491	0	73	77	0.9480519
NODE_4998_length_1101_cov_35.638723	414	491	4	4	77	0.0519481
NODE_4998_length_1101_cov_35.638723	488	544	4	56	56	1.0000000
NODE_4998_length_1101_cov_35.638723	752	832	4	4	80	0.0500000
NODE_4998_length_1101_cov_35.638723	752	832	10	21	80	0.2625000
NODE_4998_length_1101_cov_35.638723	752	832	11	22	80	0.2750000
NODE_4998_length_1101_cov_35.638723	752	832	12	33	80	0.4125000
NODE_4998_length_1101_cov_35.638723	805	885	2	11	80	0.1375000
NODE_4998_length_1101_cov_35.638723	805	885	4	46	80	0.5750000
NODE_4998_length_1101_cov_35.638723	805	885	12	23	80	0.2875000
NODE_4998_length_1101_cov_35.638723	881	961	1	50	80	0.6250000
NODE_4998_length_1101_cov_35.638723	881	961	2	30	80	0.3750000
NODE_4998_length_1101_cov_35.638723	934	1014	1	14	80	0.1750000
NODE_4998_length_1101_cov_35.638723	934	1014	2	41	80	0.5125000
NODE_4998_length_1101_cov_35.638723	934	1014	3	25	80	0.3125000
NODE_4999_length_1101_cov_28.366267	452	532	0	80	80	1.0000000
NODE_4999_length_1101_cov_28.366267	505	585	0	80	80	1.0000000
NODE_5000_length_1101_cov_24.513972	475	555	0	3	80	0.0375000
NODE_5000_length_1101_cov_24.513972	475	555	3	37	80	0.4625000
NODE_5000_length_1101_cov_24.513972	475	555	6	40	80	0.5000000
NODE_5000_length_1101_cov_24.513972	528	608	6	80	80	1.0000000
NODE_5001_length_1101_cov_22.315369	335	415	0	11	80	0.1375000
NODE_5001_length_1101_cov_22.315369	335	415	2	48	80	0.6000000
NODE_5001_length_1101_cov_22.315369	335	415	4	21	80	0.2625000
NODE_5001_length_1101_cov_22.315369	388	468	2	53	80	0.6625000
NODE_5001_length_1101_cov_22.315369	388	468	4	27	80	0.3375000
NODE_5001_length_1101_cov_22.315369	464	544	0	17	80	0.2125000
NODE_5001_length_1101_cov_22.315369	464	544	2	39	80	0.4875000
NODE_5001_length_1101_cov_22.315369	464	544	4	24	80	0.3000000
NODE_5001_length_1101_cov_22.315369	517	597	0	14	80	0.1750000
NODE_5001_length_1101_cov_22.315369	517	597	2	3	80	0.0375000
NODE_5001_length_1101_cov_22.315369	517	597	4	63	80	0.7875000
NODE_5002_length_1101_cov_22.070858	419	499	0	20	80	0.2500000
NODE_5002_length_1101_cov_22.070858	419	499	4	60	80	0.7500000
NODE_5002_length_1101_cov_22.070858	472	552	4	80	80	1.0000000
NODE_5002_length_1101_cov_22.070858	548	628	0	75	80	0.9375000
NODE_5002_length_1101_cov_22.070858	548	628	4	5	80	0.0625000
NODE_5002_length_1101_cov_22.070858	601	681	0	80	80	1.0000000
NODE_5003_length_1101_cov_18.821357	469	549	0	80	80	1.0000000
NODE_5003_length_1101_cov_18.821357	522	602	0	80	80	1.0000000
NODE_5004_length_1101_cov_17.151697	502	582	0	30	80	0.3750000
NODE_5004_length_1101_cov_17.151697	502	582	2	50	80	0.6250000
NODE_5004_length_1101_cov_17.151697	555	635	0	28	80	0.3500000
NODE_5004_length_1101_cov_17.151697	555	635	2	52	80	0.6500000
NODE_5005_length_1101_cov_8.371257	968	1048	25	1	80	0.0125000
NODE_5005_length_1101_cov_8.371257	968	1048	42	2	80	0.0250000
NODE_5005_length_1101_cov_8.371257	968	1048	43	1	80	0.0125000
NODE_5005_length_1101_cov_8.371257	968	1048	48	1	80	0.0125000
NODE_5005_length_1101_cov_8.371257	968	1048	52	3	80	0.0375000
NODE_5005_length_1101_cov_8.371257	968	1048	54	1	80	0.0125000
NODE_5005_length_1101_cov_8.371257	968	1048	58	4	80	0.0500000
NODE_5005_length_1101_cov_8.371257	968	1048	60	3	80	0.0375000
NODE_5005_length_1101_cov_8.371257	968	1048	62	1	80	0.0125000
NODE_5005_length_1101_cov_8.371257	968	1048	64	1	80	0.0125000
NODE_5005_length_1101_cov_8.371257	968	1048	66	2	80	0.0250000
NODE_5005_length_1101_cov_8.371257	968	1048	68	3	80	0.0375000
NODE_5005_length_1101_cov_8.371257	968	1048	70	1	80	0.0125000
NODE_5005_length_1101_cov_8.371257	968	1048	72	1	80	0.0125000
NODE_5005_length_1101_cov_8.371257	968	1048	74	1	80	0.0125000
NODE_5005_length_1101_cov_8.371257	968	1048	76	3	80	0.0375000
NODE_5005_length_1101_cov_8.371257	968	1048	78	51	80	0.6375000
NODE_5010_length_1100_cov_42.528472	582	662	0	67	80	0.8375000
NODE_5010_length_1100_cov_42.528472	582	662	2	13	80	0.1625000
NODE_5010_length_1100_cov_42.528472	635	715	0	14	80	0.1750000
NODE_5010_length_1100_cov_42.528472	635	715	2	66	80	0.8250000
NODE_5010_length_1100_cov_42.528472	711	791	0	54	80	0.6750000
NODE_5010_length_1100_cov_42.528472	711	791	2	26	80	0.3250000
NODE_5010_length_1100_cov_42.528472	764	844	0	80	80	1.0000000
NODE_5011_length_1100_cov_40.883117	324	404	0	80	80	1.0000000
NODE_5011_length_1100_cov_40.883117	377	457	0	80	80	1.0000000
NODE_5011_length_1100_cov_40.883117	453	533	0	13	80	0.1625000
NODE_5011_length_1100_cov_40.883117	453	533	5	1	80	0.0125000
NODE_5011_length_1100_cov_40.883117	453	533	6	25	80	0.3125000
NODE_5011_length_1100_cov_40.883117	453	533	13	1	80	0.0125000
NODE_5011_length_1100_cov_40.883117	453	533	14	16	80	0.2000000
NODE_5011_length_1100_cov_40.883117	453	533	16	2	80	0.0250000
NODE_5011_length_1100_cov_40.883117	453	533	20	11	80	0.1375000
NODE_5011_length_1100_cov_40.883117	453	533	22	2	80	0.0250000
NODE_5011_length_1100_cov_40.883117	453	533	23	9	80	0.1125000
NODE_5011_length_1100_cov_40.883117	506	586	14	4	80	0.0500000
NODE_5011_length_1100_cov_40.883117	506	586	15	8	80	0.1000000
NODE_5011_length_1100_cov_40.883117	506	586	16	2	80	0.0250000
NODE_5011_length_1100_cov_40.883117	506	586	17	10	80	0.1250000
NODE_5011_length_1100_cov_40.883117	506	586	20	11	80	0.1375000
NODE_5011_length_1100_cov_40.883117	506	586	22	2	80	0.0250000
NODE_5011_length_1100_cov_40.883117	506	586	23	43	80	0.5375000
NODE_5012_length_1100_cov_23.160839	524	604	0	80	80	1.0000000
NODE_5012_length_1100_cov_23.160839	577	657	0	59	80	0.7375000
NODE_5012_length_1100_cov_23.160839	577	657	2	21	80	0.2625000
NODE_5012_length_1100_cov_23.160839	653	733	2	36	80	0.4500000
NODE_5012_length_1100_cov_23.160839	653	733	4	44	80	0.5500000
NODE_5012_length_1100_cov_23.160839	706	786	0	22	80	0.2750000
NODE_5012_length_1100_cov_23.160839	706	786	2	3	80	0.0375000
NODE_5012_length_1100_cov_23.160839	706	786	4	55	80	0.6875000
NODE_5013_length_1100_cov_22.200799	485	565	0	31	80	0.3875000
NODE_5013_length_1100_cov_22.200799	485	565	8	49	80	0.6125000
NODE_5013_length_1100_cov_22.200799	538	618	8	70	80	0.8750000
NODE_5013_length_1100_cov_22.200799	538	618	12	10	80	0.1250000
NODE_5013_length_1100_cov_22.200799	614	694	2	5	80	0.0625000
NODE_5013_length_1100_cov_22.200799	614	694	4	22	80	0.2750000
NODE_5013_length_1100_cov_22.200799	614	694	6	24	80	0.3000000
NODE_5013_length_1100_cov_22.200799	614	694	12	29	80	0.3625000
NODE_5013_length_1100_cov_22.200799	667	745	2	56	78	0.7179487
NODE_5013_length_1100_cov_22.200799	667	745	6	22	78	0.2820513
NODE_5014_length_1100_cov_15.353646	472	552	0	80	80	1.0000000
NODE_5014_length_1100_cov_15.353646	525	605	0	80	80	1.0000000
NODE_5015_length_1100_cov_14.584416	673	753	0	80	80	1.0000000
NODE_5015_length_1100_cov_14.584416	726	806	0	80	80	1.0000000
NODE_5029_length_1099_cov_85.893000	464	544	0	14	80	0.1750000
NODE_5029_length_1099_cov_85.893000	464	544	4	66	80	0.8250000
NODE_5029_length_1099_cov_85.893000	517	597	0	67	80	0.8375000
NODE_5029_length_1099_cov_85.893000	517	597	4	13	80	0.1625000
NODE_5029_length_1099_cov_85.893000	593	673	0	63	80	0.7875000
NODE_5029_length_1099_cov_85.893000	593	673	2	17	80	0.2125000
NODE_5029_length_1099_cov_85.893000	646	726	0	10	80	0.1250000
NODE_5029_length_1099_cov_85.893000	646	726	2	20	80	0.2500000
NODE_5029_length_1099_cov_85.893000	646	726	6	50	80	0.6250000
NODE_5030_length_1099_cov_45.874000	521	601	0	80	80	1.0000000
NODE_5030_length_1099_cov_45.874000	574	654	0	80	80	1.0000000
NODE_5030_length_1099_cov_45.874000	650	730	0	80	80	1.0000000
NODE_5030_length_1099_cov_45.874000	703	783	0	80	80	1.0000000
NODE_5031_length_1099_cov_25.192000	526	606	0	80	80	1.0000000
NODE_5031_length_1099_cov_25.192000	579	659	0	80	80	1.0000000
NODE_5032_length_1099_cov_11.846000	565	645	0	43	80	0.5375000
NODE_5032_length_1099_cov_11.846000	565	645	1	22	80	0.2750000
NODE_5032_length_1099_cov_11.846000	565	645	3	15	80	0.1875000
NODE_5032_length_1099_cov_11.846000	618	698	1	12	80	0.1500000
NODE_5032_length_1099_cov_11.846000	618	698	3	35	80	0.4375000
NODE_5032_length_1099_cov_11.846000	618	698	4	33	80	0.4125000
NODE_5033_length_1099_cov_9.527000	495	575	8	9	80	0.1125000
NODE_5033_length_1099_cov_9.527000	495	575	12	7	80	0.0875000
NODE_5033_length_1099_cov_9.527000	495	575	14	3	80	0.0375000
NODE_5033_length_1099_cov_9.527000	495	575	16	6	80	0.0750000
NODE_5033_length_1099_cov_9.527000	495	575	17	1	80	0.0125000
NODE_5033_length_1099_cov_9.527000	495	575	18	54	80	0.6750000
NODE_5033_length_1099_cov_9.527000	548	628	1	13	80	0.1625000
NODE_5033_length_1099_cov_9.527000	548	628	4	2	80	0.0250000
NODE_5033_length_1099_cov_9.527000	548	628	5	18	80	0.2250000
NODE_5033_length_1099_cov_9.527000	548	628	6	5	80	0.0625000
NODE_5033_length_1099_cov_9.527000	548	628	8	5	80	0.0625000
NODE_5033_length_1099_cov_9.527000	548	628	14	13	80	0.1625000
NODE_5033_length_1099_cov_9.527000	548	628	17	1	80	0.0125000
NODE_5033_length_1099_cov_9.527000	548	628	18	23	80	0.2875000
NODE_5034_length_1099_cov_8.993000	464	544	0	56	80	0.7000000
NODE_5034_length_1099_cov_8.993000	464	544	3	24	80	0.3000000
NODE_5034_length_1099_cov_8.993000	517	597	0	15	80	0.1875000
NODE_5034_length_1099_cov_8.993000	517	597	3	65	80	0.8125000
NODE_5039_length_1099_cov_2.286000	273	353	4	80	80	1.0000000
NODE_5045_length_1098_cov_44.988989	360	440	0	80	80	1.0000000
NODE_5045_length_1098_cov_44.988989	413	493	0	80	80	1.0000000
NODE_5046_length_1098_cov_35.192192	452	532	0	24	80	0.3000000
NODE_5046_length_1098_cov_35.192192	452	532	2	56	80	0.7000000
NODE_5046_length_1098_cov_35.192192	505	585	0	42	80	0.5250000
NODE_5046_length_1098_cov_35.192192	505	585	2	38	80	0.4750000
NODE_5046_length_1098_cov_35.192192	581	661	0	80	80	1.0000000
NODE_5046_length_1098_cov_35.192192	634	714	0	80	80	1.0000000
NODE_5047_length_1098_cov_28.743744	449	529	0	80	80	1.0000000
NODE_5047_length_1098_cov_28.743744	502	582	0	80	80	1.0000000
NODE_5047_length_1098_cov_28.743744	578	658	0	79	80	0.9875000
NODE_5047_length_1098_cov_28.743744	578	658	2	1	80	0.0125000
NODE_5047_length_1098_cov_28.743744	631	711	0	26	80	0.3250000
NODE_5047_length_1098_cov_28.743744	631	711	2	15	80	0.1875000
NODE_5047_length_1098_cov_28.743744	631	711	4	39	80	0.4875000
NODE_5048_length_1098_cov_28.230230	477	557	0	80	80	1.0000000
NODE_5048_length_1098_cov_28.230230	530	610	0	62	80	0.7750000
NODE_5048_length_1098_cov_28.230230	530	610	2	18	80	0.2250000
NODE_5048_length_1098_cov_28.230230	606	686	0	13	80	0.1625000
NODE_5048_length_1098_cov_28.230230	606	686	2	67	80	0.8375000
NODE_5048_length_1098_cov_28.230230	659	739	0	66	80	0.8250000
NODE_5048_length_1098_cov_28.230230	659	739	2	14	80	0.1750000
NODE_5049_length_1098_cov_26.131131	494	574	0	45	80	0.5625000
NODE_5049_length_1098_cov_26.131131	494	574	4	35	80	0.4375000
NODE_5049_length_1098_cov_26.131131	547	627	0	13	80	0.1625000
NODE_5049_length_1098_cov_26.131131	547	627	4	67	80	0.8375000
NODE_5050_length_1098_cov_21.355355	599	679	0	12	80	0.1500000
NODE_5050_length_1098_cov_21.355355	599	679	8	1	80	0.0125000
NODE_5050_length_1098_cov_21.355355	599	679	9	47	80	0.5875000
NODE_5050_length_1098_cov_21.355355	599	679	10	20	80	0.2500000
NODE_5050_length_1098_cov_21.355355	652	732	0	65	80	0.8125000
NODE_5050_length_1098_cov_21.355355	652	732	8	1	80	0.0125000
NODE_5050_length_1098_cov_21.355355	652	732	9	14	80	0.1750000
NODE_5051_length_1098_cov_17.087087	541	621	0	48	80	0.6000000
NODE_5051_length_1098_cov_17.087087	541	621	2	32	80	0.4000000
NODE_5051_length_1098_cov_17.087087	594	674	0	6	80	0.0750000
NODE_5051_length_1098_cov_17.087087	594	674	2	74	80	0.9250000
NODE_5051_length_1098_cov_17.087087	670	750	0	80	80	1.0000000
NODE_5051_length_1098_cov_17.087087	723	803	0	27	80	0.3375000
NODE_5051_length_1098_cov_17.087087	723	803	2	53	80	0.6625000
NODE_5052_length_1098_cov_15.455455	545	625	0	80	80	1.0000000
NODE_5052_length_1098_cov_15.455455	598	678	0	80	80	1.0000000
NODE_5052_length_1098_cov_15.455455	674	754	0	80	80	1.0000000
NODE_5052_length_1098_cov_15.455455	727	807	0	80	80	1.0000000
NODE_5054_length_1097_cov_37.103206	438	518	0	14	80	0.1750000
NODE_5054_length_1097_cov_37.103206	438	518	2	17	80	0.2125000
NODE_5054_length_1097_cov_37.103206	438	518	4	49	80	0.6125000
NODE_5054_length_1097_cov_37.103206	491	571	0	67	80	0.8375000
NODE_5054_length_1097_cov_37.103206	491	571	2	13	80	0.1625000
NODE_5054_length_1097_cov_37.103206	567	647	0	36	80	0.4500000
NODE_5054_length_1097_cov_37.103206	567	647	2	44	80	0.5500000
NODE_5054_length_1097_cov_37.103206	620	700	0	1	80	0.0125000
NODE_5054_length_1097_cov_37.103206	620	700	2	79	80	0.9875000
NODE_5055_length_1097_cov_32.624248	501	581	2	1	80	0.0125000
NODE_5055_length_1097_cov_32.624248	501	581	8	40	80	0.5000000
NODE_5055_length_1097_cov_32.624248	501	581	10	39	80	0.4875000
NODE_5055_length_1097_cov_32.624248	554	634	0	52	80	0.6500000
NODE_5055_length_1097_cov_32.624248	554	634	8	28	80	0.3500000
NODE_5056_length_1097_cov_25.240481	401	480	0	23	79	0.2911392
NODE_5056_length_1097_cov_25.240481	401	480	2	56	79	0.7088608
NODE_5056_length_1097_cov_25.240481	453	533	0	39	80	0.4875000
NODE_5056_length_1097_cov_25.240481	453	533	2	41	80	0.5125000
NODE_5056_length_1097_cov_25.240481	529	609	0	10	80	0.1250000
NODE_5056_length_1097_cov_25.240481	529	609	1	20	80	0.2500000
NODE_5056_length_1097_cov_25.240481	529	609	2	50	80	0.6250000
NODE_5056_length_1097_cov_25.240481	582	662	0	49	80	0.6125000
NODE_5056_length_1097_cov_25.240481	582	662	2	31	80	0.3875000
NODE_5057_length_1097_cov_21.221443	484	564	0	80	80	1.0000000
NODE_5057_length_1097_cov_21.221443	537	617	0	61	80	0.7625000
NODE_5057_length_1097_cov_21.221443	537	617	2	19	80	0.2375000
NODE_5057_length_1097_cov_21.221443	613	693	0	11	80	0.1375000
NODE_5057_length_1097_cov_21.221443	613	693	2	69	80	0.8625000
NODE_5057_length_1097_cov_21.221443	666	746	0	64	80	0.8000000
NODE_5057_length_1097_cov_21.221443	666	746	2	16	80	0.2000000
NODE_5058_length_1097_cov_20.968938	515	595	0	80	80	1.0000000
NODE_5058_length_1097_cov_20.968938	568	648	0	80	80	1.0000000
NODE_5059_length_1097_cov_13.136273	697	779	0	82	82	1.0000000
NODE_5059_length_1097_cov_13.136273	752	832	0	80	80	1.0000000
NODE_5060_length_1097_cov_6.376754	442	522	2	31	80	0.3875000
NODE_5060_length_1097_cov_6.376754	442	522	4	18	80	0.2250000
NODE_5060_length_1097_cov_6.376754	442	522	6	24	80	0.3000000
NODE_5060_length_1097_cov_6.376754	442	522	10	7	80	0.0875000
NODE_5060_length_1097_cov_6.376754	495	575	4	1	80	0.0125000
NODE_5060_length_1097_cov_6.376754	495	575	6	20	80	0.2500000
NODE_5060_length_1097_cov_6.376754	495	575	8	6	80	0.0750000
NODE_5060_length_1097_cov_6.376754	495	575	10	53	80	0.6625000
NODE_5061_length_1097_cov_6.068136	299	379	0	80	80	1.0000000
NODE_5061_length_1097_cov_6.068136	352	432	0	80	80	1.0000000
NODE_5072_length_1096_cov_55.816449	430	510	4	66	80	0.8250000
NODE_5072_length_1096_cov_55.816449	430	510	6	14	80	0.1750000
NODE_5072_length_1096_cov_55.816449	483	563	0	7	80	0.0875000
NODE_5072_length_1096_cov_55.816449	483	563	2	26	80	0.3250000
NODE_5072_length_1096_cov_55.816449	483	563	4	13	80	0.1625000
NODE_5072_length_1096_cov_55.816449	483	563	6	34	80	0.4250000
NODE_5072_length_1096_cov_55.816449	559	639	0	19	80	0.2375000
NODE_5072_length_1096_cov_55.816449	559	639	5	61	80	0.7625000
NODE_5072_length_1096_cov_55.816449	612	692	0	3	80	0.0375000
NODE_5072_length_1096_cov_55.816449	612	692	5	77	80	0.9625000
NODE_5073_length_1096_cov_24.672016	431	511	0	26	80	0.3250000
NODE_5073_length_1096_cov_24.672016	431	511	2	8	80	0.1000000
NODE_5073_length_1096_cov_24.672016	431	511	4	43	80	0.5375000
NODE_5073_length_1096_cov_24.672016	431	511	6	3	80	0.0375000
NODE_5073_length_1096_cov_24.672016	484	564	4	54	80	0.6750000
NODE_5073_length_1096_cov_24.672016	484	564	6	3	80	0.0375000
NODE_5073_length_1096_cov_24.672016	484	564	8	23	80	0.2875000
NODE_5073_length_1096_cov_24.672016	560	640	2	35	80	0.4375000
NODE_5073_length_1096_cov_24.672016	560	640	4	45	80	0.5625000
NODE_5073_length_1096_cov_24.672016	613	693	0	48	80	0.6000000
NODE_5073_length_1096_cov_24.672016	613	693	2	32	80	0.4000000
NODE_5074_length_1096_cov_22.980943	372	452	0	80	80	1.0000000
NODE_5074_length_1096_cov_22.980943	425	505	0	80	80	1.0000000
NODE_5075_length_1096_cov_16.649950	486	566	2	21	80	0.2625000
NODE_5075_length_1096_cov_16.649950	486	566	8	50	80	0.6250000
NODE_5075_length_1096_cov_16.649950	486	566	10	9	80	0.1125000
NODE_5075_length_1096_cov_16.649950	539	619	0	11	80	0.1375000
NODE_5075_length_1096_cov_16.649950	539	619	6	1	80	0.0125000
NODE_5075_length_1096_cov_16.649950	539	619	7	18	80	0.2250000
NODE_5075_length_1096_cov_16.649950	539	619	8	50	80	0.6250000
NODE_5076_length_1096_cov_16.433300	443	523	0	13	80	0.1625000
NODE_5076_length_1096_cov_16.433300	443	523	2	67	80	0.8375000
NODE_5076_length_1096_cov_16.433300	496	576	0	66	80	0.8250000
NODE_5076_length_1096_cov_16.433300	496	576	2	14	80	0.1750000
NODE_5076_length_1096_cov_16.433300	886	966	0	36	80	0.4500000
NODE_5076_length_1096_cov_16.433300	886	966	2	44	80	0.5500000
NODE_5076_length_1096_cov_16.433300	939	1018	0	79	79	1.0000000
NODE_5077_length_1096_cov_13.398195	670	750	2	24	80	0.3000000
NODE_5077_length_1096_cov_13.398195	670	750	4	56	80	0.7000000
NODE_5077_length_1096_cov_13.398195	723	803	0	39	80	0.4875000
NODE_5077_length_1096_cov_13.398195	723	803	2	37	80	0.4625000
NODE_5077_length_1096_cov_13.398195	723	803	4	4	80	0.0500000
NODE_5080_length_1095_cov_25.390562	520	600	6	80	80	1.0000000
NODE_5080_length_1095_cov_25.390562	573	653	0	21	80	0.2625000
NODE_5080_length_1095_cov_25.390562	573	653	4	1	80	0.0125000
NODE_5080_length_1095_cov_25.390562	573	653	5	12	80	0.1500000
NODE_5080_length_1095_cov_25.390562	573	653	6	46	80	0.5750000
NODE_5080_length_1095_cov_25.390562	649	729	0	39	80	0.4875000
NODE_5080_length_1095_cov_25.390562	649	729	2	21	80	0.2625000
NODE_5080_length_1095_cov_25.390562	649	729	4	20	80	0.2500000
NODE_5080_length_1095_cov_25.390562	702	782	2	7	80	0.0875000
NODE_5080_length_1095_cov_25.390562	702	782	3	35	80	0.4375000
NODE_5080_length_1095_cov_25.390562	702	782	4	38	80	0.4750000
NODE_5081_length_1095_cov_13.832329	549	629	0	72	80	0.9000000
NODE_5081_length_1095_cov_13.832329	549	629	2	8	80	0.1000000
NODE_5081_length_1095_cov_13.832329	602	682	0	19	80	0.2375000
NODE_5081_length_1095_cov_13.832329	602	682	2	61	80	0.7625000
NODE_5082_length_1095_cov_13.017068	497	577	0	66	80	0.8250000
NODE_5082_length_1095_cov_13.017068	497	577	1	14	80	0.1750000
NODE_5082_length_1095_cov_13.017068	550	630	0	13	80	0.1625000
NODE_5082_length_1095_cov_13.017068	550	630	1	67	80	0.8375000
NODE_5083_length_1095_cov_7.640562	627	707	0	80	80	1.0000000
NODE_5083_length_1095_cov_7.640562	680	760	0	80	80	1.0000000
NODE_5085_length_1095_cov_4.664659	307	387	0	80	80	1.0000000
NODE_5089_length_1094_cov_35.850251	409	489	0	80	80	1.0000000
NODE_5089_length_1094_cov_35.850251	462	542	0	58	80	0.7250000
NODE_5089_length_1094_cov_35.850251	462	542	4	22	80	0.2750000
NODE_5089_length_1094_cov_35.850251	538	618	4	80	80	1.0000000
NODE_5089_length_1094_cov_35.850251	591	671	2	11	80	0.1375000
NODE_5089_length_1094_cov_35.850251	591	671	4	50	80	0.6250000
NODE_5089_length_1094_cov_35.850251	591	671	5	11	80	0.1375000
NODE_5089_length_1094_cov_35.850251	591	671	6	8	80	0.1000000
NODE_5090_length_1094_cov_27.197990	462	542	0	80	80	1.0000000
NODE_5090_length_1094_cov_27.197990	515	595	0	46	80	0.5750000
NODE_5090_length_1094_cov_27.197990	515	595	2	34	80	0.4250000
NODE_5091_length_1094_cov_19.282412	451	531	1	5	80	0.0625000
NODE_5091_length_1094_cov_19.282412	451	531	4	1	80	0.0125000
NODE_5091_length_1094_cov_19.282412	451	531	7	3	80	0.0375000
NODE_5091_length_1094_cov_19.282412	451	531	8	6	80	0.0750000
NODE_5091_length_1094_cov_19.282412	451	531	14	65	80	0.8125000
NODE_5091_length_1094_cov_19.282412	504	584	4	2	80	0.0250000
NODE_5091_length_1094_cov_19.282412	504	584	10	43	80	0.5375000
NODE_5091_length_1094_cov_19.282412	504	584	14	35	80	0.4375000
NODE_5092_length_1094_cov_16.084422	558	614	0	56	56	1.0000000
NODE_5092_length_1094_cov_16.084422	587	667	0	80	80	1.0000000
NODE_5093_length_1094_cov_11.335678	384	464	2	46	80	0.5750000
NODE_5093_length_1094_cov_11.335678	384	464	4	34	80	0.4250000
NODE_5093_length_1094_cov_11.335678	437	517	0	6	80	0.0750000
NODE_5093_length_1094_cov_11.335678	437	517	2	58	80	0.7250000
NODE_5093_length_1094_cov_11.335678	437	517	4	16	80	0.2000000
NODE_5094_length_1094_cov_10.767839	396	476	0	41	80	0.5125000
NODE_5094_length_1094_cov_10.767839	396	476	2	39	80	0.4875000
NODE_5094_length_1094_cov_10.767839	449	529	0	80	80	1.0000000
NODE_5095_length_1094_cov_9.527638	579	659	0	9	80	0.1125000
NODE_5095_length_1094_cov_9.527638	579	659	3	45	80	0.5625000
NODE_5095_length_1094_cov_9.527638	579	659	4	26	80	0.3250000
NODE_5095_length_1094_cov_9.527638	632	712	0	28	80	0.3500000
NODE_5095_length_1094_cov_9.527638	632	712	3	1	80	0.0125000
NODE_5095_length_1094_cov_9.527638	632	712	4	51	80	0.6375000
NODE_5096_length_1094_cov_9.166834	527	607	0	80	80	1.0000000
NODE_5096_length_1094_cov_9.166834	580	660	0	80	80	1.0000000
NODE_5097_length_1094_cov_5.632161	708	768	0	50	60	0.8333333
NODE_5097_length_1094_cov_5.632161	708	768	2	10	60	0.1666667
NODE_5097_length_1094_cov_5.632161	761	821	2	39	60	0.6500000
NODE_5097_length_1094_cov_5.632161	761	821	4	7	60	0.1166667
NODE_5097_length_1094_cov_5.632161	761	821	6	14	60	0.2333333
NODE_5108_length_1093_cov_28.531187	374	454	2	14	80	0.1750000
NODE_5108_length_1093_cov_28.531187	374	454	4	66	80	0.8250000
NODE_5108_length_1093_cov_28.531187	427	507	2	64	80	0.8000000
NODE_5108_length_1093_cov_28.531187	427	507	4	16	80	0.2000000
NODE_5109_length_1093_cov_22.744467	516	596	2	59	80	0.7375000
NODE_5109_length_1093_cov_22.744467	516	596	4	21	80	0.2625000
NODE_5109_length_1093_cov_22.744467	569	649	0	17	80	0.2125000
NODE_5109_length_1093_cov_22.744467	569	649	2	52	80	0.6500000
NODE_5109_length_1093_cov_22.744467	569	649	4	11	80	0.1375000
NODE_5109_length_1093_cov_22.744467	645	725	4	80	80	1.0000000
NODE_5109_length_1093_cov_22.744467	698	778	0	19	80	0.2375000
NODE_5109_length_1093_cov_22.744467	698	778	4	61	80	0.7625000
NODE_5110_length_1093_cov_11.637827	282	362	0	80	80	1.0000000
NODE_5110_length_1093_cov_11.637827	335	415	0	80	80	1.0000000
NODE_5111_length_1093_cov_9.047284	660	740	2	15	80	0.1875000
NODE_5111_length_1093_cov_9.047284	660	740	4	17	80	0.2125000
NODE_5111_length_1093_cov_9.047284	660	740	8	48	80	0.6000000
NODE_5111_length_1093_cov_9.047284	713	793	0	1	80	0.0125000
NODE_5111_length_1093_cov_9.047284	713	793	4	40	80	0.5000000
NODE_5111_length_1093_cov_9.047284	713	793	6	9	80	0.1125000
NODE_5111_length_1093_cov_9.047284	713	793	8	30	80	0.3750000
NODE_5112_length_1093_cov_6.857143	658	738	0	80	80	1.0000000
NODE_5112_length_1093_cov_6.857143	711	791	0	80	80	1.0000000
NODE_5113_length_1093_cov_5.311871	587	667	0	80	80	1.0000000
NODE_5113_length_1093_cov_5.311871	640	720	0	80	80	1.0000000
NODE_5118_length_1092_cov_105.542800	682	768	0	86	86	1.0000000
NODE_5118_length_1092_cov_105.542800	745	807	0	62	62	1.0000000
NODE_5119_length_1092_cov_30.957704	610	690	0	74	80	0.9250000
NODE_5119_length_1092_cov_30.957704	610	690	2	6	80	0.0750000
NODE_5119_length_1092_cov_30.957704	663	743	0	21	80	0.2625000
NODE_5119_length_1092_cov_30.957704	663	743	2	59	80	0.7375000
NODE_5121_length_1092_cov_16.737160	725	805	0	80	80	1.0000000
NODE_5121_length_1092_cov_16.737160	778	858	0	80	80	1.0000000
NODE_5123_length_1092_cov_11.193353	335	415	0	80	80	1.0000000
NODE_5123_length_1092_cov_11.193353	388	468	0	80	80	1.0000000
NODE_5124_length_1092_cov_9.348439	489	569	0	8	80	0.1000000
NODE_5124_length_1092_cov_9.348439	489	569	2	70	80	0.8750000
NODE_5124_length_1092_cov_9.348439	489	569	4	2	80	0.0250000
NODE_5124_length_1092_cov_9.348439	542	622	0	19	80	0.2375000
NODE_5124_length_1092_cov_9.348439	542	622	2	61	80	0.7625000
NODE_5125_length_1092_cov_7.533736	243	323	0	80	80	1.0000000
NODE_5125_length_1092_cov_7.533736	296	376	0	80	80	1.0000000
NODE_5126_length_1092_cov_6.968781	470	550	0	80	80	1.0000000
NODE_5126_length_1092_cov_6.968781	523	603	0	80	80	1.0000000
NODE_5134_length_1091_cov_54.234879	417	497	12	9	80	0.1125000
NODE_5134_length_1091_cov_54.234879	417	497	14	8	80	0.1000000
NODE_5134_length_1091_cov_54.234879	417	497	22	5	80	0.0625000
NODE_5134_length_1091_cov_54.234879	417	497	23	10	80	0.1250000
NODE_5134_length_1091_cov_54.234879	417	497	24	17	80	0.2125000
NODE_5134_length_1091_cov_54.234879	417	497	25	3	80	0.0375000
NODE_5134_length_1091_cov_54.234879	417	497	26	27	80	0.3375000
NODE_5134_length_1091_cov_54.234879	417	497	27	1	80	0.0125000
NODE_5134_length_1091_cov_54.234879	470	550	18	16	80	0.2000000
NODE_5134_length_1091_cov_54.234879	470	550	21	1	80	0.0125000
NODE_5134_length_1091_cov_54.234879	470	550	22	5	80	0.0625000
NODE_5134_length_1091_cov_54.234879	470	550	23	13	80	0.1625000
NODE_5134_length_1091_cov_54.234879	470	550	25	3	80	0.0375000
NODE_5134_length_1091_cov_54.234879	470	550	26	14	80	0.1750000
NODE_5134_length_1091_cov_54.234879	470	550	27	5	80	0.0625000
NODE_5134_length_1091_cov_54.234879	470	550	28	12	80	0.1500000
NODE_5134_length_1091_cov_54.234879	470	550	30	1	80	0.0125000
NODE_5134_length_1091_cov_54.234879	470	550	32	9	80	0.1125000
NODE_5134_length_1091_cov_54.234879	470	550	33	1	80	0.0125000
NODE_5134_length_1091_cov_54.234879	546	626	14	9	80	0.1125000
NODE_5134_length_1091_cov_54.234879	546	626	18	8	80	0.1000000
NODE_5134_length_1091_cov_54.234879	546	626	19	3	80	0.0375000
NODE_5134_length_1091_cov_54.234879	546	626	21	3	80	0.0375000
NODE_5134_length_1091_cov_54.234879	546	626	22	23	80	0.2875000
NODE_5134_length_1091_cov_54.234879	546	626	23	10	80	0.1250000
NODE_5134_length_1091_cov_54.234879	546	626	24	7	80	0.0875000
NODE_5134_length_1091_cov_54.234879	546	626	25	1	80	0.0125000
NODE_5134_length_1091_cov_54.234879	546	626	26	6	80	0.0750000
NODE_5134_length_1091_cov_54.234879	546	626	27	10	80	0.1250000
NODE_5134_length_1091_cov_54.234879	599	679	10	3	80	0.0375000
NODE_5134_length_1091_cov_54.234879	599	679	11	1	80	0.0125000
NODE_5134_length_1091_cov_54.234879	599	679	17	12	80	0.1500000
NODE_5134_length_1091_cov_54.234879	599	679	19	17	80	0.2125000
NODE_5134_length_1091_cov_54.234879	599	679	21	1	80	0.0125000
NODE_5134_length_1091_cov_54.234879	599	679	23	30	80	0.3750000
NODE_5134_length_1091_cov_54.234879	599	679	24	7	80	0.0875000
NODE_5134_length_1091_cov_54.234879	599	679	25	1	80	0.0125000
NODE_5134_length_1091_cov_54.234879	599	679	27	8	80	0.1000000
NODE_5135_length_1091_cov_35.045363	384	464	0	80	80	1.0000000
NODE_5135_length_1091_cov_35.045363	437	517	0	60	80	0.7500000
NODE_5135_length_1091_cov_35.045363	437	517	8	20	80	0.2500000
NODE_5135_length_1091_cov_35.045363	513	593	8	9	80	0.1125000
NODE_5135_length_1091_cov_35.045363	513	593	10	71	80	0.8875000
NODE_5135_length_1091_cov_35.045363	566	646	0	15	80	0.1875000
NODE_5135_length_1091_cov_35.045363	566	646	6	1	80	0.0125000
NODE_5135_length_1091_cov_35.045363	566	646	8	30	80	0.3750000
NODE_5135_length_1091_cov_35.045363	566	646	10	34	80	0.4250000
NODE_5136_length_1091_cov_28.490927	329	409	0	80	80	1.0000000
NODE_5136_length_1091_cov_28.490927	382	462	0	80	80	1.0000000
NODE_5136_length_1091_cov_28.490927	618	698	2	80	80	1.0000000
NODE_5136_length_1091_cov_28.490927	671	751	0	52	80	0.6500000
NODE_5136_length_1091_cov_28.490927	671	751	1	1	80	0.0125000
NODE_5136_length_1091_cov_28.490927	671	751	2	27	80	0.3375000
NODE_5137_length_1091_cov_23.733871	514	594	0	18	80	0.2250000
NODE_5137_length_1091_cov_23.733871	514	594	2	3	80	0.0375000
NODE_5137_length_1091_cov_23.733871	514	594	4	42	80	0.5250000
NODE_5137_length_1091_cov_23.733871	514	594	8	17	80	0.2125000
NODE_5137_length_1091_cov_23.733871	567	647	4	10	80	0.1250000
NODE_5137_length_1091_cov_23.733871	567	647	6	30	80	0.3750000
NODE_5137_length_1091_cov_23.733871	567	647	8	40	80	0.5000000
NODE_5138_length_1091_cov_13.065524	444	524	0	80	80	1.0000000
NODE_5138_length_1091_cov_13.065524	497	577	0	80	80	1.0000000
NODE_5139_length_1091_cov_10.961694	582	646	0	64	64	1.0000000
NODE_5140_length_1091_cov_8.166331	299	379	0	2	80	0.0250000
NODE_5140_length_1091_cov_8.166331	299	379	2	1	80	0.0125000
NODE_5140_length_1091_cov_8.166331	299	379	4	15	80	0.1875000
NODE_5140_length_1091_cov_8.166331	299	379	5	1	80	0.0125000
NODE_5140_length_1091_cov_8.166331	299	379	6	8	80	0.1000000
NODE_5140_length_1091_cov_8.166331	299	379	7	53	80	0.6625000
NODE_5140_length_1091_cov_8.166331	352	432	3	33	80	0.4125000
NODE_5140_length_1091_cov_8.166331	352	432	4	17	80	0.2125000
NODE_5140_length_1091_cov_8.166331	352	432	5	1	80	0.0125000
NODE_5140_length_1091_cov_8.166331	352	432	6	11	80	0.1375000
NODE_5140_length_1091_cov_8.166331	352	432	7	18	80	0.2250000
NODE_5141_length_1091_cov_7.006048	617	697	0	80	80	1.0000000
NODE_5141_length_1091_cov_7.006048	670	750	0	80	80	1.0000000
NODE_5151_length_1090_cov_73.781029	352	432	0	80	80	1.0000000
NODE_5151_length_1090_cov_73.781029	405	485	0	80	80	1.0000000
NODE_5151_length_1090_cov_73.781029	481	567	0	86	86	1.0000000
NODE_5151_length_1090_cov_73.781029	540	620	0	80	80	1.0000000
NODE_5152_length_1090_cov_42.394551	530	610	5	43	80	0.5375000
NODE_5152_length_1090_cov_42.394551	530	610	7	1	80	0.0125000
NODE_5152_length_1090_cov_42.394551	530	610	8	21	80	0.2625000
NODE_5152_length_1090_cov_42.394551	530	610	9	1	80	0.0125000
NODE_5152_length_1090_cov_42.394551	530	610	11	1	80	0.0125000
NODE_5152_length_1090_cov_42.394551	530	610	12	13	80	0.1625000
NODE_5152_length_1090_cov_42.394551	583	663	6	35	80	0.4375000
NODE_5152_length_1090_cov_42.394551	583	663	8	12	80	0.1500000
NODE_5152_length_1090_cov_42.394551	583	663	9	1	80	0.0125000
NODE_5152_length_1090_cov_42.394551	583	663	11	1	80	0.0125000
NODE_5152_length_1090_cov_42.394551	583	663	12	31	80	0.3875000
NODE_5153_length_1090_cov_37.643794	436	516	0	4	80	0.0500000
NODE_5153_length_1090_cov_37.643794	436	516	2	19	80	0.2375000
NODE_5153_length_1090_cov_37.643794	436	516	4	57	80	0.7125000
NODE_5153_length_1090_cov_37.643794	489	569	0	57	80	0.7125000
NODE_5153_length_1090_cov_37.643794	489	569	2	19	80	0.2375000
NODE_5153_length_1090_cov_37.643794	489	569	4	4	80	0.0500000
NODE_5153_length_1090_cov_37.643794	565	645	0	21	80	0.2625000
NODE_5153_length_1090_cov_37.643794	565	645	2	58	80	0.7250000
NODE_5153_length_1090_cov_37.643794	565	645	4	1	80	0.0125000
NODE_5153_length_1090_cov_37.643794	618	698	2	48	80	0.6000000
NODE_5153_length_1090_cov_37.643794	618	698	4	32	80	0.4000000
NODE_5154_length_1090_cov_32.876892	487	567	0	53	80	0.6625000
NODE_5154_length_1090_cov_32.876892	487	567	2	27	80	0.3375000
NODE_5154_length_1090_cov_32.876892	540	620	0	80	80	1.0000000
NODE_5155_length_1090_cov_25.373360	486	566	0	39	80	0.4875000
NODE_5155_length_1090_cov_25.373360	486	566	2	41	80	0.5125000
NODE_5155_length_1090_cov_25.373360	539	619	0	22	80	0.2750000
NODE_5155_length_1090_cov_25.373360	539	619	2	58	80	0.7250000
NODE_5156_length_1090_cov_21.290616	422	502	0	80	80	1.0000000
NODE_5156_length_1090_cov_21.290616	475	555	0	80	80	1.0000000
NODE_5156_length_1090_cov_21.290616	551	631	0	80	80	1.0000000
NODE_5156_length_1090_cov_21.290616	604	684	0	80	80	1.0000000
NODE_5157_length_1090_cov_16.040363	666	746	0	80	80	1.0000000
NODE_5157_length_1090_cov_16.040363	719	799	0	80	80	1.0000000
NODE_5158_length_1090_cov_14.826438	393	473	0	80	80	1.0000000
NODE_5158_length_1090_cov_14.826438	446	526	0	80	80	1.0000000
NODE_5159_length_1090_cov_13.721493	498	578	0	80	80	1.0000000
NODE_5159_length_1090_cov_13.721493	551	631	0	80	80	1.0000000
NODE_5160_length_1090_cov_12.365288	386	467	0	81	81	1.0000000
NODE_5160_length_1090_cov_12.365288	440	520	0	80	80	1.0000000
NODE_5160_length_1090_cov_12.365288	516	596	0	80	80	1.0000000
NODE_5160_length_1090_cov_12.365288	569	649	0	80	80	1.0000000
NODE_5161_length_1090_cov_5.348133	0	80	0	6	80	0.0750000
NODE_5161_length_1090_cov_5.348133	0	80	3	3	80	0.0375000
NODE_5161_length_1090_cov_5.348133	0	80	4	8	80	0.1000000
NODE_5161_length_1090_cov_5.348133	0	80	6	22	80	0.2750000
NODE_5161_length_1090_cov_5.348133	0	80	10	12	80	0.1500000
NODE_5161_length_1090_cov_5.348133	0	80	12	2	80	0.0250000
NODE_5161_length_1090_cov_5.348133	0	80	18	2	80	0.0250000
NODE_5161_length_1090_cov_5.348133	0	80	20	25	80	0.3125000
NODE_5161_length_1090_cov_5.348133	53	99	18	2	46	0.0434783
NODE_5161_length_1090_cov_5.348133	53	99	20	32	46	0.6956522
NODE_5161_length_1090_cov_5.348133	53	99	22	11	46	0.2391304
NODE_5161_length_1090_cov_5.348133	53	99	24	1	46	0.0217391
NODE_5163_length_1090_cov_3.598385	300	340	58	2	40	0.0500000
NODE_5163_length_1090_cov_3.598385	300	340	60	3	40	0.0750000
NODE_5163_length_1090_cov_3.598385	300	340	63	4	40	0.1000000
NODE_5163_length_1090_cov_3.598385	300	340	67	2	40	0.0500000
NODE_5163_length_1090_cov_3.598385	300	340	68	2	40	0.0500000
NODE_5163_length_1090_cov_3.598385	300	340	70	1	40	0.0250000
NODE_5163_length_1090_cov_3.598385	300	340	76	3	40	0.0750000
NODE_5163_length_1090_cov_3.598385	300	340	78	1	40	0.0250000
NODE_5163_length_1090_cov_3.598385	300	340	79	1	40	0.0250000
NODE_5163_length_1090_cov_3.598385	300	340	81	1	40	0.0250000
NODE_5163_length_1090_cov_3.598385	300	340	82	1	40	0.0250000
NODE_5163_length_1090_cov_3.598385	300	340	83	3	40	0.0750000
NODE_5163_length_1090_cov_3.598385	300	340	88	2	40	0.0500000
NODE_5163_length_1090_cov_3.598385	300	340	90	3	40	0.0750000
NODE_5163_length_1090_cov_3.598385	300	340	92	2	40	0.0500000
NODE_5163_length_1090_cov_3.598385	300	340	94	2	40	0.0500000
NODE_5163_length_1090_cov_3.598385	300	340	95	2	40	0.0500000
NODE_5163_length_1090_cov_3.598385	300	340	97	3	40	0.0750000
NODE_5163_length_1090_cov_3.598385	300	340	98	2	40	0.0500000
NODE_5170_length_1089_cov_55.374747	515	594	0	79	79	1.0000000
NODE_5170_length_1089_cov_55.374747	567	647	0	80	80	1.0000000
NODE_5170_length_1089_cov_55.374747	643	723	0	11	80	0.1375000
NODE_5170_length_1089_cov_55.374747	643	723	2	2	80	0.0250000
NODE_5170_length_1089_cov_55.374747	643	723	8	67	80	0.8375000
NODE_5170_length_1089_cov_55.374747	696	776	6	42	80	0.5250000
NODE_5170_length_1089_cov_55.374747	696	776	8	38	80	0.4750000
NODE_5171_length_1089_cov_38.506061	458	538	0	80	80	1.0000000
NODE_5171_length_1089_cov_38.506061	511	591	0	80	80	1.0000000
NODE_5171_length_1089_cov_38.506061	587	667	0	51	80	0.6375000
NODE_5171_length_1089_cov_38.506061	587	667	2	29	80	0.3625000
NODE_5171_length_1089_cov_38.506061	640	720	2	30	80	0.3750000
NODE_5171_length_1089_cov_38.506061	640	720	3	9	80	0.1125000
NODE_5171_length_1089_cov_38.506061	640	720	4	25	80	0.3125000
NODE_5171_length_1089_cov_38.506061	640	720	5	16	80	0.2000000
NODE_5172_length_1089_cov_22.657576	379	459	13	1	80	0.0125000
NODE_5172_length_1089_cov_22.657576	379	459	15	8	80	0.1000000
NODE_5172_length_1089_cov_22.657576	379	459	17	15	80	0.1875000
NODE_5172_length_1089_cov_22.657576	379	459	18	5	80	0.0625000
NODE_5172_length_1089_cov_22.657576	379	459	19	24	80	0.3000000
NODE_5172_length_1089_cov_22.657576	379	459	21	27	80	0.3375000
NODE_5172_length_1089_cov_22.657576	432	512	0	6	80	0.0750000
NODE_5172_length_1089_cov_22.657576	432	512	2	14	80	0.1750000
NODE_5172_length_1089_cov_22.657576	432	512	4	26	80	0.3250000
NODE_5172_length_1089_cov_22.657576	432	512	13	8	80	0.1000000
NODE_5172_length_1089_cov_22.657576	432	512	15	2	80	0.0250000
NODE_5172_length_1089_cov_22.657576	432	512	17	7	80	0.0875000
NODE_5172_length_1089_cov_22.657576	432	512	21	17	80	0.2125000
NODE_5173_length_1089_cov_21.180808	547	627	0	2	80	0.0250000
NODE_5173_length_1089_cov_21.180808	547	627	6	23	80	0.2875000
NODE_5173_length_1089_cov_21.180808	547	627	10	55	80	0.6875000
NODE_5173_length_1089_cov_21.180808	600	680	6	26	80	0.3250000
NODE_5173_length_1089_cov_21.180808	600	680	10	54	80	0.6750000
NODE_5174_length_1089_cov_18.713131	431	511	0	62	80	0.7750000
NODE_5174_length_1089_cov_18.713131	431	511	2	18	80	0.2250000
NODE_5174_length_1089_cov_18.713131	484	564	0	80	80	1.0000000
NODE_5174_length_1089_cov_18.713131	560	640	0	80	80	1.0000000
NODE_5174_length_1089_cov_18.713131	613	693	0	80	80	1.0000000
NODE_5175_length_1089_cov_17.382828	376	456	0	80	80	1.0000000
NODE_5175_length_1089_cov_17.382828	429	509	0	80	80	1.0000000
NODE_5175_length_1089_cov_17.382828	505	585	0	80	80	1.0000000
NODE_5175_length_1089_cov_17.382828	558	638	0	80	80	1.0000000
NODE_5176_length_1089_cov_14.540404	610	690	0	46	80	0.5750000
NODE_5176_length_1089_cov_14.540404	610	690	2	34	80	0.4250000
NODE_5176_length_1089_cov_14.540404	663	743	0	18	80	0.2250000
NODE_5176_length_1089_cov_14.540404	663	743	2	62	80	0.7750000
NODE_5182_length_1088_cov_10.603640	504	584	0	80	80	1.0000000
NODE_5182_length_1088_cov_10.603640	557	632	0	75	75	1.0000000
NODE_5194_length_1088_cov_0.759353	0	59	0	59	59	1.0000000
NODE_5194_length_1088_cov_0.759353	32	97	0	65	65	1.0000000
NODE_5195_length_1087_cov_51.676113	457	537	6	3	80	0.0375000
NODE_5195_length_1087_cov_51.676113	457	537	8	12	80	0.1500000
NODE_5195_length_1087_cov_51.676113	457	537	10	9	80	0.1125000
NODE_5195_length_1087_cov_51.676113	457	537	12	11	80	0.1375000
NODE_5195_length_1087_cov_51.676113	457	537	14	18	80	0.2250000
NODE_5195_length_1087_cov_51.676113	457	537	16	27	80	0.3375000
NODE_5195_length_1087_cov_51.676113	510	590	8	33	80	0.4125000
NODE_5195_length_1087_cov_51.676113	510	590	10	11	80	0.1375000
NODE_5195_length_1087_cov_51.676113	510	590	14	10	80	0.1250000
NODE_5195_length_1087_cov_51.676113	510	590	16	26	80	0.3250000
NODE_5195_length_1087_cov_51.676113	586	666	0	31	80	0.3875000
NODE_5195_length_1087_cov_51.676113	586	666	2	13	80	0.1625000
NODE_5195_length_1087_cov_51.676113	586	666	4	3	80	0.0375000
NODE_5195_length_1087_cov_51.676113	586	666	6	12	80	0.1500000
NODE_5195_length_1087_cov_51.676113	586	666	8	21	80	0.2625000
NODE_5195_length_1087_cov_51.676113	639	719	0	80	80	1.0000000
NODE_5196_length_1087_cov_47.144737	214	276	57	3	62	0.0483871
NODE_5196_length_1087_cov_47.144737	214	276	59	7	62	0.1129032
NODE_5196_length_1087_cov_47.144737	214	276	61	2	62	0.0322581
NODE_5196_length_1087_cov_47.144737	214	276	62	3	62	0.0483871
NODE_5196_length_1087_cov_47.144737	214	276	73	2	62	0.0322581
NODE_5196_length_1087_cov_47.144737	214	276	74	1	62	0.0161290
NODE_5196_length_1087_cov_47.144737	214	276	76	2	62	0.0322581
NODE_5196_length_1087_cov_47.144737	214	276	78	2	62	0.0322581
NODE_5196_length_1087_cov_47.144737	214	276	80	5	62	0.0806452
NODE_5196_length_1087_cov_47.144737	214	276	81	1	62	0.0161290
NODE_5196_length_1087_cov_47.144737	214	276	85	3	62	0.0483871
NODE_5196_length_1087_cov_47.144737	214	276	89	3	62	0.0483871
NODE_5196_length_1087_cov_47.144737	214	276	93	7	62	0.1129032
NODE_5196_length_1087_cov_47.144737	214	276	95	4	62	0.0645161
NODE_5196_length_1087_cov_47.144737	214	276	99	8	62	0.1290323
NODE_5196_length_1087_cov_47.144737	214	276	101	3	62	0.0483871
NODE_5196_length_1087_cov_47.144737	214	276	103	6	62	0.0967742
NODE_5196_length_1087_cov_47.144737	630	710	4	22	80	0.2750000
NODE_5196_length_1087_cov_47.144737	630	710	7	1	80	0.0125000
NODE_5196_length_1087_cov_47.144737	630	710	8	57	80	0.7125000
NODE_5196_length_1087_cov_47.144737	683	763	0	39	80	0.4875000
NODE_5196_length_1087_cov_47.144737	683	763	4	27	80	0.3375000
NODE_5196_length_1087_cov_47.144737	683	763	7	1	80	0.0125000
NODE_5196_length_1087_cov_47.144737	683	763	8	13	80	0.1625000
NODE_5197_length_1087_cov_46.633603	871	951	4	80	80	1.0000000
NODE_5197_length_1087_cov_46.633603	924	999	0	47	75	0.6266667
NODE_5197_length_1087_cov_46.633603	924	999	4	28	75	0.3733333
NODE_5198_length_1087_cov_30.577935	528	608	0	39	80	0.4875000
NODE_5198_length_1087_cov_30.577935	528	608	2	41	80	0.5125000
NODE_5198_length_1087_cov_30.577935	581	661	0	80	80	1.0000000
NODE_5199_length_1087_cov_30.205466	515	591	0	4	76	0.0526316
NODE_5199_length_1087_cov_30.205466	515	591	2	72	76	0.9473684
NODE_5199_length_1087_cov_30.205466	564	644	0	55	80	0.6875000
NODE_5199_length_1087_cov_30.205466	564	644	2	25	80	0.3125000
NODE_5200_length_1087_cov_29.595142	568	648	0	49	80	0.6125000
NODE_5200_length_1087_cov_29.595142	568	648	6	12	80	0.1500000
NODE_5200_length_1087_cov_29.595142	568	648	8	19	80	0.2375000
NODE_5200_length_1087_cov_29.595142	621	701	0	80	80	1.0000000
NODE_5201_length_1087_cov_11.600202	374	454	0	45	80	0.5625000
NODE_5201_length_1087_cov_11.600202	374	454	2	11	80	0.1375000
NODE_5201_length_1087_cov_11.600202	374	454	6	24	80	0.3000000
NODE_5201_length_1087_cov_11.600202	427	507	0	3	80	0.0375000
NODE_5201_length_1087_cov_11.600202	427	507	6	77	80	0.9625000
NODE_5202_length_1087_cov_7.746964	436	516	0	80	80	1.0000000
NODE_5202_length_1087_cov_7.746964	489	569	0	80	80	1.0000000
NODE_5211_length_1086_cov_35.748734	406	486	0	13	80	0.1625000
NODE_5211_length_1086_cov_35.748734	406	486	2	67	80	0.8375000
NODE_5211_length_1086_cov_35.748734	459	539	0	66	80	0.8250000
NODE_5211_length_1086_cov_35.748734	459	539	2	14	80	0.1750000
NODE_5212_length_1086_cov_18.445795	325	405	0	26	80	0.3250000
NODE_5212_length_1086_cov_18.445795	325	405	2	54	80	0.6750000
NODE_5212_length_1086_cov_18.445795	378	458	0	50	80	0.6250000
NODE_5212_length_1086_cov_18.445795	378	458	2	30	80	0.3750000
NODE_5213_length_1086_cov_16.878419	528	608	0	80	80	1.0000000
NODE_5213_length_1086_cov_16.878419	581	661	0	78	80	0.9750000
NODE_5213_length_1086_cov_16.878419	581	661	2	2	80	0.0250000
NODE_5214_length_1086_cov_10.700101	498	578	0	17	80	0.2125000
NODE_5214_length_1086_cov_10.700101	498	578	2	16	80	0.2000000
NODE_5214_length_1086_cov_10.700101	498	578	4	47	80	0.5875000
NODE_5214_length_1086_cov_10.700101	551	631	2	25	80	0.3125000
NODE_5214_length_1086_cov_10.700101	551	631	4	55	80	0.6875000
NODE_5215_length_1086_cov_10.656535	277	357	0	80	80	1.0000000
NODE_5215_length_1086_cov_10.656535	330	410	0	80	80	1.0000000
NODE_5216_length_1086_cov_6.873354	374	454	0	80	80	1.0000000
NODE_5216_length_1086_cov_6.873354	427	507	0	80	80	1.0000000
NODE_5217_length_1086_cov_5.225937	869	949	0	80	80	1.0000000
NODE_5217_length_1086_cov_5.225937	922	1002	0	80	80	1.0000000
NODE_5229_length_1085_cov_30.599391	515	595	2	10	80	0.1250000
NODE_5229_length_1085_cov_30.599391	515	595	4	49	80	0.6125000
NODE_5229_length_1085_cov_30.599391	515	595	6	21	80	0.2625000
NODE_5229_length_1085_cov_30.599391	568	648	0	47	80	0.5875000
NODE_5229_length_1085_cov_30.599391	568	648	2	10	80	0.1250000
NODE_5229_length_1085_cov_30.599391	568	648	4	23	80	0.2875000
NODE_5231_length_1085_cov_13.723124	558	638	0	80	80	1.0000000
NODE_5231_length_1085_cov_13.723124	611	691	0	80	80	1.0000000
NODE_5232_length_1085_cov_12.481744	576	656	0	80	80	1.0000000
NODE_5232_length_1085_cov_12.481744	629	709	0	62	80	0.7750000
NODE_5232_length_1085_cov_12.481744	629	709	2	18	80	0.2250000
NODE_5233_length_1085_cov_11.570994	553	633	0	80	80	1.0000000
NODE_5233_length_1085_cov_11.570994	606	686	0	80	80	1.0000000
NODE_5234_length_1085_cov_10.730223	273	353	0	75	80	0.9375000
NODE_5234_length_1085_cov_10.730223	273	353	2	5	80	0.0625000
NODE_5234_length_1085_cov_10.730223	326	406	0	22	80	0.2750000
NODE_5234_length_1085_cov_10.730223	326	406	2	58	80	0.7250000
NODE_5234_length_1085_cov_10.730223	402	482	2	80	80	1.0000000
NODE_5234_length_1085_cov_10.730223	455	535	0	50	80	0.6250000
NODE_5234_length_1085_cov_10.730223	455	535	2	30	80	0.3750000
NODE_5234_length_1085_cov_10.730223	832	908	0	5	76	0.0657895
NODE_5234_length_1085_cov_10.730223	832	908	4	23	76	0.3026316
NODE_5234_length_1085_cov_10.730223	832	908	6	2	76	0.0263158
NODE_5234_length_1085_cov_10.730223	832	908	10	1	76	0.0131579
NODE_5234_length_1085_cov_10.730223	832	908	12	1	76	0.0131579
NODE_5234_length_1085_cov_10.730223	832	908	14	14	76	0.1842105
NODE_5234_length_1085_cov_10.730223	832	908	16	4	76	0.0526316
NODE_5234_length_1085_cov_10.730223	832	908	17	1	76	0.0131579
NODE_5234_length_1085_cov_10.730223	832	908	18	11	76	0.1447368
NODE_5234_length_1085_cov_10.730223	832	908	20	14	76	0.1842105
NODE_5236_length_1085_cov_8.309331	400	480	0	80	80	1.0000000
NODE_5236_length_1085_cov_8.309331	453	533	0	80	80	1.0000000
NODE_5248_length_1084_cov_60.255838	446	524	4	1	78	0.0128205
NODE_5248_length_1084_cov_60.255838	446	524	8	77	78	0.9871795
NODE_5248_length_1084_cov_60.255838	497	577	0	17	80	0.2125000
NODE_5248_length_1084_cov_60.255838	497	577	4	24	80	0.3000000
NODE_5248_length_1084_cov_60.255838	497	577	7	1	80	0.0125000
NODE_5248_length_1084_cov_60.255838	497	577	8	38	80	0.4750000
NODE_5249_length_1084_cov_33.332995	445	525	2	74	80	0.9250000
NODE_5249_length_1084_cov_33.332995	445	525	4	6	80	0.0750000
NODE_5249_length_1084_cov_33.332995	498	578	2	77	80	0.9625000
NODE_5249_length_1084_cov_33.332995	498	578	4	3	80	0.0375000
NODE_5250_length_1084_cov_11.004061	757	837	2	4	80	0.0500000
NODE_5250_length_1084_cov_11.004061	757	837	4	10	80	0.1250000
NODE_5250_length_1084_cov_11.004061	757	837	6	66	80	0.8250000
NODE_5250_length_1084_cov_11.004061	810	890	0	43	80	0.5375000
NODE_5250_length_1084_cov_11.004061	810	890	4	20	80	0.2500000
NODE_5250_length_1084_cov_11.004061	810	890	6	17	80	0.2125000
NODE_5258_length_1083_cov_42.182927	451	531	0	80	80	1.0000000
NODE_5258_length_1083_cov_42.182927	504	584	0	80	80	1.0000000
NODE_5258_length_1083_cov_42.182927	580	660	0	28	80	0.3500000
NODE_5258_length_1083_cov_42.182927	580	660	2	9	80	0.1125000
NODE_5258_length_1083_cov_42.182927	580	660	4	43	80	0.5375000
NODE_5258_length_1083_cov_42.182927	633	713	0	20	80	0.2500000
NODE_5258_length_1083_cov_42.182927	633	713	2	4	80	0.0500000
NODE_5258_length_1083_cov_42.182927	633	713	3	3	80	0.0375000
NODE_5258_length_1083_cov_42.182927	633	713	4	53	80	0.6625000
NODE_5259_length_1083_cov_41.163618	275	355	0	80	80	1.0000000
NODE_5259_length_1083_cov_41.163618	328	408	0	80	80	1.0000000
NODE_5259_length_1083_cov_41.163618	404	484	0	15	80	0.1875000
NODE_5259_length_1083_cov_41.163618	404	484	6	65	80	0.8125000
NODE_5259_length_1083_cov_41.163618	457	537	0	6	80	0.0750000
NODE_5259_length_1083_cov_41.163618	457	537	2	8	80	0.1000000
NODE_5259_length_1083_cov_41.163618	457	537	6	66	80	0.8250000
NODE_5260_length_1083_cov_39.798780	527	607	0	8	80	0.1000000
NODE_5260_length_1083_cov_39.798780	527	607	4	72	80	0.9000000
NODE_5260_length_1083_cov_39.798780	580	660	0	55	80	0.6875000
NODE_5260_length_1083_cov_39.798780	580	660	4	25	80	0.3125000
NODE_5261_length_1083_cov_34.261179	475	555	2	22	80	0.2750000
NODE_5261_length_1083_cov_34.261179	475	555	4	42	80	0.5250000
NODE_5261_length_1083_cov_34.261179	475	555	6	16	80	0.2000000
NODE_5261_length_1083_cov_34.261179	528	608	4	17	80	0.2125000
NODE_5261_length_1083_cov_34.261179	528	608	6	63	80	0.7875000
NODE_5262_length_1083_cov_33.573171	486	566	0	80	80	1.0000000
NODE_5262_length_1083_cov_33.573171	539	619	0	64	80	0.8000000
NODE_5262_length_1083_cov_33.573171	539	619	2	16	80	0.2000000
NODE_5262_length_1083_cov_33.573171	615	695	2	18	80	0.2250000
NODE_5262_length_1083_cov_33.573171	615	695	4	22	80	0.2750000
NODE_5262_length_1083_cov_33.573171	615	695	6	40	80	0.5000000
NODE_5262_length_1083_cov_33.573171	668	748	4	19	80	0.2375000
NODE_5262_length_1083_cov_33.573171	668	748	6	61	80	0.7625000
NODE_5263_length_1083_cov_33.091463	452	532	7	80	80	1.0000000
NODE_5263_length_1083_cov_33.091463	505	585	0	20	80	0.2500000
NODE_5263_length_1083_cov_33.091463	505	585	4	5	80	0.0625000
NODE_5263_length_1083_cov_33.091463	505	585	7	55	80	0.6875000
NODE_5264_length_1083_cov_30.982724	550	630	6	80	80	1.0000000
NODE_5264_length_1083_cov_30.982724	603	683	0	6	80	0.0750000
NODE_5264_length_1083_cov_30.982724	603	683	3	11	80	0.1375000
NODE_5264_length_1083_cov_30.982724	603	683	6	63	80	0.7875000
NODE_5265_length_1083_cov_18.819106	586	666	0	28	80	0.3500000
NODE_5265_length_1083_cov_18.819106	586	666	2	15	80	0.1875000
NODE_5265_length_1083_cov_18.819106	586	666	4	37	80	0.4625000
NODE_5265_length_1083_cov_18.819106	639	719	2	12	80	0.1500000
NODE_5265_length_1083_cov_18.819106	639	719	4	68	80	0.8500000
NODE_5266_length_1083_cov_17.278455	408	488	0	80	80	1.0000000
NODE_5266_length_1083_cov_17.278455	461	541	0	80	80	1.0000000
NODE_5267_length_1083_cov_13.862805	481	561	0	50	80	0.6250000
NODE_5267_length_1083_cov_13.862805	481	561	2	30	80	0.3750000
NODE_5267_length_1083_cov_13.862805	534	614	2	80	80	1.0000000
NODE_5268_length_1083_cov_13.083333	522	602	0	8	80	0.1000000
NODE_5268_length_1083_cov_13.083333	522	602	4	72	80	0.9000000
NODE_5268_length_1083_cov_13.083333	575	655	0	61	80	0.7625000
NODE_5268_length_1083_cov_13.083333	575	655	4	19	80	0.2375000
NODE_5269_length_1083_cov_11.824187	242	322	0	80	80	1.0000000
NODE_5269_length_1083_cov_11.824187	295	375	0	46	80	0.5750000
NODE_5269_length_1083_cov_11.824187	295	375	2	34	80	0.4250000
NODE_5271_length_1083_cov_3.025407	359	439	0	17	80	0.2125000
NODE_5271_length_1083_cov_3.025407	359	439	2	4	80	0.0500000
NODE_5271_length_1083_cov_3.025407	359	439	4	59	80	0.7375000
NODE_5271_length_1083_cov_3.025407	412	489	0	28	77	0.3636364
NODE_5271_length_1083_cov_3.025407	412	489	2	3	77	0.0389610
NODE_5271_length_1083_cov_3.025407	412	489	4	46	77	0.5974026
NODE_5277_length_1082_cov_34.664293	461	541	0	80	80	1.0000000
NODE_5277_length_1082_cov_34.664293	514	594	0	80	80	1.0000000
NODE_5278_length_1082_cov_17.422177	406	486	0	5	80	0.0625000
NODE_5278_length_1082_cov_17.422177	406	486	2	19	80	0.2375000
NODE_5278_length_1082_cov_17.422177	406	486	6	16	80	0.2000000
NODE_5278_length_1082_cov_17.422177	406	486	14	40	80	0.5000000
NODE_5278_length_1082_cov_17.422177	459	539	4	7	80	0.0875000
NODE_5278_length_1082_cov_17.422177	459	539	6	1	80	0.0125000
NODE_5278_length_1082_cov_17.422177	459	539	13	1	80	0.0125000
NODE_5278_length_1082_cov_17.422177	459	539	14	71	80	0.8875000
NODE_5279_length_1082_cov_15.906409	442	522	4	77	80	0.9625000
NODE_5279_length_1082_cov_15.906409	442	522	8	3	80	0.0375000
NODE_5279_length_1082_cov_15.906409	495	575	0	1	80	0.0125000
NODE_5279_length_1082_cov_15.906409	495	575	4	76	80	0.9500000
NODE_5279_length_1082_cov_15.906409	495	575	8	3	80	0.0375000
NODE_5280_length_1082_cov_13.703967	324	404	9	38	80	0.4750000
NODE_5280_length_1082_cov_13.703967	324	404	10	42	80	0.5250000
NODE_5280_length_1082_cov_13.703967	377	457	0	7	80	0.0875000
NODE_5280_length_1082_cov_13.703967	377	457	9	73	80	0.9125000
NODE_5281_length_1082_cov_6.478128	159	205	8	11	46	0.2391304
NODE_5281_length_1082_cov_6.478128	159	205	10	30	46	0.6521739
NODE_5281_length_1082_cov_6.478128	159	205	11	1	46	0.0217391
NODE_5281_length_1082_cov_6.478128	159	205	12	4	46	0.0869565
NODE_5281_length_1082_cov_6.478128	203	283	2	3	80	0.0375000
NODE_5281_length_1082_cov_6.478128	203	283	4	2	80	0.0250000
NODE_5281_length_1082_cov_6.478128	203	283	6	58	80	0.7250000
NODE_5281_length_1082_cov_6.478128	203	283	8	17	80	0.2125000
NODE_5281_length_1082_cov_6.478128	256	336	0	12	80	0.1500000
NODE_5281_length_1082_cov_6.478128	256	336	2	1	80	0.0125000
NODE_5281_length_1082_cov_6.478128	256	336	4	2	80	0.0250000
NODE_5281_length_1082_cov_6.478128	256	336	6	65	80	0.8125000
NODE_5281_length_1082_cov_6.478128	861	941	0	6	80	0.0750000
NODE_5281_length_1082_cov_6.478128	861	941	2	28	80	0.3500000
NODE_5281_length_1082_cov_6.478128	861	941	6	46	80	0.5750000
NODE_5282_length_1082_cov_4.218718	982	1062	64	1	80	0.0125000
NODE_5282_length_1082_cov_4.218718	982	1062	65	1	80	0.0125000
NODE_5282_length_1082_cov_4.218718	982	1062	74	1	80	0.0125000
NODE_5282_length_1082_cov_4.218718	982	1062	83	1	80	0.0125000
NODE_5282_length_1082_cov_4.218718	982	1062	92	2	80	0.0250000
NODE_5282_length_1082_cov_4.218718	982	1062	94	1	80	0.0125000
NODE_5282_length_1082_cov_4.218718	982	1062	96	1	80	0.0125000
NODE_5282_length_1082_cov_4.218718	982	1062	98	2	80	0.0250000
NODE_5282_length_1082_cov_4.218718	982	1062	103	3	80	0.0375000
NODE_5282_length_1082_cov_4.218718	982	1062	109	1	80	0.0125000
NODE_5282_length_1082_cov_4.218718	982	1062	111	1	80	0.0125000
NODE_5282_length_1082_cov_4.218718	982	1062	117	1	80	0.0125000
NODE_5282_length_1082_cov_4.218718	982	1062	131	1	80	0.0125000
NODE_5282_length_1082_cov_4.218718	982	1062	134	1	80	0.0125000
NODE_5282_length_1082_cov_4.218718	982	1062	139	1	80	0.0125000
NODE_5282_length_1082_cov_4.218718	982	1062	140	1	80	0.0125000
NODE_5282_length_1082_cov_4.218718	982	1062	145	1	80	0.0125000
NODE_5282_length_1082_cov_4.218718	982	1062	155	1	80	0.0125000
NODE_5282_length_1082_cov_4.218718	982	1062	163	1	80	0.0125000
NODE_5282_length_1082_cov_4.218718	982	1062	166	1	80	0.0125000
NODE_5282_length_1082_cov_4.218718	982	1062	174	1	80	0.0125000
NODE_5282_length_1082_cov_4.218718	982	1062	182	2	80	0.0250000
NODE_5282_length_1082_cov_4.218718	982	1062	184	1	80	0.0125000
NODE_5282_length_1082_cov_4.218718	982	1062	186	1	80	0.0125000
NODE_5282_length_1082_cov_4.218718	982	1062	190	3	80	0.0375000
NODE_5282_length_1082_cov_4.218718	982	1062	191	3	80	0.0375000
NODE_5282_length_1082_cov_4.218718	982	1062	195	1	80	0.0125000
NODE_5282_length_1082_cov_4.218718	982	1062	199	1	80	0.0125000
NODE_5282_length_1082_cov_4.218718	982	1062	201	1	80	0.0125000
NODE_5282_length_1082_cov_4.218718	982	1062	205	2	80	0.0250000
NODE_5282_length_1082_cov_4.218718	982	1062	208	3	80	0.0375000
NODE_5282_length_1082_cov_4.218718	982	1062	209	1	80	0.0125000
NODE_5282_length_1082_cov_4.218718	982	1062	213	2	80	0.0250000
NODE_5282_length_1082_cov_4.218718	982	1062	215	1	80	0.0125000
NODE_5282_length_1082_cov_4.218718	982	1062	217	1	80	0.0125000
NODE_5282_length_1082_cov_4.218718	982	1062	219	2	80	0.0250000
NODE_5282_length_1082_cov_4.218718	982	1062	223	2	80	0.0250000
NODE_5282_length_1082_cov_4.218718	982	1062	233	2	80	0.0250000
NODE_5282_length_1082_cov_4.218718	982	1062	240	1	80	0.0125000
NODE_5282_length_1082_cov_4.218718	982	1062	244	1	80	0.0125000
NODE_5282_length_1082_cov_4.218718	982	1062	246	2	80	0.0250000
NODE_5282_length_1082_cov_4.218718	982	1062	256	1	80	0.0125000
NODE_5282_length_1082_cov_4.218718	982	1062	260	3	80	0.0375000
NODE_5282_length_1082_cov_4.218718	982	1062	266	1	80	0.0125000
NODE_5282_length_1082_cov_4.218718	982	1062	272	2	80	0.0250000
NODE_5282_length_1082_cov_4.218718	982	1062	274	2	80	0.0250000
NODE_5282_length_1082_cov_4.218718	982	1062	277	4	80	0.0500000
NODE_5282_length_1082_cov_4.218718	982	1062	278	1	80	0.0125000
NODE_5282_length_1082_cov_4.218718	982	1062	280	2	80	0.0250000
NODE_5282_length_1082_cov_4.218718	982	1062	282	3	80	0.0375000
NODE_5282_length_1082_cov_4.218718	982	1062	284	1	80	0.0125000
NODE_5282_length_1082_cov_4.218718	982	1062	286	2	80	0.0250000
NODE_5291_length_1081_cov_45.308554	510	590	0	49	80	0.6125000
NODE_5291_length_1081_cov_45.308554	510	590	6	5	80	0.0625000
NODE_5291_length_1081_cov_45.308554	510	590	10	26	80	0.3250000
NODE_5291_length_1081_cov_45.308554	563	643	6	2	80	0.0250000
NODE_5291_length_1081_cov_45.308554	563	643	10	78	80	0.9750000
NODE_5292_length_1081_cov_39.581466	476	556	0	6	80	0.0750000
NODE_5292_length_1081_cov_39.581466	476	556	6	74	80	0.9250000
NODE_5292_length_1081_cov_39.581466	529	609	0	59	80	0.7375000
NODE_5292_length_1081_cov_39.581466	529	609	6	21	80	0.2625000
NODE_5292_length_1081_cov_39.581466	605	685	0	22	80	0.2750000
NODE_5292_length_1081_cov_39.581466	605	685	1	11	80	0.1375000
NODE_5292_length_1081_cov_39.581466	605	685	3	3	80	0.0375000
NODE_5292_length_1081_cov_39.581466	605	685	4	44	80	0.5500000
NODE_5292_length_1081_cov_39.581466	658	738	4	80	80	1.0000000
NODE_5293_length_1081_cov_39.457230	373	453	0	80	80	1.0000000
NODE_5293_length_1081_cov_39.457230	426	506	0	44	80	0.5500000
NODE_5293_length_1081_cov_39.457230	426	506	9	36	80	0.4500000
NODE_5294_length_1081_cov_20.415479	376	451	0	75	75	1.0000000
NODE_5294_length_1081_cov_20.415479	436	511	0	75	75	1.0000000
NODE_5294_length_1081_cov_20.415479	496	571	0	75	75	1.0000000
NODE_5294_length_1081_cov_20.415479	544	624	0	80	80	1.0000000
NODE_5295_length_1081_cov_19.985743	378	458	0	44	80	0.5500000
NODE_5295_length_1081_cov_19.985743	378	458	2	1	80	0.0125000
NODE_5295_length_1081_cov_19.985743	378	458	3	14	80	0.1750000
NODE_5295_length_1081_cov_19.985743	378	458	4	21	80	0.2625000
NODE_5295_length_1081_cov_19.985743	431	511	0	2	80	0.0250000
NODE_5295_length_1081_cov_19.985743	431	511	2	5	80	0.0625000
NODE_5295_length_1081_cov_19.985743	431	511	3	6	80	0.0750000
NODE_5295_length_1081_cov_19.985743	431	511	4	67	80	0.8375000
NODE_5295_length_1081_cov_19.985743	507	587	0	78	80	0.9750000
NODE_5295_length_1081_cov_19.985743	507	587	2	2	80	0.0250000
NODE_5295_length_1081_cov_19.985743	560	640	0	80	80	1.0000000
NODE_5296_length_1081_cov_12.658859	468	548	0	80	80	1.0000000
NODE_5296_length_1081_cov_12.658859	521	601	0	80	80	1.0000000
NODE_5299_length_1081_cov_2.586558	7	44	0	37	37	1.0000000
NODE_5304_length_1080_cov_27.857288	261	341	0	80	80	1.0000000
NODE_5304_length_1080_cov_27.857288	314	394	0	80	80	1.0000000
NODE_5305_length_1080_cov_24.258919	321	401	0	4	80	0.0500000
NODE_5305_length_1080_cov_24.258919	321	401	4	76	80	0.9500000
NODE_5305_length_1080_cov_24.258919	374	454	0	57	80	0.7125000
NODE_5305_length_1080_cov_24.258919	374	454	4	23	80	0.2875000
NODE_5305_length_1080_cov_24.258919	450	530	0	80	80	1.0000000
NODE_5305_length_1080_cov_24.258919	503	583	0	42	80	0.5250000
NODE_5305_length_1080_cov_24.258919	503	583	2	38	80	0.4750000
NODE_5306_length_1080_cov_22.589195	446	526	0	13	80	0.1625000
NODE_5306_length_1080_cov_22.589195	446	526	2	67	80	0.8375000
NODE_5306_length_1080_cov_22.589195	499	579	0	66	80	0.8250000
NODE_5306_length_1080_cov_22.589195	499	579	2	14	80	0.1750000
NODE_5306_length_1080_cov_22.589195	575	655	0	80	80	1.0000000
NODE_5306_length_1080_cov_22.589195	628	708	0	43	80	0.5375000
NODE_5306_length_1080_cov_22.589195	628	708	4	33	80	0.4125000
NODE_5306_length_1080_cov_22.589195	628	708	6	4	80	0.0500000
NODE_5307_length_1080_cov_15.544343	599	679	0	53	80	0.6625000
NODE_5307_length_1080_cov_15.544343	599	679	2	18	80	0.2250000
NODE_5307_length_1080_cov_15.544343	599	679	4	9	80	0.1125000
NODE_5307_length_1080_cov_15.544343	652	732	2	18	80	0.2250000
NODE_5307_length_1080_cov_15.544343	652	732	4	62	80	0.7750000
NODE_5308_length_1080_cov_10.416922	321	401	0	77	80	0.9625000
NODE_5308_length_1080_cov_10.416922	321	401	4	3	80	0.0375000
NODE_5308_length_1080_cov_10.416922	374	454	0	24	80	0.3000000
NODE_5308_length_1080_cov_10.416922	374	454	4	11	80	0.1375000
NODE_5308_length_1080_cov_10.416922	374	454	6	3	80	0.0375000
NODE_5308_length_1080_cov_10.416922	374	454	8	42	80	0.5250000
NODE_5315_length_1079_cov_55.352041	367	447	0	80	80	1.0000000
NODE_5315_length_1079_cov_55.352041	420	500	0	48	80	0.6000000
NODE_5315_length_1079_cov_55.352041	420	500	2	32	80	0.4000000
NODE_5315_length_1079_cov_55.352041	496	576	0	23	80	0.2875000
NODE_5315_length_1079_cov_55.352041	496	576	2	57	80	0.7125000
NODE_5315_length_1079_cov_55.352041	549	629	0	76	80	0.9500000
NODE_5315_length_1079_cov_55.352041	549	629	2	4	80	0.0500000
NODE_5316_length_1079_cov_46.879592	444	524	2	17	80	0.2125000
NODE_5316_length_1079_cov_46.879592	444	524	4	47	80	0.5875000
NODE_5316_length_1079_cov_46.879592	444	524	6	16	80	0.2000000
NODE_5316_length_1079_cov_46.879592	497	577	2	48	80	0.6000000
NODE_5316_length_1079_cov_46.879592	497	577	4	22	80	0.2750000
NODE_5316_length_1079_cov_46.879592	497	577	6	10	80	0.1250000
NODE_5316_length_1079_cov_46.879592	573	652	4	16	79	0.2025317
NODE_5316_length_1079_cov_46.879592	573	652	6	42	79	0.5316456
NODE_5316_length_1079_cov_46.879592	573	652	8	21	79	0.2658228
NODE_5316_length_1079_cov_46.879592	625	703	0	30	78	0.3846154
NODE_5316_length_1079_cov_46.879592	625	703	4	2	78	0.0256410
NODE_5316_length_1079_cov_46.879592	625	703	6	46	78	0.5897436
NODE_5317_length_1079_cov_13.708163	611	691	0	80	80	1.0000000
NODE_5317_length_1079_cov_13.708163	664	744	0	80	80	1.0000000
NODE_5318_length_1079_cov_8.632653	416	496	0	80	80	1.0000000
NODE_5318_length_1079_cov_8.632653	469	549	0	80	80	1.0000000
NODE_5325_length_1078_cov_27.804903	357	437	0	2	80	0.0250000
NODE_5325_length_1078_cov_27.804903	357	437	6	62	80	0.7750000
NODE_5325_length_1078_cov_27.804903	357	437	8	16	80	0.2000000
NODE_5325_length_1078_cov_27.804903	410	490	2	12	80	0.1500000
NODE_5325_length_1078_cov_27.804903	410	490	6	12	80	0.1500000
NODE_5325_length_1078_cov_27.804903	410	490	8	56	80	0.7000000
NODE_5326_length_1078_cov_26.071502	459	539	0	80	80	1.0000000
NODE_5326_length_1078_cov_26.071502	512	592	0	80	80	1.0000000
NODE_5326_length_1078_cov_26.071502	588	668	0	80	80	1.0000000
NODE_5326_length_1078_cov_26.071502	641	718	0	77	77	1.0000000
NODE_5327_length_1078_cov_14.985700	495	575	0	80	80	1.0000000
NODE_5327_length_1078_cov_14.985700	548	628	0	80	80	1.0000000
NODE_5333_length_1077_cov_23.876278	546	626	0	12	80	0.1500000
NODE_5333_length_1077_cov_23.876278	546	626	2	68	80	0.8500000
NODE_5333_length_1077_cov_23.876278	599	679	0	36	80	0.4500000
NODE_5333_length_1077_cov_23.876278	599	679	2	44	80	0.5500000
NODE_5334_length_1077_cov_16.067485	532	612	0	80	80	1.0000000
NODE_5334_length_1077_cov_16.067485	585	665	0	80	80	1.0000000
NODE_5335_length_1077_cov_14.568507	556	636	0	55	80	0.6875000
NODE_5335_length_1077_cov_14.568507	556	636	4	25	80	0.3125000
NODE_5335_length_1077_cov_14.568507	609	689	0	2	80	0.0250000
NODE_5335_length_1077_cov_14.568507	609	689	4	78	80	0.9750000
NODE_5336_length_1077_cov_9.507157	496	576	0	44	80	0.5500000
NODE_5336_length_1077_cov_9.507157	496	576	2	31	80	0.3875000
NODE_5336_length_1077_cov_9.507157	496	576	4	5	80	0.0625000
NODE_5336_length_1077_cov_9.507157	549	629	0	80	80	1.0000000
NODE_5342_length_1077_cov_1.781186	252	274	0	22	22	1.0000000
NODE_5345_length_1076_cov_20.592631	534	614	0	65	80	0.8125000
NODE_5345_length_1076_cov_20.592631	534	614	2	15	80	0.1875000
NODE_5345_length_1076_cov_20.592631	587	667	0	19	80	0.2375000
NODE_5345_length_1076_cov_20.592631	587	667	2	61	80	0.7625000
NODE_5346_length_1076_cov_14.788127	427	507	0	34	80	0.4250000
NODE_5346_length_1076_cov_14.788127	427	507	4	46	80	0.5750000
NODE_5346_length_1076_cov_14.788127	480	560	0	13	80	0.1625000
NODE_5346_length_1076_cov_14.788127	480	560	4	67	80	0.8375000
NODE_5348_length_1076_cov_6.306039	883	961	0	78	78	1.0000000
NODE_5348_length_1076_cov_6.306039	936	1014	0	78	78	1.0000000
NODE_5357_length_1075_cov_37.941598	550	630	0	16	80	0.2000000
NODE_5357_length_1075_cov_37.941598	550	630	3	1	80	0.0125000
NODE_5357_length_1075_cov_37.941598	550	630	4	63	80	0.7875000
NODE_5357_length_1075_cov_37.941598	603	685	0	61	82	0.7439024
NODE_5357_length_1075_cov_37.941598	603	685	3	1	82	0.0121951
NODE_5357_length_1075_cov_37.941598	603	685	4	20	82	0.2439024
NODE_5357_length_1075_cov_37.941598	681	761	0	80	80	1.0000000
NODE_5357_length_1075_cov_37.941598	734	814	0	80	80	1.0000000
NODE_5358_length_1075_cov_32.224385	397	477	0	61	80	0.7625000
NODE_5358_length_1075_cov_32.224385	397	477	2	19	80	0.2375000
NODE_5358_length_1075_cov_32.224385	450	530	0	8	80	0.1000000
NODE_5358_length_1075_cov_32.224385	450	530	2	72	80	0.9000000
NODE_5359_length_1075_cov_9.626025	440	520	2	80	80	1.0000000
NODE_5359_length_1075_cov_9.626025	493	573	0	37	80	0.4625000
NODE_5359_length_1075_cov_9.626025	493	573	2	43	80	0.5375000
NODE_5362_length_1075_cov_2.926230	38	99	0	61	61	1.0000000
NODE_5372_length_1074_cov_19.034872	568	648	1	14	80	0.1750000
NODE_5372_length_1074_cov_19.034872	568	648	2	66	80	0.8250000
NODE_5372_length_1074_cov_19.034872	621	701	0	43	80	0.5375000
NODE_5372_length_1074_cov_19.034872	621	701	1	24	80	0.3000000
NODE_5372_length_1074_cov_19.034872	621	701	2	13	80	0.1625000
NODE_5372_length_1074_cov_19.034872	697	777	0	80	80	1.0000000
NODE_5372_length_1074_cov_19.034872	750	830	0	71	80	0.8875000
NODE_5372_length_1074_cov_19.034872	750	830	1	1	80	0.0125000
NODE_5372_length_1074_cov_19.034872	750	830	2	8	80	0.1000000
NODE_5373_length_1074_cov_9.450256	577	657	0	23	80	0.2875000
NODE_5373_length_1074_cov_9.450256	577	657	2	31	80	0.3875000
NODE_5373_length_1074_cov_9.450256	577	657	4	26	80	0.3250000
NODE_5373_length_1074_cov_9.450256	630	710	2	40	80	0.5000000
NODE_5373_length_1074_cov_9.450256	630	710	4	40	80	0.5000000
NODE_5374_length_1074_cov_9.155897	526	606	0	80	80	1.0000000
NODE_5374_length_1074_cov_9.155897	579	659	0	80	80	1.0000000
NODE_5374_length_1074_cov_9.155897	655	735	0	80	80	1.0000000
NODE_5374_length_1074_cov_9.155897	708	788	0	80	80	1.0000000
NODE_5375_length_1074_cov_4.600000	606	686	0	80	80	1.0000000
NODE_5375_length_1074_cov_4.600000	659	739	0	80	80	1.0000000
NODE_5376_length_1074_cov_4.328205	32	112	14	3	80	0.0375000
NODE_5376_length_1074_cov_4.328205	32	112	16	8	80	0.1000000
NODE_5376_length_1074_cov_4.328205	32	112	18	15	80	0.1875000
NODE_5376_length_1074_cov_4.328205	32	112	20	21	80	0.2625000
NODE_5376_length_1074_cov_4.328205	32	112	22	3	80	0.0375000
NODE_5376_length_1074_cov_4.328205	32	112	24	5	80	0.0625000
NODE_5376_length_1074_cov_4.328205	32	112	26	25	80	0.3125000
NODE_5380_length_1073_cov_60.012320	448	528	0	80	80	1.0000000
NODE_5380_length_1073_cov_60.012320	501	581	0	80	80	1.0000000
NODE_5382_length_1073_cov_26.415811	529	609	0	5	80	0.0625000
NODE_5382_length_1073_cov_26.415811	529	609	2	75	80	0.9375000
NODE_5382_length_1073_cov_26.415811	582	662	0	28	80	0.3500000
NODE_5382_length_1073_cov_26.415811	582	662	2	52	80	0.6500000
NODE_5383_length_1073_cov_19.062628	571	651	4	22	80	0.2750000
NODE_5383_length_1073_cov_19.062628	571	651	6	58	80	0.7250000
NODE_5383_length_1073_cov_19.062628	624	704	0	31	80	0.3875000
NODE_5383_length_1073_cov_19.062628	624	704	2	22	80	0.2750000
NODE_5383_length_1073_cov_19.062628	624	704	4	15	80	0.1875000
NODE_5383_length_1073_cov_19.062628	624	704	6	12	80	0.1500000
NODE_5384_length_1073_cov_18.536961	447	527	0	2	80	0.0250000
NODE_5384_length_1073_cov_18.536961	447	527	8	78	80	0.9750000
NODE_5384_length_1073_cov_18.536961	500	580	0	55	80	0.6875000
NODE_5384_length_1073_cov_18.536961	500	580	8	25	80	0.3125000
NODE_5384_length_1073_cov_18.536961	576	656	0	80	80	1.0000000
NODE_5384_length_1073_cov_18.536961	629	709	0	80	80	1.0000000
NODE_5385_length_1073_cov_15.318275	712	792	0	80	80	1.0000000
NODE_5385_length_1073_cov_15.318275	765	845	0	80	80	1.0000000
NODE_5386_length_1073_cov_8.376797	287	367	0	80	80	1.0000000
NODE_5386_length_1073_cov_8.376797	340	420	0	80	80	1.0000000
NODE_5387_length_1073_cov_5.749487	257	337	0	28	80	0.3500000
NODE_5387_length_1073_cov_5.749487	257	337	2	52	80	0.6500000
NODE_5387_length_1073_cov_5.749487	310	390	0	41	80	0.5125000
NODE_5387_length_1073_cov_5.749487	310	390	2	39	80	0.4875000
NODE_5388_length_1073_cov_5.156057	408	444	0	36	36	1.0000000
NODE_5390_length_1073_cov_3.019507	1	69	0	68	68	1.0000000
NODE_5390_length_1073_cov_3.019507	42	122	0	43	80	0.5375000
NODE_5390_length_1073_cov_3.019507	42	122	2	37	80	0.4625000
NODE_5399_length_1072_cov_62.729702	351	431	0	80	80	1.0000000
NODE_5399_length_1072_cov_62.729702	404	484	0	80	80	1.0000000
NODE_5399_length_1072_cov_62.729702	480	560	0	80	80	1.0000000
NODE_5399_length_1072_cov_62.729702	533	613	0	80	80	1.0000000
NODE_5400_length_1072_cov_34.045221	430	510	0	61	80	0.7625000
NODE_5400_length_1072_cov_34.045221	430	510	4	19	80	0.2375000
NODE_5400_length_1072_cov_34.045221	483	563	0	8	80	0.1000000
NODE_5400_length_1072_cov_34.045221	483	563	4	72	80	0.9000000
NODE_5401_length_1072_cov_34.006166	342	423	0	69	81	0.8518519
NODE_5401_length_1072_cov_34.006166	342	423	13	1	81	0.0123457
NODE_5401_length_1072_cov_34.006166	342	423	14	11	81	0.1358025
NODE_5401_length_1072_cov_34.006166	396	476	0	15	80	0.1875000
NODE_5401_length_1072_cov_34.006166	396	476	13	1	80	0.0125000
NODE_5401_length_1072_cov_34.006166	396	476	14	64	80	0.8000000
NODE_5401_length_1072_cov_34.006166	472	552	14	65	80	0.8125000
NODE_5401_length_1072_cov_34.006166	472	552	16	15	80	0.1875000
NODE_5401_length_1072_cov_34.006166	525	605	2	46	80	0.5750000
NODE_5401_length_1072_cov_34.006166	525	605	14	12	80	0.1500000
NODE_5401_length_1072_cov_34.006166	525	605	16	22	80	0.2750000
NODE_5403_length_1072_cov_21.852004	300	380	0	80	80	1.0000000
NODE_5403_length_1072_cov_21.852004	353	433	0	80	80	1.0000000
NODE_5404_length_1072_cov_21.532374	476	556	2	7	80	0.0875000
NODE_5404_length_1072_cov_21.532374	476	556	4	73	80	0.9125000
NODE_5404_length_1072_cov_21.532374	529	609	0	42	80	0.5250000
NODE_5404_length_1072_cov_21.532374	529	609	4	38	80	0.4750000
NODE_5405_length_1072_cov_17.018499	415	495	0	5	80	0.0625000
NODE_5405_length_1072_cov_17.018499	415	495	4	40	80	0.5000000
NODE_5405_length_1072_cov_17.018499	415	495	6	35	80	0.4375000
NODE_5405_length_1072_cov_17.018499	468	548	0	58	80	0.7250000
NODE_5405_length_1072_cov_17.018499	468	548	4	22	80	0.2750000
NODE_5410_length_1072_cov_3.302158	388	449	2	19	61	0.3114754
NODE_5410_length_1072_cov_3.302158	388	449	3	5	61	0.0819672
NODE_5410_length_1072_cov_3.302158	388	449	4	28	61	0.4590164
NODE_5410_length_1072_cov_3.302158	388	449	6	9	61	0.1475410
NODE_5410_length_1072_cov_3.302158	422	502	0	22	80	0.2750000
NODE_5410_length_1072_cov_3.302158	422	502	2	50	80	0.6250000
NODE_5410_length_1072_cov_3.302158	422	502	3	5	80	0.0625000
NODE_5410_length_1072_cov_3.302158	422	502	4	3	80	0.0375000
NODE_5414_length_1072_cov_1.773895	114	176	6	8	62	0.1290323
NODE_5414_length_1072_cov_1.773895	114	176	7	7	62	0.1129032
NODE_5414_length_1072_cov_1.773895	114	176	9	3	62	0.0483871
NODE_5414_length_1072_cov_1.773895	114	176	11	11	62	0.1774193
NODE_5414_length_1072_cov_1.773895	114	176	13	2	62	0.0322581
NODE_5414_length_1072_cov_1.773895	114	176	15	1	62	0.0161290
NODE_5414_length_1072_cov_1.773895	114	176	17	6	62	0.0967742
NODE_5414_length_1072_cov_1.773895	114	176	19	1	62	0.0161290
NODE_5414_length_1072_cov_1.773895	114	176	20	1	62	0.0161290
NODE_5414_length_1072_cov_1.773895	114	176	22	20	62	0.3225806
NODE_5414_length_1072_cov_1.773895	114	176	24	2	62	0.0322581
NODE_5417_length_1071_cov_27.565844	312	392	0	13	80	0.1625000
NODE_5417_length_1071_cov_27.565844	312	392	2	67	80	0.8375000
NODE_5417_length_1071_cov_27.565844	365	445	0	11	80	0.1375000
NODE_5417_length_1071_cov_27.565844	365	445	2	69	80	0.8625000
NODE_5419_length_1071_cov_12.666667	480	560	2	25	80	0.3125000
NODE_5419_length_1071_cov_12.666667	480	560	3	6	80	0.0750000
NODE_5419_length_1071_cov_12.666667	480	560	4	6	80	0.0750000
NODE_5419_length_1071_cov_12.666667	480	560	5	3	80	0.0375000
NODE_5419_length_1071_cov_12.666667	480	560	6	40	80	0.5000000
NODE_5419_length_1071_cov_12.666667	533	613	4	59	80	0.7375000
NODE_5419_length_1071_cov_12.666667	533	613	6	21	80	0.2625000
NODE_5421_length_1071_cov_8.942387	418	498	0	80	80	1.0000000
NODE_5421_length_1071_cov_8.942387	471	551	0	80	80	1.0000000
NODE_5427_length_1070_cov_39.255407	591	671	0	66	80	0.8250000
NODE_5427_length_1070_cov_39.255407	591	671	2	14	80	0.1750000
NODE_5427_length_1070_cov_39.255407	644	724	0	19	80	0.2375000
NODE_5427_length_1070_cov_39.255407	644	724	2	61	80	0.7625000
NODE_5428_length_1070_cov_21.903193	430	510	0	80	80	1.0000000
NODE_5428_length_1070_cov_21.903193	483	563	0	80	80	1.0000000
NODE_5428_length_1070_cov_21.903193	559	639	0	8	80	0.1000000
NODE_5428_length_1070_cov_21.903193	559	639	3	1	80	0.0125000
NODE_5428_length_1070_cov_21.903193	559	639	4	33	80	0.4125000
NODE_5428_length_1070_cov_21.903193	559	639	6	2	80	0.0250000
NODE_5428_length_1070_cov_21.903193	559	639	8	36	80	0.4500000
NODE_5428_length_1070_cov_21.903193	612	692	6	2	80	0.0250000
NODE_5428_length_1070_cov_21.903193	612	692	8	69	80	0.8625000
NODE_5428_length_1070_cov_21.903193	612	692	12	9	80	0.1125000
NODE_5429_length_1070_cov_8.963955	871	900	0	3	29	0.1034483
NODE_5429_length_1070_cov_8.963955	871	900	2	2	29	0.0689655
NODE_5429_length_1070_cov_8.963955	871	900	10	3	29	0.1034483
NODE_5429_length_1070_cov_8.963955	871	900	16	1	29	0.0344828
NODE_5429_length_1070_cov_8.963955	871	900	17	1	29	0.0344828
NODE_5429_length_1070_cov_8.963955	871	900	24	3	29	0.1034483
NODE_5429_length_1070_cov_8.963955	871	900	25	1	29	0.0344828
NODE_5429_length_1070_cov_8.963955	871	900	26	4	29	0.1379310
NODE_5429_length_1070_cov_8.963955	871	900	29	1	29	0.0344828
NODE_5429_length_1070_cov_8.963955	871	900	31	2	29	0.0689655
NODE_5429_length_1070_cov_8.963955	871	900	37	2	29	0.0689655
NODE_5429_length_1070_cov_8.963955	871	900	38	1	29	0.0344828
NODE_5429_length_1070_cov_8.963955	871	900	40	1	29	0.0344828
NODE_5429_length_1070_cov_8.963955	871	900	44	1	29	0.0344828
NODE_5429_length_1070_cov_8.963955	871	900	46	1	29	0.0344828
NODE_5429_length_1070_cov_8.963955	871	900	48	2	29	0.0689655
NODE_5429_length_1070_cov_8.963955	873	953	0	2	80	0.0250000
NODE_5429_length_1070_cov_8.963955	873	953	2	1	80	0.0125000
NODE_5429_length_1070_cov_8.963955	873	953	10	3	80	0.0375000
NODE_5429_length_1070_cov_8.963955	873	953	16	1	80	0.0125000
NODE_5429_length_1070_cov_8.963955	873	953	17	1	80	0.0125000
NODE_5429_length_1070_cov_8.963955	873	953	24	3	80	0.0375000
NODE_5429_length_1070_cov_8.963955	873	953	25	1	80	0.0125000
NODE_5429_length_1070_cov_8.963955	873	953	26	4	80	0.0500000
NODE_5429_length_1070_cov_8.963955	873	953	29	1	80	0.0125000
NODE_5429_length_1070_cov_8.963955	873	953	31	2	80	0.0250000
NODE_5429_length_1070_cov_8.963955	873	953	37	2	80	0.0250000
NODE_5429_length_1070_cov_8.963955	873	953	38	1	80	0.0125000
NODE_5429_length_1070_cov_8.963955	873	953	40	1	80	0.0125000
NODE_5429_length_1070_cov_8.963955	873	953	44	1	80	0.0125000
NODE_5429_length_1070_cov_8.963955	873	953	46	1	80	0.0125000
NODE_5429_length_1070_cov_8.963955	873	953	48	3	80	0.0375000
NODE_5429_length_1070_cov_8.963955	873	953	54	1	80	0.0125000
NODE_5429_length_1070_cov_8.963955	873	953	58	1	80	0.0125000
NODE_5429_length_1070_cov_8.963955	873	953	63	1	80	0.0125000
NODE_5429_length_1070_cov_8.963955	873	953	65	2	80	0.0250000
NODE_5429_length_1070_cov_8.963955	873	953	69	1	80	0.0125000
NODE_5429_length_1070_cov_8.963955	873	953	71	1	80	0.0125000
NODE_5429_length_1070_cov_8.963955	873	953	73	1	80	0.0125000
NODE_5429_length_1070_cov_8.963955	873	953	75	1	80	0.0125000
NODE_5429_length_1070_cov_8.963955	873	953	76	1	80	0.0125000
NODE_5429_length_1070_cov_8.963955	873	953	82	1	80	0.0125000
NODE_5429_length_1070_cov_8.963955	873	953	86	2	80	0.0250000
NODE_5429_length_1070_cov_8.963955	873	953	90	4	80	0.0500000
NODE_5429_length_1070_cov_8.963955	873	953	92	1	80	0.0125000
NODE_5429_length_1070_cov_8.963955	873	953	94	8	80	0.1000000
NODE_5429_length_1070_cov_8.963955	873	953	96	1	80	0.0125000
NODE_5429_length_1070_cov_8.963955	873	953	98	1	80	0.0125000
NODE_5429_length_1070_cov_8.963955	873	953	100	1	80	0.0125000
NODE_5429_length_1070_cov_8.963955	873	953	104	1	80	0.0125000
NODE_5429_length_1070_cov_8.963955	873	953	106	1	80	0.0125000
NODE_5429_length_1070_cov_8.963955	873	953	108	4	80	0.0500000
NODE_5429_length_1070_cov_8.963955	873	953	112	1	80	0.0125000
NODE_5429_length_1070_cov_8.963955	873	953	116	16	80	0.2000000
NODE_5433_length_1070_cov_1.659114	1027	1046	2	19	19	1.0000000
NODE_5439_length_1069_cov_40.277320	451	531	4	1	80	0.0125000
NODE_5439_length_1069_cov_40.277320	451	531	6	48	80	0.6000000
NODE_5439_length_1069_cov_40.277320	451	531	8	31	80	0.3875000
NODE_5439_length_1069_cov_40.277320	504	584	0	11	80	0.1375000
NODE_5439_length_1069_cov_40.277320	504	584	3	22	80	0.2750000
NODE_5439_length_1069_cov_40.277320	504	584	4	21	80	0.2625000
NODE_5439_length_1069_cov_40.277320	504	584	6	26	80	0.3250000
NODE_5440_length_1069_cov_23.571134	274	354	0	80	80	1.0000000
NODE_5440_length_1069_cov_23.571134	327	407	0	80	80	1.0000000
NODE_5441_length_1069_cov_22.436082	185	265	0	3	80	0.0375000
NODE_5441_length_1069_cov_22.436082	185	265	3	3	80	0.0375000
NODE_5441_length_1069_cov_22.436082	185	265	4	2	80	0.0250000
NODE_5441_length_1069_cov_22.436082	185	265	5	28	80	0.3500000
NODE_5441_length_1069_cov_22.436082	185	265	6	44	80	0.5500000
NODE_5441_length_1069_cov_22.436082	238	318	0	56	80	0.7000000
NODE_5441_length_1069_cov_22.436082	238	318	3	3	80	0.0375000
NODE_5441_length_1069_cov_22.436082	238	318	4	2	80	0.0250000
NODE_5441_length_1069_cov_22.436082	238	318	5	19	80	0.2375000
NODE_5442_length_1069_cov_18.207216	436	516	0	42	80	0.5250000
NODE_5442_length_1069_cov_18.207216	436	516	2	11	80	0.1375000
NODE_5442_length_1069_cov_18.207216	436	516	3	5	80	0.0625000
NODE_5442_length_1069_cov_18.207216	436	516	5	22	80	0.2750000
NODE_5442_length_1069_cov_18.207216	489	569	3	5	80	0.0625000
NODE_5442_length_1069_cov_18.207216	489	569	5	75	80	0.9375000
NODE_5443_length_1069_cov_17.601031	596	676	0	80	80	1.0000000
NODE_5443_length_1069_cov_17.601031	649	729	0	80	80	1.0000000
NODE_5444_length_1069_cov_16.318557	353	433	0	10	80	0.1250000
NODE_5444_length_1069_cov_16.318557	353	433	4	31	80	0.3875000
NODE_5444_length_1069_cov_16.318557	353	433	6	39	80	0.4875000
NODE_5444_length_1069_cov_16.318557	406	486	0	63	80	0.7875000
NODE_5444_length_1069_cov_16.318557	406	486	4	17	80	0.2125000
NODE_5444_length_1069_cov_16.318557	482	562	0	80	80	1.0000000
NODE_5444_length_1069_cov_16.318557	535	615	0	80	80	1.0000000
NODE_5445_length_1069_cov_13.349485	471	551	0	80	80	1.0000000
NODE_5445_length_1069_cov_13.349485	524	604	0	80	80	1.0000000
NODE_5446_length_1069_cov_13.050515	314	394	0	80	80	1.0000000
NODE_5446_length_1069_cov_13.050515	367	447	0	80	80	1.0000000
NODE_5447_length_1069_cov_12.818557	240	320	0	80	80	1.0000000
NODE_5447_length_1069_cov_12.818557	293	373	0	80	80	1.0000000
NODE_5448_length_1069_cov_11.985567	554	634	0	80	80	1.0000000
NODE_5448_length_1069_cov_11.985567	607	687	0	80	80	1.0000000
NODE_5449_length_1069_cov_10.812371	366	446	0	5	80	0.0625000
NODE_5449_length_1069_cov_10.812371	366	446	2	75	80	0.9375000
NODE_5449_length_1069_cov_10.812371	419	499	2	53	80	0.6625000
NODE_5449_length_1069_cov_10.812371	419	499	4	14	80	0.1750000
NODE_5449_length_1069_cov_10.812371	419	499	6	13	80	0.1625000
NODE_5450_length_1069_cov_7.729897	482	562	4	80	80	1.0000000
NODE_5450_length_1069_cov_7.729897	535	615	0	36	80	0.4500000
NODE_5450_length_1069_cov_7.729897	535	615	4	44	80	0.5500000
NODE_5456_length_1068_cov_31.692466	314	394	2	80	80	1.0000000
NODE_5456_length_1068_cov_31.692466	367	447	0	52	80	0.6500000
NODE_5456_length_1068_cov_31.692466	367	447	2	28	80	0.3500000
NODE_5456_length_1068_cov_31.692466	443	523	0	80	80	1.0000000
NODE_5456_length_1068_cov_31.692466	496	576	0	80	80	1.0000000
NODE_5457_length_1068_cov_29.579979	347	427	2	80	80	1.0000000
NODE_5457_length_1068_cov_29.579979	400	480	0	26	80	0.3250000
NODE_5457_length_1068_cov_29.579979	400	480	2	54	80	0.6750000
NODE_5459_length_1068_cov_23.020640	476	556	0	8	80	0.1000000
NODE_5459_length_1068_cov_23.020640	476	556	2	72	80	0.9000000
NODE_5459_length_1068_cov_23.020640	529	609	0	36	80	0.4500000
NODE_5459_length_1068_cov_23.020640	529	609	2	44	80	0.5500000
NODE_5460_length_1068_cov_15.272446	546	626	0	55	80	0.6875000
NODE_5460_length_1068_cov_15.272446	546	626	2	6	80	0.0750000
NODE_5460_length_1068_cov_15.272446	546	626	3	11	80	0.1375000
NODE_5460_length_1068_cov_15.272446	546	626	4	8	80	0.1000000
NODE_5460_length_1068_cov_15.272446	599	679	0	2	80	0.0250000
NODE_5460_length_1068_cov_15.272446	599	679	2	6	80	0.0750000
NODE_5460_length_1068_cov_15.272446	599	679	3	11	80	0.1375000
NODE_5460_length_1068_cov_15.272446	599	679	4	61	80	0.7625000
NODE_5461_length_1068_cov_13.557276	674	754	0	80	80	1.0000000
NODE_5461_length_1068_cov_13.557276	727	807	0	80	80	1.0000000
NODE_5479_length_1067_cov_48.282025	429	509	0	2	80	0.0250000
NODE_5479_length_1067_cov_48.282025	429	509	2	1	80	0.0125000
NODE_5479_length_1067_cov_48.282025	429	509	9	55	80	0.6875000
NODE_5479_length_1067_cov_48.282025	429	509	10	22	80	0.2750000
NODE_5479_length_1067_cov_48.282025	482	562	0	55	80	0.6875000
NODE_5479_length_1067_cov_48.282025	482	562	2	1	80	0.0125000
NODE_5479_length_1067_cov_48.282025	482	562	9	24	80	0.3000000
NODE_5480_length_1067_cov_41.111570	460	540	9	21	80	0.2625000
NODE_5480_length_1067_cov_41.111570	460	540	12	8	80	0.1000000
NODE_5480_length_1067_cov_41.111570	460	540	13	43	80	0.5375000
NODE_5480_length_1067_cov_41.111570	460	540	14	8	80	0.1000000
NODE_5480_length_1067_cov_41.111570	513	593	6	34	80	0.4250000
NODE_5480_length_1067_cov_41.111570	513	593	9	3	80	0.0375000
NODE_5480_length_1067_cov_41.111570	513	593	12	16	80	0.2000000
NODE_5480_length_1067_cov_41.111570	513	593	13	19	80	0.2375000
NODE_5480_length_1067_cov_41.111570	513	593	14	8	80	0.1000000
NODE_5481_length_1067_cov_39.109504	295	375	0	80	80	1.0000000
NODE_5481_length_1067_cov_39.109504	348	428	0	80	80	1.0000000
NODE_5481_length_1067_cov_39.109504	424	504	0	53	80	0.6625000
NODE_5481_length_1067_cov_39.109504	424	504	4	27	80	0.3375000
NODE_5481_length_1067_cov_39.109504	477	557	4	80	80	1.0000000
NODE_5482_length_1067_cov_35.426653	252	332	0	1	80	0.0125000
NODE_5482_length_1067_cov_35.426653	252	332	1	31	80	0.3875000
NODE_5482_length_1067_cov_35.426653	252	332	2	48	80	0.6000000
NODE_5482_length_1067_cov_35.426653	305	385	0	28	80	0.3500000
NODE_5482_length_1067_cov_35.426653	305	385	2	52	80	0.6500000
NODE_5483_length_1067_cov_29.467975	412	492	0	2	80	0.0250000
NODE_5483_length_1067_cov_29.467975	412	492	2	78	80	0.9750000
NODE_5483_length_1067_cov_29.467975	465	545	0	55	80	0.6875000
NODE_5483_length_1067_cov_29.467975	465	545	2	25	80	0.3125000
NODE_5484_length_1067_cov_20.738636	579	645	28	1	66	0.0151515
NODE_5484_length_1067_cov_20.738636	579	645	32	2	66	0.0303030
NODE_5484_length_1067_cov_20.738636	579	645	34	6	66	0.0909091
NODE_5484_length_1067_cov_20.738636	579	645	36	1	66	0.0151515
NODE_5484_length_1067_cov_20.738636	579	645	40	1	66	0.0151515
NODE_5484_length_1067_cov_20.738636	579	645	46	1	66	0.0151515
NODE_5484_length_1067_cov_20.738636	579	645	54	3	66	0.0454545
NODE_5484_length_1067_cov_20.738636	579	645	58	7	66	0.1060606
NODE_5484_length_1067_cov_20.738636	579	645	60	1	66	0.0151515
NODE_5484_length_1067_cov_20.738636	579	645	62	5	66	0.0757576
NODE_5484_length_1067_cov_20.738636	579	645	64	1	66	0.0151515
NODE_5484_length_1067_cov_20.738636	579	645	66	3	66	0.0454545
NODE_5484_length_1067_cov_20.738636	579	645	69	1	66	0.0151515
NODE_5484_length_1067_cov_20.738636	579	645	71	1	66	0.0151515
NODE_5484_length_1067_cov_20.738636	579	645	75	6	66	0.0909091
NODE_5484_length_1067_cov_20.738636	579	645	77	4	66	0.0606061
NODE_5484_length_1067_cov_20.738636	579	645	79	10	66	0.1515152
NODE_5484_length_1067_cov_20.738636	579	645	81	2	66	0.0303030
NODE_5484_length_1067_cov_20.738636	579	645	84	5	66	0.0757576
NODE_5484_length_1067_cov_20.738636	579	645	85	2	66	0.0303030
NODE_5484_length_1067_cov_20.738636	579	645	91	3	66	0.0454545
NODE_5484_length_1067_cov_20.738636	618	698	75	3	80	0.0375000
NODE_5484_length_1067_cov_20.738636	618	698	77	2	80	0.0250000
NODE_5484_length_1067_cov_20.738636	618	698	79	10	80	0.1250000
NODE_5484_length_1067_cov_20.738636	618	698	81	2	80	0.0250000
NODE_5484_length_1067_cov_20.738636	618	698	84	5	80	0.0625000
NODE_5484_length_1067_cov_20.738636	618	698	85	2	80	0.0250000
NODE_5484_length_1067_cov_20.738636	618	698	91	6	80	0.0750000
NODE_5484_length_1067_cov_20.738636	618	698	98	3	80	0.0375000
NODE_5484_length_1067_cov_20.738636	618	698	102	9	80	0.1125000
NODE_5484_length_1067_cov_20.738636	618	698	104	14	80	0.1750000
NODE_5484_length_1067_cov_20.738636	618	698	105	4	80	0.0500000
NODE_5484_length_1067_cov_20.738636	618	698	106	2	80	0.0250000
NODE_5484_length_1067_cov_20.738636	618	698	107	5	80	0.0625000
NODE_5484_length_1067_cov_20.738636	618	698	108	8	80	0.1000000
NODE_5484_length_1067_cov_20.738636	618	698	110	3	80	0.0375000
NODE_5484_length_1067_cov_20.738636	618	698	112	2	80	0.0250000
NODE_5485_length_1067_cov_15.280992	538	617	0	79	79	1.0000000
NODE_5485_length_1067_cov_15.280992	590	670	0	80	80	1.0000000
NODE_5486_length_1067_cov_13.708678	478	558	0	10	80	0.1250000
NODE_5486_length_1067_cov_13.708678	478	558	3	1	80	0.0125000
NODE_5486_length_1067_cov_13.708678	478	558	4	69	80	0.8625000
NODE_5486_length_1067_cov_13.708678	531	611	0	19	80	0.2375000
NODE_5486_length_1067_cov_13.708678	531	611	4	61	80	0.7625000
NODE_5488_length_1067_cov_9.070248	625	705	2	38	80	0.4750000
NODE_5488_length_1067_cov_9.070248	625	705	6	32	80	0.4000000
NODE_5488_length_1067_cov_9.070248	625	705	8	10	80	0.1250000
NODE_5488_length_1067_cov_9.070248	678	758	2	13	80	0.1625000
NODE_5488_length_1067_cov_9.070248	678	758	6	36	80	0.4500000
NODE_5488_length_1067_cov_9.070248	678	758	8	31	80	0.3875000
NODE_5494_length_1067_cov_1.946281	765	812	0	47	47	1.0000000
NODE_5501_length_1066_cov_54.227508	395	475	1	13	80	0.1625000
NODE_5501_length_1066_cov_54.227508	395	475	2	61	80	0.7625000
NODE_5501_length_1066_cov_54.227508	395	475	3	6	80	0.0750000
NODE_5501_length_1066_cov_54.227508	448	528	1	13	80	0.1625000
NODE_5501_length_1066_cov_54.227508	448	528	2	8	80	0.1000000
NODE_5501_length_1066_cov_54.227508	448	528	3	7	80	0.0875000
NODE_5501_length_1066_cov_54.227508	448	528	4	11	80	0.1375000
NODE_5501_length_1066_cov_54.227508	448	528	5	29	80	0.3625000
NODE_5501_length_1066_cov_54.227508	448	528	6	12	80	0.1500000
NODE_5502_length_1066_cov_33.501551	357	437	6	3	80	0.0375000
NODE_5502_length_1066_cov_33.501551	357	437	8	54	80	0.6750000
NODE_5502_length_1066_cov_33.501551	357	437	10	17	80	0.2125000
NODE_5502_length_1066_cov_33.501551	357	437	12	6	80	0.0750000
NODE_5502_length_1066_cov_33.501551	410	490	4	9	80	0.1125000
NODE_5502_length_1066_cov_33.501551	410	490	6	46	80	0.5750000
NODE_5502_length_1066_cov_33.501551	410	490	8	2	80	0.0250000
NODE_5502_length_1066_cov_33.501551	410	490	10	17	80	0.2125000
NODE_5502_length_1066_cov_33.501551	410	490	12	6	80	0.0750000
NODE_5503_length_1066_cov_33.115822	397	477	0	80	80	1.0000000
NODE_5503_length_1066_cov_33.115822	450	530	0	60	80	0.7500000
NODE_5503_length_1066_cov_33.115822	450	530	2	20	80	0.2500000
NODE_5504_length_1066_cov_26.517063	215	285	91	1	70	0.0142857
NODE_5504_length_1066_cov_26.517063	215	285	95	2	70	0.0285714
NODE_5504_length_1066_cov_26.517063	215	285	97	2	70	0.0285714
NODE_5504_length_1066_cov_26.517063	215	285	99	2	70	0.0285714
NODE_5504_length_1066_cov_26.517063	215	285	103	1	70	0.0142857
NODE_5504_length_1066_cov_26.517063	215	285	104	1	70	0.0142857
NODE_5504_length_1066_cov_26.517063	215	285	107	3	70	0.0428571
NODE_5504_length_1066_cov_26.517063	215	285	108	2	70	0.0285714
NODE_5504_length_1066_cov_26.517063	215	285	110	1	70	0.0142857
NODE_5504_length_1066_cov_26.517063	215	285	118	1	70	0.0142857
NODE_5504_length_1066_cov_26.517063	215	285	123	1	70	0.0142857
NODE_5504_length_1066_cov_26.517063	215	285	127	2	70	0.0285714
NODE_5504_length_1066_cov_26.517063	215	285	129	1	70	0.0142857
NODE_5504_length_1066_cov_26.517063	215	285	133	1	70	0.0142857
NODE_5504_length_1066_cov_26.517063	215	285	137	2	70	0.0285714
NODE_5504_length_1066_cov_26.517063	215	285	139	1	70	0.0142857
NODE_5504_length_1066_cov_26.517063	215	285	141	2	70	0.0285714
NODE_5504_length_1066_cov_26.517063	215	285	147	2	70	0.0285714
NODE_5504_length_1066_cov_26.517063	215	285	148	5	70	0.0714286
NODE_5504_length_1066_cov_26.517063	215	285	149	3	70	0.0428571
NODE_5504_length_1066_cov_26.517063	215	285	150	1	70	0.0142857
NODE_5504_length_1066_cov_26.517063	215	285	151	2	70	0.0285714
NODE_5504_length_1066_cov_26.517063	215	285	156	1	70	0.0142857
NODE_5504_length_1066_cov_26.517063	215	285	159	1	70	0.0142857
NODE_5504_length_1066_cov_26.517063	215	285	160	1	70	0.0142857
NODE_5504_length_1066_cov_26.517063	215	285	162	1	70	0.0142857
NODE_5504_length_1066_cov_26.517063	215	285	163	1	70	0.0142857
NODE_5504_length_1066_cov_26.517063	215	285	167	2	70	0.0285714
NODE_5504_length_1066_cov_26.517063	215	285	171	1	70	0.0142857
NODE_5504_length_1066_cov_26.517063	215	285	172	3	70	0.0428571
NODE_5504_length_1066_cov_26.517063	215	285	174	2	70	0.0285714
NODE_5504_length_1066_cov_26.517063	215	285	177	2	70	0.0285714
NODE_5504_length_1066_cov_26.517063	215	285	178	5	70	0.0714286
NODE_5504_length_1066_cov_26.517063	215	285	179	2	70	0.0285714
NODE_5504_length_1066_cov_26.517063	215	285	180	2	70	0.0285714
NODE_5504_length_1066_cov_26.517063	215	285	181	1	70	0.0142857
NODE_5504_length_1066_cov_26.517063	215	285	187	1	70	0.0142857
NODE_5504_length_1066_cov_26.517063	215	285	188	3	70	0.0428571
NODE_5504_length_1066_cov_26.517063	215	285	189	1	70	0.0142857
NODE_5504_length_1066_cov_26.517063	215	285	203	1	70	0.0142857
NODE_5505_length_1066_cov_16.906929	526	606	0	80	80	1.0000000
NODE_5505_length_1066_cov_16.906929	579	659	0	80	80	1.0000000
NODE_5506_length_1066_cov_16.190279	298	378	3	24	80	0.3000000
NODE_5506_length_1066_cov_16.190279	298	378	6	56	80	0.7000000
NODE_5506_length_1066_cov_16.190279	351	432	6	30	81	0.3703704
NODE_5506_length_1066_cov_16.190279	351	432	8	51	81	0.6296296
NODE_5507_length_1066_cov_15.444674	582	662	2	11	80	0.1375000
NODE_5507_length_1066_cov_15.444674	582	662	8	4	80	0.0500000
NODE_5507_length_1066_cov_15.444674	582	662	10	19	80	0.2375000
NODE_5507_length_1066_cov_15.444674	582	662	12	46	80	0.5750000
NODE_5507_length_1066_cov_15.444674	635	715	0	13	80	0.1625000
NODE_5507_length_1066_cov_15.444674	635	715	2	51	80	0.6375000
NODE_5507_length_1066_cov_15.444674	635	715	10	16	80	0.2000000
NODE_5516_length_1065_cov_51.693582	480	560	0	9	80	0.1125000
NODE_5516_length_1065_cov_51.693582	480	560	2	71	80	0.8875000
NODE_5516_length_1065_cov_51.693582	533	613	0	28	80	0.3500000
NODE_5516_length_1065_cov_51.693582	533	613	2	52	80	0.6500000
NODE_5517_length_1065_cov_33.428571	422	502	0	80	80	1.0000000
NODE_5517_length_1065_cov_33.428571	422	502	0	80	80	1.0000000
NODE_5517_length_1065_cov_33.428571	422	502	0	80	80	1.0000000
NODE_5517_length_1065_cov_33.428571	475	555	0	76	80	0.9500000
NODE_5517_length_1065_cov_33.428571	475	555	1	1	80	0.0125000
NODE_5517_length_1065_cov_33.428571	475	555	2	3	80	0.0375000
NODE_5517_length_1065_cov_33.428571	475	555	0	76	80	0.9500000
NODE_5517_length_1065_cov_33.428571	475	555	1	1	80	0.0125000
NODE_5517_length_1065_cov_33.428571	475	555	2	3	80	0.0375000
NODE_5517_length_1065_cov_33.428571	551	631	1	1	80	0.0125000
NODE_5517_length_1065_cov_33.428571	551	631	2	79	80	0.9875000
NODE_5517_length_1065_cov_33.428571	551	631	1	1	80	0.0125000
NODE_5517_length_1065_cov_33.428571	551	631	2	79	80	0.9875000
NODE_5517_length_1065_cov_33.428571	551	572	1	1	21	0.0476190
NODE_5517_length_1065_cov_33.428571	551	572	2	20	21	0.9523810
NODE_5517_length_1065_cov_33.428571	604	666	0	32	62	0.5161290
NODE_5517_length_1065_cov_33.428571	604	666	2	30	62	0.4838710
NODE_5517_length_1065_cov_33.428571	604	684	0	37	80	0.4625000
NODE_5517_length_1065_cov_33.428571	604	684	2	35	80	0.4375000
NODE_5517_length_1065_cov_33.428571	604	684	3	6	80	0.0750000
NODE_5517_length_1065_cov_33.428571	604	684	5	1	80	0.0125000
NODE_5517_length_1065_cov_33.428571	604	684	6	1	80	0.0125000
NODE_5518_length_1065_cov_31.874741	255	335	0	80	80	1.0000000
NODE_5518_length_1065_cov_31.874741	308	388	0	80	80	1.0000000
NODE_5519_length_1065_cov_21.762940	234	314	0	4	80	0.0500000
NODE_5519_length_1065_cov_21.762940	234	314	4	7	80	0.0875000
NODE_5519_length_1065_cov_21.762940	234	314	6	69	80	0.8625000
NODE_5519_length_1065_cov_21.762940	287	367	0	21	80	0.2625000
NODE_5519_length_1065_cov_21.762940	287	367	4	7	80	0.0875000
NODE_5519_length_1065_cov_21.762940	287	367	6	52	80	0.6500000
NODE_5520_length_1065_cov_19.947205	447	527	2	1	80	0.0125000
NODE_5520_length_1065_cov_19.947205	447	527	4	51	80	0.6375000
NODE_5520_length_1065_cov_19.947205	447	527	6	28	80	0.3500000
NODE_5520_length_1065_cov_19.947205	500	580	0	22	80	0.2750000
NODE_5520_length_1065_cov_19.947205	500	580	2	32	80	0.4000000
NODE_5520_length_1065_cov_19.947205	500	580	6	26	80	0.3250000
NODE_5521_length_1065_cov_14.590062	343	423	0	6	80	0.0750000
NODE_5521_length_1065_cov_14.590062	343	423	4	74	80	0.9250000
NODE_5521_length_1065_cov_14.590062	396	476	0	20	80	0.2500000
NODE_5521_length_1065_cov_14.590062	396	476	4	60	80	0.7500000
NODE_5522_length_1065_cov_13.232919	243	323	0	8	80	0.1000000
NODE_5522_length_1065_cov_13.232919	243	323	6	72	80	0.9000000
NODE_5522_length_1065_cov_13.232919	296	376	0	61	80	0.7625000
NODE_5522_length_1065_cov_13.232919	296	376	6	19	80	0.2375000
NODE_5523_length_1065_cov_10.670807	481	561	0	80	80	1.0000000
NODE_5523_length_1065_cov_10.670807	534	614	0	80	80	1.0000000
NODE_5524_length_1065_cov_10.473085	496	576	0	80	80	1.0000000
NODE_5524_length_1065_cov_10.473085	549	629	0	80	80	1.0000000
NODE_5525_length_1065_cov_9.711180	286	360	0	74	74	1.0000000
NODE_5525_length_1065_cov_9.711180	339	419	0	80	80	1.0000000
NODE_5534_length_1064_cov_59.929534	457	537	0	23	80	0.2875000
NODE_5534_length_1064_cov_59.929534	457	537	2	57	80	0.7125000
NODE_5534_length_1064_cov_59.929534	510	590	0	42	80	0.5250000
NODE_5534_length_1064_cov_59.929534	510	590	2	38	80	0.4750000
NODE_5534_length_1064_cov_59.929534	586	666	0	80	80	1.0000000
NODE_5534_length_1064_cov_59.929534	639	719	0	49	80	0.6125000
NODE_5534_length_1064_cov_59.929534	639	719	2	31	80	0.3875000
NODE_5535_length_1064_cov_36.480829	367	447	0	37	80	0.4625000
NODE_5535_length_1064_cov_36.480829	367	447	2	43	80	0.5375000
NODE_5535_length_1064_cov_36.480829	420	500	0	27	80	0.3375000
NODE_5535_length_1064_cov_36.480829	420	500	2	53	80	0.6625000
NODE_5535_length_1064_cov_36.480829	496	576	0	2	80	0.0250000
NODE_5535_length_1064_cov_36.480829	496	576	2	78	80	0.9750000
NODE_5535_length_1064_cov_36.480829	549	629	0	48	80	0.6000000
NODE_5535_length_1064_cov_36.480829	549	629	2	32	80	0.4000000
NODE_5536_length_1064_cov_32.307772	547	627	2	9	80	0.1125000
NODE_5536_length_1064_cov_32.307772	547	627	4	12	80	0.1500000
NODE_5536_length_1064_cov_32.307772	547	627	6	28	80	0.3500000
NODE_5536_length_1064_cov_32.307772	547	627	8	6	80	0.0750000
NODE_5536_length_1064_cov_32.307772	547	627	14	4	80	0.0500000
NODE_5536_length_1064_cov_32.307772	547	627	16	21	80	0.2625000
NODE_5536_length_1064_cov_32.307772	600	680	8	2	80	0.0250000
NODE_5536_length_1064_cov_32.307772	600	680	14	4	80	0.0500000
NODE_5536_length_1064_cov_32.307772	600	680	16	35	80	0.4375000
NODE_5536_length_1064_cov_32.307772	600	680	18	23	80	0.2875000
NODE_5536_length_1064_cov_32.307772	600	680	20	16	80	0.2000000
NODE_5537_length_1064_cov_25.255959	462	542	0	80	80	1.0000000
NODE_5537_length_1064_cov_25.255959	515	595	0	80	80	1.0000000
NODE_5537_length_1064_cov_25.255959	591	671	0	52	80	0.6500000
NODE_5537_length_1064_cov_25.255959	591	671	2	11	80	0.1375000
NODE_5537_length_1064_cov_25.255959	591	671	4	17	80	0.2125000
NODE_5537_length_1064_cov_25.255959	644	724	2	10	80	0.1250000
NODE_5537_length_1064_cov_25.255959	644	724	4	70	80	0.8750000
NODE_5538_length_1064_cov_23.053886	343	423	0	80	80	1.0000000
NODE_5538_length_1064_cov_23.053886	396	476	0	80	80	1.0000000
NODE_5538_length_1064_cov_23.053886	472	552	0	80	80	1.0000000
NODE_5538_length_1064_cov_23.053886	525	605	0	80	80	1.0000000
NODE_5539_length_1064_cov_22.018653	479	559	2	20	80	0.2500000
NODE_5539_length_1064_cov_22.018653	479	559	6	45	80	0.5625000
NODE_5539_length_1064_cov_22.018653	479	559	10	13	80	0.1625000
NODE_5539_length_1064_cov_22.018653	479	559	12	2	80	0.0250000
NODE_5539_length_1064_cov_22.018653	532	612	6	12	80	0.1500000
NODE_5539_length_1064_cov_22.018653	532	612	8	44	80	0.5500000
NODE_5539_length_1064_cov_22.018653	532	612	10	21	80	0.2625000
NODE_5539_length_1064_cov_22.018653	532	612	12	3	80	0.0375000
NODE_5540_length_1064_cov_12.868394	424	504	0	80	80	1.0000000
NODE_5540_length_1064_cov_12.868394	477	557	0	80	80	1.0000000
NODE_5541_length_1064_cov_10.098446	467	547	0	68	80	0.8500000
NODE_5541_length_1064_cov_10.098446	467	547	2	9	80	0.1125000
NODE_5541_length_1064_cov_10.098446	467	547	4	3	80	0.0375000
NODE_5541_length_1064_cov_10.098446	520	600	0	15	80	0.1875000
NODE_5541_length_1064_cov_10.098446	520	600	2	9	80	0.1125000
NODE_5541_length_1064_cov_10.098446	520	600	4	56	80	0.7000000
NODE_5543_length_1064_cov_2.925389	173	245	4	3	72	0.0416667
NODE_5543_length_1064_cov_2.925389	173	245	6	6	72	0.0833333
NODE_5543_length_1064_cov_2.925389	173	245	10	28	72	0.3888889
NODE_5543_length_1064_cov_2.925389	173	245	14	23	72	0.3194444
NODE_5543_length_1064_cov_2.925389	173	245	16	1	72	0.0138889
NODE_5543_length_1064_cov_2.925389	173	245	20	11	72	0.1527778
NODE_5551_length_1063_cov_104.615145	504	584	0	80	80	1.0000000
NODE_5551_length_1063_cov_104.615145	557	637	0	80	80	1.0000000
NODE_5552_length_1063_cov_36.515560	482	562	0	80	80	1.0000000
NODE_5552_length_1063_cov_36.515560	535	615	0	80	80	1.0000000
NODE_5552_length_1063_cov_36.515560	611	691	0	80	80	1.0000000
NODE_5552_length_1063_cov_36.515560	664	744	0	80	80	1.0000000
NODE_5553_length_1063_cov_30.700207	470	550	0	66	80	0.8250000
NODE_5553_length_1063_cov_30.700207	470	550	6	14	80	0.1750000
NODE_5553_length_1063_cov_30.700207	523	603	0	13	80	0.1625000
NODE_5553_length_1063_cov_30.700207	523	603	6	16	80	0.2000000
NODE_5553_length_1063_cov_30.700207	523	603	11	5	80	0.0625000
NODE_5553_length_1063_cov_30.700207	523	603	12	46	80	0.5750000
NODE_5553_length_1063_cov_30.700207	599	679	11	80	80	1.0000000
NODE_5553_length_1063_cov_30.700207	652	732	0	30	80	0.3750000
NODE_5553_length_1063_cov_30.700207	652	732	5	4	80	0.0500000
NODE_5553_length_1063_cov_30.700207	652	732	6	12	80	0.1500000
NODE_5553_length_1063_cov_30.700207	652	732	11	34	80	0.4250000
NODE_5554_length_1063_cov_24.552905	362	442	0	80	80	1.0000000
NODE_5554_length_1063_cov_24.552905	415	495	0	30	80	0.3750000
NODE_5554_length_1063_cov_24.552905	415	495	2	50	80	0.6250000
NODE_5555_length_1063_cov_21.985477	407	487	0	80	80	1.0000000
NODE_5555_length_1063_cov_21.985477	460	540	0	80	80	1.0000000
NODE_5555_length_1063_cov_21.985477	536	616	0	61	80	0.7625000
NODE_5555_length_1063_cov_21.985477	536	616	2	19	80	0.2375000
NODE_5555_length_1063_cov_21.985477	589	670	0	8	81	0.0987654
NODE_5555_length_1063_cov_21.985477	589	670	2	73	81	0.9012346
NODE_5557_length_1063_cov_15.400415	685	765	0	17	80	0.2125000
NODE_5557_length_1063_cov_15.400415	685	765	2	63	80	0.7875000
NODE_5557_length_1063_cov_15.400415	738	818	0	31	80	0.3875000
NODE_5557_length_1063_cov_15.400415	738	818	2	49	80	0.6125000
NODE_5558_length_1063_cov_13.282158	510	590	0	21	80	0.2625000
NODE_5558_length_1063_cov_13.282158	510	590	3	1	80	0.0125000
NODE_5558_length_1063_cov_13.282158	510	590	4	58	80	0.7250000
NODE_5558_length_1063_cov_13.282158	563	643	0	27	80	0.3375000
NODE_5558_length_1063_cov_13.282158	563	643	4	53	80	0.6625000
NODE_5559_length_1063_cov_12.970954	417	495	0	22	78	0.2820513
NODE_5559_length_1063_cov_12.970954	417	495	2	56	78	0.7179487
NODE_5559_length_1063_cov_12.970954	468	548	0	43	80	0.5375000
NODE_5559_length_1063_cov_12.970954	468	548	2	37	80	0.4625000
NODE_5560_length_1063_cov_7.917012	639	719	0	80	80	1.0000000
NODE_5560_length_1063_cov_7.917012	692	772	0	80	80	1.0000000
NODE_5569_length_1063_cov_1.695021	893	947	4	5	54	0.0925926
NODE_5569_length_1063_cov_1.695021	893	947	8	4	54	0.0740741
NODE_5569_length_1063_cov_1.695021	893	947	10	30	54	0.5555556
NODE_5569_length_1063_cov_1.695021	893	947	14	15	54	0.2777778
NODE_5574_length_1062_cov_43.399792	272	352	0	46	80	0.5750000
NODE_5574_length_1062_cov_43.399792	272	352	4	34	80	0.4250000
NODE_5574_length_1062_cov_43.399792	325	405	4	80	80	1.0000000
NODE_5576_length_1062_cov_19.778816	401	481	10	29	80	0.3625000
NODE_5576_length_1062_cov_19.778816	401	481	14	24	80	0.3000000
NODE_5576_length_1062_cov_19.778816	401	481	15	4	80	0.0500000
NODE_5576_length_1062_cov_19.778816	401	481	16	4	80	0.0500000
NODE_5576_length_1062_cov_19.778816	401	481	18	1	80	0.0125000
NODE_5576_length_1062_cov_19.778816	401	481	19	18	80	0.2250000
NODE_5576_length_1062_cov_19.778816	454	534	6	1	80	0.0125000
NODE_5576_length_1062_cov_19.778816	454	534	10	26	80	0.3250000
NODE_5576_length_1062_cov_19.778816	454	534	14	10	80	0.1250000
NODE_5576_length_1062_cov_19.778816	454	534	15	4	80	0.0500000
NODE_5576_length_1062_cov_19.778816	454	534	16	20	80	0.2500000
NODE_5576_length_1062_cov_19.778816	454	534	18	1	80	0.0125000
NODE_5576_length_1062_cov_19.778816	454	534	19	18	80	0.2250000
NODE_5577_length_1062_cov_16.034268	628	708	0	80	80	1.0000000
NODE_5577_length_1062_cov_16.034268	681	761	0	80	80	1.0000000
NODE_5578_length_1062_cov_13.346833	623	703	0	41	80	0.5125000
NODE_5578_length_1062_cov_13.346833	623	703	1	31	80	0.3875000
NODE_5578_length_1062_cov_13.346833	623	703	2	8	80	0.1000000
NODE_5578_length_1062_cov_13.346833	676	756	0	80	80	1.0000000
NODE_5579_length_1062_cov_9.886812	670	750	0	7	80	0.0875000
NODE_5579_length_1062_cov_9.886812	670	750	1	39	80	0.4875000
NODE_5579_length_1062_cov_9.886812	670	750	2	34	80	0.4250000
NODE_5579_length_1062_cov_9.886812	723	803	0	60	80	0.7500000
NODE_5579_length_1062_cov_9.886812	723	803	2	20	80	0.2500000
NODE_5580_length_1062_cov_9.078920	525	604	0	75	79	0.9493671
NODE_5580_length_1062_cov_9.078920	525	604	2	4	79	0.0506329
NODE_5580_length_1062_cov_9.078920	577	657	0	80	80	1.0000000
NODE_5581_length_1062_cov_8.934579	203	283	0	42	80	0.5250000
NODE_5581_length_1062_cov_8.934579	203	283	2	38	80	0.4750000
NODE_5581_length_1062_cov_8.934579	256	336	2	80	80	1.0000000
NODE_5588_length_1061_cov_22.637214	418	498	0	30	80	0.3750000
NODE_5588_length_1061_cov_22.637214	418	498	2	50	80	0.6250000
NODE_5588_length_1061_cov_22.637214	471	551	0	80	80	1.0000000
NODE_5589_length_1061_cov_22.338877	479	559	0	5	80	0.0625000
NODE_5589_length_1061_cov_22.338877	479	559	2	75	80	0.9375000
NODE_5589_length_1061_cov_22.338877	532	612	0	58	80	0.7250000
NODE_5589_length_1061_cov_22.338877	532	612	2	22	80	0.2750000
NODE_5597_length_1060_cov_31.595213	394	473	0	6	79	0.0759494
NODE_5597_length_1060_cov_31.595213	394	473	2	9	79	0.1139240
NODE_5597_length_1060_cov_31.595213	394	473	4	28	79	0.3544304
NODE_5597_length_1060_cov_31.595213	394	473	6	36	79	0.4556962
NODE_5597_length_1060_cov_31.595213	446	526	0	26	80	0.3250000
NODE_5597_length_1060_cov_31.595213	446	526	4	54	80	0.6750000
NODE_5597_length_1060_cov_31.595213	522	602	0	80	80	1.0000000
NODE_5597_length_1060_cov_31.595213	575	655	0	80	80	1.0000000
NODE_5598_length_1060_cov_26.136316	486	566	0	42	80	0.5250000
NODE_5598_length_1060_cov_26.136316	486	566	2	38	80	0.4750000
NODE_5598_length_1060_cov_26.136316	539	619	0	80	80	1.0000000
NODE_5598_length_1060_cov_26.136316	615	695	0	80	80	1.0000000
NODE_5598_length_1060_cov_26.136316	668	748	0	80	80	1.0000000
NODE_5599_length_1060_cov_25.329865	370	450	0	80	80	1.0000000
NODE_5599_length_1060_cov_25.329865	423	503	0	80	80	1.0000000
NODE_5600_length_1060_cov_16.881374	539	611	1	72	72	1.0000000
NODE_5601_length_1060_cov_14.789802	406	486	0	80	80	1.0000000
NODE_5601_length_1060_cov_14.789802	459	539	0	80	80	1.0000000
NODE_5603_length_1060_cov_5.900104	517	597	0	80	80	1.0000000
NODE_5603_length_1060_cov_5.900104	570	650	0	80	80	1.0000000
NODE_5611_length_1059_cov_16.630208	412	492	0	80	80	1.0000000
NODE_5611_length_1059_cov_16.630208	465	552	0	87	87	1.0000000
NODE_5611_length_1059_cov_16.630208	548	628	0	80	80	1.0000000
NODE_5611_length_1059_cov_16.630208	601	681	0	80	80	1.0000000
NODE_5621_length_1058_cov_60.155370	395	475	0	6	80	0.0750000
NODE_5621_length_1058_cov_60.155370	395	475	6	74	80	0.9250000
NODE_5621_length_1058_cov_60.155370	448	528	0	5	80	0.0625000
NODE_5621_length_1058_cov_60.155370	448	528	4	31	80	0.3875000
NODE_5621_length_1058_cov_60.155370	448	528	6	44	80	0.5500000
NODE_5621_length_1058_cov_60.155370	524	604	0	8	80	0.1000000
NODE_5621_length_1058_cov_60.155370	524	604	4	72	80	0.9000000
NODE_5621_length_1058_cov_60.155370	577	657	0	61	80	0.7625000
NODE_5621_length_1058_cov_60.155370	577	657	4	19	80	0.2375000
NODE_5622_length_1058_cov_31.253389	475	555	4	2	80	0.0250000
NODE_5622_length_1058_cov_31.253389	475	555	5	12	80	0.1500000
NODE_5622_length_1058_cov_31.253389	475	555	8	14	80	0.1750000
NODE_5622_length_1058_cov_31.253389	475	555	10	41	80	0.5125000
NODE_5622_length_1058_cov_31.253389	475	555	12	11	80	0.1375000
NODE_5622_length_1058_cov_31.253389	475	555	4	2	80	0.0250000
NODE_5622_length_1058_cov_31.253389	475	555	5	12	80	0.1500000
NODE_5622_length_1058_cov_31.253389	475	555	8	14	80	0.1750000
NODE_5622_length_1058_cov_31.253389	475	555	10	41	80	0.5125000
NODE_5622_length_1058_cov_31.253389	475	555	12	11	80	0.1375000
NODE_5622_length_1058_cov_31.253389	528	608	2	32	80	0.4000000
NODE_5622_length_1058_cov_31.253389	528	608	4	7	80	0.0875000
NODE_5622_length_1058_cov_31.253389	528	608	8	5	80	0.0625000
NODE_5622_length_1058_cov_31.253389	528	608	10	16	80	0.2000000
NODE_5622_length_1058_cov_31.253389	528	608	12	20	80	0.2500000
NODE_5622_length_1058_cov_31.253389	533	608	2	32	75	0.4266667
NODE_5622_length_1058_cov_31.253389	533	608	4	7	75	0.0933333
NODE_5622_length_1058_cov_31.253389	533	608	8	5	75	0.0666667
NODE_5622_length_1058_cov_31.253389	533	608	10	11	75	0.1466667
NODE_5622_length_1058_cov_31.253389	533	608	12	20	75	0.2666667
NODE_5623_length_1058_cov_24.520334	264	344	0	68	80	0.8500000
NODE_5623_length_1058_cov_24.520334	264	344	2	12	80	0.1500000
NODE_5623_length_1058_cov_24.520334	317	397	0	15	80	0.1875000
NODE_5623_length_1058_cov_24.520334	317	397	2	65	80	0.8125000
NODE_5624_length_1058_cov_24.211679	297	377	0	80	80	1.0000000
NODE_5624_length_1058_cov_24.211679	350	430	0	80	80	1.0000000
NODE_5625_length_1058_cov_18.100104	454	534	0	80	80	1.0000000
NODE_5625_length_1058_cov_18.100104	507	587	0	41	80	0.5125000
NODE_5625_length_1058_cov_18.100104	507	587	2	39	80	0.4875000
NODE_5626_length_1058_cov_11.645464	476	556	0	80	80	1.0000000
NODE_5626_length_1058_cov_11.645464	529	609	0	80	80	1.0000000
NODE_5627_length_1058_cov_9.953076	621	712	0	91	91	1.0000000
NODE_5627_length_1058_cov_9.953076	685	765	0	80	80	1.0000000
NODE_5628_length_1058_cov_6.294056	819	899	0	50	80	0.6250000
NODE_5628_length_1058_cov_6.294056	819	899	2	30	80	0.3750000
NODE_5628_length_1058_cov_6.294056	875	952	2	77	77	1.0000000
NODE_5637_length_1057_cov_43.191023	413	493	2	9	80	0.1125000
NODE_5637_length_1057_cov_43.191023	413	493	8	71	80	0.8875000
NODE_5637_length_1057_cov_43.191023	466	546	0	17	80	0.2125000
NODE_5637_length_1057_cov_43.191023	466	546	1	14	80	0.1750000
NODE_5637_length_1057_cov_43.191023	466	546	2	31	80	0.3875000
NODE_5637_length_1057_cov_43.191023	466	546	8	18	80	0.2250000
NODE_5637_length_1057_cov_43.191023	542	622	0	80	80	1.0000000
NODE_5637_length_1057_cov_43.191023	595	675	0	80	80	1.0000000
NODE_5638_length_1057_cov_27.387265	486	566	4	13	80	0.1625000
NODE_5638_length_1057_cov_27.387265	486	566	6	21	80	0.2625000
NODE_5638_length_1057_cov_27.387265	486	566	8	46	80	0.5750000
NODE_5638_length_1057_cov_27.387265	539	619	2	27	80	0.3375000
NODE_5638_length_1057_cov_27.387265	539	619	4	27	80	0.3375000
NODE_5638_length_1057_cov_27.387265	539	619	6	17	80	0.2125000
NODE_5638_length_1057_cov_27.387265	539	619	8	9	80	0.1125000
NODE_5639_length_1057_cov_16.489562	416	496	0	69	80	0.8625000
NODE_5639_length_1057_cov_16.489562	416	496	7	11	80	0.1375000
NODE_5639_length_1057_cov_16.489562	469	549	0	16	80	0.2000000
NODE_5639_length_1057_cov_16.489562	469	549	6	10	80	0.1250000
NODE_5639_length_1057_cov_16.489562	469	549	7	54	80	0.6750000
NODE_5640_length_1057_cov_13.605428	631	711	0	80	80	1.0000000
NODE_5640_length_1057_cov_13.605428	684	764	0	80	80	1.0000000
NODE_5641_length_1057_cov_12.768267	518	598	0	80	80	1.0000000
NODE_5641_length_1057_cov_12.768267	571	651	0	80	80	1.0000000
NODE_5644_length_1057_cov_7.692067	706	786	0	80	80	1.0000000
NODE_5644_length_1057_cov_7.692067	759	839	0	80	80	1.0000000
NODE_5645_length_1057_cov_6.697286	561	641	0	80	80	1.0000000
NODE_5645_length_1057_cov_6.697286	614	694	0	80	80	1.0000000
NODE_5654_length_1056_cov_57.539185	462	542	0	7	80	0.0875000
NODE_5654_length_1056_cov_57.539185	462	542	4	73	80	0.9125000
NODE_5654_length_1056_cov_57.539185	515	595	0	33	80	0.4125000
NODE_5654_length_1056_cov_57.539185	515	595	4	47	80	0.5875000
NODE_5655_length_1056_cov_35.751306	421	501	0	4	80	0.0500000
NODE_5655_length_1056_cov_35.751306	421	501	8	1	80	0.0125000
NODE_5655_length_1056_cov_35.751306	421	501	9	2	80	0.0250000
NODE_5655_length_1056_cov_35.751306	421	501	10	73	80	0.9125000
NODE_5655_length_1056_cov_35.751306	474	554	10	80	80	1.0000000
NODE_5656_length_1056_cov_29.749216	415	490	0	19	75	0.2533333
NODE_5656_length_1056_cov_29.749216	415	490	4	23	75	0.3066667
NODE_5656_length_1056_cov_29.749216	415	490	6	28	75	0.3733333
NODE_5656_length_1056_cov_29.749216	415	490	8	5	75	0.0666667
NODE_5656_length_1056_cov_29.749216	416	495	0	18	79	0.2278481
NODE_5656_length_1056_cov_29.749216	416	495	4	23	79	0.2911392
NODE_5656_length_1056_cov_29.749216	416	495	6	28	79	0.3544304
NODE_5656_length_1056_cov_29.749216	416	495	8	10	79	0.1265823
NODE_5656_length_1056_cov_29.749216	448	495	4	9	47	0.1914894
NODE_5656_length_1056_cov_29.749216	448	495	6	28	47	0.5957447
NODE_5656_length_1056_cov_29.749216	448	495	8	10	47	0.2127660
NODE_5656_length_1056_cov_29.749216	468	548	2	17	80	0.2125000
NODE_5656_length_1056_cov_29.749216	468	548	6	22	80	0.2750000
NODE_5656_length_1056_cov_29.749216	468	548	8	41	80	0.5125000
NODE_5656_length_1056_cov_29.749216	468	548	2	17	80	0.2125000
NODE_5656_length_1056_cov_29.749216	468	548	6	22	80	0.2750000
NODE_5656_length_1056_cov_29.749216	468	548	8	41	80	0.5125000
NODE_5656_length_1056_cov_29.749216	468	548	2	17	80	0.2125000
NODE_5656_length_1056_cov_29.749216	468	548	6	22	80	0.2750000
NODE_5656_length_1056_cov_29.749216	468	548	8	41	80	0.5125000
NODE_5657_length_1056_cov_25.342738	297	377	0	14	80	0.1750000
NODE_5657_length_1056_cov_25.342738	297	377	2	66	80	0.8250000
NODE_5657_length_1056_cov_25.342738	350	430	0	67	80	0.8375000
NODE_5657_length_1056_cov_25.342738	350	430	2	13	80	0.1625000
NODE_5657_length_1056_cov_25.342738	426	506	0	80	80	1.0000000
NODE_5657_length_1056_cov_25.342738	479	559	0	53	80	0.6625000
NODE_5657_length_1056_cov_25.342738	479	559	2	27	80	0.3375000
NODE_5658_length_1056_cov_24.094044	535	615	0	1	80	0.0125000
NODE_5658_length_1056_cov_24.094044	535	615	2	79	80	0.9875000
NODE_5658_length_1056_cov_24.094044	588	668	0	26	80	0.3250000
NODE_5658_length_1056_cov_24.094044	588	668	2	54	80	0.6750000
NODE_5659_length_1056_cov_20.700104	570	650	0	80	80	1.0000000
NODE_5659_length_1056_cov_20.700104	623	703	0	80	80	1.0000000
NODE_5660_length_1056_cov_14.215256	349	429	0	80	80	1.0000000
NODE_5660_length_1056_cov_14.215256	402	482	0	80	80	1.0000000
NODE_5660_length_1056_cov_14.215256	478	558	0	80	80	1.0000000
NODE_5660_length_1056_cov_14.215256	531	611	0	80	80	1.0000000
NODE_5661_length_1056_cov_13.782654	563	643	0	53	80	0.6625000
NODE_5661_length_1056_cov_13.782654	563	643	6	27	80	0.3375000
NODE_5661_length_1056_cov_13.782654	616	696	6	80	80	1.0000000
NODE_5663_length_1056_cov_9.298851	373	453	0	16	80	0.2000000
NODE_5663_length_1056_cov_9.298851	373	453	2	19	80	0.2375000
NODE_5663_length_1056_cov_9.298851	373	453	4	45	80	0.5625000
NODE_5663_length_1056_cov_9.298851	426	503	0	66	77	0.8571429
NODE_5663_length_1056_cov_9.298851	426	503	2	11	77	0.1428571
NODE_5665_length_1056_cov_6.157785	396	476	0	80	80	1.0000000
NODE_5665_length_1056_cov_6.157785	449	529	0	80	80	1.0000000
NODE_5666_length_1056_cov_6.034483	287	367	0	65	80	0.8125000
NODE_5666_length_1056_cov_6.034483	287	367	2	15	80	0.1875000
NODE_5666_length_1056_cov_6.034483	340	420	0	12	80	0.1500000
NODE_5666_length_1056_cov_6.034483	340	420	2	68	80	0.8500000
NODE_5667_length_1056_cov_3.259143	371	410	0	39	39	1.0000000
NODE_5667_length_1056_cov_3.259143	424	463	0	39	39	1.0000000
NODE_5668_length_1056_cov_2.362591	234	314	0	80	80	1.0000000
NODE_5672_length_1055_cov_36.460251	468	548	0	24	80	0.3000000
NODE_5672_length_1055_cov_36.460251	468	548	6	8	80	0.1000000
NODE_5672_length_1055_cov_36.460251	468	548	10	1	80	0.0125000
NODE_5672_length_1055_cov_36.460251	468	548	12	2	80	0.0250000
NODE_5672_length_1055_cov_36.460251	468	548	19	27	80	0.3375000
NODE_5672_length_1055_cov_36.460251	468	548	20	12	80	0.1500000
NODE_5672_length_1055_cov_36.460251	468	548	23	6	80	0.0750000
NODE_5672_length_1055_cov_36.460251	521	601	16	10	80	0.1250000
NODE_5672_length_1055_cov_36.460251	521	601	19	9	80	0.1125000
NODE_5672_length_1055_cov_36.460251	521	601	20	12	80	0.1500000
NODE_5672_length_1055_cov_36.460251	521	601	21	7	80	0.0875000
NODE_5672_length_1055_cov_36.460251	521	601	22	1	80	0.0125000
NODE_5672_length_1055_cov_36.460251	521	601	23	41	80	0.5125000
NODE_5673_length_1055_cov_31.235356	502	582	0	61	80	0.7625000
NODE_5673_length_1055_cov_31.235356	502	582	2	19	80	0.2375000
NODE_5673_length_1055_cov_31.235356	555	635	0	80	80	1.0000000
NODE_5674_length_1055_cov_23.330544	403	483	0	80	80	1.0000000
NODE_5674_length_1055_cov_23.330544	456	536	0	80	80	1.0000000
NODE_5674_length_1055_cov_23.330544	532	612	0	80	80	1.0000000
NODE_5674_length_1055_cov_23.330544	585	665	0	80	80	1.0000000
NODE_5675_length_1055_cov_19.541841	321	401	0	80	80	1.0000000
NODE_5675_length_1055_cov_19.541841	374	454	0	80	80	1.0000000
NODE_5676_length_1055_cov_15.744770	525	605	0	66	80	0.8250000
NODE_5676_length_1055_cov_15.744770	525	605	2	14	80	0.1750000
NODE_5676_length_1055_cov_15.744770	578	658	0	13	80	0.1625000
NODE_5676_length_1055_cov_15.744770	578	658	2	67	80	0.8375000
NODE_5677_length_1055_cov_10.729079	335	415	6	80	80	1.0000000
NODE_5677_length_1055_cov_10.729079	388	468	0	9	80	0.1125000
NODE_5677_length_1055_cov_10.729079	388	468	4	40	80	0.5000000
NODE_5677_length_1055_cov_10.729079	388	468	6	31	80	0.3875000
NODE_5678_length_1055_cov_7.525105	575	655	0	80	80	1.0000000
NODE_5678_length_1055_cov_7.525105	628	708	0	80	80	1.0000000
NODE_5688_length_1054_cov_45.920419	371	451	0	67	80	0.8375000
NODE_5688_length_1054_cov_45.920419	371	451	2	13	80	0.1625000
NODE_5688_length_1054_cov_45.920419	424	505	0	81	81	1.0000000
NODE_5689_length_1054_cov_30.545550	499	578	0	79	79	1.0000000
NODE_5689_length_1054_cov_30.545550	552	631	0	79	79	1.0000000
NODE_5689_length_1054_cov_30.545550	627	707	0	80	80	1.0000000
NODE_5689_length_1054_cov_30.545550	680	760	0	80	80	1.0000000
NODE_5690_length_1054_cov_16.606283	347	427	0	13	80	0.1625000
NODE_5690_length_1054_cov_16.606283	347	427	2	67	80	0.8375000
NODE_5690_length_1054_cov_16.606283	400	480	0	64	80	0.8000000
NODE_5690_length_1054_cov_16.606283	400	480	2	16	80	0.2000000
NODE_5691_length_1054_cov_11.637696	244	316	2	23	72	0.3194444
NODE_5691_length_1054_cov_11.637696	244	316	4	49	72	0.6805556
NODE_5691_length_1054_cov_11.637696	312	392	2	11	80	0.1375000
NODE_5691_length_1054_cov_11.637696	312	392	4	69	80	0.8625000
NODE_5691_length_1054_cov_11.637696	365	445	0	28	80	0.3500000
NODE_5691_length_1054_cov_11.637696	365	445	2	20	80	0.2500000
NODE_5691_length_1054_cov_11.637696	365	445	4	32	80	0.4000000
NODE_5692_length_1054_cov_10.381152	493	573	0	80	80	1.0000000
NODE_5692_length_1054_cov_10.381152	546	626	0	80	80	1.0000000
NODE_5703_length_1053_cov_57.660377	445	527	0	55	82	0.6707317
NODE_5703_length_1053_cov_57.660377	445	527	2	27	82	0.3292683
NODE_5703_length_1053_cov_57.660377	500	580	0	16	80	0.2000000
NODE_5703_length_1053_cov_57.660377	500	580	2	64	80	0.8000000
NODE_5704_length_1053_cov_33.518868	329	409	0	59	80	0.7375000
NODE_5704_length_1053_cov_33.518868	329	409	4	21	80	0.2625000
NODE_5704_length_1053_cov_33.518868	382	462	0	6	80	0.0750000
NODE_5704_length_1053_cov_33.518868	382	462	4	74	80	0.9250000
NODE_5704_length_1053_cov_33.518868	458	538	0	68	80	0.8500000
NODE_5704_length_1053_cov_33.518868	458	538	4	12	80	0.1500000
NODE_5704_length_1053_cov_33.518868	511	591	0	55	80	0.6875000
NODE_5704_length_1053_cov_33.518868	511	591	2	25	80	0.3125000
NODE_5705_length_1053_cov_32.412998	375	455	0	80	80	1.0000000
NODE_5705_length_1053_cov_32.412998	428	508	0	80	80	1.0000000
NODE_5705_length_1053_cov_32.412998	504	584	0	80	80	1.0000000
NODE_5705_length_1053_cov_32.412998	557	637	0	80	80	1.0000000
NODE_5706_length_1053_cov_26.545073	456	536	0	80	80	1.0000000
NODE_5706_length_1053_cov_26.545073	509	589	0	80	80	1.0000000
NODE_5706_length_1053_cov_26.545073	585	665	0	80	80	1.0000000
NODE_5706_length_1053_cov_26.545073	638	718	0	80	80	1.0000000
NODE_5707_length_1053_cov_20.346960	543	623	0	2	80	0.0250000
NODE_5707_length_1053_cov_20.346960	543	623	2	78	80	0.9750000
NODE_5707_length_1053_cov_20.346960	596	677	0	56	81	0.6913580
NODE_5707_length_1053_cov_20.346960	596	677	2	25	81	0.3086420
NODE_5708_length_1053_cov_11.655136	393	473	0	80	80	1.0000000
NODE_5708_length_1053_cov_11.655136	446	526	0	80	80	1.0000000
NODE_5710_length_1053_cov_4.771488	84	149	2	2	65	0.0307692
NODE_5710_length_1053_cov_4.771488	84	149	6	63	65	0.9692308
NODE_5718_length_1052_cov_18.469045	448	528	0	80	80	1.0000000
NODE_5718_length_1052_cov_18.469045	501	581	0	80	80	1.0000000
NODE_5719_length_1052_cov_13.136411	425	505	0	80	80	1.0000000
NODE_5719_length_1052_cov_13.136411	478	558	0	80	80	1.0000000
NODE_5722_length_1052_cov_3.082896	607	687	0	34	80	0.4250000
NODE_5722_length_1052_cov_3.082896	607	687	2	46	80	0.5750000
NODE_5722_length_1052_cov_3.082896	660	740	0	80	80	1.0000000
NODE_5729_length_1051_cov_34.868697	472	552	0	57	80	0.7125000
NODE_5729_length_1051_cov_34.868697	472	552	4	23	80	0.2875000
NODE_5729_length_1051_cov_34.868697	525	605	0	4	80	0.0500000
NODE_5729_length_1051_cov_34.868697	525	605	4	76	80	0.9500000
NODE_5730_length_1051_cov_19.446429	549	629	14	9	80	0.1125000
NODE_5730_length_1051_cov_19.446429	549	629	20	35	80	0.4375000
NODE_5730_length_1051_cov_19.446429	549	629	22	33	80	0.4125000
NODE_5730_length_1051_cov_19.446429	549	629	24	3	80	0.0375000
NODE_5730_length_1051_cov_19.446429	602	682	10	10	80	0.1250000
NODE_5730_length_1051_cov_19.446429	602	682	14	4	80	0.0500000
NODE_5730_length_1051_cov_19.446429	602	682	16	21	80	0.2625000
NODE_5730_length_1051_cov_19.446429	602	682	18	10	80	0.1250000
NODE_5730_length_1051_cov_19.446429	602	682	20	19	80	0.2375000
NODE_5730_length_1051_cov_19.446429	602	682	22	13	80	0.1625000
NODE_5730_length_1051_cov_19.446429	602	682	24	3	80	0.0375000
NODE_5731_length_1051_cov_4.022059	600	680	0	15	80	0.1875000
NODE_5731_length_1051_cov_4.022059	600	680	2	65	80	0.8125000
NODE_5736_length_1050_cov_31.556257	429	509	0	19	80	0.2375000
NODE_5736_length_1050_cov_31.556257	429	509	2	12	80	0.1500000
NODE_5736_length_1050_cov_31.556257	429	509	4	7	80	0.0875000
NODE_5736_length_1050_cov_31.556257	429	509	6	42	80	0.5250000
NODE_5736_length_1050_cov_31.556257	482	562	0	64	80	0.8000000
NODE_5736_length_1050_cov_31.556257	482	562	1	8	80	0.1000000
NODE_5736_length_1050_cov_31.556257	482	562	2	8	80	0.1000000
NODE_5736_length_1050_cov_31.556257	558	638	1	7	80	0.0875000
NODE_5736_length_1050_cov_31.556257	558	638	2	1	80	0.0125000
NODE_5736_length_1050_cov_31.556257	558	638	3	38	80	0.4750000
NODE_5736_length_1050_cov_31.556257	558	638	4	34	80	0.4250000
NODE_5736_length_1050_cov_31.556257	611	691	4	29	80	0.3625000
NODE_5736_length_1050_cov_31.556257	611	691	10	25	80	0.3125000
NODE_5736_length_1050_cov_31.556257	611	691	12	26	80	0.3250000
NODE_5737_length_1050_cov_16.337539	398	478	0	80	80	1.0000000
NODE_5737_length_1050_cov_16.337539	451	531	0	50	80	0.6250000
NODE_5737_length_1050_cov_16.337539	451	531	2	30	80	0.3750000
NODE_5738_length_1050_cov_13.290221	507	587	3	56	80	0.7000000
NODE_5738_length_1050_cov_13.290221	507	587	4	24	80	0.3000000
NODE_5738_length_1050_cov_13.290221	560	640	0	37	80	0.4625000
NODE_5738_length_1050_cov_13.290221	560	640	3	43	80	0.5375000
NODE_5739_length_1050_cov_11.389064	532	612	0	80	80	1.0000000
NODE_5739_length_1050_cov_11.389064	585	665	0	80	80	1.0000000
NODE_5740_length_1050_cov_11.091483	259	321	0	62	62	1.0000000
NODE_5740_length_1050_cov_11.091483	294	374	0	80	80	1.0000000
NODE_5740_length_1050_cov_11.091483	370	450	0	30	80	0.3750000
NODE_5740_length_1050_cov_11.091483	370	450	2	50	80	0.6250000
NODE_5740_length_1050_cov_11.091483	423	503	0	9	80	0.1125000
NODE_5740_length_1050_cov_11.091483	423	503	2	71	80	0.8875000
NODE_5742_length_1050_cov_2.201893	928	990	0	62	62	1.0000000
NODE_5742_length_1050_cov_2.201893	981	1043	0	62	62	1.0000000
NODE_5748_length_1050_cov_1.241851	935	990	18	2	55	0.0363636
NODE_5748_length_1050_cov_1.241851	935	990	20	1	55	0.0181818
NODE_5748_length_1050_cov_1.241851	935	990	22	4	55	0.0727273
NODE_5748_length_1050_cov_1.241851	935	990	28	2	55	0.0363636
NODE_5748_length_1050_cov_1.241851	935	990	30	3	55	0.0545455
NODE_5748_length_1050_cov_1.241851	935	990	32	15	55	0.2727273
NODE_5748_length_1050_cov_1.241851	935	990	34	28	55	0.5090909
NODE_5748_length_1050_cov_1.241851	956	1036	12	6	80	0.0750000
NODE_5748_length_1050_cov_1.241851	956	1036	16	2	80	0.0250000
NODE_5748_length_1050_cov_1.241851	956	1036	24	2	80	0.0250000
NODE_5748_length_1050_cov_1.241851	956	1036	26	5	80	0.0625000
NODE_5748_length_1050_cov_1.241851	956	1036	28	11	80	0.1375000
NODE_5748_length_1050_cov_1.241851	956	1036	30	5	80	0.0625000
NODE_5748_length_1050_cov_1.241851	956	1036	32	6	80	0.0750000
NODE_5748_length_1050_cov_1.241851	956	1036	34	43	80	0.5375000
NODE_5752_length_1049_cov_28.174737	446	526	0	80	80	1.0000000
NODE_5752_length_1049_cov_28.174737	499	579	0	80	80	1.0000000
NODE_5753_length_1049_cov_23.186316	389	469	0	80	80	1.0000000
NODE_5753_length_1049_cov_23.186316	442	522	0	80	80	1.0000000
NODE_5753_length_1049_cov_23.186316	518	595	0	77	77	1.0000000
NODE_5753_length_1049_cov_23.186316	568	648	0	40	80	0.5000000
NODE_5753_length_1049_cov_23.186316	568	648	2	40	80	0.5000000
NODE_5754_length_1049_cov_21.097895	532	612	0	80	80	1.0000000
NODE_5754_length_1049_cov_21.097895	585	665	0	80	80	1.0000000
NODE_5755_length_1049_cov_18.964211	375	466	4	2	91	0.0219780
NODE_5755_length_1049_cov_18.964211	375	466	6	89	91	0.9780220
NODE_5755_length_1049_cov_18.964211	439	519	0	37	80	0.4625000
NODE_5755_length_1049_cov_18.964211	439	519	4	18	80	0.2250000
NODE_5755_length_1049_cov_18.964211	439	519	6	25	80	0.3125000
NODE_5755_length_1049_cov_18.964211	515	595	0	80	80	1.0000000
NODE_5755_length_1049_cov_18.964211	568	648	0	80	80	1.0000000
NODE_5756_length_1049_cov_18.075789	437	517	0	80	80	1.0000000
NODE_5756_length_1049_cov_18.075789	490	570	0	72	80	0.9000000
NODE_5756_length_1049_cov_18.075789	490	570	2	3	80	0.0375000
NODE_5756_length_1049_cov_18.075789	490	570	4	5	80	0.0625000
NODE_5756_length_1049_cov_18.075789	566	644	4	78	78	1.0000000
NODE_5756_length_1049_cov_18.075789	620	695	0	32	75	0.4266667
NODE_5756_length_1049_cov_18.075789	620	695	2	6	75	0.0800000
NODE_5756_length_1049_cov_18.075789	620	695	4	37	75	0.4933333
NODE_5757_length_1049_cov_16.194737	569	650	0	8	81	0.0987654
NODE_5757_length_1049_cov_16.194737	569	650	2	38	81	0.4691358
NODE_5757_length_1049_cov_16.194737	569	650	4	35	81	0.4320988
NODE_5757_length_1049_cov_16.194737	623	703	0	61	80	0.7625000
NODE_5757_length_1049_cov_16.194737	623	703	2	19	80	0.2375000
NODE_5757_length_1049_cov_16.194737	699	779	0	80	80	1.0000000
NODE_5757_length_1049_cov_16.194737	752	832	0	80	80	1.0000000
NODE_5759_length_1049_cov_6.323158	588	668	0	19	80	0.2375000
NODE_5759_length_1049_cov_6.323158	588	668	1	31	80	0.3875000
NODE_5759_length_1049_cov_6.323158	588	668	2	30	80	0.3750000
NODE_5759_length_1049_cov_6.323158	641	721	0	72	80	0.9000000
NODE_5759_length_1049_cov_6.323158	641	721	1	8	80	0.1000000
NODE_5770_length_1048_cov_73.887250	535	615	0	61	80	0.7625000
NODE_5770_length_1048_cov_73.887250	535	615	2	19	80	0.2375000
NODE_5770_length_1048_cov_73.887250	588	668	0	80	80	1.0000000
NODE_5770_length_1048_cov_73.887250	664	744	0	80	80	1.0000000
NODE_5770_length_1048_cov_73.887250	717	797	0	80	80	1.0000000
NODE_5770_length_1048_cov_73.887250	899	979	0	80	80	1.0000000
NODE_5771_length_1048_cov_48.242360	407	487	2	80	80	1.0000000
NODE_5771_length_1048_cov_48.242360	460	540	0	30	80	0.3750000
NODE_5771_length_1048_cov_48.242360	460	540	2	50	80	0.6250000
NODE_5771_length_1048_cov_48.242360	536	616	0	80	80	1.0000000
NODE_5771_length_1048_cov_48.242360	589	669	0	44	80	0.5500000
NODE_5771_length_1048_cov_48.242360	589	669	4	12	80	0.1500000
NODE_5771_length_1048_cov_48.242360	589	669	7	2	80	0.0250000
NODE_5771_length_1048_cov_48.242360	589	669	8	22	80	0.2750000
NODE_5772_length_1048_cov_38.430980	352	432	2	40	80	0.5000000
NODE_5772_length_1048_cov_38.430980	352	432	6	10	80	0.1250000
NODE_5772_length_1048_cov_38.430980	352	432	12	25	80	0.3125000
NODE_5772_length_1048_cov_38.430980	352	432	14	5	80	0.0625000
NODE_5772_length_1048_cov_38.430980	405	485	4	4	80	0.0500000
NODE_5772_length_1048_cov_38.430980	405	485	11	36	80	0.4500000
NODE_5772_length_1048_cov_38.430980	405	485	12	38	80	0.4750000
NODE_5772_length_1048_cov_38.430980	405	485	14	2	80	0.0250000
NODE_5773_length_1048_cov_28.179136	548	628	0	46	80	0.5750000
NODE_5773_length_1048_cov_28.179136	548	628	2	34	80	0.4250000
NODE_5773_length_1048_cov_28.179136	601	681	0	80	80	1.0000000
NODE_5773_length_1048_cov_28.179136	677	757	0	7	80	0.0875000
NODE_5773_length_1048_cov_28.179136	677	757	6	1	80	0.0125000
NODE_5773_length_1048_cov_28.179136	677	757	8	72	80	0.9000000
NODE_5773_length_1048_cov_28.179136	730	810	0	16	80	0.2000000
NODE_5773_length_1048_cov_28.179136	730	810	6	31	80	0.3875000
NODE_5773_length_1048_cov_28.179136	730	810	8	33	80	0.4125000
NODE_5774_length_1048_cov_22.985248	409	489	0	80	80	1.0000000
NODE_5774_length_1048_cov_22.985248	462	542	0	80	80	1.0000000
NODE_5774_length_1048_cov_22.985248	538	618	0	80	80	1.0000000
NODE_5774_length_1048_cov_22.985248	591	671	0	38	80	0.4750000
NODE_5774_length_1048_cov_22.985248	591	671	4	20	80	0.2500000
NODE_5774_length_1048_cov_22.985248	591	671	6	22	80	0.2750000
NODE_5775_length_1048_cov_17.883035	500	580	0	80	80	1.0000000
NODE_5775_length_1048_cov_17.883035	553	633	0	80	80	1.0000000
NODE_5776_length_1048_cov_17.444679	377	457	0	74	80	0.9250000
NODE_5776_length_1048_cov_17.444679	377	457	2	6	80	0.0750000
NODE_5776_length_1048_cov_17.444679	430	510	0	21	80	0.2625000
NODE_5776_length_1048_cov_17.444679	430	510	2	59	80	0.7375000
NODE_5777_length_1048_cov_13.387777	518	598	0	22	80	0.2750000
NODE_5777_length_1048_cov_13.387777	518	598	2	58	80	0.7250000
NODE_5777_length_1048_cov_13.387777	571	651	0	75	80	0.9375000
NODE_5777_length_1048_cov_13.387777	571	651	2	5	80	0.0625000
NODE_5778_length_1048_cov_12.934668	716	796	0	80	80	1.0000000
NODE_5778_length_1048_cov_12.934668	769	849	0	80	80	1.0000000
NODE_5778_length_1048_cov_12.934668	845	925	0	80	80	1.0000000
NODE_5778_length_1048_cov_12.934668	898	975	0	77	77	1.0000000
NODE_5779_length_1048_cov_12.712329	330	410	0	45	80	0.5625000
NODE_5779_length_1048_cov_12.712329	330	410	2	35	80	0.4375000
NODE_5779_length_1048_cov_12.712329	384	463	0	79	79	1.0000000
NODE_5779_length_1048_cov_12.712329	459	539	0	27	80	0.3375000
NODE_5779_length_1048_cov_12.712329	459	539	4	53	80	0.6625000
NODE_5779_length_1048_cov_12.712329	512	592	4	80	80	1.0000000
NODE_5780_length_1048_cov_9.232877	305	355	0	50	50	1.0000000
NODE_5786_length_1047_cov_79.917722	540	620	0	56	80	0.7000000
NODE_5786_length_1047_cov_79.917722	540	620	2	24	80	0.3000000
NODE_5786_length_1047_cov_79.917722	593	673	0	3	80	0.0375000
NODE_5786_length_1047_cov_79.917722	593	673	2	27	80	0.3375000
NODE_5786_length_1047_cov_79.917722	593	673	4	50	80	0.6250000
NODE_5787_length_1047_cov_28.527426	582	662	0	8	80	0.1000000
NODE_5787_length_1047_cov_28.527426	582	662	4	72	80	0.9000000
NODE_5787_length_1047_cov_28.527426	635	715	0	61	80	0.7625000
NODE_5787_length_1047_cov_28.527426	635	715	4	19	80	0.2375000
NODE_5788_length_1047_cov_26.068565	372	452	0	16	80	0.2000000
NODE_5788_length_1047_cov_26.068565	372	452	3	1	80	0.0125000
NODE_5788_length_1047_cov_26.068565	372	452	4	63	80	0.7875000
NODE_5788_length_1047_cov_26.068565	425	505	0	69	80	0.8625000
NODE_5788_length_1047_cov_26.068565	425	505	3	1	80	0.0125000
NODE_5788_length_1047_cov_26.068565	425	505	4	10	80	0.1250000
NODE_5789_length_1047_cov_25.946203	424	504	0	15	80	0.1875000
NODE_5789_length_1047_cov_25.946203	424	504	4	65	80	0.8125000
NODE_5789_length_1047_cov_25.946203	477	557	0	23	80	0.2875000
NODE_5789_length_1047_cov_25.946203	477	557	2	45	80	0.5625000
NODE_5789_length_1047_cov_25.946203	477	557	4	12	80	0.1500000
NODE_5790_length_1047_cov_19.255274	458	538	0	80	80	1.0000000
NODE_5790_length_1047_cov_19.255274	511	591	0	80	80	1.0000000
NODE_5791_length_1047_cov_16.618143	467	547	0	33	80	0.4125000
NODE_5791_length_1047_cov_16.618143	467	547	2	47	80	0.5875000
NODE_5791_length_1047_cov_16.618143	520	600	0	14	80	0.1750000
NODE_5791_length_1047_cov_16.618143	520	600	2	66	80	0.8250000
NODE_5792_length_1047_cov_14.246835	643	723	0	34	80	0.4250000
NODE_5792_length_1047_cov_14.246835	643	723	2	46	80	0.5750000
NODE_5792_length_1047_cov_14.246835	696	776	0	80	80	1.0000000
NODE_5793_length_1047_cov_9.869198	414	494	0	80	80	1.0000000
NODE_5793_length_1047_cov_9.869198	467	547	0	80	80	1.0000000
NODE_5794_length_1047_cov_8.513713	300	380	0	20	80	0.2500000
NODE_5794_length_1047_cov_8.513713	300	380	2	60	80	0.7500000
NODE_5794_length_1047_cov_8.513713	353	433	0	9	80	0.1125000
NODE_5794_length_1047_cov_8.513713	353	433	2	71	80	0.8875000
NODE_5795_length_1047_cov_7.412447	442	522	0	80	80	1.0000000
NODE_5795_length_1047_cov_7.412447	495	575	0	80	80	1.0000000
NODE_5803_length_1046_cov_41.392819	587	667	0	80	80	1.0000000
NODE_5803_length_1046_cov_41.392819	640	720	0	80	80	1.0000000
NODE_5804_length_1046_cov_30.317846	382	462	0	80	80	1.0000000
NODE_5804_length_1046_cov_30.317846	435	515	0	80	80	1.0000000
NODE_5805_length_1046_cov_28.184794	346	426	0	24	80	0.3000000
NODE_5805_length_1046_cov_28.184794	346	426	2	56	80	0.7000000
NODE_5805_length_1046_cov_28.184794	399	479	0	77	80	0.9625000
NODE_5805_length_1046_cov_28.184794	399	479	2	3	80	0.0375000
NODE_5806_length_1046_cov_24.595565	501	581	0	80	80	1.0000000
NODE_5806_length_1046_cov_24.595565	554	634	0	80	80	1.0000000
NODE_5807_length_1046_cov_17.958817	447	527	0	80	80	1.0000000
NODE_5807_length_1046_cov_17.958817	500	580	0	80	80	1.0000000
NODE_5808_length_1046_cov_15.494192	385	465	0	27	80	0.3375000
NODE_5808_length_1046_cov_15.494192	385	465	2	11	80	0.1375000
NODE_5808_length_1046_cov_15.494192	385	465	3	14	80	0.1750000
NODE_5808_length_1046_cov_15.494192	385	465	6	28	80	0.3500000
NODE_5808_length_1046_cov_15.494192	438	518	6	80	80	1.0000000
NODE_5809_length_1046_cov_12.639916	554	634	0	6	80	0.0750000
NODE_5809_length_1046_cov_12.639916	554	634	2	74	80	0.9250000
NODE_5809_length_1046_cov_12.639916	607	687	0	55	80	0.6875000
NODE_5809_length_1046_cov_12.639916	607	687	2	25	80	0.3125000
NODE_5810_length_1046_cov_11.238648	471	551	0	22	80	0.2750000
NODE_5810_length_1046_cov_11.238648	471	551	8	58	80	0.7250000
NODE_5810_length_1046_cov_11.238648	524	604	8	80	80	1.0000000
NODE_5811_length_1046_cov_10.744456	459	539	0	80	80	1.0000000
NODE_5811_length_1046_cov_10.744456	512	592	0	80	80	1.0000000
NODE_5812_length_1046_cov_8.689546	302	382	0	70	80	0.8750000
NODE_5812_length_1046_cov_8.689546	302	382	2	10	80	0.1250000
NODE_5812_length_1046_cov_8.689546	355	435	0	17	80	0.2125000
NODE_5812_length_1046_cov_8.689546	355	435	2	63	80	0.7875000
NODE_5823_length_1045_cov_75.975687	359	440	0	81	81	1.0000000
NODE_5823_length_1045_cov_75.975687	412	493	0	81	81	1.0000000
NODE_5823_length_1045_cov_75.975687	489	569	0	80	80	1.0000000
NODE_5823_length_1045_cov_75.975687	542	622	0	80	80	1.0000000
NODE_5824_length_1045_cov_54.419662	434	514	0	27	80	0.3375000
NODE_5824_length_1045_cov_54.419662	434	514	4	53	80	0.6625000
NODE_5824_length_1045_cov_54.419662	487	567	0	80	80	1.0000000
NODE_5824_length_1045_cov_54.419662	563	639	0	23	76	0.3026316
NODE_5824_length_1045_cov_54.419662	563	639	2	53	76	0.6973684
NODE_5824_length_1045_cov_54.419662	616	696	0	16	80	0.2000000
NODE_5824_length_1045_cov_54.419662	616	696	2	64	80	0.8000000
NODE_5825_length_1045_cov_23.188161	395	475	4	80	80	1.0000000
NODE_5825_length_1045_cov_23.188161	448	528	0	51	80	0.6375000
NODE_5825_length_1045_cov_23.188161	448	528	2	1	80	0.0125000
NODE_5825_length_1045_cov_23.188161	448	528	4	28	80	0.3500000
NODE_5826_length_1045_cov_19.686047	571	651	0	80	80	1.0000000
NODE_5826_length_1045_cov_19.686047	624	704	0	80	80	1.0000000
NODE_5827_length_1045_cov_19.378436	478	558	2	8	80	0.1000000
NODE_5827_length_1045_cov_19.378436	478	558	4	72	80	0.9000000
NODE_5827_length_1045_cov_19.378436	531	611	0	35	80	0.4375000
NODE_5827_length_1045_cov_19.378436	531	611	2	26	80	0.3250000
NODE_5827_length_1045_cov_19.378436	531	611	4	19	80	0.2375000
NODE_5828_length_1045_cov_17.601480	359	439	0	80	80	1.0000000
NODE_5828_length_1045_cov_17.601480	412	492	0	80	80	1.0000000
NODE_5829_length_1045_cov_17.372093	633	713	0	43	80	0.5375000
NODE_5829_length_1045_cov_17.372093	633	713	4	37	80	0.4625000
NODE_5829_length_1045_cov_17.372093	686	766	4	80	80	1.0000000
NODE_5830_length_1045_cov_14.828753	433	513	2	63	80	0.7875000
NODE_5830_length_1045_cov_14.828753	433	513	4	17	80	0.2125000
NODE_5830_length_1045_cov_14.828753	486	566	2	35	80	0.4375000
NODE_5830_length_1045_cov_14.828753	486	566	4	45	80	0.5625000
NODE_5831_length_1045_cov_11.673362	664	744	0	80	80	1.0000000
NODE_5831_length_1045_cov_11.673362	717	797	0	80	80	1.0000000
NODE_5843_length_1044_cov_42.600000	344	424	0	16	80	0.2000000
NODE_5843_length_1044_cov_42.600000	344	424	4	64	80	0.8000000
NODE_5843_length_1044_cov_42.600000	397	477	0	1	80	0.0125000
NODE_5843_length_1044_cov_42.600000	397	477	4	79	80	0.9875000
NODE_5844_length_1044_cov_27.653968	454	534	22	22	80	0.2750000
NODE_5844_length_1044_cov_27.653968	454	534	24	58	80	0.7250000
NODE_5844_length_1044_cov_27.653968	507	587	9	2	80	0.0250000
NODE_5844_length_1044_cov_27.653968	507	587	18	17	80	0.2125000
NODE_5844_length_1044_cov_27.653968	507	587	19	11	80	0.1375000
NODE_5844_length_1044_cov_27.653968	507	587	23	1	80	0.0125000
NODE_5844_length_1044_cov_27.653968	507	587	24	49	80	0.6125000
NODE_5845_length_1044_cov_24.561905	297	375	0	78	78	1.0000000
NODE_5845_length_1044_cov_24.561905	348	428	0	80	80	1.0000000
NODE_5845_length_1044_cov_24.561905	424	504	0	9	80	0.1125000
NODE_5845_length_1044_cov_24.561905	424	504	2	71	80	0.8875000
NODE_5845_length_1044_cov_24.561905	477	557	0	53	80	0.6625000
NODE_5845_length_1044_cov_24.561905	477	557	2	27	80	0.3375000
NODE_5846_length_1044_cov_23.720635	294	374	0	80	80	1.0000000
NODE_5846_length_1044_cov_23.720635	347	427	0	80	80	1.0000000
NODE_5846_length_1044_cov_23.720635	423	503	0	80	80	1.0000000
NODE_5846_length_1044_cov_23.720635	476	556	0	80	80	1.0000000
NODE_5847_length_1044_cov_20.871958	462	542	0	10	80	0.1250000
NODE_5847_length_1044_cov_20.871958	462	542	2	21	80	0.2625000
NODE_5847_length_1044_cov_20.871958	462	542	4	13	80	0.1625000
NODE_5847_length_1044_cov_20.871958	462	542	5	36	80	0.4500000
NODE_5847_length_1044_cov_20.871958	515	595	0	63	80	0.7875000
NODE_5847_length_1044_cov_20.871958	515	595	2	17	80	0.2125000
NODE_5847_length_1044_cov_20.871958	591	671	0	75	80	0.9375000
NODE_5847_length_1044_cov_20.871958	591	671	2	5	80	0.0625000
NODE_5847_length_1044_cov_20.871958	644	724	0	22	80	0.2750000
NODE_5847_length_1044_cov_20.871958	644	724	2	58	80	0.7250000
NODE_5848_length_1044_cov_18.596825	433	513	0	65	80	0.8125000
NODE_5848_length_1044_cov_18.596825	433	513	2	15	80	0.1875000
NODE_5848_length_1044_cov_18.596825	486	566	0	12	80	0.1500000
NODE_5848_length_1044_cov_18.596825	486	566	2	68	80	0.8500000
NODE_5849_length_1044_cov_16.102646	414	494	0	80	80	1.0000000
NODE_5849_length_1044_cov_16.102646	467	547	0	79	80	0.9875000
NODE_5849_length_1044_cov_16.102646	467	547	2	1	80	0.0125000
NODE_5850_length_1044_cov_12.156614	578	658	0	80	80	1.0000000
NODE_5850_length_1044_cov_12.156614	631	711	0	80	80	1.0000000
NODE_5851_length_1044_cov_10.661376	506	586	0	80	80	1.0000000
NODE_5851_length_1044_cov_10.661376	559	639	0	80	80	1.0000000
NODE_5852_length_1044_cov_9.534392	461	541	0	70	80	0.8750000
NODE_5852_length_1044_cov_9.534392	461	541	2	10	80	0.1250000
NODE_5852_length_1044_cov_9.534392	514	594	0	17	80	0.2125000
NODE_5852_length_1044_cov_9.534392	514	594	2	63	80	0.7875000
NODE_5853_length_1044_cov_5.517460	434	514	0	80	80	1.0000000
NODE_5853_length_1044_cov_5.517460	487	567	0	80	80	1.0000000
NODE_5856_length_1044_cov_1.502646	769	845	1	76	76	1.0000000
NODE_5860_length_1043_cov_42.288136	452	532	0	80	80	1.0000000
NODE_5860_length_1043_cov_42.288136	505	585	0	80	80	1.0000000
NODE_5861_length_1043_cov_25.987288	350	430	0	36	80	0.4500000
NODE_5861_length_1043_cov_25.987288	350	430	2	10	80	0.1250000
NODE_5861_length_1043_cov_25.987288	350	430	4	12	80	0.1500000
NODE_5861_length_1043_cov_25.987288	350	430	6	22	80	0.2750000
NODE_5861_length_1043_cov_25.987288	403	483	4	31	80	0.3875000
NODE_5861_length_1043_cov_25.987288	403	483	6	49	80	0.6125000
NODE_5861_length_1043_cov_25.987288	479	559	2	16	80	0.2000000
NODE_5861_length_1043_cov_25.987288	479	559	4	12	80	0.1500000
NODE_5861_length_1043_cov_25.987288	479	559	10	41	80	0.5125000
NODE_5861_length_1043_cov_25.987288	479	559	12	11	80	0.1375000
NODE_5861_length_1043_cov_25.987288	532	612	0	2	80	0.0250000
NODE_5861_length_1043_cov_25.987288	532	612	8	16	80	0.2000000
NODE_5861_length_1043_cov_25.987288	532	612	10	62	80	0.7750000
NODE_5862_length_1043_cov_20.838983	561	641	0	4	80	0.0500000
NODE_5862_length_1043_cov_20.838983	561	641	2	76	80	0.9500000
NODE_5862_length_1043_cov_20.838983	614	694	0	20	80	0.2500000
NODE_5862_length_1043_cov_20.838983	614	694	2	60	80	0.7500000
NODE_5863_length_1043_cov_20.312500	489	569	0	28	80	0.3500000
NODE_5863_length_1043_cov_20.312500	489	569	2	52	80	0.6500000
NODE_5863_length_1043_cov_20.312500	542	622	0	54	80	0.6750000
NODE_5863_length_1043_cov_20.312500	542	622	2	26	80	0.3250000
NODE_5864_length_1043_cov_16.320975	569	649	0	24	80	0.3000000
NODE_5864_length_1043_cov_16.320975	569	649	2	56	80	0.7000000
NODE_5864_length_1043_cov_16.320975	622	702	2	80	80	1.0000000
NODE_5865_length_1043_cov_11.176907	521	601	0	80	80	1.0000000
NODE_5865_length_1043_cov_11.176907	574	654	0	80	80	1.0000000
NODE_5866_length_1043_cov_8.146186	530	596	0	66	66	1.0000000
NODE_5866_length_1043_cov_8.146186	569	649	0	80	80	1.0000000
NODE_5868_length_1043_cov_5.347458	646	726	0	80	80	1.0000000
NODE_5868_length_1043_cov_5.347458	699	779	0	80	80	1.0000000
NODE_5879_length_1042_cov_242.728526	820	900	286	1	80	0.0125000
NODE_5879_length_1042_cov_242.728526	820	900	292	1	80	0.0125000
NODE_5879_length_1042_cov_242.728526	820	900	296	1	80	0.0125000
NODE_5879_length_1042_cov_242.728526	820	900	299	1	80	0.0125000
NODE_5879_length_1042_cov_242.728526	820	900	301	1	80	0.0125000
NODE_5879_length_1042_cov_242.728526	820	900	304	1	80	0.0125000
NODE_5879_length_1042_cov_242.728526	820	900	321	1	80	0.0125000
NODE_5879_length_1042_cov_242.728526	820	900	335	1	80	0.0125000
NODE_5879_length_1042_cov_242.728526	820	900	356	1	80	0.0125000
NODE_5879_length_1042_cov_242.728526	820	900	365	1	80	0.0125000
NODE_5879_length_1042_cov_242.728526	820	900	373	1	80	0.0125000
NODE_5879_length_1042_cov_242.728526	820	900	381	1	80	0.0125000
NODE_5879_length_1042_cov_242.728526	820	900	386	1	80	0.0125000
NODE_5879_length_1042_cov_242.728526	820	900	397	1	80	0.0125000
NODE_5879_length_1042_cov_242.728526	820	900	409	1	80	0.0125000
NODE_5879_length_1042_cov_242.728526	820	900	424	1	80	0.0125000
NODE_5879_length_1042_cov_242.728526	820	900	431	1	80	0.0125000
NODE_5879_length_1042_cov_242.728526	820	900	432	1	80	0.0125000
NODE_5879_length_1042_cov_242.728526	820	900	434	1	80	0.0125000
NODE_5879_length_1042_cov_242.728526	820	900	468	1	80	0.0125000
NODE_5879_length_1042_cov_242.728526	820	900	469	1	80	0.0125000
NODE_5879_length_1042_cov_242.728526	820	900	471	2	80	0.0250000
NODE_5879_length_1042_cov_242.728526	820	900	475	1	80	0.0125000
NODE_5879_length_1042_cov_242.728526	820	900	481	1	80	0.0125000
NODE_5879_length_1042_cov_242.728526	820	900	484	1	80	0.0125000
NODE_5879_length_1042_cov_242.728526	820	900	486	1	80	0.0125000
NODE_5879_length_1042_cov_242.728526	820	900	487	1	80	0.0125000
NODE_5879_length_1042_cov_242.728526	820	900	493	1	80	0.0125000
NODE_5879_length_1042_cov_242.728526	820	900	495	2	80	0.0250000
NODE_5879_length_1042_cov_242.728526	820	900	498	1	80	0.0125000
NODE_5879_length_1042_cov_242.728526	820	900	501	1	80	0.0125000
NODE_5879_length_1042_cov_242.728526	820	900	507	1	80	0.0125000
NODE_5879_length_1042_cov_242.728526	820	900	518	2	80	0.0250000
NODE_5879_length_1042_cov_242.728526	820	900	519	1	80	0.0125000
NODE_5879_length_1042_cov_242.728526	820	900	529	1	80	0.0125000
NODE_5879_length_1042_cov_242.728526	820	900	531	1	80	0.0125000
NODE_5879_length_1042_cov_242.728526	820	900	538	1	80	0.0125000
NODE_5879_length_1042_cov_242.728526	820	900	547	1	80	0.0125000
NODE_5879_length_1042_cov_242.728526	820	900	550	1	80	0.0125000
NODE_5879_length_1042_cov_242.728526	820	900	554	1	80	0.0125000
NODE_5879_length_1042_cov_242.728526	820	900	562	1	80	0.0125000
NODE_5879_length_1042_cov_242.728526	820	900	572	1	80	0.0125000
NODE_5879_length_1042_cov_242.728526	820	900	578	1	80	0.0125000
NODE_5879_length_1042_cov_242.728526	820	900	579	1	80	0.0125000
NODE_5879_length_1042_cov_242.728526	820	900	588	1	80	0.0125000
NODE_5879_length_1042_cov_242.728526	820	900	589	2	80	0.0250000
NODE_5879_length_1042_cov_242.728526	820	900	594	1	80	0.0125000
NODE_5879_length_1042_cov_242.728526	820	900	598	1	80	0.0125000
NODE_5879_length_1042_cov_242.728526	820	900	607	1	80	0.0125000
NODE_5879_length_1042_cov_242.728526	820	900	614	1	80	0.0125000
NODE_5879_length_1042_cov_242.728526	820	900	623	1	80	0.0125000
NODE_5879_length_1042_cov_242.728526	820	900	647	2	80	0.0250000
NODE_5879_length_1042_cov_242.728526	820	900	654	1	80	0.0125000
NODE_5879_length_1042_cov_242.728526	820	900	660	1	80	0.0125000
NODE_5879_length_1042_cov_242.728526	820	900	662	1	80	0.0125000
NODE_5879_length_1042_cov_242.728526	820	900	667	1	80	0.0125000
NODE_5879_length_1042_cov_242.728526	820	900	671	1	80	0.0125000
NODE_5879_length_1042_cov_242.728526	820	900	677	1	80	0.0125000
NODE_5879_length_1042_cov_242.728526	820	900	678	1	80	0.0125000
NODE_5879_length_1042_cov_242.728526	820	900	680	1	80	0.0125000
NODE_5879_length_1042_cov_242.728526	820	900	688	1	80	0.0125000
NODE_5879_length_1042_cov_242.728526	820	900	692	2	80	0.0250000
NODE_5879_length_1042_cov_242.728526	820	900	695	1	80	0.0125000
NODE_5879_length_1042_cov_242.728526	820	900	700	1	80	0.0125000
NODE_5879_length_1042_cov_242.728526	820	900	704	2	80	0.0250000
NODE_5879_length_1042_cov_242.728526	820	900	707	1	80	0.0125000
NODE_5879_length_1042_cov_242.728526	820	900	709	2	80	0.0250000
NODE_5879_length_1042_cov_242.728526	820	900	710	1	80	0.0125000
NODE_5879_length_1042_cov_242.728526	820	900	713	1	80	0.0125000
NODE_5879_length_1042_cov_242.728526	820	900	714	1	80	0.0125000
NODE_5879_length_1042_cov_242.728526	820	900	715	1	80	0.0125000
NODE_5879_length_1042_cov_242.728526	820	900	716	1	80	0.0125000
NODE_5879_length_1042_cov_242.728526	873	903	614	1	30	0.0333333
NODE_5879_length_1042_cov_242.728526	873	903	623	1	30	0.0333333
NODE_5879_length_1042_cov_242.728526	873	903	647	2	30	0.0666667
NODE_5879_length_1042_cov_242.728526	873	903	654	1	30	0.0333333
NODE_5879_length_1042_cov_242.728526	873	903	660	1	30	0.0333333
NODE_5879_length_1042_cov_242.728526	873	903	662	1	30	0.0333333
NODE_5879_length_1042_cov_242.728526	873	903	667	1	30	0.0333333
NODE_5879_length_1042_cov_242.728526	873	903	671	1	30	0.0333333
NODE_5879_length_1042_cov_242.728526	873	903	677	1	30	0.0333333
NODE_5879_length_1042_cov_242.728526	873	903	678	1	30	0.0333333
NODE_5879_length_1042_cov_242.728526	873	903	680	1	30	0.0333333
NODE_5879_length_1042_cov_242.728526	873	903	688	1	30	0.0333333
NODE_5879_length_1042_cov_242.728526	873	903	692	2	30	0.0666667
NODE_5879_length_1042_cov_242.728526	873	903	695	1	30	0.0333333
NODE_5879_length_1042_cov_242.728526	873	903	700	1	30	0.0333333
NODE_5879_length_1042_cov_242.728526	873	903	704	2	30	0.0666667
NODE_5879_length_1042_cov_242.728526	873	903	707	1	30	0.0333333
NODE_5879_length_1042_cov_242.728526	873	903	709	2	30	0.0666667
NODE_5879_length_1042_cov_242.728526	873	903	710	1	30	0.0333333
NODE_5879_length_1042_cov_242.728526	873	903	713	2	30	0.0666667
NODE_5879_length_1042_cov_242.728526	873	903	714	3	30	0.1000000
NODE_5879_length_1042_cov_242.728526	873	903	715	1	30	0.0333333
NODE_5879_length_1042_cov_242.728526	873	903	716	1	30	0.0333333
NODE_5880_length_1042_cov_63.214210	355	435	3	9	80	0.1125000
NODE_5880_length_1042_cov_63.214210	355	435	4	35	80	0.4375000
NODE_5880_length_1042_cov_63.214210	355	435	8	21	80	0.2625000
NODE_5880_length_1042_cov_63.214210	355	435	9	15	80	0.1875000
NODE_5880_length_1042_cov_63.214210	408	488	0	7	80	0.0875000
NODE_5880_length_1042_cov_63.214210	408	488	6	31	80	0.3875000
NODE_5880_length_1042_cov_63.214210	408	488	8	36	80	0.4500000
NODE_5880_length_1042_cov_63.214210	408	488	9	6	80	0.0750000
NODE_5881_length_1042_cov_29.581124	497	577	0	80	80	1.0000000
NODE_5881_length_1042_cov_29.581124	550	630	0	80	80	1.0000000
NODE_5882_length_1042_cov_23.861082	519	599	0	80	80	1.0000000
NODE_5882_length_1042_cov_23.861082	572	652	0	80	80	1.0000000
NODE_5882_length_1042_cov_23.861082	648	728	0	80	80	1.0000000
NODE_5882_length_1042_cov_23.861082	701	781	0	80	80	1.0000000
NODE_5883_length_1042_cov_22.247084	555	635	2	80	80	1.0000000
NODE_5883_length_1042_cov_22.247084	608	688	0	41	80	0.5125000
NODE_5883_length_1042_cov_22.247084	608	688	2	39	80	0.4875000
NODE_5884_length_1042_cov_22.117709	335	415	0	7	80	0.0875000
NODE_5884_length_1042_cov_22.117709	335	415	4	73	80	0.9125000
NODE_5884_length_1042_cov_22.117709	388	468	0	60	80	0.7500000
NODE_5884_length_1042_cov_22.117709	388	468	4	20	80	0.2500000
NODE_5884_length_1042_cov_22.117709	464	544	0	80	80	1.0000000
NODE_5884_length_1042_cov_22.117709	517	597	0	80	80	1.0000000
NODE_5885_length_1042_cov_16.831389	27	97	8	17	70	0.2428571
NODE_5885_length_1042_cov_16.831389	27	97	10	29	70	0.4142857
NODE_5885_length_1042_cov_16.831389	27	97	12	24	70	0.3428572
NODE_5885_length_1042_cov_16.831389	372	452	0	8	80	0.1000000
NODE_5885_length_1042_cov_16.831389	372	452	2	72	80	0.9000000
NODE_5885_length_1042_cov_16.831389	425	505	0	22	80	0.2750000
NODE_5885_length_1042_cov_16.831389	425	505	2	58	80	0.7250000
NODE_5886_length_1042_cov_16.662778	416	496	2	26	80	0.3250000
NODE_5886_length_1042_cov_16.662778	416	496	4	24	80	0.3000000
NODE_5886_length_1042_cov_16.662778	416	496	5	2	80	0.0250000
NODE_5886_length_1042_cov_16.662778	416	496	6	28	80	0.3500000
NODE_5886_length_1042_cov_16.662778	469	549	0	18	80	0.2250000
NODE_5886_length_1042_cov_16.662778	469	549	4	59	80	0.7375000
NODE_5886_length_1042_cov_16.662778	469	549	5	2	80	0.0250000
NODE_5886_length_1042_cov_16.662778	469	549	6	1	80	0.0125000
NODE_5887_length_1042_cov_9.474019	361	441	0	80	80	1.0000000
NODE_5887_length_1042_cov_9.474019	414	494	0	80	80	1.0000000
NODE_5888_length_1042_cov_6.725345	356	419	0	36	63	0.5714286
NODE_5888_length_1042_cov_6.725345	356	419	2	27	63	0.4285714
NODE_5888_length_1042_cov_6.725345	392	472	0	80	80	1.0000000
NODE_5896_length_1041_cov_42.960722	335	415	0	21	80	0.2625000
NODE_5896_length_1041_cov_42.960722	335	415	2	43	80	0.5375000
NODE_5896_length_1041_cov_42.960722	335	415	8	16	80	0.2000000
NODE_5896_length_1041_cov_42.960722	388	468	2	11	80	0.1375000
NODE_5896_length_1041_cov_42.960722	388	468	8	30	80	0.3750000
NODE_5896_length_1041_cov_42.960722	388	468	10	39	80	0.4875000
NODE_5896_length_1041_cov_42.960722	464	544	0	4	80	0.0500000
NODE_5896_length_1041_cov_42.960722	464	544	2	59	80	0.7375000
NODE_5896_length_1041_cov_42.960722	464	544	8	16	80	0.2000000
NODE_5896_length_1041_cov_42.960722	464	544	10	1	80	0.0125000
NODE_5896_length_1041_cov_42.960722	517	597	0	10	80	0.1250000
NODE_5896_length_1041_cov_42.960722	517	597	2	70	80	0.8750000
NODE_5897_length_1041_cov_37.331210	513	593	0	80	80	1.0000000
NODE_5897_length_1041_cov_37.331210	566	646	0	80	80	1.0000000
NODE_5897_length_1041_cov_37.331210	642	722	0	80	80	1.0000000
NODE_5897_length_1041_cov_37.331210	695	775	0	80	80	1.0000000
NODE_5898_length_1041_cov_36.477707	455	535	12	25	80	0.3125000
NODE_5898_length_1041_cov_36.477707	455	535	14	55	80	0.6875000
NODE_5898_length_1041_cov_36.477707	508	588	2	18	80	0.2250000
NODE_5898_length_1041_cov_36.477707	508	588	8	1	80	0.0125000
NODE_5898_length_1041_cov_36.477707	508	588	14	61	80	0.7625000
NODE_5898_length_1041_cov_36.477707	584	664	0	70	80	0.8750000
NODE_5898_length_1041_cov_36.477707	584	664	2	10	80	0.1250000
NODE_5898_length_1041_cov_36.477707	637	717	0	80	80	1.0000000
NODE_5898_length_1041_cov_36.477707	753	799	0	46	46	1.0000000
NODE_5899_length_1041_cov_19.286624	468	548	4	1	80	0.0125000
NODE_5899_length_1041_cov_19.286624	468	548	6	1	80	0.0125000
NODE_5899_length_1041_cov_19.286624	468	548	8	78	80	0.9750000
NODE_5899_length_1041_cov_19.286624	521	601	4	32	80	0.4000000
NODE_5899_length_1041_cov_19.286624	521	601	8	48	80	0.6000000
NODE_5900_length_1041_cov_17.072187	578	658	0	80	80	1.0000000
NODE_5900_length_1041_cov_17.072187	631	711	0	80	80	1.0000000
NODE_5901_length_1041_cov_11.887473	437	517	0	24	80	0.3000000
NODE_5901_length_1041_cov_11.887473	437	517	2	56	80	0.7000000
NODE_5901_length_1041_cov_11.887473	490	570	2	80	80	1.0000000
NODE_5902_length_1041_cov_6.957537	354	434	0	15	80	0.1875000
NODE_5902_length_1041_cov_6.957537	354	434	8	65	80	0.8125000
NODE_5902_length_1041_cov_6.957537	407	487	0	38	80	0.4750000
NODE_5902_length_1041_cov_6.957537	407	487	8	42	80	0.5250000
NODE_5913_length_1040_cov_34.618491	478	558	0	80	80	1.0000000
NODE_5913_length_1040_cov_34.618491	531	611	0	80	80	1.0000000
NODE_5914_length_1040_cov_33.061637	485	565	0	80	80	1.0000000
NODE_5914_length_1040_cov_33.061637	538	618	0	38	80	0.4750000
NODE_5914_length_1040_cov_33.061637	538	618	4	42	80	0.5250000
NODE_5915_length_1040_cov_27.818278	402	482	2	7	80	0.0875000
NODE_5915_length_1040_cov_27.818278	402	482	6	49	80	0.6125000
NODE_5915_length_1040_cov_27.818278	402	482	8	24	80	0.3000000
NODE_5915_length_1040_cov_27.818278	455	535	0	17	80	0.2125000
NODE_5915_length_1040_cov_27.818278	455	535	2	43	80	0.5375000
NODE_5915_length_1040_cov_27.818278	455	535	6	17	80	0.2125000
NODE_5915_length_1040_cov_27.818278	455	535	8	3	80	0.0375000
NODE_5916_length_1040_cov_17.933050	487	567	0	80	80	1.0000000
NODE_5916_length_1040_cov_17.933050	540	620	0	80	80	1.0000000
NODE_5917_length_1040_cov_14.327311	237	317	0	80	80	1.0000000
NODE_5917_length_1040_cov_14.327311	290	370	0	80	80	1.0000000
NODE_5917_length_1040_cov_14.327311	366	446	0	80	80	1.0000000
NODE_5917_length_1040_cov_14.327311	419	499	0	80	80	1.0000000
NODE_5918_length_1040_cov_11.910733	369	449	6	21	80	0.2625000
NODE_5918_length_1040_cov_11.910733	369	449	8	59	80	0.7375000
NODE_5918_length_1040_cov_11.910733	422	502	0	8	80	0.1000000
NODE_5918_length_1040_cov_11.910733	422	502	2	44	80	0.5500000
NODE_5918_length_1040_cov_11.910733	422	502	8	28	80	0.3500000
NODE_5919_length_1040_cov_11.521785	355	435	0	80	80	1.0000000
NODE_5919_length_1040_cov_11.521785	408	488	0	80	80	1.0000000
NODE_5920_length_1040_cov_9.573858	632	712	0	21	80	0.2625000
NODE_5920_length_1040_cov_9.573858	632	712	2	20	80	0.2500000
NODE_5920_length_1040_cov_9.573858	632	712	4	39	80	0.4875000
NODE_5920_length_1040_cov_9.573858	685	765	0	12	80	0.1500000
NODE_5920_length_1040_cov_9.573858	685	765	4	68	80	0.8500000
NODE_5921_length_1040_cov_8.148778	349	429	0	11	80	0.1375000
NODE_5921_length_1040_cov_8.148778	349	429	6	17	80	0.2125000
NODE_5921_length_1040_cov_8.148778	349	429	8	52	80	0.6500000
NODE_5921_length_1040_cov_8.148778	402	482	8	47	80	0.5875000
NODE_5921_length_1040_cov_8.148778	402	482	9	2	80	0.0250000
NODE_5921_length_1040_cov_8.148778	402	482	10	31	80	0.3875000
NODE_5922_length_1040_cov_7.927736	282	362	0	80	80	1.0000000
NODE_5922_length_1040_cov_7.927736	335	415	0	80	80	1.0000000
NODE_5927_length_1040_cov_2.317747	2	78	0	9	76	0.1184211
NODE_5927_length_1040_cov_2.317747	2	78	16	6	76	0.0789474
NODE_5927_length_1040_cov_2.317747	2	78	17	15	76	0.1973684
NODE_5927_length_1040_cov_2.317747	2	78	18	46	76	0.6052632
NODE_5934_length_1039_cov_40.150000	487	567	0	80	80	1.0000000
NODE_5934_length_1039_cov_40.150000	540	620	0	80	80	1.0000000
NODE_5934_length_1039_cov_40.150000	616	696	0	73	80	0.9125000
NODE_5934_length_1039_cov_40.150000	616	696	7	7	80	0.0875000
NODE_5934_length_1039_cov_40.150000	669	739	0	20	70	0.2857143
NODE_5934_length_1039_cov_40.150000	669	739	7	24	70	0.3428572
NODE_5934_length_1039_cov_40.150000	669	739	8	1	70	0.0142857
NODE_5934_length_1039_cov_40.150000	669	739	10	1	70	0.0142857
NODE_5934_length_1039_cov_40.150000	669	739	11	7	70	0.1000000
NODE_5934_length_1039_cov_40.150000	669	739	14	17	70	0.2428571
NODE_5935_length_1039_cov_37.940426	175	255	0	41	80	0.5125000
NODE_5935_length_1039_cov_37.940426	175	255	4	11	80	0.1375000
NODE_5935_length_1039_cov_37.940426	175	255	5	7	80	0.0875000
NODE_5935_length_1039_cov_37.940426	175	255	6	21	80	0.2625000
NODE_5935_length_1039_cov_37.940426	228	308	5	6	80	0.0750000
NODE_5935_length_1039_cov_37.940426	228	308	6	74	80	0.9250000
NODE_5935_length_1039_cov_37.940426	304	384	2	49	80	0.6125000
NODE_5935_length_1039_cov_37.940426	304	384	3	7	80	0.0875000
NODE_5935_length_1039_cov_37.940426	304	384	4	3	80	0.0375000
NODE_5935_length_1039_cov_37.940426	304	384	6	21	80	0.2625000
NODE_5935_length_1039_cov_37.940426	357	437	2	70	80	0.8750000
NODE_5935_length_1039_cov_37.940426	357	437	3	7	80	0.0875000
NODE_5935_length_1039_cov_37.940426	357	437	4	3	80	0.0375000
NODE_5936_length_1039_cov_24.567021	371	451	0	80	80	1.0000000
NODE_5936_length_1039_cov_24.567021	424	504	0	80	80	1.0000000
NODE_5937_length_1039_cov_15.790426	293	373	0	80	80	1.0000000
NODE_5937_length_1039_cov_15.790426	346	426	0	80	80	1.0000000
NODE_5938_length_1039_cov_14.670213	591	671	0	76	80	0.9500000
NODE_5938_length_1039_cov_14.670213	591	671	4	4	80	0.0500000
NODE_5938_length_1039_cov_14.670213	644	724	0	23	80	0.2875000
NODE_5938_length_1039_cov_14.670213	644	724	4	57	80	0.7125000
NODE_5939_length_1039_cov_11.568085	439	519	0	67	80	0.8375000
NODE_5939_length_1039_cov_11.568085	439	519	2	13	80	0.1625000
NODE_5939_length_1039_cov_11.568085	492	571	0	14	79	0.1772152
NODE_5939_length_1039_cov_11.568085	492	571	2	65	79	0.8227848
NODE_5947_length_1038_cov_17.191693	549	629	2	51	80	0.6375000
NODE_5947_length_1038_cov_17.191693	549	629	3	17	80	0.2125000
NODE_5947_length_1038_cov_17.191693	549	629	4	12	80	0.1500000
NODE_5947_length_1038_cov_17.191693	602	682	0	32	80	0.4000000
NODE_5947_length_1038_cov_17.191693	602	682	3	38	80	0.4750000
NODE_5947_length_1038_cov_17.191693	602	682	4	10	80	0.1250000
NODE_5948_length_1038_cov_13.520767	516	596	0	80	80	1.0000000
NODE_5948_length_1038_cov_13.520767	569	649	0	80	80	1.0000000
NODE_5949_length_1038_cov_10.541001	487	567	2	42	80	0.5250000
NODE_5949_length_1038_cov_10.541001	487	567	4	38	80	0.4750000
NODE_5949_length_1038_cov_10.541001	540	620	0	21	80	0.2625000
NODE_5949_length_1038_cov_10.541001	540	620	2	28	80	0.3500000
NODE_5949_length_1038_cov_10.541001	540	620	4	31	80	0.3875000
NODE_5950_length_1038_cov_8.826411	432	512	0	13	80	0.1625000
NODE_5950_length_1038_cov_8.826411	432	512	2	67	80	0.8375000
NODE_5950_length_1038_cov_8.826411	485	565	0	54	80	0.6750000
NODE_5950_length_1038_cov_8.826411	485	565	2	26	80	0.3250000
NODE_5952_length_1038_cov_2.587859	673	753	0	72	80	0.9000000
NODE_5952_length_1038_cov_2.587859	673	753	2	8	80	0.1000000
NODE_5952_length_1038_cov_2.587859	726	806	0	19	80	0.2375000
NODE_5952_length_1038_cov_2.587859	726	806	2	61	80	0.7625000
NODE_5963_length_1037_cov_66.968017	402	482	0	32	80	0.4000000
NODE_5963_length_1037_cov_66.968017	402	482	2	48	80	0.6000000
NODE_5963_length_1037_cov_66.968017	455	535	0	80	80	1.0000000
NODE_5964_length_1037_cov_53.639659	527	607	0	80	80	1.0000000
NODE_5964_length_1037_cov_53.639659	580	660	0	80	80	1.0000000
NODE_5965_length_1037_cov_45.353945	542	622	0	80	80	1.0000000
NODE_5965_length_1037_cov_45.353945	595	675	0	80	80	1.0000000
NODE_5966_length_1037_cov_31.078891	356	436	2	37	80	0.4625000
NODE_5966_length_1037_cov_31.078891	356	436	4	23	80	0.2875000
NODE_5966_length_1037_cov_31.078891	356	436	6	20	80	0.2500000
NODE_5966_length_1037_cov_31.078891	409	489	0	2	80	0.0250000
NODE_5966_length_1037_cov_31.078891	409	489	4	74	80	0.9250000
NODE_5966_length_1037_cov_31.078891	409	489	6	4	80	0.0500000
NODE_5967_length_1037_cov_25.453092	421	501	12	15	80	0.1875000
NODE_5967_length_1037_cov_25.453092	421	501	14	34	80	0.4250000
NODE_5967_length_1037_cov_25.453092	421	501	16	31	80	0.3875000
NODE_5967_length_1037_cov_25.453092	474	554	6	43	80	0.5375000
NODE_5967_length_1037_cov_25.453092	474	554	14	29	80	0.3625000
NODE_5967_length_1037_cov_25.453092	474	554	16	8	80	0.1000000
NODE_5967_length_1037_cov_25.453092	550	573	2	14	23	0.6086956
NODE_5967_length_1037_cov_25.453092	550	573	6	9	23	0.3913043
NODE_5968_length_1037_cov_13.740938	348	428	0	2	80	0.0250000
NODE_5968_length_1037_cov_13.740938	348	428	1	78	80	0.9750000
NODE_5968_length_1037_cov_13.740938	401	481	0	55	80	0.6875000
NODE_5968_length_1037_cov_13.740938	401	481	1	25	80	0.3125000
NODE_5969_length_1037_cov_12.632196	564	644	2	4	80	0.0500000
NODE_5969_length_1037_cov_12.632196	564	644	4	22	80	0.2750000
NODE_5969_length_1037_cov_12.632196	564	644	5	9	80	0.1125000
NODE_5969_length_1037_cov_12.632196	564	644	7	7	80	0.0875000
NODE_5969_length_1037_cov_12.632196	564	644	9	2	80	0.0250000
NODE_5969_length_1037_cov_12.632196	564	644	10	36	80	0.4500000
NODE_5969_length_1037_cov_12.632196	617	697	2	57	80	0.7125000
NODE_5969_length_1037_cov_12.632196	617	697	4	22	80	0.2750000
NODE_5969_length_1037_cov_12.632196	617	697	7	1	80	0.0125000
NODE_5970_length_1037_cov_8.904051	640	720	0	80	80	1.0000000
NODE_5970_length_1037_cov_8.904051	693	773	0	80	80	1.0000000
NODE_5978_length_1037_cov_1.859275	31	91	0	60	60	1.0000000
NODE_5986_length_1036_cov_52.270011	493	573	4	80	80	1.0000000
NODE_5986_length_1036_cov_52.270011	546	626	0	45	80	0.5625000
NODE_5986_length_1036_cov_52.270011	546	626	3	3	80	0.0375000
NODE_5986_length_1036_cov_52.270011	546	626	4	32	80	0.4000000
NODE_5987_length_1036_cov_24.080043	369	449	0	80	80	1.0000000
NODE_5987_length_1036_cov_24.080043	422	502	0	80	80	1.0000000
NODE_5988_length_1036_cov_20.533618	513	593	0	33	80	0.4125000
NODE_5988_length_1036_cov_20.533618	513	593	2	47	80	0.5875000
NODE_5988_length_1036_cov_20.533618	566	645	0	35	79	0.4430380
NODE_5988_length_1036_cov_20.533618	566	645	2	44	79	0.5569620
NODE_5988_length_1036_cov_20.533618	648	728	0	80	80	1.0000000
NODE_5988_length_1036_cov_20.533618	701	781	0	80	80	1.0000000
NODE_5989_length_1036_cov_19.715048	467	547	0	34	80	0.4250000
NODE_5989_length_1036_cov_19.715048	467	547	4	46	80	0.5750000
NODE_5989_length_1036_cov_19.715048	520	600	4	74	80	0.9250000
NODE_5989_length_1036_cov_19.715048	520	600	5	5	80	0.0625000
NODE_5989_length_1036_cov_19.715048	520	600	6	1	80	0.0125000
NODE_5990_length_1036_cov_19.452508	399	479	0	80	80	1.0000000
NODE_5990_length_1036_cov_19.452508	452	532	0	80	80	1.0000000
NODE_5990_length_1036_cov_19.452508	528	608	0	80	80	1.0000000
NODE_5990_length_1036_cov_19.452508	581	661	0	80	80	1.0000000
NODE_5991_length_1036_cov_13.840982	635	715	4	7	80	0.0875000
NODE_5991_length_1036_cov_13.840982	635	715	6	73	80	0.9125000
NODE_5991_length_1036_cov_13.840982	688	768	2	36	80	0.4500000
NODE_5991_length_1036_cov_13.840982	688	768	4	7	80	0.0875000
NODE_5991_length_1036_cov_13.840982	688	768	6	37	80	0.4625000
NODE_5992_length_1036_cov_6.913554	424	504	0	2	80	0.0250000
NODE_5992_length_1036_cov_6.913554	424	504	2	78	80	0.9750000
NODE_5992_length_1036_cov_6.913554	477	557	2	30	80	0.3750000
NODE_5992_length_1036_cov_6.913554	477	557	6	36	80	0.4500000
NODE_5992_length_1036_cov_6.913554	477	557	8	14	80	0.1750000
NODE_5993_length_1036_cov_5.880470	436	516	0	80	80	1.0000000
NODE_5993_length_1036_cov_5.880470	489	569	0	80	80	1.0000000
NODE_5994_length_1036_cov_4.638207	531	611	0	80	80	1.0000000
NODE_5994_length_1036_cov_4.638207	584	664	0	80	80	1.0000000
NODE_5998_length_1036_cov_1.293490	19	69	0	50	50	1.0000000
NODE_6001_length_1035_cov_31.941239	590	670	0	37	80	0.4625000
NODE_6001_length_1035_cov_31.941239	590	670	4	43	80	0.5375000
NODE_6001_length_1035_cov_31.941239	643	723	0	36	80	0.4500000
NODE_6001_length_1035_cov_31.941239	643	723	4	44	80	0.5500000
NODE_6002_length_1035_cov_14.917735	396	476	0	3	80	0.0375000
NODE_6002_length_1035_cov_14.917735	396	476	2	77	80	0.9625000
NODE_6002_length_1035_cov_14.917735	449	529	0	6	80	0.0750000
NODE_6002_length_1035_cov_14.917735	449	529	2	74	80	0.9250000
NODE_6003_length_1035_cov_12.552350	467	547	2	80	80	1.0000000
NODE_6003_length_1035_cov_12.552350	520	600	0	47	80	0.5875000
NODE_6003_length_1035_cov_12.552350	520	600	2	33	80	0.4125000
NODE_6004_length_1035_cov_12.050214	40	103	0	49	63	0.7777778
NODE_6004_length_1035_cov_12.050214	40	103	5	6	63	0.0952381
NODE_6004_length_1035_cov_12.050214	40	103	6	8	63	0.1269841
NODE_6004_length_1035_cov_12.050214	138	219	6	81	81	1.0000000
NODE_6005_length_1035_cov_7.020299	350	430	0	80	80	1.0000000
NODE_6005_length_1035_cov_7.020299	403	483	0	80	80	1.0000000
NODE_6006_length_1035_cov_4.726496	531	611	0	80	80	1.0000000
NODE_6006_length_1035_cov_4.726496	584	664	0	80	80	1.0000000
NODE_6018_length_1034_cov_26.810695	322	402	0	80	80	1.0000000
NODE_6018_length_1034_cov_26.810695	375	455	0	80	80	1.0000000
NODE_6018_length_1034_cov_26.810695	451	531	0	80	80	1.0000000
NODE_6018_length_1034_cov_26.810695	504	584	0	80	80	1.0000000
NODE_6032_length_1033_cov_42.574946	462	542	0	44	80	0.5500000
NODE_6032_length_1033_cov_42.574946	462	542	4	36	80	0.4500000
NODE_6032_length_1033_cov_42.574946	515	595	0	11	80	0.1375000
NODE_6032_length_1033_cov_42.574946	515	595	4	69	80	0.8625000
NODE_6033_length_1033_cov_17.073876	464	544	0	50	80	0.6250000
NODE_6033_length_1033_cov_17.073876	464	544	2	8	80	0.1000000
NODE_6033_length_1033_cov_17.073876	464	544	4	22	80	0.2750000
NODE_6033_length_1033_cov_17.073876	517	597	0	6	80	0.0750000
NODE_6033_length_1033_cov_17.073876	517	597	2	8	80	0.1000000
NODE_6033_length_1033_cov_17.073876	517	597	4	66	80	0.8250000
NODE_6034_length_1033_cov_15.791221	309	386	0	59	77	0.7662337
NODE_6034_length_1033_cov_15.791221	309	386	2	18	77	0.2337662
NODE_6034_length_1033_cov_15.791221	359	439	0	80	80	1.0000000
NODE_6035_length_1033_cov_11.340471	437	517	0	3	80	0.0375000
NODE_6035_length_1033_cov_11.340471	437	517	3	32	80	0.4000000
NODE_6035_length_1033_cov_11.340471	437	517	4	45	80	0.5625000
NODE_6035_length_1033_cov_11.340471	490	570	0	56	80	0.7000000
NODE_6035_length_1033_cov_11.340471	490	570	3	24	80	0.3000000
NODE_6045_length_1032_cov_56.511254	466	546	0	80	80	1.0000000
NODE_6045_length_1032_cov_56.511254	519	599	0	31	80	0.3875000
NODE_6045_length_1032_cov_56.511254	519	599	4	49	80	0.6125000
NODE_6046_length_1032_cov_20.752412	479	559	0	80	80	1.0000000
NODE_6046_length_1032_cov_20.752412	532	612	0	80	80	1.0000000
NODE_6047_length_1032_cov_8.166131	257	337	0	80	80	1.0000000
NODE_6047_length_1032_cov_8.166131	310	390	0	80	80	1.0000000
NODE_6048_length_1032_cov_7.991426	277	357	0	80	80	1.0000000
NODE_6048_length_1032_cov_7.991426	330	410	0	80	80	1.0000000
NODE_6049_length_1032_cov_5.276527	371	451	0	80	80	1.0000000
NODE_6049_length_1032_cov_5.276527	424	504	0	80	80	1.0000000
NODE_6055_length_1031_cov_71.154506	586	654	4	16	68	0.2352941
NODE_6055_length_1031_cov_71.154506	586	654	8	12	68	0.1764706
NODE_6055_length_1031_cov_71.154506	586	654	10	24	68	0.3529412
NODE_6055_length_1031_cov_71.154506	586	654	12	16	68	0.2352941
NODE_6055_length_1031_cov_71.154506	616	696	4	3	80	0.0375000
NODE_6055_length_1031_cov_71.154506	616	696	5	4	80	0.0500000
NODE_6055_length_1031_cov_71.154506	616	696	9	4	80	0.0500000
NODE_6055_length_1031_cov_71.154506	616	696	10	42	80	0.5250000
NODE_6055_length_1031_cov_71.154506	616	696	12	27	80	0.3375000
NODE_6055_length_1031_cov_71.154506	669	749	0	14	80	0.1750000
NODE_6055_length_1031_cov_71.154506	669	749	2	11	80	0.1375000
NODE_6055_length_1031_cov_71.154506	669	749	4	31	80	0.3875000
NODE_6055_length_1031_cov_71.154506	669	749	5	4	80	0.0500000
NODE_6055_length_1031_cov_71.154506	669	749	9	4	80	0.0500000
NODE_6055_length_1031_cov_71.154506	669	749	10	16	80	0.2000000
NODE_6056_length_1031_cov_70.221030	409	489	0	4	80	0.0500000
NODE_6056_length_1031_cov_70.221030	409	489	2	5	80	0.0625000
NODE_6056_length_1031_cov_70.221030	409	489	4	3	80	0.0375000
NODE_6056_length_1031_cov_70.221030	409	489	5	2	80	0.0250000
NODE_6056_length_1031_cov_70.221030	409	489	6	31	80	0.3875000
NODE_6056_length_1031_cov_70.221030	409	489	10	35	80	0.4375000
NODE_6056_length_1031_cov_70.221030	462	542	10	43	80	0.5375000
NODE_6056_length_1031_cov_70.221030	462	542	16	13	80	0.1625000
NODE_6056_length_1031_cov_70.221030	462	542	18	4	80	0.0500000
NODE_6056_length_1031_cov_70.221030	462	542	20	20	80	0.2500000
NODE_6056_length_1031_cov_70.221030	538	618	8	32	80	0.4000000
NODE_6056_length_1031_cov_70.221030	538	618	10	39	80	0.4875000
NODE_6056_length_1031_cov_70.221030	538	618	16	9	80	0.1125000
NODE_6056_length_1031_cov_70.221030	591	671	0	46	80	0.5750000
NODE_6056_length_1031_cov_70.221030	591	671	8	34	80	0.4250000
NODE_6057_length_1031_cov_43.618026	462	542	0	15	80	0.1875000
NODE_6057_length_1031_cov_43.618026	462	542	2	65	80	0.8125000
NODE_6057_length_1031_cov_43.618026	515	595	0	58	80	0.7250000
NODE_6057_length_1031_cov_43.618026	515	595	2	22	80	0.2750000
NODE_6058_length_1031_cov_43.581545	303	383	0	47	80	0.5875000
NODE_6058_length_1031_cov_43.581545	303	383	2	6	80	0.0750000
NODE_6058_length_1031_cov_43.581545	303	383	4	8	80	0.1000000
NODE_6058_length_1031_cov_43.581545	303	383	6	19	80	0.2375000
NODE_6058_length_1031_cov_43.581545	356	436	0	80	80	1.0000000
NODE_6058_length_1031_cov_43.581545	432	512	0	80	80	1.0000000
NODE_6058_length_1031_cov_43.581545	485	565	0	80	80	1.0000000
NODE_6059_length_1031_cov_22.310086	382	462	0	80	80	1.0000000
NODE_6059_length_1031_cov_22.310086	435	515	0	80	80	1.0000000
NODE_6060_length_1031_cov_11.547210	481	561	0	80	80	1.0000000
NODE_6060_length_1031_cov_11.547210	534	614	0	80	80	1.0000000
NODE_6066_length_1030_cov_54.380236	363	443	0	38	80	0.4750000
NODE_6066_length_1030_cov_54.380236	363	443	3	2	80	0.0250000
NODE_6066_length_1030_cov_54.380236	363	443	4	40	80	0.5000000
NODE_6066_length_1030_cov_54.380236	416	496	0	22	80	0.2750000
NODE_6066_length_1030_cov_54.380236	416	496	3	33	80	0.4125000
NODE_6066_length_1030_cov_54.380236	416	496	4	25	80	0.3125000
NODE_6066_length_1030_cov_54.380236	492	572	0	80	80	1.0000000
NODE_6066_length_1030_cov_54.380236	545	625	0	80	80	1.0000000
NODE_6067_length_1030_cov_45.040816	334	414	0	22	80	0.2750000
NODE_6067_length_1030_cov_45.040816	334	414	2	51	80	0.6375000
NODE_6067_length_1030_cov_45.040816	334	414	4	7	80	0.0875000
NODE_6067_length_1030_cov_45.040816	387	467	0	75	80	0.9375000
NODE_6067_length_1030_cov_45.040816	387	467	2	5	80	0.0625000
NODE_6067_length_1030_cov_45.040816	463	543	0	7	80	0.0875000
NODE_6067_length_1030_cov_45.040816	463	543	4	1	80	0.0125000
NODE_6067_length_1030_cov_45.040816	463	543	5	16	80	0.2000000
NODE_6067_length_1030_cov_45.040816	463	543	6	34	80	0.4250000
NODE_6067_length_1030_cov_45.040816	463	543	8	22	80	0.2750000
NODE_6067_length_1030_cov_45.040816	516	596	2	38	80	0.4750000
NODE_6067_length_1030_cov_45.040816	516	596	6	5	80	0.0625000
NODE_6067_length_1030_cov_45.040816	516	596	8	37	80	0.4625000
NODE_6068_length_1030_cov_20.491944	511	591	0	24	80	0.3000000
NODE_6068_length_1030_cov_20.491944	511	591	4	56	80	0.7000000
NODE_6068_length_1030_cov_20.491944	564	644	0	73	80	0.9125000
NODE_6068_length_1030_cov_20.491944	564	644	4	7	80	0.0875000
NODE_6069_length_1030_cov_17.253491	524	604	0	16	80	0.2000000
NODE_6069_length_1030_cov_17.253491	524	604	2	64	80	0.8000000
NODE_6069_length_1030_cov_17.253491	577	657	0	7	80	0.0875000
NODE_6069_length_1030_cov_17.253491	577	657	2	73	80	0.9125000
NODE_6070_length_1030_cov_14.337272	564	644	0	80	80	1.0000000
NODE_6070_length_1030_cov_14.337272	617	697	0	80	80	1.0000000
NODE_6071_length_1030_cov_5.742213	474	554	4	73	80	0.9125000
NODE_6071_length_1030_cov_5.742213	474	554	8	7	80	0.0875000
NODE_6071_length_1030_cov_5.742213	527	607	4	73	80	0.9125000
NODE_6071_length_1030_cov_5.742213	527	607	8	7	80	0.0875000
NODE_6073_length_1030_cov_5.208378	978	1030	0	30	52	0.5769231
NODE_6073_length_1030_cov_5.208378	978	1030	2	12	52	0.2307692
NODE_6073_length_1030_cov_5.208378	978	1030	4	7	52	0.1346154
NODE_6073_length_1030_cov_5.208378	978	1030	6	3	52	0.0576923
NODE_6077_length_1030_cov_2.146079	979	1010	0	31	31	1.0000000
NODE_6083_length_1029_cov_236.527957	584	666	10	8	82	0.0975610
NODE_6083_length_1029_cov_236.527957	584	666	14	2	82	0.0243902
NODE_6083_length_1029_cov_236.527957	584	666	16	10	82	0.1219512
NODE_6083_length_1029_cov_236.527957	584	666	22	1	82	0.0121951
NODE_6083_length_1029_cov_236.527957	584	666	23	8	82	0.0975610
NODE_6083_length_1029_cov_236.527957	584	666	25	3	82	0.0365854
NODE_6083_length_1029_cov_236.527957	584	666	27	2	82	0.0243902
NODE_6083_length_1029_cov_236.527957	584	666	29	3	82	0.0365854
NODE_6083_length_1029_cov_236.527957	584	666	31	4	82	0.0487805
NODE_6083_length_1029_cov_236.527957	584	666	33	41	82	0.5000000
NODE_6083_length_1029_cov_236.527957	639	702	10	2	63	0.0317460
NODE_6083_length_1029_cov_236.527957	639	702	20	1	63	0.0158730
NODE_6083_length_1029_cov_236.527957	639	702	29	17	63	0.2698413
NODE_6083_length_1029_cov_236.527957	639	702	31	3	63	0.0476190
NODE_6083_length_1029_cov_236.527957	639	702	33	40	63	0.6349207
NODE_6084_length_1029_cov_41.650538	364	444	0	80	80	1.0000000
NODE_6084_length_1029_cov_41.650538	417	497	0	28	80	0.3500000
NODE_6084_length_1029_cov_41.650538	417	497	2	30	80	0.3750000
NODE_6084_length_1029_cov_41.650538	417	497	8	22	80	0.2750000
NODE_6084_length_1029_cov_41.650538	493	573	6	48	80	0.6000000
NODE_6084_length_1029_cov_41.650538	493	573	8	32	80	0.4000000
NODE_6084_length_1029_cov_41.650538	546	626	0	52	80	0.6500000
NODE_6084_length_1029_cov_41.650538	546	626	6	28	80	0.3500000
NODE_6085_length_1029_cov_34.940860	314	360	0	46	46	1.0000000
NODE_6085_length_1029_cov_34.940860	371	451	0	80	80	1.0000000
NODE_6085_length_1029_cov_34.940860	424	502	0	78	78	1.0000000
NODE_6086_length_1029_cov_28.752688	255	335	9	18	80	0.2250000
NODE_6086_length_1029_cov_28.752688	255	335	10	62	80	0.7750000
NODE_6086_length_1029_cov_28.752688	308	388	0	47	80	0.5875000
NODE_6086_length_1029_cov_28.752688	308	388	9	24	80	0.3000000
NODE_6086_length_1029_cov_28.752688	308	388	10	9	80	0.1125000
NODE_6086_length_1029_cov_28.752688	384	464	0	37	80	0.4625000
NODE_6086_length_1029_cov_28.752688	384	464	2	43	80	0.5375000
NODE_6086_length_1029_cov_28.752688	437	517	2	80	80	1.0000000
NODE_6087_length_1029_cov_28.523656	409	489	0	21	80	0.2625000
NODE_6087_length_1029_cov_28.523656	409	489	3	1	80	0.0125000
NODE_6087_length_1029_cov_28.523656	409	489	4	41	80	0.5125000
NODE_6087_length_1029_cov_28.523656	409	489	6	17	80	0.2125000
NODE_6087_length_1029_cov_28.523656	462	542	2	11	80	0.1375000
NODE_6087_length_1029_cov_28.523656	462	542	4	10	80	0.1250000
NODE_6087_length_1029_cov_28.523656	462	542	6	59	80	0.7375000
NODE_6088_length_1029_cov_28.283871	281	361	0	80	80	1.0000000
NODE_6088_length_1029_cov_28.283871	334	414	0	80	80	1.0000000
NODE_6088_length_1029_cov_28.283871	410	490	0	13	80	0.1625000
NODE_6088_length_1029_cov_28.283871	410	490	6	35	80	0.4375000
NODE_6088_length_1029_cov_28.283871	410	490	12	7	80	0.0875000
NODE_6088_length_1029_cov_28.283871	410	490	14	9	80	0.1125000
NODE_6088_length_1029_cov_28.283871	410	490	16	10	80	0.1250000
NODE_6088_length_1029_cov_28.283871	410	490	18	6	80	0.0750000
NODE_6088_length_1029_cov_28.283871	463	546	12	2	83	0.0240964
NODE_6088_length_1029_cov_28.283871	463	546	14	9	83	0.1084337
NODE_6088_length_1029_cov_28.283871	463	546	16	12	83	0.1445783
NODE_6088_length_1029_cov_28.283871	463	546	18	60	83	0.7228916
NODE_6089_length_1029_cov_26.883871	434	514	0	80	80	1.0000000
NODE_6089_length_1029_cov_26.883871	487	567	0	80	80	1.0000000
NODE_6090_length_1029_cov_23.552688	305	385	0	22	80	0.2750000
NODE_6090_length_1029_cov_23.552688	305	385	2	5	80	0.0625000
NODE_6090_length_1029_cov_23.552688	305	385	4	53	80	0.6625000
NODE_6090_length_1029_cov_23.552688	358	438	0	33	80	0.4125000
NODE_6090_length_1029_cov_23.552688	358	438	4	47	80	0.5875000
NODE_6090_length_1029_cov_23.552688	434	514	0	80	80	1.0000000
NODE_6090_length_1029_cov_23.552688	487	567	0	80	80	1.0000000
NODE_6091_length_1029_cov_22.520430	434	514	0	3	80	0.0375000
NODE_6091_length_1029_cov_22.520430	434	514	4	38	80	0.4750000
NODE_6091_length_1029_cov_22.520430	434	514	10	39	80	0.4875000
NODE_6091_length_1029_cov_22.520430	487	567	6	6	80	0.0750000
NODE_6091_length_1029_cov_22.520430	487	567	9	1	80	0.0125000
NODE_6091_length_1029_cov_22.520430	487	567	10	73	80	0.9125000
NODE_6092_length_1029_cov_21.924731	335	415	0	80	80	1.0000000
NODE_6092_length_1029_cov_21.924731	388	468	0	80	80	1.0000000
NODE_6093_length_1029_cov_17.101075	501	581	0	80	80	1.0000000
NODE_6093_length_1029_cov_17.101075	554	634	0	80	80	1.0000000
NODE_6093_length_1029_cov_17.101075	630	710	0	80	80	1.0000000
NODE_6093_length_1029_cov_17.101075	683	755	0	72	72	1.0000000
NODE_6094_length_1029_cov_14.052688	405	485	0	26	80	0.3250000
NODE_6094_length_1029_cov_14.052688	405	485	2	54	80	0.6750000
NODE_6094_length_1029_cov_14.052688	458	538	0	34	80	0.4250000
NODE_6094_length_1029_cov_14.052688	458	538	2	46	80	0.5750000
NODE_6095_length_1029_cov_11.119355	291	369	0	5	78	0.0641026
NODE_6095_length_1029_cov_11.119355	291	369	2	73	78	0.9358974
NODE_6095_length_1029_cov_11.119355	342	422	0	28	80	0.3500000
NODE_6095_length_1029_cov_11.119355	342	422	2	52	80	0.6500000
NODE_6097_length_1029_cov_3.850538	231	311	4	25	80	0.3125000
NODE_6097_length_1029_cov_3.850538	231	311	6	49	80	0.6125000
NODE_6097_length_1029_cov_3.850538	231	311	8	6	80	0.0750000
NODE_6097_length_1029_cov_3.850538	284	364	2	26	80	0.3250000
NODE_6097_length_1029_cov_3.850538	284	364	4	47	80	0.5875000
NODE_6097_length_1029_cov_3.850538	284	364	6	1	80	0.0125000
NODE_6097_length_1029_cov_3.850538	284	364	8	6	80	0.0750000
NODE_6104_length_1028_cov_19.625404	495	575	0	80	80	1.0000000
NODE_6104_length_1028_cov_19.625404	548	628	0	80	80	1.0000000
NODE_6105_length_1028_cov_17.497309	533	613	0	80	80	1.0000000
NODE_6105_length_1028_cov_17.497309	586	666	0	80	80	1.0000000
NODE_6106_length_1028_cov_16.528525	497	577	0	80	80	1.0000000
NODE_6106_length_1028_cov_16.528525	550	630	0	80	80	1.0000000
NODE_6107_length_1028_cov_10.212056	463	543	0	80	80	1.0000000
NODE_6107_length_1028_cov_10.212056	516	596	0	80	80	1.0000000
NODE_6108_length_1028_cov_10.131324	399	479	0	80	80	1.0000000
NODE_6108_length_1028_cov_10.131324	452	532	0	80	80	1.0000000
NODE_6109_length_1028_cov_9.773950	482	562	0	80	80	1.0000000
NODE_6109_length_1028_cov_9.773950	535	615	0	80	80	1.0000000
NODE_6110_length_1028_cov_8.079656	399	479	0	34	80	0.4250000
NODE_6110_length_1028_cov_8.079656	399	479	2	46	80	0.5750000
NODE_6110_length_1028_cov_8.079656	452	532	0	18	80	0.2250000
NODE_6110_length_1028_cov_8.079656	452	532	2	62	80	0.7750000
NODE_6111_length_1028_cov_7.092573	439	519	0	80	80	1.0000000
NODE_6111_length_1028_cov_7.092573	492	572	0	80	80	1.0000000
NODE_6112_length_1028_cov_4.727664	416	488	0	72	72	1.0000000
NODE_6112_length_1028_cov_4.727664	461	541	0	80	80	1.0000000
NODE_6125_length_1027_cov_51.341595	399	479	0	80	80	1.0000000
NODE_6125_length_1027_cov_51.341595	452	532	0	80	80	1.0000000
NODE_6125_length_1027_cov_51.341595	528	608	0	53	80	0.6625000
NODE_6125_length_1027_cov_51.341595	528	608	4	12	80	0.1500000
NODE_6125_length_1027_cov_51.341595	528	608	6	15	80	0.1875000
NODE_6125_length_1027_cov_51.341595	581	661	4	12	80	0.1500000
NODE_6125_length_1027_cov_51.341595	581	661	6	30	80	0.3750000
NODE_6125_length_1027_cov_51.341595	581	661	8	38	80	0.4750000
NODE_6126_length_1027_cov_45.613147	347	427	0	39	80	0.4875000
NODE_6126_length_1027_cov_45.613147	347	427	2	41	80	0.5125000
NODE_6126_length_1027_cov_45.613147	400	480	0	11	80	0.1375000
NODE_6126_length_1027_cov_45.613147	400	480	2	69	80	0.8625000
NODE_6126_length_1027_cov_45.613147	476	556	0	80	80	1.0000000
NODE_6126_length_1027_cov_45.613147	529	609	0	80	80	1.0000000
NODE_6127_length_1027_cov_35.435345	431	511	0	19	80	0.2375000
NODE_6127_length_1027_cov_35.435345	431	511	2	61	80	0.7625000
NODE_6127_length_1027_cov_35.435345	484	564	0	36	80	0.4500000
NODE_6127_length_1027_cov_35.435345	484	564	2	44	80	0.5500000
NODE_6135_length_1026_cov_39.737864	374	454	0	80	80	1.0000000
NODE_6135_length_1026_cov_39.737864	427	509	0	82	82	1.0000000
NODE_6135_length_1026_cov_39.737864	505	585	0	80	80	1.0000000
NODE_6135_length_1026_cov_39.737864	558	638	0	80	80	1.0000000
NODE_6136_length_1026_cov_26.400216	423	503	0	20	80	0.2500000
NODE_6136_length_1026_cov_26.400216	423	503	2	60	80	0.7500000
NODE_6136_length_1026_cov_26.400216	476	556	0	73	80	0.9125000
NODE_6136_length_1026_cov_26.400216	476	556	2	7	80	0.0875000
NODE_6137_length_1026_cov_25.325782	477	557	0	69	80	0.8625000
NODE_6137_length_1026_cov_25.325782	477	557	2	2	80	0.0250000
NODE_6137_length_1026_cov_25.325782	477	557	3	9	80	0.1125000
NODE_6137_length_1026_cov_25.325782	530	610	0	25	80	0.3125000
NODE_6137_length_1026_cov_25.325782	530	610	2	3	80	0.0375000
NODE_6137_length_1026_cov_25.325782	530	610	6	32	80	0.4000000
NODE_6137_length_1026_cov_25.325782	530	610	10	20	80	0.2500000
NODE_6137_length_1026_cov_25.325782	606	686	0	16	80	0.2000000
NODE_6137_length_1026_cov_25.325782	606	686	3	2	80	0.0250000
NODE_6137_length_1026_cov_25.325782	606	686	4	1	80	0.0125000
NODE_6137_length_1026_cov_25.325782	606	686	6	11	80	0.1375000
NODE_6137_length_1026_cov_25.325782	606	686	10	50	80	0.6250000
NODE_6137_length_1026_cov_25.325782	659	739	0	69	80	0.8625000
NODE_6137_length_1026_cov_25.325782	659	739	3	2	80	0.0250000
NODE_6137_length_1026_cov_25.325782	659	739	4	1	80	0.0125000
NODE_6137_length_1026_cov_25.325782	659	739	6	8	80	0.1000000
NODE_6138_length_1026_cov_22.218986	408	488	0	78	80	0.9750000
NODE_6138_length_1026_cov_22.218986	408	488	2	2	80	0.0250000
NODE_6138_length_1026_cov_22.218986	461	541	0	80	80	1.0000000
NODE_6138_length_1026_cov_22.218986	537	617	0	80	80	1.0000000
NODE_6138_length_1026_cov_22.218986	590	670	0	80	80	1.0000000
NODE_6139_length_1026_cov_15.640777	450	530	0	80	80	1.0000000
NODE_6139_length_1026_cov_15.640777	503	583	0	39	80	0.4875000
NODE_6139_length_1026_cov_15.640777	503	583	2	41	80	0.5125000
NODE_6140_length_1026_cov_12.062567	165	245	0	80	80	1.0000000
NODE_6140_length_1026_cov_12.062567	218	298	0	80	80	1.0000000
NODE_6142_length_1026_cov_5.002157	335	415	0	80	80	1.0000000
NODE_6142_length_1026_cov_5.002157	388	468	0	80	80	1.0000000
NODE_6155_length_1025_cov_52.053996	366	446	0	80	80	1.0000000
NODE_6155_length_1025_cov_52.053996	419	499	0	80	80	1.0000000
NODE_6155_length_1025_cov_52.053996	495	575	0	80	80	1.0000000
NODE_6155_length_1025_cov_52.053996	548	628	0	80	80	1.0000000
NODE_6156_length_1025_cov_35.980562	318	375	6	57	57	1.0000000
NODE_6156_length_1025_cov_35.980562	348	428	6	54	80	0.6750000
NODE_6156_length_1025_cov_35.980562	348	428	8	6	80	0.0750000
NODE_6156_length_1025_cov_35.980562	348	428	10	20	80	0.2500000
NODE_6156_length_1025_cov_35.980562	425	482	4	36	57	0.6315789
NODE_6156_length_1025_cov_35.980562	425	482	10	21	57	0.3684210
NODE_6156_length_1025_cov_35.980562	455	521	0	24	66	0.3636364
NODE_6156_length_1025_cov_35.980562	455	521	2	13	66	0.1969697
NODE_6156_length_1025_cov_35.980562	455	521	4	29	66	0.4393939
NODE_6157_length_1025_cov_26.954644	607	687	0	80	80	1.0000000
NODE_6157_length_1025_cov_26.954644	660	740	0	80	80	1.0000000
NODE_6158_length_1025_cov_20.576674	428	508	0	80	80	1.0000000
NODE_6158_length_1025_cov_20.576674	481	561	0	80	80	1.0000000
NODE_6159_length_1025_cov_15.525918	415	495	12	3	80	0.0375000
NODE_6159_length_1025_cov_15.525918	415	495	13	1	80	0.0125000
NODE_6159_length_1025_cov_15.525918	415	495	14	76	80	0.9500000
NODE_6159_length_1025_cov_15.525918	468	548	0	27	80	0.3375000
NODE_6159_length_1025_cov_15.525918	468	548	12	29	80	0.3625000
NODE_6159_length_1025_cov_15.525918	468	548	13	1	80	0.0125000
NODE_6159_length_1025_cov_15.525918	468	548	14	23	80	0.2875000
NODE_6160_length_1025_cov_7.044276	240	320	0	80	80	1.0000000
NODE_6161_length_1025_cov_6.688985	334	414	0	44	80	0.5500000
NODE_6161_length_1025_cov_6.688985	334	414	2	36	80	0.4500000
NODE_6161_length_1025_cov_6.688985	387	467	2	80	80	1.0000000
NODE_6170_length_1024_cov_28.681081	264	344	0	80	80	1.0000000
NODE_6170_length_1024_cov_28.681081	317	397	0	28	80	0.3500000
NODE_6170_length_1024_cov_28.681081	317	397	4	17	80	0.2125000
NODE_6170_length_1024_cov_28.681081	317	397	6	29	80	0.3625000
NODE_6170_length_1024_cov_28.681081	317	397	8	1	80	0.0125000
NODE_6170_length_1024_cov_28.681081	317	397	9	5	80	0.0625000
NODE_6170_length_1024_cov_28.681081	393	477	7	34	84	0.4047619
NODE_6170_length_1024_cov_28.681081	393	477	8	21	84	0.2500000
NODE_6170_length_1024_cov_28.681081	393	477	9	14	84	0.1666667
NODE_6170_length_1024_cov_28.681081	393	477	11	15	84	0.1785714
NODE_6171_length_1024_cov_17.922162	324	404	2	7	80	0.0875000
NODE_6171_length_1024_cov_17.922162	324	404	4	73	80	0.9125000
NODE_6171_length_1024_cov_17.922162	377	457	0	31	80	0.3875000
NODE_6171_length_1024_cov_17.922162	377	457	2	1	80	0.0125000
NODE_6171_length_1024_cov_17.922162	377	457	4	48	80	0.6000000
NODE_6173_length_1024_cov_12.018378	368	448	0	80	80	1.0000000
NODE_6173_length_1024_cov_12.018378	421	501	0	80	80	1.0000000
NODE_6174_length_1024_cov_8.800000	517	597	0	80	80	1.0000000
NODE_6174_length_1024_cov_8.800000	570	650	0	80	80	1.0000000
NODE_6175_length_1024_cov_6.207568	318	398	0	80	80	1.0000000
NODE_6175_length_1024_cov_6.207568	371	451	0	80	80	1.0000000
NODE_6178_length_1024_cov_2.468108	274	324	0	50	50	1.0000000
NODE_6178_length_1024_cov_2.468108	274	322	0	48	48	1.0000000
NODE_6178_length_1024_cov_2.468108	274	324	0	50	50	1.0000000
NODE_6178_length_1024_cov_2.468108	274	323	0	49	49	1.0000000
NODE_6178_length_1024_cov_2.468108	274	322	0	48	48	1.0000000
NODE_6185_length_1023_cov_100.366883	441	521	0	80	80	1.0000000
NODE_6185_length_1023_cov_100.366883	494	574	0	53	80	0.6625000
NODE_6185_length_1023_cov_100.366883	494	574	2	27	80	0.3375000
NODE_6186_length_1023_cov_64.271645	349	429	0	80	80	1.0000000
NODE_6186_length_1023_cov_64.271645	402	482	0	80	80	1.0000000
NODE_6186_length_1023_cov_64.271645	478	558	0	20	80	0.2500000
NODE_6186_length_1023_cov_64.271645	478	558	2	31	80	0.3875000
NODE_6186_length_1023_cov_64.271645	478	558	4	29	80	0.3625000
NODE_6186_length_1023_cov_64.271645	531	611	0	14	80	0.1750000
NODE_6186_length_1023_cov_64.271645	531	611	2	28	80	0.3500000
NODE_6186_length_1023_cov_64.271645	531	611	4	38	80	0.4750000
NODE_6187_length_1023_cov_32.695887	318	398	0	80	80	1.0000000
NODE_6187_length_1023_cov_32.695887	371	451	0	80	80	1.0000000
NODE_6187_length_1023_cov_32.695887	447	527	0	80	80	1.0000000
NODE_6187_length_1023_cov_32.695887	500	580	0	80	80	1.0000000
NODE_6188_length_1023_cov_16.244589	601	681	0	80	80	1.0000000
NODE_6188_length_1023_cov_16.244589	654	734	0	80	80	1.0000000
NODE_6189_length_1023_cov_15.876623	371	451	0	80	80	1.0000000
NODE_6189_length_1023_cov_15.876623	424	504	0	80	80	1.0000000
NODE_6189_length_1023_cov_15.876623	500	580	0	49	80	0.6125000
NODE_6189_length_1023_cov_15.876623	500	580	4	31	80	0.3875000
NODE_6189_length_1023_cov_15.876623	553	633	4	80	80	1.0000000
NODE_6190_length_1023_cov_14.678571	555	635	0	40	80	0.5000000
NODE_6190_length_1023_cov_14.678571	555	635	4	4	80	0.0500000
NODE_6190_length_1023_cov_14.678571	555	635	6	36	80	0.4500000
NODE_6190_length_1023_cov_14.678571	608	688	4	15	80	0.1875000
NODE_6190_length_1023_cov_14.678571	608	688	6	65	80	0.8125000
NODE_6191_length_1023_cov_14.443723	406	486	0	80	80	1.0000000
NODE_6191_length_1023_cov_14.443723	459	539	0	80	80	1.0000000
NODE_6192_length_1023_cov_10.984848	590	670	0	80	80	1.0000000
NODE_6192_length_1023_cov_10.984848	643	723	0	80	80	1.0000000
NODE_6202_length_1022_cov_42.952329	555	636	0	15	81	0.1851852
NODE_6202_length_1022_cov_42.952329	555	636	2	66	81	0.8148148
NODE_6202_length_1022_cov_42.952329	609	689	0	22	80	0.2750000
NODE_6202_length_1022_cov_42.952329	609	689	2	58	80	0.7250000
NODE_6202_length_1022_cov_42.952329	685	765	0	80	80	1.0000000
NODE_6202_length_1022_cov_42.952329	738	818	0	80	80	1.0000000
NODE_6203_length_1022_cov_29.949079	510	590	0	80	80	1.0000000
NODE_6203_length_1022_cov_29.949079	563	643	0	80	80	1.0000000
NODE_6204_length_1022_cov_7.672806	461	541	0	80	80	1.0000000
NODE_6204_length_1022_cov_7.672806	514	594	0	80	80	1.0000000
NODE_6213_length_1021_cov_47.379610	341	421	0	80	80	1.0000000
NODE_6213_length_1021_cov_47.379610	394	474	0	44	80	0.5500000
NODE_6213_length_1021_cov_47.379610	394	474	1	2	80	0.0250000
NODE_6213_length_1021_cov_47.379610	394	474	2	34	80	0.4250000
NODE_6213_length_1021_cov_47.379610	470	550	2	21	80	0.2625000
NODE_6213_length_1021_cov_47.379610	470	550	4	59	80	0.7375000
NODE_6213_length_1021_cov_47.379610	523	603	0	52	80	0.6500000
NODE_6213_length_1021_cov_47.379610	523	603	2	16	80	0.2000000
NODE_6213_length_1021_cov_47.379610	523	603	4	12	80	0.1500000
NODE_6214_length_1021_cov_33.255965	588	668	0	8	80	0.1000000
NODE_6214_length_1021_cov_33.255965	588	668	2	72	80	0.9000000
NODE_6214_length_1021_cov_33.255965	641	721	0	47	80	0.5875000
NODE_6214_length_1021_cov_33.255965	641	721	2	33	80	0.4125000
NODE_6227_length_1020_cov_24.565689	485	565	0	80	80	1.0000000
NODE_6227_length_1020_cov_24.565689	538	618	0	60	80	0.7500000
NODE_6227_length_1020_cov_24.565689	538	618	2	20	80	0.2500000
NODE_6228_length_1020_cov_20.825190	395	475	0	80	80	1.0000000
NODE_6228_length_1020_cov_20.825190	448	528	0	80	80	1.0000000
NODE_6229_length_1020_cov_20.305103	285	365	0	80	80	1.0000000
NODE_6229_length_1020_cov_20.305103	338	418	0	80	80	1.0000000
NODE_6229_length_1020_cov_20.305103	414	494	0	80	80	1.0000000
NODE_6229_length_1020_cov_20.305103	467	548	0	81	81	1.0000000
NODE_6230_length_1020_cov_17.919653	408	488	1	1	80	0.0125000
NODE_6230_length_1020_cov_17.919653	408	488	3	6	80	0.0750000
NODE_6230_length_1020_cov_17.919653	408	488	4	31	80	0.3875000
NODE_6230_length_1020_cov_17.919653	408	488	8	42	80	0.5250000
NODE_6230_length_1020_cov_17.919653	461	541	5	3	80	0.0375000
NODE_6230_length_1020_cov_17.919653	461	541	7	43	80	0.5375000
NODE_6230_length_1020_cov_17.919653	461	541	8	34	80	0.4250000
NODE_6231_length_1020_cov_13.972856	436	516	0	80	80	1.0000000
NODE_6231_length_1020_cov_13.972856	489	569	0	80	80	1.0000000
NODE_6232_length_1020_cov_10.472313	407	487	0	72	80	0.9000000
NODE_6232_length_1020_cov_10.472313	407	487	8	8	80	0.1000000
NODE_6232_length_1020_cov_10.472313	460	540	0	19	80	0.2375000
NODE_6232_length_1020_cov_10.472313	460	540	8	61	80	0.7625000
NODE_6235_length_1020_cov_3.707926	821	901	0	80	80	1.0000000
NODE_6235_length_1020_cov_3.707926	874	954	0	80	80	1.0000000
NODE_6238_length_1020_cov_2.648208	0	70	0	70	70	1.0000000
NODE_6238_length_1020_cov_2.648208	43	88	0	45	45	1.0000000
NODE_6248_length_1019_cov_30.164130	476	556	0	47	80	0.5875000
NODE_6248_length_1019_cov_30.164130	476	556	4	20	80	0.2500000
NODE_6248_length_1019_cov_30.164130	476	556	10	13	80	0.1625000
NODE_6248_length_1019_cov_30.164130	529	609	4	14	80	0.1750000
NODE_6248_length_1019_cov_30.164130	529	609	8	6	80	0.0750000
NODE_6248_length_1019_cov_30.164130	529	609	10	31	80	0.3875000
NODE_6248_length_1019_cov_30.164130	529	609	12	29	80	0.3625000
NODE_6248_length_1019_cov_30.164130	605	685	0	23	80	0.2875000
NODE_6248_length_1019_cov_30.164130	605	685	6	12	80	0.1500000
NODE_6248_length_1019_cov_30.164130	605	685	8	45	80	0.5625000
NODE_6248_length_1019_cov_30.164130	658	738	0	76	80	0.9500000
NODE_6248_length_1019_cov_30.164130	658	738	6	4	80	0.0500000
NODE_6249_length_1019_cov_22.845652	343	423	0	26	80	0.3250000
NODE_6249_length_1019_cov_22.845652	343	423	2	54	80	0.6750000
NODE_6249_length_1019_cov_22.845652	396	476	2	54	80	0.6750000
NODE_6249_length_1019_cov_22.845652	396	476	4	26	80	0.3250000
NODE_6249_length_1019_cov_22.845652	472	552	2	72	80	0.9000000
NODE_6249_length_1019_cov_22.845652	472	552	4	8	80	0.1000000
NODE_6249_length_1019_cov_22.845652	525	605	0	43	80	0.5375000
NODE_6249_length_1019_cov_22.845652	525	605	2	37	80	0.4625000
NODE_6250_length_1019_cov_8.098913	523	601	0	78	78	1.0000000
NODE_6250_length_1019_cov_8.098913	574	654	0	80	80	1.0000000
NODE_6251_length_1019_cov_7.896739	423	503	0	80	80	1.0000000
NODE_6251_length_1019_cov_7.896739	476	556	0	80	80	1.0000000
NODE_6252_length_1019_cov_4.597826	625	696	6	3	71	0.0422535
NODE_6252_length_1019_cov_4.597826	625	696	17	1	71	0.0140845
NODE_6252_length_1019_cov_4.597826	625	696	18	2	71	0.0281690
NODE_6252_length_1019_cov_4.597826	625	696	21	24	71	0.3380282
NODE_6252_length_1019_cov_4.597826	625	696	26	1	71	0.0140845
NODE_6252_length_1019_cov_4.597826	625	696	29	1	71	0.0140845
NODE_6252_length_1019_cov_4.597826	625	696	34	6	71	0.0845070
NODE_6252_length_1019_cov_4.597826	625	696	36	33	71	0.4647887
NODE_6263_length_1019_cov_1.139130	89	165	6	10	76	0.1315790
NODE_6263_length_1019_cov_1.139130	89	165	8	21	76	0.2763158
NODE_6263_length_1019_cov_1.139130	89	165	12	45	76	0.5921053
NODE_6265_length_1018_cov_33.494015	212	292	2	6	80	0.0750000
NODE_6265_length_1018_cov_33.494015	212	292	4	1	80	0.0125000
NODE_6265_length_1018_cov_33.494015	212	292	10	1	80	0.0125000
NODE_6265_length_1018_cov_33.494015	212	292	12	1	80	0.0125000
NODE_6265_length_1018_cov_33.494015	212	292	32	2	80	0.0250000
NODE_6265_length_1018_cov_33.494015	212	292	34	1	80	0.0125000
NODE_6265_length_1018_cov_33.494015	212	292	36	3	80	0.0375000
NODE_6265_length_1018_cov_33.494015	212	292	38	3	80	0.0375000
NODE_6265_length_1018_cov_33.494015	212	292	40	1	80	0.0125000
NODE_6265_length_1018_cov_33.494015	212	292	42	2	80	0.0250000
NODE_6265_length_1018_cov_33.494015	212	292	44	7	80	0.0875000
NODE_6265_length_1018_cov_33.494015	212	292	45	1	80	0.0125000
NODE_6265_length_1018_cov_33.494015	212	292	47	5	80	0.0625000
NODE_6265_length_1018_cov_33.494015	212	292	48	1	80	0.0125000
NODE_6265_length_1018_cov_33.494015	212	292	49	5	80	0.0625000
NODE_6265_length_1018_cov_33.494015	212	292	51	12	80	0.1500000
NODE_6265_length_1018_cov_33.494015	212	292	53	28	80	0.3500000
NODE_6265_length_1018_cov_33.494015	265	345	2	59	80	0.7375000
NODE_6265_length_1018_cov_33.494015	265	345	4	1	80	0.0125000
NODE_6265_length_1018_cov_33.494015	265	345	10	1	80	0.0125000
NODE_6265_length_1018_cov_33.494015	265	345	12	1	80	0.0125000
NODE_6265_length_1018_cov_33.494015	265	345	32	2	80	0.0250000
NODE_6265_length_1018_cov_33.494015	265	345	34	1	80	0.0125000
NODE_6265_length_1018_cov_33.494015	265	345	36	3	80	0.0375000
NODE_6265_length_1018_cov_33.494015	265	345	42	2	80	0.0250000
NODE_6265_length_1018_cov_33.494015	265	345	48	1	80	0.0125000
NODE_6265_length_1018_cov_33.494015	265	345	49	5	80	0.0625000
NODE_6265_length_1018_cov_33.494015	265	345	53	4	80	0.0500000
NODE_6266_length_1018_cov_22.776931	372	452	0	80	80	1.0000000
NODE_6266_length_1018_cov_22.776931	425	505	0	80	80	1.0000000
NODE_6268_length_1018_cov_8.486398	404	484	0	80	80	1.0000000
NODE_6268_length_1018_cov_8.486398	457	537	0	80	80	1.0000000
NODE_6270_length_1018_cov_7.737758	357	437	0	39	80	0.4875000
NODE_6270_length_1018_cov_7.737758	357	437	2	41	80	0.5125000
NODE_6270_length_1018_cov_7.737758	410	490	0	80	80	1.0000000
NODE_6286_length_1017_cov_207.523965	0	41	98	2	41	0.0487805
NODE_6286_length_1017_cov_207.523965	0	41	100	1	41	0.0243902
NODE_6286_length_1017_cov_207.523965	0	41	101	1	41	0.0243902
NODE_6286_length_1017_cov_207.523965	0	41	108	2	41	0.0487805
NODE_6286_length_1017_cov_207.523965	0	41	109	1	41	0.0243902
NODE_6286_length_1017_cov_207.523965	0	41	111	1	41	0.0243902
NODE_6286_length_1017_cov_207.523965	0	41	114	2	41	0.0487805
NODE_6286_length_1017_cov_207.523965	0	41	117	2	41	0.0487805
NODE_6286_length_1017_cov_207.523965	0	41	127	1	41	0.0243902
NODE_6286_length_1017_cov_207.523965	0	41	131	1	41	0.0243902
NODE_6286_length_1017_cov_207.523965	0	41	133	2	41	0.0487805
NODE_6286_length_1017_cov_207.523965	0	41	140	2	41	0.0487805
NODE_6286_length_1017_cov_207.523965	0	41	147	2	41	0.0487805
NODE_6286_length_1017_cov_207.523965	0	41	149	1	41	0.0243902
NODE_6286_length_1017_cov_207.523965	0	41	151	1	41	0.0243902
NODE_6286_length_1017_cov_207.523965	0	41	154	1	41	0.0243902
NODE_6286_length_1017_cov_207.523965	0	41	156	1	41	0.0243902
NODE_6286_length_1017_cov_207.523965	0	41	167	2	41	0.0487805
NODE_6286_length_1017_cov_207.523965	0	41	171	1	41	0.0243902
NODE_6286_length_1017_cov_207.523965	0	41	173	1	41	0.0243902
NODE_6286_length_1017_cov_207.523965	0	41	182	2	41	0.0487805
NODE_6286_length_1017_cov_207.523965	0	41	188	1	41	0.0243902
NODE_6286_length_1017_cov_207.523965	0	41	190	1	41	0.0243902
NODE_6286_length_1017_cov_207.523965	0	41	192	1	41	0.0243902
NODE_6286_length_1017_cov_207.523965	0	41	194	5	41	0.1219512
NODE_6286_length_1017_cov_207.523965	0	41	201	1	41	0.0243902
NODE_6286_length_1017_cov_207.523965	0	41	205	2	41	0.0487805
NODE_6286_length_1017_cov_207.523965	14	94	133	2	80	0.0250000
NODE_6286_length_1017_cov_207.523965	14	94	140	2	80	0.0250000
NODE_6286_length_1017_cov_207.523965	14	94	147	2	80	0.0250000
NODE_6286_length_1017_cov_207.523965	14	94	149	1	80	0.0125000
NODE_6286_length_1017_cov_207.523965	14	94	151	1	80	0.0125000
NODE_6286_length_1017_cov_207.523965	14	94	154	1	80	0.0125000
NODE_6286_length_1017_cov_207.523965	14	94	156	1	80	0.0125000
NODE_6286_length_1017_cov_207.523965	14	94	167	2	80	0.0250000
NODE_6286_length_1017_cov_207.523965	14	94	171	1	80	0.0125000
NODE_6286_length_1017_cov_207.523965	14	94	173	1	80	0.0125000
NODE_6286_length_1017_cov_207.523965	14	94	182	2	80	0.0250000
NODE_6286_length_1017_cov_207.523965	14	94	188	1	80	0.0125000
NODE_6286_length_1017_cov_207.523965	14	94	190	1	80	0.0125000
NODE_6286_length_1017_cov_207.523965	14	94	192	1	80	0.0125000
NODE_6286_length_1017_cov_207.523965	14	94	194	5	80	0.0625000
NODE_6286_length_1017_cov_207.523965	14	94	201	1	80	0.0125000
NODE_6286_length_1017_cov_207.523965	14	94	205	2	80	0.0250000
NODE_6286_length_1017_cov_207.523965	14	94	212	2	80	0.0250000
NODE_6286_length_1017_cov_207.523965	14	94	215	1	80	0.0125000
NODE_6286_length_1017_cov_207.523965	14	94	223	1	80	0.0125000
NODE_6286_length_1017_cov_207.523965	14	94	227	1	80	0.0125000
NODE_6286_length_1017_cov_207.523965	14	94	233	1	80	0.0125000
NODE_6286_length_1017_cov_207.523965	14	94	240	4	80	0.0500000
NODE_6286_length_1017_cov_207.523965	14	94	243	1	80	0.0125000
NODE_6286_length_1017_cov_207.523965	14	94	245	2	80	0.0250000
NODE_6286_length_1017_cov_207.523965	14	94	249	2	80	0.0250000
NODE_6286_length_1017_cov_207.523965	14	94	251	1	80	0.0125000
NODE_6286_length_1017_cov_207.523965	14	94	255	3	80	0.0375000
NODE_6286_length_1017_cov_207.523965	14	94	257	1	80	0.0125000
NODE_6286_length_1017_cov_207.523965	14	94	259	1	80	0.0125000
NODE_6286_length_1017_cov_207.523965	14	94	267	1	80	0.0125000
NODE_6286_length_1017_cov_207.523965	14	94	269	1	80	0.0125000
NODE_6286_length_1017_cov_207.523965	14	94	273	3	80	0.0375000
NODE_6286_length_1017_cov_207.523965	14	94	277	2	80	0.0250000
NODE_6286_length_1017_cov_207.523965	14	94	279	1	80	0.0125000
NODE_6286_length_1017_cov_207.523965	14	94	283	3	80	0.0375000
NODE_6286_length_1017_cov_207.523965	14	94	285	1	80	0.0125000
NODE_6286_length_1017_cov_207.523965	14	94	287	2	80	0.0250000
NODE_6286_length_1017_cov_207.523965	14	94	289	1	80	0.0125000
NODE_6286_length_1017_cov_207.523965	14	94	296	1	80	0.0125000
NODE_6286_length_1017_cov_207.523965	14	94	297	2	80	0.0250000
NODE_6286_length_1017_cov_207.523965	14	94	299	6	80	0.0750000
NODE_6286_length_1017_cov_207.523965	14	94	301	5	80	0.0625000
NODE_6286_length_1017_cov_207.523965	14	94	303	1	80	0.0125000
NODE_6286_length_1017_cov_207.523965	14	94	310	1	80	0.0125000
NODE_6286_length_1017_cov_207.523965	14	94	311	1	80	0.0125000
NODE_6287_length_1017_cov_18.824619	490	570	0	8	80	0.1000000
NODE_6287_length_1017_cov_18.824619	490	570	2	72	80	0.9000000
NODE_6287_length_1017_cov_18.824619	543	623	0	61	80	0.7625000
NODE_6287_length_1017_cov_18.824619	543	623	2	19	80	0.2375000
NODE_6288_length_1017_cov_14.794118	428	508	0	80	80	1.0000000
NODE_6288_length_1017_cov_14.794118	481	561	0	80	80	1.0000000
NODE_6288_length_1017_cov_14.794118	557	637	0	80	80	1.0000000
NODE_6288_length_1017_cov_14.794118	610	690	0	80	80	1.0000000
NODE_6297_length_1016_cov_22.267176	577	657	0	80	80	1.0000000
NODE_6297_length_1016_cov_22.267176	630	710	0	80	80	1.0000000
NODE_6298_length_1016_cov_21.134133	625	705	4	4	80	0.0500000
NODE_6298_length_1016_cov_21.134133	625	705	6	5	80	0.0625000
NODE_6298_length_1016_cov_21.134133	625	705	8	11	80	0.1375000
NODE_6298_length_1016_cov_21.134133	625	705	14	12	80	0.1500000
NODE_6298_length_1016_cov_21.134133	625	705	15	8	80	0.1000000
NODE_6298_length_1016_cov_21.134133	625	705	16	33	80	0.4125000
NODE_6298_length_1016_cov_21.134133	625	705	17	7	80	0.0875000
NODE_6298_length_1016_cov_21.134133	678	758	0	10	80	0.1250000
NODE_6298_length_1016_cov_21.134133	678	758	2	9	80	0.1125000
NODE_6298_length_1016_cov_21.134133	678	758	4	38	80	0.4750000
NODE_6298_length_1016_cov_21.134133	678	758	6	5	80	0.0625000
NODE_6298_length_1016_cov_21.134133	678	758	8	11	80	0.1375000
NODE_6298_length_1016_cov_21.134133	678	758	14	7	80	0.0875000
NODE_6299_length_1016_cov_20.392585	504	584	0	80	80	1.0000000
NODE_6299_length_1016_cov_20.392585	557	637	0	78	80	0.9750000
NODE_6299_length_1016_cov_20.392585	557	637	2	2	80	0.0250000
NODE_6299_length_1016_cov_20.392585	633	713	0	18	80	0.2250000
NODE_6299_length_1016_cov_20.392585	633	713	2	62	80	0.7750000
NODE_6299_length_1016_cov_20.392585	686	766	0	69	80	0.8625000
NODE_6299_length_1016_cov_20.392585	686	766	2	11	80	0.1375000
NODE_6300_length_1016_cov_16.917121	524	604	0	59	80	0.7375000
NODE_6300_length_1016_cov_16.917121	524	604	3	1	80	0.0125000
NODE_6300_length_1016_cov_16.917121	524	604	4	20	80	0.2500000
NODE_6300_length_1016_cov_16.917121	577	657	0	6	80	0.0750000
NODE_6300_length_1016_cov_16.917121	577	657	3	1	80	0.0125000
NODE_6300_length_1016_cov_16.917121	577	657	4	73	80	0.9125000
NODE_6301_length_1016_cov_8.243184	438	518	0	80	80	1.0000000
NODE_6301_length_1016_cov_8.243184	491	571	0	80	80	1.0000000
NODE_6301_length_1016_cov_8.243184	567	647	0	80	80	1.0000000
NODE_6301_length_1016_cov_8.243184	620	700	0	80	80	1.0000000
NODE_6302_length_1016_cov_8.141767	166	256	7	1	90	0.0111111
NODE_6302_length_1016_cov_8.141767	166	256	9	3	90	0.0333333
NODE_6302_length_1016_cov_8.141767	166	256	13	1	90	0.0111111
NODE_6302_length_1016_cov_8.141767	166	256	19	1	90	0.0111111
NODE_6302_length_1016_cov_8.141767	166	256	21	6	90	0.0666667
NODE_6302_length_1016_cov_8.141767	166	256	23	27	90	0.3000000
NODE_6302_length_1016_cov_8.141767	166	256	24	1	90	0.0111111
NODE_6302_length_1016_cov_8.141767	166	256	25	18	90	0.2000000
NODE_6302_length_1016_cov_8.141767	166	256	26	2	90	0.0222222
NODE_6302_length_1016_cov_8.141767	166	256	27	30	90	0.3333333
NODE_6303_length_1016_cov_7.466739	576	656	0	80	80	1.0000000
NODE_6303_length_1016_cov_7.466739	629	709	0	80	80	1.0000000
NODE_6318_length_1015_cov_24.680131	459	539	0	80	80	1.0000000
NODE_6318_length_1015_cov_24.680131	512	592	0	80	80	1.0000000
NODE_6318_length_1015_cov_24.680131	588	668	0	80	80	1.0000000
NODE_6318_length_1015_cov_24.680131	641	721	0	80	80	1.0000000
NODE_6319_length_1015_cov_23.198690	407	487	0	80	80	1.0000000
NODE_6319_length_1015_cov_23.198690	460	540	0	80	80	1.0000000
NODE_6319_length_1015_cov_23.198690	536	616	0	80	80	1.0000000
NODE_6319_length_1015_cov_23.198690	589	669	0	80	80	1.0000000
NODE_6320_length_1015_cov_22.544760	490	570	0	13	80	0.1625000
NODE_6320_length_1015_cov_22.544760	490	570	6	67	80	0.8375000
NODE_6320_length_1015_cov_22.544760	543	623	0	47	80	0.5875000
NODE_6320_length_1015_cov_22.544760	543	623	6	33	80	0.4125000
NODE_6321_length_1015_cov_17.994541	510	590	0	80	80	1.0000000
NODE_6321_length_1015_cov_17.994541	563	643	0	36	80	0.4500000
NODE_6321_length_1015_cov_17.994541	563	643	4	27	80	0.3375000
NODE_6321_length_1015_cov_17.994541	563	643	8	17	80	0.2125000
NODE_6322_length_1015_cov_16.594978	437	517	0	21	80	0.2625000
NODE_6322_length_1015_cov_16.594978	437	517	2	27	80	0.3375000
NODE_6322_length_1015_cov_16.594978	437	517	4	32	80	0.4000000
NODE_6322_length_1015_cov_16.594978	490	570	0	8	80	0.1000000
NODE_6322_length_1015_cov_16.594978	490	570	2	32	80	0.4000000
NODE_6322_length_1015_cov_16.594978	490	570	4	40	80	0.5000000
NODE_6323_length_1015_cov_14.000000	505	585	0	54	80	0.6750000
NODE_6323_length_1015_cov_14.000000	505	585	1	9	80	0.1125000
NODE_6323_length_1015_cov_14.000000	505	585	2	17	80	0.2125000
NODE_6323_length_1015_cov_14.000000	558	638	0	80	80	1.0000000
NODE_6324_length_1015_cov_9.978166	345	425	0	18	80	0.2250000
NODE_6324_length_1015_cov_9.978166	345	425	2	62	80	0.7750000
NODE_6324_length_1015_cov_9.978166	398	478	0	53	80	0.6625000
NODE_6324_length_1015_cov_9.978166	398	478	2	27	80	0.3375000
NODE_6325_length_1015_cov_6.844978	393	473	6	33	80	0.4125000
NODE_6325_length_1015_cov_6.844978	393	473	8	25	80	0.3125000
NODE_6325_length_1015_cov_6.844978	393	473	10	22	80	0.2750000
NODE_6325_length_1015_cov_6.844978	446	526	2	27	80	0.3375000
NODE_6325_length_1015_cov_6.844978	446	526	4	13	80	0.1625000
NODE_6325_length_1015_cov_6.844978	446	526	6	12	80	0.1500000
NODE_6325_length_1015_cov_6.844978	446	526	8	14	80	0.1750000
NODE_6325_length_1015_cov_6.844978	446	526	9	1	80	0.0125000
NODE_6325_length_1015_cov_6.844978	446	526	10	13	80	0.1625000
NODE_6337_length_1014_cov_95.709290	259	335	0	76	76	1.0000000
NODE_6337_length_1014_cov_95.709290	310	390	0	80	80	1.0000000
NODE_6337_length_1014_cov_95.709290	386	466	0	80	80	1.0000000
NODE_6337_length_1014_cov_95.709290	439	519	0	80	80	1.0000000
NODE_6338_length_1014_cov_67.918033	182	262	0	12	80	0.1500000
NODE_6338_length_1014_cov_67.918033	182	262	2	68	80	0.8500000
NODE_6338_length_1014_cov_67.918033	235	315	0	65	80	0.8125000
NODE_6338_length_1014_cov_67.918033	235	315	2	15	80	0.1875000
NODE_6338_length_1014_cov_67.918033	311	391	0	80	80	1.0000000
NODE_6338_length_1014_cov_67.918033	364	444	0	80	80	1.0000000
NODE_6339_length_1014_cov_44.802186	418	498	0	80	80	1.0000000
NODE_6339_length_1014_cov_44.802186	471	551	0	80	80	1.0000000
NODE_6340_length_1014_cov_36.349727	369	449	0	80	80	1.0000000
NODE_6340_length_1014_cov_36.349727	422	502	0	41	80	0.5125000
NODE_6340_length_1014_cov_36.349727	422	502	4	3	80	0.0375000
NODE_6340_length_1014_cov_36.349727	422	502	11	1	80	0.0125000
NODE_6340_length_1014_cov_36.349727	422	502	12	16	80	0.2000000
NODE_6340_length_1014_cov_36.349727	422	502	16	19	80	0.2375000
NODE_6340_length_1014_cov_36.349727	498	578	8	13	80	0.1625000
NODE_6340_length_1014_cov_36.349727	498	578	16	67	80	0.8375000
NODE_6340_length_1014_cov_36.349727	551	631	0	50	80	0.6250000
NODE_6340_length_1014_cov_36.349727	551	631	8	16	80	0.2000000
NODE_6340_length_1014_cov_36.349727	551	631	16	14	80	0.1750000
NODE_6341_length_1014_cov_35.547541	363	441	0	78	78	1.0000000
NODE_6341_length_1014_cov_35.547541	416	494	0	78	78	1.0000000
NODE_6342_length_1014_cov_32.266667	428	508	0	80	80	1.0000000
NODE_6342_length_1014_cov_32.266667	481	561	0	80	80	1.0000000
NODE_6343_length_1014_cov_28.493989	480	560	0	80	80	1.0000000
NODE_6343_length_1014_cov_28.493989	533	613	0	80	80	1.0000000
NODE_6343_length_1014_cov_28.493989	609	689	0	32	80	0.4000000
NODE_6343_length_1014_cov_28.493989	609	689	2	12	80	0.1500000
NODE_6343_length_1014_cov_28.493989	609	689	4	36	80	0.4500000
NODE_6343_length_1014_cov_28.493989	662	742	2	33	80	0.4125000
NODE_6343_length_1014_cov_28.493989	662	742	4	47	80	0.5875000
NODE_6344_length_1014_cov_25.171585	500	580	0	80	80	1.0000000
NODE_6344_length_1014_cov_25.171585	553	633	0	80	80	1.0000000
NODE_6345_length_1014_cov_22.437158	534	614	0	80	80	1.0000000
NODE_6345_length_1014_cov_22.437158	587	667	0	80	80	1.0000000
NODE_6346_length_1014_cov_19.238251	379	459	0	80	80	1.0000000
NODE_6346_length_1014_cov_19.238251	432	512	0	80	80	1.0000000
NODE_6346_length_1014_cov_19.238251	508	585	0	77	77	1.0000000
NODE_6346_length_1014_cov_19.238251	558	638	0	38	80	0.4750000
NODE_6346_length_1014_cov_19.238251	558	638	4	42	80	0.5250000
NODE_6347_length_1014_cov_15.926776	594	674	0	80	80	1.0000000
NODE_6347_length_1014_cov_15.926776	647	727	0	80	80	1.0000000
NODE_6348_length_1014_cov_8.691803	285	365	0	20	80	0.2500000
NODE_6348_length_1014_cov_8.691803	285	365	2	1	80	0.0125000
NODE_6348_length_1014_cov_8.691803	285	365	4	59	80	0.7375000
NODE_6348_length_1014_cov_8.691803	338	418	4	80	80	1.0000000
NODE_6349_length_1014_cov_7.959563	531	611	0	80	80	1.0000000
NODE_6349_length_1014_cov_7.959563	584	664	0	80	80	1.0000000
NODE_6351_length_1014_cov_7.608743	298	378	0	80	80	1.0000000
NODE_6351_length_1014_cov_7.608743	351	431	0	80	80	1.0000000
NODE_6352_length_1014_cov_6.209836	321	401	0	80	80	1.0000000
NODE_6352_length_1014_cov_6.209836	374	454	0	27	80	0.3375000
NODE_6352_length_1014_cov_6.209836	374	454	2	7	80	0.0875000
NODE_6352_length_1014_cov_6.209836	374	454	4	35	80	0.4375000
NODE_6352_length_1014_cov_6.209836	374	454	6	11	80	0.1375000
NODE_6364_length_1013_cov_32.695842	423	503	0	30	80	0.3750000
NODE_6364_length_1013_cov_32.695842	423	503	2	19	80	0.2375000
NODE_6364_length_1013_cov_32.695842	423	503	4	31	80	0.3875000
NODE_6364_length_1013_cov_32.695842	476	556	4	61	80	0.7625000
NODE_6364_length_1013_cov_32.695842	476	556	6	19	80	0.2375000
NODE_6364_length_1013_cov_32.695842	552	632	2	61	80	0.7625000
NODE_6364_length_1013_cov_32.695842	552	632	4	19	80	0.2375000
NODE_6364_length_1013_cov_32.695842	605	685	2	78	80	0.9750000
NODE_6364_length_1013_cov_32.695842	605	685	4	2	80	0.0250000
NODE_6365_length_1013_cov_21.935449	424	503	0	79	79	1.0000000
NODE_6365_length_1013_cov_21.935449	476	556	0	80	80	1.0000000
NODE_6366_length_1013_cov_17.532823	440	520	0	9	80	0.1125000
NODE_6366_length_1013_cov_17.532823	440	520	4	71	80	0.8875000
NODE_6366_length_1013_cov_17.532823	493	573	2	42	80	0.5250000
NODE_6366_length_1013_cov_17.532823	493	573	4	32	80	0.4000000
NODE_6366_length_1013_cov_17.532823	493	573	6	6	80	0.0750000
NODE_6367_length_1013_cov_14.555799	478	558	0	80	80	1.0000000
NODE_6367_length_1013_cov_14.555799	531	611	0	80	80	1.0000000
NODE_6368_length_1013_cov_13.142232	476	556	0	11	80	0.1375000
NODE_6368_length_1013_cov_13.142232	476	556	4	69	80	0.8625000
NODE_6368_length_1013_cov_13.142232	529	609	0	64	80	0.8000000
NODE_6368_length_1013_cov_13.142232	529	609	4	16	80	0.2000000
NODE_6369_length_1013_cov_7.756018	538	618	0	80	80	1.0000000
NODE_6369_length_1013_cov_7.756018	591	671	0	80	80	1.0000000
NODE_6371_length_1013_cov_4.368709	550	630	0	80	80	1.0000000
NODE_6371_length_1013_cov_4.368709	603	683	0	80	80	1.0000000
NODE_6380_length_1012_cov_91.547645	378	458	0	80	80	1.0000000
NODE_6380_length_1012_cov_91.547645	431	511	0	80	80	1.0000000
NODE_6380_length_1012_cov_91.547645	507	587	0	80	80	1.0000000
NODE_6380_length_1012_cov_91.547645	560	640	0	80	80	1.0000000
NODE_6381_length_1012_cov_64.409639	345	425	0	80	80	1.0000000
NODE_6381_length_1012_cov_64.409639	398	478	0	80	80	1.0000000
NODE_6382_length_1012_cov_63.035049	438	518	6	39	80	0.4875000
NODE_6382_length_1012_cov_63.035049	438	518	8	41	80	0.5125000
NODE_6382_length_1012_cov_63.035049	491	571	2	26	80	0.3250000
NODE_6382_length_1012_cov_63.035049	491	571	4	20	80	0.2500000
NODE_6382_length_1012_cov_63.035049	491	571	8	34	80	0.4250000
NODE_6383_length_1012_cov_53.686747	276	356	0	46	80	0.5750000
NODE_6383_length_1012_cov_53.686747	276	356	1	10	80	0.1250000
NODE_6383_length_1012_cov_53.686747	276	356	2	24	80	0.3000000
NODE_6383_length_1012_cov_53.686747	329	409	0	80	80	1.0000000
NODE_6383_length_1012_cov_53.686747	405	485	0	80	80	1.0000000
NODE_6383_length_1012_cov_53.686747	458	538	0	80	80	1.0000000
NODE_6384_length_1012_cov_35.861993	453	533	0	80	80	1.0000000
NODE_6384_length_1012_cov_35.861993	506	581	0	75	75	1.0000000
NODE_6385_length_1012_cov_16.125958	510	590	4	59	80	0.7375000
NODE_6385_length_1012_cov_16.125958	510	590	6	3	80	0.0375000
NODE_6385_length_1012_cov_16.125958	510	590	8	12	80	0.1500000
NODE_6385_length_1012_cov_16.125958	510	590	12	6	80	0.0750000
NODE_6385_length_1012_cov_16.125958	563	643	4	6	80	0.0750000
NODE_6385_length_1012_cov_16.125958	563	643	6	3	80	0.0375000
NODE_6385_length_1012_cov_16.125958	563	643	8	49	80	0.6125000
NODE_6385_length_1012_cov_16.125958	563	643	12	22	80	0.2750000
NODE_6386_length_1012_cov_15.395400	501	581	0	4	80	0.0500000
NODE_6386_length_1012_cov_15.395400	501	581	2	2	80	0.0250000
NODE_6386_length_1012_cov_15.395400	501	581	4	61	80	0.7625000
NODE_6386_length_1012_cov_15.395400	501	581	6	13	80	0.1625000
NODE_6386_length_1012_cov_15.395400	554	634	4	38	80	0.4750000
NODE_6386_length_1012_cov_15.395400	554	634	6	42	80	0.5250000
NODE_6388_length_1012_cov_6.409639	528	608	0	80	80	1.0000000
NODE_6388_length_1012_cov_6.409639	581	661	0	80	80	1.0000000
NODE_6398_length_1011_cov_53.032895	515	595	0	12	80	0.1500000
NODE_6398_length_1011_cov_53.032895	515	595	2	39	80	0.4875000
NODE_6398_length_1011_cov_53.032895	515	595	10	29	80	0.3625000
NODE_6398_length_1011_cov_53.032895	568	648	8	27	80	0.3375000
NODE_6398_length_1011_cov_53.032895	568	648	10	53	80	0.6625000
NODE_6399_length_1011_cov_25.838816	366	446	0	15	80	0.1875000
NODE_6399_length_1011_cov_25.838816	366	446	2	65	80	0.8125000
NODE_6399_length_1011_cov_25.838816	419	499	0	17	80	0.2125000
NODE_6399_length_1011_cov_25.838816	419	499	2	63	80	0.7875000
NODE_6400_length_1011_cov_22.734649	426	506	0	80	80	1.0000000
NODE_6400_length_1011_cov_22.734649	479	559	0	80	80	1.0000000
NODE_6400_length_1011_cov_22.734649	555	636	0	81	81	1.0000000
NODE_6400_length_1011_cov_22.734649	609	689	0	80	80	1.0000000
NODE_6401_length_1011_cov_18.127193	389	469	2	80	80	1.0000000
NODE_6401_length_1011_cov_18.127193	442	520	0	43	78	0.5512820
NODE_6401_length_1011_cov_18.127193	442	520	2	35	78	0.4487180
NODE_6401_length_1011_cov_18.127193	516	596	0	80	80	1.0000000
NODE_6401_length_1011_cov_18.127193	569	649	0	80	80	1.0000000
NODE_6402_length_1011_cov_12.709430	309	389	0	9	80	0.1125000
NODE_6402_length_1011_cov_12.709430	309	389	4	71	80	0.8875000
NODE_6402_length_1011_cov_12.709430	362	442	0	30	80	0.3750000
NODE_6402_length_1011_cov_12.709430	362	442	4	50	80	0.6250000
NODE_6403_length_1011_cov_8.731360	441	521	0	23	80	0.2875000
NODE_6403_length_1011_cov_8.731360	441	521	2	57	80	0.7125000
NODE_6403_length_1011_cov_8.731360	494	574	0	76	80	0.9500000
NODE_6403_length_1011_cov_8.731360	494	574	2	4	80	0.0500000
NODE_6405_length_1011_cov_7.212719	219	299	0	80	80	1.0000000
NODE_6408_length_1011_cov_3.569079	173	253	0	80	80	1.0000000
NODE_6408_length_1011_cov_3.569079	226	306	0	80	80	1.0000000
NODE_6409_length_1011_cov_1.703947	779	851	2	1	72	0.0138889
NODE_6409_length_1011_cov_1.703947	779	851	6	4	72	0.0555556
NODE_6409_length_1011_cov_1.703947	779	851	8	7	72	0.0972222
NODE_6409_length_1011_cov_1.703947	779	851	10	10	72	0.1388889
NODE_6409_length_1011_cov_1.703947	779	851	12	2	72	0.0277778
NODE_6409_length_1011_cov_1.703947	779	851	16	3	72	0.0416667
NODE_6409_length_1011_cov_1.703947	779	851	18	11	72	0.1527778
NODE_6409_length_1011_cov_1.703947	779	851	20	1	72	0.0138889
NODE_6409_length_1011_cov_1.703947	779	851	22	6	72	0.0833333
NODE_6409_length_1011_cov_1.703947	779	851	24	6	72	0.0833333
NODE_6409_length_1011_cov_1.703947	779	851	25	4	72	0.0555556
NODE_6409_length_1011_cov_1.703947	779	851	28	4	72	0.0555556
NODE_6409_length_1011_cov_1.703947	779	851	30	6	72	0.0833333
NODE_6409_length_1011_cov_1.703947	779	851	32	4	72	0.0555556
NODE_6409_length_1011_cov_1.703947	779	851	38	3	72	0.0416667
NODE_6416_length_1010_cov_51.841932	335	415	0	80	80	1.0000000
NODE_6416_length_1010_cov_51.841932	388	468	0	80	80	1.0000000
NODE_6417_length_1010_cov_35.860593	576	656	0	13	80	0.1625000
NODE_6417_length_1010_cov_35.860593	576	656	2	67	80	0.8375000
NODE_6417_length_1010_cov_35.860593	629	709	0	66	80	0.8250000
NODE_6417_length_1010_cov_35.860593	629	709	2	14	80	0.1750000
NODE_6418_length_1010_cov_30.043908	509	589	0	80	80	1.0000000
NODE_6418_length_1010_cov_30.043908	562	642	0	80	80	1.0000000
NODE_6418_length_1010_cov_30.043908	638	718	0	80	80	1.0000000
NODE_6418_length_1010_cov_30.043908	691	771	0	80	80	1.0000000
NODE_6420_length_1010_cov_15.156970	364	444	0	80	80	1.0000000
NODE_6420_length_1010_cov_15.156970	417	497	0	80	80	1.0000000
NODE_6421_length_1010_cov_13.546652	385	465	0	9	80	0.1125000
NODE_6421_length_1010_cov_13.546652	385	465	2	46	80	0.5750000
NODE_6421_length_1010_cov_13.546652	385	465	4	25	80	0.3125000
NODE_6421_length_1010_cov_13.546652	438	518	2	9	80	0.1125000
NODE_6421_length_1010_cov_13.546652	438	518	4	71	80	0.8875000
NODE_6422_length_1010_cov_13.317234	480	560	0	80	80	1.0000000
NODE_6422_length_1010_cov_13.317234	533	613	0	80	80	1.0000000
NODE_6423_length_1010_cov_12.900110	427	507	0	80	80	1.0000000
NODE_6423_length_1010_cov_12.900110	480	560	0	80	80	1.0000000
NODE_6424_length_1010_cov_11.423710	631	711	2	80	80	1.0000000
NODE_6424_length_1010_cov_11.423710	684	764	0	11	80	0.1375000
NODE_6424_length_1010_cov_11.423710	684	764	1	14	80	0.1750000
NODE_6424_length_1010_cov_11.423710	684	764	2	55	80	0.6875000
NODE_6425_length_1010_cov_11.256861	492	572	0	28	80	0.3500000
NODE_6425_length_1010_cov_11.256861	492	572	4	52	80	0.6500000
NODE_6425_length_1010_cov_11.256861	545	625	4	80	80	1.0000000
NODE_6426_length_1010_cov_11.000000	455	535	0	80	80	1.0000000
NODE_6426_length_1010_cov_11.000000	508	588	0	80	80	1.0000000
NODE_6428_length_1010_cov_4.990121	476	556	2	2	80	0.0250000
NODE_6428_length_1010_cov_4.990121	476	556	4	23	80	0.2875000
NODE_6428_length_1010_cov_4.990121	476	556	5	23	80	0.2875000
NODE_6428_length_1010_cov_4.990121	476	556	6	32	80	0.4000000
NODE_6428_length_1010_cov_4.990121	529	609	0	22	80	0.2750000
NODE_6428_length_1010_cov_4.990121	529	609	4	54	80	0.6750000
NODE_6428_length_1010_cov_4.990121	529	609	5	4	80	0.0500000
NODE_6430_length_1010_cov_4.892426	476	556	0	80	80	1.0000000
NODE_6430_length_1010_cov_4.892426	529	609	0	80	80	1.0000000
NODE_6431_length_1010_cov_3.624588	157	196	0	39	39	1.0000000
NODE_6435_length_1010_cov_1.440176	1	58	0	57	57	1.0000000
NODE_6436_length_1009_cov_44.626374	288	362	0	74	74	1.0000000
NODE_6436_length_1009_cov_44.626374	335	415	0	80	80	1.0000000
NODE_6436_length_1009_cov_44.626374	411	491	0	80	80	1.0000000
NODE_6436_length_1009_cov_44.626374	464	544	0	80	80	1.0000000
NODE_6437_length_1009_cov_31.828571	412	492	0	25	80	0.3125000
NODE_6437_length_1009_cov_31.828571	412	492	2	14	80	0.1750000
NODE_6437_length_1009_cov_31.828571	412	492	4	41	80	0.5125000
NODE_6437_length_1009_cov_31.828571	465	545	0	5	80	0.0625000
NODE_6437_length_1009_cov_31.828571	465	545	2	41	80	0.5125000
NODE_6437_length_1009_cov_31.828571	465	545	4	34	80	0.4250000
NODE_6438_length_1009_cov_28.539560	571	651	0	80	80	1.0000000
NODE_6438_length_1009_cov_28.539560	624	704	0	80	80	1.0000000
NODE_6439_length_1009_cov_20.281319	577	657	2	6	80	0.0750000
NODE_6439_length_1009_cov_20.281319	577	657	4	34	80	0.4250000
NODE_6439_length_1009_cov_20.281319	577	657	8	6	80	0.0750000
NODE_6439_length_1009_cov_20.281319	577	657	16	34	80	0.4250000
NODE_6439_length_1009_cov_20.281319	630	710	12	36	80	0.4500000
NODE_6439_length_1009_cov_20.281319	630	710	14	11	80	0.1375000
NODE_6439_length_1009_cov_20.281319	630	710	16	33	80	0.4125000
NODE_6440_length_1009_cov_18.649451	430	510	0	51	80	0.6375000
NODE_6440_length_1009_cov_18.649451	430	510	2	29	80	0.3625000
NODE_6440_length_1009_cov_18.649451	483	563	0	80	80	1.0000000
NODE_6442_length_1009_cov_3.767033	647	727	0	28	80	0.3500000
NODE_6442_length_1009_cov_3.767033	647	727	2	52	80	0.6500000
NODE_6442_length_1009_cov_3.767033	700	780	0	80	80	1.0000000
NODE_6443_length_1009_cov_2.903297	36	63	0	27	27	1.0000000
NODE_6451_length_1008_cov_44.825083	399	479	0	80	80	1.0000000
NODE_6451_length_1008_cov_44.825083	452	532	0	80	80	1.0000000
NODE_6452_length_1008_cov_41.030803	280	360	0	80	80	1.0000000
NODE_6452_length_1008_cov_41.030803	333	413	0	80	80	1.0000000
NODE_6452_length_1008_cov_41.030803	409	489	0	80	80	1.0000000
NODE_6452_length_1008_cov_41.030803	462	542	0	80	80	1.0000000
NODE_6453_length_1008_cov_39.377338	311	391	0	9	80	0.1125000
NODE_6453_length_1008_cov_39.377338	311	391	2	71	80	0.8875000
NODE_6453_length_1008_cov_39.377338	364	444	0	23	80	0.2875000
NODE_6453_length_1008_cov_39.377338	364	444	2	57	80	0.7125000
NODE_6453_length_1008_cov_39.377338	440	520	0	80	80	1.0000000
NODE_6453_length_1008_cov_39.377338	493	573	0	43	80	0.5375000
NODE_6453_length_1008_cov_39.377338	493	573	2	37	80	0.4625000
NODE_6454_length_1008_cov_27.836084	405	485	4	10	80	0.1250000
NODE_6454_length_1008_cov_27.836084	405	485	8	70	80	0.8750000
NODE_6454_length_1008_cov_27.836084	458	538	0	35	80	0.4375000
NODE_6454_length_1008_cov_27.836084	458	538	4	28	80	0.3500000
NODE_6454_length_1008_cov_27.836084	458	538	8	17	80	0.2125000
NODE_6454_length_1008_cov_27.836084	534	614	0	80	80	1.0000000
NODE_6454_length_1008_cov_27.836084	587	667	0	49	80	0.6125000
NODE_6454_length_1008_cov_27.836084	587	667	2	31	80	0.3875000
NODE_6455_length_1008_cov_24.741474	485	565	2	68	80	0.8500000
NODE_6455_length_1008_cov_24.741474	485	565	4	12	80	0.1500000
NODE_6455_length_1008_cov_24.741474	538	618	2	68	80	0.8500000
NODE_6455_length_1008_cov_24.741474	538	618	4	12	80	0.1500000
NODE_6456_length_1008_cov_20.278328	401	481	2	8	80	0.1000000
NODE_6456_length_1008_cov_20.278328	401	481	4	6	80	0.0750000
NODE_6456_length_1008_cov_20.278328	401	481	6	66	80	0.8250000
NODE_6456_length_1008_cov_20.278328	454	534	0	48	80	0.6000000
NODE_6456_length_1008_cov_20.278328	454	534	2	13	80	0.1625000
NODE_6456_length_1008_cov_20.278328	454	534	4	6	80	0.0750000
NODE_6456_length_1008_cov_20.278328	454	534	6	13	80	0.1625000
NODE_6457_length_1008_cov_6.071507	460	540	0	43	80	0.5375000
NODE_6457_length_1008_cov_6.071507	460	540	3	1	80	0.0125000
NODE_6457_length_1008_cov_6.071507	460	540	4	36	80	0.4500000
NODE_6457_length_1008_cov_6.071507	513	593	0	3	80	0.0375000
NODE_6457_length_1008_cov_6.071507	513	593	4	77	80	0.9625000
NODE_6466_length_1008_cov_1.798680	0	64	0	64	64	1.0000000
NODE_6466_length_1008_cov_1.798680	37	104	0	67	67	1.0000000
NODE_6473_length_1007_cov_27.011013	294	371	2	8	77	0.1038961
NODE_6473_length_1007_cov_27.011013	294	371	4	17	77	0.2207792
NODE_6473_length_1007_cov_27.011013	294	371	6	1	77	0.0129870
NODE_6473_length_1007_cov_27.011013	294	371	7	1	77	0.0129870
NODE_6473_length_1007_cov_27.011013	294	371	8	1	77	0.0129870
NODE_6473_length_1007_cov_27.011013	294	371	12	6	77	0.0779221
NODE_6473_length_1007_cov_27.011013	294	371	14	43	77	0.5584416
NODE_6473_length_1007_cov_27.011013	347	424	2	6	77	0.0779221
NODE_6473_length_1007_cov_27.011013	347	424	8	1	77	0.0129870
NODE_6473_length_1007_cov_27.011013	347	424	10	1	77	0.0129870
NODE_6473_length_1007_cov_27.011013	347	424	12	30	77	0.3896104
NODE_6473_length_1007_cov_27.011013	347	424	14	39	77	0.5064935
NODE_6474_length_1007_cov_24.668502	369	449	0	80	80	1.0000000
NODE_6474_length_1007_cov_24.668502	422	502	0	80	80	1.0000000
NODE_6474_length_1007_cov_24.668502	498	578	0	80	80	1.0000000
NODE_6474_length_1007_cov_24.668502	551	631	0	80	80	1.0000000
NODE_6475_length_1007_cov_21.729075	454	534	0	40	80	0.5000000
NODE_6475_length_1007_cov_21.729075	454	534	2	8	80	0.1000000
NODE_6475_length_1007_cov_21.729075	454	534	6	8	80	0.1000000
NODE_6475_length_1007_cov_21.729075	454	534	8	24	80	0.3000000
NODE_6475_length_1007_cov_21.729075	507	587	6	10	80	0.1250000
NODE_6475_length_1007_cov_21.729075	507	587	8	70	80	0.8750000
NODE_6475_length_1007_cov_21.729075	583	663	0	35	80	0.4375000
NODE_6475_length_1007_cov_21.729075	583	663	2	24	80	0.3000000
NODE_6475_length_1007_cov_21.729075	583	663	6	21	80	0.2625000
NODE_6475_length_1007_cov_21.729075	636	716	0	80	80	1.0000000
NODE_6476_length_1007_cov_14.515419	400	480	2	15	80	0.1875000
NODE_6476_length_1007_cov_14.515419	400	480	3	1	80	0.0125000
NODE_6476_length_1007_cov_14.515419	400	480	4	64	80	0.8000000
NODE_6476_length_1007_cov_14.515419	453	533	0	4	80	0.0500000
NODE_6476_length_1007_cov_14.515419	453	533	2	64	80	0.8000000
NODE_6476_length_1007_cov_14.515419	453	533	3	1	80	0.0125000
NODE_6476_length_1007_cov_14.515419	453	533	4	11	80	0.1375000
NODE_6477_length_1007_cov_13.685022	376	456	0	80	80	1.0000000
NODE_6477_length_1007_cov_13.685022	429	509	0	80	80	1.0000000
NODE_6478_length_1007_cov_9.189427	438	518	0	18	80	0.2250000
NODE_6478_length_1007_cov_9.189427	438	518	2	62	80	0.7750000
NODE_6478_length_1007_cov_9.189427	491	571	0	31	80	0.3875000
NODE_6478_length_1007_cov_9.189427	491	571	2	49	80	0.6125000
NODE_6491_length_1006_cov_59.773980	379	459	0	34	80	0.4250000
NODE_6491_length_1006_cov_59.773980	379	459	2	46	80	0.5750000
NODE_6491_length_1006_cov_59.773980	432	512	0	18	80	0.2250000
NODE_6491_length_1006_cov_59.773980	432	512	2	62	80	0.7750000
NODE_6491_length_1006_cov_59.773980	508	588	0	80	80	1.0000000
NODE_6491_length_1006_cov_59.773980	561	641	0	32	80	0.4000000
NODE_6491_length_1006_cov_59.773980	561	641	4	11	80	0.1375000
NODE_6491_length_1006_cov_59.773980	561	641	6	37	80	0.4625000
NODE_6492_length_1006_cov_34.762955	482	562	0	11	80	0.1375000
NODE_6492_length_1006_cov_34.762955	482	562	2	69	80	0.8625000
NODE_6492_length_1006_cov_34.762955	535	615	0	8	80	0.1000000
NODE_6492_length_1006_cov_34.762955	535	615	2	72	80	0.9000000
NODE_6493_length_1006_cov_21.776185	516	596	0	80	80	1.0000000
NODE_6493_length_1006_cov_21.776185	569	649	0	80	80	1.0000000
NODE_6494_length_1006_cov_19.690187	371	451	0	12	80	0.1500000
NODE_6494_length_1006_cov_19.690187	371	451	2	68	80	0.8500000
NODE_6494_length_1006_cov_19.690187	424	504	0	65	80	0.8125000
NODE_6494_length_1006_cov_19.690187	424	504	2	15	80	0.1875000
NODE_6495_length_1006_cov_19.299890	495	575	0	80	80	1.0000000
NODE_6495_length_1006_cov_19.299890	548	628	0	80	80	1.0000000
NODE_6496_length_1006_cov_13.187431	245	325	0	80	80	1.0000000
NODE_6496_length_1006_cov_13.187431	298	378	0	29	80	0.3625000
NODE_6496_length_1006_cov_13.187431	298	378	2	12	80	0.1500000
NODE_6496_length_1006_cov_13.187431	298	378	4	39	80	0.4875000
NODE_6497_length_1006_cov_12.862183	383	463	0	49	80	0.6125000
NODE_6497_length_1006_cov_12.862183	383	463	4	31	80	0.3875000
NODE_6497_length_1006_cov_12.862183	436	516	4	80	80	1.0000000
NODE_6498_length_1006_cov_10.986770	762	842	0	80	80	1.0000000
NODE_6498_length_1006_cov_10.986770	815	895	0	80	80	1.0000000
NODE_6499_length_1006_cov_8.633958	314	394	0	4	80	0.0500000
NODE_6499_length_1006_cov_8.633958	314	394	2	76	80	0.9500000
NODE_6499_length_1006_cov_8.633958	367	447	0	57	80	0.7125000
NODE_6499_length_1006_cov_8.633958	367	447	2	23	80	0.2875000
NODE_6515_length_1005_cov_80.271523	509	589	0	8	80	0.1000000
NODE_6515_length_1005_cov_80.271523	509	589	2	21	80	0.2625000
NODE_6515_length_1005_cov_80.271523	509	589	6	51	80	0.6375000
NODE_6515_length_1005_cov_80.271523	562	642	0	5	80	0.0625000
NODE_6515_length_1005_cov_80.271523	562	642	3	1	80	0.0125000
NODE_6515_length_1005_cov_80.271523	562	642	4	31	80	0.3875000
NODE_6515_length_1005_cov_80.271523	562	642	6	43	80	0.5375000
NODE_6516_length_1005_cov_45.008830	357	437	0	61	80	0.7625000
NODE_6516_length_1005_cov_45.008830	357	437	2	19	80	0.2375000
NODE_6516_length_1005_cov_45.008830	410	490	0	8	80	0.1000000
NODE_6516_length_1005_cov_45.008830	410	490	2	72	80	0.9000000
NODE_6517_length_1005_cov_36.636865	567	647	0	39	80	0.4875000
NODE_6517_length_1005_cov_36.636865	567	647	2	41	80	0.5125000
NODE_6517_length_1005_cov_36.636865	620	700	0	31	80	0.3875000
NODE_6517_length_1005_cov_36.636865	620	700	2	49	80	0.6125000
NODE_6518_length_1005_cov_21.222958	389	409	4	20	20	1.0000000
NODE_6518_length_1005_cov_21.222958	451	519	0	68	68	1.0000000
NODE_6518_length_1005_cov_21.222958	515	595	0	80	80	1.0000000
NODE_6518_length_1005_cov_21.222958	568	648	0	80	80	1.0000000
NODE_6520_length_1005_cov_14.278146	480	560	0	27	80	0.3375000
NODE_6520_length_1005_cov_14.278146	480	560	2	53	80	0.6625000
NODE_6520_length_1005_cov_14.278146	533	613	0	11	80	0.1375000
NODE_6520_length_1005_cov_14.278146	533	613	2	69	80	0.8625000
NODE_6521_length_1005_cov_13.215232	511	591	0	80	80	1.0000000
NODE_6521_length_1005_cov_13.215232	564	644	0	80	80	1.0000000
NODE_6523_length_1005_cov_5.579470	534	614	2	80	80	1.0000000
NODE_6523_length_1005_cov_5.579470	587	667	0	20	80	0.2500000
NODE_6523_length_1005_cov_5.579470	587	667	2	60	80	0.7500000
NODE_6536_length_1004_cov_45.470718	343	423	0	80	80	1.0000000
NODE_6536_length_1004_cov_45.470718	396	476	0	80	80	1.0000000
NODE_6536_length_1004_cov_45.470718	472	552	0	75	80	0.9375000
NODE_6536_length_1004_cov_45.470718	472	552	2	5	80	0.0625000
NODE_6536_length_1004_cov_45.470718	525	605	0	22	80	0.2750000
NODE_6536_length_1004_cov_45.470718	525	605	2	58	80	0.7250000
NODE_6537_length_1004_cov_34.565746	419	499	5	13	80	0.1625000
NODE_6537_length_1004_cov_34.565746	419	499	9	51	80	0.6375000
NODE_6537_length_1004_cov_34.565746	419	499	10	16	80	0.2000000
NODE_6537_length_1004_cov_34.565746	472	552	8	20	80	0.2500000
NODE_6537_length_1004_cov_34.565746	472	552	9	60	80	0.7500000
NODE_6538_length_1004_cov_28.710497	385	465	0	10	80	0.1250000
NODE_6538_length_1004_cov_28.710497	385	465	2	48	80	0.6000000
NODE_6538_length_1004_cov_28.710497	385	465	4	22	80	0.2750000
NODE_6538_length_1004_cov_28.710497	438	518	0	63	80	0.7875000
NODE_6538_length_1004_cov_28.710497	438	518	2	17	80	0.2125000
NODE_6538_length_1004_cov_28.710497	514	594	0	80	80	1.0000000
NODE_6538_length_1004_cov_28.710497	567	647	0	80	80	1.0000000
NODE_6539_length_1004_cov_12.745856	432	512	0	80	80	1.0000000
NODE_6539_length_1004_cov_12.745856	485	565	0	80	80	1.0000000
NODE_6550_length_1003_cov_47.014381	383	463	0	80	80	1.0000000
NODE_6550_length_1003_cov_47.014381	436	516	0	80	80	1.0000000
NODE_6550_length_1003_cov_47.014381	512	592	0	80	80	1.0000000
NODE_6550_length_1003_cov_47.014381	565	645	0	80	80	1.0000000
NODE_6551_length_1003_cov_35.329646	372	452	2	80	80	1.0000000
NODE_6551_length_1003_cov_35.329646	425	505	0	45	80	0.5625000
NODE_6551_length_1003_cov_35.329646	425	505	2	35	80	0.4375000
NODE_6552_length_1003_cov_32.721239	357	437	0	80	80	1.0000000
NODE_6552_length_1003_cov_32.721239	410	490	0	80	80	1.0000000
NODE_6553_length_1003_cov_23.758850	467	547	0	30	80	0.3750000
NODE_6553_length_1003_cov_23.758850	467	547	2	50	80	0.6250000
NODE_6553_length_1003_cov_23.758850	520	600	2	80	80	1.0000000
NODE_6554_length_1003_cov_19.939159	240	320	0	28	80	0.3500000
NODE_6554_length_1003_cov_19.939159	240	320	2	33	80	0.4125000
NODE_6554_length_1003_cov_19.939159	240	320	3	4	80	0.0500000
NODE_6554_length_1003_cov_19.939159	240	320	4	15	80	0.1875000
NODE_6554_length_1003_cov_19.939159	293	373	2	8	80	0.1000000
NODE_6554_length_1003_cov_19.939159	293	373	3	26	80	0.3250000
NODE_6554_length_1003_cov_19.939159	293	373	4	46	80	0.5750000
NODE_6555_length_1003_cov_16.618363	524	604	0	57	80	0.7125000
NODE_6555_length_1003_cov_16.618363	524	604	2	23	80	0.2875000
NODE_6555_length_1003_cov_16.618363	577	657	0	4	80	0.0500000
NODE_6555_length_1003_cov_16.618363	577	657	2	76	80	0.9500000
NODE_6555_length_1003_cov_16.618363	653	733	0	2	80	0.0250000
NODE_6555_length_1003_cov_16.618363	653	733	2	21	80	0.2625000
NODE_6555_length_1003_cov_16.618363	653	733	4	57	80	0.7125000
NODE_6555_length_1003_cov_16.618363	706	786	0	19	80	0.2375000
NODE_6555_length_1003_cov_16.618363	706	786	4	61	80	0.7625000
NODE_6556_length_1003_cov_13.863938	537	617	0	80	80	1.0000000
NODE_6556_length_1003_cov_13.863938	590	670	0	80	80	1.0000000
NODE_6557_length_1003_cov_12.363938	529	609	0	4	80	0.0500000
NODE_6557_length_1003_cov_12.363938	529	609	3	1	80	0.0125000
NODE_6557_length_1003_cov_12.363938	529	609	4	75	80	0.9375000
NODE_6557_length_1003_cov_12.363938	582	662	0	8	80	0.1000000
NODE_6557_length_1003_cov_12.363938	582	662	2	49	80	0.6125000
NODE_6557_length_1003_cov_12.363938	582	662	4	23	80	0.2875000
NODE_6567_length_1002_cov_65.513843	387	467	0	80	80	1.0000000
NODE_6567_length_1002_cov_65.513843	440	520	0	80	80	1.0000000
NODE_6567_length_1002_cov_65.513843	516	596	0	80	80	1.0000000
NODE_6567_length_1002_cov_65.513843	569	649	0	80	80	1.0000000
NODE_6568_length_1002_cov_41.995570	408	488	0	80	80	1.0000000
NODE_6568_length_1002_cov_41.995570	461	541	0	80	80	1.0000000
NODE_6569_length_1002_cov_19.966777	401	481	0	14	80	0.1750000
NODE_6569_length_1002_cov_19.966777	401	481	2	66	80	0.8250000
NODE_6569_length_1002_cov_19.966777	454	534	0	29	80	0.3625000
NODE_6569_length_1002_cov_19.966777	454	534	2	51	80	0.6375000
NODE_6570_length_1002_cov_19.539313	334	414	0	71	80	0.8875000
NODE_6570_length_1002_cov_19.539313	334	414	6	9	80	0.1125000
NODE_6570_length_1002_cov_19.539313	335	414	0	70	79	0.8860760
NODE_6570_length_1002_cov_19.539313	335	414	6	9	79	0.1139240
NODE_6570_length_1002_cov_19.539313	387	467	0	18	80	0.2250000
NODE_6570_length_1002_cov_19.539313	387	467	6	62	80	0.7750000
NODE_6570_length_1002_cov_19.539313	387	467	0	18	80	0.2250000
NODE_6570_length_1002_cov_19.539313	387	467	6	62	80	0.7750000
NODE_6570_length_1002_cov_19.539313	396	467	0	9	71	0.1267606
NODE_6570_length_1002_cov_19.539313	396	467	6	62	71	0.8732395
NODE_6570_length_1002_cov_19.539313	463	543	0	42	80	0.5250000
NODE_6570_length_1002_cov_19.539313	463	543	6	38	80	0.4750000
NODE_6570_length_1002_cov_19.539313	516	596	0	29	80	0.3625000
NODE_6570_length_1002_cov_19.539313	516	596	4	51	80	0.6375000
NODE_6571_length_1002_cov_17.780731	631	711	0	80	80	1.0000000
NODE_6571_length_1002_cov_17.780731	684	764	0	80	80	1.0000000
NODE_6572_length_1002_cov_17.590255	0	58	0	58	58	1.0000000
NODE_6572_length_1002_cov_17.590255	31	77	0	46	46	1.0000000
NODE_6573_length_1002_cov_17.105205	522	602	0	80	80	1.0000000
NODE_6573_length_1002_cov_17.105205	575	655	0	80	80	1.0000000
NODE_6574_length_1002_cov_11.954596	480	560	0	80	80	1.0000000
NODE_6574_length_1002_cov_11.954596	533	613	0	80	80	1.0000000
NODE_6575_length_1002_cov_11.823920	471	551	0	80	80	1.0000000
NODE_6575_length_1002_cov_11.823920	524	614	0	90	90	1.0000000
NODE_6577_length_1002_cov_6.596899	422	502	0	25	80	0.3125000
NODE_6577_length_1002_cov_6.596899	422	502	2	55	80	0.6875000
NODE_6577_length_1002_cov_6.596899	475	555	2	80	80	1.0000000
NODE_6588_length_1002_cov_2.102990	29	110	0	9	81	0.1111111
NODE_6588_length_1002_cov_2.102990	29	110	2	6	81	0.0740741
NODE_6588_length_1002_cov_2.102990	29	110	4	5	81	0.0617284
NODE_6588_length_1002_cov_2.102990	29	110	6	17	81	0.2098765
NODE_6588_length_1002_cov_2.102990	29	110	8	44	81	0.5432099
NODE_6596_length_1001_cov_41.914634	549	629	0	80	80	1.0000000
NODE_6596_length_1001_cov_41.914634	602	682	0	74	80	0.9250000
NODE_6596_length_1001_cov_41.914634	602	682	2	6	80	0.0750000
NODE_6597_length_1001_cov_30.378049	306	386	0	55	80	0.6875000
NODE_6597_length_1001_cov_30.378049	306	386	2	6	80	0.0750000
NODE_6597_length_1001_cov_30.378049	306	386	3	1	80	0.0125000
NODE_6597_length_1001_cov_30.378049	306	386	4	18	80	0.2250000
NODE_6597_length_1001_cov_30.378049	359	439	0	2	80	0.0250000
NODE_6597_length_1001_cov_30.378049	359	439	2	21	80	0.2625000
NODE_6597_length_1001_cov_30.378049	359	439	3	1	80	0.0125000
NODE_6597_length_1001_cov_30.378049	359	439	4	56	80	0.7000000
NODE_6597_length_1001_cov_30.378049	369	439	2	15	70	0.2142857
NODE_6597_length_1001_cov_30.378049	369	439	4	55	70	0.7857143
NODE_6597_length_1001_cov_30.378049	435	515	0	76	80	0.9500000
NODE_6597_length_1001_cov_30.378049	435	515	2	4	80	0.0500000
NODE_6597_length_1001_cov_30.378049	488	568	0	80	80	1.0000000
NODE_6598_length_1001_cov_22.517738	536	616	0	80	80	1.0000000
NODE_6598_length_1001_cov_22.517738	589	670	0	81	81	1.0000000
NODE_6599_length_1001_cov_17.996674	414	456	0	42	42	1.0000000
NODE_6599_length_1001_cov_17.996674	429	509	0	80	80	1.0000000
NODE_6599_length_1001_cov_17.996674	505	585	0	80	80	1.0000000
NODE_6599_length_1001_cov_17.996674	558	638	0	80	80	1.0000000
NODE_6600_length_1001_cov_16.798226	422	502	0	16	80	0.2000000
NODE_6600_length_1001_cov_16.798226	422	502	2	64	80	0.8000000
NODE_6600_length_1001_cov_16.798226	475	555	0	69	80	0.8625000
NODE_6600_length_1001_cov_16.798226	475	555	2	11	80	0.1375000
NODE_6600_length_1001_cov_16.798226	551	631	0	80	80	1.0000000
NODE_6600_length_1001_cov_16.798226	604	684	0	80	80	1.0000000
NODE_6601_length_1001_cov_12.778271	348	428	0	80	80	1.0000000
NODE_6601_length_1001_cov_12.778271	401	481	0	80	80	1.0000000
NODE_6602_length_1001_cov_12.305987	255	335	0	7	80	0.0875000
NODE_6602_length_1001_cov_12.305987	255	335	2	11	80	0.1375000
NODE_6602_length_1001_cov_12.305987	255	335	6	62	80	0.7750000
NODE_6602_length_1001_cov_12.305987	308	388	0	4	80	0.0500000
NODE_6602_length_1001_cov_12.305987	308	388	4	35	80	0.4375000
NODE_6602_length_1001_cov_12.305987	308	388	6	41	80	0.5125000
NODE_6603_length_1001_cov_11.955654	485	569	2	28	84	0.3333333
NODE_6603_length_1001_cov_11.955654	485	569	4	31	84	0.3690476
NODE_6603_length_1001_cov_11.955654	485	569	6	14	84	0.1666667
NODE_6603_length_1001_cov_11.955654	485	569	8	11	84	0.1309524
NODE_6603_length_1001_cov_11.955654	542	622	2	1	80	0.0125000
NODE_6603_length_1001_cov_11.955654	542	622	3	2	80	0.0250000
NODE_6603_length_1001_cov_11.955654	542	622	4	16	80	0.2000000
NODE_6603_length_1001_cov_11.955654	542	622	6	49	80	0.6125000
NODE_6603_length_1001_cov_11.955654	542	622	8	12	80	0.1500000
NODE_6604_length_1001_cov_10.156319	587	667	0	7	80	0.0875000
NODE_6604_length_1001_cov_10.156319	587	667	2	57	80	0.7125000
NODE_6604_length_1001_cov_10.156319	587	667	6	16	80	0.2000000
NODE_6604_length_1001_cov_10.156319	640	720	0	48	80	0.6000000
NODE_6604_length_1001_cov_10.156319	640	720	2	32	80	0.4000000
NODE_6605_length_1001_cov_9.754989	377	457	2	27	80	0.3375000
NODE_6605_length_1001_cov_9.754989	377	457	6	53	80	0.6625000
NODE_6605_length_1001_cov_9.754989	430	510	0	34	80	0.4250000
NODE_6605_length_1001_cov_9.754989	430	510	2	46	80	0.5750000
NODE_6607_length_1001_cov_4.616408	408	488	0	80	80	1.0000000
NODE_6607_length_1001_cov_4.616408	461	541	0	80	80	1.0000000
NODE_6616_length_1000_cov_55.578246	393	473	0	64	80	0.8000000
NODE_6616_length_1000_cov_55.578246	393	473	2	16	80	0.2000000
NODE_6616_length_1000_cov_55.578246	446	526	0	11	80	0.1375000
NODE_6616_length_1000_cov_55.578246	446	526	2	69	80	0.8625000
NODE_6616_length_1000_cov_55.578246	522	598	0	61	76	0.8026316
NODE_6616_length_1000_cov_55.578246	522	598	2	15	76	0.1973684
NODE_6616_length_1000_cov_55.578246	575	649	0	74	74	1.0000000
NODE_6617_length_1000_cov_51.534961	432	512	4	80	80	1.0000000
NODE_6617_length_1000_cov_51.534961	485	565	0	36	80	0.4500000
NODE_6617_length_1000_cov_51.534961	485	565	4	44	80	0.5500000
NODE_6617_length_1000_cov_51.534961	561	641	4	8	80	0.1000000
NODE_6617_length_1000_cov_51.534961	561	641	7	12	80	0.1500000
NODE_6617_length_1000_cov_51.534961	561	641	8	21	80	0.2625000
NODE_6617_length_1000_cov_51.534961	561	641	9	4	80	0.0500000
NODE_6617_length_1000_cov_51.534961	561	641	11	19	80	0.2375000
NODE_6617_length_1000_cov_51.534961	561	641	12	16	80	0.2000000
NODE_6617_length_1000_cov_51.534961	614	694	2	8	80	0.1000000
NODE_6617_length_1000_cov_51.534961	614	694	6	4	80	0.0500000
NODE_6617_length_1000_cov_51.534961	614	694	8	62	80	0.7750000
NODE_6617_length_1000_cov_51.534961	614	694	12	6	80	0.0750000
NODE_6618_length_1000_cov_39.011099	186	266	0	69	80	0.8625000
NODE_6618_length_1000_cov_39.011099	186	266	2	11	80	0.1375000
NODE_6618_length_1000_cov_39.011099	239	319	0	80	80	1.0000000
NODE_6619_length_1000_cov_19.897891	451	531	0	80	80	1.0000000
NODE_6619_length_1000_cov_19.897891	504	584	0	80	80	1.0000000
NODE_6619_length_1000_cov_19.897891	580	660	0	80	80	1.0000000
NODE_6619_length_1000_cov_19.897891	633	713	0	80	80	1.0000000
NODE_6620_length_1000_cov_13.349612	324	404	0	80	80	1.0000000
NODE_6620_length_1000_cov_13.349612	377	457	0	80	80	1.0000000
NODE_6621_length_1000_cov_11.463929	382	462	0	7	80	0.0875000
NODE_6621_length_1000_cov_11.463929	382	462	2	73	80	0.9125000
NODE_6621_length_1000_cov_11.463929	435	515	0	60	80	0.7500000
NODE_6621_length_1000_cov_11.463929	435	515	2	20	80	0.2500000
NODE_6622_length_1000_cov_9.675916	625	705	0	23	80	0.2875000
NODE_6622_length_1000_cov_9.675916	625	705	2	57	80	0.7125000
NODE_6622_length_1000_cov_9.675916	678	758	0	36	80	0.4500000
NODE_6622_length_1000_cov_9.675916	678	758	2	44	80	0.5500000
NODE_6623_length_1000_cov_7.051054	358	438	0	54	80	0.6750000
NODE_6623_length_1000_cov_7.051054	358	438	2	26	80	0.3250000
NODE_6623_length_1000_cov_7.051054	411	491	0	80	80	1.0000000
NODE_6626_length_1000_cov_3.652608	203	265	0	35	62	0.5645161
NODE_6626_length_1000_cov_3.652608	203	265	2	27	62	0.4354839
NODE_6639_length_999_cov_47.442222	604	684	0	24	80	0.3000000
NODE_6639_length_999_cov_47.442222	604	684	2	3	80	0.0375000
NODE_6639_length_999_cov_47.442222	604	684	6	53	80	0.6625000
NODE_6639_length_999_cov_47.442222	657	723	0	12	66	0.1818182
NODE_6639_length_999_cov_47.442222	657	723	4	1	66	0.0151515
NODE_6639_length_999_cov_47.442222	657	723	6	53	66	0.8030303
NODE_6640_length_999_cov_33.055556	458	540	0	36	82	0.4390244
NODE_6640_length_999_cov_33.055556	458	540	4	46	82	0.5609756
NODE_6640_length_999_cov_33.055556	513	593	4	27	80	0.3375000
NODE_6640_length_999_cov_33.055556	513	593	8	7	80	0.0875000
NODE_6640_length_999_cov_33.055556	513	593	12	46	80	0.5750000
NODE_6641_length_999_cov_22.755556	493	573	2	5	80	0.0625000
NODE_6641_length_999_cov_22.755556	493	573	4	75	80	0.9375000
NODE_6641_length_999_cov_22.755556	546	626	0	50	80	0.6250000
NODE_6641_length_999_cov_22.755556	546	626	2	8	80	0.1000000
NODE_6641_length_999_cov_22.755556	546	626	4	22	80	0.2750000
NODE_6642_length_999_cov_21.842222	359	439	0	15	80	0.1875000
NODE_6642_length_999_cov_21.842222	359	439	2	65	80	0.8125000
NODE_6642_length_999_cov_21.842222	412	492	0	40	80	0.5000000
NODE_6642_length_999_cov_21.842222	412	492	2	40	80	0.5000000
NODE_6643_length_999_cov_20.006667	361	441	0	53	80	0.6625000
NODE_6643_length_999_cov_20.006667	361	441	2	10	80	0.1250000
NODE_6643_length_999_cov_20.006667	361	441	4	17	80	0.2125000
NODE_6643_length_999_cov_20.006667	414	494	2	10	80	0.1250000
NODE_6643_length_999_cov_20.006667	414	494	4	70	80	0.8750000
NODE_6643_length_999_cov_20.006667	490	570	2	33	80	0.4125000
NODE_6643_length_999_cov_20.006667	490	570	4	36	80	0.4500000
NODE_6643_length_999_cov_20.006667	490	570	6	11	80	0.1375000
NODE_6643_length_999_cov_20.006667	543	623	0	35	80	0.4375000
NODE_6643_length_999_cov_20.006667	543	623	2	45	80	0.5625000
NODE_6645_length_999_cov_16.794444	438	518	0	33	80	0.4125000
NODE_6645_length_999_cov_16.794444	438	518	1	47	80	0.5875000
NODE_6645_length_999_cov_16.794444	491	571	1	80	80	1.0000000
NODE_6646_length_999_cov_15.146667	464	544	0	80	80	1.0000000
NODE_6646_length_999_cov_15.146667	517	597	0	80	80	1.0000000
NODE_6648_length_999_cov_8.771111	361	441	0	18	80	0.2250000
NODE_6648_length_999_cov_8.771111	361	441	4	62	80	0.7750000
NODE_6648_length_999_cov_8.771111	414	492	0	38	78	0.4871795
NODE_6648_length_999_cov_8.771111	414	492	4	40	78	0.5128205
NODE_6649_length_999_cov_5.171111	417	497	0	73	80	0.9125000
NODE_6649_length_999_cov_5.171111	417	497	2	7	80	0.0875000
NODE_6649_length_999_cov_5.171111	470	550	0	80	80	1.0000000
NODE_6650_length_999_cov_2.854444	35	101	10	62	66	0.9393939
NODE_6650_length_999_cov_2.854444	35	101	14	4	66	0.0606061
NODE_6657_length_998_cov_30.697442	404	484	0	80	80	1.0000000
NODE_6657_length_998_cov_30.697442	457	537	0	49	80	0.6125000
NODE_6657_length_998_cov_30.697442	457	537	2	31	80	0.3875000
NODE_6657_length_998_cov_30.697442	533	613	2	80	80	1.0000000
NODE_6657_length_998_cov_30.697442	586	666	0	30	80	0.3750000
NODE_6657_length_998_cov_30.697442	586	666	2	50	80	0.6250000
NODE_6658_length_998_cov_23.703003	235	315	6	29	80	0.3625000
NODE_6658_length_998_cov_23.703003	235	315	7	4	80	0.0500000
NODE_6658_length_998_cov_23.703003	235	315	8	1	80	0.0125000
NODE_6658_length_998_cov_23.703003	235	315	10	46	80	0.5750000
NODE_6658_length_998_cov_23.703003	288	368	4	43	80	0.5375000
NODE_6658_length_998_cov_23.703003	288	368	6	22	80	0.2750000
NODE_6658_length_998_cov_23.703003	288	368	8	1	80	0.0125000
NODE_6658_length_998_cov_23.703003	288	368	10	14	80	0.1750000
NODE_6659_length_998_cov_22.692992	531	611	0	12	80	0.1500000
NODE_6659_length_998_cov_22.692992	531	611	2	68	80	0.8500000
NODE_6659_length_998_cov_22.692992	584	664	0	65	80	0.8125000
NODE_6659_length_998_cov_22.692992	584	664	2	15	80	0.1875000
NODE_6660_length_998_cov_11.152392	514	594	0	80	80	1.0000000
NODE_6660_length_998_cov_11.152392	567	640	0	73	73	1.0000000
NODE_6660_length_998_cov_11.152392	636	716	0	80	80	1.0000000
NODE_6660_length_998_cov_11.152392	689	769	0	80	80	1.0000000
NODE_6661_length_998_cov_10.061179	422	502	0	32	80	0.4000000
NODE_6661_length_998_cov_10.061179	422	502	2	48	80	0.6000000
NODE_6661_length_998_cov_10.061179	475	555	0	25	80	0.3125000
NODE_6661_length_998_cov_10.061179	475	555	2	55	80	0.6875000
NODE_6662_length_998_cov_7.126808	353	430	0	77	77	1.0000000
NODE_6662_length_998_cov_7.126808	403	483	0	80	80	1.0000000
NODE_6669_length_997_cov_48.518931	445	525	0	80	80	1.0000000
NODE_6669_length_997_cov_48.518931	498	578	0	80	80	1.0000000
NODE_6670_length_997_cov_36.721604	400	480	0	3	80	0.0375000
NODE_6670_length_997_cov_36.721604	400	480	8	14	80	0.1750000
NODE_6670_length_997_cov_36.721604	400	480	10	5	80	0.0625000
NODE_6670_length_997_cov_36.721604	400	480	12	34	80	0.4250000
NODE_6670_length_997_cov_36.721604	400	480	14	24	80	0.3000000
NODE_6670_length_997_cov_36.721604	453	533	0	9	80	0.1125000
NODE_6670_length_997_cov_36.721604	453	533	2	10	80	0.1250000
NODE_6670_length_997_cov_36.721604	453	533	12	7	80	0.0875000
NODE_6670_length_997_cov_36.721604	453	533	14	54	80	0.6750000
NODE_6671_length_997_cov_22.646993	328	408	0	80	80	1.0000000
NODE_6671_length_997_cov_22.646993	381	461	0	80	80	1.0000000
NODE_6672_length_997_cov_19.709354	420	500	0	43	80	0.5375000
NODE_6672_length_997_cov_19.709354	420	500	2	37	80	0.4625000
NODE_6672_length_997_cov_19.709354	473	553	0	80	80	1.0000000
NODE_6672_length_997_cov_19.709354	549	629	0	80	80	1.0000000
NODE_6672_length_997_cov_19.709354	602	682	0	80	80	1.0000000
NODE_6673_length_997_cov_17.947661	465	545	0	14	80	0.1750000
NODE_6673_length_997_cov_17.947661	465	545	2	66	80	0.8250000
NODE_6673_length_997_cov_17.947661	518	598	0	67	80	0.8375000
NODE_6673_length_997_cov_17.947661	518	598	2	13	80	0.1625000
NODE_6673_length_997_cov_17.947661	594	674	0	80	80	1.0000000
NODE_6673_length_997_cov_17.947661	647	727	0	80	80	1.0000000
NODE_6674_length_997_cov_14.718263	388	468	1	18	80	0.2250000
NODE_6674_length_997_cov_14.718263	388	468	2	41	80	0.5125000
NODE_6674_length_997_cov_14.718263	388	468	4	21	80	0.2625000
NODE_6674_length_997_cov_14.718263	441	521	2	6	80	0.0750000
NODE_6674_length_997_cov_14.718263	441	521	4	74	80	0.9250000
NODE_6675_length_997_cov_7.114699	307	387	0	80	80	1.0000000
NODE_6675_length_997_cov_7.114699	360	440	0	80	80	1.0000000
NODE_6694_length_996_cov_59.568562	387	467	0	11	80	0.1375000
NODE_6694_length_996_cov_59.568562	387	467	2	69	80	0.8625000
NODE_6694_length_996_cov_59.568562	440	520	0	10	80	0.1250000
NODE_6694_length_996_cov_59.568562	440	520	2	70	80	0.8750000
NODE_6695_length_996_cov_32.462653	503	583	7	16	80	0.2000000
NODE_6695_length_996_cov_32.462653	503	583	8	44	80	0.5500000
NODE_6695_length_996_cov_32.462653	503	583	12	20	80	0.2500000
NODE_6695_length_996_cov_32.462653	556	636	4	34	80	0.4250000
NODE_6695_length_996_cov_32.462653	556	636	8	7	80	0.0875000
NODE_6695_length_996_cov_32.462653	556	636	12	39	80	0.4875000
NODE_6696_length_996_cov_23.312152	571	651	0	45	80	0.5625000
NODE_6696_length_996_cov_23.312152	571	651	2	35	80	0.4375000
NODE_6696_length_996_cov_23.312152	624	704	0	80	80	1.0000000
NODE_6697_length_996_cov_20.979933	533	613	0	80	80	1.0000000
NODE_6697_length_996_cov_20.979933	586	666	0	80	80	1.0000000
NODE_6698_length_996_cov_17.865106	535	615	0	80	80	1.0000000
NODE_6698_length_996_cov_17.865106	588	668	0	80	80	1.0000000
NODE_6699_length_996_cov_10.297659	499	579	2	22	80	0.2750000
NODE_6699_length_996_cov_10.297659	499	579	6	58	80	0.7250000
NODE_6699_length_996_cov_10.297659	552	630	0	38	78	0.4871795
NODE_6699_length_996_cov_10.297659	552	630	2	35	78	0.4487180
NODE_6699_length_996_cov_10.297659	552	630	6	5	78	0.0641026
NODE_6702_length_996_cov_3.205128	499	555	0	56	56	1.0000000
NODE_6707_length_995_cov_26.131696	543	623	2	1	80	0.0125000
NODE_6707_length_995_cov_26.131696	543	623	4	79	80	0.9875000
NODE_6707_length_995_cov_26.131696	596	676	0	51	80	0.6375000
NODE_6707_length_995_cov_26.131696	596	676	2	3	80	0.0375000
NODE_6707_length_995_cov_26.131696	596	676	4	26	80	0.3250000
NODE_6708_length_995_cov_20.262277	457	537	0	80	80	1.0000000
NODE_6708_length_995_cov_20.262277	510	590	0	80	80	1.0000000
NODE_6709_length_995_cov_19.382812	457	537	0	80	80	1.0000000
NODE_6709_length_995_cov_19.382812	510	590	0	80	80	1.0000000
NODE_6710_length_995_cov_19.034598	453	533	0	80	80	1.0000000
NODE_6710_length_995_cov_19.034598	506	586	0	80	80	1.0000000
NODE_6711_length_995_cov_9.734375	222	323	0	101	101	1.0000000
NODE_6711_length_995_cov_9.734375	296	376	0	80	80	1.0000000
NODE_6723_length_994_cov_74.678212	362	442	2	73	80	0.9125000
NODE_6723_length_994_cov_74.678212	362	442	4	7	80	0.0875000
NODE_6723_length_994_cov_74.678212	415	495	0	49	80	0.6125000
NODE_6723_length_994_cov_74.678212	415	495	2	31	80	0.3875000
NODE_6723_length_994_cov_74.678212	491	571	0	80	80	1.0000000
NODE_6723_length_994_cov_74.678212	544	624	0	80	80	1.0000000
NODE_6724_length_994_cov_26.045810	442	522	0	80	80	1.0000000
NODE_6724_length_994_cov_26.045810	495	575	0	80	80	1.0000000
NODE_6725_length_994_cov_25.240223	504	584	6	80	80	1.0000000
NODE_6725_length_994_cov_25.240223	557	637	2	19	80	0.2375000
NODE_6725_length_994_cov_25.240223	557	637	4	16	80	0.2000000
NODE_6725_length_994_cov_25.240223	557	637	6	45	80	0.5625000
NODE_6726_length_994_cov_24.615642	422	502	0	80	80	1.0000000
NODE_6726_length_994_cov_24.615642	475	555	0	80	80	1.0000000
NODE_6726_length_994_cov_24.615642	551	631	0	80	80	1.0000000
NODE_6726_length_994_cov_24.615642	604	684	0	27	80	0.3375000
NODE_6726_length_994_cov_24.615642	604	684	2	53	80	0.6625000
NODE_6727_length_994_cov_22.593296	323	403	0	80	80	1.0000000
NODE_6727_length_994_cov_22.593296	376	456	0	80	80	1.0000000
NODE_6727_length_994_cov_22.593296	452	532	0	80	80	1.0000000
NODE_6727_length_994_cov_22.593296	505	585	0	80	80	1.0000000
NODE_6728_length_994_cov_6.985475	0	58	0	58	58	1.0000000
NODE_6728_length_994_cov_6.985475	15	95	0	80	80	1.0000000
NODE_6728_length_994_cov_6.985475	68	148	0	80	80	1.0000000
NODE_6740_length_993_cov_56.321029	266	346	0	80	80	1.0000000
NODE_6740_length_993_cov_56.321029	319	399	0	80	80	1.0000000
NODE_6740_length_993_cov_56.321029	400	470	0	70	70	1.0000000
NODE_6740_length_993_cov_56.321029	443	523	0	80	80	1.0000000
NODE_6741_length_993_cov_44.695749	385	465	0	80	80	1.0000000
NODE_6741_length_993_cov_44.695749	438	518	0	80	80	1.0000000
NODE_6742_length_993_cov_40.574944	417	497	0	21	80	0.2625000
NODE_6742_length_993_cov_40.574944	417	497	4	59	80	0.7375000
NODE_6742_length_993_cov_40.574944	470	550	0	14	80	0.1750000
NODE_6742_length_993_cov_40.574944	470	550	2	18	80	0.2250000
NODE_6742_length_993_cov_40.574944	470	550	4	48	80	0.6000000
NODE_6742_length_993_cov_40.574944	546	628	0	22	82	0.2682927
NODE_6742_length_993_cov_40.574944	546	628	2	60	82	0.7317073
NODE_6742_length_993_cov_40.574944	601	681	0	75	80	0.9375000
NODE_6742_length_993_cov_40.574944	601	681	2	5	80	0.0625000
NODE_6743_length_993_cov_39.817673	3	83	0	63	80	0.7875000
NODE_6743_length_993_cov_39.817673	3	83	2	17	80	0.2125000
NODE_6744_length_993_cov_30.128635	477	557	4	30	80	0.3750000
NODE_6744_length_993_cov_30.128635	477	557	6	4	80	0.0500000
NODE_6744_length_993_cov_30.128635	477	557	10	10	80	0.1250000
NODE_6744_length_993_cov_30.128635	477	557	15	4	80	0.0500000
NODE_6744_length_993_cov_30.128635	477	557	16	32	80	0.4000000
NODE_6744_length_993_cov_30.128635	530	610	0	12	80	0.1500000
NODE_6744_length_993_cov_30.128635	530	610	6	3	80	0.0375000
NODE_6744_length_993_cov_30.128635	530	610	8	17	80	0.2125000
NODE_6744_length_993_cov_30.128635	530	610	13	7	80	0.0875000
NODE_6744_length_993_cov_30.128635	530	610	15	17	80	0.2125000
NODE_6744_length_993_cov_30.128635	530	610	16	24	80	0.3000000
NODE_6745_length_993_cov_17.435123	573	653	0	80	80	1.0000000
NODE_6745_length_993_cov_17.435123	626	706	0	80	80	1.0000000
NODE_6746_length_993_cov_13.074944	483	563	0	16	80	0.2000000
NODE_6746_length_993_cov_13.074944	483	563	2	11	80	0.1375000
NODE_6746_length_993_cov_13.074944	483	563	10	27	80	0.3375000
NODE_6746_length_993_cov_13.074944	483	563	12	26	80	0.3250000
NODE_6746_length_993_cov_13.074944	536	616	10	47	80	0.5875000
NODE_6746_length_993_cov_13.074944	536	616	12	33	80	0.4125000
NODE_6747_length_993_cov_10.190157	500	580	4	80	80	1.0000000
NODE_6747_length_993_cov_10.190157	553	633	4	54	80	0.6750000
NODE_6747_length_993_cov_10.190157	553	633	8	26	80	0.3250000
NODE_6756_length_993_cov_0.909396	16	73	0	57	57	1.0000000
NODE_6757_length_992_cov_36.119821	354	434	0	80	80	1.0000000
NODE_6757_length_992_cov_36.119821	407	487	0	80	80	1.0000000
NODE_6757_length_992_cov_36.119821	483	563	0	80	80	1.0000000
NODE_6757_length_992_cov_36.119821	536	616	0	80	80	1.0000000
NODE_6758_length_992_cov_34.802912	443	523	0	80	80	1.0000000
NODE_6758_length_992_cov_34.802912	496	576	0	80	80	1.0000000
NODE_6759_length_992_cov_33.047032	381	461	0	80	80	1.0000000
NODE_6759_length_992_cov_33.047032	434	514	0	80	80	1.0000000
NODE_6759_length_992_cov_33.047032	510	590	0	80	80	1.0000000
NODE_6759_length_992_cov_33.047032	563	643	0	80	80	1.0000000
NODE_6760_length_992_cov_23.543113	435	515	1	13	80	0.1625000
NODE_6760_length_992_cov_23.543113	435	515	2	65	80	0.8125000
NODE_6760_length_992_cov_23.543113	435	515	3	2	80	0.0250000
NODE_6760_length_992_cov_23.543113	488	568	0	4	80	0.0500000
NODE_6760_length_992_cov_23.543113	488	568	2	76	80	0.9500000
NODE_6761_length_992_cov_22.608063	440	520	8	44	80	0.5500000
NODE_6761_length_992_cov_22.608063	440	520	9	36	80	0.4500000
NODE_6761_length_992_cov_22.608063	493	573	0	18	80	0.2250000
NODE_6761_length_992_cov_22.608063	493	573	9	62	80	0.7750000
NODE_6762_length_992_cov_21.427772	216	296	0	64	80	0.8000000
NODE_6762_length_992_cov_21.427772	216	296	2	16	80	0.2000000
NODE_6762_length_992_cov_21.427772	269	349	0	11	80	0.1375000
NODE_6762_length_992_cov_21.427772	269	349	2	34	80	0.4250000
NODE_6762_length_992_cov_21.427772	269	349	4	35	80	0.4375000
NODE_6763_length_992_cov_20.010078	312	392	6	6	80	0.0750000
NODE_6763_length_992_cov_20.010078	312	392	8	38	80	0.4750000
NODE_6763_length_992_cov_20.010078	312	392	12	36	80	0.4500000
NODE_6763_length_992_cov_20.010078	365	445	2	18	80	0.2250000
NODE_6763_length_992_cov_20.010078	365	445	6	26	80	0.3250000
NODE_6763_length_992_cov_20.010078	365	445	8	2	80	0.0250000
NODE_6763_length_992_cov_20.010078	365	445	12	34	80	0.4250000
NODE_6764_length_992_cov_16.524076	465	545	0	80	80	1.0000000
NODE_6764_length_992_cov_16.524076	518	598	0	80	80	1.0000000
NODE_6765_length_992_cov_16.266517	396	476	0	80	80	1.0000000
NODE_6765_length_992_cov_16.266517	449	529	0	80	80	1.0000000
NODE_6766_length_992_cov_16.146697	272	352	0	80	80	1.0000000
NODE_6766_length_992_cov_16.146697	325	405	0	80	80	1.0000000
NODE_6767_length_992_cov_15.212766	354	434	0	80	80	1.0000000
NODE_6767_length_992_cov_15.212766	407	487	0	80	80	1.0000000
NODE_6767_length_992_cov_15.212766	483	563	0	80	80	1.0000000
NODE_6767_length_992_cov_15.212766	536	616	0	80	80	1.0000000
NODE_6781_length_991_cov_48.582960	451	531	21	4	80	0.0500000
NODE_6781_length_991_cov_48.582960	451	531	22	62	80	0.7750000
NODE_6781_length_991_cov_48.582960	451	531	24	14	80	0.1750000
NODE_6781_length_991_cov_48.582960	504	584	20	2	80	0.0250000
NODE_6781_length_991_cov_48.582960	504	584	21	6	80	0.0750000
NODE_6781_length_991_cov_48.582960	504	584	22	25	80	0.3125000
NODE_6781_length_991_cov_48.582960	504	584	23	14	80	0.1750000
NODE_6781_length_991_cov_48.582960	504	584	24	33	80	0.4125000
NODE_6782_length_991_cov_25.891256	340	420	0	80	80	1.0000000
NODE_6782_length_991_cov_25.891256	393	473	0	80	80	1.0000000
NODE_6782_length_991_cov_25.891256	469	549	0	80	80	1.0000000
NODE_6782_length_991_cov_25.891256	522	602	0	80	80	1.0000000
NODE_6783_length_991_cov_25.392377	377	457	0	23	80	0.2875000
NODE_6783_length_991_cov_25.392377	377	457	2	33	80	0.4125000
NODE_6783_length_991_cov_25.392377	377	457	4	24	80	0.3000000
NODE_6783_length_991_cov_25.392377	430	510	2	16	80	0.2000000
NODE_6783_length_991_cov_25.392377	430	510	3	19	80	0.2375000
NODE_6783_length_991_cov_25.392377	430	510	4	45	80	0.5625000
NODE_6783_length_991_cov_25.392377	506	586	2	43	80	0.5375000
NODE_6783_length_991_cov_25.392377	506	586	3	8	80	0.1000000
NODE_6783_length_991_cov_25.392377	506	586	4	29	80	0.3625000
NODE_6783_length_991_cov_25.392377	559	639	2	7	80	0.0875000
NODE_6783_length_991_cov_25.392377	559	639	4	28	80	0.3500000
NODE_6783_length_991_cov_25.392377	559	639	6	45	80	0.5625000
NODE_6784_length_991_cov_22.210762	421	501	0	80	80	1.0000000
NODE_6784_length_991_cov_22.210762	474	554	0	80	80	1.0000000
NODE_6785_length_991_cov_18.008969	366	446	0	80	80	1.0000000
NODE_6785_length_991_cov_18.008969	419	499	0	80	80	1.0000000
NODE_6785_length_991_cov_18.008969	495	575	0	80	80	1.0000000
NODE_6785_length_991_cov_18.008969	548	629	0	81	81	1.0000000
NODE_6786_length_991_cov_14.727578	426	506	4	71	80	0.8875000
NODE_6786_length_991_cov_14.727578	426	506	6	9	80	0.1125000
NODE_6786_length_991_cov_14.727578	479	559	4	26	80	0.3250000
NODE_6786_length_991_cov_14.727578	479	559	6	54	80	0.6750000
NODE_6787_length_991_cov_13.081839	240	320	0	80	80	1.0000000
NODE_6787_length_991_cov_13.081839	293	373	0	80	80	1.0000000
NODE_6788_length_991_cov_12.693946	425	505	0	15	80	0.1875000
NODE_6788_length_991_cov_12.693946	425	505	2	65	80	0.8125000
NODE_6788_length_991_cov_12.693946	478	558	0	68	80	0.8500000
NODE_6788_length_991_cov_12.693946	478	558	2	12	80	0.1500000
NODE_6789_length_991_cov_9.647982	436	516	0	80	80	1.0000000
NODE_6789_length_991_cov_9.647982	489	569	0	80	80	1.0000000
NODE_6790_length_991_cov_5.176009	538	618	0	80	80	1.0000000
NODE_6790_length_991_cov_5.176009	591	671	0	80	80	1.0000000
NODE_6801_length_990_cov_39.386083	402	482	0	19	80	0.2375000
NODE_6801_length_990_cov_39.386083	402	482	2	61	80	0.7625000
NODE_6801_length_990_cov_39.386083	455	535	2	80	80	1.0000000
NODE_6802_length_990_cov_35.993266	321	401	0	80	80	1.0000000
NODE_6802_length_990_cov_35.993266	374	454	0	80	80	1.0000000
NODE_6802_length_990_cov_35.993266	450	530	0	80	80	1.0000000
NODE_6802_length_990_cov_35.993266	503	583	0	80	80	1.0000000
NODE_6803_length_990_cov_24.445567	588	668	0	80	80	1.0000000
NODE_6803_length_990_cov_24.445567	641	721	0	80	80	1.0000000
NODE_6805_length_990_cov_22.378227	430	510	0	34	80	0.4250000
NODE_6805_length_990_cov_22.378227	430	510	2	2	80	0.0250000
NODE_6805_length_990_cov_22.378227	430	510	5	4	80	0.0500000
NODE_6805_length_990_cov_22.378227	430	510	6	1	80	0.0125000
NODE_6805_length_990_cov_22.378227	430	510	10	39	80	0.4875000
NODE_6805_length_990_cov_22.378227	483	563	0	80	80	1.0000000
NODE_6806_length_990_cov_20.150393	408	488	0	20	80	0.2500000
NODE_6806_length_990_cov_20.150393	408	488	2	2	80	0.0250000
NODE_6806_length_990_cov_20.150393	408	488	4	58	80	0.7250000
NODE_6806_length_990_cov_20.150393	461	541	0	26	80	0.3250000
NODE_6806_length_990_cov_20.150393	461	541	2	25	80	0.3125000
NODE_6806_length_990_cov_20.150393	461	541	4	29	80	0.3625000
NODE_6807_length_990_cov_18.154882	434	514	0	80	80	1.0000000
NODE_6807_length_990_cov_18.154882	487	567	0	80	80	1.0000000
NODE_6808_length_990_cov_17.250281	329	409	0	51	80	0.6375000
NODE_6808_length_990_cov_17.250281	329	409	2	29	80	0.3625000
NODE_6808_length_990_cov_17.250281	382	462	2	80	80	1.0000000
NODE_6808_length_990_cov_17.250281	458	538	0	34	80	0.4250000
NODE_6808_length_990_cov_17.250281	458	538	2	31	80	0.3875000
NODE_6808_length_990_cov_17.250281	458	538	6	4	80	0.0500000
NODE_6808_length_990_cov_17.250281	458	538	8	11	80	0.1375000
NODE_6808_length_990_cov_17.250281	511	591	0	2	80	0.0250000
NODE_6808_length_990_cov_17.250281	511	591	2	10	80	0.1250000
NODE_6808_length_990_cov_17.250281	511	591	6	4	80	0.0500000
NODE_6808_length_990_cov_17.250281	511	591	8	64	80	0.8000000
NODE_6809_length_990_cov_14.977553	448	528	4	20	80	0.2500000
NODE_6809_length_990_cov_14.977553	448	528	6	2	80	0.0250000
NODE_6809_length_990_cov_14.977553	448	528	8	49	80	0.6125000
NODE_6809_length_990_cov_14.977553	448	528	10	9	80	0.1125000
NODE_6809_length_990_cov_14.977553	501	581	0	23	80	0.2875000
NODE_6809_length_990_cov_14.977553	501	581	6	32	80	0.4000000
NODE_6809_length_990_cov_14.977553	501	581	8	25	80	0.3125000
NODE_6810_length_990_cov_13.846240	482	562	0	18	80	0.2250000
NODE_6810_length_990_cov_13.846240	482	562	2	62	80	0.7750000
NODE_6810_length_990_cov_13.846240	535	615	0	68	80	0.8500000
NODE_6810_length_990_cov_13.846240	535	615	2	12	80	0.1500000
NODE_6821_length_990_cov_0.978676	79	151	0	17	72	0.2361111
NODE_6821_length_990_cov_0.978676	79	151	2	7	72	0.0972222
NODE_6821_length_990_cov_0.978676	79	151	4	48	72	0.6666667
NODE_6821_length_990_cov_0.978676	82	152	0	18	70	0.2571429
NODE_6821_length_990_cov_0.978676	82	152	2	7	70	0.1000000
NODE_6821_length_990_cov_0.978676	82	152	4	45	70	0.6428571
NODE_6823_length_989_cov_45.902247	47	127	2	1	80	0.0125000
NODE_6823_length_989_cov_45.902247	47	127	6	3	80	0.0375000
NODE_6823_length_989_cov_45.902247	47	127	8	2	80	0.0250000
NODE_6823_length_989_cov_45.902247	47	127	12	1	80	0.0125000
NODE_6823_length_989_cov_45.902247	47	127	16	1	80	0.0125000
NODE_6823_length_989_cov_45.902247	47	127	18	2	80	0.0250000
NODE_6823_length_989_cov_45.902247	47	127	20	1	80	0.0125000
NODE_6823_length_989_cov_45.902247	47	127	24	5	80	0.0625000
NODE_6823_length_989_cov_45.902247	47	127	26	5	80	0.0625000
NODE_6823_length_989_cov_45.902247	47	127	28	2	80	0.0250000
NODE_6823_length_989_cov_45.902247	47	127	30	57	80	0.7125000
NODE_6823_length_989_cov_45.902247	330	410	0	8	80	0.1000000
NODE_6823_length_989_cov_45.902247	330	410	2	72	80	0.9000000
NODE_6823_length_989_cov_45.902247	383	463	0	61	80	0.7625000
NODE_6823_length_989_cov_45.902247	383	463	2	19	80	0.2375000
NODE_6824_length_989_cov_35.430337	412	492	0	27	80	0.3375000
NODE_6824_length_989_cov_35.430337	412	492	2	53	80	0.6625000
NODE_6824_length_989_cov_35.430337	465	545	0	26	80	0.3250000
NODE_6824_length_989_cov_35.430337	465	545	2	54	80	0.6750000
NODE_6825_length_989_cov_30.124719	477	557	0	80	80	1.0000000
NODE_6825_length_989_cov_30.124719	530	610	0	80	80	1.0000000
NODE_6826_length_989_cov_29.347191	447	527	0	80	80	1.0000000
NODE_6826_length_989_cov_29.347191	500	580	0	80	80	1.0000000
NODE_6826_length_989_cov_29.347191	576	656	0	80	80	1.0000000
NODE_6826_length_989_cov_29.347191	629	709	0	80	80	1.0000000
NODE_6827_length_989_cov_27.886517	245	325	0	80	80	1.0000000
NODE_6827_length_989_cov_27.886517	298	378	0	62	80	0.7750000
NODE_6827_length_989_cov_27.886517	298	378	1	18	80	0.2250000
NODE_6827_length_989_cov_27.886517	374	454	1	36	80	0.4500000
NODE_6827_length_989_cov_27.886517	374	454	2	44	80	0.5500000
NODE_6827_length_989_cov_27.886517	427	507	2	80	80	1.0000000
NODE_6828_length_989_cov_27.515730	393	473	0	80	80	1.0000000
NODE_6828_length_989_cov_27.515730	446	526	0	80	80	1.0000000
NODE_6828_length_989_cov_27.515730	522	602	0	80	80	1.0000000
NODE_6828_length_989_cov_27.515730	575	655	0	80	80	1.0000000
NODE_6829_length_989_cov_23.844944	312	392	2	14	80	0.1750000
NODE_6829_length_989_cov_23.844944	312	392	4	31	80	0.3875000
NODE_6829_length_989_cov_23.844944	312	392	6	35	80	0.4375000
NODE_6829_length_989_cov_23.844944	365	445	4	44	80	0.5500000
NODE_6829_length_989_cov_23.844944	365	445	6	36	80	0.4500000
NODE_6830_length_989_cov_23.131461	475	555	0	80	80	1.0000000
NODE_6830_length_989_cov_23.131461	528	608	0	80	80	1.0000000
NODE_6831_length_989_cov_20.189888	500	580	0	80	80	1.0000000
NODE_6831_length_989_cov_20.189888	553	633	0	80	80	1.0000000
NODE_6832_length_989_cov_18.429213	190	270	0	73	80	0.9125000
NODE_6832_length_989_cov_18.429213	190	270	2	6	80	0.0750000
NODE_6832_length_989_cov_18.429213	190	270	4	1	80	0.0125000
NODE_6832_length_989_cov_18.429213	258	323	0	11	65	0.1692308
NODE_6832_length_989_cov_18.429213	258	323	4	38	65	0.5846154
NODE_6832_length_989_cov_18.429213	258	323	6	12	65	0.1846154
NODE_6832_length_989_cov_18.429213	258	323	11	1	65	0.0153846
NODE_6832_length_989_cov_18.429213	258	323	13	2	65	0.0307692
NODE_6832_length_989_cov_18.429213	258	323	15	1	65	0.0153846
NODE_6832_length_989_cov_18.429213	319	399	11	1	80	0.0125000
NODE_6832_length_989_cov_18.429213	319	399	13	7	80	0.0875000
NODE_6832_length_989_cov_18.429213	319	399	14	44	80	0.5500000
NODE_6832_length_989_cov_18.429213	319	399	15	26	80	0.3250000
NODE_6832_length_989_cov_18.429213	319	399	18	2	80	0.0250000
NODE_6832_length_989_cov_18.429213	372	412	12	5	40	0.1250000
NODE_6832_length_989_cov_18.429213	372	412	13	5	40	0.1250000
NODE_6832_length_989_cov_18.429213	372	412	14	30	40	0.7500000
NODE_6833_length_989_cov_10.307865	433	513	2	80	80	1.0000000
NODE_6833_length_989_cov_10.307865	486	570	0	42	84	0.5000000
NODE_6833_length_989_cov_10.307865	486	570	2	42	84	0.5000000
NODE_6833_length_989_cov_10.307865	566	642	0	76	76	1.0000000
NODE_6833_length_989_cov_10.307865	615	695	0	80	80	1.0000000
NODE_6834_length_989_cov_8.941573	528	608	0	80	80	1.0000000
NODE_6834_length_989_cov_8.941573	581	661	0	46	80	0.5750000
NODE_6834_length_989_cov_8.941573	581	661	2	28	80	0.3500000
NODE_6834_length_989_cov_8.941573	581	661	4	6	80	0.0750000
NODE_6835_length_989_cov_5.132584	459	524	0	65	65	1.0000000
NODE_6838_length_989_cov_2.540449	703	783	0	80	80	1.0000000
NODE_6845_length_988_cov_52.168729	361	441	0	80	80	1.0000000
NODE_6845_length_988_cov_52.168729	414	494	0	54	80	0.6750000
NODE_6845_length_988_cov_52.168729	414	494	2	26	80	0.3250000
NODE_6845_length_988_cov_52.168729	490	570	2	20	80	0.2500000
NODE_6845_length_988_cov_52.168729	490	570	4	60	80	0.7500000
NODE_6845_length_988_cov_52.168729	543	623	0	12	80	0.1500000
NODE_6845_length_988_cov_52.168729	543	623	2	8	80	0.1000000
NODE_6845_length_988_cov_52.168729	543	623	4	60	80	0.7500000
NODE_6846_length_988_cov_36.733408	390	470	0	80	80	1.0000000
NODE_6846_length_988_cov_36.733408	443	523	0	49	80	0.6125000
NODE_6846_length_988_cov_36.733408	443	523	4	31	80	0.3875000
NODE_6847_length_988_cov_36.221597	478	558	0	80	80	1.0000000
NODE_6847_length_988_cov_36.221597	531	611	0	80	80	1.0000000
NODE_6848_length_988_cov_25.895388	389	469	4	30	80	0.3750000
NODE_6848_length_988_cov_25.895388	389	469	6	50	80	0.6250000
NODE_6848_length_988_cov_25.895388	442	522	0	9	80	0.1125000
NODE_6848_length_988_cov_25.895388	442	522	2	13	80	0.1625000
NODE_6848_length_988_cov_25.895388	442	522	4	58	80	0.7250000
NODE_6848_length_988_cov_25.895388	518	598	2	80	80	1.0000000
NODE_6848_length_988_cov_25.895388	571	651	0	49	80	0.6125000
NODE_6848_length_988_cov_25.895388	571	651	2	31	80	0.3875000
NODE_6849_length_988_cov_20.250844	423	503	0	26	80	0.3250000
NODE_6849_length_988_cov_20.250844	423	503	2	54	80	0.6750000
NODE_6849_length_988_cov_20.250844	476	556	0	79	80	0.9875000
NODE_6849_length_988_cov_20.250844	476	556	2	1	80	0.0125000
NODE_6850_length_988_cov_15.812148	474	554	0	40	80	0.5000000
NODE_6850_length_988_cov_15.812148	474	554	2	36	80	0.4500000
NODE_6850_length_988_cov_15.812148	474	554	4	4	80	0.0500000
NODE_6850_length_988_cov_15.812148	527	607	2	23	80	0.2875000
NODE_6850_length_988_cov_15.812148	527	607	4	57	80	0.7125000
NODE_6851_length_988_cov_15.082115	435	517	0	82	82	1.0000000
NODE_6851_length_988_cov_15.082115	490	570	0	80	80	1.0000000
NODE_6852_length_988_cov_14.697413	467	547	0	80	80	1.0000000
NODE_6852_length_988_cov_14.697413	520	600	0	80	80	1.0000000
NODE_6853_length_988_cov_7.730034	562	642	0	80	80	1.0000000
NODE_6853_length_988_cov_7.730034	615	695	0	80	80	1.0000000
NODE_6862_length_987_cov_42.784910	383	476	2	38	93	0.4086021
NODE_6862_length_987_cov_42.784910	383	476	3	2	93	0.0215054
NODE_6862_length_987_cov_42.784910	383	476	4	41	93	0.4408602
NODE_6862_length_987_cov_42.784910	383	476	5	12	93	0.1290323
NODE_6862_length_987_cov_42.784910	449	529	2	80	80	1.0000000
NODE_6863_length_987_cov_39.716216	290	370	0	2	80	0.0250000
NODE_6863_length_987_cov_39.716216	290	370	2	78	80	0.9750000
NODE_6863_length_987_cov_39.716216	343	423	0	55	80	0.6875000
NODE_6863_length_987_cov_39.716216	343	423	2	25	80	0.3125000
NODE_6863_length_987_cov_39.716216	419	499	0	80	80	1.0000000
NODE_6863_length_987_cov_39.716216	472	552	0	80	80	1.0000000
NODE_6864_length_987_cov_28.171171	406	486	0	25	80	0.3125000
NODE_6864_length_987_cov_28.171171	406	486	4	55	80	0.6875000
NODE_6864_length_987_cov_28.171171	459	539	0	78	80	0.9750000
NODE_6864_length_987_cov_28.171171	459	539	4	2	80	0.0250000
NODE_6864_length_987_cov_28.171171	535	615	0	14	80	0.1750000
NODE_6864_length_987_cov_28.171171	535	615	4	66	80	0.8250000
NODE_6864_length_987_cov_28.171171	588	668	0	4	80	0.0500000
NODE_6864_length_987_cov_28.171171	588	668	4	76	80	0.9500000
NODE_6865_length_987_cov_23.627252	331	411	0	80	80	1.0000000
NODE_6865_length_987_cov_23.627252	384	464	0	80	80	1.0000000
NODE_6866_length_987_cov_18.797297	437	517	0	15	80	0.1875000
NODE_6866_length_987_cov_18.797297	437	517	2	65	80	0.8125000
NODE_6866_length_987_cov_18.797297	490	570	0	18	80	0.2250000
NODE_6866_length_987_cov_18.797297	490	570	2	62	80	0.7750000
NODE_6867_length_987_cov_15.628378	369	449	0	12	80	0.1500000
NODE_6867_length_987_cov_15.628378	369	449	2	64	80	0.8000000
NODE_6867_length_987_cov_15.628378	369	449	4	4	80	0.0500000
NODE_6867_length_987_cov_15.628378	422	502	2	39	80	0.4875000
NODE_6867_length_987_cov_15.628378	422	502	4	41	80	0.5125000
NODE_6868_length_987_cov_15.439189	438	518	0	11	80	0.1375000
NODE_6868_length_987_cov_15.439189	438	518	4	69	80	0.8625000
NODE_6868_length_987_cov_15.439189	491	571	0	64	80	0.8000000
NODE_6868_length_987_cov_15.439189	491	571	4	16	80	0.2000000
NODE_6869_length_987_cov_14.343468	506	586	0	41	80	0.5125000
NODE_6869_length_987_cov_14.343468	506	586	2	39	80	0.4875000
NODE_6869_length_987_cov_14.343468	559	639	0	16	80	0.2000000
NODE_6869_length_987_cov_14.343468	559	639	2	64	80	0.8000000
NODE_6870_length_987_cov_13.515766	475	555	2	44	80	0.5500000
NODE_6870_length_987_cov_13.515766	475	555	4	36	80	0.4500000
NODE_6870_length_987_cov_13.515766	528	608	0	12	80	0.1500000
NODE_6870_length_987_cov_13.515766	528	608	2	31	80	0.3875000
NODE_6870_length_987_cov_13.515766	528	608	4	37	80	0.4625000
NODE_6871_length_987_cov_9.521396	408	482	0	18	74	0.2432432
NODE_6871_length_987_cov_9.521396	408	482	3	4	74	0.0540541
NODE_6871_length_987_cov_9.521396	408	482	6	52	74	0.7027027
NODE_6871_length_987_cov_9.521396	455	535	6	80	80	1.0000000
NODE_6872_length_987_cov_9.054054	440	520	0	4	80	0.0500000
NODE_6872_length_987_cov_9.054054	440	520	2	76	80	0.9500000
NODE_6872_length_987_cov_9.054054	493	573	0	30	80	0.3750000
NODE_6872_length_987_cov_9.054054	493	573	2	36	80	0.4500000
NODE_6872_length_987_cov_9.054054	493	573	6	14	80	0.1750000
NODE_6875_length_987_cov_5.378378	509	589	0	80	80	1.0000000
NODE_6875_length_987_cov_5.378378	562	642	0	80	80	1.0000000
NODE_6889_length_986_cov_36.937993	327	407	2	80	80	1.0000000
NODE_6889_length_986_cov_36.937993	380	460	0	27	80	0.3375000
NODE_6889_length_986_cov_36.937993	380	460	2	53	80	0.6625000
NODE_6889_length_986_cov_36.937993	456	536	0	80	80	1.0000000
NODE_6889_length_986_cov_36.937993	509	589	0	65	80	0.8125000
NODE_6889_length_986_cov_36.937993	509	589	2	15	80	0.1875000
NODE_6890_length_986_cov_35.130778	325	405	2	34	80	0.4250000
NODE_6890_length_986_cov_35.130778	325	405	4	46	80	0.5750000
NODE_6890_length_986_cov_35.130778	378	458	0	50	80	0.6250000
NODE_6890_length_986_cov_35.130778	378	458	2	30	80	0.3750000
NODE_6890_length_986_cov_35.130778	454	534	0	34	80	0.4250000
NODE_6890_length_986_cov_35.130778	454	534	2	46	80	0.5750000
NODE_6890_length_986_cov_35.130778	507	587	2	80	80	1.0000000
NODE_6891_length_986_cov_24.037204	602	682	0	80	80	1.0000000
NODE_6891_length_986_cov_24.037204	655	735	0	47	80	0.5875000
NODE_6891_length_986_cov_24.037204	655	735	2	33	80	0.4125000
NODE_6891_length_986_cov_24.037204	731	811	2	80	80	1.0000000
NODE_6891_length_986_cov_24.037204	784	864	0	38	80	0.4750000
NODE_6891_length_986_cov_24.037204	784	864	2	32	80	0.4000000
NODE_6891_length_986_cov_24.037204	784	864	4	10	80	0.1250000
NODE_6892_length_986_cov_20.591883	395	475	0	21	80	0.2625000
NODE_6892_length_986_cov_20.591883	395	475	2	4	80	0.0500000
NODE_6892_length_986_cov_20.591883	395	475	4	55	80	0.6875000
NODE_6892_length_986_cov_20.591883	448	528	2	36	80	0.4500000
NODE_6892_length_986_cov_20.591883	448	528	4	44	80	0.5500000
NODE_6893_length_986_cov_16.815107	389	469	2	73	80	0.9125000
NODE_6893_length_986_cov_16.815107	389	469	4	7	80	0.0875000
NODE_6893_length_986_cov_16.815107	442	522	2	75	80	0.9375000
NODE_6893_length_986_cov_16.815107	442	522	4	5	80	0.0625000
NODE_6894_length_986_cov_11.021421	474	554	0	80	80	1.0000000
NODE_6894_length_986_cov_11.021421	527	607	0	80	80	1.0000000
NODE_6905_length_985_cov_41.707675	443	523	0	80	80	1.0000000
NODE_6905_length_985_cov_41.707675	496	576	0	80	80	1.0000000
NODE_6911_length_984_cov_64.531073	412	481	0	69	69	1.0000000
NODE_6911_length_984_cov_64.531073	454	534	0	80	80	1.0000000
NODE_6911_length_984_cov_64.531073	475	555	0	80	80	1.0000000
NODE_6911_length_984_cov_64.531073	528	608	0	80	80	1.0000000
NODE_6911_length_984_cov_64.531073	549	629	0	80	80	1.0000000
NODE_6912_length_984_cov_28.832768	430	510	0	80	80	1.0000000
NODE_6912_length_984_cov_28.832768	483	563	0	80	80	1.0000000
NODE_6913_length_984_cov_27.247458	203	283	2	80	80	1.0000000
NODE_6913_length_984_cov_27.247458	256	336	0	38	80	0.4750000
NODE_6913_length_984_cov_27.247458	256	336	2	42	80	0.5250000
NODE_6913_length_984_cov_27.247458	332	412	0	40	80	0.5000000
NODE_6913_length_984_cov_27.247458	332	412	2	40	80	0.5000000
NODE_6913_length_984_cov_27.247458	385	465	0	12	80	0.1500000
NODE_6913_length_984_cov_27.247458	385	465	2	68	80	0.8500000
NODE_6914_length_984_cov_25.944633	483	563	2	22	80	0.2750000
NODE_6914_length_984_cov_25.944633	483	563	4	38	80	0.4750000
NODE_6914_length_984_cov_25.944633	483	563	6	20	80	0.2500000
NODE_6914_length_984_cov_25.944633	536	616	2	13	80	0.1625000
NODE_6914_length_984_cov_25.944633	536	616	4	19	80	0.2375000
NODE_6914_length_984_cov_25.944633	536	616	6	48	80	0.6000000
NODE_6915_length_984_cov_16.611299	351	431	0	80	80	1.0000000
NODE_6915_length_984_cov_16.611299	404	484	0	80	80	1.0000000
NODE_6917_length_984_cov_6.414689	415	495	0	54	80	0.6750000
NODE_6917_length_984_cov_6.414689	415	495	4	26	80	0.3250000
NODE_6917_length_984_cov_6.414689	468	548	0	14	80	0.1750000
NODE_6917_length_984_cov_6.414689	468	548	4	66	80	0.8250000
NODE_6918_length_984_cov_4.720904	494	574	0	36	80	0.4500000
NODE_6918_length_984_cov_4.720904	494	574	2	44	80	0.5500000
NODE_6918_length_984_cov_4.720904	547	627	2	80	80	1.0000000
NODE_6927_length_984_cov_1.333333	922	971	0	38	49	0.7755102
NODE_6927_length_984_cov_1.333333	922	971	2	11	49	0.2244898
NODE_6931_length_983_cov_34.566742	466	546	0	22	80	0.2750000
NODE_6931_length_983_cov_34.566742	466	546	2	58	80	0.7250000
NODE_6931_length_983_cov_34.566742	519	599	2	59	80	0.7375000
NODE_6931_length_983_cov_34.566742	519	599	4	21	80	0.2625000
NODE_6932_length_983_cov_26.011312	449	529	0	80	80	1.0000000
NODE_6932_length_983_cov_26.011312	502	582	0	80	80	1.0000000
NODE_6932_length_983_cov_26.011312	578	658	0	80	80	1.0000000
NODE_6932_length_983_cov_26.011312	631	711	0	80	80	1.0000000
NODE_6933_length_983_cov_24.694570	539	619	0	2	80	0.0250000
NODE_6933_length_983_cov_24.694570	539	619	2	78	80	0.9750000
NODE_6933_length_983_cov_24.694570	592	672	0	21	80	0.2625000
NODE_6933_length_983_cov_24.694570	592	672	2	59	80	0.7375000
NODE_6934_length_983_cov_22.214932	395	475	0	2	80	0.0250000
NODE_6934_length_983_cov_22.214932	395	475	2	43	80	0.5375000
NODE_6934_length_983_cov_22.214932	395	475	4	27	80	0.3375000
NODE_6934_length_983_cov_22.214932	395	475	6	8	80	0.1000000
NODE_6934_length_983_cov_22.214932	448	528	4	72	80	0.9000000
NODE_6934_length_983_cov_22.214932	448	528	6	8	80	0.1000000
NODE_6935_length_983_cov_19.132353	377	457	0	5	80	0.0625000
NODE_6935_length_983_cov_19.132353	377	457	1	5	80	0.0625000
NODE_6935_length_983_cov_19.132353	377	457	2	70	80	0.8750000
NODE_6935_length_983_cov_19.132353	430	510	0	58	80	0.7250000
NODE_6935_length_983_cov_19.132353	430	510	1	5	80	0.0625000
NODE_6935_length_983_cov_19.132353	430	510	2	17	80	0.2125000
NODE_6936_length_983_cov_16.875566	419	499	6	80	80	1.0000000
NODE_6936_length_983_cov_16.875566	472	552	0	36	80	0.4500000
NODE_6936_length_983_cov_16.875566	472	552	6	44	80	0.5500000
NODE_6936_length_983_cov_16.875566	548	628	0	50	80	0.6250000
NODE_6936_length_983_cov_16.875566	548	628	4	16	80	0.2000000
NODE_6936_length_983_cov_16.875566	548	628	6	14	80	0.1750000
NODE_6936_length_983_cov_16.875566	601	681	4	13	80	0.1625000
NODE_6936_length_983_cov_16.875566	601	681	6	67	80	0.8375000
NODE_6937_length_983_cov_7.240950	487	567	0	80	80	1.0000000
NODE_6937_length_983_cov_7.240950	540	620	0	80	80	1.0000000
NODE_6949_length_982_cov_30.750849	357	437	0	80	80	1.0000000
NODE_6949_length_982_cov_30.750849	410	490	0	80	80	1.0000000
NODE_6950_length_982_cov_29.901472	516	596	0	80	80	1.0000000
NODE_6950_length_982_cov_29.901472	569	649	0	80	80	1.0000000
NODE_6951_length_982_cov_18.251416	356	436	0	80	80	1.0000000
NODE_6951_length_982_cov_18.251416	409	489	0	80	80	1.0000000
NODE_6951_length_982_cov_18.251416	485	565	0	80	80	1.0000000
NODE_6951_length_982_cov_18.251416	538	618	0	80	80	1.0000000
NODE_6952_length_982_cov_13.840317	608	688	0	16	80	0.2000000
NODE_6952_length_982_cov_13.840317	608	688	4	7	80	0.0875000
NODE_6952_length_982_cov_13.840317	608	688	6	57	80	0.7125000
NODE_6952_length_982_cov_13.840317	661	741	0	69	80	0.8625000
NODE_6952_length_982_cov_13.840317	661	741	4	7	80	0.0875000
NODE_6952_length_982_cov_13.840317	661	741	6	4	80	0.0500000
NODE_6953_length_982_cov_13.227633	317	397	2	20	80	0.2500000
NODE_6953_length_982_cov_13.227633	317	397	4	60	80	0.7500000
NODE_6953_length_982_cov_13.227633	370	450	0	20	80	0.2500000
NODE_6953_length_982_cov_13.227633	370	450	2	7	80	0.0875000
NODE_6953_length_982_cov_13.227633	370	450	4	53	80	0.6625000
NODE_6954_length_982_cov_10.918460	209	289	2	80	80	1.0000000
NODE_6954_length_982_cov_10.918460	262	342	0	38	80	0.4750000
NODE_6954_length_982_cov_10.918460	262	342	2	42	80	0.5250000
NODE_6956_length_982_cov_7.210646	216	296	0	80	80	1.0000000
NODE_6956_length_982_cov_7.210646	269	349	0	80	80	1.0000000
NODE_6973_length_981_cov_55.260771	410	490	0	46	80	0.5750000
NODE_6973_length_981_cov_55.260771	410	490	2	34	80	0.4250000
NODE_6973_length_981_cov_55.260771	463	543	0	6	80	0.0750000
NODE_6973_length_981_cov_55.260771	463	543	2	74	80	0.9250000
NODE_6973_length_981_cov_55.260771	539	619	0	6	80	0.0750000
NODE_6973_length_981_cov_55.260771	539	619	3	74	80	0.9250000
NODE_6973_length_981_cov_55.260771	592	672	0	22	80	0.2750000
NODE_6973_length_981_cov_55.260771	592	672	3	58	80	0.7250000
NODE_6974_length_981_cov_33.287982	362	441	0	65	79	0.8227848
NODE_6974_length_981_cov_33.287982	362	441	4	14	79	0.1772152
NODE_6974_length_981_cov_33.287982	414	495	0	13	81	0.1604938
NODE_6974_length_981_cov_33.287982	414	495	4	68	81	0.8395061
NODE_6974_length_981_cov_33.287982	491	571	2	41	80	0.5125000
NODE_6974_length_981_cov_33.287982	491	571	4	26	80	0.3250000
NODE_6974_length_981_cov_33.287982	491	571	6	13	80	0.1625000
NODE_6974_length_981_cov_33.287982	544	624	0	11	80	0.1375000
NODE_6974_length_981_cov_33.287982	544	624	2	15	80	0.1875000
NODE_6974_length_981_cov_33.287982	544	624	4	54	80	0.6750000
NODE_6975_length_981_cov_33.121315	269	349	0	80	80	1.0000000
NODE_6975_length_981_cov_33.121315	322	402	0	80	80	1.0000000
NODE_6975_length_981_cov_33.121315	398	478	0	11	80	0.1375000
NODE_6975_length_981_cov_33.121315	398	478	4	69	80	0.8625000
NODE_6975_length_981_cov_33.121315	451	531	0	34	80	0.4250000
NODE_6975_length_981_cov_33.121315	451	531	4	46	80	0.5750000
NODE_6976_length_981_cov_26.732426	397	477	0	80	80	1.0000000
NODE_6976_length_981_cov_26.732426	450	530	0	80	80	1.0000000
NODE_6977_length_981_cov_24.304989	390	470	0	75	80	0.9375000
NODE_6977_length_981_cov_24.304989	390	470	8	5	80	0.0625000
NODE_6977_length_981_cov_24.304989	443	523	0	22	80	0.2750000
NODE_6977_length_981_cov_24.304989	443	523	8	10	80	0.1250000
NODE_6977_length_981_cov_24.304989	443	523	14	48	80	0.6000000
NODE_6978_length_981_cov_10.485261	363	443	0	80	80	1.0000000
NODE_6978_length_981_cov_10.485261	416	496	0	80	80	1.0000000
NODE_6980_length_981_cov_5.328798	821	885	0	52	64	0.8125000
NODE_6980_length_981_cov_5.328798	821	885	2	12	64	0.1875000
NODE_6980_length_981_cov_5.328798	847	884	0	37	37	1.0000000
NODE_6998_length_980_cov_40.710556	329	409	0	21	80	0.2625000
NODE_6998_length_980_cov_40.710556	329	409	4	59	80	0.7375000
NODE_6998_length_980_cov_40.710556	382	462	0	22	80	0.2750000
NODE_6998_length_980_cov_40.710556	382	462	4	58	80	0.7250000
NODE_6998_length_980_cov_40.710556	458	538	0	80	80	1.0000000
NODE_6998_length_980_cov_40.710556	511	591	0	80	80	1.0000000
NODE_6999_length_980_cov_37.634506	666	746	0	80	80	1.0000000
NODE_6999_length_980_cov_37.634506	719	799	0	80	80	1.0000000
NODE_7000_length_980_cov_36.261067	331	411	12	80	80	1.0000000
NODE_7000_length_980_cov_36.261067	384	453	0	10	69	0.1449275
NODE_7000_length_980_cov_36.261067	384	453	4	18	69	0.2608696
NODE_7000_length_980_cov_36.261067	384	453	6	5	69	0.0724638
NODE_7000_length_980_cov_36.261067	384	453	8	4	69	0.0579710
NODE_7000_length_980_cov_36.261067	384	453	12	32	69	0.4637681
NODE_7000_length_980_cov_36.261067	465	545	2	80	80	1.0000000
NODE_7000_length_980_cov_36.261067	518	598	0	6	80	0.0750000
NODE_7000_length_980_cov_36.261067	518	598	2	74	80	0.9250000
NODE_7001_length_980_cov_28.514188	430	510	0	65	80	0.8125000
NODE_7001_length_980_cov_28.514188	430	510	2	15	80	0.1875000
NODE_7001_length_980_cov_28.514188	483	563	0	80	80	1.0000000
NODE_7002_length_980_cov_25.205448	497	577	0	80	80	1.0000000
NODE_7002_length_980_cov_25.205448	550	630	0	37	80	0.4625000
NODE_7002_length_980_cov_25.205448	550	630	1	43	80	0.5375000
NODE_7003_length_980_cov_24.321226	417	497	0	43	80	0.5375000
NODE_7003_length_980_cov_24.321226	417	497	1	1	80	0.0125000
NODE_7003_length_980_cov_24.321226	417	497	2	36	80	0.4500000
NODE_7003_length_980_cov_24.321226	470	550	0	80	80	1.0000000
NODE_7004_length_980_cov_20.460840	388	468	0	2	80	0.0250000
NODE_7004_length_980_cov_20.460840	388	468	2	26	80	0.3250000
NODE_7004_length_980_cov_20.460840	388	468	4	21	80	0.2625000
NODE_7004_length_980_cov_20.460840	388	468	8	31	80	0.3875000
NODE_7004_length_980_cov_20.460840	441	521	8	38	80	0.4750000
NODE_7004_length_980_cov_20.460840	441	521	10	42	80	0.5250000
NODE_7005_length_980_cov_19.969353	486	566	0	80	80	1.0000000
NODE_7005_length_980_cov_19.969353	539	619	0	80	80	1.0000000
NODE_7006_length_980_cov_13.736663	350	430	0	80	80	1.0000000
NODE_7006_length_980_cov_13.736663	403	483	0	80	80	1.0000000
NODE_7006_length_980_cov_13.736663	479	559	0	80	80	1.0000000
NODE_7006_length_980_cov_13.736663	532	612	0	80	80	1.0000000
NODE_7008_length_980_cov_10.842225	517	597	0	43	80	0.5375000
NODE_7008_length_980_cov_10.842225	517	597	2	37	80	0.4625000
NODE_7008_length_980_cov_10.842225	570	650	0	14	80	0.1750000
NODE_7008_length_980_cov_10.842225	570	650	2	66	80	0.8250000
NODE_7009_length_980_cov_10.087401	341	424	4	22	83	0.2650602
NODE_7009_length_980_cov_10.087401	341	424	8	3	83	0.0361446
NODE_7009_length_980_cov_10.087401	341	424	12	58	83	0.6987952
NODE_7009_length_980_cov_10.087401	397	477	0	21	80	0.2625000
NODE_7009_length_980_cov_10.087401	397	477	8	35	80	0.4375000
NODE_7009_length_980_cov_10.087401	397	477	12	24	80	0.3000000
NODE_7010_length_980_cov_9.643587	267	347	0	80	80	1.0000000
NODE_7010_length_980_cov_9.643587	320	400	0	80	80	1.0000000
NODE_7010_length_980_cov_9.643587	396	476	0	80	80	1.0000000
NODE_7010_length_980_cov_9.643587	449	529	0	59	80	0.7375000
NODE_7010_length_980_cov_9.643587	449	529	2	6	80	0.0750000
NODE_7010_length_980_cov_9.643587	449	529	4	15	80	0.1875000
NODE_7026_length_979_cov_22.576136	442	522	0	56	80	0.7000000
NODE_7026_length_979_cov_22.576136	442	522	2	24	80	0.3000000
NODE_7026_length_979_cov_22.576136	495	575	0	3	80	0.0375000
NODE_7026_length_979_cov_22.576136	495	575	2	77	80	0.9625000
NODE_7027_length_979_cov_19.739773	445	524	0	79	79	1.0000000
NODE_7027_length_979_cov_19.739773	497	577	0	80	80	1.0000000
NODE_7028_length_979_cov_19.480682	436	516	0	80	80	1.0000000
NODE_7028_length_979_cov_19.480682	489	569	0	80	80	1.0000000
NODE_7028_length_979_cov_19.480682	565	645	0	80	80	1.0000000
NODE_7028_length_979_cov_19.480682	618	698	0	73	80	0.9125000
NODE_7028_length_979_cov_19.480682	618	698	2	7	80	0.0875000
NODE_7029_length_979_cov_18.901136	470	550	0	80	80	1.0000000
NODE_7029_length_979_cov_18.901136	523	603	0	80	80	1.0000000
NODE_7031_length_979_cov_3.519318	101	168	10	2	67	0.0298507
NODE_7031_length_979_cov_3.519318	101	168	11	31	67	0.4626866
NODE_7031_length_979_cov_3.519318	101	168	13	34	67	0.5074627
NODE_7040_length_978_cov_23.195677	424	504	0	26	80	0.3250000
NODE_7040_length_978_cov_23.195677	424	504	2	54	80	0.6750000
NODE_7040_length_978_cov_23.195677	477	557	0	79	80	0.9875000
NODE_7040_length_978_cov_23.195677	477	557	2	1	80	0.0125000
NODE_7041_length_978_cov_18.866894	440	520	3	3	80	0.0375000
NODE_7041_length_978_cov_18.866894	440	520	4	77	80	0.9625000
NODE_7041_length_978_cov_18.866894	493	573	0	36	80	0.4500000
NODE_7041_length_978_cov_18.866894	493	573	3	20	80	0.2500000
NODE_7041_length_978_cov_18.866894	493	573	4	24	80	0.3000000
NODE_7042_length_978_cov_15.614334	341	421	0	80	80	1.0000000
NODE_7042_length_978_cov_15.614334	394	474	0	80	80	1.0000000
NODE_7042_length_978_cov_15.614334	470	550	0	80	80	1.0000000
NODE_7042_length_978_cov_15.614334	523	603	0	80	80	1.0000000
NODE_7043_length_978_cov_15.253697	327	407	0	80	80	1.0000000
NODE_7043_length_978_cov_15.253697	380	460	0	79	80	0.9875000
NODE_7043_length_978_cov_15.253697	380	460	4	1	80	0.0125000
NODE_7043_length_978_cov_15.253697	456	536	0	3	80	0.0375000
NODE_7043_length_978_cov_15.253697	456	536	4	77	80	0.9625000
NODE_7043_length_978_cov_15.253697	509	589	2	49	80	0.6125000
NODE_7043_length_978_cov_15.253697	509	589	4	31	80	0.3875000
NODE_7044_length_978_cov_14.730375	407	487	0	19	80	0.2375000
NODE_7044_length_978_cov_14.730375	407	487	6	61	80	0.7625000
NODE_7044_length_978_cov_14.730375	460	540	0	72	80	0.9000000
NODE_7044_length_978_cov_14.730375	460	540	6	8	80	0.1000000
NODE_7045_length_978_cov_7.257110	571	651	0	80	80	1.0000000
NODE_7045_length_978_cov_7.257110	624	704	0	80	80	1.0000000
NODE_7062_length_977_cov_47.484055	427	507	0	18	80	0.2250000
NODE_7062_length_977_cov_47.484055	427	507	4	62	80	0.7750000
NODE_7062_length_977_cov_47.484055	480	560	0	71	80	0.8875000
NODE_7062_length_977_cov_47.484055	480	560	4	9	80	0.1125000
NODE_7063_length_977_cov_47.116173	428	508	0	80	80	1.0000000
NODE_7063_length_977_cov_47.116173	481	561	0	80	80	1.0000000
NODE_7063_length_977_cov_47.116173	557	637	0	80	80	1.0000000
NODE_7063_length_977_cov_47.116173	610	690	0	80	80	1.0000000
NODE_7064_length_977_cov_32.542141	486	566	0	80	80	1.0000000
NODE_7064_length_977_cov_32.542141	539	619	0	80	80	1.0000000
NODE_7065_length_977_cov_30.676538	361	441	0	80	80	1.0000000
NODE_7065_length_977_cov_30.676538	414	494	0	80	80	1.0000000
NODE_7066_length_977_cov_28.348519	455	535	0	80	80	1.0000000
NODE_7066_length_977_cov_28.348519	508	588	0	80	80	1.0000000
NODE_7067_length_977_cov_26.571754	343	423	0	80	80	1.0000000
NODE_7067_length_977_cov_26.571754	396	476	0	80	80	1.0000000
NODE_7067_length_977_cov_26.571754	472	552	0	80	80	1.0000000
NODE_7067_length_977_cov_26.571754	525	600	0	75	75	1.0000000
NODE_7068_length_977_cov_24.898633	470	550	0	80	80	1.0000000
NODE_7068_length_977_cov_24.898633	523	603	0	80	80	1.0000000
NODE_7069_length_977_cov_22.986333	313	393	0	52	80	0.6500000
NODE_7069_length_977_cov_22.986333	313	393	2	28	80	0.3500000
NODE_7069_length_977_cov_22.986333	366	446	0	11	80	0.1375000
NODE_7069_length_977_cov_22.986333	366	446	2	69	80	0.8625000
NODE_7069_length_977_cov_22.986333	442	522	0	80	80	1.0000000
NODE_7069_length_977_cov_22.986333	495	575	0	80	80	1.0000000
NODE_7070_length_977_cov_10.753986	290	370	0	51	80	0.6375000
NODE_7070_length_977_cov_10.753986	290	370	2	29	80	0.3625000
NODE_7070_length_977_cov_10.753986	343	423	0	80	80	1.0000000
NODE_7071_length_977_cov_9.924829	401	456	12	13	55	0.2363636
NODE_7071_length_977_cov_9.924829	401	456	14	14	55	0.2545455
NODE_7071_length_977_cov_9.924829	401	456	16	28	55	0.5090909
NODE_7073_length_977_cov_6.391800	483	563	0	80	80	1.0000000
NODE_7073_length_977_cov_6.391800	536	616	0	80	80	1.0000000
NODE_7075_length_977_cov_2.907745	191	241	2	2	50	0.0400000
NODE_7075_length_977_cov_2.907745	191	241	4	48	50	0.9600000
NODE_7085_length_976_cov_38.192702	326	406	0	80	80	1.0000000
NODE_7085_length_976_cov_38.192702	379	459	0	80	80	1.0000000
NODE_7085_length_976_cov_38.192702	455	535	0	80	80	1.0000000
NODE_7085_length_976_cov_38.192702	455	536	0	81	81	1.0000000
NODE_7085_length_976_cov_38.192702	455	519	0	64	64	1.0000000
NODE_7085_length_976_cov_38.192702	508	588	0	80	80	1.0000000
NODE_7086_length_976_cov_26.275941	499	579	2	79	80	0.9875000
NODE_7086_length_976_cov_26.275941	499	579	4	1	80	0.0125000
NODE_7086_length_976_cov_26.275941	552	632	0	20	80	0.2500000
NODE_7086_length_976_cov_26.275941	552	632	2	60	80	0.7500000
NODE_7087_length_976_cov_25.559863	376	456	0	61	80	0.7625000
NODE_7087_length_976_cov_25.559863	376	456	2	19	80	0.2375000
NODE_7087_length_976_cov_25.559863	429	509	0	8	80	0.1000000
NODE_7087_length_976_cov_25.559863	429	509	2	72	80	0.9000000
NODE_7088_length_976_cov_17.961231	572	652	0	80	80	1.0000000
NODE_7088_length_976_cov_17.961231	625	705	0	80	80	1.0000000
NODE_7089_length_976_cov_5.567845	789	851	0	14	62	0.2258064
NODE_7089_length_976_cov_5.567845	789	851	2	48	62	0.7741935
NODE_7089_length_976_cov_5.567845	842	904	0	9	62	0.1451613
NODE_7089_length_976_cov_5.567845	842	904	2	53	62	0.8548387
NODE_7101_length_975_cov_192.211187	722	802	2	10	80	0.1250000
NODE_7101_length_975_cov_192.211187	722	802	4	6	80	0.0750000
NODE_7101_length_975_cov_192.211187	722	802	6	19	80	0.2375000
NODE_7101_length_975_cov_192.211187	722	802	8	2	80	0.0250000
NODE_7101_length_975_cov_192.211187	722	802	10	14	80	0.1750000
NODE_7101_length_975_cov_192.211187	722	802	12	14	80	0.1750000
NODE_7101_length_975_cov_192.211187	722	802	18	15	80	0.1875000
NODE_7102_length_975_cov_41.446347	414	494	0	80	80	1.0000000
NODE_7102_length_975_cov_41.446347	467	547	0	80	80	1.0000000
NODE_7103_length_975_cov_37.618721	375	455	0	7	80	0.0875000
NODE_7103_length_975_cov_37.618721	375	455	6	73	80	0.9125000
NODE_7103_length_975_cov_37.618721	428	508	0	4	80	0.0500000
NODE_7103_length_975_cov_37.618721	428	508	6	76	80	0.9500000
NODE_7104_length_975_cov_34.265982	424	504	0	19	80	0.2375000
NODE_7104_length_975_cov_34.265982	424	504	2	61	80	0.7625000
NODE_7104_length_975_cov_34.265982	477	557	2	80	80	1.0000000
NODE_7105_length_975_cov_31.888128	461	541	0	35	80	0.4375000
NODE_7105_length_975_cov_31.888128	461	541	2	2	80	0.0250000
NODE_7105_length_975_cov_31.888128	461	541	3	43	80	0.5375000
NODE_7105_length_975_cov_31.888128	514	594	2	20	80	0.2500000
NODE_7105_length_975_cov_31.888128	514	594	3	60	80	0.7500000
NODE_7106_length_975_cov_22.093607	392	472	0	35	80	0.4375000
NODE_7106_length_975_cov_22.093607	392	472	6	45	80	0.5625000
NODE_7106_length_975_cov_22.093607	445	525	0	13	80	0.1625000
NODE_7106_length_975_cov_22.093607	445	525	6	67	80	0.8375000
NODE_7107_length_975_cov_15.091324	403	483	0	80	80	1.0000000
NODE_7107_length_975_cov_15.091324	456	536	0	80	80	1.0000000
NODE_7108_length_975_cov_15.046804	63	143	0	80	80	1.0000000
NODE_7108_length_975_cov_15.046804	116	196	0	80	80	1.0000000
NODE_7109_length_975_cov_12.043379	535	615	0	4	80	0.0500000
NODE_7109_length_975_cov_12.043379	535	615	2	76	80	0.9500000
NODE_7109_length_975_cov_12.043379	588	668	0	33	80	0.4125000
NODE_7109_length_975_cov_12.043379	588	668	2	47	80	0.5875000
NODE_7110_length_975_cov_11.772831	276	354	0	78	78	1.0000000
NODE_7110_length_975_cov_11.772831	327	407	0	80	80	1.0000000
NODE_7111_length_975_cov_10.599315	405	485	0	79	80	0.9875000
NODE_7111_length_975_cov_10.599315	405	485	2	1	80	0.0125000
NODE_7111_length_975_cov_10.599315	458	538	0	26	80	0.3250000
NODE_7111_length_975_cov_10.599315	458	538	2	54	80	0.6750000
NODE_7112_length_975_cov_8.089041	430	510	0	80	80	1.0000000
NODE_7112_length_975_cov_8.089041	483	563	0	80	80	1.0000000
NODE_7114_length_975_cov_3.728311	254	334	0	75	80	0.9375000
NODE_7114_length_975_cov_3.728311	254	334	2	5	80	0.0625000
NODE_7114_length_975_cov_3.728311	307	387	0	80	80	1.0000000
NODE_7125_length_974_cov_293.334857	564	642	66	1	78	0.0128205
NODE_7125_length_974_cov_293.334857	564	642	69	2	78	0.0256410
NODE_7125_length_974_cov_293.334857	564	642	70	2	78	0.0256410
NODE_7125_length_974_cov_293.334857	564	642	71	4	78	0.0512821
NODE_7125_length_974_cov_293.334857	564	642	72	1	78	0.0128205
NODE_7125_length_974_cov_293.334857	564	642	73	5	78	0.0641026
NODE_7125_length_974_cov_293.334857	564	642	74	2	78	0.0256410
NODE_7125_length_974_cov_293.334857	564	642	75	4	78	0.0512821
NODE_7125_length_974_cov_293.334857	564	642	76	4	78	0.0512821
NODE_7125_length_974_cov_293.334857	564	642	77	4	78	0.0512821
NODE_7125_length_974_cov_293.334857	564	642	78	5	78	0.0641026
NODE_7125_length_974_cov_293.334857	564	642	79	2	78	0.0256410
NODE_7125_length_974_cov_293.334857	564	642	80	2	78	0.0256410
NODE_7125_length_974_cov_293.334857	564	642	81	1	78	0.0128205
NODE_7125_length_974_cov_293.334857	564	642	85	1	78	0.0128205
NODE_7125_length_974_cov_293.334857	564	642	87	1	78	0.0128205
NODE_7125_length_974_cov_293.334857	564	642	88	1	78	0.0128205
NODE_7125_length_974_cov_293.334857	564	642	90	1	78	0.0128205
NODE_7125_length_974_cov_293.334857	564	642	91	1	78	0.0128205
NODE_7125_length_974_cov_293.334857	564	642	100	1	78	0.0128205
NODE_7125_length_974_cov_293.334857	564	642	102	1	78	0.0128205
NODE_7125_length_974_cov_293.334857	564	642	104	2	78	0.0256410
NODE_7125_length_974_cov_293.334857	564	642	105	1	78	0.0128205
NODE_7125_length_974_cov_293.334857	564	642	106	2	78	0.0256410
NODE_7125_length_974_cov_293.334857	564	642	110	8	78	0.1025641
NODE_7125_length_974_cov_293.334857	564	642	112	2	78	0.0256410
NODE_7125_length_974_cov_293.334857	564	642	114	4	78	0.0512821
NODE_7125_length_974_cov_293.334857	564	642	116	1	78	0.0128205
NODE_7125_length_974_cov_293.334857	564	642	117	2	78	0.0256410
NODE_7125_length_974_cov_293.334857	564	642	131	1	78	0.0128205
NODE_7125_length_974_cov_293.334857	564	642	132	1	78	0.0128205
NODE_7125_length_974_cov_293.334857	564	642	137	1	78	0.0128205
NODE_7125_length_974_cov_293.334857	564	642	139	1	78	0.0128205
NODE_7125_length_974_cov_293.334857	564	642	145	1	78	0.0128205
NODE_7125_length_974_cov_293.334857	564	642	147	1	78	0.0128205
NODE_7125_length_974_cov_293.334857	564	642	154	1	78	0.0128205
NODE_7125_length_974_cov_293.334857	564	642	155	2	78	0.0256410
NODE_7125_length_974_cov_293.334857	564	642	156	1	78	0.0128205
NODE_7125_length_974_cov_293.334857	564	642	66	1	78	0.0128205
NODE_7125_length_974_cov_293.334857	564	642	69	2	78	0.0256410
NODE_7125_length_974_cov_293.334857	564	642	70	2	78	0.0256410
NODE_7125_length_974_cov_293.334857	564	642	71	4	78	0.0512821
NODE_7125_length_974_cov_293.334857	564	642	72	1	78	0.0128205
NODE_7125_length_974_cov_293.334857	564	642	73	5	78	0.0641026
NODE_7125_length_974_cov_293.334857	564	642	74	2	78	0.0256410
NODE_7125_length_974_cov_293.334857	564	642	75	4	78	0.0512821
NODE_7125_length_974_cov_293.334857	564	642	76	4	78	0.0512821
NODE_7125_length_974_cov_293.334857	564	642	77	4	78	0.0512821
NODE_7125_length_974_cov_293.334857	564	642	78	5	78	0.0641026
NODE_7125_length_974_cov_293.334857	564	642	79	2	78	0.0256410
NODE_7125_length_974_cov_293.334857	564	642	80	2	78	0.0256410
NODE_7125_length_974_cov_293.334857	564	642	81	1	78	0.0128205
NODE_7125_length_974_cov_293.334857	564	642	85	1	78	0.0128205
NODE_7125_length_974_cov_293.334857	564	642	87	1	78	0.0128205
NODE_7125_length_974_cov_293.334857	564	642	88	1	78	0.0128205
NODE_7125_length_974_cov_293.334857	564	642	90	1	78	0.0128205
NODE_7125_length_974_cov_293.334857	564	642	91	1	78	0.0128205
NODE_7125_length_974_cov_293.334857	564	642	100	1	78	0.0128205
NODE_7125_length_974_cov_293.334857	564	642	102	1	78	0.0128205
NODE_7125_length_974_cov_293.334857	564	642	104	2	78	0.0256410
NODE_7125_length_974_cov_293.334857	564	642	105	1	78	0.0128205
NODE_7125_length_974_cov_293.334857	564	642	106	2	78	0.0256410
NODE_7125_length_974_cov_293.334857	564	642	110	8	78	0.1025641
NODE_7125_length_974_cov_293.334857	564	642	112	2	78	0.0256410
NODE_7125_length_974_cov_293.334857	564	642	114	4	78	0.0512821
NODE_7125_length_974_cov_293.334857	564	642	116	1	78	0.0128205
NODE_7125_length_974_cov_293.334857	564	642	117	2	78	0.0256410
NODE_7125_length_974_cov_293.334857	564	642	131	1	78	0.0128205
NODE_7125_length_974_cov_293.334857	564	642	132	1	78	0.0128205
NODE_7125_length_974_cov_293.334857	564	642	137	1	78	0.0128205
NODE_7125_length_974_cov_293.334857	564	642	139	1	78	0.0128205
NODE_7125_length_974_cov_293.334857	564	642	145	1	78	0.0128205
NODE_7125_length_974_cov_293.334857	564	642	147	1	78	0.0128205
NODE_7125_length_974_cov_293.334857	564	642	154	1	78	0.0128205
NODE_7125_length_974_cov_293.334857	564	642	155	2	78	0.0256410
NODE_7125_length_974_cov_293.334857	564	642	156	1	78	0.0128205
NODE_7125_length_974_cov_293.334857	564	633	66	1	69	0.0144928
NODE_7125_length_974_cov_293.334857	564	633	69	2	69	0.0289855
NODE_7125_length_974_cov_293.334857	564	633	70	2	69	0.0289855
NODE_7125_length_974_cov_293.334857	564	633	71	4	69	0.0579710
NODE_7125_length_974_cov_293.334857	564	633	72	1	69	0.0144928
NODE_7125_length_974_cov_293.334857	564	633	73	5	69	0.0724638
NODE_7125_length_974_cov_293.334857	564	633	74	2	69	0.0289855
NODE_7125_length_974_cov_293.334857	564	633	75	4	69	0.0579710
NODE_7125_length_974_cov_293.334857	564	633	76	4	69	0.0579710
NODE_7125_length_974_cov_293.334857	564	633	77	4	69	0.0579710
NODE_7125_length_974_cov_293.334857	564	633	78	5	69	0.0724638
NODE_7125_length_974_cov_293.334857	564	633	79	2	69	0.0289855
NODE_7125_length_974_cov_293.334857	564	633	80	2	69	0.0289855
NODE_7125_length_974_cov_293.334857	564	633	81	1	69	0.0144928
NODE_7125_length_974_cov_293.334857	564	633	85	1	69	0.0144928
NODE_7125_length_974_cov_293.334857	564	633	87	1	69	0.0144928
NODE_7125_length_974_cov_293.334857	564	633	88	1	69	0.0144928
NODE_7125_length_974_cov_293.334857	564	633	90	1	69	0.0144928
NODE_7125_length_974_cov_293.334857	564	633	91	1	69	0.0144928
NODE_7125_length_974_cov_293.334857	564	633	100	1	69	0.0144928
NODE_7125_length_974_cov_293.334857	564	633	102	1	69	0.0144928
NODE_7125_length_974_cov_293.334857	564	633	104	2	69	0.0289855
NODE_7125_length_974_cov_293.334857	564	633	105	1	69	0.0144928
NODE_7125_length_974_cov_293.334857	564	633	106	2	69	0.0289855
NODE_7125_length_974_cov_293.334857	564	633	110	4	69	0.0579710
NODE_7125_length_974_cov_293.334857	564	633	112	1	69	0.0144928
NODE_7125_length_974_cov_293.334857	564	633	114	2	69	0.0289855
NODE_7125_length_974_cov_293.334857	564	633	116	1	69	0.0144928
NODE_7125_length_974_cov_293.334857	564	633	131	1	69	0.0144928
NODE_7125_length_974_cov_293.334857	564	633	132	1	69	0.0144928
NODE_7125_length_974_cov_293.334857	564	633	137	1	69	0.0144928
NODE_7125_length_974_cov_293.334857	564	633	139	1	69	0.0144928
NODE_7125_length_974_cov_293.334857	564	633	145	1	69	0.0144928
NODE_7125_length_974_cov_293.334857	564	633	147	1	69	0.0144928
NODE_7125_length_974_cov_293.334857	564	633	154	1	69	0.0144928
NODE_7125_length_974_cov_293.334857	564	633	155	2	69	0.0289855
NODE_7125_length_974_cov_293.334857	564	633	156	1	69	0.0144928
NODE_7126_length_974_cov_49.884571	459	539	0	80	80	1.0000000
NODE_7126_length_974_cov_49.884571	512	592	0	80	80	1.0000000
NODE_7127_length_974_cov_38.384000	430	508	0	78	78	1.0000000
NODE_7127_length_974_cov_38.384000	483	561	0	78	78	1.0000000
NODE_7128_length_974_cov_26.008000	391	471	2	38	80	0.4750000
NODE_7128_length_974_cov_26.008000	391	471	4	42	80	0.5250000
NODE_7128_length_974_cov_26.008000	444	524	0	13	80	0.1625000
NODE_7128_length_974_cov_26.008000	444	524	2	55	80	0.6875000
NODE_7128_length_974_cov_26.008000	444	524	4	12	80	0.1500000
NODE_7128_length_974_cov_26.008000	520	600	0	80	80	1.0000000
NODE_7128_length_974_cov_26.008000	573	653	0	72	80	0.9000000
NODE_7128_length_974_cov_26.008000	573	653	2	8	80	0.1000000
NODE_7129_length_974_cov_21.160000	460	540	0	80	80	1.0000000
NODE_7129_length_974_cov_21.160000	513	593	0	80	80	1.0000000
NODE_7131_length_974_cov_11.384000	290	370	0	80	80	1.0000000
NODE_7131_length_974_cov_11.384000	343	423	0	80	80	1.0000000
NODE_7132_length_974_cov_11.216000	543	623	6	40	80	0.5000000
NODE_7132_length_974_cov_11.216000	543	623	8	40	80	0.5000000
NODE_7132_length_974_cov_11.216000	596	668	0	30	72	0.4166667
NODE_7132_length_974_cov_11.216000	596	668	5	13	72	0.1805556
NODE_7132_length_974_cov_11.216000	596	668	6	29	72	0.4027778
NODE_7133_length_974_cov_9.601143	436	516	0	80	80	1.0000000
NODE_7133_length_974_cov_9.601143	489	569	0	80	80	1.0000000
NODE_7134_length_974_cov_7.436571	382	462	0	80	80	1.0000000
NODE_7134_length_974_cov_7.436571	436	515	0	79	79	1.0000000
NODE_7147_length_973_cov_46.012586	349	429	0	13	80	0.1625000
NODE_7147_length_973_cov_46.012586	349	429	2	9	80	0.1125000
NODE_7147_length_973_cov_46.012586	349	429	4	58	80	0.7250000
NODE_7147_length_973_cov_46.012586	402	482	0	5	80	0.0625000
NODE_7147_length_973_cov_46.012586	402	482	2	33	80	0.4125000
NODE_7147_length_973_cov_46.012586	402	482	4	42	80	0.5250000
NODE_7147_length_973_cov_46.012586	478	558	0	45	80	0.5625000
NODE_7147_length_973_cov_46.012586	478	558	2	35	80	0.4375000
NODE_7147_length_973_cov_46.012586	531	611	2	80	80	1.0000000
NODE_7148_length_973_cov_40.305492	364	444	0	80	80	1.0000000
NODE_7148_length_973_cov_40.305492	417	497	0	80	80	1.0000000
NODE_7149_length_973_cov_24.105263	460	540	0	44	80	0.5500000
NODE_7149_length_973_cov_24.105263	460	540	2	36	80	0.4500000
NODE_7149_length_973_cov_24.105263	513	593	0	36	80	0.4500000
NODE_7149_length_973_cov_24.105263	513	593	2	44	80	0.5500000
NODE_7150_length_973_cov_22.106407	342	422	0	72	80	0.9000000
NODE_7150_length_973_cov_22.106407	342	422	2	8	80	0.1000000
NODE_7150_length_973_cov_22.106407	395	475	0	19	80	0.2375000
NODE_7150_length_973_cov_22.106407	395	475	2	61	80	0.7625000
NODE_7150_length_973_cov_22.106407	471	550	1	15	79	0.1898734
NODE_7150_length_973_cov_22.106407	471	550	2	57	79	0.7215190
NODE_7150_length_973_cov_22.106407	471	550	3	7	79	0.0886076
NODE_7150_length_973_cov_22.106407	526	604	0	10	78	0.1282051
NODE_7150_length_973_cov_22.106407	526	604	1	26	78	0.3333333
NODE_7150_length_973_cov_22.106407	526	604	2	42	78	0.5384616
NODE_7151_length_973_cov_10.994279	430	510	0	80	80	1.0000000
NODE_7151_length_973_cov_10.994279	483	563	0	80	80	1.0000000
NODE_7151_length_973_cov_10.994279	559	635	0	76	76	1.0000000
NODE_7151_length_973_cov_10.994279	608	688	0	80	80	1.0000000
NODE_7153_length_973_cov_2.973684	734	814	0	80	80	1.0000000
NODE_7153_length_973_cov_2.973684	820	890	2	7	70	0.1000000
NODE_7153_length_973_cov_2.973684	820	890	3	8	70	0.1142857
NODE_7153_length_973_cov_2.973684	820	890	5	3	70	0.0428571
NODE_7153_length_973_cov_2.973684	820	890	7	7	70	0.1000000
NODE_7153_length_973_cov_2.973684	820	890	8	45	70	0.6428571
NODE_7153_length_973_cov_2.973684	863	944	4	27	81	0.3333333
NODE_7153_length_973_cov_2.973684	863	944	6	27	81	0.3333333
NODE_7153_length_973_cov_2.973684	863	944	8	27	81	0.3333333
NODE_7166_length_972_cov_32.547537	299	379	0	19	80	0.2375000
NODE_7166_length_972_cov_32.547537	299	379	4	61	80	0.7625000
NODE_7166_length_972_cov_32.547537	352	432	0	35	80	0.4375000
NODE_7166_length_972_cov_32.547537	352	432	2	37	80	0.4625000
NODE_7166_length_972_cov_32.547537	352	432	4	8	80	0.1000000
NODE_7166_length_972_cov_32.547537	428	508	0	50	80	0.6250000
NODE_7166_length_972_cov_32.547537	428	508	2	30	80	0.3750000
NODE_7166_length_972_cov_32.547537	481	561	0	80	80	1.0000000
NODE_7167_length_972_cov_31.010309	474	554	4	5	80	0.0625000
NODE_7167_length_972_cov_31.010309	474	554	6	75	80	0.9375000
NODE_7167_length_972_cov_31.010309	527	607	0	50	80	0.6250000
NODE_7167_length_972_cov_31.010309	527	607	4	8	80	0.1000000
NODE_7167_length_972_cov_31.010309	527	607	6	22	80	0.2750000
NODE_7168_length_972_cov_29.810997	481	561	0	80	80	1.0000000
NODE_7168_length_972_cov_29.810997	534	614	0	31	80	0.3875000
NODE_7168_length_972_cov_29.810997	534	614	4	26	80	0.3250000
NODE_7168_length_972_cov_29.810997	534	614	7	23	80	0.2875000
NODE_7169_length_972_cov_23.438717	442	522	2	26	80	0.3250000
NODE_7169_length_972_cov_23.438717	442	522	4	41	80	0.5125000
NODE_7169_length_972_cov_23.438717	442	522	6	3	80	0.0375000
NODE_7169_length_972_cov_23.438717	442	522	8	10	80	0.1250000
NODE_7169_length_972_cov_23.438717	495	575	4	15	80	0.1875000
NODE_7169_length_972_cov_23.438717	495	575	6	25	80	0.3125000
NODE_7169_length_972_cov_23.438717	495	575	8	40	80	0.5000000
NODE_7170_length_972_cov_18.886598	453	533	8	6	80	0.0750000
NODE_7170_length_972_cov_18.886598	453	533	10	48	80	0.6000000
NODE_7170_length_972_cov_18.886598	453	533	14	17	80	0.2125000
NODE_7170_length_972_cov_18.886598	453	533	20	9	80	0.1125000
NODE_7170_length_972_cov_18.886598	506	585	10	1	79	0.0126582
NODE_7170_length_972_cov_18.886598	506	585	12	12	79	0.1518987
NODE_7170_length_972_cov_18.886598	506	585	14	54	79	0.6835443
NODE_7170_length_972_cov_18.886598	506	585	16	3	79	0.0379747
NODE_7170_length_972_cov_18.886598	506	585	20	9	79	0.1139240
NODE_7171_length_972_cov_15.100802	329	409	0	80	80	1.0000000
NODE_7171_length_972_cov_15.100802	382	462	0	80	80	1.0000000
NODE_7172_length_972_cov_12.674685	444	524	0	80	80	1.0000000
NODE_7172_length_972_cov_12.674685	497	577	0	80	80	1.0000000
NODE_7173_length_972_cov_11.235968	504	584	0	80	80	1.0000000
NODE_7173_length_972_cov_11.235968	557	637	0	80	80	1.0000000
NODE_7174_length_972_cov_10.983963	402	482	0	80	80	1.0000000
NODE_7174_length_972_cov_10.983963	455	535	0	35	80	0.4375000
NODE_7174_length_972_cov_10.983963	455	535	1	22	80	0.2750000
NODE_7174_length_972_cov_10.983963	455	535	2	23	80	0.2875000
NODE_7175_length_972_cov_8.887743	302	382	0	19	80	0.2375000
NODE_7175_length_972_cov_8.887743	302	382	2	6	80	0.0750000
NODE_7175_length_972_cov_8.887743	302	382	6	55	80	0.6875000
NODE_7175_length_972_cov_8.887743	355	430	2	22	75	0.2933333
NODE_7175_length_972_cov_8.887743	355	430	6	53	75	0.7066666
NODE_7176_length_972_cov_8.265750	488	568	0	80	80	1.0000000
NODE_7176_length_972_cov_8.265750	541	621	0	80	80	1.0000000
NODE_7182_length_972_cov_2.714777	165	241	2	17	76	0.2236842
NODE_7182_length_972_cov_2.714777	165	241	4	5	76	0.0657895
NODE_7182_length_972_cov_2.714777	165	241	6	16	76	0.2105263
NODE_7182_length_972_cov_2.714777	165	241	8	38	76	0.5000000
NODE_7195_length_971_cov_52.575688	398	478	0	19	80	0.2375000
NODE_7195_length_971_cov_52.575688	398	478	4	61	80	0.7625000
NODE_7195_length_971_cov_52.575688	451	531	0	72	80	0.9000000
NODE_7195_length_971_cov_52.575688	451	531	4	8	80	0.1000000
NODE_7195_length_971_cov_52.575688	527	607	0	80	80	1.0000000
NODE_7195_length_971_cov_52.575688	580	660	0	80	80	1.0000000
NODE_7196_length_971_cov_44.464450	280	360	0	80	80	1.0000000
NODE_7196_length_971_cov_44.464450	333	413	0	80	80	1.0000000
NODE_7196_length_971_cov_44.464450	409	489	0	80	80	1.0000000
NODE_7196_length_971_cov_44.464450	462	542	0	80	80	1.0000000
NODE_7197_length_971_cov_32.721330	509	589	0	40	80	0.5000000
NODE_7197_length_971_cov_32.721330	509	589	4	40	80	0.5000000
NODE_7197_length_971_cov_32.721330	562	642	0	11	80	0.1375000
NODE_7197_length_971_cov_32.721330	562	642	4	69	80	0.8625000
NODE_7198_length_971_cov_30.264908	474	554	0	35	80	0.4375000
NODE_7198_length_971_cov_30.264908	474	554	4	45	80	0.5625000
NODE_7198_length_971_cov_30.264908	527	607	0	18	80	0.2250000
NODE_7198_length_971_cov_30.264908	527	607	4	62	80	0.7750000
NODE_7199_length_971_cov_26.631881	434	514	0	80	80	1.0000000
NODE_7199_length_971_cov_26.631881	487	567	0	80	80	1.0000000
NODE_7200_length_971_cov_25.635321	404	484	0	80	80	1.0000000
NODE_7200_length_971_cov_25.635321	457	537	0	80	80	1.0000000
NODE_7201_length_971_cov_23.334862	363	443	0	80	80	1.0000000
NODE_7201_length_971_cov_23.334862	416	497	0	81	81	1.0000000
NODE_7202_length_971_cov_18.254587	468	548	0	80	80	1.0000000
NODE_7202_length_971_cov_18.254587	521	601	0	80	80	1.0000000
NODE_7203_length_971_cov_18.229358	392	472	6	80	80	1.0000000
NODE_7203_length_971_cov_18.229358	445	525	0	8	80	0.1000000
NODE_7203_length_971_cov_18.229358	445	525	2	30	80	0.3750000
NODE_7203_length_971_cov_18.229358	445	525	6	42	80	0.5250000
NODE_7204_length_971_cov_16.591743	481	561	0	18	80	0.2250000
NODE_7204_length_971_cov_16.591743	481	561	2	62	80	0.7750000
NODE_7204_length_971_cov_16.591743	534	614	0	71	80	0.8875000
NODE_7204_length_971_cov_16.591743	534	614	2	9	80	0.1125000
NODE_7205_length_971_cov_15.563073	463	543	0	80	80	1.0000000
NODE_7205_length_971_cov_15.563073	516	596	0	80	80	1.0000000
NODE_7206_length_971_cov_12.141055	415	495	0	5	80	0.0625000
NODE_7206_length_971_cov_12.141055	415	495	2	75	80	0.9375000
NODE_7206_length_971_cov_12.141055	468	548	0	47	80	0.5875000
NODE_7206_length_971_cov_12.141055	468	548	2	33	80	0.4125000
NODE_7222_length_970_cov_34.928817	438	518	0	80	80	1.0000000
NODE_7222_length_970_cov_34.928817	491	571	0	80	80	1.0000000
NODE_7223_length_970_cov_34.445465	540	620	4	15	80	0.1875000
NODE_7223_length_970_cov_34.445465	540	620	6	65	80	0.8125000
NODE_7223_length_970_cov_34.445465	593	673	0	38	80	0.4750000
NODE_7223_length_970_cov_34.445465	593	673	4	2	80	0.0250000
NODE_7223_length_970_cov_34.445465	593	673	6	40	80	0.5000000
NODE_7224_length_970_cov_34.257176	352	432	0	25	80	0.3125000
NODE_7224_length_970_cov_34.257176	352	432	1	5	80	0.0625000
NODE_7224_length_970_cov_34.257176	352	432	2	50	80	0.6250000
NODE_7224_length_970_cov_34.257176	405	485	1	2	80	0.0250000
NODE_7224_length_970_cov_34.257176	405	485	2	78	80	0.9750000
NODE_7225_length_970_cov_26.904707	297	372	2	2	75	0.0266667
NODE_7225_length_970_cov_26.904707	297	372	4	13	75	0.1733333
NODE_7225_length_970_cov_26.904707	297	372	5	1	75	0.0133333
NODE_7225_length_970_cov_26.904707	297	372	7	8	75	0.1066667
NODE_7225_length_970_cov_26.904707	297	372	8	51	75	0.6800000
NODE_7225_length_970_cov_26.904707	303	376	2	6	73	0.0821918
NODE_7225_length_970_cov_26.904707	303	376	4	13	73	0.1780822
NODE_7225_length_970_cov_26.904707	303	376	5	1	73	0.0136986
NODE_7225_length_970_cov_26.904707	303	376	7	8	73	0.1095890
NODE_7225_length_970_cov_26.904707	303	376	8	45	73	0.6164383
NODE_7225_length_970_cov_26.904707	311	377	2	7	66	0.1060606
NODE_7225_length_970_cov_26.904707	311	377	4	13	66	0.1969697
NODE_7225_length_970_cov_26.904707	311	377	5	1	66	0.0151515
NODE_7225_length_970_cov_26.904707	311	377	7	8	66	0.1212121
NODE_7225_length_970_cov_26.904707	311	377	8	37	66	0.5606061
NODE_7225_length_970_cov_26.904707	350	429	0	40	79	0.5063291
NODE_7225_length_970_cov_26.904707	350	429	2	19	79	0.2405063
NODE_7225_length_970_cov_26.904707	350	429	4	13	79	0.1645570
NODE_7225_length_970_cov_26.904707	350	429	5	1	79	0.0126582
NODE_7225_length_970_cov_26.904707	350	429	7	6	79	0.0759494
NODE_7225_length_970_cov_26.904707	350	429	0	40	79	0.5063291
NODE_7225_length_970_cov_26.904707	350	429	2	19	79	0.2405063
NODE_7225_length_970_cov_26.904707	350	429	4	13	79	0.1645570
NODE_7225_length_970_cov_26.904707	350	429	5	1	79	0.0126582
NODE_7225_length_970_cov_26.904707	350	429	7	6	79	0.0759494
NODE_7225_length_970_cov_26.904707	350	429	0	40	79	0.5063291
NODE_7225_length_970_cov_26.904707	350	429	2	19	79	0.2405063
NODE_7225_length_970_cov_26.904707	350	429	4	13	79	0.1645570
NODE_7225_length_970_cov_26.904707	350	429	5	1	79	0.0126582
NODE_7225_length_970_cov_26.904707	350	429	7	6	79	0.0759494
NODE_7226_length_970_cov_26.040184	266	346	0	64	80	0.8000000
NODE_7226_length_970_cov_26.040184	266	346	2	12	80	0.1500000
NODE_7226_length_970_cov_26.040184	266	346	4	4	80	0.0500000
NODE_7226_length_970_cov_26.040184	319	399	0	11	80	0.1375000
NODE_7226_length_970_cov_26.040184	319	399	2	12	80	0.1500000
NODE_7226_length_970_cov_26.040184	319	399	4	57	80	0.7125000
NODE_7226_length_970_cov_26.040184	395	475	0	32	80	0.4000000
NODE_7226_length_970_cov_26.040184	395	475	4	48	80	0.6000000
NODE_7226_length_970_cov_26.040184	448	528	0	80	80	1.0000000
NODE_7227_length_970_cov_19.291619	415	495	2	80	80	1.0000000
NODE_7227_length_970_cov_19.291619	468	548	0	42	80	0.5250000
NODE_7227_length_970_cov_19.291619	468	548	2	38	80	0.4750000
NODE_7228_length_970_cov_17.731343	557	637	0	80	80	1.0000000
NODE_7228_length_970_cov_17.731343	610	690	0	80	80	1.0000000
NODE_7229_length_970_cov_15.135476	407	487	0	73	80	0.9125000
NODE_7229_length_970_cov_15.135476	407	487	2	7	80	0.0875000
NODE_7229_length_970_cov_15.135476	460	540	0	20	80	0.2500000
NODE_7229_length_970_cov_15.135476	460	540	2	60	80	0.7500000
NODE_7230_length_970_cov_12.675086	534	614	0	10	80	0.1250000
NODE_7230_length_970_cov_12.675086	534	614	2	70	80	0.8750000
NODE_7230_length_970_cov_12.675086	587	667	0	63	80	0.7875000
NODE_7230_length_970_cov_12.675086	587	667	2	17	80	0.2125000
NODE_7231_length_970_cov_8.095293	487	567	0	80	80	1.0000000
NODE_7231_length_970_cov_8.095293	540	620	0	80	80	1.0000000
NODE_7233_length_970_cov_7.127440	336	416	0	80	80	1.0000000
NODE_7233_length_970_cov_7.127440	389	469	0	80	80	1.0000000
NODE_7234_length_970_cov_5.824340	0	56	2	56	56	1.0000000
NODE_7246_length_969_cov_47.172414	419	499	2	34	80	0.4250000
NODE_7246_length_969_cov_47.172414	419	499	19	4	80	0.0500000
NODE_7246_length_969_cov_47.172414	419	499	20	17	80	0.2125000
NODE_7246_length_969_cov_47.172414	419	499	21	25	80	0.3125000
NODE_7246_length_969_cov_47.172414	472	552	19	4	80	0.0500000
NODE_7246_length_969_cov_47.172414	472	552	20	1	80	0.0125000
NODE_7246_length_969_cov_47.172414	472	552	21	22	80	0.2750000
NODE_7246_length_969_cov_47.172414	472	552	24	1	80	0.0125000
NODE_7246_length_969_cov_47.172414	472	552	27	2	80	0.0250000
NODE_7246_length_969_cov_47.172414	472	552	28	14	80	0.1750000
NODE_7246_length_969_cov_47.172414	472	552	30	1	80	0.0125000
NODE_7246_length_969_cov_47.172414	472	552	31	3	80	0.0375000
NODE_7246_length_969_cov_47.172414	472	552	32	1	80	0.0125000
NODE_7246_length_969_cov_47.172414	472	552	33	8	80	0.1000000
NODE_7246_length_969_cov_47.172414	472	552	35	2	80	0.0250000
NODE_7246_length_969_cov_47.172414	472	552	37	21	80	0.2625000
NODE_7247_length_969_cov_28.234483	327	407	0	80	80	1.0000000
NODE_7247_length_969_cov_28.234483	380	460	0	80	80	1.0000000
NODE_7248_length_969_cov_27.131034	392	472	0	43	80	0.5375000
NODE_7248_length_969_cov_27.131034	392	472	4	37	80	0.4625000
NODE_7248_length_969_cov_27.131034	445	525	0	4	80	0.0500000
NODE_7248_length_969_cov_27.131034	445	525	2	1	80	0.0125000
NODE_7248_length_969_cov_27.131034	445	525	4	75	80	0.9375000
NODE_7249_length_969_cov_26.345977	466	542	0	33	76	0.4342105
NODE_7249_length_969_cov_26.345977	466	542	3	1	76	0.0131579
NODE_7249_length_969_cov_26.345977	466	542	4	42	76	0.5526316
NODE_7249_length_969_cov_26.345977	515	595	0	80	80	1.0000000
NODE_7250_length_969_cov_18.954023	274	354	0	80	80	1.0000000
NODE_7250_length_969_cov_18.954023	327	407	0	80	80	1.0000000
NODE_7251_length_969_cov_17.952874	410	490	1	66	80	0.8250000
NODE_7251_length_969_cov_17.952874	410	490	3	14	80	0.1750000
NODE_7251_length_969_cov_17.952874	463	543	1	13	80	0.1625000
NODE_7251_length_969_cov_17.952874	463	543	2	6	80	0.0750000
NODE_7251_length_969_cov_17.952874	463	543	3	61	80	0.7625000
NODE_7251_length_969_cov_17.952874	693	773	0	49	80	0.6125000
NODE_7251_length_969_cov_17.952874	693	773	2	31	80	0.3875000
NODE_7251_length_969_cov_17.952874	746	826	2	55	80	0.6875000
NODE_7251_length_969_cov_17.952874	746	826	3	1	80	0.0125000
NODE_7251_length_969_cov_17.952874	746	826	4	24	80	0.3000000
NODE_7252_length_969_cov_15.942529	446	526	0	80	80	1.0000000
NODE_7252_length_969_cov_15.942529	499	579	0	80	80	1.0000000
NODE_7253_length_969_cov_9.926437	573	653	0	80	80	1.0000000
NODE_7253_length_969_cov_9.926437	626	706	0	80	80	1.0000000
NODE_7265_length_968_cov_59.162255	376	456	0	17	80	0.2125000
NODE_7265_length_968_cov_59.162255	376	456	6	63	80	0.7875000
NODE_7265_length_968_cov_59.162255	429	509	0	70	80	0.8750000
NODE_7265_length_968_cov_59.162255	429	509	6	10	80	0.1250000
NODE_7265_length_968_cov_59.162255	505	585	0	61	80	0.7625000
NODE_7265_length_968_cov_59.162255	505	585	2	19	80	0.2375000
NODE_7265_length_968_cov_59.162255	558	638	0	8	80	0.1000000
NODE_7265_length_968_cov_59.162255	558	638	2	72	80	0.9000000
NODE_7266_length_968_cov_40.005754	514	594	0	49	80	0.6125000
NODE_7266_length_968_cov_40.005754	514	594	2	29	80	0.3625000
NODE_7266_length_968_cov_40.005754	514	594	4	2	80	0.0250000
NODE_7266_length_968_cov_40.005754	567	647	2	25	80	0.3125000
NODE_7266_length_968_cov_40.005754	567	647	4	55	80	0.6875000
NODE_7267_length_968_cov_36.521289	450	530	0	80	80	1.0000000
NODE_7267_length_968_cov_36.521289	503	583	0	32	80	0.4000000
NODE_7267_length_968_cov_36.521289	503	583	2	48	80	0.6000000
NODE_7268_length_968_cov_34.799770	474	554	0	80	80	1.0000000
NODE_7268_length_968_cov_34.799770	527	607	0	80	80	1.0000000
NODE_7269_length_968_cov_26.929804	293	372	0	79	79	1.0000000
NODE_7269_length_968_cov_26.929804	345	425	0	80	80	1.0000000
NODE_7269_length_968_cov_26.929804	421	501	0	20	80	0.2500000
NODE_7269_length_968_cov_26.929804	421	501	2	60	80	0.7500000
NODE_7269_length_968_cov_26.929804	474	554	0	21	80	0.2625000
NODE_7269_length_968_cov_26.929804	474	554	2	59	80	0.7375000
NODE_7270_length_968_cov_24.468354	434	514	0	2	80	0.0250000
NODE_7270_length_968_cov_24.468354	434	514	4	35	80	0.4375000
NODE_7270_length_968_cov_24.468354	434	514	8	25	80	0.3125000
NODE_7270_length_968_cov_24.468354	434	514	10	18	80	0.2250000
NODE_7270_length_968_cov_24.468354	487	567	4	9	80	0.1125000
NODE_7270_length_968_cov_24.468354	487	567	8	13	80	0.1625000
NODE_7270_length_968_cov_24.468354	487	567	10	58	80	0.7250000
NODE_7271_length_968_cov_23.204833	344	424	0	7	80	0.0875000
NODE_7271_length_968_cov_23.204833	344	424	4	28	80	0.3500000
NODE_7271_length_968_cov_23.204833	344	424	7	2	80	0.0250000
NODE_7271_length_968_cov_23.204833	344	424	8	43	80	0.5375000
NODE_7271_length_968_cov_23.204833	397	477	0	60	80	0.7500000
NODE_7271_length_968_cov_23.204833	397	477	4	20	80	0.2500000
NODE_7271_length_968_cov_23.204833	473	553	0	80	80	1.0000000
NODE_7271_length_968_cov_23.204833	526	606	0	80	80	1.0000000
NODE_7272_length_968_cov_22.321059	417	497	6	4	80	0.0500000
NODE_7272_length_968_cov_22.321059	417	497	10	38	80	0.4750000
NODE_7272_length_968_cov_22.321059	417	497	18	38	80	0.4750000
NODE_7272_length_968_cov_22.321059	470	550	8	30	80	0.3750000
NODE_7272_length_968_cov_22.321059	470	550	12	18	80	0.2250000
NODE_7272_length_968_cov_22.321059	470	550	16	4	80	0.0500000
NODE_7272_length_968_cov_22.321059	470	550	18	28	80	0.3500000
NODE_7273_length_968_cov_20.897583	313	393	2	4	80	0.0500000
NODE_7273_length_968_cov_20.897583	313	393	4	1	80	0.0125000
NODE_7273_length_968_cov_20.897583	313	393	5	41	80	0.5125000
NODE_7273_length_968_cov_20.897583	313	393	6	1	80	0.0125000
NODE_7273_length_968_cov_20.897583	313	393	12	33	80	0.4125000
NODE_7273_length_968_cov_20.897583	366	446	6	6	80	0.0750000
NODE_7273_length_968_cov_20.897583	366	446	8	35	80	0.4375000
NODE_7273_length_968_cov_20.897583	366	446	11	1	80	0.0125000
NODE_7273_length_968_cov_20.897583	366	446	12	38	80	0.4750000
NODE_7274_length_968_cov_19.296893	401	481	27	19	80	0.2375000
NODE_7274_length_968_cov_19.296893	401	481	28	61	80	0.7625000
NODE_7274_length_968_cov_19.296893	454	534	0	6	80	0.0750000
NODE_7274_length_968_cov_19.296893	454	534	24	1	80	0.0125000
NODE_7274_length_968_cov_19.296893	454	534	27	65	80	0.8125000
NODE_7274_length_968_cov_19.296893	454	534	28	8	80	0.1000000
NODE_7275_length_968_cov_18.100115	573	653	0	80	80	1.0000000
NODE_7275_length_968_cov_18.100115	626	706	0	80	80	1.0000000
NODE_7276_length_968_cov_15.576525	472	552	0	34	80	0.4250000
NODE_7276_length_968_cov_15.576525	472	552	2	46	80	0.5750000
NODE_7276_length_968_cov_15.576525	525	605	2	80	80	1.0000000
NODE_7277_length_968_cov_15.024166	329	409	0	29	80	0.3625000
NODE_7277_length_968_cov_15.024166	329	409	4	51	80	0.6375000
NODE_7277_length_968_cov_15.024166	382	462	4	80	80	1.0000000
NODE_7277_length_968_cov_15.024166	458	538	0	65	80	0.8125000
NODE_7277_length_968_cov_15.024166	458	538	4	15	80	0.1875000
NODE_7277_length_968_cov_15.024166	511	591	0	80	80	1.0000000
NODE_7278_length_968_cov_13.911392	674	754	0	80	80	1.0000000
NODE_7278_length_968_cov_13.911392	727	807	0	80	80	1.0000000
NODE_7279_length_968_cov_11.698504	598	678	0	80	80	1.0000000
NODE_7279_length_968_cov_11.698504	651	731	0	80	80	1.0000000
NODE_7280_length_968_cov_6.490219	538	618	0	80	80	1.0000000
NODE_7280_length_968_cov_6.490219	591	671	0	80	80	1.0000000
NODE_7294_length_967_cov_25.572581	332	412	0	32	80	0.4000000
NODE_7294_length_967_cov_25.572581	332	412	2	48	80	0.6000000
NODE_7294_length_967_cov_25.572581	385	465	0	35	80	0.4375000
NODE_7294_length_967_cov_25.572581	385	465	2	45	80	0.5625000
NODE_7295_length_967_cov_24.919355	396	476	0	80	80	1.0000000
NODE_7295_length_967_cov_24.919355	449	529	0	80	80	1.0000000
NODE_7296_length_967_cov_19.137097	374	454	0	1	80	0.0125000
NODE_7296_length_967_cov_19.137097	374	454	3	1	80	0.0125000
NODE_7296_length_967_cov_19.137097	374	454	4	3	80	0.0375000
NODE_7296_length_967_cov_19.137097	374	454	6	3	80	0.0375000
NODE_7296_length_967_cov_19.137097	374	454	10	24	80	0.3000000
NODE_7296_length_967_cov_19.137097	374	454	11	1	80	0.0125000
NODE_7296_length_967_cov_19.137097	374	454	12	47	80	0.5875000
NODE_7296_length_967_cov_19.137097	427	507	0	54	80	0.6750000
NODE_7296_length_967_cov_19.137097	427	507	3	1	80	0.0125000
NODE_7296_length_967_cov_19.137097	427	507	4	3	80	0.0375000
NODE_7296_length_967_cov_19.137097	427	507	10	22	80	0.2750000
NODE_7296_length_967_cov_19.137097	503	583	0	80	80	1.0000000
NODE_7296_length_967_cov_19.137097	556	636	0	80	80	1.0000000
NODE_7297_length_967_cov_14.654378	453	533	0	5	80	0.0625000
NODE_7297_length_967_cov_14.654378	453	533	2	31	80	0.3875000
NODE_7297_length_967_cov_14.654378	453	533	4	44	80	0.5500000
NODE_7297_length_967_cov_14.654378	506	586	0	26	80	0.3250000
NODE_7297_length_967_cov_14.654378	506	586	2	49	80	0.6125000
NODE_7297_length_967_cov_14.654378	506	586	4	5	80	0.0625000
NODE_7298_length_967_cov_8.027650	280	360	0	80	80	1.0000000
NODE_7298_length_967_cov_8.027650	333	413	0	80	80	1.0000000
NODE_7310_length_966_cov_43.154556	401	474	0	10	73	0.1369863
NODE_7310_length_966_cov_43.154556	401	474	2	3	73	0.0410959
NODE_7310_length_966_cov_43.154556	401	474	4	22	73	0.3013699
NODE_7310_length_966_cov_43.154556	401	474	6	38	73	0.5205479
NODE_7310_length_966_cov_43.154556	447	527	0	63	80	0.7875000
NODE_7310_length_966_cov_43.154556	447	527	2	3	80	0.0375000
NODE_7310_length_966_cov_43.154556	447	527	4	14	80	0.1750000
NODE_7311_length_966_cov_42.877739	477	557	0	14	80	0.1750000
NODE_7311_length_966_cov_42.877739	477	557	4	66	80	0.8250000
NODE_7311_length_966_cov_42.877739	530	610	0	67	80	0.8375000
NODE_7311_length_966_cov_42.877739	530	610	4	13	80	0.1625000
NODE_7312_length_966_cov_39.956171	283	363	0	80	80	1.0000000
NODE_7312_length_966_cov_39.956171	336	416	0	80	80	1.0000000
NODE_7312_length_966_cov_39.956171	412	494	0	82	82	1.0000000
NODE_7312_length_966_cov_39.956171	467	547	0	80	80	1.0000000
NODE_7313_length_966_cov_36.160323	461	541	0	23	80	0.2875000
NODE_7313_length_966_cov_36.160323	461	541	2	57	80	0.7125000
NODE_7313_length_966_cov_36.160323	461	541	0	23	80	0.2875000
NODE_7313_length_966_cov_36.160323	461	541	2	57	80	0.7125000
NODE_7313_length_966_cov_36.160323	514	594	0	51	80	0.6375000
NODE_7313_length_966_cov_36.160323	514	594	2	29	80	0.3625000
NODE_7314_length_966_cov_18.658593	408	488	0	80	80	1.0000000
NODE_7314_length_966_cov_18.658593	461	541	0	52	80	0.6500000
NODE_7314_length_966_cov_18.658593	461	541	2	28	80	0.3500000
NODE_7315_length_966_cov_17.606690	341	421	2	80	80	1.0000000
NODE_7315_length_966_cov_17.606690	394	474	0	46	80	0.5750000
NODE_7315_length_966_cov_17.606690	394	474	2	34	80	0.4250000
NODE_7316_length_966_cov_16.064591	296	376	0	80	80	1.0000000
NODE_7316_length_966_cov_16.064591	349	429	0	80	80	1.0000000
NODE_7317_length_966_cov_15.155709	562	642	0	80	80	1.0000000
NODE_7317_length_966_cov_15.155709	615	695	0	80	80	1.0000000
NODE_7318_length_966_cov_7.726644	280	360	2	36	80	0.4500000
NODE_7318_length_966_cov_7.726644	280	360	4	44	80	0.5500000
NODE_7318_length_966_cov_7.726644	334	414	0	21	80	0.2625000
NODE_7318_length_966_cov_7.726644	334	414	2	40	80	0.5000000
NODE_7318_length_966_cov_7.726644	334	414	4	19	80	0.2375000
NODE_7335_length_965_cov_51.524249	197	277	0	80	80	1.0000000
NODE_7335_length_965_cov_51.524249	250	327	0	77	77	1.0000000
NODE_7335_length_965_cov_51.524249	329	406	0	51	77	0.6623377
NODE_7335_length_965_cov_51.524249	329	406	2	10	77	0.1298701
NODE_7335_length_965_cov_51.524249	329	406	4	16	77	0.2077922
NODE_7335_length_965_cov_51.524249	379	459	0	1	80	0.0125000
NODE_7335_length_965_cov_51.524249	379	459	2	10	80	0.1250000
NODE_7335_length_965_cov_51.524249	379	459	4	23	80	0.2875000
NODE_7335_length_965_cov_51.524249	379	459	6	34	80	0.4250000
NODE_7335_length_965_cov_51.524249	379	459	10	12	80	0.1500000
NODE_7336_length_965_cov_18.072748	515	595	0	80	80	1.0000000
NODE_7336_length_965_cov_18.072748	568	648	0	80	80	1.0000000
NODE_7337_length_965_cov_14.277136	342	422	4	5	80	0.0625000
NODE_7337_length_965_cov_14.277136	342	422	8	75	80	0.9375000
NODE_7337_length_965_cov_14.277136	395	470	0	21	75	0.2800000
NODE_7337_length_965_cov_14.277136	395	470	4	32	75	0.4266667
NODE_7337_length_965_cov_14.277136	395	470	8	22	75	0.2933333
NODE_7338_length_965_cov_7.808314	567	647	0	80	80	1.0000000
NODE_7338_length_965_cov_7.808314	620	700	0	80	80	1.0000000
NODE_7344_length_964_cov_60.153757	197	277	16	6	80	0.0750000
NODE_7344_length_964_cov_60.153757	197	277	17	6	80	0.0750000
NODE_7344_length_964_cov_60.153757	197	277	19	7	80	0.0875000
NODE_7344_length_964_cov_60.153757	197	277	25	2	80	0.0250000
NODE_7344_length_964_cov_60.153757	197	277	26	3	80	0.0375000
NODE_7344_length_964_cov_60.153757	197	277	27	4	80	0.0500000
NODE_7344_length_964_cov_60.153757	197	277	28	3	80	0.0375000
NODE_7344_length_964_cov_60.153757	197	277	30	8	80	0.1000000
NODE_7344_length_964_cov_60.153757	197	277	31	1	80	0.0125000
NODE_7344_length_964_cov_60.153757	197	277	33	1	80	0.0125000
NODE_7344_length_964_cov_60.153757	197	277	34	1	80	0.0125000
NODE_7344_length_964_cov_60.153757	197	277	35	1	80	0.0125000
NODE_7344_length_964_cov_60.153757	197	277	38	3	80	0.0375000
NODE_7344_length_964_cov_60.153757	197	277	39	5	80	0.0625000
NODE_7344_length_964_cov_60.153757	197	277	40	4	80	0.0500000
NODE_7344_length_964_cov_60.153757	197	277	44	1	80	0.0125000
NODE_7344_length_964_cov_60.153757	197	277	47	3	80	0.0375000
NODE_7344_length_964_cov_60.153757	197	277	48	1	80	0.0125000
NODE_7344_length_964_cov_60.153757	197	277	49	3	80	0.0375000
NODE_7344_length_964_cov_60.153757	197	277	51	6	80	0.0750000
NODE_7344_length_964_cov_60.153757	197	277	53	1	80	0.0125000
NODE_7344_length_964_cov_60.153757	197	277	57	1	80	0.0125000
NODE_7344_length_964_cov_60.153757	197	277	62	3	80	0.0375000
NODE_7344_length_964_cov_60.153757	197	277	64	2	80	0.0250000
NODE_7344_length_964_cov_60.153757	197	277	67	1	80	0.0125000
NODE_7344_length_964_cov_60.153757	197	277	68	1	80	0.0125000
NODE_7344_length_964_cov_60.153757	197	277	69	1	80	0.0125000
NODE_7344_length_964_cov_60.153757	197	277	70	1	80	0.0125000
NODE_7344_length_964_cov_60.153757	250	314	6	5	64	0.0781250
NODE_7344_length_964_cov_60.153757	250	314	8	2	64	0.0312500
NODE_7344_length_964_cov_60.153757	250	314	10	7	64	0.1093750
NODE_7344_length_964_cov_60.153757	250	314	12	2	64	0.0312500
NODE_7344_length_964_cov_60.153757	250	314	14	16	64	0.2500000
NODE_7344_length_964_cov_60.153757	250	314	16	11	64	0.1718750
NODE_7344_length_964_cov_60.153757	250	314	17	6	64	0.0937500
NODE_7344_length_964_cov_60.153757	250	314	19	7	64	0.1093750
NODE_7344_length_964_cov_60.153757	250	314	25	2	64	0.0312500
NODE_7344_length_964_cov_60.153757	250	314	26	3	64	0.0468750
NODE_7344_length_964_cov_60.153757	250	314	27	3	64	0.0468750
NODE_7344_length_964_cov_60.153757	672	752	0	22	80	0.2750000
NODE_7344_length_964_cov_60.153757	672	752	2	58	80	0.7250000
NODE_7344_length_964_cov_60.153757	725	805	0	70	80	0.8750000
NODE_7344_length_964_cov_60.153757	725	805	2	10	80	0.1250000
NODE_7345_length_964_cov_45.564162	314	394	0	80	80	1.0000000
NODE_7345_length_964_cov_45.564162	367	447	0	80	80	1.0000000
NODE_7345_length_964_cov_45.564162	443	523	0	80	80	1.0000000
NODE_7345_length_964_cov_45.564162	496	566	0	70	70	1.0000000
NODE_7346_length_964_cov_33.487861	363	443	0	4	80	0.0500000
NODE_7346_length_964_cov_33.487861	363	443	4	76	80	0.9500000
NODE_7346_length_964_cov_33.487861	416	496	0	57	80	0.7125000
NODE_7346_length_964_cov_33.487861	416	496	4	23	80	0.2875000
NODE_7347_length_964_cov_33.077457	408	488	0	80	80	1.0000000
NODE_7347_length_964_cov_33.077457	461	541	0	80	80	1.0000000
NODE_7347_length_964_cov_33.077457	537	617	0	65	80	0.8125000
NODE_7347_length_964_cov_33.077457	537	617	2	15	80	0.1875000
NODE_7347_length_964_cov_33.077457	590	670	0	12	80	0.1500000
NODE_7347_length_964_cov_33.077457	590	670	2	68	80	0.8500000
NODE_7348_length_964_cov_29.250867	419	499	0	44	80	0.5500000
NODE_7348_length_964_cov_29.250867	419	499	2	1	80	0.0125000
NODE_7348_length_964_cov_29.250867	419	499	6	35	80	0.4375000
NODE_7348_length_964_cov_29.250867	472	552	6	54	80	0.6750000
NODE_7348_length_964_cov_29.250867	472	552	7	1	80	0.0125000
NODE_7348_length_964_cov_29.250867	472	552	8	25	80	0.3125000
NODE_7349_length_964_cov_20.191908	228	301	0	73	73	1.0000000
NODE_7349_length_964_cov_20.191908	349	429	0	80	80	1.0000000
NODE_7349_length_964_cov_20.191908	402	482	0	80	80	1.0000000
NODE_7350_length_964_cov_18.510983	486	566	0	80	80	1.0000000
NODE_7350_length_964_cov_18.510983	539	619	0	80	80	1.0000000
NODE_7351_length_964_cov_16.613873	464	544	0	52	80	0.6500000
NODE_7351_length_964_cov_16.613873	464	544	2	28	80	0.3500000
NODE_7351_length_964_cov_16.613873	517	597	2	80	80	1.0000000
NODE_7352_length_964_cov_15.717919	411	491	0	80	80	1.0000000
NODE_7352_length_964_cov_15.717919	464	544	0	80	80	1.0000000
NODE_7352_length_964_cov_15.717919	540	620	0	80	80	1.0000000
NODE_7352_length_964_cov_15.717919	593	668	0	75	75	1.0000000
NODE_7353_length_964_cov_14.591908	521	601	0	80	80	1.0000000
NODE_7353_length_964_cov_14.591908	574	654	0	80	80	1.0000000
NODE_7354_length_964_cov_11.589595	475	555	0	54	80	0.6750000
NODE_7354_length_964_cov_11.589595	475	555	2	26	80	0.3250000
NODE_7354_length_964_cov_11.589595	528	608	0	19	80	0.2375000
NODE_7354_length_964_cov_11.589595	528	608	2	61	80	0.7625000
NODE_7355_length_964_cov_7.639306	420	500	0	80	80	1.0000000
NODE_7355_length_964_cov_7.639306	473	553	0	80	80	1.0000000
NODE_7356_length_964_cov_7.596532	534	614	0	32	80	0.4000000
NODE_7356_length_964_cov_7.596532	534	614	2	48	80	0.6000000
NODE_7356_length_964_cov_7.596532	587	667	0	44	80	0.5500000
NODE_7356_length_964_cov_7.596532	587	667	2	36	80	0.4500000
NODE_7357_length_964_cov_6.568786	368	448	0	4	80	0.0500000
NODE_7357_length_964_cov_6.568786	368	448	4	76	80	0.9500000
NODE_7357_length_964_cov_6.568786	421	501	0	50	80	0.6250000
NODE_7357_length_964_cov_6.568786	421	501	2	7	80	0.0875000
NODE_7357_length_964_cov_6.568786	421	501	4	23	80	0.2875000
NODE_7359_length_964_cov_6.027746	890	940	8	41	50	0.8200000
NODE_7359_length_964_cov_6.027746	890	940	10	9	50	0.1800000
NODE_7361_length_964_cov_4.665896	706	772	0	66	66	1.0000000
NODE_7376_length_963_cov_66.251157	456	536	0	7	80	0.0875000
NODE_7376_length_963_cov_66.251157	456	536	5	29	80	0.3625000
NODE_7376_length_963_cov_66.251157	456	536	7	8	80	0.1000000
NODE_7376_length_963_cov_66.251157	456	536	8	36	80	0.4500000
NODE_7376_length_963_cov_66.251157	509	589	0	25	80	0.3125000
NODE_7376_length_963_cov_66.251157	509	589	2	28	80	0.3500000
NODE_7376_length_963_cov_66.251157	509	589	8	27	80	0.3375000
NODE_7376_length_963_cov_66.251157	585	665	0	80	80	1.0000000
NODE_7376_length_963_cov_66.251157	638	718	0	80	80	1.0000000
NODE_7377_length_963_cov_35.638889	381	461	0	35	80	0.4375000
NODE_7377_length_963_cov_35.638889	381	461	2	45	80	0.5625000
NODE_7377_length_963_cov_35.638889	434	514	0	18	80	0.2250000
NODE_7377_length_963_cov_35.638889	434	514	2	62	80	0.7750000
NODE_7377_length_963_cov_35.638889	510	590	0	80	80	1.0000000
NODE_7377_length_963_cov_35.638889	563	643	0	80	80	1.0000000
NODE_7378_length_963_cov_33.642361	347	427	0	80	80	1.0000000
NODE_7378_length_963_cov_33.642361	400	480	0	80	80	1.0000000
NODE_7379_length_963_cov_18.626157	392	472	0	80	80	1.0000000
NODE_7379_length_963_cov_18.626157	445	525	0	80	80	1.0000000
NODE_7380_length_963_cov_17.750000	402	482	3	6	80	0.0750000
NODE_7380_length_963_cov_17.750000	402	482	5	3	80	0.0375000
NODE_7380_length_963_cov_17.750000	402	482	8	71	80	0.8875000
NODE_7380_length_963_cov_17.750000	455	535	3	25	80	0.3125000
NODE_7380_length_963_cov_17.750000	455	535	6	15	80	0.1875000
NODE_7380_length_963_cov_17.750000	455	535	8	40	80	0.5000000
NODE_7381_length_963_cov_17.023148	542	622	10	80	80	1.0000000
NODE_7381_length_963_cov_17.023148	595	675	0	10	80	0.1250000
NODE_7381_length_963_cov_17.023148	595	675	7	1	80	0.0125000
NODE_7381_length_963_cov_17.023148	595	675	8	28	80	0.3500000
NODE_7381_length_963_cov_17.023148	595	675	10	41	80	0.5125000
NODE_7382_length_963_cov_16.642361	481	561	0	80	80	1.0000000
NODE_7382_length_963_cov_16.642361	534	614	0	80	80	1.0000000
NODE_7382_length_963_cov_16.642361	572	629	0	57	57	1.0000000
NODE_7383_length_963_cov_14.961806	283	363	0	80	80	1.0000000
NODE_7383_length_963_cov_14.961806	336	416	0	80	80	1.0000000
NODE_7384_length_963_cov_13.341435	558	638	0	80	80	1.0000000
NODE_7384_length_963_cov_13.341435	611	691	0	80	80	1.0000000
NODE_7386_length_963_cov_9.520833	459	539	0	80	80	1.0000000
NODE_7386_length_963_cov_9.520833	512	592	0	80	80	1.0000000
NODE_7386_length_963_cov_9.520833	588	662	0	74	74	1.0000000
NODE_7386_length_963_cov_9.520833	641	724	0	83	83	1.0000000
NODE_7388_length_963_cov_7.510417	781	842	3	5	61	0.0819672
NODE_7388_length_963_cov_7.510417	781	842	7	1	61	0.0163934
NODE_7388_length_963_cov_7.510417	781	842	9	4	61	0.0655738
NODE_7388_length_963_cov_7.510417	781	842	10	4	61	0.0655738
NODE_7388_length_963_cov_7.510417	781	842	19	2	61	0.0327869
NODE_7388_length_963_cov_7.510417	781	842	20	4	61	0.0655738
NODE_7388_length_963_cov_7.510417	781	842	26	2	61	0.0327869
NODE_7388_length_963_cov_7.510417	781	842	28	1	61	0.0163934
NODE_7388_length_963_cov_7.510417	781	842	34	5	61	0.0819672
NODE_7388_length_963_cov_7.510417	781	842	38	10	61	0.1639344
NODE_7388_length_963_cov_7.510417	781	842	44	3	61	0.0491803
NODE_7388_length_963_cov_7.510417	781	842	46	1	61	0.0163934
NODE_7388_length_963_cov_7.510417	781	842	47	11	61	0.1803279
NODE_7388_length_963_cov_7.510417	781	842	48	4	61	0.0655738
NODE_7388_length_963_cov_7.510417	781	842	49	3	61	0.0491803
NODE_7388_length_963_cov_7.510417	781	842	51	1	61	0.0163934
NODE_7388_length_963_cov_7.510417	815	894	37	2	79	0.0253165
NODE_7388_length_963_cov_7.510417	815	894	38	4	79	0.0506329
NODE_7388_length_963_cov_7.510417	815	894	41	1	79	0.0126582
NODE_7388_length_963_cov_7.510417	815	894	44	3	79	0.0379747
NODE_7388_length_963_cov_7.510417	815	894	45	1	79	0.0126582
NODE_7388_length_963_cov_7.510417	815	894	46	1	79	0.0126582
NODE_7388_length_963_cov_7.510417	815	894	47	12	79	0.1518987
NODE_7388_length_963_cov_7.510417	815	894	48	4	79	0.0506329
NODE_7388_length_963_cov_7.510417	815	894	49	3	79	0.0379747
NODE_7388_length_963_cov_7.510417	815	894	51	1	79	0.0126582
NODE_7388_length_963_cov_7.510417	815	894	53	4	79	0.0506329
NODE_7388_length_963_cov_7.510417	815	894	55	21	79	0.2658228
NODE_7388_length_963_cov_7.510417	815	894	57	22	79	0.2784810
NODE_7392_length_963_cov_3.755787	378	458	0	80	80	1.0000000
NODE_7392_length_963_cov_3.755787	431	511	0	64	80	0.8000000
NODE_7392_length_963_cov_3.755787	431	511	2	16	80	0.2000000
NODE_7397_length_963_cov_1.931713	426	485	0	59	59	1.0000000
NODE_7404_length_962_cov_37.169177	356	436	0	80	80	1.0000000
NODE_7404_length_962_cov_37.169177	409	489	0	36	80	0.4500000
NODE_7404_length_962_cov_37.169177	409	489	2	44	80	0.5500000
NODE_7405_length_962_cov_28.852839	474	554	0	80	80	1.0000000
NODE_7405_length_962_cov_28.852839	527	607	0	80	80	1.0000000
NODE_7405_length_962_cov_28.852839	603	683	0	10	80	0.1250000
NODE_7405_length_962_cov_28.852839	603	683	2	67	80	0.8375000
NODE_7405_length_962_cov_28.852839	603	683	4	3	80	0.0375000
NODE_7405_length_962_cov_28.852839	656	736	2	55	80	0.6875000
NODE_7405_length_962_cov_28.852839	656	736	4	25	80	0.3125000
NODE_7406_length_962_cov_27.859791	441	521	0	80	80	1.0000000
NODE_7406_length_962_cov_27.859791	494	574	0	80	80	1.0000000
NODE_7407_length_962_cov_21.019699	318	398	0	32	80	0.4000000
NODE_7407_length_962_cov_21.019699	318	398	2	2	80	0.0250000
NODE_7407_length_962_cov_21.019699	318	398	6	46	80	0.5750000
NODE_7407_length_962_cov_21.019699	371	451	6	80	80	1.0000000
NODE_7408_length_962_cov_16.792584	350	430	0	80	80	1.0000000
NODE_7408_length_962_cov_16.792584	403	483	0	80	80	1.0000000
NODE_7409_length_962_cov_14.650058	477	557	0	7	80	0.0875000
NODE_7409_length_962_cov_14.650058	477	557	4	73	80	0.9125000
NODE_7409_length_962_cov_14.650058	530	610	0	47	80	0.5875000
NODE_7409_length_962_cov_14.650058	530	610	4	33	80	0.4125000
NODE_7410_length_962_cov_7.993048	308	345	0	37	37	1.0000000
NODE_7411_length_962_cov_7.835458	447	527	0	26	80	0.3250000
NODE_7411_length_962_cov_7.835458	447	527	2	54	80	0.6750000
NODE_7411_length_962_cov_7.835458	500	580	0	20	80	0.2500000
NODE_7411_length_962_cov_7.835458	500	580	2	60	80	0.7500000
NODE_7412_length_962_cov_6.855156	490	570	0	30	80	0.3750000
NODE_7412_length_962_cov_6.855156	490	570	2	50	80	0.6250000
NODE_7412_length_962_cov_6.855156	543	623	0	80	80	1.0000000
NODE_7417_length_962_cov_1.840093	88	151	2	3	63	0.0476190
NODE_7417_length_962_cov_1.840093	88	151	11	1	63	0.0158730
NODE_7417_length_962_cov_1.840093	88	151	13	1	63	0.0158730
NODE_7417_length_962_cov_1.840093	88	151	17	1	63	0.0158730
NODE_7417_length_962_cov_1.840093	88	151	19	1	63	0.0158730
NODE_7417_length_962_cov_1.840093	88	151	21	1	63	0.0158730
NODE_7417_length_962_cov_1.840093	88	151	27	1	63	0.0158730
NODE_7417_length_962_cov_1.840093	88	151	29	1	63	0.0158730
NODE_7417_length_962_cov_1.840093	88	151	33	2	63	0.0317460
NODE_7417_length_962_cov_1.840093	88	151	53	2	63	0.0317460
NODE_7417_length_962_cov_1.840093	88	151	61	3	63	0.0476190
NODE_7417_length_962_cov_1.840093	88	151	69	1	63	0.0158730
NODE_7417_length_962_cov_1.840093	88	151	73	2	63	0.0317460
NODE_7417_length_962_cov_1.840093	88	151	75	4	63	0.0634921
NODE_7417_length_962_cov_1.840093	88	151	77	9	63	0.1428571
NODE_7417_length_962_cov_1.840093	88	151	80	1	63	0.0158730
NODE_7417_length_962_cov_1.840093	88	151	83	1	63	0.0158730
NODE_7417_length_962_cov_1.840093	88	151	85	2	63	0.0317460
NODE_7417_length_962_cov_1.840093	88	151	87	4	63	0.0634921
NODE_7417_length_962_cov_1.840093	88	151	89	3	63	0.0476190
NODE_7417_length_962_cov_1.840093	88	151	91	1	63	0.0158730
NODE_7417_length_962_cov_1.840093	88	151	93	2	63	0.0317460
NODE_7417_length_962_cov_1.840093	88	151	95	2	63	0.0317460
NODE_7417_length_962_cov_1.840093	88	151	97	5	63	0.0793651
NODE_7417_length_962_cov_1.840093	88	151	101	3	63	0.0476190
NODE_7417_length_962_cov_1.840093	88	151	103	2	63	0.0317460
NODE_7417_length_962_cov_1.840093	88	151	107	4	63	0.0634921
NODE_7422_length_961_cov_61.019722	453	533	0	80	80	1.0000000
NODE_7422_length_961_cov_61.019722	506	586	0	80	80	1.0000000
NODE_7422_length_961_cov_61.019722	614	672	0	58	58	1.0000000
NODE_7423_length_961_cov_51.005800	334	414	0	3	80	0.0375000
NODE_7423_length_961_cov_51.005800	334	414	2	37	80	0.4625000
NODE_7423_length_961_cov_51.005800	334	414	6	8	80	0.1000000
NODE_7423_length_961_cov_51.005800	334	414	10	5	80	0.0625000
NODE_7423_length_961_cov_51.005800	334	414	12	18	80	0.2250000
NODE_7423_length_961_cov_51.005800	334	414	14	9	80	0.1125000
NODE_7423_length_961_cov_51.005800	387	467	4	3	80	0.0375000
NODE_7423_length_961_cov_51.005800	387	467	8	11	80	0.1375000
NODE_7423_length_961_cov_51.005800	387	467	12	57	80	0.7125000
NODE_7423_length_961_cov_51.005800	387	467	14	9	80	0.1125000
NODE_7424_length_961_cov_45.923434	391	471	2	43	80	0.5375000
NODE_7424_length_961_cov_45.923434	391	471	14	3	80	0.0375000
NODE_7424_length_961_cov_45.923434	391	471	26	16	80	0.2000000
NODE_7424_length_961_cov_45.923434	391	471	28	18	80	0.2250000
NODE_7424_length_961_cov_45.923434	444	524	26	21	80	0.2625000
NODE_7424_length_961_cov_45.923434	444	524	28	23	80	0.2875000
NODE_7424_length_961_cov_45.923434	444	524	31	2	80	0.0250000
NODE_7424_length_961_cov_45.923434	444	524	32	34	80	0.4250000
NODE_7426_length_961_cov_21.410673	313	393	0	35	80	0.4375000
NODE_7426_length_961_cov_21.410673	313	393	8	25	80	0.3125000
NODE_7426_length_961_cov_21.410673	313	393	10	20	80	0.2500000
NODE_7426_length_961_cov_21.410673	366	446	8	7	80	0.0875000
NODE_7426_length_961_cov_21.410673	366	446	10	73	80	0.9125000
NODE_7427_length_961_cov_18.592807	403	483	0	80	80	1.0000000
NODE_7427_length_961_cov_18.592807	456	536	0	80	80	1.0000000
NODE_7428_length_961_cov_17.701856	433	513	0	80	80	1.0000000
NODE_7428_length_961_cov_17.701856	486	566	0	70	80	0.8750000
NODE_7428_length_961_cov_17.701856	486	566	1	10	80	0.1250000
NODE_7429_length_961_cov_17.020882	505	585	2	25	80	0.3125000
NODE_7429_length_961_cov_17.020882	505	585	4	5	80	0.0625000
NODE_7429_length_961_cov_17.020882	505	585	5	2	80	0.0250000
NODE_7429_length_961_cov_17.020882	505	585	6	48	80	0.6000000
NODE_7429_length_961_cov_17.020882	558	638	0	49	80	0.6125000
NODE_7429_length_961_cov_17.020882	558	638	2	29	80	0.3625000
NODE_7429_length_961_cov_17.020882	558	638	4	2	80	0.0250000
NODE_7430_length_961_cov_16.235499	328	408	2	80	80	1.0000000
NODE_7430_length_961_cov_16.235499	381	461	0	27	80	0.3375000
NODE_7430_length_961_cov_16.235499	381	461	2	53	80	0.6625000
NODE_7432_length_961_cov_12.968677	347	427	0	80	80	1.0000000
NODE_7432_length_961_cov_12.968677	400	480	0	80	80	1.0000000
NODE_7433_length_961_cov_9.875870	439	519	0	80	80	1.0000000
NODE_7433_length_961_cov_9.875870	492	572	0	80	80	1.0000000
NODE_7434_length_961_cov_6.172854	624	704	0	80	80	1.0000000
NODE_7434_length_961_cov_6.172854	677	757	0	80	80	1.0000000
NODE_7435_length_961_cov_4.553364	451	531	0	9	80	0.1125000
NODE_7435_length_961_cov_4.553364	451	531	2	71	80	0.8875000
NODE_7435_length_961_cov_4.553364	504	584	0	22	80	0.2750000
NODE_7435_length_961_cov_4.553364	504	584	2	58	80	0.7250000
NODE_7440_length_960_cov_35.649245	65	145	0	18	80	0.2250000
NODE_7440_length_960_cov_35.649245	65	145	2	62	80	0.7750000
NODE_7440_length_960_cov_35.649245	118	198	0	52	80	0.6500000
NODE_7440_length_960_cov_35.649245	118	198	2	28	80	0.3500000
NODE_7440_length_960_cov_35.649245	446	526	0	4	80	0.0500000
NODE_7440_length_960_cov_35.649245	446	526	2	76	80	0.9500000
NODE_7440_length_960_cov_35.649245	499	579	0	57	80	0.7125000
NODE_7440_length_960_cov_35.649245	499	579	2	23	80	0.2875000
NODE_7441_length_960_cov_34.886179	386	466	2	80	80	1.0000000
NODE_7441_length_960_cov_34.886179	439	519	0	39	80	0.4875000
NODE_7441_length_960_cov_34.886179	439	519	2	41	80	0.5125000
NODE_7443_length_960_cov_25.133566	413	493	0	80	80	1.0000000
NODE_7443_length_960_cov_25.133566	466	546	0	80	80	1.0000000
NODE_7444_length_960_cov_19.336818	385	465	0	24	80	0.3000000
NODE_7444_length_960_cov_19.336818	385	465	6	27	80	0.3375000
NODE_7444_length_960_cov_19.336818	385	465	8	29	80	0.3625000
NODE_7444_length_960_cov_19.336818	438	518	2	13	80	0.1625000
NODE_7444_length_960_cov_19.336818	438	518	8	67	80	0.8375000
NODE_7445_length_960_cov_13.221835	460	539	0	79	79	1.0000000
NODE_7445_length_960_cov_13.221835	512	592	0	80	80	1.0000000
NODE_7446_length_960_cov_12.804878	347	427	0	80	80	1.0000000
NODE_7446_length_960_cov_12.804878	400	480	0	80	80	1.0000000
NODE_7462_length_959_cov_39.394186	326	406	0	80	80	1.0000000
NODE_7462_length_959_cov_39.394186	379	459	0	80	80	1.0000000
NODE_7463_length_959_cov_28.895349	327	407	6	33	80	0.4125000
NODE_7463_length_959_cov_28.895349	327	407	9	33	80	0.4125000
NODE_7463_length_959_cov_28.895349	327	407	10	14	80	0.1750000
NODE_7463_length_959_cov_28.895349	380	460	5	13	80	0.1625000
NODE_7463_length_959_cov_28.895349	380	460	6	13	80	0.1625000
NODE_7463_length_959_cov_28.895349	380	460	7	28	80	0.3500000
NODE_7463_length_959_cov_28.895349	380	460	9	1	80	0.0125000
NODE_7463_length_959_cov_28.895349	380	460	10	25	80	0.3125000
NODE_7464_length_959_cov_26.634884	563	643	0	80	80	1.0000000
NODE_7464_length_959_cov_26.634884	616	696	0	80	80	1.0000000
NODE_7464_length_959_cov_26.634884	692	772	0	51	80	0.6375000
NODE_7464_length_959_cov_26.634884	692	772	2	29	80	0.3625000
NODE_7464_length_959_cov_26.634884	745	825	0	6	80	0.0750000
NODE_7464_length_959_cov_26.634884	745	825	2	74	80	0.9250000
NODE_7465_length_959_cov_18.862791	320	400	0	47	80	0.5875000
NODE_7465_length_959_cov_18.862791	320	400	4	33	80	0.4125000
NODE_7465_length_959_cov_18.862791	373	453	0	16	80	0.2000000
NODE_7465_length_959_cov_18.862791	373	453	4	64	80	0.8000000
NODE_7466_length_959_cov_17.910465	358	438	2	80	80	1.0000000
NODE_7466_length_959_cov_17.910465	411	491	0	53	80	0.6625000
NODE_7466_length_959_cov_17.910465	411	491	2	27	80	0.3375000
NODE_7467_length_959_cov_15.337209	267	347	2	39	80	0.4875000
NODE_7467_length_959_cov_15.337209	267	347	6	25	80	0.3125000
NODE_7467_length_959_cov_15.337209	267	347	8	16	80	0.2000000
NODE_7467_length_959_cov_15.337209	320	400	6	28	80	0.3500000
NODE_7467_length_959_cov_15.337209	320	400	8	52	80	0.6500000
NODE_7468_length_959_cov_9.005814	529	609	0	80	80	1.0000000
NODE_7468_length_959_cov_9.005814	582	662	0	80	80	1.0000000
NODE_7469_length_959_cov_8.163953	392	472	0	80	80	1.0000000
NODE_7469_length_959_cov_8.163953	445	525	0	53	80	0.6625000
NODE_7469_length_959_cov_8.163953	445	525	2	27	80	0.3375000
NODE_7470_length_959_cov_7.097674	401	481	4	27	80	0.3375000
NODE_7470_length_959_cov_7.097674	401	481	5	5	80	0.0625000
NODE_7470_length_959_cov_7.097674	401	481	7	9	80	0.1125000
NODE_7470_length_959_cov_7.097674	401	481	8	39	80	0.4875000
NODE_7470_length_959_cov_7.097674	454	534	2	6	80	0.0750000
NODE_7470_length_959_cov_7.097674	454	534	4	31	80	0.3875000
NODE_7470_length_959_cov_7.097674	454	534	8	43	80	0.5375000
NODE_7472_length_959_cov_4.603488	596	676	0	60	80	0.7500000
NODE_7472_length_959_cov_4.603488	596	676	1	2	80	0.0250000
NODE_7472_length_959_cov_4.603488	596	676	3	1	80	0.0125000
NODE_7472_length_959_cov_4.603488	596	676	4	17	80	0.2125000
NODE_7472_length_959_cov_4.603488	649	729	0	7	80	0.0875000
NODE_7472_length_959_cov_4.603488	649	729	1	2	80	0.0250000
NODE_7472_length_959_cov_4.603488	649	729	3	1	80	0.0125000
NODE_7472_length_959_cov_4.603488	649	729	4	70	80	0.8750000
NODE_7486_length_958_cov_57.015134	328	408	0	80	80	1.0000000
NODE_7486_length_958_cov_57.015134	381	461	0	80	80	1.0000000
NODE_7486_length_958_cov_57.015134	457	537	0	80	80	1.0000000
NODE_7486_length_958_cov_57.015134	510	590	0	80	80	1.0000000
NODE_7487_length_958_cov_42.265425	418	498	0	80	80	1.0000000
NODE_7487_length_958_cov_42.265425	471	551	0	50	80	0.6250000
NODE_7487_length_958_cov_42.265425	471	551	2	30	80	0.3750000
NODE_7488_length_958_cov_28.618161	336	416	2	40	80	0.5000000
NODE_7488_length_958_cov_28.618161	336	416	6	22	80	0.2750000
NODE_7488_length_958_cov_28.618161	336	416	8	18	80	0.2250000
NODE_7488_length_958_cov_28.618161	389	469	0	35	80	0.4375000
NODE_7488_length_958_cov_28.618161	389	469	2	45	80	0.5625000
NODE_7488_length_958_cov_28.618161	465	545	0	80	80	1.0000000
NODE_7488_length_958_cov_28.618161	518	598	0	80	80	1.0000000
NODE_7489_length_958_cov_16.452852	446	526	0	37	80	0.4625000
NODE_7489_length_958_cov_16.452852	446	526	2	43	80	0.5375000
NODE_7489_length_958_cov_16.452852	499	579	0	27	80	0.3375000
NODE_7489_length_958_cov_16.452852	499	579	2	53	80	0.6625000
NODE_7490_length_958_cov_16.008149	446	526	0	80	80	1.0000000
NODE_7490_length_958_cov_16.008149	499	579	0	80	80	1.0000000
NODE_7491_length_958_cov_14.154831	516	596	0	80	80	1.0000000
NODE_7491_length_958_cov_14.154831	569	649	0	80	80	1.0000000
NODE_7492_length_958_cov_12.381839	454	534	0	80	80	1.0000000
NODE_7492_length_958_cov_12.381839	507	587	0	80	80	1.0000000
NODE_7493_length_958_cov_11.782305	479	559	0	80	80	1.0000000
NODE_7493_length_958_cov_11.782305	532	612	0	80	80	1.0000000
NODE_7501_length_957_cov_40.837995	746	826	0	59	80	0.7375000
NODE_7501_length_957_cov_40.837995	746	826	2	21	80	0.2625000
NODE_7501_length_957_cov_40.837995	799	879	0	20	80	0.2500000
NODE_7501_length_957_cov_40.837995	799	879	2	60	80	0.7500000
NODE_7502_length_957_cov_25.976690	631	711	0	80	80	1.0000000
NODE_7502_length_957_cov_25.976690	684	764	0	80	80	1.0000000
NODE_7503_length_957_cov_25.855478	57	131	6	8	74	0.1081081
NODE_7503_length_957_cov_25.855478	57	131	8	9	74	0.1216216
NODE_7503_length_957_cov_25.855478	57	131	10	3	74	0.0405405
NODE_7503_length_957_cov_25.855478	57	131	12	54	74	0.7297297
NODE_7503_length_957_cov_25.855478	414	494	0	80	80	1.0000000
NODE_7503_length_957_cov_25.855478	467	547	0	80	80	1.0000000
NODE_7504_length_957_cov_24.625874	445	525	8	20	80	0.2500000
NODE_7504_length_957_cov_24.625874	445	525	10	60	80	0.7500000
NODE_7504_length_957_cov_24.625874	498	578	0	37	80	0.4625000
NODE_7504_length_957_cov_24.625874	498	578	4	1	80	0.0125000
NODE_7504_length_957_cov_24.625874	498	578	8	11	80	0.1375000
NODE_7504_length_957_cov_24.625874	498	578	10	31	80	0.3875000
NODE_7505_length_957_cov_19.955711	286	366	2	46	80	0.5750000
NODE_7505_length_957_cov_19.955711	286	366	3	34	80	0.4250000
NODE_7505_length_957_cov_19.955711	339	419	0	38	80	0.4750000
NODE_7505_length_957_cov_19.955711	339	419	2	1	80	0.0125000
NODE_7505_length_957_cov_19.955711	339	419	3	41	80	0.5125000
NODE_7506_length_957_cov_18.861305	414	494	0	80	80	1.0000000
NODE_7506_length_957_cov_18.861305	467	547	0	80	80	1.0000000
NODE_7507_length_957_cov_17.356643	361	441	2	80	80	1.0000000
NODE_7507_length_957_cov_17.356643	414	494	0	5	80	0.0625000
NODE_7507_length_957_cov_17.356643	414	494	2	75	80	0.9375000
NODE_7508_length_957_cov_13.569930	162	242	0	44	80	0.5500000
NODE_7508_length_957_cov_13.569930	162	242	2	36	80	0.4500000
NODE_7508_length_957_cov_13.569930	215	299	0	17	84	0.2023810
NODE_7508_length_957_cov_13.569930	215	299	2	67	84	0.7976190
NODE_7509_length_957_cov_12.334499	314	394	0	80	80	1.0000000
NODE_7509_length_957_cov_12.334499	367	447	0	80	80	1.0000000
NODE_7510_length_957_cov_12.017483	173	253	0	61	80	0.7625000
NODE_7510_length_957_cov_12.017483	173	253	4	19	80	0.2375000
NODE_7510_length_957_cov_12.017483	226	306	0	29	80	0.3625000
NODE_7510_length_957_cov_12.017483	226	306	4	51	80	0.6375000
NODE_7511_length_957_cov_10.026807	446	526	0	80	80	1.0000000
NODE_7511_length_957_cov_10.026807	499	579	0	80	80	1.0000000
NODE_7529_length_956_cov_48.047841	479	559	0	35	80	0.4375000
NODE_7529_length_956_cov_48.047841	479	559	2	45	80	0.5625000
NODE_7529_length_956_cov_48.047841	532	612	0	6	80	0.0750000
NODE_7529_length_956_cov_48.047841	532	612	2	74	80	0.9250000
NODE_7529_length_956_cov_48.047841	608	688	0	30	80	0.3750000
NODE_7529_length_956_cov_48.047841	608	688	2	50	80	0.6250000
NODE_7529_length_956_cov_48.047841	661	741	0	13	80	0.1625000
NODE_7529_length_956_cov_48.047841	661	741	2	64	80	0.8000000
NODE_7529_length_956_cov_48.047841	661	741	4	3	80	0.0375000
NODE_7530_length_956_cov_34.539090	298	378	0	80	80	1.0000000
NODE_7530_length_956_cov_34.539090	351	431	0	80	80	1.0000000
NODE_7530_length_956_cov_34.539090	427	507	0	80	80	1.0000000
NODE_7530_length_956_cov_34.539090	480	560	0	70	80	0.8750000
NODE_7530_length_956_cov_34.539090	480	560	4	10	80	0.1250000
NODE_7531_length_956_cov_24.355893	398	478	0	80	80	1.0000000
NODE_7531_length_956_cov_24.355893	451	531	0	80	80	1.0000000
NODE_7532_length_956_cov_21.940490	373	453	0	80	80	1.0000000
NODE_7532_length_956_cov_21.940490	426	506	0	67	80	0.8375000
NODE_7532_length_956_cov_21.940490	426	506	2	13	80	0.1625000
NODE_7532_length_956_cov_21.940490	502	582	2	10	80	0.1250000
NODE_7532_length_956_cov_21.940490	502	582	4	70	80	0.8750000
NODE_7532_length_956_cov_21.940490	555	635	0	51	80	0.6375000
NODE_7532_length_956_cov_21.940490	555	635	2	6	80	0.0750000
NODE_7532_length_956_cov_21.940490	555	635	4	23	80	0.2875000
NODE_7533_length_956_cov_19.435239	274	354	0	80	80	1.0000000
NODE_7533_length_956_cov_19.435239	274	301	0	27	27	1.0000000
NODE_7534_length_956_cov_17.819137	378	458	8	80	80	1.0000000
NODE_7534_length_956_cov_17.819137	431	511	4	9	80	0.1125000
NODE_7534_length_956_cov_17.819137	431	511	6	21	80	0.2625000
NODE_7534_length_956_cov_17.819137	431	511	8	50	80	0.6250000
NODE_7535_length_956_cov_16.098016	551	631	0	9	80	0.1125000
NODE_7535_length_956_cov_16.098016	551	631	1	7	80	0.0875000
NODE_7535_length_956_cov_16.098016	551	631	2	64	80	0.8000000
NODE_7535_length_956_cov_16.098016	604	684	0	62	80	0.7750000
NODE_7535_length_956_cov_16.098016	604	684	1	7	80	0.0875000
NODE_7535_length_956_cov_16.098016	604	684	2	11	80	0.1375000
NODE_7536_length_956_cov_15.229872	490	570	0	80	80	1.0000000
NODE_7536_length_956_cov_15.229872	543	623	0	80	80	1.0000000
NODE_7537_length_956_cov_7.533256	439	519	2	17	80	0.2125000
NODE_7537_length_956_cov_7.533256	439	519	6	63	80	0.7875000
NODE_7537_length_956_cov_7.533256	497	572	0	29	75	0.3866667
NODE_7537_length_956_cov_7.533256	497	572	2	41	75	0.5466667
NODE_7537_length_956_cov_7.533256	497	572	6	5	75	0.0666667
NODE_7545_length_955_cov_30.821262	438	518	0	7	80	0.0875000
NODE_7545_length_955_cov_30.821262	438	518	1	13	80	0.1625000
NODE_7545_length_955_cov_30.821262	438	518	2	25	80	0.3125000
NODE_7545_length_955_cov_30.821262	438	518	3	22	80	0.2750000
NODE_7545_length_955_cov_30.821262	438	518	4	13	80	0.1625000
NODE_7545_length_955_cov_30.821262	491	571	0	2	80	0.0250000
NODE_7545_length_955_cov_30.821262	491	571	2	78	80	0.9750000
NODE_7546_length_955_cov_30.574766	380	460	2	11	80	0.1375000
NODE_7546_length_955_cov_30.574766	380	460	4	7	80	0.0875000
NODE_7546_length_955_cov_30.574766	380	460	6	37	80	0.4625000
NODE_7546_length_955_cov_30.574766	380	460	8	25	80	0.3125000
NODE_7546_length_955_cov_30.574766	433	513	0	21	80	0.2625000
NODE_7546_length_955_cov_30.574766	433	513	2	8	80	0.1000000
NODE_7546_length_955_cov_30.574766	433	513	4	12	80	0.1500000
NODE_7546_length_955_cov_30.574766	433	513	6	39	80	0.4875000
NODE_7546_length_955_cov_30.574766	509	589	0	37	80	0.4625000
NODE_7546_length_955_cov_30.574766	509	589	2	43	80	0.5375000
NODE_7546_length_955_cov_30.574766	562	642	1	16	80	0.2000000
NODE_7546_length_955_cov_30.574766	562	642	2	44	80	0.5500000
NODE_7546_length_955_cov_30.574766	562	642	3	20	80	0.2500000
NODE_7547_length_955_cov_27.734813	373	453	0	15	80	0.1875000
NODE_7547_length_955_cov_27.734813	373	453	14	1	80	0.0125000
NODE_7547_length_955_cov_27.734813	373	453	15	15	80	0.1875000
NODE_7547_length_955_cov_27.734813	373	453	16	1	80	0.0125000
NODE_7547_length_955_cov_27.734813	373	453	17	3	80	0.0375000
NODE_7547_length_955_cov_27.734813	373	453	19	8	80	0.1000000
NODE_7547_length_955_cov_27.734813	373	453	20	37	80	0.4625000
NODE_7547_length_955_cov_27.734813	426	506	13	5	80	0.0625000
NODE_7547_length_955_cov_27.734813	426	506	14	3	80	0.0375000
NODE_7547_length_955_cov_27.734813	426	506	15	11	80	0.1375000
NODE_7547_length_955_cov_27.734813	426	506	16	35	80	0.4375000
NODE_7547_length_955_cov_27.734813	426	506	20	26	80	0.3250000
NODE_7548_length_955_cov_24.475467	439	519	0	17	80	0.2125000
NODE_7548_length_955_cov_24.475467	439	519	2	25	80	0.3125000
NODE_7548_length_955_cov_24.475467	439	519	4	38	80	0.4750000
NODE_7548_length_955_cov_24.475467	492	572	4	80	80	1.0000000
NODE_7549_length_955_cov_22.146028	351	431	4	79	80	0.9875000
NODE_7549_length_955_cov_22.146028	351	431	6	1	80	0.0125000
NODE_7549_length_955_cov_22.146028	404	484	4	26	80	0.3250000
NODE_7549_length_955_cov_22.146028	404	484	6	18	80	0.2250000
NODE_7549_length_955_cov_22.146028	404	484	8	9	80	0.1125000
NODE_7549_length_955_cov_22.146028	404	484	13	4	80	0.0500000
NODE_7549_length_955_cov_22.146028	404	484	14	2	80	0.0250000
NODE_7549_length_955_cov_22.146028	404	484	15	12	80	0.1500000
NODE_7549_length_955_cov_22.146028	404	484	16	9	80	0.1125000
NODE_7550_length_955_cov_16.212617	441	521	0	27	80	0.3375000
NODE_7550_length_955_cov_16.212617	441	521	6	53	80	0.6625000
NODE_7550_length_955_cov_16.212617	494	574	4	21	80	0.2625000
NODE_7550_length_955_cov_16.212617	494	574	6	59	80	0.7375000
NODE_7551_length_955_cov_13.334112	269	349	0	5	80	0.0625000
NODE_7551_length_955_cov_13.334112	269	349	2	75	80	0.9375000
NODE_7551_length_955_cov_13.334112	322	402	0	58	80	0.7250000
NODE_7551_length_955_cov_13.334112	322	402	2	22	80	0.2750000
NODE_7552_length_955_cov_12.544393	363	443	0	80	80	1.0000000
NODE_7552_length_955_cov_12.544393	416	496	0	80	80	1.0000000
NODE_7553_length_955_cov_8.204439	358	438	0	39	80	0.4875000
NODE_7553_length_955_cov_8.204439	358	438	2	41	80	0.5125000
NODE_7553_length_955_cov_8.204439	411	491	0	80	80	1.0000000
NODE_7563_length_954_cov_35.691228	381	461	10	36	80	0.4500000
NODE_7563_length_954_cov_35.691228	381	461	11	12	80	0.1500000
NODE_7563_length_954_cov_35.691228	381	461	13	29	80	0.3625000
NODE_7563_length_954_cov_35.691228	381	461	14	3	80	0.0375000
NODE_7563_length_954_cov_35.691228	434	514	0	36	80	0.4500000
NODE_7563_length_954_cov_35.691228	434	514	2	3	80	0.0375000
NODE_7563_length_954_cov_35.691228	434	514	10	41	80	0.5125000
NODE_7564_length_954_cov_30.769591	408	488	0	10	80	0.1250000
NODE_7564_length_954_cov_30.769591	408	488	4	70	80	0.8750000
NODE_7564_length_954_cov_30.769591	461	541	0	63	80	0.7875000
NODE_7564_length_954_cov_30.769591	461	541	4	17	80	0.2125000
NODE_7565_length_954_cov_27.247953	418	498	0	44	80	0.5500000
NODE_7565_length_954_cov_27.247953	418	498	2	36	80	0.4500000
NODE_7565_length_954_cov_27.247953	471	551	0	17	80	0.2125000
NODE_7565_length_954_cov_27.247953	471	551	2	63	80	0.7875000
NODE_7566_length_954_cov_22.796491	270	350	0	80	80	1.0000000
NODE_7566_length_954_cov_22.796491	323	403	0	59	80	0.7375000
NODE_7566_length_954_cov_22.796491	323	403	3	21	80	0.2625000
NODE_7567_length_954_cov_15.645614	337	417	0	33	80	0.4125000
NODE_7567_length_954_cov_15.645614	337	417	2	47	80	0.5875000
NODE_7567_length_954_cov_15.645614	390	470	2	31	80	0.3875000
NODE_7567_length_954_cov_15.645614	390	470	4	20	80	0.2500000
NODE_7567_length_954_cov_15.645614	390	470	5	1	80	0.0125000
NODE_7567_length_954_cov_15.645614	390	470	6	28	80	0.3500000
NODE_7568_length_954_cov_13.538012	346	426	0	28	80	0.3500000
NODE_7568_length_954_cov_13.538012	346	426	2	52	80	0.6500000
NODE_7568_length_954_cov_13.538012	399	479	0	62	80	0.7750000
NODE_7568_length_954_cov_13.538012	399	479	2	18	80	0.2250000
NODE_7569_length_954_cov_12.162573	155	217	0	50	62	0.8064516
NODE_7569_length_954_cov_12.162573	155	217	2	1	62	0.0161290
NODE_7569_length_954_cov_12.162573	155	217	4	11	62	0.1774193
NODE_7570_length_954_cov_10.714620	239	319	0	28	80	0.3500000
NODE_7570_length_954_cov_10.714620	239	319	2	52	80	0.6500000
NODE_7570_length_954_cov_10.714620	292	372	0	25	80	0.3125000
NODE_7570_length_954_cov_10.714620	292	372	2	55	80	0.6875000
NODE_7571_length_954_cov_5.670175	431	511	0	75	80	0.9375000
NODE_7571_length_954_cov_5.670175	431	511	2	5	80	0.0625000
NODE_7571_length_954_cov_5.670175	484	564	0	80	80	1.0000000
NODE_7582_length_953_cov_35.789227	425	505	0	52	80	0.6500000
NODE_7582_length_953_cov_35.789227	425	505	6	28	80	0.3500000
NODE_7582_length_953_cov_35.789227	478	558	6	80	80	1.0000000
NODE_7583_length_953_cov_33.940281	430	510	0	55	80	0.6875000
NODE_7583_length_953_cov_33.940281	430	510	2	25	80	0.3125000
NODE_7583_length_953_cov_33.940281	483	563	0	2	80	0.0250000
NODE_7583_length_953_cov_33.940281	483	563	2	78	80	0.9750000
NODE_7584_length_953_cov_26.844262	333	413	2	80	80	1.0000000
NODE_7584_length_953_cov_26.844262	386	466	0	24	80	0.3000000
NODE_7584_length_953_cov_26.844262	386	466	2	56	80	0.7000000
NODE_7584_length_953_cov_26.844262	462	542	0	14	80	0.1750000
NODE_7584_length_953_cov_26.844262	462	542	6	15	80	0.1875000
NODE_7584_length_953_cov_26.844262	462	542	10	11	80	0.1375000
NODE_7584_length_953_cov_26.844262	462	542	12	40	80	0.5000000
NODE_7584_length_953_cov_26.844262	515	595	6	26	80	0.3250000
NODE_7584_length_953_cov_26.844262	515	595	12	54	80	0.6750000
NODE_7585_length_953_cov_20.770492	301	381	0	26	80	0.3250000
NODE_7585_length_953_cov_20.770492	301	381	2	10	80	0.1250000
NODE_7585_length_953_cov_20.770492	301	381	4	12	80	0.1500000
NODE_7585_length_953_cov_20.770492	301	381	6	32	80	0.4000000
NODE_7585_length_953_cov_20.770492	354	434	2	17	80	0.2125000
NODE_7585_length_953_cov_20.770492	354	434	4	11	80	0.1375000
NODE_7585_length_953_cov_20.770492	354	434	6	52	80	0.6500000
NODE_7586_length_953_cov_17.514052	421	501	0	80	80	1.0000000
NODE_7586_length_953_cov_17.514052	474	554	0	80	80	1.0000000
NODE_7586_length_953_cov_17.514052	550	630	0	80	80	1.0000000
NODE_7586_length_953_cov_17.514052	603	683	0	80	80	1.0000000
NODE_7587_length_953_cov_11.579625	332	412	0	80	80	1.0000000
NODE_7587_length_953_cov_11.579625	385	465	0	80	80	1.0000000
NODE_7588_length_953_cov_7.281030	276	356	0	80	80	1.0000000
NODE_7588_length_953_cov_7.281030	329	409	0	80	80	1.0000000
NODE_7599_length_952_cov_44.880422	447	527	0	80	80	1.0000000
NODE_7599_length_952_cov_44.880422	500	580	0	36	80	0.4500000
NODE_7599_length_952_cov_44.880422	500	580	2	44	80	0.5500000
NODE_7599_length_952_cov_44.880422	871	951	0	80	80	1.0000000
NODE_7600_length_952_cov_42.485346	402	482	0	80	80	1.0000000
NODE_7600_length_952_cov_42.485346	455	535	0	44	80	0.5500000
NODE_7600_length_952_cov_42.485346	455	535	2	4	80	0.0500000
NODE_7600_length_952_cov_42.485346	455	535	4	32	80	0.4000000
NODE_7601_length_952_cov_40.065651	422	502	2	32	80	0.4000000
NODE_7601_length_952_cov_40.065651	422	502	4	14	80	0.1750000
NODE_7601_length_952_cov_40.065651	422	502	6	34	80	0.4250000
NODE_7601_length_952_cov_40.065651	475	555	4	57	80	0.7125000
NODE_7601_length_952_cov_40.065651	475	555	6	23	80	0.2875000
NODE_7602_length_952_cov_34.813599	308	388	0	4	80	0.0500000
NODE_7602_length_952_cov_34.813599	308	388	4	76	80	0.9500000
NODE_7602_length_952_cov_34.813599	361	441	2	24	80	0.3000000
NODE_7602_length_952_cov_34.813599	361	441	4	37	80	0.4625000
NODE_7602_length_952_cov_34.813599	361	441	6	19	80	0.2375000
NODE_7603_length_952_cov_28.055100	661	741	0	80	80	1.0000000
NODE_7603_length_952_cov_28.055100	714	794	0	80	80	1.0000000
NODE_7604_length_952_cov_23.739742	435	515	0	18	80	0.2250000
NODE_7604_length_952_cov_23.739742	435	515	2	62	80	0.7750000
NODE_7604_length_952_cov_23.739742	488	568	0	71	80	0.8875000
NODE_7604_length_952_cov_23.739742	488	568	2	9	80	0.1125000
NODE_7606_length_952_cov_11.478312	245	324	0	79	79	1.0000000
NODE_7606_length_952_cov_11.478312	297	377	0	80	80	1.0000000
NODE_7607_length_952_cov_11.284877	272	352	0	80	80	1.0000000
NODE_7607_length_952_cov_11.284877	325	405	0	80	80	1.0000000
NODE_7608_length_952_cov_10.807737	458	538	0	80	80	1.0000000
NODE_7608_length_952_cov_10.807737	511	591	0	80	80	1.0000000
NODE_7609_length_952_cov_8.770223	375	455	0	80	80	1.0000000
NODE_7609_length_952_cov_8.770223	428	508	0	80	80	1.0000000
NODE_7623_length_951_cov_54.397887	354	434	0	80	80	1.0000000
NODE_7623_length_951_cov_54.397887	407	487	0	80	80	1.0000000
NODE_7623_length_951_cov_54.397887	483	563	0	80	80	1.0000000
NODE_7623_length_951_cov_54.397887	544	616	0	72	72	1.0000000
NODE_7624_length_951_cov_47.881455	355	435	0	80	80	1.0000000
NODE_7624_length_951_cov_47.881455	408	488	0	80	80	1.0000000
NODE_7624_length_951_cov_47.881455	484	564	0	49	80	0.6125000
NODE_7624_length_951_cov_47.881455	484	564	6	24	80	0.3000000
NODE_7624_length_951_cov_47.881455	484	564	8	3	80	0.0375000
NODE_7624_length_951_cov_47.881455	484	564	10	4	80	0.0500000
NODE_7624_length_951_cov_47.881455	537	617	6	20	80	0.2500000
NODE_7624_length_951_cov_47.881455	537	617	8	3	80	0.0375000
NODE_7624_length_951_cov_47.881455	537	617	10	57	80	0.7125000
NODE_7625_length_951_cov_24.322770	479	559	0	11	80	0.1375000
NODE_7625_length_951_cov_24.322770	479	559	2	69	80	0.8625000
NODE_7625_length_951_cov_24.322770	532	612	0	2	80	0.0250000
NODE_7625_length_951_cov_24.322770	532	612	2	78	80	0.9750000
NODE_7626_length_951_cov_23.001174	470	550	4	64	80	0.8000000
NODE_7626_length_951_cov_23.001174	470	550	6	16	80	0.2000000
NODE_7626_length_951_cov_23.001174	523	603	2	39	80	0.4875000
NODE_7626_length_951_cov_23.001174	523	603	4	25	80	0.3125000
NODE_7626_length_951_cov_23.001174	523	603	6	16	80	0.2000000
NODE_7627_length_951_cov_22.059859	562	642	0	80	80	1.0000000
NODE_7627_length_951_cov_22.059859	615	695	0	80	80	1.0000000
NODE_7628_length_951_cov_19.413146	456	536	6	80	80	1.0000000
NODE_7628_length_951_cov_19.413146	509	589	0	31	80	0.3875000
NODE_7628_length_951_cov_19.413146	509	589	6	49	80	0.6125000
NODE_7628_length_951_cov_19.413146	830	877	0	47	47	1.0000000
NODE_7629_length_951_cov_18.970657	384	464	0	13	80	0.1625000
NODE_7629_length_951_cov_18.970657	384	464	4	67	80	0.8375000
NODE_7629_length_951_cov_18.970657	437	517	4	80	80	1.0000000
NODE_7629_length_951_cov_18.970657	513	593	0	51	80	0.6375000
NODE_7629_length_951_cov_18.970657	513	593	4	29	80	0.3625000
NODE_7629_length_951_cov_18.970657	566	646	0	80	80	1.0000000
NODE_7630_length_951_cov_17.164319	409	490	4	18	81	0.2222222
NODE_7630_length_951_cov_17.164319	409	490	10	63	81	0.7777778
NODE_7630_length_951_cov_17.164319	463	543	0	50	80	0.6250000
NODE_7630_length_951_cov_17.164319	463	543	2	3	80	0.0375000
NODE_7630_length_951_cov_17.164319	463	543	4	18	80	0.2250000
NODE_7630_length_951_cov_17.164319	463	543	10	9	80	0.1125000
NODE_7631_length_951_cov_17.009390	393	473	0	23	80	0.2875000
NODE_7631_length_951_cov_17.009390	393	473	4	57	80	0.7125000
NODE_7631_length_951_cov_17.009390	446	526	0	17	80	0.2125000
NODE_7631_length_951_cov_17.009390	446	526	3	33	80	0.4125000
NODE_7631_length_951_cov_17.009390	446	526	4	30	80	0.3750000
NODE_7632_length_951_cov_15.551643	520	600	0	10	80	0.1250000
NODE_7632_length_951_cov_15.551643	520	600	2	7	80	0.0875000
NODE_7632_length_951_cov_15.551643	520	600	4	63	80	0.7875000
NODE_7632_length_951_cov_15.551643	573	653	0	10	80	0.1250000
NODE_7632_length_951_cov_15.551643	573	653	2	60	80	0.7500000
NODE_7632_length_951_cov_15.551643	573	653	4	10	80	0.1250000
NODE_7633_length_951_cov_13.562207	364	444	0	30	80	0.3750000
NODE_7633_length_951_cov_13.562207	364	444	2	23	80	0.2875000
NODE_7633_length_951_cov_13.562207	364	444	5	1	80	0.0125000
NODE_7633_length_951_cov_13.562207	364	444	6	26	80	0.3250000
NODE_7633_length_951_cov_13.562207	417	497	5	1	80	0.0125000
NODE_7633_length_951_cov_13.562207	417	497	6	79	80	0.9875000
NODE_7634_length_951_cov_13.086854	450	530	4	26	80	0.3250000
NODE_7634_length_951_cov_13.086854	450	530	8	54	80	0.6750000
NODE_7634_length_951_cov_13.086854	503	583	0	41	80	0.5125000
NODE_7634_length_951_cov_13.086854	503	583	4	22	80	0.2750000
NODE_7634_length_951_cov_13.086854	503	583	8	17	80	0.2125000
NODE_7635_length_951_cov_6.812207	350	430	0	1	80	0.0125000
NODE_7635_length_951_cov_6.812207	350	430	2	79	80	0.9875000
NODE_7635_length_951_cov_6.812207	403	483	0	37	80	0.4625000
NODE_7635_length_951_cov_6.812207	403	483	2	43	80	0.5375000
NODE_7636_length_951_cov_5.076291	80	160	0	38	80	0.4750000
NODE_7636_length_951_cov_5.076291	80	160	4	42	80	0.5250000
NODE_7636_length_951_cov_5.076291	133	213	0	15	80	0.1875000
NODE_7636_length_951_cov_5.076291	133	213	4	65	80	0.8125000
NODE_7649_length_950_cov_62.151586	731	794	2	19	63	0.3015873
NODE_7649_length_950_cov_62.151586	731	794	6	17	63	0.2698413
NODE_7649_length_950_cov_62.151586	731	794	8	27	63	0.4285714
NODE_7650_length_950_cov_56.088132	354	434	2	80	80	1.0000000
NODE_7650_length_950_cov_56.088132	407	487	0	35	80	0.4375000
NODE_7650_length_950_cov_56.088132	407	487	2	45	80	0.5625000
NODE_7650_length_950_cov_56.088132	483	563	0	80	80	1.0000000
NODE_7650_length_950_cov_56.088132	536	616	0	80	80	1.0000000
NODE_7651_length_950_cov_29.780259	501	581	2	80	80	1.0000000
NODE_7651_length_950_cov_29.780259	554	634	0	52	80	0.6500000
NODE_7651_length_950_cov_29.780259	554	634	2	28	80	0.3500000
NODE_7652_length_950_cov_27.278496	388	468	0	80	80	1.0000000
NODE_7652_length_950_cov_27.278496	441	519	0	78	78	1.0000000
NODE_7653_length_950_cov_26.766157	322	402	0	80	80	1.0000000
NODE_7653_length_950_cov_26.766157	375	455	0	80	80	1.0000000
NODE_7653_length_950_cov_26.766157	451	531	0	80	80	1.0000000
NODE_7653_length_950_cov_26.766157	504	584	0	80	80	1.0000000
NODE_7654_length_950_cov_19.638073	421	501	0	80	80	1.0000000
NODE_7654_length_950_cov_19.638073	474	554	0	80	80	1.0000000
NODE_7654_length_950_cov_19.638073	550	630	0	34	80	0.4250000
NODE_7654_length_950_cov_19.638073	550	630	4	46	80	0.5750000
NODE_7654_length_950_cov_19.638073	603	683	4	80	80	1.0000000
NODE_7655_length_950_cov_14.686251	376	456	0	80	80	1.0000000
NODE_7655_length_950_cov_14.686251	429	509	0	80	80	1.0000000
NODE_7656_length_950_cov_14.215041	339	419	0	80	80	1.0000000
NODE_7656_length_950_cov_14.215041	392	472	0	80	80	1.0000000
NODE_7657_length_950_cov_6.397180	370	450	0	80	80	1.0000000
NODE_7657_length_950_cov_6.397180	423	504	0	81	81	1.0000000
NODE_7659_length_950_cov_4.430082	594	674	0	80	80	1.0000000
NODE_7659_length_950_cov_4.430082	647	727	0	80	80	1.0000000
NODE_7672_length_949_cov_25.550588	371	451	0	80	80	1.0000000
NODE_7672_length_949_cov_25.550588	500	580	0	28	80	0.3500000
NODE_7672_length_949_cov_25.550588	500	580	4	52	80	0.6500000
NODE_7672_length_949_cov_25.550588	553	633	0	26	80	0.3250000
NODE_7672_length_949_cov_25.550588	553	633	4	54	80	0.6750000
NODE_7673_length_949_cov_20.949412	252	332	0	80	80	1.0000000
NODE_7673_length_949_cov_20.949412	305	385	0	80	80	1.0000000
NODE_7674_length_949_cov_20.601176	364	444	2	25	80	0.3125000
NODE_7674_length_949_cov_20.601176	364	444	4	55	80	0.6875000
NODE_7674_length_949_cov_20.601176	417	497	2	31	80	0.3875000
NODE_7674_length_949_cov_20.601176	417	497	4	49	80	0.6125000
NODE_7674_length_949_cov_20.601176	493	573	0	54	80	0.6750000
NODE_7674_length_949_cov_20.601176	493	573	2	26	80	0.3250000
NODE_7674_length_949_cov_20.601176	546	626	0	80	80	1.0000000
NODE_7675_length_949_cov_20.575294	481	561	0	9	80	0.1125000
NODE_7675_length_949_cov_20.575294	481	561	1	1	80	0.0125000
NODE_7675_length_949_cov_20.575294	481	561	2	70	80	0.8750000
NODE_7675_length_949_cov_20.575294	534	614	0	24	80	0.3000000
NODE_7675_length_949_cov_20.575294	534	614	2	56	80	0.7000000
NODE_7676_length_949_cov_19.483529	340	420	0	80	80	1.0000000
NODE_7676_length_949_cov_19.483529	393	473	0	80	80	1.0000000
NODE_7676_length_949_cov_19.483529	469	549	0	80	80	1.0000000
NODE_7676_length_949_cov_19.483529	522	602	0	80	80	1.0000000
NODE_7677_length_949_cov_19.407059	433	513	0	80	80	1.0000000
NODE_7677_length_949_cov_19.407059	486	566	0	80	80	1.0000000
NODE_7677_length_949_cov_19.407059	562	642	0	80	80	1.0000000
NODE_7677_length_949_cov_19.407059	615	695	0	80	80	1.0000000
NODE_7678_length_949_cov_10.903529	561	641	0	80	80	1.0000000
NODE_7678_length_949_cov_10.903529	614	694	0	80	80	1.0000000
NODE_7679_length_949_cov_7.245882	0	71	0	41	71	0.5774648
NODE_7679_length_949_cov_7.245882	0	71	2	13	71	0.1830986
NODE_7679_length_949_cov_7.245882	0	71	4	17	71	0.2394366
NODE_7679_length_949_cov_7.245882	0	71	0	41	71	0.5774648
NODE_7679_length_949_cov_7.245882	0	71	2	13	71	0.1830986
NODE_7679_length_949_cov_7.245882	0	71	4	17	71	0.2394366
NODE_7679_length_949_cov_7.245882	44	124	2	10	80	0.1250000
NODE_7679_length_949_cov_7.245882	44	124	4	26	80	0.3250000
NODE_7679_length_949_cov_7.245882	44	124	5	15	80	0.1875000
NODE_7679_length_949_cov_7.245882	44	124	6	7	80	0.0875000
NODE_7679_length_949_cov_7.245882	44	124	12	1	80	0.0125000
NODE_7679_length_949_cov_7.245882	44	124	13	21	80	0.2625000
NODE_7680_length_949_cov_6.998824	494	574	0	80	80	1.0000000
NODE_7680_length_949_cov_6.998824	547	627	0	80	80	1.0000000
NODE_7702_length_948_cov_37.201413	510	590	0	5	80	0.0625000
NODE_7702_length_948_cov_37.201413	510	590	3	1	80	0.0125000
NODE_7702_length_948_cov_37.201413	510	590	4	74	80	0.9250000
NODE_7702_length_948_cov_37.201413	563	643	0	58	80	0.7250000
NODE_7702_length_948_cov_37.201413	563	643	3	1	80	0.0125000
NODE_7702_length_948_cov_37.201413	563	643	4	21	80	0.2625000
NODE_7703_length_948_cov_20.082450	58	99	2	41	41	1.0000000
NODE_7703_length_948_cov_20.082450	113	193	6	5	80	0.0625000
NODE_7703_length_948_cov_20.082450	113	193	7	1	80	0.0125000
NODE_7703_length_948_cov_20.082450	113	193	8	3	80	0.0375000
NODE_7703_length_948_cov_20.082450	113	193	10	11	80	0.1375000
NODE_7703_length_948_cov_20.082450	113	193	11	7	80	0.0875000
NODE_7703_length_948_cov_20.082450	113	193	12	2	80	0.0250000
NODE_7703_length_948_cov_20.082450	113	193	13	3	80	0.0375000
NODE_7703_length_948_cov_20.082450	113	193	16	4	80	0.0500000
NODE_7703_length_948_cov_20.082450	113	193	17	20	80	0.2500000
NODE_7703_length_948_cov_20.082450	113	193	19	1	80	0.0125000
NODE_7703_length_948_cov_20.082450	113	193	22	3	80	0.0375000
NODE_7703_length_948_cov_20.082450	113	193	24	2	80	0.0250000
NODE_7703_length_948_cov_20.082450	113	193	26	5	80	0.0625000
NODE_7703_length_948_cov_20.082450	113	193	28	3	80	0.0375000
NODE_7703_length_948_cov_20.082450	113	193	30	6	80	0.0750000
NODE_7703_length_948_cov_20.082450	113	193	32	4	80	0.0500000
NODE_7703_length_948_cov_20.082450	166	246	17	3	80	0.0375000
NODE_7703_length_948_cov_20.082450	166	246	19	1	80	0.0125000
NODE_7703_length_948_cov_20.082450	166	246	22	3	80	0.0375000
NODE_7703_length_948_cov_20.082450	166	246	24	2	80	0.0250000
NODE_7703_length_948_cov_20.082450	166	246	26	5	80	0.0625000
NODE_7703_length_948_cov_20.082450	166	246	28	11	80	0.1375000
NODE_7703_length_948_cov_20.082450	166	246	29	12	80	0.1500000
NODE_7703_length_948_cov_20.082450	166	246	30	8	80	0.1000000
NODE_7703_length_948_cov_20.082450	166	246	32	32	80	0.4000000
NODE_7703_length_948_cov_20.082450	166	246	34	3	80	0.0375000
NODE_7704_length_948_cov_16.785630	308	388	0	80	80	1.0000000
NODE_7704_length_948_cov_16.785630	361	441	0	80	80	1.0000000
NODE_7704_length_948_cov_16.785630	437	517	0	80	80	1.0000000
NODE_7704_length_948_cov_16.785630	490	570	0	80	80	1.0000000
NODE_7705_length_948_cov_12.740872	400	480	0	5	80	0.0625000
NODE_7705_length_948_cov_12.740872	400	480	2	75	80	0.9375000
NODE_7705_length_948_cov_12.740872	453	533	0	58	80	0.7250000
NODE_7705_length_948_cov_12.740872	453	533	2	22	80	0.2750000
NODE_7706_length_948_cov_10.220259	465	545	0	80	80	1.0000000
NODE_7706_length_948_cov_10.220259	518	598	0	80	80	1.0000000
NODE_7707_length_948_cov_8.504122	456	536	0	80	80	1.0000000
NODE_7707_length_948_cov_8.504122	509	589	0	80	80	1.0000000
NODE_7709_length_948_cov_5.425206	641	721	2	12	80	0.1500000
NODE_7709_length_948_cov_5.425206	641	721	4	29	80	0.3625000
NODE_7709_length_948_cov_5.425206	641	721	6	39	80	0.4875000
NODE_7709_length_948_cov_5.425206	694	774	2	30	80	0.3750000
NODE_7709_length_948_cov_5.425206	694	774	4	35	80	0.4375000
NODE_7709_length_948_cov_5.425206	694	774	6	15	80	0.1875000
NODE_7711_length_948_cov_3.586572	696	776	8	80	80	1.0000000
NODE_7715_length_948_cov_2.786808	259	324	0	38	65	0.5846154
NODE_7715_length_948_cov_2.786808	259	324	4	27	65	0.4153846
NODE_7715_length_948_cov_2.786808	297	377	0	4	80	0.0500000
NODE_7715_length_948_cov_2.786808	297	377	4	76	80	0.9500000
NODE_7721_length_947_cov_91.466981	393	473	0	35	80	0.4375000
NODE_7721_length_947_cov_91.466981	393	473	2	45	80	0.5625000
NODE_7721_length_947_cov_91.466981	446	526	0	80	80	1.0000000
NODE_7722_length_947_cov_61.139151	402	482	0	67	80	0.8375000
NODE_7722_length_947_cov_61.139151	402	482	2	13	80	0.1625000
NODE_7722_length_947_cov_61.139151	455	535	0	14	80	0.1750000
NODE_7722_length_947_cov_61.139151	455	535	2	66	80	0.8250000
NODE_7723_length_947_cov_50.009434	488	568	0	80	80	1.0000000
NODE_7723_length_947_cov_50.009434	541	621	0	80	80	1.0000000
NODE_7724_length_947_cov_36.271226	511	591	0	80	80	1.0000000
NODE_7724_length_947_cov_36.271226	564	644	0	80	80	1.0000000
NODE_7725_length_947_cov_23.384434	425	505	2	68	80	0.8500000
NODE_7725_length_947_cov_23.384434	425	505	4	12	80	0.1500000
NODE_7725_length_947_cov_23.384434	478	558	0	48	80	0.6000000
NODE_7725_length_947_cov_23.384434	478	558	2	32	80	0.4000000
NODE_7726_length_947_cov_19.103774	316	396	0	14	80	0.1750000
NODE_7726_length_947_cov_19.103774	316	396	2	66	80	0.8250000
NODE_7726_length_947_cov_19.103774	369	449	0	67	80	0.8375000
NODE_7726_length_947_cov_19.103774	369	449	2	13	80	0.1625000
NODE_7727_length_947_cov_18.853774	516	596	0	80	80	1.0000000
NODE_7727_length_947_cov_18.853774	569	649	0	80	80	1.0000000
NODE_7728_length_947_cov_18.077830	315	395	0	50	80	0.6250000
NODE_7728_length_947_cov_18.077830	315	395	2	30	80	0.3750000
NODE_7728_length_947_cov_18.077830	368	448	0	80	80	1.0000000
NODE_7729_length_947_cov_17.713443	403	483	0	80	80	1.0000000
NODE_7729_length_947_cov_17.713443	456	536	0	80	80	1.0000000
NODE_7730_length_947_cov_14.492925	358	438	0	38	80	0.4750000
NODE_7730_length_947_cov_14.492925	358	438	2	42	80	0.5250000
NODE_7730_length_947_cov_14.492925	411	491	0	80	80	1.0000000
NODE_7730_length_947_cov_14.492925	487	567	0	80	80	1.0000000
NODE_7730_length_947_cov_14.492925	540	620	0	46	80	0.5750000
NODE_7730_length_947_cov_14.492925	540	620	2	34	80	0.4250000
NODE_7731_length_947_cov_10.573113	550	630	0	80	80	1.0000000
NODE_7731_length_947_cov_10.573113	603	683	0	80	80	1.0000000
NODE_7732_length_947_cov_7.762972	550	630	0	21	80	0.2625000
NODE_7732_length_947_cov_7.762972	550	630	2	59	80	0.7375000
NODE_7732_length_947_cov_7.762972	607	683	0	10	76	0.1315790
NODE_7732_length_947_cov_7.762972	607	683	2	66	76	0.8684211
NODE_7747_length_946_cov_39.726092	378	458	0	27	80	0.3375000
NODE_7747_length_946_cov_39.726092	378	458	2	53	80	0.6625000
NODE_7747_length_946_cov_39.726092	431	511	0	80	80	1.0000000
NODE_7747_length_946_cov_39.726092	507	587	0	80	80	1.0000000
NODE_7747_length_946_cov_39.726092	560	640	0	80	80	1.0000000
NODE_7748_length_946_cov_32.728453	404	484	0	80	80	1.0000000
NODE_7748_length_946_cov_32.728453	457	537	0	80	80	1.0000000
NODE_7749_length_946_cov_27.548996	280	360	0	46	80	0.5750000
NODE_7749_length_946_cov_27.548996	280	360	2	34	80	0.4250000
NODE_7749_length_946_cov_27.548996	333	413	0	80	80	1.0000000
NODE_7750_length_946_cov_24.622196	352	432	0	35	80	0.4375000
NODE_7750_length_946_cov_24.622196	352	432	4	45	80	0.5625000
NODE_7750_length_946_cov_24.622196	405	486	0	20	81	0.2469136
NODE_7750_length_946_cov_24.622196	405	486	4	61	81	0.7530864
NODE_7751_length_946_cov_18.082645	492	572	0	59	80	0.7375000
NODE_7751_length_946_cov_18.082645	492	572	2	21	80	0.2625000
NODE_7751_length_946_cov_18.082645	545	625	0	12	80	0.1500000
NODE_7751_length_946_cov_18.082645	545	625	2	68	80	0.8500000
NODE_7752_length_946_cov_18.031877	433	513	0	80	80	1.0000000
NODE_7752_length_946_cov_18.031877	486	566	0	80	80	1.0000000
NODE_7753_length_946_cov_15.188902	472	552	0	80	80	1.0000000
NODE_7753_length_946_cov_15.188902	525	605	0	80	80	1.0000000
NODE_7754_length_946_cov_11.201889	408	488	0	80	80	1.0000000
NODE_7754_length_946_cov_11.201889	461	541	0	80	80	1.0000000
NODE_7768_length_945_cov_42.997636	361	441	0	78	80	0.9750000
NODE_7768_length_945_cov_42.997636	361	441	2	2	80	0.0250000
NODE_7768_length_945_cov_42.997636	414	494	0	25	80	0.3125000
NODE_7768_length_945_cov_42.997636	414	494	2	55	80	0.6875000
NODE_7769_length_945_cov_31.223404	357	437	0	17	80	0.2125000
NODE_7769_length_945_cov_31.223404	357	437	5	29	80	0.3625000
NODE_7769_length_945_cov_31.223404	357	437	11	20	80	0.2500000
NODE_7769_length_945_cov_31.223404	357	437	15	14	80	0.1750000
NODE_7769_length_945_cov_31.223404	410	490	10	16	80	0.2000000
NODE_7769_length_945_cov_31.223404	410	490	11	13	80	0.1625000
NODE_7769_length_945_cov_31.223404	410	490	14	23	80	0.2875000
NODE_7769_length_945_cov_31.223404	410	490	15	28	80	0.3500000
NODE_7770_length_945_cov_26.348700	331	411	8	2	80	0.0250000
NODE_7770_length_945_cov_26.348700	331	411	13	2	80	0.0250000
NODE_7770_length_945_cov_26.348700	331	411	18	55	80	0.6875000
NODE_7770_length_945_cov_26.348700	331	411	19	7	80	0.0875000
NODE_7770_length_945_cov_26.348700	331	411	20	14	80	0.1750000
NODE_7770_length_945_cov_26.348700	384	464	11	23	80	0.2875000
NODE_7770_length_945_cov_26.348700	384	464	15	9	80	0.1125000
NODE_7770_length_945_cov_26.348700	384	464	18	6	80	0.0750000
NODE_7770_length_945_cov_26.348700	384	464	19	28	80	0.3500000
NODE_7770_length_945_cov_26.348700	384	464	20	14	80	0.1750000
NODE_7771_length_945_cov_20.349882	435	515	0	9	80	0.1125000
NODE_7771_length_945_cov_20.349882	435	515	2	71	80	0.8875000
NODE_7771_length_945_cov_20.349882	488	568	2	80	80	1.0000000
NODE_7772_length_945_cov_14.771868	386	466	0	80	80	1.0000000
NODE_7772_length_945_cov_14.771868	439	519	0	80	80	1.0000000
NODE_7773_length_945_cov_10.158392	599	679	0	80	80	1.0000000
NODE_7773_length_945_cov_10.158392	652	732	0	80	80	1.0000000
NODE_7775_length_945_cov_5.403073	357	437	0	80	80	1.0000000
NODE_7775_length_945_cov_5.403073	410	490	0	80	80	1.0000000
NODE_7785_length_944_cov_42.401183	358	438	2	26	80	0.3250000
NODE_7785_length_944_cov_42.401183	358	438	6	12	80	0.1500000
NODE_7785_length_944_cov_42.401183	358	438	10	4	80	0.0500000
NODE_7785_length_944_cov_42.401183	358	438	11	1	80	0.0125000
NODE_7785_length_944_cov_42.401183	358	438	12	17	80	0.2125000
NODE_7785_length_944_cov_42.401183	358	438	14	1	80	0.0125000
NODE_7785_length_944_cov_42.401183	358	438	16	19	80	0.2375000
NODE_7785_length_944_cov_42.401183	411	498	10	4	87	0.0459770
NODE_7785_length_944_cov_42.401183	411	498	12	5	87	0.0574713
NODE_7785_length_944_cov_42.401183	411	498	14	1	87	0.0114943
NODE_7785_length_944_cov_42.401183	411	498	16	77	87	0.8850574
NODE_7786_length_944_cov_32.712426	377	457	0	80	80	1.0000000
NODE_7786_length_944_cov_32.712426	430	510	0	80	80	1.0000000
NODE_7787_length_944_cov_27.839053	417	497	0	80	80	1.0000000
NODE_7787_length_944_cov_27.839053	470	550	0	80	80	1.0000000
NODE_7788_length_944_cov_24.702959	413	493	0	31	80	0.3875000
NODE_7788_length_944_cov_24.702959	413	493	1	1	80	0.0125000
NODE_7788_length_944_cov_24.702959	413	493	3	37	80	0.4625000
NODE_7788_length_944_cov_24.702959	413	493	5	7	80	0.0875000
NODE_7788_length_944_cov_24.702959	413	493	6	4	80	0.0500000
NODE_7788_length_944_cov_24.702959	466	546	3	16	80	0.2000000
NODE_7788_length_944_cov_24.702959	466	546	5	7	80	0.0875000
NODE_7788_length_944_cov_24.702959	466	546	6	57	80	0.7125000
NODE_7789_length_944_cov_11.951479	347	427	0	29	80	0.3625000
NODE_7789_length_944_cov_11.951479	347	427	2	51	80	0.6375000
NODE_7789_length_944_cov_11.951479	400	480	0	80	80	1.0000000
NODE_7789_length_944_cov_11.951479	476	556	0	80	80	1.0000000
NODE_7789_length_944_cov_11.951479	529	609	0	80	80	1.0000000
NODE_7790_length_944_cov_6.745562	366	446	0	80	80	1.0000000
NODE_7790_length_944_cov_6.745562	419	499	0	80	80	1.0000000
NODE_7792_length_944_cov_4.420118	236	316	0	80	80	1.0000000
NODE_7792_length_944_cov_4.420118	289	369	0	80	80	1.0000000
NODE_7800_length_943_cov_40.111374	536	614	0	78	78	1.0000000
NODE_7800_length_943_cov_40.111374	587	667	0	80	80	1.0000000
NODE_7801_length_943_cov_29.446682	338	418	4	80	80	1.0000000
NODE_7801_length_943_cov_29.446682	391	471	0	44	80	0.5500000
NODE_7801_length_943_cov_29.446682	391	471	4	36	80	0.4500000
NODE_7802_length_943_cov_28.289100	393	473	0	80	80	1.0000000
NODE_7802_length_943_cov_28.289100	446	526	0	80	80	1.0000000
NODE_7803_length_943_cov_27.225118	343	423	0	80	80	1.0000000
NODE_7803_length_943_cov_27.225118	396	476	0	80	80	1.0000000
NODE_7804_length_943_cov_26.536730	275	303	0	28	28	1.0000000
NODE_7804_length_943_cov_26.536730	299	379	0	14	80	0.1750000
NODE_7804_length_943_cov_26.536730	299	379	2	14	80	0.1750000
NODE_7804_length_943_cov_26.536730	299	379	4	9	80	0.1125000
NODE_7804_length_943_cov_26.536730	299	379	6	43	80	0.5375000
NODE_7804_length_943_cov_26.536730	352	432	2	30	80	0.3750000
NODE_7804_length_943_cov_26.536730	352	432	4	2	80	0.0250000
NODE_7804_length_943_cov_26.536730	352	432	6	48	80	0.6000000
NODE_7805_length_943_cov_24.992891	374	454	0	80	80	1.0000000
NODE_7805_length_943_cov_24.992891	427	507	0	80	80	1.0000000
NODE_7805_length_943_cov_24.992891	503	583	0	32	80	0.4000000
NODE_7805_length_943_cov_24.992891	503	583	4	48	80	0.6000000
NODE_7805_length_943_cov_24.992891	556	636	4	80	80	1.0000000
NODE_7806_length_943_cov_24.758294	403	483	0	80	80	1.0000000
NODE_7806_length_943_cov_24.758294	456	536	0	80	80	1.0000000
NODE_7807_length_943_cov_22.316351	432	512	2	41	80	0.5125000
NODE_7807_length_943_cov_22.316351	432	512	4	39	80	0.4875000
NODE_7807_length_943_cov_22.316351	485	565	2	38	80	0.4750000
NODE_7807_length_943_cov_22.316351	485	565	4	42	80	0.5250000
NODE_7808_length_943_cov_22.149289	393	473	0	80	80	1.0000000
NODE_7808_length_943_cov_22.149289	446	526	0	75	80	0.9375000
NODE_7808_length_943_cov_22.149289	446	526	2	5	80	0.0625000
NODE_7809_length_943_cov_20.055687	412	492	0	80	80	1.0000000
NODE_7809_length_943_cov_20.055687	465	545	0	80	80	1.0000000
NODE_7810_length_943_cov_16.022512	338	418	0	80	80	1.0000000
NODE_7810_length_943_cov_16.022512	391	471	0	80	80	1.0000000
NODE_7811_length_943_cov_10.939573	474	554	0	31	80	0.3875000
NODE_7811_length_943_cov_10.939573	474	554	2	49	80	0.6125000
NODE_7811_length_943_cov_10.939573	527	607	0	43	80	0.5375000
NODE_7811_length_943_cov_10.939573	527	607	2	37	80	0.4625000
NODE_7812_length_943_cov_9.483412	422	502	0	1	80	0.0125000
NODE_7812_length_943_cov_9.483412	422	502	4	79	80	0.9875000
NODE_7812_length_943_cov_9.483412	475	555	0	47	80	0.5875000
NODE_7812_length_943_cov_9.483412	475	555	4	33	80	0.4125000
NODE_7830_length_942_cov_58.088968	384	464	0	26	80	0.3250000
NODE_7830_length_942_cov_58.088968	384	464	2	54	80	0.6750000
NODE_7830_length_942_cov_58.088968	437	517	0	41	80	0.5125000
NODE_7830_length_942_cov_58.088968	437	517	2	39	80	0.4875000
NODE_7832_length_942_cov_27.466192	360	440	0	79	80	0.9875000
NODE_7832_length_942_cov_27.466192	360	440	2	1	80	0.0125000
NODE_7832_length_942_cov_27.466192	413	493	0	26	80	0.3250000
NODE_7832_length_942_cov_27.466192	413	493	2	54	80	0.6750000
NODE_7833_length_942_cov_26.914591	346	426	0	80	80	1.0000000
NODE_7833_length_942_cov_26.914591	399	479	0	80	80	1.0000000
NODE_7834_length_942_cov_17.911032	390	470	0	25	80	0.3125000
NODE_7834_length_942_cov_17.911032	390	470	4	12	80	0.1500000
NODE_7834_length_942_cov_17.911032	390	470	5	1	80	0.0125000
NODE_7834_length_942_cov_17.911032	390	470	6	1	80	0.0125000
NODE_7834_length_942_cov_17.911032	390	470	7	1	80	0.0125000
NODE_7834_length_942_cov_17.911032	390	470	8	5	80	0.0625000
NODE_7834_length_942_cov_17.911032	390	470	10	35	80	0.4375000
NODE_7834_length_942_cov_17.911032	443	523	10	80	80	1.0000000
NODE_7835_length_942_cov_14.695136	442	522	0	78	80	0.9750000
NODE_7835_length_942_cov_14.695136	442	522	2	2	80	0.0250000
NODE_7835_length_942_cov_14.695136	495	575	0	80	80	1.0000000
NODE_7836_length_942_cov_14.097272	547	627	0	6	80	0.0750000
NODE_7836_length_942_cov_14.097272	547	627	2	24	80	0.3000000
NODE_7836_length_942_cov_14.097272	547	627	4	50	80	0.6250000
NODE_7836_length_942_cov_14.097272	600	680	0	15	80	0.1875000
NODE_7836_length_942_cov_14.097272	600	680	2	2	80	0.0250000
NODE_7836_length_942_cov_14.097272	600	680	4	63	80	0.7875000
NODE_7837_length_942_cov_13.174377	322	402	4	48	80	0.6000000
NODE_7837_length_942_cov_13.174377	322	402	6	32	80	0.4000000
NODE_7837_length_942_cov_13.174377	375	455	2	48	80	0.6000000
NODE_7837_length_942_cov_13.174377	375	455	4	32	80	0.4000000
NODE_7858_length_941_cov_36.592637	259	339	4	80	80	1.0000000
NODE_7858_length_941_cov_36.592637	312	392	0	26	80	0.3250000
NODE_7858_length_941_cov_36.592637	312	392	4	54	80	0.6750000
NODE_7858_length_941_cov_36.592637	388	468	0	80	80	1.0000000
NODE_7858_length_941_cov_36.592637	441	521	0	80	80	1.0000000
NODE_7859_length_941_cov_35.375297	352	432	0	80	80	1.0000000
NODE_7859_length_941_cov_35.375297	405	485	0	32	80	0.4000000
NODE_7859_length_941_cov_35.375297	405	485	2	48	80	0.6000000
NODE_7859_length_941_cov_35.375297	481	561	0	2	80	0.0250000
NODE_7859_length_941_cov_35.375297	481	561	2	14	80	0.1750000
NODE_7859_length_941_cov_35.375297	481	561	4	16	80	0.2000000
NODE_7859_length_941_cov_35.375297	481	561	6	48	80	0.6000000
NODE_7859_length_941_cov_35.375297	534	614	0	55	80	0.6875000
NODE_7859_length_941_cov_35.375297	534	614	4	16	80	0.2000000
NODE_7859_length_941_cov_35.375297	534	614	6	9	80	0.1125000
NODE_7860_length_941_cov_32.222090	407	487	6	80	80	1.0000000
NODE_7860_length_941_cov_32.222090	460	540	0	13	80	0.1625000
NODE_7860_length_941_cov_32.222090	460	540	2	12	80	0.1500000
NODE_7860_length_941_cov_32.222090	460	540	6	55	80	0.6875000
NODE_7861_length_941_cov_28.442993	391	471	0	11	80	0.1375000
NODE_7861_length_941_cov_28.442993	391	471	1	14	80	0.1750000
NODE_7861_length_941_cov_28.442993	391	471	2	55	80	0.6875000
NODE_7861_length_941_cov_28.442993	444	524	0	11	80	0.1375000
NODE_7861_length_941_cov_28.442993	444	524	1	48	80	0.6000000
NODE_7861_length_941_cov_28.442993	444	524	2	21	80	0.2625000
NODE_7862_length_941_cov_20.788599	341	421	0	80	80	1.0000000
NODE_7862_length_941_cov_20.788599	394	474	0	80	80	1.0000000
NODE_7863_length_941_cov_18.000000	364	444	6	27	80	0.3375000
NODE_7863_length_941_cov_18.000000	364	444	8	53	80	0.6625000
NODE_7863_length_941_cov_18.000000	417	497	0	16	80	0.2000000
NODE_7863_length_941_cov_18.000000	417	497	2	36	80	0.4500000
NODE_7863_length_941_cov_18.000000	417	497	8	28	80	0.3500000
NODE_7864_length_941_cov_11.020190	325	405	0	1	80	0.0125000
NODE_7864_length_941_cov_11.020190	325	405	2	79	80	0.9875000
NODE_7864_length_941_cov_11.020190	378	458	0	54	80	0.6750000
NODE_7864_length_941_cov_11.020190	378	458	2	26	80	0.3250000
NODE_7865_length_941_cov_6.020190	260	287	2	27	27	1.0000000
NODE_7865_length_941_cov_6.020190	260	340	0	17	80	0.2125000
NODE_7865_length_941_cov_6.020190	260	340	2	63	80	0.7875000
NODE_7867_length_941_cov_3.745843	867	941	0	19	74	0.2567568
NODE_7867_length_941_cov_3.745843	867	941	2	24	74	0.3243243
NODE_7867_length_941_cov_3.745843	867	941	6	1	74	0.0135135
NODE_7867_length_941_cov_3.745843	867	941	8	9	74	0.1216216
NODE_7867_length_941_cov_3.745843	867	941	10	21	74	0.2837838
NODE_7877_length_940_cov_43.954816	243	323	8	69	80	0.8625000
NODE_7877_length_940_cov_43.954816	243	323	10	11	80	0.1375000
NODE_7877_length_940_cov_43.954816	296	376	0	12	80	0.1500000
NODE_7877_length_940_cov_43.954816	296	376	4	20	80	0.2500000
NODE_7877_length_940_cov_43.954816	296	376	8	48	80	0.6000000
NODE_7877_length_940_cov_43.954816	372	452	0	80	80	1.0000000
NODE_7877_length_940_cov_43.954816	425	505	0	55	80	0.6875000
NODE_7877_length_940_cov_43.954816	425	505	2	25	80	0.3125000
NODE_7878_length_940_cov_27.763377	423	503	0	17	80	0.2125000
NODE_7878_length_940_cov_27.763377	423	503	4	23	80	0.2875000
NODE_7878_length_940_cov_27.763377	423	503	6	40	80	0.5000000
NODE_7878_length_940_cov_27.763377	476	556	0	8	80	0.1000000
NODE_7878_length_940_cov_27.763377	476	556	2	15	80	0.1875000
NODE_7878_length_940_cov_27.763377	476	556	6	57	80	0.7125000
NODE_7897_length_939_cov_58.982143	363	443	0	3	80	0.0375000
NODE_7897_length_939_cov_58.982143	363	443	2	25	80	0.3125000
NODE_7897_length_939_cov_58.982143	363	443	4	20	80	0.2500000
NODE_7897_length_939_cov_58.982143	363	443	6	13	80	0.1625000
NODE_7897_length_939_cov_58.982143	363	443	8	19	80	0.2375000
NODE_7897_length_939_cov_58.982143	416	496	0	8	80	0.1000000
NODE_7897_length_939_cov_58.982143	416	496	2	4	80	0.0500000
NODE_7897_length_939_cov_58.982143	416	496	4	1	80	0.0125000
NODE_7897_length_939_cov_58.982143	416	496	6	48	80	0.6000000
NODE_7897_length_939_cov_58.982143	416	496	8	19	80	0.2375000
NODE_7898_length_939_cov_32.469048	327	407	0	80	80	1.0000000
NODE_7898_length_939_cov_32.469048	380	460	0	35	80	0.4375000
NODE_7898_length_939_cov_32.469048	380	460	4	45	80	0.5625000
NODE_7899_length_939_cov_31.895238	265	345	0	80	80	1.0000000
NODE_7899_length_939_cov_31.895238	318	398	0	80	80	1.0000000
NODE_7900_length_939_cov_25.354762	439	519	0	80	80	1.0000000
NODE_7900_length_939_cov_25.354762	492	572	0	80	80	1.0000000
NODE_7901_length_939_cov_24.892857	370	450	0	36	80	0.4500000
NODE_7901_length_939_cov_24.892857	370	450	2	25	80	0.3125000
NODE_7901_length_939_cov_24.892857	370	450	6	19	80	0.2375000
NODE_7901_length_939_cov_24.892857	423	503	0	11	80	0.1375000
NODE_7901_length_939_cov_24.892857	423	503	2	8	80	0.1000000
NODE_7901_length_939_cov_24.892857	423	503	4	2	80	0.0250000
NODE_7901_length_939_cov_24.892857	423	503	6	59	80	0.7375000
NODE_7902_length_939_cov_24.246429	422	502	0	29	80	0.3625000
NODE_7902_length_939_cov_24.246429	422	502	2	51	80	0.6375000
NODE_7902_length_939_cov_24.246429	475	555	0	24	80	0.3000000
NODE_7902_length_939_cov_24.246429	475	555	2	56	80	0.7000000
NODE_7902_length_939_cov_24.246429	551	631	0	8	80	0.1000000
NODE_7902_length_939_cov_24.246429	551	631	2	72	80	0.9000000
NODE_7902_length_939_cov_24.246429	604	684	0	27	80	0.3375000
NODE_7902_length_939_cov_24.246429	604	684	2	53	80	0.6625000
NODE_7903_length_939_cov_21.141667	368	448	0	80	80	1.0000000
NODE_7903_length_939_cov_21.141667	421	501	0	80	80	1.0000000
NODE_7904_length_939_cov_16.425000	327	407	2	4	80	0.0500000
NODE_7904_length_939_cov_16.425000	327	407	4	76	80	0.9500000
NODE_7904_length_939_cov_16.425000	380	460	0	24	80	0.3000000
NODE_7904_length_939_cov_16.425000	380	460	2	6	80	0.0750000
NODE_7904_length_939_cov_16.425000	380	460	4	50	80	0.6250000
NODE_7905_length_939_cov_13.828571	469	548	4	41	79	0.5189874
NODE_7905_length_939_cov_13.828571	469	548	8	6	79	0.0759494
NODE_7905_length_939_cov_13.828571	469	548	10	11	79	0.1392405
NODE_7905_length_939_cov_13.828571	469	548	12	21	79	0.2658228
NODE_7905_length_939_cov_13.828571	522	603	8	60	81	0.7407407
NODE_7905_length_939_cov_13.828571	522	603	12	21	81	0.2592593
NODE_7906_length_939_cov_13.521429	402	482	0	80	80	1.0000000
NODE_7906_length_939_cov_13.521429	455	535	0	80	80	1.0000000
NODE_7907_length_939_cov_12.955952	398	478	0	80	80	1.0000000
NODE_7907_length_939_cov_12.955952	451	531	0	80	80	1.0000000
NODE_7908_length_939_cov_6.564286	523	545	0	22	22	1.0000000
NODE_7922_length_938_cov_44.458880	362	442	0	48	80	0.6000000
NODE_7922_length_938_cov_44.458880	362	442	11	4	80	0.0500000
NODE_7922_length_938_cov_44.458880	362	442	13	28	80	0.3500000
NODE_7922_length_938_cov_44.458880	415	495	13	47	80	0.5875000
NODE_7922_length_938_cov_44.458880	415	495	14	9	80	0.1125000
NODE_7922_length_938_cov_44.458880	415	495	15	24	80	0.3000000
NODE_7923_length_938_cov_44.435042	748	815	6	48	67	0.7164179
NODE_7923_length_938_cov_44.435042	748	815	8	19	67	0.2835821
NODE_7924_length_938_cov_32.177592	466	546	0	17	80	0.2125000
NODE_7924_length_938_cov_32.177592	466	546	2	63	80	0.7875000
NODE_7924_length_938_cov_32.177592	519	599	0	55	80	0.6875000
NODE_7924_length_938_cov_32.177592	519	599	2	25	80	0.3125000
NODE_7925_length_938_cov_21.139452	474	554	0	80	80	1.0000000
NODE_7925_length_938_cov_21.139452	527	607	0	80	80	1.0000000
NODE_7927_length_938_cov_8.791418	300	380	0	80	80	1.0000000
NODE_7927_length_938_cov_8.791418	353	433	0	80	80	1.0000000
NODE_7932_length_938_cov_2.693683	59	139	6	9	80	0.1125000
NODE_7932_length_938_cov_2.693683	59	139	8	11	80	0.1375000
NODE_7932_length_938_cov_2.693683	59	139	10	60	80	0.7500000
NODE_7932_length_938_cov_2.693683	112	192	0	29	80	0.3625000
NODE_7932_length_938_cov_2.693683	112	192	4	15	80	0.1875000
NODE_7932_length_938_cov_2.693683	112	192	6	17	80	0.2125000
NODE_7932_length_938_cov_2.693683	112	192	10	19	80	0.2375000
NODE_7946_length_937_cov_31.890215	407	487	4	15	80	0.1875000
NODE_7946_length_937_cov_31.890215	407	487	6	25	80	0.3125000
NODE_7946_length_937_cov_31.890215	407	487	8	40	80	0.5000000
NODE_7946_length_937_cov_31.890215	460	536	2	24	76	0.3157895
NODE_7946_length_937_cov_31.890215	460	536	4	12	76	0.1578947
NODE_7946_length_937_cov_31.890215	460	536	6	11	76	0.1447368
NODE_7946_length_937_cov_31.890215	460	536	8	29	76	0.3815790
NODE_7947_length_937_cov_31.198091	425	505	0	73	80	0.9125000
NODE_7947_length_937_cov_31.198091	425	505	2	7	80	0.0875000
NODE_7947_length_937_cov_31.198091	478	558	0	20	80	0.2500000
NODE_7947_length_937_cov_31.198091	478	558	2	60	80	0.7500000
NODE_7948_length_937_cov_29.742243	296	376	0	7	80	0.0875000
NODE_7948_length_937_cov_29.742243	296	376	2	73	80	0.9125000
NODE_7948_length_937_cov_29.742243	349	429	2	45	80	0.5625000
NODE_7948_length_937_cov_29.742243	349	429	5	5	80	0.0625000
NODE_7948_length_937_cov_29.742243	349	429	7	15	80	0.1875000
NODE_7948_length_937_cov_29.742243	349	429	10	15	80	0.1875000
NODE_7948_length_937_cov_29.742243	425	505	10	41	80	0.5125000
NODE_7948_length_937_cov_29.742243	425	505	11	5	80	0.0625000
NODE_7948_length_937_cov_29.742243	425	505	12	34	80	0.4250000
NODE_7948_length_937_cov_29.742243	478	558	7	14	80	0.1750000
NODE_7948_length_937_cov_29.742243	478	558	11	44	80	0.5500000
NODE_7948_length_937_cov_29.742243	478	558	12	22	80	0.2750000
NODE_7950_length_937_cov_26.153938	487	567	0	80	80	1.0000000
NODE_7950_length_937_cov_26.153938	540	620	0	80	80	1.0000000
NODE_7951_length_937_cov_20.898568	515	595	0	80	80	1.0000000
NODE_7951_length_937_cov_20.898568	568	648	0	80	80	1.0000000
NODE_7952_length_937_cov_20.502387	181	261	0	7	80	0.0875000
NODE_7952_length_937_cov_20.502387	181	261	4	73	80	0.9125000
NODE_7952_length_937_cov_20.502387	234	314	0	60	80	0.7500000
NODE_7952_length_937_cov_20.502387	234	314	4	20	80	0.2500000
NODE_7952_length_937_cov_20.502387	310	390	0	45	80	0.5625000
NODE_7952_length_937_cov_20.502387	310	390	2	15	80	0.1875000
NODE_7952_length_937_cov_20.502387	310	390	4	11	80	0.1375000
NODE_7952_length_937_cov_20.502387	310	390	7	5	80	0.0625000
NODE_7952_length_937_cov_20.502387	310	390	9	4	80	0.0500000
NODE_7952_length_937_cov_20.502387	363	443	2	7	80	0.0875000
NODE_7952_length_937_cov_20.502387	363	443	4	11	80	0.1375000
NODE_7952_length_937_cov_20.502387	363	443	7	5	80	0.0625000
NODE_7952_length_937_cov_20.502387	363	443	9	57	80	0.7125000
NODE_7953_length_937_cov_15.219570	526	606	0	80	80	1.0000000
NODE_7953_length_937_cov_15.219570	579	659	0	80	80	1.0000000
NODE_7954_length_937_cov_9.633652	521	601	0	80	80	1.0000000
NODE_7954_length_937_cov_9.633652	574	654	0	80	80	1.0000000
NODE_7956_length_937_cov_6.630072	305	385	0	80	80	1.0000000
NODE_7956_length_937_cov_6.630072	358	438	0	80	80	1.0000000
NODE_7957_length_937_cov_4.649165	470	550	0	80	80	1.0000000
NODE_7957_length_937_cov_4.649165	523	603	0	80	80	1.0000000
NODE_7969_length_936_cov_57.105137	267	347	0	27	80	0.3375000
NODE_7969_length_936_cov_57.105137	267	347	2	20	80	0.2500000
NODE_7969_length_936_cov_57.105137	267	347	4	33	80	0.4125000
NODE_7969_length_936_cov_57.105137	320	400	4	80	80	1.0000000
NODE_7969_length_936_cov_57.105137	396	476	0	12	80	0.1500000
NODE_7969_length_936_cov_57.105137	396	476	2	20	80	0.2500000
NODE_7969_length_936_cov_57.105137	396	476	4	48	80	0.6000000
NODE_7969_length_936_cov_57.105137	449	529	0	65	80	0.8125000
NODE_7969_length_936_cov_57.105137	449	529	2	15	80	0.1875000
NODE_7970_length_936_cov_39.983274	433	513	9	22	80	0.2750000
NODE_7970_length_936_cov_39.983274	433	513	10	58	80	0.7250000
NODE_7970_length_936_cov_39.983274	486	566	0	39	80	0.4875000
NODE_7970_length_936_cov_39.983274	486	566	10	41	80	0.5125000
NODE_7971_length_936_cov_22.486260	534	614	0	80	80	1.0000000
NODE_7971_length_936_cov_22.486260	587	667	0	80	80	1.0000000
NODE_7972_length_936_cov_19.639188	409	489	0	4	80	0.0500000
NODE_7972_length_936_cov_19.639188	409	489	6	1	80	0.0125000
NODE_7972_length_936_cov_19.639188	409	489	7	56	80	0.7000000
NODE_7972_length_936_cov_19.639188	409	489	8	19	80	0.2375000
NODE_7972_length_936_cov_19.639188	462	542	0	21	80	0.2625000
NODE_7972_length_936_cov_19.639188	462	542	7	8	80	0.1000000
NODE_7972_length_936_cov_19.639188	462	542	8	51	80	0.6375000
NODE_7973_length_936_cov_15.083632	322	402	0	29	80	0.3625000
NODE_7973_length_936_cov_15.083632	322	402	2	51	80	0.6375000
NODE_7973_length_936_cov_15.083632	375	455	0	1	80	0.0125000
NODE_7973_length_936_cov_15.083632	375	455	2	79	80	0.9875000
NODE_7974_length_936_cov_13.962963	356	424	2	42	68	0.6176471
NODE_7974_length_936_cov_13.962963	356	424	6	26	68	0.3823529
NODE_7975_length_936_cov_12.502987	447	527	0	80	80	1.0000000
NODE_7975_length_936_cov_12.502987	500	580	0	80	80	1.0000000
NODE_7976_length_936_cov_12.279570	340	420	0	80	80	1.0000000
NODE_7976_length_936_cov_12.279570	393	473	0	80	80	1.0000000
NODE_7977_length_936_cov_7.906810	587	667	0	33	80	0.4125000
NODE_7977_length_936_cov_7.906810	587	667	2	47	80	0.5875000
NODE_7977_length_936_cov_7.906810	640	720	0	29	80	0.3625000
NODE_7977_length_936_cov_7.906810	640	720	2	51	80	0.6375000
NODE_7978_length_936_cov_6.845878	322	402	0	80	80	1.0000000
NODE_7978_length_936_cov_6.845878	375	455	0	80	80	1.0000000
NODE_7979_length_936_cov_6.434886	556	635	0	54	79	0.6835443
NODE_7979_length_936_cov_6.434886	556	635	2	25	79	0.3164557
NODE_7979_length_936_cov_6.434886	608	688	0	5	80	0.0625000
NODE_7979_length_936_cov_6.434886	608	688	2	75	80	0.9375000
NODE_7993_length_935_cov_38.209330	57	137	77	4	80	0.0500000
NODE_7993_length_935_cov_38.209330	57	137	81	1	80	0.0125000
NODE_7993_length_935_cov_38.209330	57	137	85	2	80	0.0250000
NODE_7993_length_935_cov_38.209330	57	137	89	1	80	0.0125000
NODE_7993_length_935_cov_38.209330	57	137	91	3	80	0.0375000
NODE_7993_length_935_cov_38.209330	57	137	95	1	80	0.0125000
NODE_7993_length_935_cov_38.209330	57	137	97	4	80	0.0500000
NODE_7993_length_935_cov_38.209330	57	137	99	1	80	0.0125000
NODE_7993_length_935_cov_38.209330	57	137	101	1	80	0.0125000
NODE_7993_length_935_cov_38.209330	57	137	103	3	80	0.0375000
NODE_7993_length_935_cov_38.209330	57	137	105	1	80	0.0125000
NODE_7993_length_935_cov_38.209330	57	137	107	1	80	0.0125000
NODE_7993_length_935_cov_38.209330	57	137	109	2	80	0.0250000
NODE_7993_length_935_cov_38.209330	57	137	111	1	80	0.0125000
NODE_7993_length_935_cov_38.209330	57	137	113	8	80	0.1000000
NODE_7993_length_935_cov_38.209330	57	137	114	46	80	0.5750000
NODE_7994_length_935_cov_27.306220	439	519	2	80	80	1.0000000
NODE_7994_length_935_cov_27.306220	492	572	0	16	80	0.2000000
NODE_7994_length_935_cov_27.306220	492	572	2	64	80	0.8000000
NODE_7995_length_935_cov_26.562201	321	401	0	14	80	0.1750000
NODE_7995_length_935_cov_26.562201	321	401	2	66	80	0.8250000
NODE_7995_length_935_cov_26.562201	374	454	0	52	80	0.6500000
NODE_7995_length_935_cov_26.562201	374	454	2	28	80	0.3500000
NODE_7995_length_935_cov_26.562201	450	530	0	80	80	1.0000000
NODE_7995_length_935_cov_26.562201	503	583	0	80	80	1.0000000
NODE_7996_length_935_cov_25.098086	356	436	0	80	80	1.0000000
NODE_7996_length_935_cov_25.098086	409	489	0	80	80	1.0000000
NODE_7997_length_935_cov_24.316986	467	547	0	68	80	0.8500000
NODE_7997_length_935_cov_24.316986	467	547	2	7	80	0.0875000
NODE_7997_length_935_cov_24.316986	467	547	4	5	80	0.0625000
NODE_7997_length_935_cov_24.316986	520	600	0	15	80	0.1875000
NODE_7997_length_935_cov_24.316986	520	600	2	7	80	0.0875000
NODE_7997_length_935_cov_24.316986	520	600	4	58	80	0.7250000
NODE_7998_length_935_cov_19.221292	397	477	0	30	80	0.3750000
NODE_7998_length_935_cov_19.221292	397	477	2	50	80	0.6250000
NODE_7998_length_935_cov_19.221292	450	530	0	19	80	0.2375000
NODE_7998_length_935_cov_19.221292	450	530	2	61	80	0.7625000
NODE_7999_length_935_cov_15.016746	404	484	4	80	80	1.0000000
NODE_7999_length_935_cov_15.016746	457	537	0	2	80	0.0250000
NODE_7999_length_935_cov_15.016746	457	537	4	78	80	0.9750000
NODE_8000_length_935_cov_13.138756	341	421	0	76	80	0.9500000
NODE_8000_length_935_cov_13.138756	341	421	4	4	80	0.0500000
NODE_8000_length_935_cov_13.138756	394	474	0	23	80	0.2875000
NODE_8000_length_935_cov_13.138756	394	474	4	57	80	0.7125000
NODE_8002_length_935_cov_6.485646	512	592	0	80	80	1.0000000
NODE_8002_length_935_cov_6.485646	565	645	0	36	80	0.4500000
NODE_8002_length_935_cov_6.485646	565	645	2	44	80	0.5500000
NODE_8003_length_935_cov_6.467703	250	330	0	80	80	1.0000000
NODE_8003_length_935_cov_6.467703	303	383	0	80	80	1.0000000
NODE_8004_length_935_cov_6.144737	478	558	0	12	80	0.1500000
NODE_8004_length_935_cov_6.144737	478	558	4	68	80	0.8500000
NODE_8004_length_935_cov_6.144737	531	611	0	65	80	0.8125000
NODE_8004_length_935_cov_6.144737	531	611	4	15	80	0.1875000
NODE_8005_length_935_cov_3.905502	39	119	8	5	80	0.0625000
NODE_8005_length_935_cov_3.905502	39	119	10	5	80	0.0625000
NODE_8005_length_935_cov_3.905502	39	119	12	2	80	0.0250000
NODE_8005_length_935_cov_3.905502	39	119	14	6	80	0.0750000
NODE_8005_length_935_cov_3.905502	39	119	16	62	80	0.7750000
NODE_8005_length_935_cov_3.905502	92	166	2	15	74	0.2027027
NODE_8005_length_935_cov_3.905502	92	166	4	16	74	0.2162162
NODE_8005_length_935_cov_3.905502	92	166	6	16	74	0.2162162
NODE_8005_length_935_cov_3.905502	92	166	8	5	74	0.0675676
NODE_8005_length_935_cov_3.905502	92	166	10	5	74	0.0675676
NODE_8005_length_935_cov_3.905502	92	166	12	2	74	0.0270270
NODE_8005_length_935_cov_3.905502	92	166	14	6	74	0.0810811
NODE_8005_length_935_cov_3.905502	92	166	16	9	74	0.1216216
NODE_8028_length_934_cov_22.898204	403	483	0	80	80	1.0000000
NODE_8028_length_934_cov_22.898204	456	536	0	80	80	1.0000000
NODE_8029_length_934_cov_17.746108	246	326	0	28	80	0.3500000
NODE_8029_length_934_cov_17.746108	246	326	2	52	80	0.6500000
NODE_8029_length_934_cov_17.746108	299	379	0	7	80	0.0875000
NODE_8029_length_934_cov_17.746108	299	379	2	73	80	0.9125000
NODE_8030_length_934_cov_16.049102	367	447	0	80	80	1.0000000
NODE_8030_length_934_cov_16.049102	420	500	0	80	80	1.0000000
NODE_8031_length_934_cov_13.738922	379	459	0	80	80	1.0000000
NODE_8031_length_934_cov_13.738922	432	459	0	27	27	1.0000000
NODE_8031_length_934_cov_13.738922	470	512	0	42	42	1.0000000
NODE_8032_length_934_cov_9.091018	407	487	0	51	80	0.6375000
NODE_8032_length_934_cov_9.091018	407	487	2	29	80	0.3625000
NODE_8032_length_934_cov_9.091018	460	540	0	80	80	1.0000000
NODE_8034_length_934_cov_5.349701	583	663	0	4	80	0.0500000
NODE_8034_length_934_cov_5.349701	583	663	2	76	80	0.9500000
NODE_8050_length_933_cov_36.557554	462	542	0	80	80	1.0000000
NODE_8050_length_933_cov_36.557554	515	595	0	80	80	1.0000000
NODE_8051_length_933_cov_27.645084	476	556	0	80	80	1.0000000
NODE_8051_length_933_cov_27.645084	529	609	0	80	80	1.0000000
NODE_8052_length_933_cov_26.749400	611	691	0	80	80	1.0000000
NODE_8052_length_933_cov_26.749400	664	744	0	80	80	1.0000000
NODE_8053_length_933_cov_26.308153	430	510	0	80	80	1.0000000
NODE_8053_length_933_cov_26.308153	483	563	0	80	80	1.0000000
NODE_8054_length_933_cov_19.966427	444	530	0	17	86	0.1976744
NODE_8054_length_933_cov_19.966427	444	530	2	69	86	0.8023256
NODE_8054_length_933_cov_19.966427	497	583	2	86	86	1.0000000
NODE_8055_length_933_cov_16.870504	284	364	0	39	80	0.4875000
NODE_8055_length_933_cov_16.870504	284	364	2	18	80	0.2250000
NODE_8055_length_933_cov_16.870504	284	364	4	23	80	0.2875000
NODE_8055_length_933_cov_16.870504	337	415	0	15	78	0.1923077
NODE_8055_length_933_cov_16.870504	337	415	2	12	78	0.1538462
NODE_8055_length_933_cov_16.870504	337	415	4	51	78	0.6538461
NODE_8056_length_933_cov_16.699041	366	446	0	31	80	0.3875000
NODE_8056_length_933_cov_16.699041	366	446	2	49	80	0.6125000
NODE_8056_length_933_cov_16.699041	419	499	2	65	80	0.8125000
NODE_8056_length_933_cov_16.699041	419	499	4	15	80	0.1875000
NODE_8057_length_933_cov_11.171463	197	277	0	80	80	1.0000000
NODE_8057_length_933_cov_11.171463	250	330	0	80	80	1.0000000
NODE_8073_length_932_cov_26.656663	397	477	2	6	80	0.0750000
NODE_8073_length_932_cov_26.656663	397	477	4	58	80	0.7250000
NODE_8073_length_932_cov_26.656663	397	477	6	16	80	0.2000000
NODE_8073_length_932_cov_26.656663	450	530	0	23	80	0.2875000
NODE_8073_length_932_cov_26.656663	450	530	2	15	80	0.1875000
NODE_8073_length_932_cov_26.656663	450	530	4	42	80	0.5250000
NODE_8074_length_932_cov_16.581032	407	485	0	48	78	0.6153846
NODE_8074_length_932_cov_16.581032	407	485	2	30	78	0.3846154
NODE_8074_length_932_cov_16.581032	460	538	0	78	78	1.0000000
NODE_8075_length_932_cov_13.462185	413	493	0	80	80	1.0000000
NODE_8075_length_932_cov_13.462185	466	546	0	80	80	1.0000000
NODE_8076_length_932_cov_13.442977	386	466	0	80	80	1.0000000
NODE_8076_length_932_cov_13.442977	439	519	0	80	80	1.0000000
NODE_8077_length_932_cov_11.947179	344	424	0	80	80	1.0000000
NODE_8077_length_932_cov_11.947179	397	477	0	80	80	1.0000000
NODE_8079_length_932_cov_10.849940	409	489	0	80	80	1.0000000
NODE_8079_length_932_cov_10.849940	462	542	0	80	80	1.0000000
NODE_8080_length_932_cov_10.174070	342	422	0	2	80	0.0250000
NODE_8080_length_932_cov_10.174070	342	422	2	78	80	0.9750000
NODE_8080_length_932_cov_10.174070	395	475	0	24	80	0.3000000
NODE_8080_length_932_cov_10.174070	395	475	2	56	80	0.7000000
NODE_8082_length_932_cov_9.200480	184	264	0	80	80	1.0000000
NODE_8082_length_932_cov_9.200480	237	317	0	80	80	1.0000000
NODE_8090_length_932_cov_2.689076	598	676	0	78	78	1.0000000
NODE_8090_length_932_cov_2.689076	798	845	0	1	47	0.0212766
NODE_8090_length_932_cov_2.689076	798	845	2	46	47	0.9787234
NODE_8103_length_931_cov_51.451923	320	400	0	80	80	1.0000000
NODE_8103_length_931_cov_51.451923	373	453	0	30	80	0.3750000
NODE_8103_length_931_cov_51.451923	373	453	2	50	80	0.6250000
NODE_8104_length_931_cov_46.621394	527	607	4	34	80	0.4250000
NODE_8104_length_931_cov_46.621394	527	607	5	1	80	0.0125000
NODE_8104_length_931_cov_46.621394	527	607	6	4	80	0.0500000
NODE_8104_length_931_cov_46.621394	527	607	8	41	80	0.5125000
NODE_8104_length_931_cov_46.621394	580	660	0	20	80	0.2500000
NODE_8104_length_931_cov_46.621394	580	660	1	1	80	0.0125000
NODE_8104_length_931_cov_46.621394	580	660	2	27	80	0.3375000
NODE_8104_length_931_cov_46.621394	580	660	4	32	80	0.4000000
NODE_8105_length_931_cov_36.334135	347	427	0	80	80	1.0000000
NODE_8105_length_931_cov_36.334135	400	480	0	80	80	1.0000000
NODE_8106_length_931_cov_32.495192	482	562	0	80	80	1.0000000
NODE_8106_length_931_cov_32.495192	535	617	0	82	82	1.0000000
NODE_8107_length_931_cov_22.100962	375	455	21	17	80	0.2125000
NODE_8107_length_931_cov_22.100962	375	455	22	63	80	0.7875000
NODE_8107_length_931_cov_22.100962	428	508	0	27	80	0.3375000
NODE_8107_length_931_cov_22.100962	428	508	5	13	80	0.1625000
NODE_8107_length_931_cov_22.100962	428	508	8	1	80	0.0125000
NODE_8107_length_931_cov_22.100962	428	508	9	1	80	0.0125000
NODE_8107_length_931_cov_22.100962	428	508	10	2	80	0.0250000
NODE_8107_length_931_cov_22.100962	428	508	19	2	80	0.0250000
NODE_8107_length_931_cov_22.100962	428	508	21	24	80	0.3000000
NODE_8107_length_931_cov_22.100962	428	508	22	10	80	0.1250000
NODE_8108_length_931_cov_21.781250	347	427	0	80	80	1.0000000
NODE_8108_length_931_cov_21.781250	400	480	0	80	80	1.0000000
NODE_8109_length_931_cov_19.084135	411	491	0	8	80	0.1000000
NODE_8109_length_931_cov_19.084135	411	491	2	72	80	0.9000000
NODE_8109_length_931_cov_19.084135	464	544	2	80	80	1.0000000
NODE_8110_length_931_cov_14.879808	444	524	0	80	80	1.0000000
NODE_8110_length_931_cov_14.879808	497	577	0	80	80	1.0000000
NODE_8111_length_931_cov_13.087740	759	800	10	4	41	0.0975610
NODE_8111_length_931_cov_13.087740	759	800	12	2	41	0.0487805
NODE_8111_length_931_cov_13.087740	759	800	14	35	41	0.8536586
NODE_8112_length_931_cov_10.534856	399	479	0	54	80	0.6750000
NODE_8112_length_931_cov_10.534856	399	479	8	26	80	0.3250000
NODE_8112_length_931_cov_10.534856	452	532	0	1	80	0.0125000
NODE_8112_length_931_cov_10.534856	452	532	8	79	80	0.9875000
NODE_8113_length_931_cov_9.865385	236	316	0	80	80	1.0000000
NODE_8113_length_931_cov_9.865385	289	369	0	80	80	1.0000000
NODE_8115_length_931_cov_6.201923	479	559	0	35	80	0.4375000
NODE_8115_length_931_cov_6.201923	479	559	2	45	80	0.5625000
NODE_8115_length_931_cov_6.201923	532	612	0	2	80	0.0250000
NODE_8115_length_931_cov_6.201923	532	612	2	35	80	0.4375000
NODE_8115_length_931_cov_6.201923	532	612	3	7	80	0.0875000
NODE_8115_length_931_cov_6.201923	532	612	4	36	80	0.4500000
NODE_8124_length_931_cov_1.780048	832	902	0	70	70	1.0000000
NODE_8126_length_931_cov_1.433894	220	284	3	13	64	0.2031250
NODE_8126_length_931_cov_1.433894	220	284	5	1	64	0.0156250
NODE_8126_length_931_cov_1.433894	220	284	9	3	64	0.0468750
NODE_8126_length_931_cov_1.433894	220	284	10	1	64	0.0156250
NODE_8126_length_931_cov_1.433894	220	284	11	10	64	0.1562500
NODE_8126_length_931_cov_1.433894	220	284	12	12	64	0.1875000
NODE_8126_length_931_cov_1.433894	220	284	14	4	64	0.0625000
NODE_8126_length_931_cov_1.433894	220	284	16	4	64	0.0625000
NODE_8126_length_931_cov_1.433894	220	284	17	2	64	0.0312500
NODE_8126_length_931_cov_1.433894	220	284	18	8	64	0.1250000
NODE_8126_length_931_cov_1.433894	220	284	20	6	64	0.0937500
NODE_8131_length_930_cov_49.052948	252	332	2	80	80	1.0000000
NODE_8131_length_930_cov_49.052948	305	385	0	37	80	0.4625000
NODE_8131_length_930_cov_49.052948	305	385	2	42	80	0.5250000
NODE_8131_length_930_cov_49.052948	305	385	8	1	80	0.0125000
NODE_8131_length_930_cov_49.052948	381	462	0	3	81	0.0370370
NODE_8131_length_930_cov_49.052948	381	462	8	21	81	0.2592593
NODE_8131_length_930_cov_49.052948	381	462	14	1	81	0.0123457
NODE_8131_length_930_cov_49.052948	381	462	16	18	81	0.2222222
NODE_8131_length_930_cov_49.052948	381	462	20	38	81	0.4691358
NODE_8131_length_930_cov_49.052948	435	515	15	27	80	0.3375000
NODE_8131_length_930_cov_49.052948	435	515	19	23	80	0.2875000
NODE_8131_length_930_cov_49.052948	435	515	20	30	80	0.3750000
NODE_8132_length_930_cov_31.510229	400	482	0	26	82	0.3170732
NODE_8132_length_930_cov_31.510229	400	482	2	56	82	0.6829268
NODE_8132_length_930_cov_31.510229	453	535	0	79	82	0.9634146
NODE_8132_length_930_cov_31.510229	453	535	2	3	82	0.0365854
NODE_8133_length_930_cov_29.139591	329	409	0	80	80	1.0000000
NODE_8133_length_930_cov_29.139591	382	462	0	80	80	1.0000000
NODE_8134_length_930_cov_24.787004	518	598	0	80	80	1.0000000
NODE_8134_length_930_cov_24.787004	571	651	0	80	80	1.0000000
NODE_8135_length_930_cov_24.608905	300	380	0	80	80	1.0000000
NODE_8135_length_930_cov_24.608905	353	433	0	80	80	1.0000000
NODE_8136_length_930_cov_16.494585	482	562	0	28	80	0.3500000
NODE_8136_length_930_cov_16.494585	482	562	2	1	80	0.0125000
NODE_8136_length_930_cov_16.494585	482	562	4	51	80	0.6375000
NODE_8136_length_930_cov_16.494585	535	615	0	29	80	0.3625000
NODE_8136_length_930_cov_16.494585	535	615	2	7	80	0.0875000
NODE_8136_length_930_cov_16.494585	535	615	4	44	80	0.5500000
NODE_8137_length_930_cov_13.296029	249	329	0	80	80	1.0000000
NODE_8137_length_930_cov_13.296029	302	382	0	80	80	1.0000000
NODE_8137_length_930_cov_13.296029	378	458	0	80	80	1.0000000
NODE_8137_length_930_cov_13.296029	431	511	0	80	80	1.0000000
NODE_8138_length_930_cov_11.758123	463	543	0	14	80	0.1750000
NODE_8138_length_930_cov_11.758123	463	543	4	66	80	0.8250000
NODE_8138_length_930_cov_11.758123	516	596	0	37	80	0.4625000
NODE_8138_length_930_cov_11.758123	516	596	4	43	80	0.5375000
NODE_8139_length_930_cov_7.576414	531	611	0	65	80	0.8125000
NODE_8139_length_930_cov_7.576414	531	611	2	15	80	0.1875000
NODE_8139_length_930_cov_7.576414	584	664	0	80	80	1.0000000
NODE_8156_length_930_cov_0.821901	676	736	0	60	60	1.0000000
NODE_8157_length_929_cov_54.485542	313	393	2	63	80	0.7875000
NODE_8157_length_929_cov_54.485542	313	393	4	17	80	0.2125000
NODE_8157_length_929_cov_54.485542	366	446	0	28	80	0.3500000
NODE_8157_length_929_cov_54.485542	366	446	2	51	80	0.6375000
NODE_8157_length_929_cov_54.485542	366	446	4	1	80	0.0125000
NODE_8157_length_929_cov_54.485542	442	522	0	80	80	1.0000000
NODE_8157_length_929_cov_54.485542	495	575	0	80	80	1.0000000
NODE_8158_length_929_cov_49.865060	429	509	0	58	80	0.7250000
NODE_8158_length_929_cov_49.865060	429	509	2	14	80	0.1750000
NODE_8158_length_929_cov_49.865060	429	509	4	8	80	0.1000000
NODE_8158_length_929_cov_49.865060	482	562	0	5	80	0.0625000
NODE_8158_length_929_cov_49.865060	482	562	2	14	80	0.1750000
NODE_8158_length_929_cov_49.865060	482	562	4	11	80	0.1375000
NODE_8158_length_929_cov_49.865060	482	562	6	47	80	0.5875000
NODE_8158_length_929_cov_49.865060	482	562	8	3	80	0.0375000
NODE_8159_length_929_cov_34.634940	358	438	0	10	80	0.1250000
NODE_8159_length_929_cov_34.634940	358	438	2	70	80	0.8750000
NODE_8159_length_929_cov_34.634940	411	491	0	51	80	0.6375000
NODE_8159_length_929_cov_34.634940	411	491	2	29	80	0.3625000
NODE_8161_length_929_cov_20.815663	365	445	0	80	80	1.0000000
NODE_8161_length_929_cov_20.815663	418	498	0	80	80	1.0000000
NODE_8162_length_929_cov_17.798795	376	456	0	36	80	0.4500000
NODE_8162_length_929_cov_17.798795	376	456	8	44	80	0.5500000
NODE_8162_length_929_cov_17.798795	429	509	8	80	80	1.0000000
NODE_8163_length_929_cov_16.622892	331	408	0	77	77	1.0000000
NODE_8163_length_929_cov_16.622892	381	461	0	80	80	1.0000000
NODE_8163_length_929_cov_16.622892	457	537	0	80	80	1.0000000
NODE_8163_length_929_cov_16.622892	510	590	0	80	80	1.0000000
NODE_8164_length_929_cov_15.242169	302	382	0	80	80	1.0000000
NODE_8164_length_929_cov_15.242169	355	435	0	80	80	1.0000000
NODE_8164_length_929_cov_15.242169	431	511	0	25	80	0.3125000
NODE_8164_length_929_cov_15.242169	431	511	2	55	80	0.6875000
NODE_8164_length_929_cov_15.242169	484	564	0	13	80	0.1625000
NODE_8164_length_929_cov_15.242169	484	564	2	67	80	0.8375000
NODE_8165_length_929_cov_13.197590	259	339	0	4	80	0.0500000
NODE_8165_length_929_cov_13.197590	259	339	4	11	80	0.1375000
NODE_8165_length_929_cov_13.197590	259	339	10	65	80	0.8125000
NODE_8165_length_929_cov_13.197590	312	392	0	4	80	0.0500000
NODE_8165_length_929_cov_13.197590	312	392	6	22	80	0.2750000
NODE_8165_length_929_cov_13.197590	312	392	10	54	80	0.6750000
NODE_8167_length_929_cov_7.766265	385	465	0	80	80	1.0000000
NODE_8167_length_929_cov_7.766265	438	518	0	33	80	0.4125000
NODE_8167_length_929_cov_7.766265	438	518	2	47	80	0.5875000
NODE_8168_length_929_cov_5.750602	382	462	0	15	80	0.1875000
NODE_8168_length_929_cov_5.750602	382	462	2	65	80	0.8125000
NODE_8168_length_929_cov_5.750602	435	515	0	68	80	0.8500000
NODE_8168_length_929_cov_5.750602	435	515	2	12	80	0.1500000
NODE_8181_length_928_cov_35.226779	273	353	0	6	80	0.0750000
NODE_8181_length_928_cov_35.226779	273	353	2	74	80	0.9250000
NODE_8181_length_928_cov_35.226779	326	406	0	59	80	0.7375000
NODE_8181_length_928_cov_35.226779	326	406	2	21	80	0.2625000
NODE_8181_length_928_cov_35.226779	402	482	0	80	80	1.0000000
NODE_8181_length_928_cov_35.226779	455	535	0	69	80	0.8625000
NODE_8181_length_928_cov_35.226779	455	535	2	11	80	0.1375000
NODE_8182_length_928_cov_25.218335	299	379	0	80	80	1.0000000
NODE_8182_length_928_cov_25.218335	352	432	0	80	80	1.0000000
NODE_8183_length_928_cov_22.815440	342	422	0	54	80	0.6750000
NODE_8183_length_928_cov_22.815440	342	422	2	26	80	0.3250000
NODE_8183_length_928_cov_22.815440	395	475	0	32	80	0.4000000
NODE_8183_length_928_cov_22.815440	395	475	2	48	80	0.6000000
NODE_8183_length_928_cov_22.815440	471	551	2	80	80	1.0000000
NODE_8183_length_928_cov_22.815440	524	604	0	38	80	0.4750000
NODE_8183_length_928_cov_22.815440	524	604	2	42	80	0.5250000
NODE_8184_length_928_cov_20.718938	365	445	0	80	80	1.0000000
NODE_8184_length_928_cov_20.718938	418	498	0	80	80	1.0000000
NODE_8185_length_928_cov_19.418577	420	500	6	40	80	0.5000000
NODE_8185_length_928_cov_19.418577	420	500	8	40	80	0.5000000
NODE_8185_length_928_cov_19.418577	473	553	0	3	80	0.0375000
NODE_8185_length_928_cov_19.418577	473	553	2	7	80	0.0875000
NODE_8185_length_928_cov_19.418577	473	553	4	42	80	0.5250000
NODE_8185_length_928_cov_19.418577	473	553	6	7	80	0.0875000
NODE_8185_length_928_cov_19.418577	473	553	8	21	80	0.2625000
NODE_8185_length_928_cov_19.418577	549	591	2	9	42	0.2142857
NODE_8185_length_928_cov_19.418577	549	591	4	33	42	0.7857143
NODE_8186_length_928_cov_13.354644	323	403	0	20	80	0.2500000
NODE_8186_length_928_cov_13.354644	323	403	3	1	80	0.0125000
NODE_8186_length_928_cov_13.354644	323	403	4	59	80	0.7375000
NODE_8186_length_928_cov_13.354644	376	456	0	32	80	0.4000000
NODE_8186_length_928_cov_13.354644	376	456	4	48	80	0.6000000
NODE_8187_length_928_cov_13.096502	361	441	2	80	80	1.0000000
NODE_8187_length_928_cov_13.096502	414	494	0	24	80	0.3000000
NODE_8187_length_928_cov_13.096502	414	494	2	56	80	0.7000000
NODE_8189_length_928_cov_10.399276	447	527	0	14	80	0.1750000
NODE_8189_length_928_cov_10.399276	447	527	4	66	80	0.8250000
NODE_8189_length_928_cov_10.399276	500	580	0	22	80	0.2750000
NODE_8189_length_928_cov_10.399276	500	580	4	58	80	0.7250000
NODE_8207_length_927_cov_19.516908	398	478	0	44	80	0.5500000
NODE_8207_length_927_cov_19.516908	398	478	2	36	80	0.4500000
NODE_8207_length_927_cov_19.516908	451	531	0	80	80	1.0000000
NODE_8208_length_927_cov_11.190821	358	438	0	18	80	0.2250000
NODE_8208_length_927_cov_11.190821	358	438	2	62	80	0.7750000
NODE_8208_length_927_cov_11.190821	411	491	0	42	80	0.5250000
NODE_8208_length_927_cov_11.190821	411	491	2	38	80	0.4750000
NODE_8209_length_927_cov_8.123188	239	319	0	80	80	1.0000000
NODE_8209_length_927_cov_8.123188	292	372	0	80	80	1.0000000
NODE_8210_length_927_cov_4.585749	515	595	0	80	80	1.0000000
NODE_8210_length_927_cov_4.585749	568	648	0	80	80	1.0000000
NODE_8222_length_927_cov_1.250000	626	706	0	80	80	1.0000000
NODE_8222_length_927_cov_1.250000	679	759	0	80	80	1.0000000
NODE_8227_length_926_cov_78.382104	433	513	0	21	80	0.2625000
NODE_8227_length_926_cov_78.382104	433	513	8	59	80	0.7375000
NODE_8227_length_926_cov_78.382104	486	566	0	13	80	0.1625000
NODE_8227_length_926_cov_78.382104	486	566	8	67	80	0.8375000
NODE_8228_length_926_cov_44.385732	383	463	0	80	80	1.0000000
NODE_8228_length_926_cov_44.385732	436	516	0	80	80	1.0000000
NODE_8229_length_926_cov_43.446191	362	442	0	80	80	1.0000000
NODE_8229_length_926_cov_43.446191	415	495	0	80	80	1.0000000
NODE_8229_length_926_cov_43.446191	491	571	0	80	80	1.0000000
NODE_8229_length_926_cov_43.446191	544	624	0	80	80	1.0000000
NODE_8230_length_926_cov_40.163241	42	61	0	13	19	0.6842105
NODE_8230_length_926_cov_40.163241	42	61	2	6	19	0.3157895
NODE_8230_length_926_cov_40.163241	279	359	6	41	80	0.5125000
NODE_8230_length_926_cov_40.163241	279	359	8	39	80	0.4875000
NODE_8230_length_926_cov_40.163241	332	412	0	6	80	0.0750000
NODE_8230_length_926_cov_40.163241	332	412	2	17	80	0.2125000
NODE_8230_length_926_cov_40.163241	332	412	8	57	80	0.7125000
NODE_8230_length_926_cov_40.163241	408	488	0	80	80	1.0000000
NODE_8230_length_926_cov_40.163241	461	541	0	80	80	1.0000000
NODE_8231_length_926_cov_29.923821	372	452	0	2	80	0.0250000
NODE_8231_length_926_cov_29.923821	372	452	2	78	80	0.9750000
NODE_8231_length_926_cov_29.923821	425	505	0	55	80	0.6875000
NODE_8231_length_926_cov_29.923821	425	505	2	25	80	0.3125000
NODE_8232_length_926_cov_24.657799	350	430	0	65	80	0.8125000
NODE_8232_length_926_cov_24.657799	350	430	2	15	80	0.1875000
NODE_8232_length_926_cov_24.657799	403	483	0	12	80	0.1500000
NODE_8232_length_926_cov_24.657799	403	483	2	68	80	0.8500000
NODE_8233_length_926_cov_17.438936	360	440	4	61	80	0.7625000
NODE_8233_length_926_cov_17.438936	360	440	6	8	80	0.1000000
NODE_8233_length_926_cov_17.438936	360	440	8	11	80	0.1375000
NODE_8233_length_926_cov_17.438936	413	493	4	61	80	0.7625000
NODE_8233_length_926_cov_17.438936	413	493	6	8	80	0.1000000
NODE_8233_length_926_cov_17.438936	413	493	8	11	80	0.1375000
NODE_8234_length_926_cov_12.413543	418	491	2	47	73	0.6438356
NODE_8234_length_926_cov_12.413543	418	491	4	26	73	0.3561644
NODE_8234_length_926_cov_12.413543	464	544	2	1	80	0.0125000
NODE_8234_length_926_cov_12.413543	464	544	4	79	80	0.9875000
NODE_8235_length_926_cov_5.771463	453	533	0	80	80	1.0000000
NODE_8235_length_926_cov_5.771463	505	586	0	81	81	1.0000000
NODE_8236_length_926_cov_5.209190	435	515	0	80	80	1.0000000
NODE_8236_length_926_cov_5.209190	488	568	0	80	80	1.0000000
NODE_8247_length_925_cov_40.767554	514	594	0	80	80	1.0000000
NODE_8247_length_925_cov_40.767554	567	647	0	51	80	0.6375000
NODE_8247_length_925_cov_40.767554	567	647	2	29	80	0.3625000
NODE_8248_length_925_cov_30.226392	262	342	0	80	80	1.0000000
NODE_8248_length_925_cov_30.226392	315	395	0	80	80	1.0000000
NODE_8248_length_925_cov_30.226392	391	471	0	57	80	0.7125000
NODE_8248_length_925_cov_30.226392	391	471	2	23	80	0.2875000
NODE_8248_length_925_cov_30.226392	444	524	0	5	80	0.0625000
NODE_8248_length_925_cov_30.226392	444	524	2	75	80	0.9375000
NODE_8249_length_925_cov_22.075061	334	414	0	80	80	1.0000000
NODE_8249_length_925_cov_22.075061	387	467	0	80	80	1.0000000
NODE_8250_length_925_cov_18.164649	410	490	0	39	80	0.4875000
NODE_8250_length_925_cov_18.164649	410	490	2	41	80	0.5125000
NODE_8250_length_925_cov_18.164649	464	543	2	79	79	1.0000000
NODE_8251_length_925_cov_14.067797	472	548	0	65	76	0.8552632
NODE_8251_length_925_cov_14.067797	472	548	2	11	76	0.1447368
NODE_8251_length_925_cov_14.067797	525	601	0	12	76	0.1578947
NODE_8251_length_925_cov_14.067797	525	601	2	64	76	0.8421053
NODE_8252_length_925_cov_7.098063	418	498	0	24	80	0.3000000
NODE_8252_length_925_cov_7.098063	418	498	4	56	80	0.7000000
NODE_8252_length_925_cov_7.098063	471	551	0	77	80	0.9625000
NODE_8252_length_925_cov_7.098063	471	551	4	3	80	0.0375000
NODE_8266_length_924_cov_61.292121	397	477	0	80	80	1.0000000
NODE_8266_length_924_cov_61.292121	450	530	0	80	80	1.0000000
NODE_8267_length_924_cov_31.522424	375	455	0	80	80	1.0000000
NODE_8267_length_924_cov_31.522424	428	508	0	80	80	1.0000000
NODE_8268_length_924_cov_30.446061	299	379	0	80	80	1.0000000
NODE_8268_length_924_cov_30.446061	352	432	0	80	80	1.0000000
NODE_8268_length_924_cov_30.446061	428	508	0	18	80	0.2250000
NODE_8268_length_924_cov_30.446061	428	508	2	62	80	0.7750000
NODE_8268_length_924_cov_30.446061	481	561	0	40	80	0.5000000
NODE_8268_length_924_cov_30.446061	481	561	2	40	80	0.5000000
NODE_8269_length_924_cov_28.877576	542	622	0	80	80	1.0000000
NODE_8269_length_924_cov_28.877576	595	675	0	80	80	1.0000000
NODE_8270_length_924_cov_27.261818	506	586	0	3	80	0.0375000
NODE_8270_length_924_cov_27.261818	506	586	5	77	80	0.9625000
NODE_8270_length_924_cov_27.261818	559	639	0	4	80	0.0500000
NODE_8270_length_924_cov_27.261818	559	639	5	76	80	0.9500000
NODE_8271_length_924_cov_25.946667	371	451	0	80	80	1.0000000
NODE_8271_length_924_cov_25.946667	424	504	0	80	80	1.0000000
NODE_8271_length_924_cov_25.946667	500	580	0	80	80	1.0000000
NODE_8271_length_924_cov_25.946667	553	633	0	80	80	1.0000000
NODE_8272_length_924_cov_25.113939	305	385	0	80	80	1.0000000
NODE_8272_length_924_cov_25.113939	358	438	0	80	80	1.0000000
NODE_8272_length_924_cov_25.113939	434	514	0	80	80	1.0000000
NODE_8272_length_924_cov_25.113939	487	567	0	80	80	1.0000000
NODE_8273_length_924_cov_16.343030	481	561	0	80	80	1.0000000
NODE_8273_length_924_cov_16.343030	534	614	0	72	80	0.9000000
NODE_8273_length_924_cov_16.343030	534	614	2	8	80	0.1000000
NODE_8274_length_924_cov_14.793939	299	379	0	80	80	1.0000000
NODE_8274_length_924_cov_14.793939	352	432	0	36	80	0.4500000
NODE_8274_length_924_cov_14.793939	352	432	2	44	80	0.5500000
NODE_8275_length_924_cov_14.209697	485	562	0	77	77	1.0000000
NODE_8275_length_924_cov_14.209697	535	615	0	80	80	1.0000000
NODE_8276_length_924_cov_13.423030	287	367	2	80	80	1.0000000
NODE_8276_length_924_cov_13.423030	340	420	0	47	80	0.5875000
NODE_8276_length_924_cov_13.423030	340	420	2	33	80	0.4125000
NODE_8277_length_924_cov_12.008485	237	307	0	70	70	1.0000000
NODE_8279_length_924_cov_8.619394	560	640	0	80	80	1.0000000
NODE_8279_length_924_cov_8.619394	613	693	0	80	80	1.0000000
NODE_8280_length_924_cov_4.640000	426	506	0	80	80	1.0000000
NODE_8280_length_924_cov_4.640000	479	559	0	80	80	1.0000000
NODE_8290_length_924_cov_1.467879	352	381	0	29	29	1.0000000
NODE_8296_length_924_cov_0.648485	830	890	0	60	60	1.0000000
NODE_8296_length_924_cov_0.648485	863	924	0	61	61	1.0000000
NODE_8297_length_923_cov_43.213592	371	451	0	80	80	1.0000000
NODE_8297_length_923_cov_43.213592	424	504	0	80	80	1.0000000
NODE_8297_length_923_cov_43.213592	500	580	0	80	80	1.0000000
NODE_8297_length_923_cov_43.213592	553	633	0	80	80	1.0000000
NODE_8298_length_923_cov_34.108010	370	450	3	15	80	0.1875000
NODE_8298_length_923_cov_34.108010	370	450	7	33	80	0.4125000
NODE_8298_length_923_cov_34.108010	370	450	8	28	80	0.3500000
NODE_8298_length_923_cov_34.108010	370	450	12	4	80	0.0500000
NODE_8298_length_923_cov_34.108010	423	503	4	16	80	0.2000000
NODE_8298_length_923_cov_34.108010	423	503	8	38	80	0.4750000
NODE_8298_length_923_cov_34.108010	423	503	12	26	80	0.3250000
NODE_8299_length_923_cov_29.163835	392	472	0	47	80	0.5875000
NODE_8299_length_923_cov_29.163835	392	472	2	2	80	0.0250000
NODE_8299_length_923_cov_29.163835	392	472	7	2	80	0.0250000
NODE_8299_length_923_cov_29.163835	392	472	8	29	80	0.3625000
NODE_8299_length_923_cov_29.163835	445	525	8	52	80	0.6500000
NODE_8299_length_923_cov_29.163835	445	525	11	25	80	0.3125000
NODE_8299_length_923_cov_29.163835	445	525	13	3	80	0.0375000
NODE_8300_length_923_cov_19.139563	375	455	0	80	80	1.0000000
NODE_8300_length_923_cov_19.139563	428	508	0	75	80	0.9375000
NODE_8300_length_923_cov_19.139563	428	508	2	5	80	0.0625000
NODE_8301_length_923_cov_17.433252	512	592	0	7	80	0.0875000
NODE_8301_length_923_cov_17.433252	512	592	2	73	80	0.9125000
NODE_8301_length_923_cov_17.433252	565	645	0	60	80	0.7500000
NODE_8301_length_923_cov_17.433252	565	645	2	20	80	0.2500000
NODE_8302_length_923_cov_16.597087	279	359	4	80	80	1.0000000
NODE_8302_length_923_cov_16.597087	332	412	0	37	80	0.4625000
NODE_8302_length_923_cov_16.597087	332	412	2	6	80	0.0750000
NODE_8302_length_923_cov_16.597087	332	412	4	37	80	0.4625000
NODE_8303_length_923_cov_15.229369	446	526	0	80	80	1.0000000
NODE_8303_length_923_cov_15.229369	499	579	0	71	80	0.8875000
NODE_8303_length_923_cov_15.229369	499	579	2	9	80	0.1125000
NODE_8304_length_923_cov_14.007282	304	349	0	6	45	0.1333333
NODE_8304_length_923_cov_14.007282	304	349	2	39	45	0.8666667
NODE_8304_length_923_cov_14.007282	345	427	0	34	82	0.4146341
NODE_8304_length_923_cov_14.007282	345	427	2	48	82	0.5853658
NODE_8304_length_923_cov_14.007282	397	480	0	83	83	1.0000000
NODE_8305_length_923_cov_6.500000	308	388	0	9	80	0.1125000
NODE_8305_length_923_cov_6.500000	308	388	2	71	80	0.8875000
NODE_8305_length_923_cov_6.500000	361	441	0	62	80	0.7750000
NODE_8305_length_923_cov_6.500000	361	441	2	18	80	0.2250000
NODE_8307_length_923_cov_6.115291	447	527	0	80	80	1.0000000
NODE_8307_length_923_cov_6.115291	500	580	0	80	80	1.0000000
NODE_8308_length_923_cov_5.351942	363	445	0	18	82	0.2195122
NODE_8308_length_923_cov_5.351942	363	445	4	64	82	0.7804878
NODE_8308_length_923_cov_5.351942	365	445	0	18	80	0.2250000
NODE_8308_length_923_cov_5.351942	365	445	4	62	80	0.7750000
NODE_8317_length_923_cov_1.059466	63	143	0	40	80	0.5000000
NODE_8317_length_923_cov_1.059466	63	143	2	4	80	0.0500000
NODE_8317_length_923_cov_1.059466	63	143	4	36	80	0.4500000
NODE_8320_length_922_cov_40.331713	243	289	68	1	46	0.0217391
NODE_8320_length_922_cov_40.331713	243	289	69	1	46	0.0217391
NODE_8320_length_922_cov_40.331713	243	289	71	1	46	0.0217391
NODE_8320_length_922_cov_40.331713	243	289	73	2	46	0.0434783
NODE_8320_length_922_cov_40.331713	243	289	74	1	46	0.0217391
NODE_8320_length_922_cov_40.331713	243	289	75	1	46	0.0217391
NODE_8320_length_922_cov_40.331713	243	289	76	2	46	0.0434783
NODE_8320_length_922_cov_40.331713	243	289	77	1	46	0.0217391
NODE_8320_length_922_cov_40.331713	243	289	78	1	46	0.0217391
NODE_8320_length_922_cov_40.331713	243	289	79	4	46	0.0869565
NODE_8320_length_922_cov_40.331713	243	289	80	3	46	0.0652174
NODE_8320_length_922_cov_40.331713	243	289	81	1	46	0.0217391
NODE_8320_length_922_cov_40.331713	243	289	83	1	46	0.0217391
NODE_8320_length_922_cov_40.331713	243	289	84	1	46	0.0217391
NODE_8320_length_922_cov_40.331713	243	289	86	1	46	0.0217391
NODE_8320_length_922_cov_40.331713	243	289	96	1	46	0.0217391
NODE_8320_length_922_cov_40.331713	243	289	98	2	46	0.0434783
NODE_8320_length_922_cov_40.331713	243	289	104	2	46	0.0434783
NODE_8320_length_922_cov_40.331713	243	289	108	2	46	0.0434783
NODE_8320_length_922_cov_40.331713	243	289	109	1	46	0.0217391
NODE_8320_length_922_cov_40.331713	243	289	115	1	46	0.0217391
NODE_8320_length_922_cov_40.331713	243	289	117	2	46	0.0434783
NODE_8320_length_922_cov_40.331713	243	289	121	2	46	0.0434783
NODE_8320_length_922_cov_40.331713	243	289	127	4	46	0.0869565
NODE_8320_length_922_cov_40.331713	243	289	131	1	46	0.0217391
NODE_8320_length_922_cov_40.331713	243	289	134	4	46	0.0869565
NODE_8320_length_922_cov_40.331713	243	289	142	1	46	0.0217391
NODE_8320_length_922_cov_40.331713	243	289	144	1	46	0.0217391
NODE_8320_length_922_cov_40.331713	262	342	68	1	80	0.0125000
NODE_8320_length_922_cov_40.331713	262	342	69	1	80	0.0125000
NODE_8320_length_922_cov_40.331713	262	342	71	1	80	0.0125000
NODE_8320_length_922_cov_40.331713	262	342	73	2	80	0.0250000
NODE_8320_length_922_cov_40.331713	262	342	74	1	80	0.0125000
NODE_8320_length_922_cov_40.331713	262	342	75	1	80	0.0125000
NODE_8320_length_922_cov_40.331713	262	342	76	2	80	0.0250000
NODE_8320_length_922_cov_40.331713	262	342	77	3	80	0.0375000
NODE_8320_length_922_cov_40.331713	262	342	78	1	80	0.0125000
NODE_8320_length_922_cov_40.331713	262	342	79	5	80	0.0625000
NODE_8320_length_922_cov_40.331713	262	342	80	6	80	0.0750000
NODE_8320_length_922_cov_40.331713	262	342	81	2	80	0.0250000
NODE_8320_length_922_cov_40.331713	262	342	83	1	80	0.0125000
NODE_8320_length_922_cov_40.331713	262	342	84	1	80	0.0125000
NODE_8320_length_922_cov_40.331713	262	342	86	1	80	0.0125000
NODE_8320_length_922_cov_40.331713	262	342	91	1	80	0.0125000
NODE_8320_length_922_cov_40.331713	262	342	96	1	80	0.0125000
NODE_8320_length_922_cov_40.331713	262	342	98	2	80	0.0250000
NODE_8320_length_922_cov_40.331713	262	342	101	4	80	0.0500000
NODE_8320_length_922_cov_40.331713	262	342	104	2	80	0.0250000
NODE_8320_length_922_cov_40.331713	262	342	110	1	80	0.0125000
NODE_8320_length_922_cov_40.331713	262	342	111	1	80	0.0125000
NODE_8320_length_922_cov_40.331713	262	342	112	1	80	0.0125000
NODE_8320_length_922_cov_40.331713	262	342	117	1	80	0.0125000
NODE_8320_length_922_cov_40.331713	262	342	121	1	80	0.0125000
NODE_8320_length_922_cov_40.331713	262	342	122	1	80	0.0125000
NODE_8320_length_922_cov_40.331713	262	342	123	1	80	0.0125000
NODE_8320_length_922_cov_40.331713	262	342	126	2	80	0.0250000
NODE_8320_length_922_cov_40.331713	262	342	128	1	80	0.0125000
NODE_8320_length_922_cov_40.331713	262	342	146	2	80	0.0250000
NODE_8320_length_922_cov_40.331713	262	342	151	1	80	0.0125000
NODE_8320_length_922_cov_40.331713	262	342	155	1	80	0.0125000
NODE_8320_length_922_cov_40.331713	262	342	160	2	80	0.0250000
NODE_8320_length_922_cov_40.331713	262	342	170	1	80	0.0125000
NODE_8320_length_922_cov_40.331713	262	342	174	1	80	0.0125000
NODE_8320_length_922_cov_40.331713	262	342	182	1	80	0.0125000
NODE_8320_length_922_cov_40.331713	262	342	193	1	80	0.0125000
NODE_8320_length_922_cov_40.331713	262	342	197	1	80	0.0125000
NODE_8320_length_922_cov_40.331713	262	342	205	1	80	0.0125000
NODE_8320_length_922_cov_40.331713	262	342	211	1	80	0.0125000
NODE_8320_length_922_cov_40.331713	262	342	213	1	80	0.0125000
NODE_8320_length_922_cov_40.331713	262	342	217	5	80	0.0625000
NODE_8320_length_922_cov_40.331713	262	342	219	2	80	0.0250000
NODE_8320_length_922_cov_40.331713	262	342	225	1	80	0.0125000
NODE_8320_length_922_cov_40.331713	262	342	231	2	80	0.0250000
NODE_8320_length_922_cov_40.331713	262	342	234	1	80	0.0125000
NODE_8320_length_922_cov_40.331713	262	342	236	1	80	0.0125000
NODE_8320_length_922_cov_40.331713	262	342	237	2	80	0.0250000
NODE_8320_length_922_cov_40.331713	262	342	241	1	80	0.0125000
NODE_8320_length_922_cov_40.331713	262	342	243	1	80	0.0125000
NODE_8320_length_922_cov_40.331713	262	342	245	1	80	0.0125000
NODE_8320_length_922_cov_40.331713	780	860	10	23	80	0.2875000
NODE_8320_length_922_cov_40.331713	780	860	11	5	80	0.0625000
NODE_8320_length_922_cov_40.331713	780	860	12	10	80	0.1250000
NODE_8320_length_922_cov_40.331713	780	860	13	42	80	0.5250000
NODE_8320_length_922_cov_40.331713	833	913	2	21	80	0.2625000
NODE_8320_length_922_cov_40.331713	833	913	6	26	80	0.3250000
NODE_8320_length_922_cov_40.331713	833	913	8	2	80	0.0250000
NODE_8320_length_922_cov_40.331713	833	913	13	31	80	0.3875000
NODE_8321_length_922_cov_38.549210	126	177	144	2	51	0.0392157
NODE_8321_length_922_cov_38.549210	126	177	160	1	51	0.0196078
NODE_8321_length_922_cov_38.549210	126	177	168	1	51	0.0196078
NODE_8321_length_922_cov_38.549210	126	177	187	2	51	0.0392157
NODE_8321_length_922_cov_38.549210	126	177	188	1	51	0.0196078
NODE_8321_length_922_cov_38.549210	126	177	195	1	51	0.0196078
NODE_8321_length_922_cov_38.549210	126	177	200	1	51	0.0196078
NODE_8321_length_922_cov_38.549210	126	177	205	1	51	0.0196078
NODE_8321_length_922_cov_38.549210	126	177	206	2	51	0.0392157
NODE_8321_length_922_cov_38.549210	126	177	218	1	51	0.0196078
NODE_8321_length_922_cov_38.549210	126	177	220	1	51	0.0196078
NODE_8321_length_922_cov_38.549210	126	177	234	1	51	0.0196078
NODE_8321_length_922_cov_38.549210	126	177	236	1	51	0.0196078
NODE_8321_length_922_cov_38.549210	126	177	243	1	51	0.0196078
NODE_8321_length_922_cov_38.549210	126	177	250	1	51	0.0196078
NODE_8321_length_922_cov_38.549210	126	177	254	1	51	0.0196078
NODE_8321_length_922_cov_38.549210	126	177	261	1	51	0.0196078
NODE_8321_length_922_cov_38.549210	126	177	262	2	51	0.0392157
NODE_8321_length_922_cov_38.549210	126	177	263	1	51	0.0196078
NODE_8321_length_922_cov_38.549210	126	177	266	3	51	0.0588235
NODE_8321_length_922_cov_38.549210	126	177	271	1	51	0.0196078
NODE_8321_length_922_cov_38.549210	126	177	279	1	51	0.0196078
NODE_8321_length_922_cov_38.549210	126	177	283	1	51	0.0196078
NODE_8321_length_922_cov_38.549210	126	177	291	1	51	0.0196078
NODE_8321_length_922_cov_38.549210	126	177	297	2	51	0.0392157
NODE_8321_length_922_cov_38.549210	126	177	309	1	51	0.0196078
NODE_8321_length_922_cov_38.549210	126	177	317	1	51	0.0196078
NODE_8321_length_922_cov_38.549210	126	177	324	1	51	0.0196078
NODE_8321_length_922_cov_38.549210	126	177	328	1	51	0.0196078
NODE_8321_length_922_cov_38.549210	126	177	329	1	51	0.0196078
NODE_8321_length_922_cov_38.549210	126	177	332	1	51	0.0196078
NODE_8321_length_922_cov_38.549210	126	177	333	1	51	0.0196078
NODE_8321_length_922_cov_38.549210	126	177	334	2	51	0.0392157
NODE_8321_length_922_cov_38.549210	126	177	336	4	51	0.0784314
NODE_8321_length_922_cov_38.549210	126	177	338	1	51	0.0196078
NODE_8321_length_922_cov_38.549210	126	177	339	2	51	0.0392157
NODE_8321_length_922_cov_38.549210	126	177	340	1	51	0.0196078
NODE_8321_length_922_cov_38.549210	126	177	346	1	51	0.0196078
NODE_8321_length_922_cov_38.549210	126	177	352	1	51	0.0196078
NODE_8321_length_922_cov_38.549210	308	383	0	75	75	1.0000000
NODE_8321_length_922_cov_38.549210	356	393	0	37	37	1.0000000
NODE_8321_length_922_cov_38.549210	818	898	0	80	80	1.0000000
NODE_8321_length_922_cov_38.549210	871	908	0	37	37	1.0000000
NODE_8322_length_922_cov_35.041312	385	465	0	80	80	1.0000000
NODE_8322_length_922_cov_35.041312	438	518	0	80	80	1.0000000
NODE_8323_length_922_cov_30.749696	426	506	2	12	80	0.1500000
NODE_8323_length_922_cov_30.749696	426	506	4	1	80	0.0125000
NODE_8323_length_922_cov_30.749696	426	506	5	17	80	0.2125000
NODE_8323_length_922_cov_30.749696	426	506	6	41	80	0.5125000
NODE_8323_length_922_cov_30.749696	426	506	8	9	80	0.1125000
NODE_8323_length_922_cov_30.749696	479	559	5	9	80	0.1125000
NODE_8323_length_922_cov_30.749696	479	559	6	62	80	0.7750000
NODE_8323_length_922_cov_30.749696	479	559	8	9	80	0.1125000
NODE_8324_length_922_cov_25.558931	291	370	2	79	79	1.0000000
NODE_8324_length_922_cov_25.558931	344	423	0	46	79	0.5822785
NODE_8324_length_922_cov_25.558931	344	423	2	33	79	0.4177215
NODE_8325_length_922_cov_25.527339	391	471	0	80	80	1.0000000
NODE_8325_length_922_cov_25.527339	444	524	0	80	80	1.0000000
NODE_8326_length_922_cov_23.630620	224	304	0	80	80	1.0000000
NODE_8326_length_922_cov_23.630620	277	357	0	80	80	1.0000000
NODE_8326_length_922_cov_23.630620	353	433	0	5	80	0.0625000
NODE_8326_length_922_cov_23.630620	353	433	2	45	80	0.5625000
NODE_8326_length_922_cov_23.630620	353	433	4	30	80	0.3750000
NODE_8326_length_922_cov_23.630620	406	486	2	13	80	0.1625000
NODE_8326_length_922_cov_23.630620	406	486	4	67	80	0.8375000
NODE_8327_length_922_cov_22.388821	465	545	0	80	80	1.0000000
NODE_8327_length_922_cov_22.388821	518	598	0	80	80	1.0000000
NODE_8328_length_922_cov_20.320778	421	501	0	80	80	1.0000000
NODE_8328_length_922_cov_20.320778	474	554	0	80	80	1.0000000
NODE_8329_length_922_cov_17.645200	413	479	0	3	66	0.0454545
NODE_8329_length_922_cov_17.645200	413	479	2	63	66	0.9545454
NODE_8330_length_922_cov_12.574727	454	534	0	53	80	0.6625000
NODE_8330_length_922_cov_12.574727	454	534	2	27	80	0.3375000
NODE_8330_length_922_cov_12.574727	507	587	2	80	80	1.0000000
NODE_8331_length_922_cov_11.934386	255	335	0	80	80	1.0000000
NODE_8331_length_922_cov_11.934386	308	388	0	80	80	1.0000000
NODE_8332_length_922_cov_11.068044	423	503	0	80	80	1.0000000
NODE_8332_length_922_cov_11.068044	476	557	0	81	81	1.0000000
NODE_8333_length_922_cov_7.907655	441	521	0	80	80	1.0000000
NODE_8333_length_922_cov_7.907655	494	574	0	80	80	1.0000000
NODE_8334_length_922_cov_7.737546	463	543	9	1	80	0.0125000
NODE_8334_length_922_cov_7.737546	463	543	10	27	80	0.3375000
NODE_8334_length_922_cov_7.737546	463	543	11	28	80	0.3500000
NODE_8334_length_922_cov_7.737546	463	543	12	23	80	0.2875000
NODE_8334_length_922_cov_7.737546	463	543	14	1	80	0.0125000
NODE_8334_length_922_cov_7.737546	516	596	0	2	80	0.0250000
NODE_8334_length_922_cov_7.737546	516	596	6	6	80	0.0750000
NODE_8334_length_922_cov_7.737546	516	596	8	28	80	0.3500000
NODE_8334_length_922_cov_7.737546	516	596	11	44	80	0.5500000
NODE_8335_length_922_cov_7.241798	298	378	0	80	80	1.0000000
NODE_8335_length_922_cov_7.241798	351	431	0	80	80	1.0000000
NODE_8347_length_921_cov_21.317518	457	537	0	80	80	1.0000000
NODE_8347_length_921_cov_21.317518	510	590	0	80	80	1.0000000
NODE_8348_length_921_cov_18.462287	519	599	0	80	80	1.0000000
NODE_8348_length_921_cov_18.462287	572	652	0	80	80	1.0000000
NODE_8349_length_921_cov_15.440389	373	453	0	80	80	1.0000000
NODE_8349_length_921_cov_15.440389	426	506	0	80	80	1.0000000
NODE_8350_length_921_cov_13.216545	465	545	0	80	80	1.0000000
NODE_8350_length_921_cov_13.216545	518	598	0	80	80	1.0000000
NODE_8351_length_921_cov_9.283455	399	439	2	40	40	1.0000000
NODE_8351_length_921_cov_9.283455	532	612	0	25	80	0.3125000
NODE_8351_length_921_cov_9.283455	532	612	6	54	80	0.6750000
NODE_8351_length_921_cov_9.283455	532	612	8	1	80	0.0125000
NODE_8351_length_921_cov_9.283455	585	665	0	78	80	0.9750000
NODE_8351_length_921_cov_9.283455	585	665	6	2	80	0.0250000
NODE_8352_length_921_cov_8.253041	289	369	0	80	80	1.0000000
NODE_8352_length_921_cov_8.253041	342	422	0	80	80	1.0000000
NODE_8364_length_920_cov_47.493301	543	623	0	80	80	1.0000000
NODE_8364_length_920_cov_47.493301	596	676	0	80	80	1.0000000
NODE_8365_length_920_cov_30.404385	543	623	0	59	80	0.7375000
NODE_8365_length_920_cov_30.404385	543	623	2	21	80	0.2625000
NODE_8365_length_920_cov_30.404385	596	676	0	15	80	0.1875000
NODE_8365_length_920_cov_30.404385	596	676	2	65	80	0.8125000
NODE_8366_length_920_cov_25.360536	413	493	2	18	80	0.2250000
NODE_8366_length_920_cov_25.360536	413	493	4	42	80	0.5250000
NODE_8366_length_920_cov_25.360536	413	493	6	20	80	0.2500000
NODE_8366_length_920_cov_25.360536	466	546	0	1	80	0.0125000
NODE_8366_length_920_cov_25.360536	466	546	2	70	80	0.8750000
NODE_8366_length_920_cov_25.360536	466	546	4	9	80	0.1125000
NODE_8366_length_920_cov_25.360536	542	615	0	39	73	0.5342466
NODE_8366_length_920_cov_25.360536	542	615	2	34	73	0.4657534
NODE_8366_length_920_cov_25.360536	588	668	0	80	80	1.0000000
NODE_8367_length_920_cov_24.918392	403	483	0	12	80	0.1500000
NODE_8367_length_920_cov_24.918392	403	483	2	34	80	0.4250000
NODE_8367_length_920_cov_24.918392	403	483	4	34	80	0.4250000
NODE_8367_length_920_cov_24.918392	456	536	2	7	80	0.0875000
NODE_8367_length_920_cov_24.918392	456	536	4	56	80	0.7000000
NODE_8367_length_920_cov_24.918392	456	536	6	17	80	0.2125000
NODE_8368_length_920_cov_18.517661	353	433	0	10	80	0.1250000
NODE_8368_length_920_cov_18.517661	353	433	4	70	80	0.8750000
NODE_8368_length_920_cov_18.517661	406	486	0	63	80	0.7875000
NODE_8368_length_920_cov_18.517661	406	486	4	17	80	0.2125000
NODE_8369_length_920_cov_17.710110	310	390	0	80	80	1.0000000
NODE_8369_length_920_cov_17.710110	363	443	0	80	80	1.0000000
NODE_8370_length_920_cov_15.650426	403	458	2	19	55	0.3454545
NODE_8370_length_920_cov_15.650426	403	458	4	36	55	0.6545454
NODE_8371_length_920_cov_12.588307	454	534	0	80	80	1.0000000
NODE_8371_length_920_cov_12.588307	507	586	0	79	79	1.0000000
NODE_8372_length_920_cov_10.822168	354	434	0	80	80	1.0000000
NODE_8372_length_920_cov_10.822168	407	487	0	80	80	1.0000000
NODE_8374_length_920_cov_8.297199	453	533	2	12	80	0.1500000
NODE_8374_length_920_cov_8.297199	453	533	3	2	80	0.0250000
NODE_8374_length_920_cov_8.297199	453	533	4	66	80	0.8250000
NODE_8374_length_920_cov_8.297199	506	583	2	55	77	0.7142857
NODE_8374_length_920_cov_8.297199	506	583	3	2	77	0.0259740
NODE_8374_length_920_cov_8.297199	506	583	4	20	77	0.2597403
NODE_8378_length_920_cov_2.992692	501	581	0	80	80	1.0000000
NODE_8378_length_920_cov_2.992692	554	634	0	80	80	1.0000000
NODE_8389_length_919_cov_44.813415	338	418	4	80	80	1.0000000
NODE_8389_length_919_cov_44.813415	391	471	0	2	80	0.0250000
NODE_8389_length_919_cov_44.813415	391	471	2	31	80	0.3875000
NODE_8389_length_919_cov_44.813415	391	471	4	47	80	0.5875000
NODE_8389_length_919_cov_44.813415	467	547	0	78	80	0.9750000
NODE_8389_length_919_cov_44.813415	467	547	2	2	80	0.0250000
NODE_8389_length_919_cov_44.813415	520	600	0	80	80	1.0000000
NODE_8390_length_919_cov_37.459756	389	469	2	17	80	0.2125000
NODE_8390_length_919_cov_37.459756	389	469	4	63	80	0.7875000
NODE_8390_length_919_cov_37.459756	442	522	0	8	80	0.1000000
NODE_8390_length_919_cov_37.459756	442	522	2	15	80	0.1875000
NODE_8390_length_919_cov_37.459756	442	522	4	57	80	0.7125000
NODE_8390_length_919_cov_37.459756	518	598	0	80	80	1.0000000
NODE_8390_length_919_cov_37.459756	571	651	0	80	80	1.0000000
NODE_8391_length_919_cov_35.002439	474	554	0	1	80	0.0125000
NODE_8391_length_919_cov_35.002439	474	554	2	67	80	0.8375000
NODE_8391_length_919_cov_35.002439	474	554	4	12	80	0.1500000
NODE_8391_length_919_cov_35.002439	527	607	0	54	80	0.6750000
NODE_8391_length_919_cov_35.002439	527	607	2	26	80	0.3250000
NODE_8392_length_919_cov_29.935366	246	326	0	80	80	1.0000000
NODE_8392_length_919_cov_29.935366	299	379	0	80	80	1.0000000
NODE_8393_length_919_cov_28.190244	470	550	2	80	80	1.0000000
NODE_8393_length_919_cov_28.190244	523	603	0	50	80	0.6250000
NODE_8393_length_919_cov_28.190244	523	603	2	30	80	0.3750000
NODE_8394_length_919_cov_27.119512	454	534	0	11	80	0.1375000
NODE_8394_length_919_cov_27.119512	454	534	2	5	80	0.0625000
NODE_8394_length_919_cov_27.119512	454	534	4	64	80	0.8000000
NODE_8394_length_919_cov_27.119512	507	587	0	64	80	0.8000000
NODE_8394_length_919_cov_27.119512	507	587	2	3	80	0.0375000
NODE_8394_length_919_cov_27.119512	507	587	4	13	80	0.1625000
NODE_8395_length_919_cov_21.836585	545	625	0	80	80	1.0000000
NODE_8395_length_919_cov_21.836585	598	677	0	79	79	1.0000000
NODE_8396_length_919_cov_17.442683	385	465	0	80	80	1.0000000
NODE_8396_length_919_cov_17.442683	438	518	0	80	80	1.0000000
NODE_8397_length_919_cov_16.685366	309	389	0	8	80	0.1000000
NODE_8397_length_919_cov_16.685366	309	389	2	51	80	0.6375000
NODE_8397_length_919_cov_16.685366	309	389	4	21	80	0.2625000
NODE_8397_length_919_cov_16.685366	362	442	0	61	80	0.7625000
NODE_8397_length_919_cov_16.685366	362	442	2	19	80	0.2375000
NODE_8398_length_919_cov_14.013415	435	515	0	80	80	1.0000000
NODE_8398_length_919_cov_14.013415	488	568	0	80	80	1.0000000
NODE_8399_length_919_cov_12.013415	340	420	0	80	80	1.0000000
NODE_8399_length_919_cov_12.013415	393	473	0	80	80	1.0000000
NODE_8403_length_919_cov_3.529268	424	504	0	80	80	1.0000000
NODE_8403_length_919_cov_3.529268	477	557	0	54	80	0.6750000
NODE_8403_length_919_cov_3.529268	477	557	2	26	80	0.3250000
NODE_8404_length_919_cov_3.200000	444	524	0	80	80	1.0000000
NODE_8404_length_919_cov_3.200000	497	577	0	80	80	1.0000000
NODE_8415_length_918_cov_41.115995	387	467	5	19	80	0.2375000
NODE_8415_length_918_cov_41.115995	387	467	6	27	80	0.3375000
NODE_8415_length_918_cov_41.115995	387	467	10	23	80	0.2875000
NODE_8415_length_918_cov_41.115995	387	467	11	11	80	0.1375000
NODE_8415_length_918_cov_41.115995	440	520	2	24	80	0.3000000
NODE_8415_length_918_cov_41.115995	440	520	5	22	80	0.2750000
NODE_8415_length_918_cov_41.115995	440	520	6	26	80	0.3250000
NODE_8415_length_918_cov_41.115995	440	520	11	8	80	0.1000000
NODE_8416_length_918_cov_37.405372	427	507	10	80	80	1.0000000
NODE_8416_length_918_cov_37.405372	480	560	0	53	80	0.6625000
NODE_8416_length_918_cov_37.405372	480	560	10	27	80	0.3375000
NODE_8417_length_918_cov_31.559219	289	369	0	56	80	0.7000000
NODE_8417_length_918_cov_31.559219	289	369	2	24	80	0.3000000
NODE_8417_length_918_cov_31.559219	342	422	0	3	80	0.0375000
NODE_8417_length_918_cov_31.559219	342	422	2	77	80	0.9625000
NODE_8417_length_918_cov_31.559219	418	498	0	39	80	0.4875000
NODE_8417_length_918_cov_31.559219	418	498	2	41	80	0.5125000
NODE_8417_length_918_cov_31.559219	471	551	0	80	80	1.0000000
NODE_8418_length_918_cov_25.195360	429	509	0	4	80	0.0500000
NODE_8418_length_918_cov_25.195360	429	509	2	34	80	0.4250000
NODE_8418_length_918_cov_25.195360	429	509	4	18	80	0.2250000
NODE_8418_length_918_cov_25.195360	429	509	6	24	80	0.3000000
NODE_8418_length_918_cov_25.195360	482	562	0	14	80	0.1750000
NODE_8418_length_918_cov_25.195360	482	562	2	3	80	0.0375000
NODE_8418_length_918_cov_25.195360	482	562	4	12	80	0.1500000
NODE_8418_length_918_cov_25.195360	482	562	6	51	80	0.6375000
NODE_8420_length_918_cov_10.537241	361	441	0	80	80	1.0000000
NODE_8420_length_918_cov_10.537241	414	492	0	78	78	1.0000000
NODE_8421_length_918_cov_9.821734	283	363	0	80	80	1.0000000
NODE_8421_length_918_cov_9.821734	336	416	0	80	80	1.0000000
NODE_8422_length_918_cov_9.714286	365	445	4	20	80	0.2500000
NODE_8422_length_918_cov_9.714286	365	445	8	26	80	0.3250000
NODE_8422_length_918_cov_9.714286	365	445	10	34	80	0.4250000
NODE_8422_length_918_cov_9.714286	418	498	2	9	80	0.1125000
NODE_8422_length_918_cov_9.714286	418	498	3	6	80	0.0750000
NODE_8422_length_918_cov_9.714286	418	498	4	58	80	0.7250000
NODE_8422_length_918_cov_9.714286	418	498	8	2	80	0.0250000
NODE_8422_length_918_cov_9.714286	418	498	10	5	80	0.0625000
NODE_8441_length_917_cov_38.845966	405	476	2	49	71	0.6901408
NODE_8441_length_917_cov_38.845966	405	476	4	22	71	0.3098592
NODE_8441_length_917_cov_38.845966	458	538	2	80	80	1.0000000
NODE_8442_length_917_cov_37.775061	505	585	0	80	80	1.0000000
NODE_8442_length_917_cov_37.775061	558	638	0	80	80	1.0000000
NODE_8443_length_917_cov_33.195599	335	415	0	80	80	1.0000000
NODE_8443_length_917_cov_33.195599	388	468	0	80	80	1.0000000
NODE_8443_length_917_cov_33.195599	464	544	0	55	80	0.6875000
NODE_8443_length_917_cov_33.195599	464	544	4	13	80	0.1625000
NODE_8443_length_917_cov_33.195599	464	544	6	12	80	0.1500000
NODE_8443_length_917_cov_33.195599	517	597	0	2	80	0.0250000
NODE_8443_length_917_cov_33.195599	517	597	4	13	80	0.1625000
NODE_8443_length_917_cov_33.195599	517	597	6	65	80	0.8125000
NODE_8444_length_917_cov_22.871638	463	543	0	80	80	1.0000000
NODE_8444_length_917_cov_22.871638	516	593	0	77	77	1.0000000
NODE_8445_length_917_cov_16.899756	321	401	0	80	80	1.0000000
NODE_8445_length_917_cov_16.899756	374	454	0	80	80	1.0000000
NODE_8446_length_917_cov_12.283619	397	477	0	15	80	0.1875000
NODE_8446_length_917_cov_12.283619	397	477	2	65	80	0.8125000
NODE_8446_length_917_cov_12.283619	450	530	0	68	80	0.8500000
NODE_8446_length_917_cov_12.283619	450	530	2	12	80	0.1500000
NODE_8447_length_917_cov_12.172372	380	460	6	80	80	1.0000000
NODE_8447_length_917_cov_12.172372	433	513	0	6	80	0.0750000
NODE_8447_length_917_cov_12.172372	433	513	2	7	80	0.0875000
NODE_8447_length_917_cov_12.172372	433	513	4	18	80	0.2250000
NODE_8447_length_917_cov_12.172372	433	513	6	49	80	0.6125000
NODE_8447_length_917_cov_12.172372	545	597	2	52	52	1.0000000
NODE_8448_length_917_cov_8.277506	564	644	0	80	80	1.0000000
NODE_8448_length_917_cov_8.277506	617	697	0	80	80	1.0000000
NODE_8449_length_917_cov_8.145477	155	235	0	80	80	1.0000000
NODE_8449_length_917_cov_8.145477	208	288	0	80	80	1.0000000
NODE_8451_length_917_cov_6.073350	366	446	0	80	80	1.0000000
NODE_8451_length_917_cov_6.073350	419	499	0	80	80	1.0000000
NODE_8463_length_916_cov_32.867809	347	427	0	80	80	1.0000000
NODE_8463_length_916_cov_32.867809	400	480	0	80	80	1.0000000
NODE_8464_length_916_cov_27.673195	450	530	0	80	80	1.0000000
NODE_8464_length_916_cov_27.673195	503	583	0	80	80	1.0000000
NODE_8465_length_916_cov_27.146879	223	303	0	80	80	1.0000000
NODE_8465_length_916_cov_27.146879	276	356	0	80	80	1.0000000
NODE_8466_length_916_cov_25.604651	398	478	0	31	80	0.3875000
NODE_8466_length_916_cov_25.604651	398	478	2	49	80	0.6125000
NODE_8466_length_916_cov_25.604651	451	531	2	80	80	1.0000000
NODE_8467_length_916_cov_18.035496	456	536	0	17	80	0.2125000
NODE_8467_length_916_cov_18.035496	456	536	4	1	80	0.0125000
NODE_8467_length_916_cov_18.035496	456	536	5	3	80	0.0375000
NODE_8467_length_916_cov_18.035496	456	536	7	48	80	0.6000000
NODE_8467_length_916_cov_18.035496	456	536	8	11	80	0.1375000
NODE_8467_length_916_cov_18.035496	509	589	0	10	80	0.1250000
NODE_8467_length_916_cov_18.035496	509	589	6	17	80	0.2125000
NODE_8467_length_916_cov_18.035496	509	589	7	16	80	0.2000000
NODE_8467_length_916_cov_18.035496	509	589	8	37	80	0.4625000
NODE_8468_length_916_cov_12.651163	500	580	2	20	80	0.2500000
NODE_8468_length_916_cov_12.651163	500	580	6	1	80	0.0125000
NODE_8468_length_916_cov_12.651163	500	580	10	5	80	0.0625000
NODE_8468_length_916_cov_12.651163	500	580	12	54	80	0.6750000
NODE_8468_length_916_cov_12.651163	553	633	8	11	80	0.1375000
NODE_8468_length_916_cov_12.651163	553	633	10	37	80	0.4625000
NODE_8468_length_916_cov_12.651163	553	633	12	32	80	0.4000000
NODE_8469_length_916_cov_11.337821	530	610	0	80	80	1.0000000
NODE_8469_length_916_cov_11.337821	583	663	0	80	80	1.0000000
NODE_8470_length_916_cov_9.640147	293	373	0	80	80	1.0000000
NODE_8470_length_916_cov_9.640147	346	426	0	80	80	1.0000000
NODE_8472_length_916_cov_8.042840	426	506	0	52	80	0.6500000
NODE_8472_length_916_cov_8.042840	426	506	2	28	80	0.3500000
NODE_8472_length_916_cov_8.042840	479	559	0	10	80	0.1250000
NODE_8472_length_916_cov_8.042840	479	559	2	70	80	0.8750000
NODE_8473_length_916_cov_7.123623	785	847	16	5	62	0.0806452
NODE_8473_length_916_cov_7.123623	785	847	18	2	62	0.0322581
NODE_8473_length_916_cov_7.123623	785	847	20	5	62	0.0806452
NODE_8473_length_916_cov_7.123623	785	847	22	1	62	0.0161290
NODE_8473_length_916_cov_7.123623	785	847	26	1	62	0.0161290
NODE_8473_length_916_cov_7.123623	785	847	32	2	62	0.0322581
NODE_8473_length_916_cov_7.123623	785	847	44	3	62	0.0483871
NODE_8473_length_916_cov_7.123623	785	847	46	7	62	0.1129032
NODE_8473_length_916_cov_7.123623	785	847	50	36	62	0.5806451
NODE_8473_length_916_cov_7.123623	820	900	36	2	80	0.0250000
NODE_8473_length_916_cov_7.123623	820	900	38	1	80	0.0125000
NODE_8473_length_916_cov_7.123623	820	900	39	1	80	0.0125000
NODE_8473_length_916_cov_7.123623	820	900	44	4	80	0.0500000
NODE_8473_length_916_cov_7.123623	820	900	46	5	80	0.0625000
NODE_8473_length_916_cov_7.123623	820	900	50	67	80	0.8375000
NODE_8481_length_915_cov_59.289216	398	478	0	10	80	0.1250000
NODE_8481_length_915_cov_59.289216	398	478	2	64	80	0.8000000
NODE_8481_length_915_cov_59.289216	398	478	4	6	80	0.0750000
NODE_8481_length_915_cov_59.289216	451	531	0	10	80	0.1250000
NODE_8481_length_915_cov_59.289216	451	531	2	11	80	0.1375000
NODE_8481_length_915_cov_59.289216	451	531	4	59	80	0.7375000
NODE_8481_length_915_cov_59.289216	527	607	1	36	80	0.4500000
NODE_8481_length_915_cov_59.289216	527	607	2	12	80	0.1500000
NODE_8481_length_915_cov_59.289216	527	607	4	9	80	0.1125000
NODE_8481_length_915_cov_59.289216	527	607	6	23	80	0.2875000
NODE_8481_length_915_cov_59.289216	580	660	1	30	80	0.3750000
NODE_8481_length_915_cov_59.289216	580	660	2	34	80	0.4250000
NODE_8481_length_915_cov_59.289216	580	660	3	16	80	0.2000000
NODE_8482_length_915_cov_45.104167	153	228	0	75	75	1.0000000
NODE_8482_length_915_cov_45.104167	206	286	0	80	80	1.0000000
NODE_8482_length_915_cov_45.104167	282	362	0	80	80	1.0000000
NODE_8482_length_915_cov_45.104167	335	415	0	80	80	1.0000000
NODE_8483_length_915_cov_37.599265	397	477	0	38	80	0.4750000
NODE_8483_length_915_cov_37.599265	397	477	2	42	80	0.5250000
NODE_8483_length_915_cov_37.599265	450	530	2	80	80	1.0000000
NODE_8485_length_915_cov_20.458333	297	377	0	26	80	0.3250000
NODE_8485_length_915_cov_20.458333	297	377	2	54	80	0.6750000
NODE_8485_length_915_cov_20.458333	350	430	0	28	80	0.3500000
NODE_8485_length_915_cov_20.458333	350	430	2	52	80	0.6500000
NODE_8485_length_915_cov_20.458333	426	506	0	80	80	1.0000000
NODE_8485_length_915_cov_20.458333	479	559	0	80	80	1.0000000
NODE_8486_length_915_cov_14.397059	175	255	0	5	80	0.0625000
NODE_8486_length_915_cov_14.397059	175	255	2	75	80	0.9375000
NODE_8486_length_915_cov_14.397059	228	308	0	24	80	0.3000000
NODE_8486_length_915_cov_14.397059	228	308	2	56	80	0.7000000
NODE_8487_length_915_cov_8.741422	295	375	0	25	80	0.3125000
NODE_8487_length_915_cov_8.741422	295	375	2	8	80	0.1000000
NODE_8487_length_915_cov_8.741422	295	375	4	6	80	0.0750000
NODE_8487_length_915_cov_8.741422	295	375	6	27	80	0.3375000
NODE_8487_length_915_cov_8.741422	295	375	8	14	80	0.1750000
NODE_8487_length_915_cov_8.741422	348	428	2	1	80	0.0125000
NODE_8487_length_915_cov_8.741422	348	428	4	13	80	0.1625000
NODE_8487_length_915_cov_8.741422	348	428	6	32	80	0.4000000
NODE_8487_length_915_cov_8.741422	348	428	8	34	80	0.4250000
NODE_8488_length_915_cov_7.719363	823	894	0	6	71	0.0845070
NODE_8488_length_915_cov_7.719363	823	894	4	35	71	0.4929577
NODE_8488_length_915_cov_7.719363	823	894	12	3	71	0.0422535
NODE_8488_length_915_cov_7.719363	823	894	15	27	71	0.3802817
NODE_8488_length_915_cov_7.719363	828	894	0	6	66	0.0909091
NODE_8488_length_915_cov_7.719363	828	894	4	35	66	0.5303030
NODE_8488_length_915_cov_7.719363	828	894	12	3	66	0.0454545
NODE_8488_length_915_cov_7.719363	828	894	15	22	66	0.3333333
NODE_8488_length_915_cov_7.719363	867	915	0	27	48	0.5625000
NODE_8488_length_915_cov_7.719363	867	915	4	21	48	0.4375000
NODE_8488_length_915_cov_7.719363	867	915	0	27	48	0.5625000
NODE_8488_length_915_cov_7.719363	867	915	4	21	48	0.4375000
NODE_8488_length_915_cov_7.719363	867	915	0	27	48	0.5625000
NODE_8488_length_915_cov_7.719363	867	915	4	21	48	0.4375000
NODE_8489_length_915_cov_7.648284	370	450	0	80	80	1.0000000
NODE_8489_length_915_cov_7.648284	423	503	0	80	80	1.0000000
NODE_8490_length_915_cov_6.848039	434	514	0	80	80	1.0000000
NODE_8490_length_915_cov_6.848039	487	567	0	80	80	1.0000000
NODE_8497_length_915_cov_2.011029	24	99	0	75	75	1.0000000
NODE_8505_length_914_cov_89.814724	0	41	2	4	41	0.0975610
NODE_8505_length_914_cov_89.814724	0	41	5	1	41	0.0243902
NODE_8505_length_914_cov_89.814724	0	41	6	2	41	0.0487805
NODE_8505_length_914_cov_89.814724	0	41	14	3	41	0.0731707
NODE_8505_length_914_cov_89.814724	0	41	15	2	41	0.0487805
NODE_8505_length_914_cov_89.814724	0	41	16	1	41	0.0243902
NODE_8505_length_914_cov_89.814724	0	41	18	2	41	0.0487805
NODE_8505_length_914_cov_89.814724	0	41	21	1	41	0.0243902
NODE_8505_length_914_cov_89.814724	0	41	23	1	41	0.0243902
NODE_8505_length_914_cov_89.814724	0	41	24	2	41	0.0487805
NODE_8505_length_914_cov_89.814724	0	41	28	3	41	0.0731707
NODE_8505_length_914_cov_89.814724	0	41	38	1	41	0.0243902
NODE_8505_length_914_cov_89.814724	0	41	40	1	41	0.0243902
NODE_8505_length_914_cov_89.814724	0	41	42	1	41	0.0243902
NODE_8505_length_914_cov_89.814724	0	41	54	1	41	0.0243902
NODE_8505_length_914_cov_89.814724	0	41	55	2	41	0.0487805
NODE_8505_length_914_cov_89.814724	0	41	57	2	41	0.0487805
NODE_8505_length_914_cov_89.814724	0	41	62	1	41	0.0243902
NODE_8505_length_914_cov_89.814724	0	41	66	2	41	0.0487805
NODE_8505_length_914_cov_89.814724	0	41	69	1	41	0.0243902
NODE_8505_length_914_cov_89.814724	0	41	70	3	41	0.0731707
NODE_8505_length_914_cov_89.814724	0	41	78	1	41	0.0243902
NODE_8505_length_914_cov_89.814724	0	41	80	3	41	0.0731707
NODE_8505_length_914_cov_89.814724	19	94	28	3	75	0.0400000
NODE_8505_length_914_cov_89.814724	19	94	38	1	75	0.0133333
NODE_8505_length_914_cov_89.814724	19	94	40	1	75	0.0133333
NODE_8505_length_914_cov_89.814724	19	94	42	1	75	0.0133333
NODE_8505_length_914_cov_89.814724	19	94	54	1	75	0.0133333
NODE_8505_length_914_cov_89.814724	19	94	55	2	75	0.0266667
NODE_8505_length_914_cov_89.814724	19	94	57	2	75	0.0266667
NODE_8505_length_914_cov_89.814724	19	94	62	1	75	0.0133333
NODE_8505_length_914_cov_89.814724	19	94	66	2	75	0.0266667
NODE_8505_length_914_cov_89.814724	19	94	69	1	75	0.0133333
NODE_8505_length_914_cov_89.814724	19	94	70	3	75	0.0400000
NODE_8505_length_914_cov_89.814724	19	94	78	1	75	0.0133333
NODE_8505_length_914_cov_89.814724	19	94	80	3	75	0.0400000
NODE_8505_length_914_cov_89.814724	19	94	86	3	75	0.0400000
NODE_8505_length_914_cov_89.814724	19	94	88	1	75	0.0133333
NODE_8505_length_914_cov_89.814724	19	94	90	1	75	0.0133333
NODE_8505_length_914_cov_89.814724	19	94	95	1	75	0.0133333
NODE_8505_length_914_cov_89.814724	19	94	100	4	75	0.0533333
NODE_8505_length_914_cov_89.814724	19	94	105	5	75	0.0666667
NODE_8505_length_914_cov_89.814724	19	94	107	2	75	0.0266667
NODE_8505_length_914_cov_89.814724	19	94	110	1	75	0.0133333
NODE_8505_length_914_cov_89.814724	19	94	111	17	75	0.2266667
NODE_8505_length_914_cov_89.814724	19	94	112	15	75	0.2000000
NODE_8505_length_914_cov_89.814724	19	94	113	3	75	0.0400000
NODE_8506_length_914_cov_33.755828	400	480	0	80	80	1.0000000
NODE_8506_length_914_cov_33.755828	453	533	0	80	80	1.0000000
NODE_8507_length_914_cov_31.557055	368	448	0	79	80	0.9875000
NODE_8507_length_914_cov_31.557055	368	448	4	1	80	0.0125000
NODE_8507_length_914_cov_31.557055	421	501	0	26	80	0.3250000
NODE_8507_length_914_cov_31.557055	421	501	4	54	80	0.6750000
NODE_8508_length_914_cov_29.087117	331	411	0	28	80	0.3500000
NODE_8508_length_914_cov_29.087117	331	411	2	52	80	0.6500000
NODE_8508_length_914_cov_29.087117	384	464	0	80	80	1.0000000
NODE_8509_length_914_cov_28.490798	273	353	0	80	80	1.0000000
NODE_8509_length_914_cov_28.490798	326	406	0	80	80	1.0000000
NODE_8509_length_914_cov_28.490798	402	482	0	80	80	1.0000000
NODE_8509_length_914_cov_28.490798	455	535	0	80	80	1.0000000
NODE_8510_length_914_cov_25.429448	393	473	0	42	80	0.5250000
NODE_8510_length_914_cov_25.429448	393	473	12	3	80	0.0375000
NODE_8510_length_914_cov_25.429448	393	473	14	26	80	0.3250000
NODE_8510_length_914_cov_25.429448	393	473	16	9	80	0.1125000
NODE_8510_length_914_cov_25.429448	446	526	14	36	80	0.4500000
NODE_8510_length_914_cov_25.429448	446	526	16	44	80	0.5500000
NODE_8510_length_914_cov_25.429448	522	602	2	29	80	0.3625000
NODE_8510_length_914_cov_25.429448	522	602	4	29	80	0.3625000
NODE_8510_length_914_cov_25.429448	522	602	6	8	80	0.1000000
NODE_8510_length_914_cov_25.429448	522	602	14	14	80	0.1750000
NODE_8510_length_914_cov_25.429448	575	655	4	80	80	1.0000000
NODE_8511_length_914_cov_19.111656	354	434	0	5	80	0.0625000
NODE_8511_length_914_cov_19.111656	354	434	2	14	80	0.1750000
NODE_8511_length_914_cov_19.111656	354	434	4	15	80	0.1875000
NODE_8511_length_914_cov_19.111656	354	434	6	46	80	0.5750000
NODE_8511_length_914_cov_19.111656	407	487	2	29	80	0.3625000
NODE_8511_length_914_cov_19.111656	407	487	4	2	80	0.0250000
NODE_8511_length_914_cov_19.111656	407	487	6	49	80	0.6125000
NODE_8512_length_914_cov_13.423313	603	683	0	17	80	0.2125000
NODE_8512_length_914_cov_13.423313	603	683	4	63	80	0.7875000
NODE_8512_length_914_cov_13.423313	656	736	0	70	80	0.8750000
NODE_8512_length_914_cov_13.423313	656	736	4	10	80	0.1250000
NODE_8513_length_914_cov_10.947239	341	411	0	70	70	1.0000000
NODE_8513_length_914_cov_10.947239	384	464	0	80	80	1.0000000
NODE_8518_length_914_cov_1.931288	833	873	0	13	40	0.3250000
NODE_8518_length_914_cov_1.931288	833	873	4	27	40	0.6750000
NODE_8526_length_913_cov_49.665848	31	111	4	1	80	0.0125000
NODE_8526_length_913_cov_49.665848	31	111	5	4	80	0.0500000
NODE_8526_length_913_cov_49.665848	31	111	7	17	80	0.2125000
NODE_8526_length_913_cov_49.665848	31	111	9	1	80	0.0125000
NODE_8526_length_913_cov_49.665848	31	111	10	21	80	0.2625000
NODE_8526_length_913_cov_49.665848	31	111	12	3	80	0.0375000
NODE_8526_length_913_cov_49.665848	31	111	14	33	80	0.4125000
NODE_8526_length_913_cov_49.665848	136	155	14	5	19	0.2631579
NODE_8526_length_913_cov_49.665848	136	155	16	4	19	0.2105263
NODE_8526_length_913_cov_49.665848	136	155	17	10	19	0.5263158
NODE_8527_length_913_cov_47.115479	367	447	0	80	80	1.0000000
NODE_8527_length_913_cov_47.115479	420	500	0	80	80	1.0000000
NODE_8528_length_913_cov_36.541769	502	582	0	80	80	1.0000000
NODE_8528_length_913_cov_36.541769	555	635	0	80	80	1.0000000
NODE_8529_length_913_cov_33.679361	433	513	0	80	80	1.0000000
NODE_8529_length_913_cov_33.679361	486	566	0	80	80	1.0000000
NODE_8530_length_913_cov_29.675676	408	488	0	12	80	0.1500000
NODE_8530_length_913_cov_29.675676	408	488	2	68	80	0.8500000
NODE_8530_length_913_cov_29.675676	461	541	2	80	80	1.0000000
NODE_8531_length_913_cov_24.901720	342	422	0	80	80	1.0000000
NODE_8531_length_913_cov_24.901720	395	475	0	80	80	1.0000000
NODE_8532_length_913_cov_24.625307	396	476	0	10	80	0.1250000
NODE_8532_length_913_cov_24.625307	396	476	2	37	80	0.4625000
NODE_8532_length_913_cov_24.625307	396	476	4	13	80	0.1625000
NODE_8532_length_913_cov_24.625307	396	476	6	20	80	0.2500000
NODE_8532_length_913_cov_24.625307	449	529	0	63	80	0.7875000
NODE_8532_length_913_cov_24.625307	449	529	2	17	80	0.2125000
NODE_8533_length_913_cov_15.094595	525	589	0	43	64	0.6718750
NODE_8533_length_913_cov_15.094595	525	589	2	21	64	0.3281250
NODE_8533_length_913_cov_15.094595	562	642	0	6	80	0.0750000
NODE_8533_length_913_cov_15.094595	562	642	2	74	80	0.9250000
NODE_8534_length_913_cov_8.633907	305	385	0	6	80	0.0750000
NODE_8534_length_913_cov_8.633907	305	385	2	74	80	0.9250000
NODE_8534_length_913_cov_8.633907	358	429	2	71	71	1.0000000
NODE_8546_length_912_cov_25.110701	419	499	0	80	80	1.0000000
NODE_8546_length_912_cov_25.110701	472	552	0	80	80	1.0000000
NODE_8547_length_912_cov_20.045510	306	386	0	80	80	1.0000000
NODE_8547_length_912_cov_20.045510	359	439	0	80	80	1.0000000
NODE_8548_length_912_cov_19.635916	326	406	0	40	80	0.5000000
NODE_8548_length_912_cov_19.635916	326	406	2	40	80	0.5000000
NODE_8548_length_912_cov_19.635916	379	459	0	59	80	0.7375000
NODE_8548_length_912_cov_19.635916	379	459	2	21	80	0.2625000
NODE_8549_length_912_cov_17.714637	395	475	0	80	80	1.0000000
NODE_8549_length_912_cov_17.714637	448	528	0	80	80	1.0000000
NODE_8550_length_912_cov_15.546125	355	435	4	44	80	0.5500000
NODE_8550_length_912_cov_15.546125	355	435	6	29	80	0.3625000
NODE_8550_length_912_cov_15.546125	355	435	8	7	80	0.0875000
NODE_8550_length_912_cov_15.546125	408	488	2	18	80	0.2250000
NODE_8550_length_912_cov_15.546125	408	488	4	17	80	0.2125000
NODE_8550_length_912_cov_15.546125	408	488	6	26	80	0.3250000
NODE_8550_length_912_cov_15.546125	408	488	8	19	80	0.2375000
NODE_8551_length_912_cov_15.077491	255	291	0	36	36	1.0000000
NODE_8551_length_912_cov_15.077491	264	328	0	64	64	1.0000000
NODE_8551_length_912_cov_15.077491	415	495	0	80	80	1.0000000
NODE_8551_length_912_cov_15.077491	468	548	0	80	80	1.0000000
NODE_8552_length_912_cov_15.023370	361	441	0	8	80	0.1000000
NODE_8552_length_912_cov_15.023370	361	441	2	47	80	0.5875000
NODE_8552_length_912_cov_15.023370	361	441	4	25	80	0.3125000
NODE_8552_length_912_cov_15.023370	414	494	0	9	80	0.1125000
NODE_8552_length_912_cov_15.023370	414	494	4	71	80	0.8875000
NODE_8553_length_912_cov_13.600246	61	141	0	56	80	0.7000000
NODE_8553_length_912_cov_13.600246	61	141	2	24	80	0.3000000
NODE_8553_length_912_cov_13.600246	460	540	0	5	80	0.0625000
NODE_8553_length_912_cov_13.600246	460	540	2	46	80	0.5750000
NODE_8553_length_912_cov_13.600246	460	540	3	29	80	0.3625000
NODE_8553_length_912_cov_13.600246	513	593	0	15	80	0.1875000
NODE_8553_length_912_cov_13.600246	513	593	2	65	80	0.8125000
NODE_8554_length_912_cov_13.113161	385	465	3	21	80	0.2625000
NODE_8554_length_912_cov_13.113161	385	465	4	5	80	0.0625000
NODE_8554_length_912_cov_13.113161	385	465	8	37	80	0.4625000
NODE_8554_length_912_cov_13.113161	385	465	10	17	80	0.2125000
NODE_8554_length_912_cov_13.113161	438	518	2	36	80	0.4500000
NODE_8554_length_912_cov_13.113161	438	518	6	4	80	0.0500000
NODE_8554_length_912_cov_13.113161	438	518	8	10	80	0.1250000
NODE_8554_length_912_cov_13.113161	438	518	9	1	80	0.0125000
NODE_8554_length_912_cov_13.113161	438	518	10	29	80	0.3625000
NODE_8555_length_912_cov_11.110701	353	433	0	80	80	1.0000000
NODE_8555_length_912_cov_11.110701	406	486	0	80	80	1.0000000
NODE_8555_length_912_cov_11.110701	827	907	0	11	80	0.1375000
NODE_8555_length_912_cov_11.110701	827	907	4	19	80	0.2375000
NODE_8555_length_912_cov_11.110701	827	907	6	50	80	0.6250000
NODE_8555_length_912_cov_11.110701	831	854	6	23	23	1.0000000
NODE_8584_length_911_cov_173.171182	580	660	250	1	80	0.0125000
NODE_8584_length_911_cov_173.171182	580	660	253	1	80	0.0125000
NODE_8584_length_911_cov_173.171182	580	660	255	1	80	0.0125000
NODE_8584_length_911_cov_173.171182	580	660	262	2	80	0.0250000
NODE_8584_length_911_cov_173.171182	580	660	263	2	80	0.0250000
NODE_8584_length_911_cov_173.171182	580	660	264	1	80	0.0125000
NODE_8584_length_911_cov_173.171182	580	660	281	1	80	0.0125000
NODE_8584_length_911_cov_173.171182	580	660	284	1	80	0.0125000
NODE_8584_length_911_cov_173.171182	580	660	286	1	80	0.0125000
NODE_8584_length_911_cov_173.171182	580	660	294	1	80	0.0125000
NODE_8584_length_911_cov_173.171182	580	660	301	1	80	0.0125000
NODE_8584_length_911_cov_173.171182	580	660	303	1	80	0.0125000
NODE_8584_length_911_cov_173.171182	580	660	315	1	80	0.0125000
NODE_8584_length_911_cov_173.171182	580	660	320	1	80	0.0125000
NODE_8584_length_911_cov_173.171182	580	660	330	3	80	0.0375000
NODE_8584_length_911_cov_173.171182	580	660	334	1	80	0.0125000
NODE_8584_length_911_cov_173.171182	580	660	339	1	80	0.0125000
NODE_8584_length_911_cov_173.171182	580	660	347	1	80	0.0125000
NODE_8584_length_911_cov_173.171182	580	660	349	1	80	0.0125000
NODE_8584_length_911_cov_173.171182	580	660	357	2	80	0.0250000
NODE_8584_length_911_cov_173.171182	580	660	359	4	80	0.0500000
NODE_8584_length_911_cov_173.171182	580	660	360	2	80	0.0250000
NODE_8584_length_911_cov_173.171182	580	660	361	1	80	0.0125000
NODE_8584_length_911_cov_173.171182	580	660	363	1	80	0.0125000
NODE_8584_length_911_cov_173.171182	580	660	365	1	80	0.0125000
NODE_8584_length_911_cov_173.171182	580	660	369	1	80	0.0125000
NODE_8584_length_911_cov_173.171182	580	660	372	1	80	0.0125000
NODE_8584_length_911_cov_173.171182	580	660	379	1	80	0.0125000
NODE_8584_length_911_cov_173.171182	580	660	383	2	80	0.0250000
NODE_8584_length_911_cov_173.171182	580	660	385	1	80	0.0125000
NODE_8584_length_911_cov_173.171182	580	660	388	1	80	0.0125000
NODE_8584_length_911_cov_173.171182	580	660	391	1	80	0.0125000
NODE_8584_length_911_cov_173.171182	580	660	401	1	80	0.0125000
NODE_8584_length_911_cov_173.171182	580	660	406	1	80	0.0125000
NODE_8584_length_911_cov_173.171182	580	660	408	1	80	0.0125000
NODE_8584_length_911_cov_173.171182	580	660	414	1	80	0.0125000
NODE_8584_length_911_cov_173.171182	580	660	416	2	80	0.0250000
NODE_8584_length_911_cov_173.171182	580	660	419	1	80	0.0125000
NODE_8584_length_911_cov_173.171182	580	660	427	1	80	0.0125000
NODE_8584_length_911_cov_173.171182	580	660	433	1	80	0.0125000
NODE_8584_length_911_cov_173.171182	580	660	435	2	80	0.0250000
NODE_8584_length_911_cov_173.171182	580	660	438	1	80	0.0125000
NODE_8584_length_911_cov_173.171182	580	660	444	1	80	0.0125000
NODE_8584_length_911_cov_173.171182	580	660	449	1	80	0.0125000
NODE_8584_length_911_cov_173.171182	580	660	452	2	80	0.0250000
NODE_8584_length_911_cov_173.171182	580	660	453	1	80	0.0125000
NODE_8584_length_911_cov_173.171182	580	660	455	1	80	0.0125000
NODE_8584_length_911_cov_173.171182	580	660	456	1	80	0.0125000
NODE_8584_length_911_cov_173.171182	580	660	457	1	80	0.0125000
NODE_8584_length_911_cov_173.171182	580	660	459	1	80	0.0125000
NODE_8584_length_911_cov_173.171182	580	660	473	1	80	0.0125000
NODE_8584_length_911_cov_173.171182	580	660	474	2	80	0.0250000
NODE_8584_length_911_cov_173.171182	580	660	475	2	80	0.0250000
NODE_8584_length_911_cov_173.171182	580	660	477	3	80	0.0375000
NODE_8584_length_911_cov_173.171182	580	660	478	1	80	0.0125000
NODE_8584_length_911_cov_173.171182	580	660	482	1	80	0.0125000
NODE_8584_length_911_cov_173.171182	580	660	483	1	80	0.0125000
NODE_8584_length_911_cov_173.171182	580	660	492	2	80	0.0250000
NODE_8584_length_911_cov_173.171182	580	660	495	1	80	0.0125000
NODE_8584_length_911_cov_173.171182	580	660	498	1	80	0.0125000
NODE_8584_length_911_cov_173.171182	580	660	500	1	80	0.0125000
NODE_8584_length_911_cov_173.171182	580	660	501	1	80	0.0125000
NODE_8584_length_911_cov_173.171182	633	713	435	1	80	0.0125000
NODE_8584_length_911_cov_173.171182	633	713	444	1	80	0.0125000
NODE_8584_length_911_cov_173.171182	633	713	449	1	80	0.0125000
NODE_8584_length_911_cov_173.171182	633	713	452	2	80	0.0250000
NODE_8584_length_911_cov_173.171182	633	713	453	1	80	0.0125000
NODE_8584_length_911_cov_173.171182	633	713	455	1	80	0.0125000
NODE_8584_length_911_cov_173.171182	633	713	456	1	80	0.0125000
NODE_8584_length_911_cov_173.171182	633	713	457	1	80	0.0125000
NODE_8584_length_911_cov_173.171182	633	713	459	1	80	0.0125000
NODE_8584_length_911_cov_173.171182	633	713	473	1	80	0.0125000
NODE_8584_length_911_cov_173.171182	633	713	474	2	80	0.0250000
NODE_8584_length_911_cov_173.171182	633	713	475	2	80	0.0250000
NODE_8584_length_911_cov_173.171182	633	713	477	3	80	0.0375000
NODE_8584_length_911_cov_173.171182	633	713	478	1	80	0.0125000
NODE_8584_length_911_cov_173.171182	633	713	482	1	80	0.0125000
NODE_8584_length_911_cov_173.171182	633	713	483	1	80	0.0125000
NODE_8584_length_911_cov_173.171182	633	713	492	2	80	0.0250000
NODE_8584_length_911_cov_173.171182	633	713	495	1	80	0.0125000
NODE_8584_length_911_cov_173.171182	633	713	498	1	80	0.0125000
NODE_8584_length_911_cov_173.171182	633	713	500	1	80	0.0125000
NODE_8584_length_911_cov_173.171182	633	713	501	1	80	0.0125000
NODE_8584_length_911_cov_173.171182	633	713	516	1	80	0.0125000
NODE_8584_length_911_cov_173.171182	633	713	517	1	80	0.0125000
NODE_8584_length_911_cov_173.171182	633	713	520	1	80	0.0125000
NODE_8584_length_911_cov_173.171182	633	713	522	1	80	0.0125000
NODE_8584_length_911_cov_173.171182	633	713	539	2	80	0.0250000
NODE_8584_length_911_cov_173.171182	633	713	551	1	80	0.0125000
NODE_8584_length_911_cov_173.171182	633	713	558	2	80	0.0250000
NODE_8584_length_911_cov_173.171182	633	713	559	3	80	0.0375000
NODE_8584_length_911_cov_173.171182	633	713	560	1	80	0.0125000
NODE_8584_length_911_cov_173.171182	633	713	562	6	80	0.0750000
NODE_8584_length_911_cov_173.171182	633	713	563	3	80	0.0375000
NODE_8584_length_911_cov_173.171182	633	713	564	5	80	0.0625000
NODE_8584_length_911_cov_173.171182	633	713	565	1	80	0.0125000
NODE_8584_length_911_cov_173.171182	633	713	566	1	80	0.0125000
NODE_8584_length_911_cov_173.171182	633	713	567	1	80	0.0125000
NODE_8584_length_911_cov_173.171182	633	713	568	2	80	0.0250000
NODE_8584_length_911_cov_173.171182	633	713	569	1	80	0.0125000
NODE_8584_length_911_cov_173.171182	633	713	571	1	80	0.0125000
NODE_8584_length_911_cov_173.171182	633	713	572	2	80	0.0250000
NODE_8584_length_911_cov_173.171182	633	713	574	1	80	0.0125000
NODE_8584_length_911_cov_173.171182	633	713	575	1	80	0.0125000
NODE_8584_length_911_cov_173.171182	633	713	578	2	80	0.0250000
NODE_8584_length_911_cov_173.171182	633	713	579	1	80	0.0125000
NODE_8584_length_911_cov_173.171182	633	713	580	1	80	0.0125000
NODE_8584_length_911_cov_173.171182	633	713	583	1	80	0.0125000
NODE_8584_length_911_cov_173.171182	633	713	584	1	80	0.0125000
NODE_8584_length_911_cov_173.171182	633	713	585	1	80	0.0125000
NODE_8584_length_911_cov_173.171182	633	713	586	1	80	0.0125000
NODE_8584_length_911_cov_173.171182	633	713	594	1	80	0.0125000
NODE_8584_length_911_cov_173.171182	633	713	601	1	80	0.0125000
NODE_8584_length_911_cov_173.171182	633	713	606	1	80	0.0125000
NODE_8584_length_911_cov_173.171182	633	713	608	1	80	0.0125000
NODE_8584_length_911_cov_173.171182	633	713	618	1	80	0.0125000
NODE_8584_length_911_cov_173.171182	633	713	622	1	80	0.0125000
NODE_8584_length_911_cov_173.171182	633	713	638	1	80	0.0125000
NODE_8585_length_911_cov_88.250000	525	605	0	80	80	1.0000000
NODE_8585_length_911_cov_88.250000	578	658	0	80	80	1.0000000
NODE_8586_length_911_cov_46.854680	255	335	0	80	80	1.0000000
NODE_8586_length_911_cov_46.854680	308	388	0	80	80	1.0000000
NODE_8586_length_911_cov_46.854680	384	464	0	43	80	0.5375000
NODE_8586_length_911_cov_46.854680	384	464	2	37	80	0.4625000
NODE_8586_length_911_cov_46.854680	437	517	2	80	80	1.0000000
NODE_8587_length_911_cov_31.362069	301	381	2	28	80	0.3500000
NODE_8587_length_911_cov_31.362069	301	381	4	52	80	0.6500000
NODE_8587_length_911_cov_31.362069	354	434	2	45	80	0.5625000
NODE_8587_length_911_cov_31.362069	354	434	3	26	80	0.3250000
NODE_8587_length_911_cov_31.362069	354	434	4	9	80	0.1125000
NODE_8588_length_911_cov_19.235222	445	525	6	5	80	0.0625000
NODE_8588_length_911_cov_19.235222	445	525	9	7	80	0.0875000
NODE_8588_length_911_cov_19.235222	445	525	10	1	80	0.0125000
NODE_8588_length_911_cov_19.235222	445	525	12	67	80	0.8375000
NODE_8588_length_911_cov_19.235222	498	578	0	23	80	0.2875000
NODE_8588_length_911_cov_19.235222	498	578	2	26	80	0.3250000
NODE_8588_length_911_cov_19.235222	498	578	6	9	80	0.1125000
NODE_8588_length_911_cov_19.235222	498	578	12	22	80	0.2750000
NODE_8589_length_911_cov_16.230296	233	313	4	31	80	0.3875000
NODE_8589_length_911_cov_16.230296	233	313	6	49	80	0.6125000
NODE_8589_length_911_cov_16.230296	286	366	0	30	80	0.3750000
NODE_8589_length_911_cov_16.230296	286	366	2	13	80	0.1625000
NODE_8589_length_911_cov_16.230296	286	366	4	28	80	0.3500000
NODE_8589_length_911_cov_16.230296	286	366	6	9	80	0.1125000
NODE_8590_length_911_cov_14.979064	472	552	0	80	80	1.0000000
NODE_8590_length_911_cov_14.979064	525	605	0	80	80	1.0000000
NODE_8591_length_911_cov_12.089901	357	409	4	39	52	0.7500000
NODE_8591_length_911_cov_12.089901	357	409	6	13	52	0.2500000
NODE_8591_length_911_cov_12.089901	401	462	0	11	61	0.1803279
NODE_8591_length_911_cov_12.089901	401	462	2	18	61	0.2950820
NODE_8591_length_911_cov_12.089901	401	462	4	16	61	0.2622951
NODE_8591_length_911_cov_12.089901	401	462	6	16	61	0.2622951
NODE_8606_length_910_cov_27.838471	347	427	0	80	80	1.0000000
NODE_8606_length_910_cov_27.838471	400	480	0	80	80	1.0000000
NODE_8607_length_910_cov_25.895191	361	441	4	80	80	1.0000000
NODE_8607_length_910_cov_25.895191	414	494	0	6	80	0.0750000
NODE_8607_length_910_cov_25.895191	414	494	2	23	80	0.2875000
NODE_8607_length_910_cov_25.895191	414	494	4	51	80	0.6375000
NODE_8608_length_910_cov_25.604192	294	374	0	2	80	0.0250000
NODE_8608_length_910_cov_25.604192	294	374	10	77	80	0.9625000
NODE_8608_length_910_cov_25.604192	294	374	12	1	80	0.0125000
NODE_8608_length_910_cov_25.604192	347	427	10	26	80	0.3250000
NODE_8608_length_910_cov_25.604192	347	427	12	54	80	0.6750000
NODE_8608_length_910_cov_25.604192	423	503	6	37	80	0.4625000
NODE_8608_length_910_cov_25.604192	423	503	7	1	80	0.0125000
NODE_8608_length_910_cov_25.604192	423	503	8	32	80	0.4000000
NODE_8608_length_910_cov_25.604192	423	503	12	5	80	0.0625000
NODE_8608_length_910_cov_25.604192	423	503	14	1	80	0.0125000
NODE_8608_length_910_cov_25.604192	423	503	16	4	80	0.0500000
NODE_8608_length_910_cov_25.604192	476	556	2	23	80	0.2875000
NODE_8608_length_910_cov_25.604192	476	556	4	22	80	0.2750000
NODE_8608_length_910_cov_25.604192	476	556	6	32	80	0.4000000
NODE_8608_length_910_cov_25.604192	476	556	8	3	80	0.0375000
NODE_8609_length_910_cov_16.066584	656	736	0	80	80	1.0000000
NODE_8609_length_910_cov_16.066584	709	789	0	80	80	1.0000000
NODE_8610_length_910_cov_14.696671	417	497	0	80	80	1.0000000
NODE_8610_length_910_cov_14.696671	470	550	0	80	80	1.0000000
NODE_8612_length_910_cov_7.114673	442	522	0	21	80	0.2625000
NODE_8612_length_910_cov_7.114673	442	522	2	15	80	0.1875000
NODE_8612_length_910_cov_7.114673	442	522	4	4	80	0.0500000
NODE_8612_length_910_cov_7.114673	442	522	6	40	80	0.5000000
NODE_8612_length_910_cov_7.114673	495	575	0	74	80	0.9250000
NODE_8612_length_910_cov_7.114673	495	575	2	6	80	0.0750000
NODE_8614_length_910_cov_2.992602	196	269	14	3	73	0.0410959
NODE_8614_length_910_cov_2.992602	196	269	16	15	73	0.2054795
NODE_8614_length_910_cov_2.992602	196	269	18	5	73	0.0684932
NODE_8614_length_910_cov_2.992602	196	269	20	23	73	0.3150685
NODE_8614_length_910_cov_2.992602	196	269	22	21	73	0.2876712
NODE_8614_length_910_cov_2.992602	196	269	24	6	73	0.0821918
NODE_8614_length_910_cov_2.992602	249	329	20	8	80	0.1000000
NODE_8614_length_910_cov_2.992602	249	329	21	1	80	0.0125000
NODE_8614_length_910_cov_2.992602	249	329	22	8	80	0.1000000
NODE_8614_length_910_cov_2.992602	249	329	24	26	80	0.3250000
NODE_8614_length_910_cov_2.992602	249	329	25	13	80	0.1625000
NODE_8614_length_910_cov_2.992602	249	329	26	24	80	0.3000000
NODE_8614_length_910_cov_2.992602	386	439	12	2	53	0.0377358
NODE_8614_length_910_cov_2.992602	386	439	14	20	53	0.3773585
NODE_8614_length_910_cov_2.992602	386	439	18	31	53	0.5849057
NODE_8623_length_909_cov_35.291358	426	506	0	80	80	1.0000000
NODE_8623_length_909_cov_35.291358	479	559	0	80	80	1.0000000
NODE_8624_length_909_cov_27.449383	311	391	0	32	80	0.4000000
NODE_8624_length_909_cov_27.449383	311	391	2	48	80	0.6000000
NODE_8624_length_909_cov_27.449383	364	444	0	22	80	0.2750000
NODE_8624_length_909_cov_27.449383	364	444	2	58	80	0.7250000
NODE_8625_length_909_cov_25.212346	295	375	0	80	80	1.0000000
NODE_8625_length_909_cov_25.212346	348	428	0	31	80	0.3875000
NODE_8625_length_909_cov_25.212346	348	428	2	49	80	0.6125000
NODE_8626_length_909_cov_23.604938	403	483	0	28	80	0.3500000
NODE_8626_length_909_cov_23.604938	403	483	2	14	80	0.1750000
NODE_8626_length_909_cov_23.604938	403	483	4	38	80	0.4750000
NODE_8626_length_909_cov_23.604938	456	536	0	21	80	0.2625000
NODE_8626_length_909_cov_23.604938	456	536	2	19	80	0.2375000
NODE_8626_length_909_cov_23.604938	456	536	4	40	80	0.5000000
NODE_8627_length_909_cov_19.070370	441	521	0	56	80	0.7000000
NODE_8627_length_909_cov_19.070370	441	521	3	24	80	0.3000000
NODE_8627_length_909_cov_19.070370	494	574	0	3	80	0.0375000
NODE_8627_length_909_cov_19.070370	494	574	3	27	80	0.3375000
NODE_8627_length_909_cov_19.070370	494	574	4	50	80	0.6250000
NODE_8628_length_909_cov_11.533333	332	412	2	80	80	1.0000000
NODE_8628_length_909_cov_11.533333	385	465	0	52	80	0.6500000
NODE_8628_length_909_cov_11.533333	385	465	2	28	80	0.3500000
NODE_8629_length_909_cov_10.229630	497	577	0	57	80	0.7125000
NODE_8629_length_909_cov_10.229630	497	577	2	23	80	0.2875000
NODE_8629_length_909_cov_10.229630	550	622	0	72	72	1.0000000
NODE_8631_length_909_cov_7.122222	328	408	0	80	80	1.0000000
NODE_8631_length_909_cov_7.122222	381	461	0	56	80	0.7000000
NODE_8631_length_909_cov_7.122222	381	461	2	24	80	0.3000000
NODE_8632_length_909_cov_4.664198	775	855	2	5	80	0.0625000
NODE_8632_length_909_cov_4.664198	775	855	4	9	80	0.1125000
NODE_8632_length_909_cov_4.664198	775	855	8	26	80	0.3250000
NODE_8632_length_909_cov_4.664198	775	855	10	6	80	0.0750000
NODE_8632_length_909_cov_4.664198	775	855	12	11	80	0.1375000
NODE_8632_length_909_cov_4.664198	775	855	14	12	80	0.1500000
NODE_8632_length_909_cov_4.664198	775	855	15	7	80	0.0875000
NODE_8632_length_909_cov_4.664198	775	855	16	4	80	0.0500000
NODE_8632_length_909_cov_4.664198	828	885	0	6	57	0.1052632
NODE_8632_length_909_cov_4.664198	828	885	2	29	57	0.5087720
NODE_8632_length_909_cov_4.664198	828	885	4	9	57	0.1578947
NODE_8632_length_909_cov_4.664198	828	885	8	13	57	0.2280702
NODE_8644_length_908_cov_55.546354	409	489	0	17	80	0.2125000
NODE_8644_length_908_cov_55.546354	409	489	4	63	80	0.7875000
NODE_8644_length_908_cov_55.546354	462	542	0	70	80	0.8750000
NODE_8644_length_908_cov_55.546354	462	542	4	10	80	0.1250000
NODE_8645_length_908_cov_18.720643	329	409	0	12	80	0.1500000
NODE_8645_length_908_cov_18.720643	329	409	4	68	80	0.8500000
NODE_8645_length_908_cov_18.720643	382	462	2	16	80	0.2000000
NODE_8645_length_908_cov_18.720643	382	462	4	48	80	0.6000000
NODE_8645_length_908_cov_18.720643	382	462	5	1	80	0.0125000
NODE_8645_length_908_cov_18.720643	382	462	6	15	80	0.1875000
NODE_8646_length_908_cov_14.640297	430	510	1	4	80	0.0500000
NODE_8646_length_908_cov_14.640297	430	510	2	76	80	0.9500000
NODE_8646_length_908_cov_14.640297	483	562	0	48	79	0.6075949
NODE_8646_length_908_cov_14.640297	483	562	1	8	79	0.1012658
NODE_8646_length_908_cov_14.640297	483	562	2	23	79	0.2911392
NODE_8648_length_908_cov_10.789864	370	450	0	33	80	0.4125000
NODE_8648_length_908_cov_10.789864	370	450	2	47	80	0.5875000
NODE_8648_length_908_cov_10.789864	423	503	0	18	80	0.2250000
NODE_8648_length_908_cov_10.789864	423	503	2	62	80	0.7750000
NODE_8651_length_908_cov_3.737948	251	331	0	27	80	0.3375000
NODE_8651_length_908_cov_3.737948	251	331	2	53	80	0.6625000
NODE_8651_length_908_cov_3.737948	304	384	0	33	80	0.4125000
NODE_8651_length_908_cov_3.737948	304	384	2	47	80	0.5875000
NODE_8664_length_907_cov_22.110149	459	539	0	80	80	1.0000000
NODE_8664_length_907_cov_22.110149	512	592	0	80	80	1.0000000
NODE_8665_length_907_cov_20.943069	410	490	0	80	80	1.0000000
NODE_8665_length_907_cov_20.943069	463	543	0	80	80	1.0000000
NODE_8666_length_907_cov_19.519802	411	488	0	77	77	1.0000000
NODE_8666_length_907_cov_19.519802	461	541	0	80	80	1.0000000
NODE_8667_length_907_cov_17.928218	329	405	0	4	76	0.0526316
NODE_8667_length_907_cov_17.928218	329	405	4	72	76	0.9473684
NODE_8667_length_907_cov_17.928218	382	462	0	39	80	0.4875000
NODE_8667_length_907_cov_17.928218	382	462	4	41	80	0.5125000
NODE_8668_length_907_cov_13.060644	293	373	0	80	80	1.0000000
NODE_8668_length_907_cov_13.060644	346	426	0	80	80	1.0000000
NODE_8669_length_907_cov_11.155941	401	462	2	48	61	0.7868853
NODE_8669_length_907_cov_11.155941	401	462	4	13	61	0.2131148
NODE_8669_length_907_cov_11.155941	607	687	0	80	80	1.0000000
NODE_8670_length_907_cov_9.237624	247	327	0	80	80	1.0000000
NODE_8670_length_907_cov_9.237624	300	380	0	80	80	1.0000000
NODE_8671_length_907_cov_8.686881	275	365	0	90	90	1.0000000
NODE_8671_length_907_cov_8.686881	338	418	0	80	80	1.0000000
NODE_8680_length_907_cov_2.949257	503	526	0	23	23	1.0000000
NODE_8686_length_906_cov_32.369269	447	527	0	19	80	0.2375000
NODE_8686_length_906_cov_32.369269	447	527	2	61	80	0.7625000
NODE_8686_length_906_cov_32.369269	500	580	0	15	80	0.1875000
NODE_8686_length_906_cov_32.369269	500	580	2	65	80	0.8125000
NODE_8687_length_906_cov_23.594796	196	276	2	80	80	1.0000000
NODE_8687_length_906_cov_23.594796	249	329	1	20	80	0.2500000
NODE_8687_length_906_cov_23.594796	249	329	2	60	80	0.7500000
NODE_8688_length_906_cov_21.443618	404	484	0	80	80	1.0000000
NODE_8688_length_906_cov_21.443618	457	537	0	80	80	1.0000000
NODE_8689_length_906_cov_20.596035	593	634	0	41	41	1.0000000
NODE_8690_length_906_cov_20.429988	410	490	0	80	80	1.0000000
NODE_8690_length_906_cov_20.429988	463	543	0	80	80	1.0000000
NODE_8691_length_906_cov_20.395291	523	603	4	80	80	1.0000000
NODE_8691_length_906_cov_20.395291	576	656	0	48	80	0.6000000
NODE_8691_length_906_cov_20.395291	576	656	4	32	80	0.4000000
NODE_8692_length_906_cov_19.297398	255	335	0	80	80	1.0000000
NODE_8692_length_906_cov_19.297398	308	388	0	80	80	1.0000000
NODE_8693_length_906_cov_18.505576	357	437	6	58	80	0.7250000
NODE_8693_length_906_cov_18.505576	357	437	8	22	80	0.2750000
NODE_8693_length_906_cov_18.505576	410	490	0	46	80	0.5750000
NODE_8693_length_906_cov_18.505576	410	490	3	2	80	0.0250000
NODE_8693_length_906_cov_18.505576	410	490	6	32	80	0.4000000
NODE_8694_length_906_cov_10.068154	191	271	0	18	80	0.2250000
NODE_8694_length_906_cov_10.068154	191	271	4	62	80	0.7750000
NODE_8694_length_906_cov_10.068154	244	324	2	23	80	0.2875000
NODE_8694_length_906_cov_10.068154	244	324	4	28	80	0.3500000
NODE_8694_length_906_cov_10.068154	244	324	6	29	80	0.3625000
NODE_8695_length_906_cov_10.006196	304	384	0	80	80	1.0000000
NODE_8695_length_906_cov_10.006196	357	437	0	80	80	1.0000000
NODE_8696_length_906_cov_8.562577	370	454	0	44	84	0.5238096
NODE_8696_length_906_cov_8.562577	370	454	2	40	84	0.4761905
NODE_8696_length_906_cov_8.562577	423	507	0	20	84	0.2380952
NODE_8696_length_906_cov_8.562577	423	507	2	64	84	0.7619048
NODE_8716_length_905_cov_39.203474	406	486	0	77	80	0.9625000
NODE_8716_length_905_cov_39.203474	406	486	2	3	80	0.0375000
NODE_8716_length_905_cov_39.203474	459	539	0	24	80	0.3000000
NODE_8716_length_905_cov_39.203474	459	539	2	56	80	0.7000000
NODE_8717_length_905_cov_37.053350	411	491	17	73	80	0.9125000
NODE_8717_length_905_cov_37.053350	411	491	18	7	80	0.0875000
NODE_8717_length_905_cov_37.053350	464	544	0	4	80	0.0500000
NODE_8717_length_905_cov_37.053350	464	544	17	69	80	0.8625000
NODE_8717_length_905_cov_37.053350	464	544	18	7	80	0.0875000
NODE_8718_length_905_cov_27.426799	288	368	4	59	80	0.7375000
NODE_8718_length_905_cov_27.426799	288	368	8	19	80	0.2375000
NODE_8718_length_905_cov_27.426799	288	368	12	2	80	0.0250000
NODE_8718_length_905_cov_27.426799	341	421	4	6	80	0.0750000
NODE_8718_length_905_cov_27.426799	341	421	8	23	80	0.2875000
NODE_8718_length_905_cov_27.426799	341	421	12	51	80	0.6375000
NODE_8719_length_905_cov_26.332506	375	455	0	34	80	0.4250000
NODE_8719_length_905_cov_26.332506	375	455	2	46	80	0.5750000
NODE_8719_length_905_cov_26.332506	428	508	0	9	80	0.1125000
NODE_8719_length_905_cov_26.332506	428	508	2	71	80	0.8875000
NODE_8720_length_905_cov_20.651365	377	457	0	80	80	1.0000000
NODE_8720_length_905_cov_20.651365	430	510	0	80	80	1.0000000
NODE_8721_length_905_cov_19.718362	365	445	0	12	80	0.1500000
NODE_8721_length_905_cov_19.718362	365	445	2	68	80	0.8500000
NODE_8721_length_905_cov_19.718362	418	498	0	65	80	0.8125000
NODE_8721_length_905_cov_19.718362	418	498	2	15	80	0.1875000
NODE_8722_length_905_cov_13.696030	366	420	2	54	54	1.0000000
NODE_8723_length_905_cov_9.978908	222	302	0	80	80	1.0000000
NODE_8723_length_905_cov_9.978908	275	355	0	80	80	1.0000000
NODE_8725_length_905_cov_7.980149	321	401	0	40	80	0.5000000
NODE_8725_length_905_cov_7.980149	321	401	2	39	80	0.4875000
NODE_8725_length_905_cov_7.980149	321	401	4	1	80	0.0125000
NODE_8725_length_905_cov_7.980149	374	454	2	80	80	1.0000000
NODE_8727_length_905_cov_6.064516	459	539	0	80	80	1.0000000
NODE_8727_length_905_cov_6.064516	512	592	0	80	80	1.0000000
NODE_8742_length_905_cov_1.040943	73	119	10	6	46	0.1304348
NODE_8742_length_905_cov_1.040943	73	119	11	5	46	0.1086956
NODE_8742_length_905_cov_1.040943	73	119	12	1	46	0.0217391
NODE_8742_length_905_cov_1.040943	73	119	14	34	46	0.7391304
NODE_8742_length_905_cov_1.040943	126	172	4	3	46	0.0652174
NODE_8742_length_905_cov_1.040943	126	172	5	1	46	0.0217391
NODE_8742_length_905_cov_1.040943	126	172	8	1	46	0.0217391
NODE_8742_length_905_cov_1.040943	126	172	9	15	46	0.3260870
NODE_8742_length_905_cov_1.040943	126	172	11	26	46	0.5652174
NODE_8743_length_904_cov_29.532919	338	418	0	22	80	0.2750000
NODE_8743_length_904_cov_29.532919	338	418	2	4	80	0.0500000
NODE_8743_length_904_cov_29.532919	338	418	4	54	80	0.6750000
NODE_8743_length_904_cov_29.532919	391	471	0	75	80	0.9375000
NODE_8743_length_904_cov_29.532919	391	471	2	4	80	0.0500000
NODE_8743_length_904_cov_29.532919	391	471	4	1	80	0.0125000
NODE_8743_length_904_cov_29.532919	467	547	0	80	80	1.0000000
NODE_8743_length_904_cov_29.532919	520	600	0	80	80	1.0000000
NODE_8744_length_904_cov_28.844720	371	451	0	80	80	1.0000000
NODE_8744_length_904_cov_28.844720	424	504	0	80	80	1.0000000
NODE_8745_length_904_cov_26.977640	488	568	2	80	80	1.0000000
NODE_8745_length_904_cov_26.977640	541	621	0	42	80	0.5250000
NODE_8745_length_904_cov_26.977640	541	621	2	38	80	0.4750000
NODE_8746_length_904_cov_24.529193	464	544	0	80	80	1.0000000
NODE_8746_length_904_cov_24.529193	517	597	0	80	80	1.0000000
NODE_8747_length_904_cov_24.452174	507	587	0	80	80	1.0000000
NODE_8747_length_904_cov_24.452174	560	640	0	80	80	1.0000000
NODE_8748_length_904_cov_19.649689	307	387	0	80	80	1.0000000
NODE_8748_length_904_cov_19.649689	360	440	0	80	80	1.0000000
NODE_8748_length_904_cov_19.649689	595	675	0	20	80	0.2500000
NODE_8748_length_904_cov_19.649689	595	675	2	60	80	0.7500000
NODE_8748_length_904_cov_19.649689	648	728	0	19	80	0.2375000
NODE_8748_length_904_cov_19.649689	648	728	2	61	80	0.7625000
NODE_8750_length_904_cov_16.608696	252	332	0	26	80	0.3250000
NODE_8750_length_904_cov_16.608696	252	332	2	15	80	0.1875000
NODE_8750_length_904_cov_16.608696	252	332	6	25	80	0.3125000
NODE_8750_length_904_cov_16.608696	252	332	8	14	80	0.1750000
NODE_8750_length_904_cov_16.608696	305	385	6	19	80	0.2375000
NODE_8750_length_904_cov_16.608696	305	385	8	61	80	0.7625000
NODE_8750_length_904_cov_16.608696	381	461	6	10	80	0.1250000
NODE_8750_length_904_cov_16.608696	381	461	8	40	80	0.5000000
NODE_8750_length_904_cov_16.608696	381	461	10	28	80	0.3500000
NODE_8750_length_904_cov_16.608696	381	461	14	2	80	0.0250000
NODE_8750_length_904_cov_16.608696	434	514	0	8	80	0.1000000
NODE_8750_length_904_cov_16.608696	434	514	8	72	80	0.9000000
NODE_8751_length_904_cov_15.811180	431	511	0	43	80	0.5375000
NODE_8751_length_904_cov_15.811180	431	511	5	1	80	0.0125000
NODE_8751_length_904_cov_15.811180	431	511	6	3	80	0.0375000
NODE_8751_length_904_cov_15.811180	431	511	11	1	80	0.0125000
NODE_8751_length_904_cov_15.811180	431	511	12	3	80	0.0375000
NODE_8751_length_904_cov_15.811180	431	511	14	13	80	0.1625000
NODE_8751_length_904_cov_15.811180	431	511	16	7	80	0.0875000
NODE_8751_length_904_cov_15.811180	431	511	18	9	80	0.1125000
NODE_8751_length_904_cov_15.811180	484	564	14	11	80	0.1375000
NODE_8751_length_904_cov_15.811180	484	564	16	7	80	0.0875000
NODE_8751_length_904_cov_15.811180	484	564	18	62	80	0.7750000
NODE_8752_length_904_cov_9.249689	581	661	0	80	80	1.0000000
NODE_8752_length_904_cov_9.249689	634	714	0	80	80	1.0000000
NODE_8756_length_904_cov_4.772671	318	398	0	7	80	0.0875000
NODE_8756_length_904_cov_4.772671	318	398	2	73	80	0.9125000
NODE_8756_length_904_cov_4.772671	371	451	0	20	80	0.2500000
NODE_8756_length_904_cov_4.772671	371	451	2	60	80	0.7500000
NODE_8773_length_903_cov_58.723881	386	466	12	4	80	0.0500000
NODE_8773_length_903_cov_58.723881	386	466	14	5	80	0.0625000
NODE_8773_length_903_cov_58.723881	386	466	16	6	80	0.0750000
NODE_8773_length_903_cov_58.723881	386	466	18	14	80	0.1750000
NODE_8773_length_903_cov_58.723881	386	466	20	4	80	0.0500000
NODE_8773_length_903_cov_58.723881	386	466	21	2	80	0.0250000
NODE_8773_length_903_cov_58.723881	386	466	23	3	80	0.0375000
NODE_8773_length_903_cov_58.723881	386	466	24	6	80	0.0750000
NODE_8773_length_903_cov_58.723881	386	466	25	6	80	0.0750000
NODE_8773_length_903_cov_58.723881	386	466	28	7	80	0.0875000
NODE_8773_length_903_cov_58.723881	386	466	32	1	80	0.0125000
NODE_8773_length_903_cov_58.723881	386	466	36	5	80	0.0625000
NODE_8773_length_903_cov_58.723881	386	466	38	6	80	0.0750000
NODE_8773_length_903_cov_58.723881	386	466	40	4	80	0.0500000
NODE_8773_length_903_cov_58.723881	386	466	44	7	80	0.0875000
NODE_8773_length_903_cov_58.723881	439	519	20	1	80	0.0125000
NODE_8773_length_903_cov_58.723881	439	519	22	1	80	0.0125000
NODE_8773_length_903_cov_58.723881	439	519	28	6	80	0.0750000
NODE_8773_length_903_cov_58.723881	439	519	30	8	80	0.1000000
NODE_8773_length_903_cov_58.723881	439	519	32	14	80	0.1750000
NODE_8773_length_903_cov_58.723881	439	519	34	14	80	0.1750000
NODE_8773_length_903_cov_58.723881	439	519	36	16	80	0.2000000
NODE_8773_length_903_cov_58.723881	439	519	38	9	80	0.1125000
NODE_8773_length_903_cov_58.723881	439	519	40	4	80	0.0500000
NODE_8773_length_903_cov_58.723881	439	519	44	7	80	0.0875000
NODE_8773_length_903_cov_58.723881	515	595	5	1	80	0.0125000
NODE_8773_length_903_cov_58.723881	515	595	6	14	80	0.1750000
NODE_8773_length_903_cov_58.723881	515	595	7	3	80	0.0375000
NODE_8773_length_903_cov_58.723881	515	595	11	8	80	0.1000000
NODE_8773_length_903_cov_58.723881	515	595	12	28	80	0.3500000
NODE_8773_length_903_cov_58.723881	515	595	16	1	80	0.0125000
NODE_8773_length_903_cov_58.723881	515	595	18	19	80	0.2375000
NODE_8773_length_903_cov_58.723881	515	595	20	3	80	0.0375000
NODE_8773_length_903_cov_58.723881	515	595	22	1	80	0.0125000
NODE_8773_length_903_cov_58.723881	515	595	28	2	80	0.0250000
NODE_8773_length_903_cov_58.723881	568	648	2	6	80	0.0750000
NODE_8773_length_903_cov_58.723881	568	648	5	1	80	0.0125000
NODE_8773_length_903_cov_58.723881	568	648	6	61	80	0.7625000
NODE_8773_length_903_cov_58.723881	568	648	7	3	80	0.0375000
NODE_8773_length_903_cov_58.723881	568	648	11	8	80	0.1000000
NODE_8773_length_903_cov_58.723881	568	648	12	1	80	0.0125000
NODE_8774_length_903_cov_41.298507	397	477	0	18	80	0.2250000
NODE_8774_length_903_cov_41.298507	397	477	2	62	80	0.7750000
NODE_8774_length_903_cov_41.298507	450	530	0	71	80	0.8875000
NODE_8774_length_903_cov_41.298507	450	530	2	9	80	0.1125000
NODE_8775_length_903_cov_28.691542	394	474	0	55	80	0.6875000
NODE_8775_length_903_cov_28.691542	394	474	2	25	80	0.3125000
NODE_8775_length_903_cov_28.691542	447	527	0	30	80	0.3750000
NODE_8775_length_903_cov_28.691542	447	527	2	50	80	0.6250000
NODE_8776_length_903_cov_26.276119	441	521	0	3	80	0.0375000
NODE_8776_length_903_cov_26.276119	441	521	2	77	80	0.9625000
NODE_8776_length_903_cov_26.276119	494	574	0	3	80	0.0375000
NODE_8776_length_903_cov_26.276119	494	574	2	30	80	0.3750000
NODE_8776_length_903_cov_26.276119	494	574	3	13	80	0.1625000
NODE_8776_length_903_cov_26.276119	494	574	4	34	80	0.4250000
NODE_8778_length_903_cov_18.166667	351	431	0	80	80	1.0000000
NODE_8778_length_903_cov_18.166667	404	484	0	80	80	1.0000000
NODE_8779_length_903_cov_15.460199	440	520	0	80	80	1.0000000
NODE_8779_length_903_cov_15.460199	493	573	0	80	80	1.0000000
NODE_8780_length_903_cov_15.084577	352	432	4	80	80	1.0000000
NODE_8780_length_903_cov_15.084577	405	485	0	40	80	0.5000000
NODE_8780_length_903_cov_15.084577	405	485	4	40	80	0.5000000
NODE_8781_length_903_cov_15.070896	367	447	2	80	80	1.0000000
NODE_8781_length_903_cov_15.070896	420	500	0	52	80	0.6500000
NODE_8781_length_903_cov_15.070896	420	500	2	28	80	0.3500000
NODE_8782_length_903_cov_14.004975	318	399	0	36	81	0.4444444
NODE_8782_length_903_cov_14.004975	318	399	1	6	81	0.0740741
NODE_8782_length_903_cov_14.004975	318	399	2	39	81	0.4814815
NODE_8782_length_903_cov_14.004975	372	452	2	80	80	1.0000000
NODE_8783_length_903_cov_10.546020	150	230	0	52	80	0.6500000
NODE_8783_length_903_cov_10.546020	150	230	2	28	80	0.3500000
NODE_8783_length_903_cov_10.546020	203	283	0	80	80	1.0000000
NODE_8784_length_903_cov_9.288557	373	453	0	80	80	1.0000000
NODE_8784_length_903_cov_9.288557	426	506	0	34	80	0.4250000
NODE_8784_length_903_cov_9.288557	426	506	1	46	80	0.5750000
NODE_8785_length_903_cov_8.052239	439	519	0	80	80	1.0000000
NODE_8785_length_903_cov_8.052239	492	572	0	80	80	1.0000000
NODE_8798_length_902_cov_64.459527	355	435	0	80	80	1.0000000
NODE_8798_length_902_cov_64.459527	408	488	0	80	80	1.0000000
NODE_8798_length_902_cov_64.459527	484	564	0	80	80	1.0000000
NODE_8798_length_902_cov_64.459527	537	617	0	80	80	1.0000000
NODE_8799_length_902_cov_60.823163	395	475	0	12	80	0.1500000
NODE_8799_length_902_cov_60.823163	395	475	6	68	80	0.8500000
NODE_8799_length_902_cov_60.823163	448	528	0	21	80	0.2625000
NODE_8799_length_902_cov_60.823163	448	528	6	59	80	0.7375000
NODE_8800_length_902_cov_44.002491	383	463	0	80	80	1.0000000
NODE_8800_length_902_cov_44.002491	436	516	0	80	80	1.0000000
NODE_8801_length_902_cov_41.059776	378	458	0	36	80	0.4500000
NODE_8801_length_902_cov_41.059776	378	458	4	44	80	0.5500000
NODE_8801_length_902_cov_41.059776	431	511	4	80	80	1.0000000
NODE_8802_length_902_cov_38.952677	372	452	0	80	80	1.0000000
NODE_8802_length_902_cov_38.952677	425	505	0	80	80	1.0000000
NODE_8803_length_902_cov_34.156912	373	453	0	32	80	0.4000000
NODE_8803_length_902_cov_34.156912	373	453	2	40	80	0.5000000
NODE_8803_length_902_cov_34.156912	373	453	4	8	80	0.1000000
NODE_8803_length_902_cov_34.156912	426	506	2	64	80	0.8000000
NODE_8803_length_902_cov_34.156912	426	506	4	16	80	0.2000000
NODE_8804_length_902_cov_23.007472	295	375	0	68	80	0.8500000
NODE_8804_length_902_cov_23.007472	295	375	2	12	80	0.1500000
NODE_8804_length_902_cov_23.007472	348	428	0	80	80	1.0000000
NODE_8805_length_902_cov_19.491905	238	291	0	15	53	0.2830189
NODE_8805_length_902_cov_19.491905	238	291	6	38	53	0.7169811
NODE_8805_length_902_cov_19.491905	264	344	5	24	80	0.3000000
NODE_8805_length_902_cov_19.491905	264	344	6	56	80	0.7000000
NODE_8806_length_902_cov_10.794521	214	294	4	80	80	1.0000000
NODE_8806_length_902_cov_10.794521	267	347	0	27	80	0.3375000
NODE_8806_length_902_cov_10.794521	267	347	2	15	80	0.1875000
NODE_8806_length_902_cov_10.794521	267	347	4	38	80	0.4750000
NODE_8807_length_902_cov_9.520548	518	598	0	49	80	0.6125000
NODE_8807_length_902_cov_9.520548	518	598	2	31	80	0.3875000
NODE_8807_length_902_cov_9.520548	571	651	0	20	80	0.2500000
NODE_8807_length_902_cov_9.520548	571	651	2	60	80	0.7500000
NODE_8808_length_902_cov_8.323786	337	417	0	80	80	1.0000000
NODE_8808_length_902_cov_8.323786	390	470	0	80	80	1.0000000
NODE_8811_length_902_cov_7.300125	434	514	0	80	80	1.0000000
NODE_8811_length_902_cov_7.300125	487	567	0	80	80	1.0000000
NODE_8812_length_902_cov_4.185554	505	585	0	80	80	1.0000000
NODE_8812_length_902_cov_4.185554	558	588	0	30	30	1.0000000
NODE_8812_length_902_cov_4.185554	610	662	0	52	52	1.0000000
NODE_8830_length_902_cov_0.963885	82	106	0	24	24	1.0000000
NODE_8832_length_901_cov_36.066085	412	490	0	32	78	0.4102564
NODE_8832_length_901_cov_36.066085	412	490	2	46	78	0.5897436
NODE_8832_length_901_cov_36.066085	463	543	0	12	80	0.1500000
NODE_8832_length_901_cov_36.066085	463	543	2	68	80	0.8500000
NODE_8833_length_901_cov_28.129676	377	457	0	80	80	1.0000000
NODE_8833_length_901_cov_28.129676	430	510	0	80	80	1.0000000
NODE_8834_length_901_cov_26.763092	272	352	2	38	80	0.4750000
NODE_8834_length_901_cov_26.763092	272	352	4	42	80	0.5250000
NODE_8834_length_901_cov_26.763092	325	405	0	25	80	0.3125000
NODE_8834_length_901_cov_26.763092	325	405	2	55	80	0.6875000
NODE_8834_length_901_cov_26.763092	401	481	0	80	80	1.0000000
NODE_8834_length_901_cov_26.763092	454	534	0	80	80	1.0000000
NODE_8835_length_901_cov_25.628429	369	449	0	80	80	1.0000000
NODE_8835_length_901_cov_25.628429	422	502	0	80	80	1.0000000
NODE_8836_length_901_cov_17.857855	408	488	0	80	80	1.0000000
NODE_8836_length_901_cov_17.857855	461	541	0	80	80	1.0000000
NODE_8837_length_901_cov_16.254364	362	442	0	80	80	1.0000000
NODE_8837_length_901_cov_16.254364	415	495	0	80	80	1.0000000
NODE_8838_length_901_cov_8.346633	321	401	0	80	80	1.0000000
NODE_8838_length_901_cov_8.346633	374	454	0	80	80	1.0000000
NODE_8840_length_901_cov_6.044888	363	443	0	7	80	0.0875000
NODE_8840_length_901_cov_6.044888	363	443	4	73	80	0.9125000
NODE_8840_length_901_cov_6.044888	416	496	0	30	80	0.3750000
NODE_8840_length_901_cov_6.044888	416	496	4	50	80	0.6250000
NODE_8845_length_901_cov_3.814214	194	274	0	80	80	1.0000000
NODE_8845_length_901_cov_3.814214	247	326	0	79	79	1.0000000
NODE_8857_length_900_cov_30.284644	407	487	0	80	80	1.0000000
NODE_8857_length_900_cov_30.284644	460	540	0	80	80	1.0000000
NODE_8858_length_900_cov_29.679151	425	505	0	28	80	0.3500000
NODE_8858_length_900_cov_29.679151	425	505	5	1	80	0.0125000
NODE_8858_length_900_cov_29.679151	425	505	6	34	80	0.4250000
NODE_8858_length_900_cov_29.679151	425	505	8	17	80	0.2125000
NODE_8858_length_900_cov_29.679151	478	558	0	15	80	0.1875000
NODE_8858_length_900_cov_29.679151	478	558	6	10	80	0.1250000
NODE_8858_length_900_cov_29.679151	478	558	8	55	80	0.6875000
NODE_8859_length_900_cov_25.963795	321	401	0	38	80	0.4750000
NODE_8859_length_900_cov_25.963795	321	401	2	17	80	0.2125000
NODE_8859_length_900_cov_25.963795	321	401	6	25	80	0.3125000
NODE_8859_length_900_cov_25.963795	374	454	2	2	80	0.0250000
NODE_8859_length_900_cov_25.963795	374	454	6	43	80	0.5375000
NODE_8859_length_900_cov_25.963795	374	454	8	35	80	0.4375000
NODE_8860_length_900_cov_17.681648	530	606	0	76	76	1.0000000
NODE_8860_length_900_cov_17.681648	583	659	0	76	76	1.0000000
NODE_8861_length_900_cov_16.294632	316	396	0	80	80	1.0000000
NODE_8861_length_900_cov_16.294632	369	449	0	35	80	0.4375000
NODE_8861_length_900_cov_16.294632	369	449	2	45	80	0.5625000
NODE_8863_length_900_cov_5.962547	0	70	2	2	70	0.0285714
NODE_8863_length_900_cov_5.962547	0	70	10	1	70	0.0142857
NODE_8863_length_900_cov_5.962547	0	70	15	1	70	0.0142857
NODE_8863_length_900_cov_5.962547	0	70	18	4	70	0.0571429
NODE_8863_length_900_cov_5.962547	0	70	20	2	70	0.0285714
NODE_8863_length_900_cov_5.962547	0	70	24	3	70	0.0428571
NODE_8863_length_900_cov_5.962547	0	70	26	23	70	0.3285714
NODE_8863_length_900_cov_5.962547	0	70	28	3	70	0.0428571
NODE_8863_length_900_cov_5.962547	0	70	30	2	70	0.0285714
NODE_8863_length_900_cov_5.962547	0	70	32	29	70	0.4142857
NODE_8863_length_900_cov_5.962547	43	108	10	1	65	0.0153846
NODE_8863_length_900_cov_5.962547	43	108	18	2	65	0.0307692
NODE_8863_length_900_cov_5.962547	43	108	32	62	65	0.9538462
NODE_8870_length_900_cov_2.521848	85	165	0	80	80	1.0000000
NODE_8870_length_900_cov_2.521848	138	218	0	80	80	1.0000000
NODE_8879_length_899_cov_45.853750	380	460	0	33	80	0.4125000
NODE_8879_length_899_cov_45.853750	380	460	3	23	80	0.2875000
NODE_8879_length_899_cov_45.853750	380	460	5	24	80	0.3000000
NODE_8879_length_899_cov_45.853750	433	516	3	3	83	0.0361446
NODE_8879_length_899_cov_45.853750	433	516	5	80	83	0.9638554
NODE_8880_length_899_cov_37.758750	381	461	2	61	80	0.7625000
NODE_8880_length_899_cov_37.758750	381	461	4	19	80	0.2375000
NODE_8880_length_899_cov_37.758750	434	514	2	80	80	1.0000000
NODE_8881_length_899_cov_27.362500	413	493	4	59	80	0.7375000
NODE_8881_length_899_cov_27.362500	413	493	6	21	80	0.2625000
NODE_8881_length_899_cov_27.362500	466	546	0	43	80	0.5375000
NODE_8881_length_899_cov_27.362500	466	546	2	2	80	0.0250000
NODE_8881_length_899_cov_27.362500	466	546	4	35	80	0.4375000
NODE_8882_length_899_cov_20.563750	379	459	4	80	80	1.0000000
NODE_8882_length_899_cov_20.563750	432	507	0	38	75	0.5066667
NODE_8882_length_899_cov_20.563750	432	507	4	37	75	0.4933333
NODE_8884_length_899_cov_17.130000	319	399	0	17	80	0.2125000
NODE_8884_length_899_cov_17.130000	319	399	2	63	80	0.7875000
NODE_8884_length_899_cov_17.130000	372	452	0	2	80	0.0250000
NODE_8884_length_899_cov_17.130000	372	452	2	78	80	0.9750000
NODE_8885_length_899_cov_16.317500	270	350	0	56	80	0.7000000
NODE_8885_length_899_cov_16.317500	270	350	2	24	80	0.3000000
NODE_8885_length_899_cov_16.317500	323	403	0	26	80	0.3250000
NODE_8885_length_899_cov_16.317500	323	403	2	54	80	0.6750000
NODE_8886_length_899_cov_16.190000	284	364	0	49	80	0.6125000
NODE_8886_length_899_cov_16.190000	284	364	2	31	80	0.3875000
NODE_8886_length_899_cov_16.190000	337	417	2	80	80	1.0000000
NODE_8887_length_899_cov_13.873750	317	397	0	80	80	1.0000000
NODE_8887_length_899_cov_13.873750	370	450	0	80	80	1.0000000
NODE_8888_length_899_cov_12.957500	240	320	0	80	80	1.0000000
NODE_8888_length_899_cov_12.957500	293	373	0	80	80	1.0000000
NODE_8889_length_899_cov_12.516250	387	467	0	80	80	1.0000000
NODE_8889_length_899_cov_12.516250	440	520	0	53	80	0.6625000
NODE_8889_length_899_cov_12.516250	440	520	2	27	80	0.3375000
NODE_8890_length_899_cov_10.846250	348	428	0	80	80	1.0000000
NODE_8890_length_899_cov_10.846250	401	485	0	84	84	1.0000000
NODE_8891_length_899_cov_9.185000	347	427	0	80	80	1.0000000
NODE_8891_length_899_cov_9.185000	400	480	0	80	80	1.0000000
NODE_8892_length_899_cov_8.655000	498	578	0	80	80	1.0000000
NODE_8892_length_899_cov_8.655000	551	631	0	80	80	1.0000000
NODE_8893_length_899_cov_3.551250	0	54	0	2	54	0.0370370
NODE_8893_length_899_cov_3.551250	0	54	4	1	54	0.0185185
NODE_8893_length_899_cov_3.551250	0	54	6	8	54	0.1481481
NODE_8893_length_899_cov_3.551250	0	54	12	11	54	0.2037037
NODE_8893_length_899_cov_3.551250	0	54	16	11	54	0.2037037
NODE_8893_length_899_cov_3.551250	0	54	20	7	54	0.1296296
NODE_8893_length_899_cov_3.551250	0	54	22	4	54	0.0740741
NODE_8893_length_899_cov_3.551250	0	54	24	2	54	0.0370370
NODE_8893_length_899_cov_3.551250	0	54	26	1	54	0.0185185
NODE_8893_length_899_cov_3.551250	0	54	30	3	54	0.0555556
NODE_8893_length_899_cov_3.551250	0	54	32	4	54	0.0740741
NODE_8893_length_899_cov_3.551250	27	107	16	6	80	0.0750000
NODE_8893_length_899_cov_3.551250	27	107	20	7	80	0.0875000
NODE_8893_length_899_cov_3.551250	27	107	22	4	80	0.0500000
NODE_8893_length_899_cov_3.551250	27	107	24	2	80	0.0250000
NODE_8893_length_899_cov_3.551250	27	107	26	1	80	0.0125000
NODE_8893_length_899_cov_3.551250	27	107	30	3	80	0.0375000
NODE_8893_length_899_cov_3.551250	27	107	32	9	80	0.1125000
NODE_8893_length_899_cov_3.551250	27	107	34	11	80	0.1375000
NODE_8893_length_899_cov_3.551250	27	107	40	4	80	0.0500000
NODE_8893_length_899_cov_3.551250	27	107	42	11	80	0.1375000
NODE_8893_length_899_cov_3.551250	27	107	44	22	80	0.2750000
NODE_8893_length_899_cov_3.551250	103	183	6	4	80	0.0500000
NODE_8893_length_899_cov_3.551250	103	183	12	8	80	0.1000000
NODE_8893_length_899_cov_3.551250	103	183	14	4	80	0.0500000
NODE_8893_length_899_cov_3.551250	103	183	16	2	80	0.0250000
NODE_8893_length_899_cov_3.551250	103	183	18	3	80	0.0375000
NODE_8893_length_899_cov_3.551250	103	183	20	1	80	0.0125000
NODE_8893_length_899_cov_3.551250	103	183	24	16	80	0.2000000
NODE_8893_length_899_cov_3.551250	103	183	26	20	80	0.2500000
NODE_8893_length_899_cov_3.551250	103	183	30	1	80	0.0125000
NODE_8893_length_899_cov_3.551250	103	183	36	10	80	0.1250000
NODE_8893_length_899_cov_3.551250	103	183	40	1	80	0.0125000
NODE_8893_length_899_cov_3.551250	103	183	42	10	80	0.1250000
NODE_8893_length_899_cov_3.551250	156	179	12	8	23	0.3478261
NODE_8893_length_899_cov_3.551250	156	179	14	4	23	0.1739130
NODE_8893_length_899_cov_3.551250	156	179	16	2	23	0.0869565
NODE_8893_length_899_cov_3.551250	156	179	18	3	23	0.1304348
NODE_8893_length_899_cov_3.551250	156	179	20	1	23	0.0434783
NODE_8893_length_899_cov_3.551250	156	179	24	5	23	0.2173913
NODE_8914_length_898_cov_52.405507	299	379	4	28	80	0.3500000
NODE_8914_length_898_cov_52.405507	299	379	6	52	80	0.6500000
NODE_8914_length_898_cov_52.405507	352	432	0	13	80	0.1625000
NODE_8914_length_898_cov_52.405507	352	432	2	26	80	0.3250000
NODE_8914_length_898_cov_52.405507	352	432	6	41	80	0.5125000
NODE_8914_length_898_cov_52.405507	428	508	0	80	80	1.0000000
NODE_8914_length_898_cov_52.405507	481	561	0	80	80	1.0000000
NODE_8915_length_898_cov_44.973717	363	443	2	1	80	0.0125000
NODE_8915_length_898_cov_44.973717	363	443	4	63	80	0.7875000
NODE_8915_length_898_cov_44.973717	363	443	6	16	80	0.2000000
NODE_8915_length_898_cov_44.973717	416	496	0	12	80	0.1500000
NODE_8915_length_898_cov_44.973717	416	496	2	33	80	0.4125000
NODE_8915_length_898_cov_44.973717	416	496	4	28	80	0.3500000
NODE_8915_length_898_cov_44.973717	416	496	6	7	80	0.0875000
NODE_8916_length_898_cov_38.269086	425	505	6	4	80	0.0500000
NODE_8916_length_898_cov_38.269086	425	505	10	4	80	0.0500000
NODE_8916_length_898_cov_38.269086	425	505	12	7	80	0.0875000
NODE_8916_length_898_cov_38.269086	425	505	14	9	80	0.1125000
NODE_8916_length_898_cov_38.269086	425	505	16	7	80	0.0875000
NODE_8916_length_898_cov_38.269086	425	505	18	49	80	0.6125000
NODE_8916_length_898_cov_38.269086	478	558	0	43	80	0.5375000
NODE_8916_length_898_cov_38.269086	478	558	5	1	80	0.0125000
NODE_8916_length_898_cov_38.269086	478	558	6	13	80	0.1625000
NODE_8916_length_898_cov_38.269086	478	558	14	9	80	0.1125000
NODE_8916_length_898_cov_38.269086	478	558	16	7	80	0.0875000
NODE_8916_length_898_cov_38.269086	478	558	18	7	80	0.0875000
NODE_8917_length_898_cov_27.006258	465	545	2	21	80	0.2625000
NODE_8917_length_898_cov_27.006258	465	545	3	7	80	0.0875000
NODE_8917_length_898_cov_27.006258	465	545	4	52	80	0.6500000
NODE_8917_length_898_cov_27.006258	518	598	0	44	80	0.5500000
NODE_8917_length_898_cov_27.006258	518	598	2	23	80	0.2875000
NODE_8917_length_898_cov_27.006258	518	598	3	7	80	0.0875000
NODE_8917_length_898_cov_27.006258	518	598	4	6	80	0.0750000
NODE_8918_length_898_cov_25.902378	185	265	0	38	80	0.4750000
NODE_8918_length_898_cov_25.902378	185	265	2	31	80	0.3875000
NODE_8918_length_898_cov_25.902378	185	265	4	11	80	0.1375000
NODE_8918_length_898_cov_25.902378	238	318	0	80	80	1.0000000
NODE_8918_length_898_cov_25.902378	314	394	0	80	80	1.0000000
NODE_8918_length_898_cov_25.902378	367	447	0	80	80	1.0000000
NODE_8919_length_898_cov_25.209011	368	448	0	80	80	1.0000000
NODE_8919_length_898_cov_25.209011	421	501	0	77	80	0.9625000
NODE_8919_length_898_cov_25.209011	421	501	2	3	80	0.0375000
NODE_8920_length_898_cov_21.923655	325	405	0	80	80	1.0000000
NODE_8920_length_898_cov_21.923655	378	458	0	80	80	1.0000000
NODE_8921_length_898_cov_21.065081	306	386	0	9	80	0.1125000
NODE_8921_length_898_cov_21.065081	306	386	8	1	80	0.0125000
NODE_8921_length_898_cov_21.065081	306	386	10	1	80	0.0125000
NODE_8921_length_898_cov_21.065081	306	386	21	8	80	0.1000000
NODE_8921_length_898_cov_21.065081	306	386	22	61	80	0.7625000
NODE_8921_length_898_cov_21.065081	359	439	21	34	80	0.4250000
NODE_8921_length_898_cov_21.065081	359	439	22	46	80	0.5750000
NODE_8922_length_898_cov_20.954944	374	454	0	80	80	1.0000000
NODE_8922_length_898_cov_20.954944	427	507	0	80	80	1.0000000
NODE_8923_length_898_cov_17.387985	398	478	0	14	80	0.1750000
NODE_8923_length_898_cov_17.387985	398	478	2	66	80	0.8250000
NODE_8923_length_898_cov_17.387985	451	531	0	30	80	0.3750000
NODE_8923_length_898_cov_17.387985	451	531	2	50	80	0.6250000
NODE_8924_length_898_cov_17.252816	265	345	2	9	80	0.1125000
NODE_8924_length_898_cov_17.252816	265	345	6	71	80	0.8875000
NODE_8924_length_898_cov_17.252816	318	398	0	40	80	0.5000000
NODE_8924_length_898_cov_17.252816	318	398	4	9	80	0.1125000
NODE_8924_length_898_cov_17.252816	318	398	6	31	80	0.3875000
NODE_8926_length_898_cov_13.152691	455	535	0	80	80	1.0000000
NODE_8926_length_898_cov_13.152691	508	588	0	80	80	1.0000000
NODE_8927_length_898_cov_12.612015	375	455	0	14	80	0.1750000
NODE_8927_length_898_cov_12.612015	375	455	4	20	80	0.2500000
NODE_8927_length_898_cov_12.612015	375	455	6	46	80	0.5750000
NODE_8927_length_898_cov_12.612015	428	508	0	67	80	0.8375000
NODE_8927_length_898_cov_12.612015	428	508	4	13	80	0.1625000
NODE_8928_length_898_cov_12.498123	428	508	0	14	80	0.1750000
NODE_8928_length_898_cov_12.498123	428	508	4	66	80	0.8250000
NODE_8928_length_898_cov_12.498123	481	561	0	28	80	0.3500000
NODE_8928_length_898_cov_12.498123	481	561	4	52	80	0.6500000
NODE_8932_length_898_cov_1.790989	0	56	0	56	56	1.0000000
NODE_8932_length_898_cov_1.790989	29	93	0	62	64	0.9687500
NODE_8932_length_898_cov_1.790989	29	93	9	2	64	0.0312500
NODE_8944_length_897_cov_63.921053	350	430	0	80	80	1.0000000
NODE_8944_length_897_cov_63.921053	403	483	0	80	80	1.0000000
NODE_8945_length_897_cov_58.921053	316	396	0	71	80	0.8875000
NODE_8945_length_897_cov_58.921053	316	396	6	9	80	0.1125000
NODE_8945_length_897_cov_58.921053	369	449	0	18	80	0.2250000
NODE_8945_length_897_cov_58.921053	369	449	6	62	80	0.7750000
NODE_8946_length_897_cov_35.946115	324	404	0	80	80	1.0000000
NODE_8946_length_897_cov_35.946115	377	457	0	80	80	1.0000000
NODE_8947_length_897_cov_25.548872	238	318	0	9	80	0.1125000
NODE_8947_length_897_cov_25.548872	238	318	2	12	80	0.1500000
NODE_8947_length_897_cov_25.548872	238	318	6	59	80	0.7375000
NODE_8947_length_897_cov_25.548872	291	371	0	47	80	0.5875000
NODE_8947_length_897_cov_25.548872	291	371	4	3	80	0.0375000
NODE_8947_length_897_cov_25.548872	291	371	6	30	80	0.3750000
NODE_8948_length_897_cov_24.913534	399	479	4	9	80	0.1125000
NODE_8948_length_897_cov_24.913534	399	479	8	38	80	0.4750000
NODE_8948_length_897_cov_24.913534	399	479	10	30	80	0.3750000
NODE_8948_length_897_cov_24.913534	399	479	12	3	80	0.0375000
NODE_8948_length_897_cov_24.913534	452	532	0	19	80	0.2375000
NODE_8948_length_897_cov_24.913534	452	532	4	43	80	0.5375000
NODE_8948_length_897_cov_24.913534	452	532	10	18	80	0.2250000
NODE_8949_length_897_cov_21.839599	308	388	0	80	80	1.0000000
NODE_8949_length_897_cov_21.839599	361	441	0	80	80	1.0000000
NODE_8950_length_897_cov_19.355890	489	569	0	80	80	1.0000000
NODE_8950_length_897_cov_19.355890	542	622	0	80	80	1.0000000
NODE_8951_length_897_cov_16.295739	209	289	0	80	80	1.0000000
NODE_8951_length_897_cov_16.295739	262	342	0	36	80	0.4500000
NODE_8951_length_897_cov_16.295739	262	342	2	44	80	0.5500000
NODE_8952_length_897_cov_14.766917	395	475	0	18	80	0.2250000
NODE_8952_length_897_cov_14.766917	395	475	2	62	80	0.7750000
NODE_8952_length_897_cov_14.766917	448	528	0	13	80	0.1625000
NODE_8952_length_897_cov_14.766917	448	528	2	67	80	0.8375000
NODE_8953_length_897_cov_14.219298	253	333	0	80	80	1.0000000
NODE_8953_length_897_cov_14.219298	306	386	0	80	80	1.0000000
NODE_8954_length_897_cov_11.116541	182	262	0	6	80	0.0750000
NODE_8954_length_897_cov_11.116541	182	262	2	74	80	0.9250000
NODE_8954_length_897_cov_11.116541	235	315	2	80	80	1.0000000
NODE_8955_length_897_cov_8.211779	303	383	0	80	80	1.0000000
NODE_8955_length_897_cov_8.211779	356	436	0	75	80	0.9375000
NODE_8955_length_897_cov_8.211779	356	436	1	5	80	0.0625000
NODE_8973_length_896_cov_48.249686	397	477	0	9	80	0.1125000
NODE_8973_length_896_cov_48.249686	397	477	2	71	80	0.8875000
NODE_8973_length_896_cov_48.249686	450	530	0	61	80	0.7625000
NODE_8973_length_896_cov_48.249686	450	530	2	19	80	0.2375000
NODE_8974_length_896_cov_24.824341	213	293	0	80	80	1.0000000
NODE_8974_length_896_cov_24.824341	266	346	0	43	80	0.5375000
NODE_8974_length_896_cov_24.824341	266	346	1	13	80	0.1625000
NODE_8974_length_896_cov_24.824341	266	346	2	24	80	0.3000000
NODE_8975_length_896_cov_23.130489	333	413	0	37	80	0.4625000
NODE_8975_length_896_cov_23.130489	333	413	2	43	80	0.5375000
NODE_8975_length_896_cov_23.130489	386	466	0	80	80	1.0000000
NODE_8975_length_896_cov_23.130489	462	542	0	80	80	1.0000000
NODE_8975_length_896_cov_23.130489	515	595	0	80	80	1.0000000
NODE_8976_length_896_cov_20.673777	361	441	0	28	80	0.3500000
NODE_8976_length_896_cov_20.673777	361	441	2	52	80	0.6500000
NODE_8976_length_896_cov_20.673777	414	497	0	74	83	0.8915663
NODE_8976_length_896_cov_20.673777	414	497	2	9	83	0.1084337
NODE_8977_length_896_cov_18.979925	418	498	0	15	80	0.1875000
NODE_8977_length_896_cov_18.979925	418	498	2	65	80	0.8125000
NODE_8977_length_896_cov_18.979925	471	551	0	40	80	0.5000000
NODE_8977_length_896_cov_18.979925	471	551	2	40	80	0.5000000
NODE_8978_length_896_cov_15.875784	340	420	0	30	80	0.3750000
NODE_8978_length_896_cov_15.875784	340	420	4	50	80	0.6250000
NODE_8978_length_896_cov_15.875784	393	473	4	80	80	1.0000000
NODE_8980_length_896_cov_10.646173	337	417	0	80	80	1.0000000
NODE_8980_length_896_cov_10.646173	390	470	0	80	80	1.0000000
NODE_8981_length_896_cov_10.351317	327	407	0	80	80	1.0000000
NODE_8981_length_896_cov_10.351317	380	460	0	80	80	1.0000000
NODE_8982_length_896_cov_9.754078	411	491	0	80	80	1.0000000
NODE_8982_length_896_cov_9.754078	464	544	0	71	80	0.8875000
NODE_8982_length_896_cov_9.754078	464	544	2	9	80	0.1125000
NODE_8983_length_896_cov_8.069009	340	422	0	82	82	1.0000000
NODE_8983_length_896_cov_8.069009	395	475	0	80	80	1.0000000
NODE_8986_length_896_cov_4.939774	384	464	0	80	80	1.0000000
NODE_8986_length_896_cov_4.939774	437	517	0	80	80	1.0000000
NODE_9005_length_895_cov_54.949749	378	458	0	16	80	0.2000000
NODE_9005_length_895_cov_54.949749	378	458	2	64	80	0.8000000
NODE_9005_length_895_cov_54.949749	431	511	0	47	80	0.5875000
NODE_9005_length_895_cov_54.949749	431	511	2	33	80	0.4125000
NODE_9006_length_895_cov_53.945980	306	386	0	80	80	1.0000000
NODE_9006_length_895_cov_53.945980	359	439	0	80	80	1.0000000
NODE_9007_length_895_cov_48.915829	369	449	0	18	80	0.2250000
NODE_9007_length_895_cov_48.915829	369	449	2	62	80	0.7750000
NODE_9007_length_895_cov_48.915829	422	502	0	37	80	0.4625000
NODE_9007_length_895_cov_48.915829	422	502	2	43	80	0.5375000
NODE_9007_length_895_cov_48.915829	498	578	0	11	80	0.1375000
NODE_9007_length_895_cov_48.915829	498	578	2	69	80	0.8625000
NODE_9007_length_895_cov_48.915829	551	631	2	43	80	0.5375000
NODE_9007_length_895_cov_48.915829	551	631	4	37	80	0.4625000
NODE_9008_length_895_cov_38.347990	452	532	0	80	80	1.0000000
NODE_9008_length_895_cov_38.347990	505	585	0	80	80	1.0000000
NODE_9009_length_895_cov_33.716080	418	499	0	81	81	1.0000000
NODE_9009_length_895_cov_33.716080	472	552	0	80	80	1.0000000
NODE_9010_length_895_cov_21.630653	392	468	1	4	76	0.0526316
NODE_9010_length_895_cov_21.630653	392	468	2	72	76	0.9473684
NODE_9010_length_895_cov_21.630653	441	521	0	16	80	0.2000000
NODE_9010_length_895_cov_21.630653	441	521	2	64	80	0.8000000
NODE_9011_length_895_cov_19.932161	331	411	5	24	80	0.3000000
NODE_9011_length_895_cov_19.932161	331	411	6	1	80	0.0125000
NODE_9011_length_895_cov_19.932161	331	411	7	13	80	0.1625000
NODE_9011_length_895_cov_19.932161	331	411	10	17	80	0.2125000
NODE_9011_length_895_cov_19.932161	331	411	12	13	80	0.1625000
NODE_9011_length_895_cov_19.932161	331	411	14	12	80	0.1500000
NODE_9011_length_895_cov_19.932161	384	464	0	48	80	0.6000000
NODE_9011_length_895_cov_19.932161	384	464	2	3	80	0.0375000
NODE_9011_length_895_cov_19.932161	384	464	5	26	80	0.3250000
NODE_9011_length_895_cov_19.932161	384	464	6	1	80	0.0125000
NODE_9011_length_895_cov_19.932161	384	464	7	2	80	0.0250000
NODE_9011_length_895_cov_19.932161	460	540	0	80	80	1.0000000
NODE_9011_length_895_cov_19.932161	513	593	0	80	80	1.0000000
NODE_9012_length_895_cov_16.037688	403	479	0	9	76	0.1184211
NODE_9012_length_895_cov_16.037688	403	479	2	67	76	0.8815789
NODE_9012_length_895_cov_16.037688	452	532	0	28	80	0.3500000
NODE_9012_length_895_cov_16.037688	452	532	2	52	80	0.6500000
NODE_9013_length_895_cov_13.003769	372	452	0	31	80	0.3875000
NODE_9013_length_895_cov_13.003769	372	452	4	49	80	0.6125000
NODE_9013_length_895_cov_13.003769	425	491	4	66	66	1.0000000
NODE_9014_length_895_cov_12.736181	280	360	8	80	80	1.0000000
NODE_9014_length_895_cov_12.736181	333	413	3	16	80	0.2000000
NODE_9014_length_895_cov_12.736181	333	413	6	34	80	0.4250000
NODE_9014_length_895_cov_12.736181	333	413	8	30	80	0.3750000
NODE_9015_length_895_cov_11.090452	505	585	0	20	80	0.2500000
NODE_9015_length_895_cov_11.090452	505	585	4	60	80	0.7500000
NODE_9015_length_895_cov_11.090452	558	638	0	31	80	0.3875000
NODE_9015_length_895_cov_11.090452	558	638	4	49	80	0.6125000
NODE_9016_length_895_cov_9.266332	468	548	0	80	80	1.0000000
NODE_9016_length_895_cov_9.266332	521	601	0	80	80	1.0000000
NODE_9018_length_895_cov_5.659548	472	552	0	77	80	0.9625000
NODE_9018_length_895_cov_5.659548	472	552	2	3	80	0.0375000
NODE_9018_length_895_cov_5.659548	525	605	0	80	80	1.0000000
NODE_9019_length_895_cov_5.383166	42	123	0	10	81	0.1234568
NODE_9019_length_895_cov_5.383166	42	123	2	43	81	0.5308642
NODE_9019_length_895_cov_5.383166	42	123	4	28	81	0.3456790
NODE_9030_length_894_cov_60.153459	446	526	0	80	80	1.0000000
NODE_9030_length_894_cov_60.153459	499	579	0	80	80	1.0000000
NODE_9031_length_894_cov_49.618868	373	453	0	48	80	0.6000000
NODE_9031_length_894_cov_49.618868	373	453	2	19	80	0.2375000
NODE_9031_length_894_cov_49.618868	373	453	4	13	80	0.1625000
NODE_9031_length_894_cov_49.618868	426	506	0	13	80	0.1625000
NODE_9031_length_894_cov_49.618868	426	506	2	67	80	0.8375000
NODE_9032_length_894_cov_33.228931	459	539	8	5	80	0.0625000
NODE_9032_length_894_cov_33.228931	459	539	10	75	80	0.9375000
NODE_9032_length_894_cov_33.228931	512	592	0	42	80	0.5250000
NODE_9032_length_894_cov_33.228931	512	592	8	2	80	0.0250000
NODE_9032_length_894_cov_33.228931	512	592	10	36	80	0.4500000
NODE_9033_length_894_cov_31.933333	411	491	0	80	80	1.0000000
NODE_9033_length_894_cov_31.933333	464	544	0	80	80	1.0000000
NODE_9034_length_894_cov_30.499371	270	350	4	80	80	1.0000000
NODE_9034_length_894_cov_30.499371	323	403	0	32	80	0.4000000
NODE_9034_length_894_cov_30.499371	323	403	2	5	80	0.0625000
NODE_9034_length_894_cov_30.499371	323	403	4	43	80	0.5375000
NODE_9034_length_894_cov_30.499371	399	479	2	45	80	0.5625000
NODE_9034_length_894_cov_30.499371	399	479	4	35	80	0.4375000
NODE_9034_length_894_cov_30.499371	452	532	0	25	80	0.3125000
NODE_9034_length_894_cov_30.499371	452	532	2	26	80	0.3250000
NODE_9034_length_894_cov_30.499371	452	532	4	29	80	0.3625000
NODE_9035_length_894_cov_23.046541	79	159	0	80	80	1.0000000
NODE_9035_length_894_cov_23.046541	132	212	0	80	80	1.0000000
NODE_9036_length_894_cov_22.266667	381	461	0	80	80	1.0000000
NODE_9036_length_894_cov_22.266667	434	514	0	80	80	1.0000000
NODE_9037_length_894_cov_21.997484	332	412	0	80	80	1.0000000
NODE_9037_length_894_cov_21.997484	385	465	0	80	80	1.0000000
NODE_9038_length_894_cov_21.205031	319	399	0	6	80	0.0750000
NODE_9038_length_894_cov_21.205031	319	399	6	29	80	0.3625000
NODE_9038_length_894_cov_21.205031	319	399	8	45	80	0.5625000
NODE_9038_length_894_cov_21.205031	372	452	0	59	80	0.7375000
NODE_9038_length_894_cov_21.205031	372	452	6	21	80	0.2625000
NODE_9038_length_894_cov_21.205031	448	528	0	80	80	1.0000000
NODE_9038_length_894_cov_21.205031	501	581	0	80	80	1.0000000
NODE_9039_length_894_cov_21.132075	422	502	0	80	80	1.0000000
NODE_9039_length_894_cov_21.132075	475	555	0	80	80	1.0000000
NODE_9040_length_894_cov_15.598742	338	418	0	21	80	0.2625000
NODE_9040_length_894_cov_15.598742	338	418	2	21	80	0.2625000
NODE_9040_length_894_cov_15.598742	338	418	4	38	80	0.4750000
NODE_9040_length_894_cov_15.598742	391	471	2	18	80	0.2250000
NODE_9040_length_894_cov_15.598742	391	471	4	62	80	0.7750000
NODE_9041_length_894_cov_14.079245	344	424	0	80	80	1.0000000
NODE_9041_length_894_cov_14.079245	397	477	0	80	80	1.0000000
NODE_9042_length_894_cov_13.031447	336	416	0	21	80	0.2625000
NODE_9042_length_894_cov_13.031447	336	416	2	44	80	0.5500000
NODE_9042_length_894_cov_13.031447	336	416	4	15	80	0.1875000
NODE_9042_length_894_cov_13.031447	389	469	2	59	80	0.7375000
NODE_9042_length_894_cov_13.031447	389	469	4	21	80	0.2625000
NODE_9043_length_894_cov_13.031447	353	433	0	21	80	0.2625000
NODE_9043_length_894_cov_13.031447	353	433	2	59	80	0.7375000
NODE_9043_length_894_cov_13.031447	406	486	0	17	80	0.2125000
NODE_9043_length_894_cov_13.031447	406	486	2	63	80	0.7875000
NODE_9044_length_894_cov_9.706918	330	410	0	80	80	1.0000000
NODE_9045_length_894_cov_6.963522	378	458	0	80	80	1.0000000
NODE_9045_length_894_cov_6.963522	431	511	0	80	80	1.0000000
NODE_9046_length_894_cov_4.993711	365	445	0	80	80	1.0000000
NODE_9046_length_894_cov_4.993711	418	498	0	80	80	1.0000000
NODE_9066_length_893_cov_59.134761	261	341	0	22	80	0.2750000
NODE_9066_length_893_cov_59.134761	261	341	2	58	80	0.7250000
NODE_9066_length_893_cov_59.134761	314	394	0	46	80	0.5750000
NODE_9066_length_893_cov_59.134761	314	394	2	34	80	0.4250000
NODE_9067_length_893_cov_58.991184	388	468	0	80	80	1.0000000
NODE_9067_length_893_cov_58.991184	441	521	0	80	80	1.0000000
NODE_9067_length_893_cov_58.991184	517	597	0	80	80	1.0000000
NODE_9067_length_893_cov_58.991184	570	650	0	80	80	1.0000000
NODE_9068_length_893_cov_55.644836	434	514	0	80	80	1.0000000
NODE_9068_length_893_cov_55.644836	487	567	0	80	80	1.0000000
NODE_9068_length_893_cov_55.644836	563	643	0	5	80	0.0625000
NODE_9068_length_893_cov_55.644836	563	643	2	53	80	0.6625000
NODE_9068_length_893_cov_55.644836	563	643	4	12	80	0.1500000
NODE_9068_length_893_cov_55.644836	563	643	6	10	80	0.1250000
NODE_9068_length_893_cov_55.644836	616	696	2	5	80	0.0625000
NODE_9068_length_893_cov_55.644836	616	696	4	65	80	0.8125000
NODE_9068_length_893_cov_55.644836	616	696	6	10	80	0.1250000
NODE_9069_length_893_cov_54.803526	479	559	0	80	80	1.0000000
NODE_9069_length_893_cov_54.803526	532	612	0	80	80	1.0000000
NODE_9070_length_893_cov_38.147355	391	471	0	80	80	1.0000000
NODE_9070_length_893_cov_38.147355	444	524	0	80	80	1.0000000
NODE_9071_length_893_cov_33.690176	387	467	0	23	80	0.2875000
NODE_9071_length_893_cov_33.690176	387	467	2	57	80	0.7125000
NODE_9071_length_893_cov_33.690176	440	520	2	46	80	0.5750000
NODE_9071_length_893_cov_33.690176	440	520	4	34	80	0.4250000
NODE_9072_length_893_cov_32.162469	524	604	0	31	80	0.3875000
NODE_9072_length_893_cov_32.162469	524	604	2	49	80	0.6125000
NODE_9072_length_893_cov_32.162469	577	657	0	12	80	0.1500000
NODE_9072_length_893_cov_32.162469	577	657	2	68	80	0.8500000
NODE_9073_length_893_cov_31.916877	344	424	0	41	80	0.5125000
NODE_9073_length_893_cov_31.916877	344	424	2	39	80	0.4875000
NODE_9073_length_893_cov_31.916877	397	477	2	33	80	0.4125000
NODE_9073_length_893_cov_31.916877	397	477	6	8	80	0.1000000
NODE_9073_length_893_cov_31.916877	397	477	8	39	80	0.4875000
NODE_9074_length_893_cov_28.693955	437	517	2	1	80	0.0125000
NODE_9074_length_893_cov_28.693955	437	517	6	20	80	0.2500000
NODE_9074_length_893_cov_28.693955	437	517	8	18	80	0.2250000
NODE_9074_length_893_cov_28.693955	437	517	10	41	80	0.5125000
NODE_9074_length_893_cov_28.693955	490	570	0	4	80	0.0500000
NODE_9074_length_893_cov_28.693955	490	570	2	50	80	0.6250000
NODE_9074_length_893_cov_28.693955	490	570	6	20	80	0.2500000
NODE_9074_length_893_cov_28.693955	490	570	10	6	80	0.0750000
NODE_9075_length_893_cov_23.564232	363	443	0	80	80	1.0000000
NODE_9075_length_893_cov_23.564232	416	496	0	80	80	1.0000000
NODE_9076_length_893_cov_22.633501	272	352	2	30	80	0.3750000
NODE_9076_length_893_cov_22.633501	272	352	4	22	80	0.2750000
NODE_9076_length_893_cov_22.633501	272	352	6	7	80	0.0875000
NODE_9076_length_893_cov_22.633501	272	352	8	21	80	0.2625000
NODE_9076_length_893_cov_22.633501	272	352	2	30	80	0.3750000
NODE_9076_length_893_cov_22.633501	272	352	4	22	80	0.2750000
NODE_9076_length_893_cov_22.633501	272	352	6	7	80	0.0875000
NODE_9076_length_893_cov_22.633501	272	352	8	21	80	0.2625000
NODE_9076_length_893_cov_22.633501	272	352	2	30	80	0.3750000
NODE_9076_length_893_cov_22.633501	272	352	4	22	80	0.2750000
NODE_9076_length_893_cov_22.633501	272	352	6	7	80	0.0875000
NODE_9076_length_893_cov_22.633501	272	352	8	21	80	0.2625000
NODE_9076_length_893_cov_22.633501	325	405	2	3	80	0.0375000
NODE_9076_length_893_cov_22.633501	325	405	4	8	80	0.1000000
NODE_9076_length_893_cov_22.633501	325	405	6	35	80	0.4375000
NODE_9076_length_893_cov_22.633501	325	405	8	34	80	0.4250000
NODE_9076_length_893_cov_22.633501	325	405	2	3	80	0.0375000
NODE_9076_length_893_cov_22.633501	325	405	4	8	80	0.1000000
NODE_9076_length_893_cov_22.633501	325	405	6	35	80	0.4375000
NODE_9076_length_893_cov_22.633501	325	405	8	34	80	0.4250000
NODE_9076_length_893_cov_22.633501	325	405	2	3	80	0.0375000
NODE_9076_length_893_cov_22.633501	325	405	4	8	80	0.1000000
NODE_9076_length_893_cov_22.633501	325	405	6	35	80	0.4375000
NODE_9076_length_893_cov_22.633501	325	405	8	34	80	0.4250000
NODE_9076_length_893_cov_22.633501	401	481	2	2	80	0.0250000
NODE_9076_length_893_cov_22.633501	401	481	4	26	80	0.3250000
NODE_9076_length_893_cov_22.633501	401	481	6	22	80	0.2750000
NODE_9076_length_893_cov_22.633501	401	481	8	15	80	0.1875000
NODE_9076_length_893_cov_22.633501	401	481	10	15	80	0.1875000
NODE_9076_length_893_cov_22.633501	454	534	4	36	80	0.4500000
NODE_9076_length_893_cov_22.633501	454	534	6	6	80	0.0750000
NODE_9076_length_893_cov_22.633501	454	534	8	19	80	0.2375000
NODE_9076_length_893_cov_22.633501	454	534	10	19	80	0.2375000
NODE_9077_length_893_cov_22.403023	453	533	8	5	80	0.0625000
NODE_9077_length_893_cov_22.403023	453	533	12	1	80	0.0125000
NODE_9077_length_893_cov_22.403023	453	533	13	24	80	0.3000000
NODE_9077_length_893_cov_22.403023	453	533	14	50	80	0.6250000
NODE_9077_length_893_cov_22.403023	506	586	2	13	80	0.1625000
NODE_9077_length_893_cov_22.403023	506	586	8	24	80	0.3000000
NODE_9077_length_893_cov_22.403023	506	586	10	13	80	0.1625000
NODE_9077_length_893_cov_22.403023	506	586	12	1	80	0.0125000
NODE_9077_length_893_cov_22.403023	506	586	13	14	80	0.1750000
NODE_9077_length_893_cov_22.403023	506	586	14	15	80	0.1875000
NODE_9078_length_893_cov_19.423174	298	378	6	80	80	1.0000000
NODE_9078_length_893_cov_19.423174	351	431	0	46	80	0.5750000
NODE_9078_length_893_cov_19.423174	351	431	6	34	80	0.4250000
NODE_9078_length_893_cov_19.423174	427	507	0	8	80	0.1000000
NODE_9078_length_893_cov_19.423174	427	507	2	1	80	0.0125000
NODE_9078_length_893_cov_19.423174	427	507	3	2	80	0.0250000
NODE_9078_length_893_cov_19.423174	427	507	5	3	80	0.0375000
NODE_9078_length_893_cov_19.423174	427	507	12	1	80	0.0125000
NODE_9078_length_893_cov_19.423174	427	507	13	1	80	0.0125000
NODE_9078_length_893_cov_19.423174	427	507	16	22	80	0.2750000
NODE_9078_length_893_cov_19.423174	427	507	18	19	80	0.2375000
NODE_9078_length_893_cov_19.423174	427	507	20	23	80	0.2875000
NODE_9078_length_893_cov_19.423174	480	560	16	9	80	0.1125000
NODE_9078_length_893_cov_19.423174	480	560	18	5	80	0.0625000
NODE_9078_length_893_cov_19.423174	480	560	20	32	80	0.4000000
NODE_9078_length_893_cov_19.423174	480	560	22	9	80	0.1125000
NODE_9078_length_893_cov_19.423174	480	560	23	21	80	0.2625000
NODE_9078_length_893_cov_19.423174	480	560	24	4	80	0.0500000
NODE_9079_length_893_cov_19.389169	360	440	0	3	80	0.0375000
NODE_9079_length_893_cov_19.389169	360	440	4	77	80	0.9625000
NODE_9079_length_893_cov_19.389169	413	493	0	56	80	0.7000000
NODE_9079_length_893_cov_19.389169	413	493	4	24	80	0.3000000
NODE_9079_length_893_cov_19.389169	489	569	0	80	80	1.0000000
NODE_9079_length_893_cov_19.389169	542	622	0	80	80	1.0000000
NODE_9080_length_893_cov_18.152393	394	474	0	80	80	1.0000000
NODE_9080_length_893_cov_18.152393	447	527	0	80	80	1.0000000
NODE_9081_length_893_cov_15.960957	442	522	0	80	80	1.0000000
NODE_9081_length_893_cov_15.960957	495	575	0	80	80	1.0000000
NODE_9082_length_893_cov_13.119647	473	553	0	80	80	1.0000000
NODE_9082_length_893_cov_13.119647	526	606	0	80	80	1.0000000
NODE_9084_length_893_cov_5.549118	353	415	1	2	62	0.0322581
NODE_9084_length_893_cov_5.549118	353	415	2	1	62	0.0161290
NODE_9084_length_893_cov_5.549118	353	415	3	59	62	0.9516129
NODE_9100_length_893_cov_1.141058	28	108	4	18	80	0.2250000
NODE_9100_length_893_cov_1.141058	28	108	6	59	80	0.7375000
NODE_9100_length_893_cov_1.141058	28	108	8	3	80	0.0375000
NODE_9104_length_892_cov_74.968474	333	413	0	80	80	1.0000000
NODE_9104_length_892_cov_74.968474	386	466	0	80	80	1.0000000
NODE_9104_length_892_cov_74.968474	462	542	0	80	80	1.0000000
NODE_9104_length_892_cov_74.968474	515	595	0	80	80	1.0000000
NODE_9105_length_892_cov_54.549811	463	550	0	87	87	1.0000000
NODE_9105_length_892_cov_54.549811	523	603	0	80	80	1.0000000
NODE_9105_length_892_cov_54.549811	599	679	0	80	80	1.0000000
NODE_9106_length_892_cov_37.887768	373	453	0	5	80	0.0625000
NODE_9106_length_892_cov_37.887768	373	453	4	75	80	0.9375000
NODE_9106_length_892_cov_37.887768	426	506	0	58	80	0.7250000
NODE_9106_length_892_cov_37.887768	426	506	4	22	80	0.2750000
NODE_9107_length_892_cov_19.732661	361	441	5	17	80	0.2125000
NODE_9107_length_892_cov_19.732661	361	441	6	63	80	0.7875000
NODE_9107_length_892_cov_19.732661	414	494	2	41	80	0.5125000
NODE_9107_length_892_cov_19.732661	414	494	4	3	80	0.0375000
NODE_9107_length_892_cov_19.732661	414	494	6	36	80	0.4500000
NODE_9108_length_892_cov_19.052963	290	370	4	49	80	0.6125000
NODE_9108_length_892_cov_19.052963	290	370	5	1	80	0.0125000
NODE_9108_length_892_cov_19.052963	290	370	6	10	80	0.1250000
NODE_9108_length_892_cov_19.052963	290	370	8	20	80	0.2500000
NODE_9108_length_892_cov_19.052963	343	423	4	41	80	0.5125000
NODE_9108_length_892_cov_19.052963	343	423	6	7	80	0.0875000
NODE_9108_length_892_cov_19.052963	343	423	8	32	80	0.4000000
NODE_9108_length_892_cov_19.052963	419	499	4	48	80	0.6000000
NODE_9108_length_892_cov_19.052963	419	499	6	19	80	0.2375000
NODE_9108_length_892_cov_19.052963	419	499	8	13	80	0.1625000
NODE_9108_length_892_cov_19.052963	472	552	4	52	80	0.6500000
NODE_9108_length_892_cov_19.052963	472	552	6	15	80	0.1875000
NODE_9108_length_892_cov_19.052963	472	552	8	13	80	0.1625000
NODE_9109_length_892_cov_17.276166	341	421	0	36	80	0.4500000
NODE_9109_length_892_cov_17.276166	341	421	2	44	80	0.5500000
NODE_9109_length_892_cov_17.276166	394	474	2	80	80	1.0000000
NODE_9110_length_892_cov_16.312736	411	491	4	80	80	1.0000000
NODE_9110_length_892_cov_16.312736	464	544	0	21	80	0.2625000
NODE_9110_length_892_cov_16.312736	464	544	4	59	80	0.7375000
NODE_9111_length_892_cov_15.808323	395	475	0	80	80	1.0000000
NODE_9111_length_892_cov_15.808323	448	528	0	80	80	1.0000000
NODE_9112_length_892_cov_14.020177	522	602	0	80	80	1.0000000
NODE_9112_length_892_cov_14.020177	575	655	0	80	80	1.0000000
NODE_9114_length_892_cov_8.798235	400	480	2	67	80	0.8375000
NODE_9114_length_892_cov_8.798235	400	480	6	13	80	0.1625000
NODE_9114_length_892_cov_8.798235	453	533	2	14	80	0.1750000
NODE_9114_length_892_cov_8.798235	453	533	4	13	80	0.1625000
NODE_9114_length_892_cov_8.798235	453	533	6	53	80	0.6625000
NODE_9115_length_892_cov_8.413619	428	508	0	24	80	0.3000000
NODE_9115_length_892_cov_8.413619	428	508	2	56	80	0.7000000
NODE_9115_length_892_cov_8.413619	481	561	0	77	80	0.9625000
NODE_9115_length_892_cov_8.413619	481	561	2	3	80	0.0375000
NODE_9116_length_892_cov_6.694830	374	454	0	80	80	1.0000000
NODE_9116_length_892_cov_6.694830	427	507	0	80	80	1.0000000
NODE_9134_length_891_cov_30.166667	295	375	0	80	80	1.0000000
NODE_9134_length_891_cov_30.166667	348	428	0	80	80	1.0000000
NODE_9135_length_891_cov_26.333333	319	399	0	80	80	1.0000000
NODE_9135_length_891_cov_26.333333	372	452	0	80	80	1.0000000
NODE_9136_length_891_cov_22.228535	336	416	0	20	80	0.2500000
NODE_9136_length_891_cov_22.228535	336	416	2	60	80	0.7500000
NODE_9136_length_891_cov_22.228535	389	469	0	16	80	0.2000000
NODE_9136_length_891_cov_22.228535	389	469	2	64	80	0.8000000
NODE_9137_length_891_cov_20.446970	377	457	0	3	80	0.0375000
NODE_9137_length_891_cov_20.446970	377	457	2	77	80	0.9625000
NODE_9137_length_891_cov_20.446970	430	510	0	49	80	0.6125000
NODE_9137_length_891_cov_20.446970	430	510	2	31	80	0.3875000
NODE_9138_length_891_cov_20.226010	310	390	0	80	80	1.0000000
NODE_9138_length_891_cov_20.226010	363	443	0	80	80	1.0000000
NODE_9140_length_891_cov_13.207071	392	472	4	80	80	1.0000000
NODE_9140_length_891_cov_13.207071	445	525	0	47	80	0.5875000
NODE_9140_length_891_cov_13.207071	445	525	4	33	80	0.4125000
NODE_9141_length_891_cov_11.579545	379	459	0	3	80	0.0375000
NODE_9141_length_891_cov_11.579545	379	459	2	41	80	0.5125000
NODE_9141_length_891_cov_11.579545	379	459	4	36	80	0.4500000
NODE_9141_length_891_cov_11.579545	432	512	0	11	80	0.1375000
NODE_9141_length_891_cov_11.579545	432	512	2	24	80	0.3000000
NODE_9141_length_891_cov_11.579545	432	512	3	45	80	0.5625000
NODE_9142_length_891_cov_11.117424	499	579	2	43	80	0.5375000
NODE_9142_length_891_cov_11.117424	499	579	4	25	80	0.3125000
NODE_9142_length_891_cov_11.117424	499	579	6	12	80	0.1500000
NODE_9142_length_891_cov_11.117424	552	632	2	20	80	0.2500000
NODE_9142_length_891_cov_11.117424	552	632	4	48	80	0.6000000
NODE_9142_length_891_cov_11.117424	552	632	6	12	80	0.1500000
NODE_9153_length_890_cov_29.070796	284	364	0	80	80	1.0000000
NODE_9153_length_890_cov_29.070796	337	417	0	80	80	1.0000000
NODE_9153_length_890_cov_29.070796	413	497	0	84	84	1.0000000
NODE_9153_length_890_cov_29.070796	470	550	0	80	80	1.0000000
NODE_9154_length_890_cov_27.295828	550	630	0	80	80	1.0000000
NODE_9154_length_890_cov_27.295828	603	683	0	80	80	1.0000000
NODE_9155_length_890_cov_18.088496	80	135	2	55	55	1.0000000
NODE_9155_length_890_cov_18.088496	276	356	0	38	80	0.4750000
NODE_9155_length_890_cov_18.088496	276	356	2	42	80	0.5250000
NODE_9155_length_890_cov_18.088496	329	406	2	77	77	1.0000000
NODE_9156_length_890_cov_16.831858	402	482	0	13	80	0.1625000
NODE_9156_length_890_cov_16.831858	402	482	2	4	80	0.0500000
NODE_9156_length_890_cov_16.831858	402	482	4	31	80	0.3875000
NODE_9156_length_890_cov_16.831858	402	482	6	5	80	0.0625000
NODE_9156_length_890_cov_16.831858	402	482	14	27	80	0.3375000
NODE_9156_length_890_cov_16.831858	455	535	11	11	80	0.1375000
NODE_9156_length_890_cov_16.831858	455	535	13	3	80	0.0375000
NODE_9156_length_890_cov_16.831858	455	535	14	66	80	0.8250000
NODE_9157_length_890_cov_11.881163	222	302	0	6	80	0.0750000
NODE_9157_length_890_cov_11.881163	222	302	2	74	80	0.9250000
NODE_9157_length_890_cov_11.881163	275	355	0	59	80	0.7375000
NODE_9157_length_890_cov_11.881163	275	355	2	21	80	0.2625000
NODE_9158_length_890_cov_8.676359	335	415	0	80	80	1.0000000
NODE_9158_length_890_cov_8.676359	388	468	0	80	80	1.0000000
NODE_9183_length_889_cov_61.520253	334	414	0	28	80	0.3500000
NODE_9183_length_889_cov_61.520253	334	414	2	7	80	0.0875000
NODE_9183_length_889_cov_61.520253	334	414	4	45	80	0.5625000
NODE_9183_length_889_cov_61.520253	387	467	2	20	80	0.2500000
NODE_9183_length_889_cov_61.520253	387	467	4	60	80	0.7500000
NODE_9183_length_889_cov_61.520253	463	543	0	69	80	0.8625000
NODE_9183_length_889_cov_61.520253	463	543	2	11	80	0.1375000
NODE_9183_length_889_cov_61.520253	516	596	0	80	80	1.0000000
NODE_9184_length_889_cov_30.012658	311	391	0	30	80	0.3750000
NODE_9184_length_889_cov_30.012658	311	391	2	32	80	0.4000000
NODE_9184_length_889_cov_30.012658	311	391	8	18	80	0.2250000
NODE_9184_length_889_cov_30.012658	364	444	2	9	80	0.1125000
NODE_9184_length_889_cov_30.012658	364	444	8	71	80	0.8875000
NODE_9185_length_889_cov_28.217722	413	483	0	16	70	0.2285714
NODE_9185_length_889_cov_28.217722	413	483	2	54	70	0.7714286
NODE_9185_length_889_cov_28.217722	466	542	2	68	76	0.8947368
NODE_9185_length_889_cov_28.217722	466	542	4	8	76	0.1052632
NODE_9186_length_889_cov_27.924051	379	449	2	70	70	1.0000000
NODE_9186_length_889_cov_27.924051	432	512	0	26	80	0.3250000
NODE_9186_length_889_cov_27.924051	432	512	1	11	80	0.1375000
NODE_9186_length_889_cov_27.924051	432	512	2	43	80	0.5375000
NODE_9187_length_889_cov_25.887342	227	285	2	10	58	0.1724138
NODE_9187_length_889_cov_25.887342	227	285	8	10	58	0.1724138
NODE_9187_length_889_cov_25.887342	227	285	10	5	58	0.0862069
NODE_9187_length_889_cov_25.887342	227	285	12	33	58	0.5689655
NODE_9187_length_889_cov_25.887342	258	337	6	20	79	0.2531646
NODE_9187_length_889_cov_25.887342	258	337	8	8	79	0.1012658
NODE_9187_length_889_cov_25.887342	258	337	10	6	79	0.0759494
NODE_9187_length_889_cov_25.887342	258	337	12	45	79	0.5696203
NODE_9188_length_889_cov_22.992405	451	531	0	80	80	1.0000000
NODE_9188_length_889_cov_22.992405	504	584	0	80	80	1.0000000
NODE_9189_length_889_cov_20.703797	331	411	8	58	80	0.7250000
NODE_9189_length_889_cov_20.703797	331	411	10	22	80	0.2750000
NODE_9189_length_889_cov_20.703797	384	464	2	17	80	0.2125000
NODE_9189_length_889_cov_20.703797	384	464	8	14	80	0.1750000
NODE_9189_length_889_cov_20.703797	384	464	10	49	80	0.6125000
NODE_9190_length_889_cov_20.226582	234	314	0	80	80	1.0000000
NODE_9190_length_889_cov_20.226582	287	367	0	80	80	1.0000000
NODE_9191_length_889_cov_15.587342	407	487	0	80	80	1.0000000
NODE_9191_length_889_cov_15.587342	460	540	0	80	80	1.0000000
NODE_9192_length_889_cov_12.669620	313	393	0	51	80	0.6375000
NODE_9192_length_889_cov_12.669620	313	393	2	29	80	0.3625000
NODE_9192_length_889_cov_12.669620	366	446	2	40	80	0.5000000
NODE_9192_length_889_cov_12.669620	366	446	4	40	80	0.5000000
NODE_9193_length_889_cov_12.198734	399	479	0	80	80	1.0000000
NODE_9193_length_889_cov_12.198734	452	532	0	80	80	1.0000000
NODE_9197_length_889_cov_3.841772	187	267	0	80	80	1.0000000
NODE_9197_length_889_cov_3.841772	240	320	0	80	80	1.0000000
NODE_9213_length_888_cov_37.102662	490	570	0	80	80	1.0000000
NODE_9213_length_888_cov_37.102662	543	623	0	80	80	1.0000000
NODE_9214_length_888_cov_28.230672	366	446	0	26	80	0.3250000
NODE_9214_length_888_cov_28.230672	366	446	2	34	80	0.4250000
NODE_9214_length_888_cov_28.230672	366	446	4	20	80	0.2500000
NODE_9214_length_888_cov_28.230672	419	499	0	27	80	0.3375000
NODE_9214_length_888_cov_28.230672	419	499	2	53	80	0.6625000
NODE_9215_length_888_cov_25.243346	391	471	5	16	80	0.2000000
NODE_9215_length_888_cov_25.243346	391	471	6	10	80	0.1250000
NODE_9215_length_888_cov_25.243346	391	471	8	17	80	0.2125000
NODE_9215_length_888_cov_25.243346	391	471	9	25	80	0.3125000
NODE_9215_length_888_cov_25.243346	391	471	10	12	80	0.1500000
NODE_9215_length_888_cov_25.243346	444	524	0	1	80	0.0125000
NODE_9215_length_888_cov_25.243346	444	524	2	11	80	0.1375000
NODE_9215_length_888_cov_25.243346	444	524	4	40	80	0.5000000
NODE_9215_length_888_cov_25.243346	444	524	5	17	80	0.2125000
NODE_9215_length_888_cov_25.243346	444	524	6	5	80	0.0625000
NODE_9215_length_888_cov_25.243346	444	524	8	6	80	0.0750000
NODE_9216_length_888_cov_21.045627	236	316	0	64	80	0.8000000
NODE_9216_length_888_cov_21.045627	236	316	6	16	80	0.2000000
NODE_9216_length_888_cov_21.045627	289	367	0	11	78	0.1410256
NODE_9216_length_888_cov_21.045627	289	367	6	67	78	0.8589743
NODE_9218_length_888_cov_13.447402	515	595	0	80	80	1.0000000
NODE_9218_length_888_cov_13.447402	568	648	0	80	80	1.0000000
NODE_9219_length_888_cov_12.806084	179	259	0	16	80	0.2000000
NODE_9219_length_888_cov_12.806084	179	259	2	64	80	0.8000000
NODE_9219_length_888_cov_12.806084	232	312	0	40	80	0.5000000
NODE_9219_length_888_cov_12.806084	232	312	2	40	80	0.5000000
NODE_9219_length_888_cov_12.806084	308	388	0	80	80	1.0000000
NODE_9219_length_888_cov_12.806084	361	441	0	80	80	1.0000000
NODE_9220_length_888_cov_12.551331	365	445	0	23	80	0.2875000
NODE_9220_length_888_cov_12.551331	365	445	2	57	80	0.7125000
NODE_9220_length_888_cov_12.551331	418	498	0	29	80	0.3625000
NODE_9220_length_888_cov_12.551331	418	498	2	4	80	0.0500000
NODE_9220_length_888_cov_12.551331	418	498	4	47	80	0.5875000
NODE_9228_length_888_cov_2.041825	42	102	2	60	60	1.0000000
NODE_9237_length_887_cov_32.927665	514	594	0	80	80	1.0000000
NODE_9237_length_887_cov_32.927665	567	647	0	80	80	1.0000000
NODE_9238_length_887_cov_26.920051	358	438	0	80	80	1.0000000
NODE_9238_length_887_cov_26.920051	411	491	0	80	80	1.0000000
NODE_9239_length_887_cov_20.714467	304	384	0	80	80	1.0000000
NODE_9239_length_887_cov_20.714467	357	433	0	76	76	1.0000000
NODE_9240_length_887_cov_19.771574	407	487	0	80	80	1.0000000
NODE_9240_length_887_cov_19.771574	460	540	0	80	80	1.0000000
NODE_9241_length_887_cov_14.535533	333	413	0	12	80	0.1500000
NODE_9241_length_887_cov_14.535533	333	413	2	68	80	0.8500000
NODE_9241_length_887_cov_14.535533	386	466	0	64	80	0.8000000
NODE_9241_length_887_cov_14.535533	386	466	2	16	80	0.2000000
NODE_9242_length_887_cov_14.114213	345	425	2	62	80	0.7750000
NODE_9242_length_887_cov_14.114213	345	425	4	18	80	0.2250000
NODE_9242_length_887_cov_14.114213	398	478	2	80	80	1.0000000
NODE_9243_length_887_cov_9.451777	406	486	0	80	80	1.0000000
NODE_9243_length_887_cov_9.451777	459	539	0	80	80	1.0000000
NODE_9245_length_887_cov_6.656091	473	553	0	9	80	0.1125000
NODE_9245_length_887_cov_6.656091	473	553	2	71	80	0.8875000
NODE_9245_length_887_cov_6.656091	526	606	0	22	80	0.2750000
NODE_9245_length_887_cov_6.656091	526	606	2	58	80	0.7250000
NODE_9246_length_887_cov_4.719543	420	500	0	80	80	1.0000000
NODE_9246_length_887_cov_4.719543	473	553	0	80	80	1.0000000
NODE_9250_length_887_cov_2.583756	385	429	0	44	44	1.0000000
NODE_9250_length_887_cov_2.583756	393	428	0	35	35	1.0000000
NODE_9261_length_887_cov_1.087563	754	829	0	1	75	0.0133333
NODE_9261_length_887_cov_1.087563	754	829	2	74	75	0.9866667
NODE_9264_length_886_cov_35.482846	365	445	0	80	80	1.0000000
NODE_9264_length_886_cov_35.482846	418	498	0	80	80	1.0000000
NODE_9265_length_886_cov_31.939009	438	518	0	38	80	0.4750000
NODE_9265_length_886_cov_31.939009	438	518	3	2	80	0.0250000
NODE_9265_length_886_cov_31.939009	438	518	4	40	80	0.5000000
NODE_9265_length_886_cov_31.939009	491	571	4	80	80	1.0000000
NODE_9266_length_886_cov_25.301144	326	406	0	64	80	0.8000000
NODE_9266_length_886_cov_25.301144	326	406	2	9	80	0.1125000
NODE_9266_length_886_cov_25.301144	326	406	4	7	80	0.0875000
NODE_9266_length_886_cov_25.301144	326	406	0	64	80	0.8000000
NODE_9266_length_886_cov_25.301144	326	406	2	9	80	0.1125000
NODE_9266_length_886_cov_25.301144	326	406	4	7	80	0.0875000
NODE_9266_length_886_cov_25.301144	379	459	0	20	80	0.2500000
NODE_9266_length_886_cov_25.301144	379	459	4	60	80	0.7500000
NODE_9266_length_886_cov_25.301144	379	459	0	20	80	0.2500000
NODE_9266_length_886_cov_25.301144	379	459	4	60	80	0.7500000
NODE_9267_length_886_cov_14.463787	327	407	0	80	80	1.0000000
NODE_9267_length_886_cov_14.463787	380	460	0	80	80	1.0000000
NODE_9286_length_885_cov_35.510178	373	453	0	18	80	0.2250000
NODE_9286_length_885_cov_35.510178	373	453	2	17	80	0.2125000
NODE_9286_length_885_cov_35.510178	373	453	6	12	80	0.1500000
NODE_9286_length_885_cov_35.510178	373	453	7	33	80	0.4125000
NODE_9286_length_885_cov_35.510178	426	506	6	28	80	0.3500000
NODE_9286_length_885_cov_35.510178	426	506	7	32	80	0.4000000
NODE_9286_length_885_cov_35.510178	426	506	8	3	80	0.0375000
NODE_9286_length_885_cov_35.510178	426	506	9	17	80	0.2125000
NODE_9287_length_885_cov_31.857506	368	448	2	80	80	1.0000000
NODE_9287_length_885_cov_31.857506	421	501	0	49	80	0.6125000
NODE_9287_length_885_cov_31.857506	421	501	2	31	80	0.3875000
NODE_9288_length_885_cov_31.195929	395	475	0	80	80	1.0000000
NODE_9288_length_885_cov_31.195929	448	528	0	80	80	1.0000000
NODE_9289_length_885_cov_23.735369	356	436	0	80	80	1.0000000
NODE_9289_length_885_cov_23.735369	409	489	0	80	80	1.0000000
NODE_9289_length_885_cov_23.735369	485	565	0	80	80	1.0000000
NODE_9289_length_885_cov_23.735369	538	618	0	80	80	1.0000000
NODE_9290_length_885_cov_22.174300	340	420	0	80	80	1.0000000
NODE_9290_length_885_cov_22.174300	393	473	0	80	80	1.0000000
NODE_9290_length_885_cov_22.174300	469	549	0	62	80	0.7750000
NODE_9290_length_885_cov_22.174300	469	549	2	18	80	0.2250000
NODE_9290_length_885_cov_22.174300	522	602	0	9	80	0.1125000
NODE_9290_length_885_cov_22.174300	522	602	2	32	80	0.4000000
NODE_9290_length_885_cov_22.174300	522	602	6	39	80	0.4875000
NODE_9291_length_885_cov_17.852417	413	493	0	80	80	1.0000000
NODE_9291_length_885_cov_17.852417	466	546	0	80	80	1.0000000
NODE_9292_length_885_cov_15.652672	346	426	0	80	80	1.0000000
NODE_9292_length_885_cov_15.652672	399	479	0	80	80	1.0000000
NODE_9292_length_885_cov_15.652672	475	555	0	80	80	1.0000000
NODE_9292_length_885_cov_15.652672	528	608	0	80	80	1.0000000
NODE_9293_length_885_cov_11.648855	530	610	4	9	80	0.1125000
NODE_9293_length_885_cov_11.648855	530	610	6	5	80	0.0625000
NODE_9293_length_885_cov_11.648855	530	610	8	53	80	0.6625000
NODE_9293_length_885_cov_11.648855	530	610	10	13	80	0.1625000
NODE_9293_length_885_cov_11.648855	583	663	0	3	80	0.0375000
NODE_9293_length_885_cov_11.648855	583	663	4	15	80	0.1875000
NODE_9293_length_885_cov_11.648855	583	663	6	40	80	0.5000000
NODE_9293_length_885_cov_11.648855	583	663	8	9	80	0.1125000
NODE_9293_length_885_cov_11.648855	583	663	10	13	80	0.1625000
NODE_9294_length_885_cov_9.707379	611	691	0	3	80	0.0375000
NODE_9294_length_885_cov_9.707379	611	691	1	17	80	0.2125000
NODE_9294_length_885_cov_9.707379	611	691	2	60	80	0.7500000
NODE_9294_length_885_cov_9.707379	664	744	0	53	80	0.6625000
NODE_9294_length_885_cov_9.707379	664	744	1	17	80	0.2125000
NODE_9294_length_885_cov_9.707379	664	744	2	10	80	0.1250000
NODE_9311_length_884_cov_73.050955	536	616	0	12	80	0.1500000
NODE_9311_length_884_cov_73.050955	536	616	2	68	80	0.8500000
NODE_9311_length_884_cov_73.050955	589	669	0	56	80	0.7000000
NODE_9311_length_884_cov_73.050955	589	669	2	24	80	0.3000000
NODE_9312_length_884_cov_28.373248	381	461	0	11	80	0.1375000
NODE_9312_length_884_cov_28.373248	381	461	2	69	80	0.8625000
NODE_9312_length_884_cov_28.373248	434	514	0	64	80	0.8000000
NODE_9312_length_884_cov_28.373248	434	514	2	16	80	0.2000000
NODE_9313_length_884_cov_20.649682	463	543	0	25	80	0.3125000
NODE_9313_length_884_cov_20.649682	463	543	4	16	80	0.2000000
NODE_9313_length_884_cov_20.649682	463	543	5	5	80	0.0625000
NODE_9313_length_884_cov_20.649682	463	543	7	16	80	0.2000000
NODE_9313_length_884_cov_20.649682	463	543	8	6	80	0.0750000
NODE_9313_length_884_cov_20.649682	463	543	10	12	80	0.1500000
NODE_9313_length_884_cov_20.649682	516	596	7	9	80	0.1125000
NODE_9313_length_884_cov_20.649682	516	596	8	23	80	0.2875000
NODE_9313_length_884_cov_20.649682	516	596	10	15	80	0.1875000
NODE_9313_length_884_cov_20.649682	516	596	12	33	80	0.4125000
NODE_9314_length_884_cov_13.391083	225	305	0	80	80	1.0000000
NODE_9314_length_884_cov_13.391083	278	358	0	80	80	1.0000000
NODE_9315_length_884_cov_9.192357	278	358	0	32	80	0.4000000
NODE_9315_length_884_cov_9.192357	278	358	2	10	80	0.1250000
NODE_9315_length_884_cov_9.192357	278	358	3	1	80	0.0125000
NODE_9315_length_884_cov_9.192357	278	358	4	37	80	0.4625000
NODE_9315_length_884_cov_9.192357	331	411	0	80	80	1.0000000
NODE_9315_length_884_cov_9.192357	407	487	0	80	80	1.0000000
NODE_9315_length_884_cov_9.192357	460	540	0	80	80	1.0000000
NODE_9335_length_883_cov_46.780612	344	424	0	80	80	1.0000000
NODE_9335_length_883_cov_46.780612	397	477	0	80	80	1.0000000
NODE_9336_length_883_cov_46.304847	387	467	0	80	80	1.0000000
NODE_9336_length_883_cov_46.304847	440	520	0	80	80	1.0000000
NODE_9337_length_883_cov_39.579082	410	490	0	80	80	1.0000000
NODE_9337_length_883_cov_39.579082	463	543	0	80	80	1.0000000
NODE_9338_length_883_cov_28.307398	379	459	0	34	80	0.4250000
NODE_9338_length_883_cov_28.307398	379	459	2	13	80	0.1625000
NODE_9338_length_883_cov_28.307398	379	459	6	33	80	0.4125000
NODE_9338_length_883_cov_28.307398	432	512	4	33	80	0.4125000
NODE_9338_length_883_cov_28.307398	432	512	6	47	80	0.5875000
NODE_9339_length_883_cov_24.927296	429	509	0	34	80	0.4250000
NODE_9339_length_883_cov_24.927296	429	509	2	46	80	0.5750000
NODE_9339_length_883_cov_24.927296	482	562	0	80	80	1.0000000
NODE_9341_length_883_cov_17.445153	326	406	0	3	80	0.0375000
NODE_9341_length_883_cov_17.445153	326	406	2	74	80	0.9250000
NODE_9341_length_883_cov_17.445153	326	406	4	3	80	0.0375000
NODE_9341_length_883_cov_17.445153	379	459	2	24	80	0.3000000
NODE_9341_length_883_cov_17.445153	379	459	4	56	80	0.7000000
NODE_9342_length_883_cov_14.660714	319	395	0	13	76	0.1710526
NODE_9342_length_883_cov_14.660714	319	395	2	10	76	0.1315790
NODE_9342_length_883_cov_14.660714	319	395	4	15	76	0.1973684
NODE_9342_length_883_cov_14.660714	319	395	6	11	76	0.1447368
NODE_9342_length_883_cov_14.660714	319	395	8	27	76	0.3552631
NODE_9342_length_883_cov_14.660714	740	816	0	74	76	0.9736842
NODE_9342_length_883_cov_14.660714	740	816	2	2	76	0.0263158
NODE_9343_length_883_cov_11.052296	223	303	0	80	80	1.0000000
NODE_9343_length_883_cov_11.052296	276	356	0	80	80	1.0000000
NODE_9344_length_883_cov_6.873724	0	66	0	1	66	0.0151515
NODE_9344_length_883_cov_6.873724	0	66	1	5	66	0.0757576
NODE_9344_length_883_cov_6.873724	0	66	2	25	66	0.3787879
NODE_9344_length_883_cov_6.873724	0	66	6	10	66	0.1515152
NODE_9344_length_883_cov_6.873724	0	66	8	2	66	0.0303030
NODE_9344_length_883_cov_6.873724	0	66	12	23	66	0.3484848
NODE_9345_length_883_cov_3.873724	471	551	0	80	80	1.0000000
NODE_9345_length_883_cov_3.873724	524	604	0	80	80	1.0000000
NODE_9346_length_883_cov_3.247449	294	374	0	80	80	1.0000000
NODE_9346_length_883_cov_3.247449	347	427	0	80	80	1.0000000
NODE_9370_length_882_cov_24.241379	438	518	2	19	80	0.2375000
NODE_9370_length_882_cov_24.241379	438	518	4	61	80	0.7625000
NODE_9370_length_882_cov_24.241379	491	571	0	23	80	0.2875000
NODE_9370_length_882_cov_24.241379	491	571	1	1	80	0.0125000
NODE_9370_length_882_cov_24.241379	491	571	2	29	80	0.3625000
NODE_9370_length_882_cov_24.241379	491	571	4	27	80	0.3375000
NODE_9371_length_882_cov_23.145594	355	435	0	9	80	0.1125000
NODE_9371_length_882_cov_23.145594	355	435	2	1	80	0.0125000
NODE_9371_length_882_cov_23.145594	355	435	3	27	80	0.3375000
NODE_9371_length_882_cov_23.145594	355	435	6	43	80	0.5375000
NODE_9371_length_882_cov_23.145594	408	488	0	31	80	0.3875000
NODE_9371_length_882_cov_23.145594	408	488	2	32	80	0.4000000
NODE_9371_length_882_cov_23.145594	408	488	3	17	80	0.2125000
NODE_9372_length_882_cov_21.401022	335	415	0	80	80	1.0000000
NODE_9372_length_882_cov_21.401022	388	468	0	80	80	1.0000000
NODE_9373_length_882_cov_19.579821	456	511	0	47	55	0.8545455
NODE_9373_length_882_cov_19.579821	456	511	2	8	55	0.1454545
NODE_9373_length_882_cov_19.579821	506	586	0	80	80	1.0000000
NODE_9373_length_882_cov_19.579821	559	639	0	80	80	1.0000000
NODE_9374_length_882_cov_19.342273	298	378	0	80	80	1.0000000
NODE_9374_length_882_cov_19.342273	351	431	0	80	80	1.0000000
NODE_9374_length_882_cov_19.342273	427	508	0	27	81	0.3333333
NODE_9374_length_882_cov_19.342273	427	508	2	24	81	0.2962963
NODE_9374_length_882_cov_19.342273	427	508	4	13	81	0.1604938
NODE_9374_length_882_cov_19.342273	427	508	6	17	81	0.2098765
NODE_9374_length_882_cov_19.342273	481	561	4	43	80	0.5375000
NODE_9374_length_882_cov_19.342273	481	561	6	37	80	0.4625000
NODE_9375_length_882_cov_11.873563	267	347	0	80	80	1.0000000
NODE_9375_length_882_cov_11.873563	320	400	0	80	80	1.0000000
NODE_9376_length_882_cov_8.794381	430	510	0	80	80	1.0000000
NODE_9376_length_882_cov_8.794381	483	563	0	80	80	1.0000000
NODE_9377_length_882_cov_7.537676	527	608	0	81	81	1.0000000
NODE_9379_length_882_cov_6.696041	355	435	0	80	80	1.0000000
NODE_9379_length_882_cov_6.696041	408	488	0	80	80	1.0000000
NODE_9380_length_882_cov_4.734355	585	665	0	80	80	1.0000000
NODE_9380_length_882_cov_4.734355	638	718	0	80	80	1.0000000
NODE_9398_length_881_cov_32.875959	444	524	0	42	80	0.5250000
NODE_9398_length_881_cov_32.875959	444	524	2	6	80	0.0750000
NODE_9398_length_881_cov_32.875959	444	524	6	32	80	0.4000000
NODE_9398_length_881_cov_32.875959	497	577	0	80	80	1.0000000
NODE_9399_length_881_cov_25.750639	43	117	0	12	74	0.1621622
NODE_9399_length_881_cov_25.750639	43	117	2	62	74	0.8378378
NODE_9399_length_881_cov_25.750639	116	193	2	16	77	0.2077922
NODE_9399_length_881_cov_25.750639	116	193	4	25	77	0.3246753
NODE_9399_length_881_cov_25.750639	116	193	6	36	77	0.4675325
NODE_9400_length_881_cov_23.897698	286	365	0	79	79	1.0000000
NODE_9400_length_881_cov_23.897698	338	418	0	80	80	1.0000000
NODE_9401_length_881_cov_20.656010	359	439	0	35	80	0.4375000
NODE_9401_length_881_cov_20.656010	359	439	4	45	80	0.5625000
NODE_9401_length_881_cov_20.656010	412	492	0	6	80	0.0750000
NODE_9401_length_881_cov_20.656010	412	492	4	74	80	0.9250000
NODE_9402_length_881_cov_20.340153	242	322	0	80	80	1.0000000
NODE_9402_length_881_cov_20.340153	295	375	0	78	80	0.9750000
NODE_9402_length_881_cov_20.340153	295	375	2	2	80	0.0250000
NODE_9403_length_881_cov_18.234015	420	500	0	80	80	1.0000000
NODE_9403_length_881_cov_18.234015	473	553	0	80	80	1.0000000
NODE_9404_length_881_cov_17.748082	291	371	0	27	80	0.3375000
NODE_9404_length_881_cov_17.748082	291	371	2	53	80	0.6625000
NODE_9404_length_881_cov_17.748082	344	424	0	7	80	0.0875000
NODE_9404_length_881_cov_17.748082	344	424	2	73	80	0.9125000
NODE_9405_length_881_cov_12.884910	332	412	0	16	80	0.2000000
NODE_9405_length_881_cov_12.884910	332	412	2	64	80	0.8000000
NODE_9405_length_881_cov_12.884910	385	465	0	44	80	0.5500000
NODE_9405_length_881_cov_12.884910	385	465	2	36	80	0.4500000
NODE_9406_length_881_cov_6.473146	474	553	0	13	79	0.1645570
NODE_9406_length_881_cov_6.473146	474	553	2	35	79	0.4430380
NODE_9406_length_881_cov_6.473146	474	553	4	31	79	0.3924051
NODE_9406_length_881_cov_6.473146	514	594	0	54	80	0.6750000
NODE_9406_length_881_cov_6.473146	514	594	2	26	80	0.3250000
NODE_9406_length_881_cov_6.473146	526	565	0	25	39	0.6410257
NODE_9406_length_881_cov_6.473146	526	565	2	14	39	0.3589744
NODE_9406_length_881_cov_6.473146	555	606	0	51	51	1.0000000
NODE_9406_length_881_cov_6.473146	567	647	0	80	80	1.0000000
NODE_9407_length_881_cov_5.615090	547	627	0	80	80	1.0000000
NODE_9407_length_881_cov_5.615090	600	680	0	80	80	1.0000000
NODE_9424_length_880_cov_26.663252	320	400	0	58	80	0.7250000
NODE_9424_length_880_cov_26.663252	320	400	4	22	80	0.2750000
NODE_9424_length_880_cov_26.663252	373	453	0	5	80	0.0625000
NODE_9424_length_880_cov_26.663252	373	453	4	22	80	0.2750000
NODE_9424_length_880_cov_26.663252	373	453	6	53	80	0.6625000
NODE_9425_length_880_cov_21.828425	328	408	0	80	80	1.0000000
NODE_9425_length_880_cov_21.828425	381	461	0	80	80	1.0000000
NODE_9426_length_880_cov_20.245839	427	507	0	80	80	1.0000000
NODE_9426_length_880_cov_20.245839	480	560	0	80	80	1.0000000
NODE_9427_length_880_cov_19.434059	0	69	0	69	69	1.0000000
NODE_9428_length_880_cov_11.843790	363	430	0	67	67	1.0000000
NODE_9429_length_880_cov_11.544174	185	265	0	80	80	1.0000000
NODE_9429_length_880_cov_11.544174	238	318	0	80	80	1.0000000
NODE_9430_length_880_cov_10.956466	354	434	0	80	80	1.0000000
NODE_9430_length_880_cov_10.956466	407	487	0	80	80	1.0000000
NODE_9431_length_880_cov_10.008963	395	474	0	1	79	0.0126582
NODE_9431_length_880_cov_10.008963	395	474	4	78	79	0.9873418
NODE_9431_length_880_cov_10.008963	448	527	0	29	79	0.3670886
NODE_9431_length_880_cov_10.008963	448	527	2	7	79	0.0886076
NODE_9431_length_880_cov_10.008963	448	527	3	12	79	0.1518987
NODE_9431_length_880_cov_10.008963	448	527	4	31	79	0.3924051
NODE_9453_length_879_cov_23.565385	326	406	0	80	80	1.0000000
NODE_9453_length_879_cov_23.565385	379	459	0	80	80	1.0000000
NODE_9453_length_879_cov_23.565385	455	535	0	80	80	1.0000000
NODE_9453_length_879_cov_23.565385	508	586	0	78	78	1.0000000
NODE_9454_length_879_cov_20.758974	355	439	0	15	84	0.1785714
NODE_9454_length_879_cov_20.758974	355	439	4	69	84	0.8214286
NODE_9454_length_879_cov_20.758974	412	492	0	41	80	0.5125000
NODE_9454_length_879_cov_20.758974	412	492	4	39	80	0.4875000
NODE_9455_length_879_cov_19.685897	295	375	0	53	80	0.6625000
NODE_9455_length_879_cov_19.685897	295	375	2	27	80	0.3375000
NODE_9455_length_879_cov_19.685897	348	428	0	20	80	0.2500000
NODE_9455_length_879_cov_19.685897	348	428	2	60	80	0.7500000
NODE_9456_length_879_cov_17.738462	413	488	0	75	75	1.0000000
NODE_9456_length_879_cov_17.738462	569	649	0	24	80	0.3000000
NODE_9456_length_879_cov_17.738462	569	649	2	56	80	0.7000000
NODE_9456_length_879_cov_17.738462	569	649	0	24	80	0.3000000
NODE_9456_length_879_cov_17.738462	569	649	2	56	80	0.7000000
NODE_9456_length_879_cov_17.738462	569	649	0	24	80	0.3000000
NODE_9456_length_879_cov_17.738462	569	649	2	56	80	0.7000000
NODE_9456_length_879_cov_17.738462	622	676	0	51	54	0.9444444
NODE_9456_length_879_cov_17.738462	622	676	2	3	54	0.0555556
NODE_9458_length_879_cov_10.756410	335	415	0	80	80	1.0000000
NODE_9458_length_879_cov_10.756410	388	468	0	80	80	1.0000000
NODE_9459_length_879_cov_7.432051	234	314	0	28	80	0.3500000
NODE_9459_length_879_cov_7.432051	234	314	2	52	80	0.6500000
NODE_9459_length_879_cov_7.432051	288	367	0	79	79	1.0000000
NODE_9473_length_878_cov_230.436457	415	495	6	55	80	0.6875000
NODE_9473_length_878_cov_230.436457	415	495	10	15	80	0.1875000
NODE_9473_length_878_cov_230.436457	415	495	64	4	80	0.0500000
NODE_9473_length_878_cov_230.436457	415	495	65	6	80	0.0750000
NODE_9473_length_878_cov_230.436457	468	548	6	2	80	0.0250000
NODE_9473_length_878_cov_230.436457	468	548	10	15	80	0.1875000
NODE_9473_length_878_cov_230.436457	468	548	58	11	80	0.1375000
NODE_9473_length_878_cov_230.436457	468	548	60	8	80	0.1000000
NODE_9473_length_878_cov_230.436457	468	548	61	6	80	0.0750000
NODE_9473_length_878_cov_230.436457	468	548	62	17	80	0.2125000
NODE_9473_length_878_cov_230.436457	468	548	64	4	80	0.0500000
NODE_9473_length_878_cov_230.436457	468	548	65	13	80	0.1625000
NODE_9473_length_878_cov_230.436457	468	548	66	4	80	0.0500000
NODE_9474_length_878_cov_49.514763	410	490	0	23	80	0.2875000
NODE_9474_length_878_cov_49.514763	410	490	2	57	80	0.7125000
NODE_9474_length_878_cov_49.514763	463	543	0	68	80	0.8500000
NODE_9474_length_878_cov_49.514763	463	543	2	8	80	0.1000000
NODE_9474_length_878_cov_49.514763	463	543	4	4	80	0.0500000
NODE_9475_length_878_cov_38.862644	365	445	0	31	80	0.3875000
NODE_9475_length_878_cov_38.862644	365	445	2	49	80	0.6125000
NODE_9475_length_878_cov_38.862644	418	498	2	80	80	1.0000000
NODE_9476_length_878_cov_36.517330	346	426	0	80	80	1.0000000
NODE_9476_length_878_cov_36.517330	399	479	0	80	80	1.0000000
NODE_9476_length_878_cov_36.517330	475	555	0	80	80	1.0000000
NODE_9476_length_878_cov_36.517330	528	608	0	80	80	1.0000000
NODE_9477_length_878_cov_34.404365	627	707	12	4	80	0.0500000
NODE_9477_length_878_cov_34.404365	627	707	14	12	80	0.1500000
NODE_9477_length_878_cov_34.404365	627	707	16	29	80	0.3625000
NODE_9477_length_878_cov_34.404365	627	707	20	4	80	0.0500000
NODE_9477_length_878_cov_34.404365	627	707	22	20	80	0.2500000
NODE_9477_length_878_cov_34.404365	627	707	24	8	80	0.1000000
NODE_9477_length_878_cov_34.404365	627	707	26	3	80	0.0375000
NODE_9477_length_878_cov_34.404365	627	695	12	4	68	0.0588235
NODE_9477_length_878_cov_34.404365	627	695	14	12	68	0.1764706
NODE_9477_length_878_cov_34.404365	627	695	16	29	68	0.4264706
NODE_9477_length_878_cov_34.404365	627	695	22	14	68	0.2058824
NODE_9477_length_878_cov_34.404365	627	695	24	6	68	0.0882353
NODE_9477_length_878_cov_34.404365	627	695	26	3	68	0.0441176
NODE_9477_length_878_cov_34.404365	680	760	16	5	80	0.0625000
NODE_9477_length_878_cov_34.404365	680	760	20	10	80	0.1250000
NODE_9477_length_878_cov_34.404365	680	760	22	22	80	0.2750000
NODE_9477_length_878_cov_34.404365	680	760	23	1	80	0.0125000
NODE_9477_length_878_cov_34.404365	680	760	24	14	80	0.1750000
NODE_9477_length_878_cov_34.404365	680	760	25	1	80	0.0125000
NODE_9477_length_878_cov_34.404365	680	760	26	7	80	0.0875000
NODE_9477_length_878_cov_34.404365	680	760	27	2	80	0.0250000
NODE_9477_length_878_cov_34.404365	680	760	28	10	80	0.1250000
NODE_9477_length_878_cov_34.404365	680	760	30	2	80	0.0250000
NODE_9477_length_878_cov_34.404365	680	760	35	6	80	0.0750000
NODE_9478_length_878_cov_28.761232	467	547	0	80	80	1.0000000
NODE_9478_length_878_cov_28.761232	520	600	0	80	80	1.0000000
NODE_9479_length_878_cov_24.899872	316	396	0	80	80	1.0000000
NODE_9479_length_878_cov_24.899872	369	449	0	80	80	1.0000000
NODE_9479_length_878_cov_24.899872	445	525	0	80	80	1.0000000
NODE_9479_length_878_cov_24.899872	498	578	0	80	80	1.0000000
NODE_9480_length_878_cov_21.446727	377	457	0	8	80	0.1000000
NODE_9480_length_878_cov_21.446727	377	457	2	24	80	0.3000000
NODE_9480_length_878_cov_21.446727	377	457	4	48	80	0.6000000
NODE_9480_length_878_cov_21.446727	430	510	0	30	80	0.3750000
NODE_9480_length_878_cov_21.446727	430	510	2	32	80	0.4000000
NODE_9480_length_878_cov_21.446727	430	510	4	18	80	0.2250000
NODE_9481_length_878_cov_20.553273	424	504	0	16	80	0.2000000
NODE_9481_length_878_cov_20.553273	424	504	2	18	80	0.2250000
NODE_9481_length_878_cov_20.553273	424	504	4	11	80	0.1375000
NODE_9481_length_878_cov_20.553273	424	504	6	35	80	0.4375000
NODE_9481_length_878_cov_20.553273	477	557	2	20	80	0.2500000
NODE_9481_length_878_cov_20.553273	477	557	4	28	80	0.3500000
NODE_9481_length_878_cov_20.553273	477	557	6	32	80	0.4000000
NODE_9482_length_878_cov_14.016688	214	294	0	80	80	1.0000000
NODE_9482_length_878_cov_14.016688	267	347	0	80	80	1.0000000
NODE_9483_length_878_cov_9.252888	423	503	0	80	80	1.0000000
NODE_9483_length_878_cov_9.252888	476	556	0	80	80	1.0000000
NODE_9484_length_878_cov_8.695764	333	413	0	80	80	1.0000000
NODE_9484_length_878_cov_8.695764	386	466	0	80	80	1.0000000
NODE_9485_length_878_cov_6.686778	65	145	0	18	80	0.2250000
NODE_9485_length_878_cov_6.686778	65	145	2	62	80	0.7750000
NODE_9485_length_878_cov_6.686778	118	198	0	71	80	0.8875000
NODE_9485_length_878_cov_6.686778	118	198	2	9	80	0.1125000
NODE_9487_length_878_cov_6.328626	426	506	0	80	80	1.0000000
NODE_9487_length_878_cov_6.328626	479	559	0	80	80	1.0000000
NODE_9488_length_878_cov_5.771502	470	513	6	43	43	1.0000000
NODE_9490_length_878_cov_2.672657	499	579	0	50	80	0.6250000
NODE_9490_length_878_cov_2.672657	499	579	1	1	80	0.0125000
NODE_9490_length_878_cov_2.672657	499	579	2	29	80	0.3625000
NODE_9490_length_878_cov_2.672657	552	631	2	73	79	0.9240506
NODE_9490_length_878_cov_2.672657	552	631	6	6	79	0.0759494
NODE_9507_length_877_cov_59.021851	324	404	0	62	80	0.7750000
NODE_9507_length_877_cov_59.021851	324	404	2	18	80	0.2250000
NODE_9507_length_877_cov_59.021851	377	457	0	9	80	0.1125000
NODE_9507_length_877_cov_59.021851	377	457	2	71	80	0.8875000
NODE_9508_length_877_cov_54.422879	418	498	0	80	80	1.0000000
NODE_9508_length_877_cov_54.422879	471	551	0	80	80	1.0000000
NODE_9509_length_877_cov_47.672237	451	527	0	17	76	0.2236842
NODE_9509_length_877_cov_47.672237	451	527	2	59	76	0.7763158
NODE_9509_length_877_cov_47.672237	500	580	0	16	80	0.2000000
NODE_9509_length_877_cov_47.672237	500	580	2	64	80	0.8000000
NODE_9510_length_877_cov_29.884319	349	429	8	9	80	0.1125000
NODE_9510_length_877_cov_29.884319	349	429	9	1	80	0.0125000
NODE_9510_length_877_cov_29.884319	349	429	10	4	80	0.0500000
NODE_9510_length_877_cov_29.884319	349	429	18	32	80	0.4000000
NODE_9510_length_877_cov_29.884319	349	429	20	11	80	0.1375000
NODE_9510_length_877_cov_29.884319	349	429	22	23	80	0.2875000
NODE_9510_length_877_cov_29.884319	402	482	0	11	80	0.1375000
NODE_9510_length_877_cov_29.884319	402	482	2	13	80	0.1625000
NODE_9510_length_877_cov_29.884319	402	482	4	3	80	0.0375000
NODE_9510_length_877_cov_29.884319	402	482	14	3	80	0.0375000
NODE_9510_length_877_cov_29.884319	402	482	16	3	80	0.0375000
NODE_9510_length_877_cov_29.884319	402	482	18	47	80	0.5875000
NODE_9511_length_877_cov_17.681234	423	503	0	11	80	0.1375000
NODE_9511_length_877_cov_17.681234	423	503	4	56	80	0.7000000
NODE_9511_length_877_cov_17.681234	423	503	6	13	80	0.1625000
NODE_9511_length_877_cov_17.681234	476	556	0	64	80	0.8000000
NODE_9511_length_877_cov_17.681234	476	556	4	16	80	0.2000000
NODE_9512_length_877_cov_17.520566	228	308	0	60	80	0.7500000
NODE_9512_length_877_cov_17.520566	228	308	2	20	80	0.2500000
NODE_9512_length_877_cov_17.520566	281	361	0	9	80	0.1125000
NODE_9512_length_877_cov_17.520566	281	361	2	71	80	0.8875000
NODE_9513_length_877_cov_17.374036	362	442	0	78	80	0.9750000
NODE_9513_length_877_cov_17.374036	362	442	1	2	80	0.0250000
NODE_9513_length_877_cov_17.374036	415	495	0	25	80	0.3125000
NODE_9513_length_877_cov_17.374036	415	495	1	55	80	0.6875000
NODE_9515_length_877_cov_9.320051	395	475	0	80	80	1.0000000
NODE_9515_length_877_cov_9.320051	448	528	0	80	80	1.0000000
NODE_9517_length_877_cov_6.755784	222	302	0	80	80	1.0000000
NODE_9517_length_877_cov_6.755784	275	354	0	79	79	1.0000000
NODE_9537_length_876_cov_46.021879	389	469	0	80	80	1.0000000
NODE_9537_length_876_cov_46.021879	442	522	0	80	80	1.0000000
NODE_9538_length_876_cov_34.441441	379	459	0	52	80	0.6500000
NODE_9538_length_876_cov_34.441441	379	459	2	6	80	0.0750000
NODE_9538_length_876_cov_34.441441	379	459	4	16	80	0.2000000
NODE_9538_length_876_cov_34.441441	379	459	6	6	80	0.0750000
NODE_9538_length_876_cov_34.441441	432	512	2	5	80	0.0625000
NODE_9538_length_876_cov_34.441441	432	512	4	16	80	0.2000000
NODE_9538_length_876_cov_34.441441	432	512	6	30	80	0.3750000
NODE_9538_length_876_cov_34.441441	432	512	8	29	80	0.3625000
NODE_9539_length_876_cov_30.742600	344	424	0	80	80	1.0000000
NODE_9539_length_876_cov_30.742600	397	477	0	80	80	1.0000000
NODE_9540_length_876_cov_28.476190	345	425	0	38	80	0.4750000
NODE_9540_length_876_cov_28.476190	345	425	2	42	80	0.5250000
NODE_9540_length_876_cov_28.476190	398	478	2	80	80	1.0000000
NODE_9541_length_876_cov_22.722008	324	404	2	15	80	0.1875000
NODE_9541_length_876_cov_22.722008	324	404	8	5	80	0.0625000
NODE_9541_length_876_cov_22.722008	324	404	12	2	80	0.0250000
NODE_9541_length_876_cov_22.722008	324	404	18	37	80	0.4625000
NODE_9541_length_876_cov_22.722008	324	404	20	21	80	0.2625000
NODE_9541_length_876_cov_22.722008	377	457	0	20	80	0.2500000
NODE_9541_length_876_cov_22.722008	377	457	2	48	80	0.6000000
NODE_9541_length_876_cov_22.722008	377	457	8	5	80	0.0625000
NODE_9541_length_876_cov_22.722008	377	457	12	2	80	0.0250000
NODE_9541_length_876_cov_22.722008	377	457	20	5	80	0.0625000
NODE_9542_length_876_cov_17.458172	367	447	0	1	80	0.0125000
NODE_9542_length_876_cov_17.458172	367	447	4	11	80	0.1375000
NODE_9542_length_876_cov_17.458172	367	447	6	68	80	0.8500000
NODE_9542_length_876_cov_17.458172	420	500	0	54	80	0.6750000
NODE_9542_length_876_cov_17.458172	420	500	4	11	80	0.1375000
NODE_9542_length_876_cov_17.458172	420	500	6	15	80	0.1875000
NODE_9561_length_875_cov_52.965206	190	270	0	80	80	1.0000000
NODE_9561_length_875_cov_52.965206	243	323	0	80	80	1.0000000
NODE_9561_length_875_cov_52.965206	319	399	0	80	80	1.0000000
NODE_9561_length_875_cov_52.965206	372	447	0	75	75	1.0000000
NODE_9562_length_875_cov_35.634021	260	340	0	47	80	0.5875000
NODE_9562_length_875_cov_35.634021	260	340	2	33	80	0.4125000
NODE_9562_length_875_cov_35.634021	313	393	0	80	80	1.0000000
NODE_9562_length_875_cov_35.634021	389	469	0	66	80	0.8250000
NODE_9562_length_875_cov_35.634021	389	469	2	14	80	0.1750000
NODE_9562_length_875_cov_35.634021	442	522	0	17	80	0.2125000
NODE_9562_length_875_cov_35.634021	442	522	2	63	80	0.7875000
NODE_9563_length_875_cov_33.771907	363	441	0	53	78	0.6794872
NODE_9563_length_875_cov_33.771907	363	441	2	25	78	0.3205128
NODE_9563_length_875_cov_33.771907	414	494	0	2	80	0.0250000
NODE_9563_length_875_cov_33.771907	414	494	2	78	80	0.9750000
NODE_9564_length_875_cov_29.698454	322	402	0	80	80	1.0000000
NODE_9564_length_875_cov_29.698454	375	455	0	80	80	1.0000000
NODE_9565_length_875_cov_23.041237	364	444	0	80	80	1.0000000
NODE_9565_length_875_cov_23.041237	417	497	0	80	80	1.0000000
NODE_9565_length_875_cov_23.041237	493	573	0	80	80	1.0000000
NODE_9565_length_875_cov_23.041237	546	626	0	80	80	1.0000000
NODE_9566_length_875_cov_9.800258	242	322	0	53	80	0.6625000
NODE_9566_length_875_cov_9.800258	242	322	2	27	80	0.3375000
NODE_9566_length_875_cov_9.800258	295	376	2	81	81	1.0000000
NODE_9567_length_875_cov_8.195876	407	487	2	80	80	1.0000000
NODE_9567_length_875_cov_8.195876	460	540	0	42	80	0.5250000
NODE_9567_length_875_cov_8.195876	460	540	2	38	80	0.4750000
NODE_9585_length_874_cov_48.925161	185	265	0	80	80	1.0000000
NODE_9585_length_874_cov_48.925161	238	318	0	30	80	0.3750000
NODE_9585_length_874_cov_48.925161	238	318	2	50	80	0.6250000
NODE_9587_length_874_cov_37.354839	199	279	0	70	80	0.8750000
NODE_9587_length_874_cov_37.354839	199	279	4	10	80	0.1250000
NODE_9587_length_874_cov_37.354839	252	332	0	17	80	0.2125000
NODE_9587_length_874_cov_37.354839	252	332	4	63	80	0.7875000
NODE_9588_length_874_cov_35.040000	231	311	0	31	80	0.3875000
NODE_9588_length_874_cov_35.040000	231	311	2	9	80	0.1125000
NODE_9588_length_874_cov_35.040000	231	311	6	37	80	0.4625000
NODE_9588_length_874_cov_35.040000	231	311	8	3	80	0.0375000
NODE_9588_length_874_cov_35.040000	284	364	6	59	80	0.7375000
NODE_9588_length_874_cov_35.040000	284	364	8	21	80	0.2625000
NODE_9589_length_874_cov_23.415484	327	407	2	17	80	0.2125000
NODE_9589_length_874_cov_23.415484	327	407	6	63	80	0.7875000
NODE_9589_length_874_cov_23.415484	380	460	0	10	80	0.1250000
NODE_9589_length_874_cov_23.415484	380	460	3	1	80	0.0125000
NODE_9589_length_874_cov_23.415484	380	460	4	29	80	0.3625000
NODE_9589_length_874_cov_23.415484	380	460	6	40	80	0.5000000
NODE_9589_length_874_cov_23.415484	456	536	0	80	80	1.0000000
NODE_9589_length_874_cov_23.415484	509	589	0	80	80	1.0000000
NODE_9590_length_874_cov_21.885161	279	359	0	16	80	0.2000000
NODE_9590_length_874_cov_21.885161	279	359	1	11	80	0.1375000
NODE_9590_length_874_cov_21.885161	279	359	2	53	80	0.6625000
NODE_9590_length_874_cov_21.885161	332	412	0	69	80	0.8625000
NODE_9590_length_874_cov_21.885161	332	412	1	11	80	0.1375000
NODE_9591_length_874_cov_11.172903	67	147	0	80	80	1.0000000
NODE_9591_length_874_cov_11.172903	120	200	0	80	80	1.0000000
NODE_9592_length_874_cov_9.645161	424	504	0	80	80	1.0000000
NODE_9592_length_874_cov_9.645161	477	557	0	80	80	1.0000000
NODE_9593_length_874_cov_8.637419	359	439	0	80	80	1.0000000
NODE_9593_length_874_cov_8.637419	412	499	0	87	87	1.0000000
NODE_9596_length_874_cov_4.785806	829	874	0	45	45	1.0000000
NODE_9618_length_873_cov_100.625323	50	130	21	4	80	0.0500000
NODE_9618_length_873_cov_100.625323	50	130	23	2	80	0.0250000
NODE_9618_length_873_cov_100.625323	50	130	25	5	80	0.0625000
NODE_9618_length_873_cov_100.625323	50	130	29	1	80	0.0125000
NODE_9618_length_873_cov_100.625323	50	130	31	68	80	0.8500000
NODE_9619_length_873_cov_45.633075	226	306	0	80	80	1.0000000
NODE_9619_length_873_cov_45.633075	279	359	0	80	80	1.0000000
NODE_9619_length_873_cov_45.633075	693	773	0	29	80	0.3625000
NODE_9619_length_873_cov_45.633075	693	773	2	51	80	0.6375000
NODE_9619_length_873_cov_45.633075	746	826	0	80	80	1.0000000
NODE_9620_length_873_cov_39.224806	190	270	0	56	80	0.7000000
NODE_9620_length_873_cov_39.224806	190	270	2	11	80	0.1375000
NODE_9620_length_873_cov_39.224806	190	270	4	13	80	0.1625000
NODE_9620_length_873_cov_39.224806	243	307	0	64	64	1.0000000
NODE_9620_length_873_cov_39.224806	390	470	0	80	80	1.0000000
NODE_9620_length_873_cov_39.224806	443	523	0	80	80	1.0000000
NODE_9620_length_873_cov_39.224806	504	523	0	19	19	1.0000000
NODE_9620_length_873_cov_39.224806	519	599	0	80	80	1.0000000
NODE_9620_length_873_cov_39.224806	572	652	0	80	80	1.0000000
NODE_9621_length_873_cov_27.992248	372	452	0	80	80	1.0000000
NODE_9621_length_873_cov_27.992248	425	505	0	80	80	1.0000000
NODE_9622_length_873_cov_23.270026	390	470	0	24	80	0.3000000
NODE_9622_length_873_cov_23.270026	390	470	2	56	80	0.7000000
NODE_9622_length_873_cov_23.270026	443	528	0	82	85	0.9647059
NODE_9622_length_873_cov_23.270026	443	528	2	3	85	0.0352941
NODE_9623_length_873_cov_23.197674	293	373	0	21	80	0.2625000
NODE_9623_length_873_cov_23.197674	293	373	2	59	80	0.7375000
NODE_9623_length_873_cov_23.197674	346	426	0	74	80	0.9250000
NODE_9623_length_873_cov_23.197674	346	426	2	6	80	0.0750000
NODE_9624_length_873_cov_20.432817	347	427	0	37	80	0.4625000
NODE_9624_length_873_cov_20.432817	347	427	2	43	80	0.5375000
NODE_9624_length_873_cov_20.432817	400	480	0	80	80	1.0000000
NODE_9624_length_873_cov_20.432817	476	556	0	30	80	0.3750000
NODE_9624_length_873_cov_20.432817	476	556	4	50	80	0.6250000
NODE_9624_length_873_cov_20.432817	529	609	0	22	80	0.2750000
NODE_9624_length_873_cov_20.432817	529	609	3	1	80	0.0125000
NODE_9624_length_873_cov_20.432817	529	609	4	57	80	0.7125000
NODE_9625_length_873_cov_19.913437	445	525	0	80	80	1.0000000
NODE_9625_length_873_cov_19.913437	498	578	0	80	80	1.0000000
NODE_9626_length_873_cov_16.718346	276	356	2	36	80	0.4500000
NODE_9626_length_873_cov_16.718346	276	356	4	44	80	0.5500000
NODE_9626_length_873_cov_16.718346	329	409	0	40	80	0.5000000
NODE_9626_length_873_cov_16.718346	329	409	2	26	80	0.3250000
NODE_9626_length_873_cov_16.718346	329	409	4	14	80	0.1750000
NODE_9627_length_873_cov_16.422481	423	503	0	10	80	0.1250000
NODE_9627_length_873_cov_16.422481	423	503	2	70	80	0.8750000
NODE_9627_length_873_cov_16.422481	476	556	0	63	80	0.7875000
NODE_9627_length_873_cov_16.422481	476	556	2	17	80	0.2125000
NODE_9628_length_873_cov_11.198966	410	490	0	80	80	1.0000000
NODE_9628_length_873_cov_11.198966	463	543	0	80	80	1.0000000
NODE_9629_length_873_cov_9.799742	334	414	0	18	80	0.2250000
NODE_9629_length_873_cov_9.799742	334	414	2	23	80	0.2875000
NODE_9629_length_873_cov_9.799742	334	414	4	39	80	0.4875000
NODE_9629_length_873_cov_9.799742	387	467	0	12	80	0.1500000
NODE_9629_length_873_cov_9.799742	387	467	4	68	80	0.8500000
NODE_9632_length_873_cov_3.828165	490	570	0	80	80	1.0000000
NODE_9632_length_873_cov_3.828165	543	583	0	40	40	1.0000000
NODE_9632_length_873_cov_3.828165	690	735	0	31	45	0.6888889
NODE_9632_length_873_cov_3.828165	690	735	2	14	45	0.3111111
NODE_9633_length_873_cov_3.443152	716	746	0	30	30	1.0000000
NODE_9647_length_873_cov_1.239018	593	658	2	12	65	0.1846154
NODE_9647_length_873_cov_1.239018	593	658	4	28	65	0.4307692
NODE_9647_length_873_cov_1.239018	593	658	6	6	65	0.0923077
NODE_9647_length_873_cov_1.239018	593	658	8	2	65	0.0307692
NODE_9647_length_873_cov_1.239018	593	658	10	1	65	0.0153846
NODE_9647_length_873_cov_1.239018	593	658	12	16	65	0.2461538
NODE_9651_length_872_cov_47.732212	432	512	0	20	80	0.2500000
NODE_9651_length_872_cov_47.732212	432	512	2	60	80	0.7500000
NODE_9651_length_872_cov_47.732212	484	564	0	9	80	0.1125000
NODE_9651_length_872_cov_47.732212	484	564	2	71	80	0.8875000
NODE_9651_length_872_cov_47.732212	560	640	0	80	80	1.0000000
NODE_9651_length_872_cov_47.732212	613	693	0	80	80	1.0000000
NODE_9652_length_872_cov_16.204398	349	429	0	80	80	1.0000000
NODE_9652_length_872_cov_16.204398	402	482	0	45	80	0.5625000
NODE_9652_length_872_cov_16.204398	402	482	1	1	80	0.0125000
NODE_9652_length_872_cov_16.204398	402	482	4	34	80	0.4250000
NODE_9652_length_872_cov_16.204398	478	558	4	80	80	1.0000000
NODE_9652_length_872_cov_16.204398	531	611	0	13	80	0.1625000
NODE_9652_length_872_cov_16.204398	531	611	1	1	80	0.0125000
NODE_9652_length_872_cov_16.204398	531	611	3	1	80	0.0125000
NODE_9652_length_872_cov_16.204398	531	611	4	65	80	0.8125000
NODE_9653_length_872_cov_12.835705	376	456	0	14	80	0.1750000
NODE_9653_length_872_cov_12.835705	376	456	2	66	80	0.8250000
NODE_9653_length_872_cov_12.835705	429	509	0	14	80	0.1750000
NODE_9653_length_872_cov_12.835705	429	509	2	66	80	0.8250000
NODE_9654_length_872_cov_9.657180	356	431	6	75	75	1.0000000
NODE_9660_length_872_cov_3.531695	425	505	0	80	80	1.0000000
NODE_9660_length_872_cov_3.531695	478	559	0	81	81	1.0000000
NODE_9673_length_871_cov_56.841969	265	345	0	80	80	1.0000000
NODE_9673_length_871_cov_56.841969	318	398	0	64	80	0.8000000
NODE_9673_length_871_cov_56.841969	318	398	2	16	80	0.2000000
NODE_9673_length_871_cov_56.841969	394	474	2	80	80	1.0000000
NODE_9673_length_871_cov_56.841969	447	527	0	21	80	0.2625000
NODE_9673_length_871_cov_56.841969	447	527	2	59	80	0.7375000
NODE_9674_length_871_cov_47.528497	461	541	0	80	80	1.0000000
NODE_9674_length_871_cov_47.528497	514	594	0	27	80	0.3375000
NODE_9674_length_871_cov_47.528497	514	594	2	53	80	0.6625000
NODE_9675_length_871_cov_31.145078	326	406	0	80	80	1.0000000
NODE_9675_length_871_cov_31.145078	379	459	0	44	80	0.5500000
NODE_9675_length_871_cov_31.145078	379	459	2	36	80	0.4500000
NODE_9676_length_871_cov_27.993523	379	459	0	80	80	1.0000000
NODE_9676_length_871_cov_27.993523	432	512	0	80	80	1.0000000
NODE_9677_length_871_cov_25.954663	463	543	8	80	80	1.0000000
NODE_9677_length_871_cov_25.954663	516	596	7	49	80	0.6125000
NODE_9677_length_871_cov_25.954663	516	596	8	31	80	0.3875000
NODE_9678_length_871_cov_24.069948	492	558	0	66	66	1.0000000
NODE_9678_length_871_cov_24.069948	558	634	0	76	76	1.0000000
NODE_9679_length_871_cov_23.953368	445	522	0	14	77	0.1818182
NODE_9679_length_871_cov_23.953368	445	522	2	55	77	0.7142857
NODE_9679_length_871_cov_23.953368	445	522	6	2	77	0.0259740
NODE_9679_length_871_cov_23.953368	445	522	10	1	77	0.0129870
NODE_9679_length_871_cov_23.953368	445	522	16	5	77	0.0649351
NODE_9680_length_871_cov_19.304404	335	415	0	80	80	1.0000000
NODE_9680_length_871_cov_19.304404	388	468	0	30	80	0.3750000
NODE_9680_length_871_cov_19.304404	388	468	2	50	80	0.6250000
NODE_9682_length_871_cov_18.108808	370	450	0	80	80	1.0000000
NODE_9682_length_871_cov_18.108808	423	503	0	80	80	1.0000000
NODE_9683_length_871_cov_17.034974	362	442	0	25	80	0.3125000
NODE_9683_length_871_cov_17.034974	362	442	2	4	80	0.0500000
NODE_9683_length_871_cov_17.034974	362	442	8	51	80	0.6375000
NODE_9683_length_871_cov_17.034974	415	495	0	1	80	0.0125000
NODE_9683_length_871_cov_17.034974	415	495	4	1	80	0.0125000
NODE_9683_length_871_cov_17.034974	415	495	6	45	80	0.5625000
NODE_9683_length_871_cov_17.034974	415	495	8	33	80	0.4125000
NODE_9684_length_871_cov_16.768135	374	454	0	7	80	0.0875000
NODE_9684_length_871_cov_16.768135	374	454	2	73	80	0.9125000
NODE_9685_length_871_cov_14.196891	267	347	0	17	80	0.2125000
NODE_9685_length_871_cov_14.196891	267	347	2	46	80	0.5750000
NODE_9685_length_871_cov_14.196891	267	347	4	17	80	0.2125000
NODE_9685_length_871_cov_14.196891	320	400	2	17	80	0.2125000
NODE_9685_length_871_cov_14.196891	320	400	4	63	80	0.7875000
NODE_9686_length_871_cov_13.443005	246	326	0	80	80	1.0000000
NODE_9686_length_871_cov_13.443005	299	322	0	23	23	1.0000000
NODE_9687_length_871_cov_11.839378	29	109	0	80	80	1.0000000
NODE_9687_length_871_cov_11.839378	82	149	0	67	67	1.0000000
NODE_9687_length_871_cov_11.839378	331	411	0	80	80	1.0000000
NODE_9687_length_871_cov_11.839378	384	464	0	80	80	1.0000000
NODE_9689_length_871_cov_5.730570	316	373	0	32	57	0.5614035
NODE_9689_length_871_cov_5.730570	316	373	2	8	57	0.1403509
NODE_9689_length_871_cov_5.730570	316	373	4	17	57	0.2982456
NODE_9694_length_871_cov_3.544041	428	508	0	52	80	0.6500000
NODE_9694_length_871_cov_3.544041	428	508	3	2	80	0.0250000
NODE_9694_length_871_cov_3.544041	428	508	4	26	80	0.3250000
NODE_9694_length_871_cov_3.544041	481	561	3	1	80	0.0125000
NODE_9694_length_871_cov_3.544041	481	561	4	79	80	0.9875000
NODE_9716_length_870_cov_43.400778	542	622	0	80	80	1.0000000
NODE_9716_length_870_cov_43.400778	595	675	0	80	80	1.0000000
NODE_9719_length_870_cov_28.249027	442	524	0	44	82	0.5365854
NODE_9719_length_870_cov_28.249027	442	524	4	38	82	0.4634146
NODE_9719_length_870_cov_28.249027	497	577	0	4	80	0.0500000
NODE_9719_length_870_cov_28.249027	497	577	4	76	80	0.9500000
NODE_9720_length_870_cov_26.992218	240	320	0	40	80	0.5000000
NODE_9720_length_870_cov_26.992218	240	320	4	40	80	0.5000000
NODE_9720_length_870_cov_26.992218	293	373	4	80	80	1.0000000
NODE_9720_length_870_cov_26.992218	369	449	0	27	80	0.3375000
NODE_9720_length_870_cov_26.992218	369	449	4	53	80	0.6625000
NODE_9720_length_870_cov_26.992218	422	502	0	80	80	1.0000000
NODE_9721_length_870_cov_25.806744	186	237	2	44	51	0.8627451
NODE_9721_length_870_cov_25.806744	186	237	4	1	51	0.0196078
NODE_9721_length_870_cov_25.806744	186	237	6	6	51	0.1176471
NODE_9721_length_870_cov_25.806744	391	471	4	39	80	0.4875000
NODE_9721_length_870_cov_25.806744	391	471	6	12	80	0.1500000
NODE_9721_length_870_cov_25.806744	391	471	8	29	80	0.3625000
NODE_9721_length_870_cov_25.806744	444	524	0	3	80	0.0375000
NODE_9721_length_870_cov_25.806744	444	524	4	15	80	0.1875000
NODE_9721_length_870_cov_25.806744	444	524	8	62	80	0.7750000
NODE_9722_length_870_cov_18.862516	345	425	0	68	80	0.8500000
NODE_9722_length_870_cov_18.862516	345	425	2	12	80	0.1500000
NODE_9722_length_870_cov_18.862516	398	478	0	15	80	0.1875000
NODE_9722_length_870_cov_18.862516	398	478	2	65	80	0.8125000
NODE_9723_length_870_cov_15.686122	330	410	0	80	80	1.0000000
NODE_9723_length_870_cov_15.686122	383	463	0	80	80	1.0000000
NODE_9725_length_870_cov_13.334630	479	559	0	40	80	0.5000000
NODE_9725_length_870_cov_13.334630	479	559	2	40	80	0.5000000
NODE_9725_length_870_cov_13.334630	532	612	0	80	80	1.0000000
NODE_9726_length_870_cov_9.712062	410	490	0	80	80	1.0000000
NODE_9726_length_870_cov_9.712062	463	542	0	63	79	0.7974684
NODE_9726_length_870_cov_9.712062	463	542	2	16	79	0.2025317
NODE_9728_length_870_cov_7.556420	448	528	0	64	80	0.8000000
NODE_9728_length_870_cov_7.556420	448	528	2	16	80	0.2000000
NODE_9728_length_870_cov_7.556420	501	581	0	80	80	1.0000000
NODE_9746_length_869_cov_42.784416	395	475	0	80	80	1.0000000
NODE_9746_length_869_cov_42.784416	448	528	0	80	80	1.0000000
NODE_9747_length_869_cov_29.525974	211	291	0	80	80	1.0000000
NODE_9747_length_869_cov_29.525974	264	344	0	80	80	1.0000000
NODE_9748_length_869_cov_16.258442	389	469	0	80	80	1.0000000
NODE_9748_length_869_cov_16.258442	442	522	0	80	80	1.0000000
NODE_9749_length_869_cov_15.940260	321	401	0	80	80	1.0000000
NODE_9749_length_869_cov_15.940260	374	454	0	80	80	1.0000000
NODE_9750_length_869_cov_9.619481	402	442	137	1	40	0.0250000
NODE_9750_length_869_cov_9.619481	402	442	143	3	40	0.0750000
NODE_9750_length_869_cov_9.619481	402	442	144	2	40	0.0500000
NODE_9750_length_869_cov_9.619481	402	442	145	11	40	0.2750000
NODE_9750_length_869_cov_9.619481	402	442	146	5	40	0.1250000
NODE_9750_length_869_cov_9.619481	402	442	147	4	40	0.1000000
NODE_9750_length_869_cov_9.619481	402	442	148	3	40	0.0750000
NODE_9750_length_869_cov_9.619481	402	442	149	1	40	0.0250000
NODE_9750_length_869_cov_9.619481	402	442	151	2	40	0.0500000
NODE_9750_length_869_cov_9.619481	402	442	155	2	40	0.0500000
NODE_9750_length_869_cov_9.619481	402	442	158	1	40	0.0250000
NODE_9750_length_869_cov_9.619481	402	442	160	1	40	0.0250000
NODE_9750_length_869_cov_9.619481	402	442	161	1	40	0.0250000
NODE_9750_length_869_cov_9.619481	402	442	162	2	40	0.0500000
NODE_9750_length_869_cov_9.619481	402	442	164	1	40	0.0250000
NODE_9751_length_869_cov_7.123377	392	472	0	80	80	1.0000000
NODE_9751_length_869_cov_7.123377	445	525	0	80	80	1.0000000
NODE_9753_length_869_cov_3.658442	310	378	0	68	68	1.0000000
NODE_9777_length_868_cov_57.465540	355	435	0	53	80	0.6625000
NODE_9777_length_868_cov_57.465540	355	435	2	27	80	0.3375000
NODE_9778_length_868_cov_46.509753	0	65	0	65	65	1.0000000
NODE_9778_length_868_cov_46.509753	0	65	0	65	65	1.0000000
NODE_9778_length_868_cov_46.509753	0	65	0	65	65	1.0000000
NODE_9778_length_868_cov_46.509753	0	65	0	65	65	1.0000000
NODE_9778_length_868_cov_46.509753	61	141	0	80	80	1.0000000
NODE_9778_length_868_cov_46.509753	61	141	0	80	80	1.0000000
NODE_9778_length_868_cov_46.509753	114	194	0	80	80	1.0000000
NODE_9778_length_868_cov_46.509753	114	194	0	80	80	1.0000000
NODE_9779_length_868_cov_26.092328	318	398	1	36	80	0.4500000
NODE_9779_length_868_cov_26.092328	318	398	2	2	80	0.0250000
NODE_9779_length_868_cov_26.092328	318	398	4	42	80	0.5250000
NODE_9779_length_868_cov_26.092328	371	451	0	14	80	0.1750000
NODE_9779_length_868_cov_26.092328	371	451	1	66	80	0.8250000
NODE_9781_length_868_cov_22.555267	377	457	2	4	80	0.0500000
NODE_9781_length_868_cov_22.555267	377	457	4	4	80	0.0500000
NODE_9781_length_868_cov_22.555267	377	457	8	17	80	0.2125000
NODE_9781_length_868_cov_22.555267	377	457	10	7	80	0.0875000
NODE_9781_length_868_cov_22.555267	377	457	11	30	80	0.3750000
NODE_9781_length_868_cov_22.555267	377	457	12	18	80	0.2250000
NODE_9781_length_868_cov_22.555267	430	510	2	11	80	0.1375000
NODE_9781_length_868_cov_22.555267	430	510	6	19	80	0.2375000
NODE_9781_length_868_cov_22.555267	430	510	7	3	80	0.0375000
NODE_9781_length_868_cov_22.555267	430	510	9	2	80	0.0250000
NODE_9781_length_868_cov_22.555267	430	510	11	45	80	0.5625000
NODE_9782_length_868_cov_20.466840	259	339	2	80	80	1.0000000
NODE_9782_length_868_cov_20.466840	312	392	0	28	80	0.3500000
NODE_9782_length_868_cov_20.466840	312	392	2	52	80	0.6500000
NODE_9782_length_868_cov_20.466840	388	468	2	80	80	1.0000000
NODE_9782_length_868_cov_20.466840	441	521	0	47	80	0.5875000
NODE_9782_length_868_cov_20.466840	441	521	2	33	80	0.4125000
NODE_9783_length_868_cov_20.414824	311	391	4	6	80	0.0750000
NODE_9783_length_868_cov_20.414824	311	391	8	74	80	0.9250000
NODE_9783_length_868_cov_20.414824	364	444	0	42	80	0.5250000
NODE_9783_length_868_cov_20.414824	364	444	2	9	80	0.1125000
NODE_9783_length_868_cov_20.414824	364	444	4	8	80	0.1000000
NODE_9783_length_868_cov_20.414824	364	444	8	21	80	0.2625000
NODE_9784_length_868_cov_17.613784	340	420	0	80	80	1.0000000
NODE_9784_length_868_cov_17.613784	393	473	0	80	80	1.0000000
NODE_9785_length_868_cov_15.768531	353	433	0	80	80	1.0000000
NODE_9785_length_868_cov_15.768531	406	486	0	67	80	0.8375000
NODE_9785_length_868_cov_15.768531	406	486	2	8	80	0.1000000
NODE_9785_length_868_cov_15.768531	406	486	4	5	80	0.0625000
NODE_9786_length_868_cov_13.997399	611	691	0	80	80	1.0000000
NODE_9786_length_868_cov_13.997399	664	744	0	80	80	1.0000000
NODE_9787_length_868_cov_13.224967	451	531	0	30	80	0.3750000
NODE_9787_length_868_cov_13.224967	451	531	2	50	80	0.6250000
NODE_9787_length_868_cov_13.224967	504	583	0	37	79	0.4683544
NODE_9787_length_868_cov_13.224967	504	583	2	42	79	0.5316456
NODE_9788_length_868_cov_11.851756	363	422	0	59	59	1.0000000
NODE_9788_length_868_cov_11.851756	395	475	0	80	80	1.0000000
NODE_9789_length_868_cov_11.352406	361	441	0	80	80	1.0000000
NODE_9789_length_868_cov_11.352406	414	494	0	80	80	1.0000000
NODE_9790_length_868_cov_11.335501	289	369	0	80	80	1.0000000
NODE_9790_length_868_cov_11.335501	342	422	0	80	80	1.0000000
NODE_9791_length_868_cov_8.455137	401	481	0	12	80	0.1500000
NODE_9791_length_868_cov_8.455137	401	481	2	68	80	0.8500000
NODE_9791_length_868_cov_8.455137	454	534	0	65	80	0.8125000
NODE_9791_length_868_cov_8.455137	454	534	2	15	80	0.1875000
NODE_9816_length_867_cov_27.756510	333	376	0	43	43	1.0000000
NODE_9816_length_867_cov_27.756510	349	429	0	80	80	1.0000000
NODE_9816_length_867_cov_27.756510	425	505	0	80	80	1.0000000
NODE_9816_length_867_cov_27.756510	478	542	0	64	64	1.0000000
NODE_9817_length_867_cov_25.354167	280	345	0	65	65	1.0000000
NODE_9817_length_867_cov_25.354167	325	397	0	72	72	1.0000000
NODE_9818_length_867_cov_23.968750	369	449	0	80	80	1.0000000
NODE_9818_length_867_cov_23.968750	422	502	0	80	80	1.0000000
NODE_9819_length_867_cov_21.220052	524	604	0	47	80	0.5875000
NODE_9819_length_867_cov_21.220052	524	604	2	33	80	0.4125000
NODE_9819_length_867_cov_21.220052	577	657	2	29	80	0.3625000
NODE_9819_length_867_cov_21.220052	577	657	4	51	80	0.6375000
NODE_9820_length_867_cov_15.042969	287	364	0	77	77	1.0000000
NODE_9821_length_867_cov_11.057292	305	373	0	68	68	1.0000000
NODE_9821_length_867_cov_11.057292	346	426	0	80	80	1.0000000
NODE_9821_length_867_cov_11.057292	475	555	0	80	80	1.0000000
NODE_9822_length_867_cov_8.127604	347	427	0	80	80	1.0000000
NODE_9822_length_867_cov_8.127604	400	480	0	80	80	1.0000000
NODE_9823_length_867_cov_7.621094	292	372	0	80	80	1.0000000
NODE_9823_length_867_cov_7.621094	345	425	0	80	80	1.0000000
NODE_9826_length_867_cov_5.494792	445	525	0	80	80	1.0000000
NODE_9826_length_867_cov_5.494792	498	578	0	80	80	1.0000000
NODE_9857_length_866_cov_49.224250	269	349	0	35	80	0.4375000
NODE_9857_length_866_cov_49.224250	269	349	7	11	80	0.1375000
NODE_9857_length_866_cov_49.224250	269	349	8	23	80	0.2875000
NODE_9857_length_866_cov_49.224250	269	349	10	11	80	0.1375000
NODE_9857_length_866_cov_49.224250	322	402	6	4	80	0.0500000
NODE_9857_length_866_cov_49.224250	322	402	8	16	80	0.2000000
NODE_9857_length_866_cov_49.224250	322	402	10	36	80	0.4500000
NODE_9857_length_866_cov_49.224250	322	402	12	11	80	0.1375000
NODE_9857_length_866_cov_49.224250	322	402	14	13	80	0.1625000
NODE_9858_length_866_cov_47.160365	428	508	0	80	80	1.0000000
NODE_9858_length_866_cov_47.160365	481	561	0	80	80	1.0000000
NODE_9858_length_866_cov_47.160365	557	637	0	80	80	1.0000000
NODE_9858_length_866_cov_47.160365	610	690	0	80	80	1.0000000
NODE_9859_length_866_cov_23.398957	281	361	0	2	80	0.0250000
NODE_9859_length_866_cov_23.398957	281	361	2	78	80	0.9750000
NODE_9859_length_866_cov_23.398957	334	414	2	80	80	1.0000000
NODE_9860_length_866_cov_22.186441	455	535	0	41	80	0.5125000
NODE_9860_length_866_cov_22.186441	455	535	2	23	80	0.2875000
NODE_9860_length_866_cov_22.186441	455	535	4	16	80	0.2000000
NODE_9860_length_866_cov_22.186441	508	588	2	45	80	0.5625000
NODE_9860_length_866_cov_22.186441	508	588	4	35	80	0.4375000
NODE_9861_length_866_cov_18.362451	451	531	0	48	80	0.6000000
NODE_9861_length_866_cov_18.362451	451	531	2	32	80	0.4000000
NODE_9861_length_866_cov_18.362451	504	584	0	24	80	0.3000000
NODE_9861_length_866_cov_18.362451	504	584	2	56	80	0.7000000
NODE_9862_length_866_cov_16.830508	372	452	0	80	80	1.0000000
NODE_9862_length_866_cov_16.830508	425	505	0	80	80	1.0000000
NODE_9882_length_865_cov_63.137076	288	368	0	80	80	1.0000000
NODE_9882_length_865_cov_63.137076	341	421	0	28	80	0.3500000
NODE_9882_length_865_cov_63.137076	341	421	2	52	80	0.6500000
NODE_9883_length_865_cov_19.882507	335	415	0	80	80	1.0000000
NODE_9883_length_865_cov_19.882507	388	468	0	80	80	1.0000000
NODE_9884_length_865_cov_17.784595	306	386	0	80	80	1.0000000
NODE_9884_length_865_cov_17.784595	359	439	0	80	80	1.0000000
NODE_9885_length_865_cov_16.150131	451	531	0	28	80	0.3500000
NODE_9885_length_865_cov_16.150131	451	531	6	15	80	0.1875000
NODE_9885_length_865_cov_16.150131	451	531	8	37	80	0.4625000
NODE_9885_length_865_cov_16.150131	504	584	0	4	80	0.0500000
NODE_9885_length_865_cov_16.150131	504	584	2	6	80	0.0750000
NODE_9885_length_865_cov_16.150131	504	584	7	1	80	0.0125000
NODE_9885_length_865_cov_16.150131	504	584	8	69	80	0.8625000
NODE_9886_length_865_cov_14.751958	473	553	0	80	80	1.0000000
NODE_9886_length_865_cov_14.751958	473	553	0	80	80	1.0000000
NODE_9886_length_865_cov_14.751958	526	589	0	63	63	1.0000000
NODE_9886_length_865_cov_14.751958	526	606	0	80	80	1.0000000
NODE_9887_length_865_cov_10.937337	422	502	0	80	80	1.0000000
NODE_9887_length_865_cov_10.937337	475	555	0	80	80	1.0000000
NODE_9889_length_865_cov_9.167102	389	469	0	80	80	1.0000000
NODE_9889_length_865_cov_9.167102	442	522	0	80	80	1.0000000
NODE_9912_length_864_cov_13.398693	491	571	2	42	80	0.5250000
NODE_9912_length_864_cov_13.398693	491	571	4	7	80	0.0875000
NODE_9912_length_864_cov_13.398693	491	571	8	16	80	0.2000000
NODE_9912_length_864_cov_13.398693	491	571	9	1	80	0.0125000
NODE_9912_length_864_cov_13.398693	491	571	10	14	80	0.1750000
NODE_9912_length_864_cov_13.398693	544	624	8	69	80	0.8625000
NODE_9912_length_864_cov_13.398693	544	624	10	11	80	0.1375000
NODE_9913_length_864_cov_8.466667	308	388	0	80	80	1.0000000
NODE_9913_length_864_cov_8.466667	361	441	0	80	80	1.0000000
NODE_9917_length_864_cov_3.947712	651	676	0	25	25	1.0000000
NODE_9917_length_864_cov_3.947712	725	805	0	80	80	1.0000000
NODE_9917_length_864_cov_3.947712	778	844	0	66	66	1.0000000
NODE_9931_length_863_cov_72.856021	241	321	0	80	80	1.0000000
NODE_9931_length_863_cov_72.856021	294	374	0	80	80	1.0000000
NODE_9931_length_863_cov_72.856021	370	450	0	80	80	1.0000000
NODE_9931_length_863_cov_72.856021	423	503	0	80	80	1.0000000
NODE_9932_length_863_cov_37.130890	363	443	0	28	80	0.3500000
NODE_9932_length_863_cov_37.130890	363	443	2	52	80	0.6500000
NODE_9932_length_863_cov_37.130890	416	496	0	45	80	0.5625000
NODE_9932_length_863_cov_37.130890	416	496	2	35	80	0.4375000
NODE_9932_length_863_cov_37.130890	492	572	0	80	80	1.0000000
NODE_9932_length_863_cov_37.130890	545	617	0	70	72	0.9722222
NODE_9932_length_863_cov_37.130890	545	617	2	1	72	0.0138889
NODE_9932_length_863_cov_37.130890	545	617	4	1	72	0.0138889
NODE_9933_length_863_cov_33.159686	287	367	0	55	80	0.6875000
NODE_9933_length_863_cov_33.159686	287	367	2	25	80	0.3125000
NODE_9933_length_863_cov_33.159686	340	420	0	2	80	0.0250000
NODE_9933_length_863_cov_33.159686	340	420	2	78	80	0.9750000
NODE_9934_length_863_cov_24.714660	370	450	0	7	80	0.0875000
NODE_9934_length_863_cov_24.714660	370	450	2	73	80	0.9125000
NODE_9934_length_863_cov_24.714660	423	503	0	60	80	0.7500000
NODE_9934_length_863_cov_24.714660	423	503	2	20	80	0.2500000
NODE_9935_length_863_cov_21.945026	341	421	2	80	80	1.0000000
NODE_9935_length_863_cov_21.945026	394	474	0	21	80	0.2625000
NODE_9935_length_863_cov_21.945026	394	474	2	59	80	0.7375000
NODE_9936_length_863_cov_19.794503	393	473	2	5	80	0.0625000
NODE_9936_length_863_cov_19.794503	393	473	6	58	80	0.7250000
NODE_9936_length_863_cov_19.794503	393	473	8	17	80	0.2125000
NODE_9936_length_863_cov_19.794503	446	526	2	38	80	0.4750000
NODE_9936_length_863_cov_19.794503	446	526	4	5	80	0.0625000
NODE_9936_length_863_cov_19.794503	446	526	6	21	80	0.2625000
NODE_9936_length_863_cov_19.794503	446	526	8	16	80	0.2000000
NODE_9937_length_863_cov_11.778796	303	383	0	11	80	0.1375000
NODE_9937_length_863_cov_11.778796	303	383	2	69	80	0.8625000
NODE_9937_length_863_cov_11.778796	356	436	0	51	80	0.6375000
NODE_9937_length_863_cov_11.778796	356	436	2	29	80	0.3625000
NODE_9938_length_863_cov_10.026178	283	363	0	4	80	0.0500000
NODE_9938_length_863_cov_10.026178	283	363	5	2	80	0.0250000
NODE_9938_length_863_cov_10.026178	283	363	6	15	80	0.1875000
NODE_9938_length_863_cov_10.026178	283	363	10	20	80	0.2500000
NODE_9938_length_863_cov_10.026178	283	363	12	4	80	0.0500000
NODE_9938_length_863_cov_10.026178	283	363	16	35	80	0.4375000
NODE_9938_length_863_cov_10.026178	336	416	10	14	80	0.1750000
NODE_9938_length_863_cov_10.026178	336	416	16	66	80	0.8250000
NODE_9957_length_862_cov_46.811271	272	352	0	80	80	1.0000000
NODE_9957_length_862_cov_46.811271	325	405	0	80	80	1.0000000
NODE_9957_length_862_cov_46.811271	401	481	0	80	80	1.0000000
NODE_9957_length_862_cov_46.811271	454	534	0	80	80	1.0000000
NODE_9958_length_862_cov_34.638270	259	339	0	80	80	1.0000000
NODE_9958_length_862_cov_34.638270	312	392	0	80	80	1.0000000
NODE_9958_length_862_cov_34.638270	388	468	0	80	80	1.0000000
NODE_9958_length_862_cov_34.638270	441	521	0	80	80	1.0000000
NODE_9959_length_862_cov_32.068152	468	548	0	14	80	0.1750000
NODE_9959_length_862_cov_32.068152	468	548	2	66	80	0.8250000
NODE_9959_length_862_cov_32.068152	521	601	0	67	80	0.8375000
NODE_9959_length_862_cov_32.068152	521	601	2	13	80	0.1625000
NODE_9960_length_862_cov_23.584535	526	606	0	52	80	0.6500000
NODE_9960_length_862_cov_23.584535	526	606	6	28	80	0.3500000
NODE_9960_length_862_cov_23.584535	579	659	6	80	80	1.0000000
NODE_9961_length_862_cov_19.980341	347	427	0	28	80	0.3500000
NODE_9961_length_862_cov_19.980341	347	427	2	28	80	0.3500000
NODE_9961_length_862_cov_19.980341	347	427	6	24	80	0.3000000
NODE_9961_length_862_cov_19.980341	400	480	2	3	80	0.0375000
NODE_9961_length_862_cov_19.980341	400	480	6	77	80	0.9625000
NODE_9962_length_862_cov_19.079948	379	459	0	80	80	1.0000000
NODE_9962_length_862_cov_19.079948	432	512	0	80	80	1.0000000
NODE_9963_length_862_cov_18.425950	94	174	0	80	80	1.0000000
NODE_9963_length_862_cov_18.425950	147	201	0	54	54	1.0000000
NODE_9963_length_862_cov_18.425950	392	472	0	80	80	1.0000000
NODE_9963_length_862_cov_18.425950	445	525	0	80	80	1.0000000
NODE_9964_length_862_cov_11.740498	348	428	0	80	80	1.0000000
NODE_9964_length_862_cov_11.740498	401	481	0	80	80	1.0000000
NODE_9965_length_862_cov_11.685452	292	372	0	80	80	1.0000000
NODE_9965_length_862_cov_11.685452	345	425	0	69	80	0.8625000
NODE_9965_length_862_cov_11.685452	345	425	2	11	80	0.1375000
NODE_9966_length_862_cov_8.259502	385	465	2	80	80	1.0000000
NODE_9966_length_862_cov_8.259502	438	518	2	80	80	1.0000000
NODE_9970_length_862_cov_2.895151	388	468	0	80	80	1.0000000
NODE_9970_length_862_cov_2.895151	441	521	0	80	80	1.0000000
NODE_9984_length_861_cov_52.679790	450	530	0	44	80	0.5500000
NODE_9984_length_861_cov_52.679790	450	530	4	36	80	0.4500000
NODE_9984_length_861_cov_52.679790	503	583	0	12	80	0.1500000
NODE_9984_length_861_cov_52.679790	503	583	4	68	80	0.8500000
NODE_9985_length_861_cov_34.868766	470	550	0	52	80	0.6500000
NODE_9985_length_861_cov_34.868766	470	550	2	28	80	0.3500000
NODE_9985_length_861_cov_34.868766	523	603	0	80	80	1.0000000
NODE_9986_length_861_cov_25.622047	145	225	0	38	80	0.4750000
NODE_9986_length_861_cov_25.622047	145	225	2	42	80	0.5250000
NODE_9986_length_861_cov_25.622047	198	278	0	18	80	0.2250000
NODE_9986_length_861_cov_25.622047	198	278	2	62	80	0.7750000
NODE_9987_length_861_cov_22.052493	401	481	0	80	80	1.0000000
NODE_9987_length_861_cov_22.052493	454	534	0	80	80	1.0000000
NODE_9988_length_861_cov_19.913386	400	480	0	62	80	0.7750000
NODE_9988_length_861_cov_19.913386	400	480	4	18	80	0.2250000
NODE_9988_length_861_cov_19.913386	453	533	0	9	80	0.1125000
NODE_9988_length_861_cov_19.913386	453	533	4	71	80	0.8875000
NODE_9989_length_861_cov_15.237533	492	572	0	50	80	0.6250000
NODE_9989_length_861_cov_15.237533	492	572	2	30	80	0.3750000
NODE_9989_length_861_cov_15.237533	545	625	0	7	80	0.0875000
NODE_9989_length_861_cov_15.237533	545	625	2	73	80	0.9125000
NODE_9990_length_861_cov_12.460630	451	531	0	80	80	1.0000000
NODE_9990_length_861_cov_12.460630	504	584	0	80	80	1.0000000
NODE_9991_length_861_cov_9.463255	446	526	2	80	80	1.0000000
NODE_9991_length_861_cov_9.463255	499	579	0	38	80	0.4750000
NODE_9991_length_861_cov_9.463255	499	579	2	42	80	0.5250000
NODE_9992_length_861_cov_9.435696	348	423	0	24	75	0.3200000
NODE_9992_length_861_cov_9.435696	348	423	4	51	75	0.6800000
NODE_9993_length_861_cov_7.009186	51	91	0	40	40	1.0000000
NODE_9993_length_861_cov_7.009186	185	265	0	80	80	1.0000000
NODE_9993_length_861_cov_7.009186	238	318	0	80	80	1.0000000
NODE_10019_length_860_cov_54.315375	245	325	0	80	80	1.0000000
NODE_10019_length_860_cov_54.315375	298	378	0	44	80	0.5500000
NODE_10019_length_860_cov_54.315375	298	378	4	36	80	0.4500000
NODE_10019_length_860_cov_54.315375	374	454	0	20	80	0.2500000
NODE_10019_length_860_cov_54.315375	374	454	4	60	80	0.7500000
NODE_10019_length_860_cov_54.315375	427	507	0	73	80	0.9125000
NODE_10019_length_860_cov_54.315375	427	507	4	7	80	0.0875000
NODE_10020_length_860_cov_29.618922	356	436	0	19	80	0.2375000
NODE_10020_length_860_cov_29.618922	356	436	2	61	80	0.7625000
NODE_10020_length_860_cov_29.618922	409	489	0	72	80	0.9000000
NODE_10020_length_860_cov_29.618922	409	489	2	8	80	0.1000000
NODE_10021_length_860_cov_15.152431	393	473	2	21	80	0.2625000
NODE_10021_length_860_cov_15.152431	393	473	4	59	80	0.7375000
NODE_10021_length_860_cov_15.152431	446	526	2	51	80	0.6375000
NODE_10021_length_860_cov_15.152431	446	526	3	1	80	0.0125000
NODE_10021_length_860_cov_15.152431	446	526	4	28	80	0.3500000
NODE_10022_length_860_cov_11.320631	343	423	0	80	80	1.0000000
NODE_10022_length_860_cov_11.320631	396	476	0	80	80	1.0000000
NODE_10049_length_859_cov_48.173684	432	512	4	16	80	0.2000000
NODE_10049_length_859_cov_48.173684	432	512	6	4	80	0.0500000
NODE_10049_length_859_cov_48.173684	432	512	7	51	80	0.6375000
NODE_10049_length_859_cov_48.173684	432	512	8	9	80	0.1125000
NODE_10049_length_859_cov_48.173684	485	565	0	50	80	0.6250000
NODE_10049_length_859_cov_48.173684	485	565	2	1	80	0.0125000
NODE_10049_length_859_cov_48.173684	485	565	4	18	80	0.2250000
NODE_10049_length_859_cov_48.173684	485	565	6	1	80	0.0125000
NODE_10049_length_859_cov_48.173684	485	565	7	10	80	0.1250000
NODE_10050_length_859_cov_24.957895	402	482	6	80	80	1.0000000
NODE_10050_length_859_cov_24.957895	455	535	0	22	80	0.2750000
NODE_10050_length_859_cov_24.957895	455	535	6	58	80	0.7250000
NODE_10051_length_859_cov_23.431579	251	331	0	80	80	1.0000000
NODE_10051_length_859_cov_23.431579	304	384	0	80	80	1.0000000
NODE_10052_length_859_cov_20.523684	341	421	0	42	80	0.5250000
NODE_10052_length_859_cov_20.523684	341	421	2	38	80	0.4750000
NODE_10052_length_859_cov_20.523684	394	474	2	80	80	1.0000000
NODE_10053_length_859_cov_17.996053	316	396	0	80	80	1.0000000
NODE_10053_length_859_cov_17.996053	369	449	0	80	80	1.0000000
NODE_10054_length_859_cov_16.757895	404	484	0	80	80	1.0000000
NODE_10054_length_859_cov_16.757895	457	537	0	80	80	1.0000000
NODE_10055_length_859_cov_15.852632	346	426	0	34	80	0.4250000
NODE_10055_length_859_cov_15.852632	346	426	2	46	80	0.5750000
NODE_10055_length_859_cov_15.852632	399	479	0	27	80	0.3375000
NODE_10055_length_859_cov_15.852632	399	479	2	53	80	0.6625000
NODE_10056_length_859_cov_11.584211	407	487	0	6	80	0.0750000
NODE_10056_length_859_cov_11.584211	407	487	5	1	80	0.0125000
NODE_10056_length_859_cov_11.584211	407	487	6	73	80	0.9125000
NODE_10056_length_859_cov_11.584211	460	540	0	59	80	0.7375000
NODE_10056_length_859_cov_11.584211	460	540	5	1	80	0.0125000
NODE_10056_length_859_cov_11.584211	460	540	6	20	80	0.2500000
NODE_10057_length_859_cov_10.296053	368	448	0	80	80	1.0000000
NODE_10057_length_859_cov_10.296053	421	501	0	80	80	1.0000000
NODE_10066_length_859_cov_2.359211	498	578	0	23	80	0.2875000
NODE_10066_length_859_cov_2.359211	498	578	2	57	80	0.7125000
NODE_10066_length_859_cov_2.359211	551	631	0	5	80	0.0625000
NODE_10066_length_859_cov_2.359211	551	631	2	75	80	0.9375000
NODE_10079_length_858_cov_54.677207	277	357	0	80	80	1.0000000
NODE_10079_length_858_cov_54.677207	330	410	0	80	80	1.0000000
NODE_10080_length_858_cov_40.584980	500	580	0	80	80	1.0000000
NODE_10080_length_858_cov_40.584980	553	633	0	80	80	1.0000000
NODE_10081_length_858_cov_30.177866	363	443	2	4	80	0.0500000
NODE_10081_length_858_cov_30.177866	363	443	4	6	80	0.0750000
NODE_10081_length_858_cov_30.177866	363	443	6	22	80	0.2750000
NODE_10081_length_858_cov_30.177866	363	443	8	48	80	0.6000000
NODE_10081_length_858_cov_30.177866	416	496	0	38	80	0.4750000
NODE_10081_length_858_cov_30.177866	416	496	2	19	80	0.2375000
NODE_10081_length_858_cov_30.177866	416	496	6	22	80	0.2750000
NODE_10081_length_858_cov_30.177866	416	496	8	1	80	0.0125000
NODE_10081_length_858_cov_30.177866	492	572	0	80	80	1.0000000
NODE_10081_length_858_cov_30.177866	545	625	0	80	80	1.0000000
NODE_10082_length_858_cov_18.534914	371	451	0	80	80	1.0000000
NODE_10082_length_858_cov_18.534914	424	504	0	80	80	1.0000000
NODE_10083_length_858_cov_15.378129	232	312	0	9	80	0.1125000
NODE_10083_length_858_cov_15.378129	232	312	2	71	80	0.8875000
NODE_10083_length_858_cov_15.378129	285	365	0	23	80	0.2875000
NODE_10083_length_858_cov_15.378129	285	365	2	57	80	0.7125000
NODE_10084_length_858_cov_12.310935	335	415	0	21	80	0.2625000
NODE_10084_length_858_cov_12.310935	335	415	2	59	80	0.7375000
NODE_10084_length_858_cov_12.310935	388	468	0	38	80	0.4750000
NODE_10084_length_858_cov_12.310935	388	468	2	42	80	0.5250000
NODE_10085_length_858_cov_7.835310	396	479	0	83	83	1.0000000
NODE_10085_length_858_cov_7.835310	452	532	0	80	80	1.0000000
NODE_10088_length_858_cov_4.953887	474	554	0	80	80	1.0000000
NODE_10088_length_858_cov_4.953887	527	607	0	80	80	1.0000000
NODE_10091_length_858_cov_3.475626	428	502	0	55	74	0.7432432
NODE_10091_length_858_cov_3.475626	428	502	2	19	74	0.2567568
NODE_10091_length_858_cov_3.475626	498	578	2	23	80	0.2875000
NODE_10091_length_858_cov_3.475626	498	578	6	49	80	0.6125000
NODE_10091_length_858_cov_3.475626	498	578	8	8	80	0.1000000
NODE_10091_length_858_cov_3.475626	551	631	0	7	80	0.0875000
NODE_10091_length_858_cov_3.475626	551	631	4	14	80	0.1750000
NODE_10091_length_858_cov_3.475626	551	631	6	59	80	0.7375000
NODE_10108_length_857_cov_33.449868	384	455	0	71	71	1.0000000
NODE_10108_length_857_cov_33.449868	437	518	0	81	81	1.0000000
NODE_10109_length_857_cov_32.527704	391	471	0	76	80	0.9500000
NODE_10109_length_857_cov_32.527704	391	471	2	4	80	0.0500000
NODE_10109_length_857_cov_32.527704	444	524	0	80	80	1.0000000
NODE_10110_length_857_cov_27.853562	310	390	0	80	80	1.0000000
NODE_10110_length_857_cov_27.853562	363	443	0	80	80	1.0000000
NODE_10111_length_857_cov_24.654354	282	362	0	80	80	1.0000000
NODE_10111_length_857_cov_24.654354	335	415	0	80	80	1.0000000
NODE_10112_length_857_cov_22.604222	374	456	0	82	82	1.0000000
NODE_10112_length_857_cov_22.604222	427	509	0	82	82	1.0000000
NODE_10113_length_857_cov_17.399736	320	400	3	14	80	0.1750000
NODE_10113_length_857_cov_17.399736	320	400	4	25	80	0.3125000
NODE_10113_length_857_cov_17.399736	320	400	5	32	80	0.4000000
NODE_10113_length_857_cov_17.399736	320	400	6	9	80	0.1125000
NODE_10113_length_857_cov_17.399736	373	453	0	17	80	0.2125000
NODE_10113_length_857_cov_17.399736	373	453	2	1	80	0.0125000
NODE_10113_length_857_cov_17.399736	373	453	3	49	80	0.6125000
NODE_10113_length_857_cov_17.399736	373	453	4	13	80	0.1625000
NODE_10114_length_857_cov_17.069921	388	468	0	80	80	1.0000000
NODE_10114_length_857_cov_17.069921	441	521	0	80	80	1.0000000
NODE_10115_length_857_cov_11.816623	433	513	0	60	80	0.7500000
NODE_10115_length_857_cov_11.816623	433	513	4	20	80	0.2500000
NODE_10115_length_857_cov_11.816623	486	566	0	7	80	0.0875000
NODE_10115_length_857_cov_11.816623	486	566	4	73	80	0.9125000
NODE_10116_length_857_cov_6.733509	513	593	0	80	80	1.0000000
NODE_10117_length_857_cov_6.251979	298	378	0	80	80	1.0000000
NODE_10117_length_857_cov_6.251979	351	431	0	80	80	1.0000000
NODE_10118_length_857_cov_5.827177	323	403	0	52	80	0.6500000
NODE_10118_length_857_cov_5.827177	323	403	4	28	80	0.3500000
NODE_10118_length_857_cov_5.827177	376	456	4	80	80	1.0000000
NODE_10120_length_857_cov_4.530343	362	442	0	80	80	1.0000000
NODE_10120_length_857_cov_4.530343	415	495	0	80	80	1.0000000
NODE_10128_length_857_cov_1.464380	179	249	8	4	70	0.0571429
NODE_10128_length_857_cov_1.464380	179	249	10	8	70	0.1142857
NODE_10128_length_857_cov_1.464380	179	249	12	58	70	0.8285714
NODE_10128_length_857_cov_1.464380	222	288	4	2	66	0.0303030
NODE_10128_length_857_cov_1.464380	222	288	10	29	66	0.4393939
NODE_10128_length_857_cov_1.464380	222	288	12	35	66	0.5303030
NODE_10138_length_856_cov_39.147952	157	237	0	80	80	1.0000000
NODE_10138_length_856_cov_39.147952	210	290	0	80	80	1.0000000
NODE_10138_length_856_cov_39.147952	286	366	0	7	80	0.0875000
NODE_10138_length_856_cov_39.147952	286	366	2	27	80	0.3375000
NODE_10138_length_856_cov_39.147952	286	366	4	46	80	0.5750000
NODE_10138_length_856_cov_39.147952	339	419	0	22	80	0.2750000
NODE_10138_length_856_cov_39.147952	339	419	2	25	80	0.3125000
NODE_10138_length_856_cov_39.147952	339	419	4	33	80	0.4125000
NODE_10139_length_856_cov_21.937913	353	433	0	80	80	1.0000000
NODE_10139_length_856_cov_21.937913	406	486	0	80	80	1.0000000
NODE_10140_length_856_cov_20.227213	375	459	0	84	84	1.0000000
NODE_10140_length_856_cov_20.227213	432	512	0	80	80	1.0000000
NODE_10141_length_856_cov_18.445178	340	420	0	34	80	0.4250000
NODE_10141_length_856_cov_18.445178	340	420	1	46	80	0.5750000
NODE_10141_length_856_cov_18.445178	393	473	1	80	80	1.0000000
NODE_10142_length_856_cov_16.564069	462	543	0	81	81	1.0000000
NODE_10142_length_856_cov_16.564069	516	596	0	80	80	1.0000000
NODE_10142_length_856_cov_16.564069	516	593	0	77	77	1.0000000
NODE_10143_length_856_cov_15.803170	403	483	0	30	80	0.3750000
NODE_10143_length_856_cov_15.803170	403	483	2	50	80	0.6250000
NODE_10143_length_856_cov_15.803170	456	536	0	80	80	1.0000000
NODE_10144_length_856_cov_12.904888	345	425	0	16	80	0.2000000
NODE_10144_length_856_cov_12.904888	345	425	2	64	80	0.8000000
NODE_10144_length_856_cov_12.904888	398	478	0	68	80	0.8500000
NODE_10144_length_856_cov_12.904888	398	478	2	12	80	0.1500000
NODE_10145_length_856_cov_9.881110	338	418	0	62	80	0.7750000
NODE_10145_length_856_cov_9.881110	338	418	2	5	80	0.0625000
NODE_10145_length_856_cov_9.881110	338	418	4	3	80	0.0375000
NODE_10145_length_856_cov_9.881110	338	418	6	10	80	0.1250000
NODE_10145_length_856_cov_9.881110	391	471	0	9	80	0.1125000
NODE_10145_length_856_cov_9.881110	391	471	2	5	80	0.0625000
NODE_10145_length_856_cov_9.881110	391	471	4	3	80	0.0375000
NODE_10145_length_856_cov_9.881110	391	471	6	63	80	0.7875000
NODE_10146_length_856_cov_5.875826	405	485	0	52	80	0.6500000
NODE_10146_length_856_cov_5.875826	405	485	2	28	80	0.3500000
NODE_10146_length_856_cov_5.875826	458	538	0	80	80	1.0000000
NODE_10149_length_856_cov_4.821664	466	546	0	80	80	1.0000000
NODE_10149_length_856_cov_4.821664	519	599	0	80	80	1.0000000
NODE_10151_length_856_cov_4.195509	248	328	0	80	80	1.0000000
NODE_10151_length_856_cov_4.195509	301	381	0	80	80	1.0000000
NODE_10152_length_856_cov_3.899604	262	339	0	77	77	1.0000000
NODE_10152_length_856_cov_3.899604	312	392	0	80	80	1.0000000
NODE_10176_length_855_cov_28.312169	541	621	0	80	80	1.0000000
NODE_10176_length_855_cov_28.312169	594	674	0	80	80	1.0000000
NODE_10177_length_855_cov_19.392857	692	772	2	67	80	0.8375000
NODE_10177_length_855_cov_19.392857	692	772	4	13	80	0.1625000
NODE_10177_length_855_cov_19.392857	745	825	0	27	80	0.3375000
NODE_10177_length_855_cov_19.392857	745	825	2	53	80	0.6625000
NODE_10178_length_855_cov_13.402116	343	423	0	80	80	1.0000000
NODE_10178_length_855_cov_13.402116	396	476	0	80	80	1.0000000
NODE_10179_length_855_cov_13.116402	295	375	0	5	80	0.0625000
NODE_10179_length_855_cov_13.116402	295	375	2	75	80	0.9375000
NODE_10179_length_855_cov_13.116402	348	428	1	16	80	0.2000000
NODE_10179_length_855_cov_13.116402	348	428	2	45	80	0.5625000
NODE_10179_length_855_cov_13.116402	348	428	3	19	80	0.2375000
NODE_10180_length_855_cov_11.179894	360	436	0	76	76	1.0000000
NODE_10180_length_855_cov_11.179894	409	489	0	80	80	1.0000000
NODE_10183_length_855_cov_8.593915	339	419	0	80	80	1.0000000
NODE_10183_length_855_cov_8.593915	392	472	0	80	80	1.0000000
NODE_10206_length_854_cov_64.200000	586	666	0	1	80	0.0125000
NODE_10206_length_854_cov_64.200000	586	666	2	79	80	0.9875000
NODE_10206_length_854_cov_64.200000	639	719	0	54	80	0.6750000
NODE_10206_length_854_cov_64.200000	639	719	2	26	80	0.3250000
NODE_10207_length_854_cov_46.037086	348	428	0	42	80	0.5250000
NODE_10207_length_854_cov_46.037086	348	428	1	7	80	0.0875000
NODE_10207_length_854_cov_46.037086	348	428	2	31	80	0.3875000
NODE_10207_length_854_cov_46.037086	401	481	2	80	80	1.0000000
NODE_10207_length_854_cov_46.037086	458	481	2	23	23	1.0000000
NODE_10208_length_854_cov_45.633113	393	473	0	80	80	1.0000000
NODE_10208_length_854_cov_45.633113	446	526	0	80	80	1.0000000
NODE_10209_length_854_cov_40.407947	489	569	2	74	80	0.9250000
NODE_10209_length_854_cov_40.407947	489	569	4	1	80	0.0125000
NODE_10209_length_854_cov_40.407947	489	569	6	4	80	0.0500000
NODE_10209_length_854_cov_40.407947	489	569	8	1	80	0.0125000
NODE_10209_length_854_cov_40.407947	542	622	0	4	80	0.0500000
NODE_10209_length_854_cov_40.407947	542	622	2	75	80	0.9375000
NODE_10209_length_854_cov_40.407947	542	622	4	1	80	0.0125000
NODE_10210_length_854_cov_29.773510	450	530	0	80	80	1.0000000
NODE_10210_length_854_cov_29.773510	503	583	0	80	80	1.0000000
NODE_10211_length_854_cov_22.968212	318	398	0	80	80	1.0000000
NODE_10211_length_854_cov_22.968212	371	451	0	80	80	1.0000000
NODE_10212_length_854_cov_18.038411	387	467	0	54	80	0.6750000
NODE_10212_length_854_cov_18.038411	387	467	4	3	80	0.0375000
NODE_10212_length_854_cov_18.038411	387	467	6	23	80	0.2875000
NODE_10212_length_854_cov_18.038411	440	520	0	1	80	0.0125000
NODE_10212_length_854_cov_18.038411	440	520	4	15	80	0.1875000
NODE_10212_length_854_cov_18.038411	440	520	6	28	80	0.3500000
NODE_10212_length_854_cov_18.038411	440	520	8	36	80	0.4500000
NODE_10213_length_854_cov_13.774834	330	410	0	39	80	0.4875000
NODE_10213_length_854_cov_13.774834	330	410	2	5	80	0.0625000
NODE_10213_length_854_cov_13.774834	330	410	4	36	80	0.4500000
NODE_10213_length_854_cov_13.774834	383	463	0	80	80	1.0000000
NODE_10214_length_854_cov_11.998675	366	446	0	80	80	1.0000000
NODE_10214_length_854_cov_11.998675	419	499	0	80	80	1.0000000
NODE_10215_length_854_cov_7.600000	298	378	0	80	80	1.0000000
NODE_10215_length_854_cov_7.600000	351	431	0	35	80	0.4375000
NODE_10215_length_854_cov_7.600000	351	431	2	45	80	0.5625000
NODE_10218_length_854_cov_4.939073	603	633	0	6	30	0.2000000
NODE_10218_length_854_cov_4.939073	603	633	2	12	30	0.4000000
NODE_10218_length_854_cov_4.939073	603	633	4	12	30	0.4000000
NODE_10226_length_854_cov_2.354967	613	633	0	20	20	1.0000000
NODE_10239_length_853_cov_61.988064	380	460	0	80	80	1.0000000
NODE_10239_length_853_cov_61.988064	433	513	0	80	80	1.0000000
NODE_10240_length_853_cov_33.683024	384	464	0	80	80	1.0000000
NODE_10240_length_853_cov_33.683024	437	517	0	80	80	1.0000000
NODE_10241_length_853_cov_31.965517	224	305	2	2	81	0.0246914
NODE_10241_length_853_cov_31.965517	224	305	4	21	81	0.2592593
NODE_10241_length_853_cov_31.965517	224	305	6	55	81	0.6790124
NODE_10241_length_853_cov_31.965517	224	305	8	3	81	0.0370370
NODE_10241_length_853_cov_31.965517	278	358	6	77	80	0.9625000
NODE_10241_length_853_cov_31.965517	278	358	8	3	80	0.0375000
NODE_10241_length_853_cov_31.965517	354	434	0	37	80	0.4625000
NODE_10241_length_853_cov_31.965517	354	434	2	8	80	0.1000000
NODE_10241_length_853_cov_31.965517	354	434	4	13	80	0.1625000
NODE_10241_length_853_cov_31.965517	354	434	6	22	80	0.2750000
NODE_10241_length_853_cov_31.965517	407	466	0	59	59	1.0000000
NODE_10242_length_853_cov_16.551724	247	327	0	80	80	1.0000000
NODE_10242_length_853_cov_16.551724	300	380	0	80	80	1.0000000
NODE_10242_length_853_cov_16.551724	376	456	0	80	80	1.0000000
NODE_10242_length_853_cov_16.551724	429	509	0	49	80	0.6125000
NODE_10242_length_853_cov_16.551724	429	509	2	31	80	0.3875000
NODE_10243_length_853_cov_15.395225	395	475	4	6	80	0.0750000
NODE_10243_length_853_cov_15.395225	395	475	6	20	80	0.2500000
NODE_10243_length_853_cov_15.395225	395	475	8	54	80	0.6750000
NODE_10243_length_853_cov_15.395225	448	528	0	29	80	0.3625000
NODE_10243_length_853_cov_15.395225	448	528	4	30	80	0.3750000
NODE_10243_length_853_cov_15.395225	448	528	6	20	80	0.2500000
NODE_10243_length_853_cov_15.395225	448	528	8	1	80	0.0125000
NODE_10244_length_853_cov_15.086207	355	434	2	15	79	0.1898734
NODE_10244_length_853_cov_15.086207	355	434	4	19	79	0.2405063
NODE_10244_length_853_cov_15.086207	355	434	6	45	79	0.5696203
NODE_10244_length_853_cov_15.086207	408	488	0	22	80	0.2750000
NODE_10244_length_853_cov_15.086207	408	488	2	2	80	0.0250000
NODE_10244_length_853_cov_15.086207	408	488	4	45	80	0.5625000
NODE_10244_length_853_cov_15.086207	408	488	6	11	80	0.1375000
NODE_10245_length_853_cov_14.929708	160	240	0	80	80	1.0000000
NODE_10245_length_853_cov_14.929708	213	293	0	80	80	1.0000000
NODE_10246_length_853_cov_11.299735	395	475	0	80	80	1.0000000
NODE_10246_length_853_cov_11.299735	448	528	0	80	80	1.0000000
NODE_10247_length_853_cov_9.571618	479	559	0	80	80	1.0000000
NODE_10247_length_853_cov_9.571618	532	612	0	80	80	1.0000000
NODE_10248_length_853_cov_7.828912	265	345	2	27	80	0.3375000
NODE_10248_length_853_cov_7.828912	265	345	4	16	80	0.2000000
NODE_10248_length_853_cov_7.828912	265	345	6	37	80	0.4625000
NODE_10248_length_853_cov_7.828912	318	398	4	15	80	0.1875000
NODE_10248_length_853_cov_7.828912	318	398	6	47	80	0.5875000
NODE_10248_length_853_cov_7.828912	318	398	8	6	80	0.0750000
NODE_10248_length_853_cov_7.828912	318	398	10	12	80	0.1500000
NODE_10249_length_853_cov_7.623342	255	335	0	80	80	1.0000000
NODE_10249_length_853_cov_7.623342	308	388	0	80	80	1.0000000
NODE_10253_length_853_cov_3.173740	212	292	0	80	80	1.0000000
NODE_10253_length_853_cov_3.173740	265	343	0	78	78	1.0000000
NODE_10258_length_853_cov_1.823607	710	773	0	63	63	1.0000000
NODE_10258_length_853_cov_1.823607	711	773	0	62	62	1.0000000
NODE_10258_length_853_cov_1.823607	711	773	0	62	62	1.0000000
NODE_10258_length_853_cov_1.823607	746	826	0	80	80	1.0000000
NODE_10267_length_852_cov_30.022576	279	359	0	80	80	1.0000000
NODE_10267_length_852_cov_30.022576	332	412	0	80	80	1.0000000
NODE_10268_length_852_cov_19.373174	353	433	0	44	80	0.5500000
NODE_10268_length_852_cov_19.373174	353	433	2	36	80	0.4500000
NODE_10268_length_852_cov_19.373174	406	486	0	14	80	0.1750000
NODE_10268_length_852_cov_19.373174	406	486	2	66	80	0.8250000
NODE_10269_length_852_cov_18.853918	297	377	0	13	80	0.1625000
NODE_10269_length_852_cov_18.853918	297	377	2	4	80	0.0500000
NODE_10269_length_852_cov_18.853918	297	377	8	1	80	0.0125000
NODE_10269_length_852_cov_18.853918	297	377	9	7	80	0.0875000
NODE_10269_length_852_cov_18.853918	297	377	13	1	80	0.0125000
NODE_10269_length_852_cov_18.853918	297	377	15	54	80	0.6750000
NODE_10269_length_852_cov_18.853918	350	430	0	66	80	0.8250000
NODE_10269_length_852_cov_18.853918	350	430	2	4	80	0.0500000
NODE_10269_length_852_cov_18.853918	350	430	8	1	80	0.0125000
NODE_10269_length_852_cov_18.853918	350	430	9	7	80	0.0875000
NODE_10269_length_852_cov_18.853918	350	430	13	1	80	0.0125000
NODE_10269_length_852_cov_18.853918	350	430	15	1	80	0.0125000
NODE_10269_length_852_cov_18.853918	426	506	0	80	80	1.0000000
NODE_10269_length_852_cov_18.853918	489	559	0	70	70	1.0000000
NODE_10270_length_852_cov_17.391766	472	552	0	80	80	1.0000000
NODE_10270_length_852_cov_17.391766	525	605	0	80	80	1.0000000
NODE_10271_length_852_cov_8.818061	513	593	0	80	80	1.0000000
NODE_10271_length_852_cov_8.818061	566	646	0	80	80	1.0000000
NODE_10274_length_852_cov_4.403718	493	573	0	80	80	1.0000000
NODE_10274_length_852_cov_4.403718	546	626	0	80	80	1.0000000
NODE_10285_length_851_cov_33.953457	329	409	0	36	80	0.4500000
NODE_10285_length_851_cov_33.953457	329	409	5	44	80	0.5500000
NODE_10285_length_851_cov_33.953457	382	462	0	80	80	1.0000000
NODE_10286_length_851_cov_30.488032	395	475	0	80	80	1.0000000
NODE_10286_length_851_cov_30.488032	448	528	0	65	80	0.8125000
NODE_10286_length_851_cov_30.488032	448	528	4	15	80	0.1875000
NODE_10287_length_851_cov_27.481383	353	433	2	60	80	0.7500000
NODE_10287_length_851_cov_27.481383	353	433	4	17	80	0.2125000
NODE_10287_length_851_cov_27.481383	353	433	6	3	80	0.0375000
NODE_10287_length_851_cov_27.481383	406	486	2	7	80	0.0875000
NODE_10287_length_851_cov_27.481383	406	486	4	60	80	0.7500000
NODE_10287_length_851_cov_27.481383	406	486	6	13	80	0.1625000
NODE_10288_length_851_cov_23.656915	345	425	0	80	80	1.0000000
NODE_10288_length_851_cov_23.656915	398	478	0	80	80	1.0000000
NODE_10289_length_851_cov_19.769947	298	378	0	16	80	0.2000000
NODE_10289_length_851_cov_19.769947	298	378	2	33	80	0.4125000
NODE_10289_length_851_cov_19.769947	298	378	4	31	80	0.3875000
NODE_10289_length_851_cov_19.769947	351	431	2	33	80	0.4125000
NODE_10289_length_851_cov_19.769947	351	431	4	47	80	0.5875000
NODE_10290_length_851_cov_17.386968	459	539	0	80	80	1.0000000
NODE_10290_length_851_cov_17.386968	512	592	0	80	80	1.0000000
NODE_10291_length_851_cov_13.519947	323	403	0	38	80	0.4750000
NODE_10291_length_851_cov_13.519947	323	403	6	42	80	0.5250000
NODE_10291_length_851_cov_13.519947	376	456	0	4	80	0.0500000
NODE_10291_length_851_cov_13.519947	376	456	2	5	80	0.0625000
NODE_10291_length_851_cov_13.519947	376	456	6	71	80	0.8875000
NODE_10292_length_851_cov_11.771277	403	483	0	80	80	1.0000000
NODE_10292_length_851_cov_11.771277	456	536	0	80	80	1.0000000
NODE_10293_length_851_cov_11.698138	227	307	0	4	80	0.0500000
NODE_10293_length_851_cov_11.698138	227	307	2	3	80	0.0375000
NODE_10293_length_851_cov_11.698138	227	307	3	73	80	0.9125000
NODE_10293_length_851_cov_11.698138	280	360	0	6	80	0.0750000
NODE_10293_length_851_cov_11.698138	280	360	1	34	80	0.4250000
NODE_10293_length_851_cov_11.698138	280	360	3	40	80	0.5000000
NODE_10293_length_851_cov_11.698138	356	436	1	61	80	0.7625000
NODE_10293_length_851_cov_11.698138	356	436	3	19	80	0.2375000
NODE_10293_length_851_cov_11.698138	409	489	1	8	80	0.1000000
NODE_10293_length_851_cov_11.698138	409	489	2	13	80	0.1625000
NODE_10293_length_851_cov_11.698138	409	489	3	59	80	0.7375000
NODE_10294_length_851_cov_11.672872	372	452	2	23	80	0.2875000
NODE_10294_length_851_cov_11.672872	372	452	4	57	80	0.7125000
NODE_10294_length_851_cov_11.672872	425	505	0	28	80	0.3500000
NODE_10294_length_851_cov_11.672872	425	505	2	2	80	0.0250000
NODE_10294_length_851_cov_11.672872	425	505	3	5	80	0.0625000
NODE_10294_length_851_cov_11.672872	425	505	4	45	80	0.5625000
NODE_10295_length_851_cov_10.938830	418	499	0	81	81	1.0000000
NODE_10296_length_851_cov_10.074468	454	534	0	80	80	1.0000000
NODE_10296_length_851_cov_10.074468	507	587	0	80	80	1.0000000
NODE_10297_length_851_cov_7.599734	330	410	0	80	80	1.0000000
NODE_10297_length_851_cov_7.599734	383	463	0	80	80	1.0000000
NODE_10298_length_851_cov_5.639628	379	459	0	50	80	0.6250000
NODE_10298_length_851_cov_5.639628	379	459	2	30	80	0.3750000
NODE_10298_length_851_cov_5.639628	432	512	0	8	80	0.1000000
NODE_10298_length_851_cov_5.639628	432	512	2	72	80	0.9000000
NODE_10300_length_851_cov_3.880319	729	765	2	36	36	1.0000000
NODE_10300_length_851_cov_3.880319	743	824	2	81	81	1.0000000
NODE_10301_length_851_cov_3.823138	380	460	0	80	80	1.0000000
NODE_10301_length_851_cov_3.823138	433	513	0	80	80	1.0000000
NODE_10318_length_851_cov_1.130319	33	103	0	70	70	1.0000000
NODE_10326_length_850_cov_36.527297	360	440	0	80	80	1.0000000
NODE_10326_length_850_cov_36.527297	413	493	0	80	80	1.0000000
NODE_10327_length_850_cov_31.006658	330	410	0	29	80	0.3625000
NODE_10327_length_850_cov_31.006658	330	410	2	51	80	0.6375000
NODE_10327_length_850_cov_31.006658	383	463	0	9	80	0.1125000
NODE_10327_length_850_cov_31.006658	383	463	2	71	80	0.8875000
NODE_10328_length_850_cov_30.460719	251	331	8	22	80	0.2750000
NODE_10328_length_850_cov_30.460719	251	331	10	15	80	0.1875000
NODE_10328_length_850_cov_30.460719	251	331	12	43	80	0.5375000
NODE_10328_length_850_cov_30.460719	304	384	0	5	80	0.0625000
NODE_10328_length_850_cov_30.460719	304	384	2	10	80	0.1250000
NODE_10328_length_850_cov_30.460719	304	384	6	2	80	0.0250000
NODE_10328_length_850_cov_30.460719	304	384	10	51	80	0.6375000
NODE_10328_length_850_cov_30.460719	304	384	12	12	80	0.1500000
NODE_10329_length_850_cov_25.263648	355	435	8	22	80	0.2750000
NODE_10329_length_850_cov_25.263648	355	435	10	30	80	0.3750000
NODE_10329_length_850_cov_25.263648	355	435	12	17	80	0.2125000
NODE_10329_length_850_cov_25.263648	355	435	16	11	80	0.1375000
NODE_10329_length_850_cov_25.263648	408	488	12	16	80	0.2000000
NODE_10329_length_850_cov_25.263648	408	488	16	64	80	0.8000000
NODE_10330_length_850_cov_21.368842	290	370	0	24	80	0.3000000
NODE_10330_length_850_cov_21.368842	290	370	2	56	80	0.7000000
NODE_10330_length_850_cov_21.368842	343	423	0	27	80	0.3375000
NODE_10330_length_850_cov_21.368842	343	423	2	53	80	0.6625000
NODE_10331_length_850_cov_20.500666	318	398	0	54	80	0.6750000
NODE_10331_length_850_cov_20.500666	318	398	2	26	80	0.3250000
NODE_10331_length_850_cov_20.500666	371	451	0	14	80	0.1750000
NODE_10331_length_850_cov_20.500666	371	451	2	66	80	0.8250000
NODE_10332_length_850_cov_17.268975	398	478	0	80	80	1.0000000
NODE_10332_length_850_cov_17.268975	451	531	0	80	80	1.0000000
NODE_10333_length_850_cov_14.728362	379	459	0	15	80	0.1875000
NODE_10333_length_850_cov_14.728362	379	459	2	65	80	0.8125000
NODE_10333_length_850_cov_14.728362	432	512	0	58	80	0.7250000
NODE_10333_length_850_cov_14.728362	432	512	2	22	80	0.2750000
NODE_10334_length_850_cov_14.230360	313	393	0	56	80	0.7000000
NODE_10334_length_850_cov_14.230360	313	393	3	24	80	0.3000000
NODE_10334_length_850_cov_14.230360	366	446	0	10	80	0.1250000
NODE_10334_length_850_cov_14.230360	366	446	3	70	80	0.8750000
NODE_10335_length_850_cov_12.387483	337	417	0	80	80	1.0000000
NODE_10335_length_850_cov_12.387483	390	470	0	80	80	1.0000000
NODE_10335_length_850_cov_12.387483	466	545	0	79	79	1.0000000
NODE_10335_length_850_cov_12.387483	518	598	0	80	80	1.0000000
NODE_10336_length_850_cov_11.402130	329	409	4	22	80	0.2750000
NODE_10336_length_850_cov_11.402130	329	409	8	58	80	0.7250000
NODE_10336_length_850_cov_11.402130	382	462	0	12	80	0.1500000
NODE_10336_length_850_cov_11.402130	382	462	3	1	80	0.0125000
NODE_10336_length_850_cov_11.402130	382	462	4	25	80	0.3125000
NODE_10336_length_850_cov_11.402130	382	462	8	42	80	0.5250000
NODE_10337_length_850_cov_10.326232	330	410	0	80	80	1.0000000
NODE_10337_length_850_cov_10.326232	383	463	0	80	80	1.0000000
NODE_10338_length_850_cov_9.675100	464	544	0	76	80	0.9500000
NODE_10338_length_850_cov_9.675100	464	544	2	4	80	0.0500000
NODE_10338_length_850_cov_9.675100	517	597	0	80	80	1.0000000
NODE_10367_length_849_cov_43.137333	336	416	0	80	80	1.0000000
NODE_10367_length_849_cov_43.137333	389	469	0	80	80	1.0000000
NODE_10368_length_849_cov_36.562667	326	406	0	16	80	0.2000000
NODE_10368_length_849_cov_36.562667	326	406	2	64	80	0.8000000
NODE_10368_length_849_cov_36.562667	379	459	0	13	80	0.1625000
NODE_10368_length_849_cov_36.562667	379	459	2	67	80	0.8375000
NODE_10369_length_849_cov_35.449333	408	488	4	18	80	0.2250000
NODE_10369_length_849_cov_35.449333	408	488	6	62	80	0.7750000
NODE_10369_length_849_cov_35.449333	461	541	0	49	80	0.6125000
NODE_10369_length_849_cov_35.449333	461	541	4	22	80	0.2750000
NODE_10369_length_849_cov_35.449333	461	541	6	9	80	0.1125000
NODE_10370_length_849_cov_29.989333	332	412	0	15	80	0.1875000
NODE_10370_length_849_cov_29.989333	332	412	2	42	80	0.5250000
NODE_10370_length_849_cov_29.989333	332	412	4	23	80	0.2875000
NODE_10370_length_849_cov_29.989333	385	465	0	1	80	0.0125000
NODE_10370_length_849_cov_29.989333	385	465	2	11	80	0.1375000
NODE_10370_length_849_cov_29.989333	385	465	4	68	80	0.8500000
NODE_10371_length_849_cov_17.974667	343	423	0	80	80	1.0000000
NODE_10371_length_849_cov_17.974667	396	476	0	80	80	1.0000000
NODE_10372_length_849_cov_17.018667	360	440	0	13	80	0.1625000
NODE_10372_length_849_cov_17.018667	360	440	2	24	80	0.3000000
NODE_10372_length_849_cov_17.018667	360	440	4	31	80	0.3875000
NODE_10372_length_849_cov_17.018667	360	440	6	12	80	0.1500000
NODE_10372_length_849_cov_17.018667	416	493	4	42	77	0.5454546
NODE_10372_length_849_cov_17.018667	416	493	6	35	77	0.4545455
NODE_10373_length_849_cov_15.581333	287	367	7	19	80	0.2375000
NODE_10373_length_849_cov_15.581333	287	367	8	2	80	0.0250000
NODE_10373_length_849_cov_15.581333	287	367	9	7	80	0.0875000
NODE_10373_length_849_cov_15.581333	287	367	10	6	80	0.0750000
NODE_10373_length_849_cov_15.581333	287	367	11	9	80	0.1125000
NODE_10373_length_849_cov_15.581333	287	367	12	26	80	0.3250000
NODE_10373_length_849_cov_15.581333	287	367	13	5	80	0.0625000
NODE_10373_length_849_cov_15.581333	287	367	14	6	80	0.0750000
NODE_10373_length_849_cov_15.581333	340	420	0	28	80	0.3500000
NODE_10373_length_849_cov_15.581333	340	420	2	15	80	0.1875000
NODE_10373_length_849_cov_15.581333	340	420	6	1	80	0.0125000
NODE_10373_length_849_cov_15.581333	340	420	7	1	80	0.0125000
NODE_10373_length_849_cov_15.581333	340	420	8	10	80	0.1250000
NODE_10373_length_849_cov_15.581333	340	420	10	6	80	0.0750000
NODE_10373_length_849_cov_15.581333	340	420	12	19	80	0.2375000
NODE_10373_length_849_cov_15.581333	416	496	0	80	80	1.0000000
NODE_10373_length_849_cov_15.581333	469	549	0	80	80	1.0000000
NODE_10374_length_849_cov_9.460000	370	450	2	10	80	0.1250000
NODE_10374_length_849_cov_9.460000	370	450	4	70	80	0.8750000
NODE_10374_length_849_cov_9.460000	423	503	0	52	80	0.6500000
NODE_10374_length_849_cov_9.460000	423	503	2	11	80	0.1375000
NODE_10374_length_849_cov_9.460000	423	503	4	17	80	0.2125000
NODE_10375_length_849_cov_4.893333	427	507	2	22	80	0.2750000
NODE_10375_length_849_cov_4.893333	427	507	4	41	80	0.5125000
NODE_10375_length_849_cov_4.893333	427	507	6	17	80	0.2125000
NODE_10375_length_849_cov_4.893333	480	560	4	10	80	0.1250000
NODE_10375_length_849_cov_4.893333	480	560	6	60	80	0.7500000
NODE_10375_length_849_cov_4.893333	480	560	8	10	80	0.1250000
NODE_10376_length_849_cov_4.860000	380	460	0	80	80	1.0000000
NODE_10376_length_849_cov_4.860000	433	513	0	80	80	1.0000000
NODE_10379_length_849_cov_2.761333	254	334	0	80	80	1.0000000
NODE_10396_length_848_cov_27.287049	253	333	0	80	80	1.0000000
NODE_10396_length_848_cov_27.287049	306	386	0	80	80	1.0000000
NODE_10396_length_848_cov_27.287049	382	458	0	60	76	0.7894737
NODE_10396_length_848_cov_27.287049	382	458	2	16	76	0.2105263
NODE_10396_length_848_cov_27.287049	435	513	0	7	78	0.0897436
NODE_10396_length_848_cov_27.287049	435	513	2	28	78	0.3589744
NODE_10396_length_848_cov_27.287049	435	513	4	43	78	0.5512820
NODE_10397_length_848_cov_23.511348	248	328	0	80	80	1.0000000
NODE_10397_length_848_cov_23.511348	301	381	0	59	80	0.7375000
NODE_10397_length_848_cov_23.511348	301	381	2	9	80	0.1125000
NODE_10397_length_848_cov_23.511348	301	381	4	12	80	0.1500000
NODE_10397_length_848_cov_23.511348	377	457	4	7	80	0.0875000
NODE_10397_length_848_cov_23.511348	377	457	8	11	80	0.1375000
NODE_10397_length_848_cov_23.511348	377	457	10	62	80	0.7750000
NODE_10397_length_848_cov_23.511348	430	508	0	1	78	0.0128205
NODE_10397_length_848_cov_23.511348	430	508	6	39	78	0.5000000
NODE_10397_length_848_cov_23.511348	430	508	8	22	78	0.2820513
NODE_10397_length_848_cov_23.511348	430	508	10	16	78	0.2051282
NODE_10398_length_848_cov_21.939920	295	375	0	80	80	1.0000000
NODE_10398_length_848_cov_21.939920	348	428	0	80	80	1.0000000
NODE_10399_length_848_cov_21.937250	434	514	0	80	80	1.0000000
NODE_10399_length_848_cov_21.937250	487	567	0	80	80	1.0000000
NODE_10400_length_848_cov_19.500668	367	392	2	25	25	1.0000000
NODE_10400_length_848_cov_19.500668	388	468	0	15	80	0.1875000
NODE_10400_length_848_cov_19.500668	388	468	2	65	80	0.8125000
NODE_10400_length_848_cov_19.500668	441	521	0	29	80	0.3625000
NODE_10400_length_848_cov_19.500668	441	521	2	51	80	0.6375000
NODE_10400_length_848_cov_19.500668	443	512	0	20	69	0.2898551
NODE_10400_length_848_cov_19.500668	443	512	2	49	69	0.7101449
NODE_10400_length_848_cov_19.500668	443	472	2	29	29	1.0000000
NODE_10401_length_848_cov_16.566088	323	403	0	80	80	1.0000000
NODE_10401_length_848_cov_16.566088	376	456	0	73	80	0.9125000
NODE_10401_length_848_cov_16.566088	376	456	2	7	80	0.0875000
NODE_10402_length_848_cov_16.109479	256	336	2	74	80	0.9250000
NODE_10402_length_848_cov_16.109479	256	336	4	6	80	0.0750000
NODE_10402_length_848_cov_16.109479	309	389	2	75	80	0.9375000
NODE_10402_length_848_cov_16.109479	309	389	4	5	80	0.0625000
NODE_10402_length_848_cov_16.109479	385	465	0	32	80	0.4000000
NODE_10402_length_848_cov_16.109479	385	465	2	48	80	0.6000000
NODE_10402_length_848_cov_16.109479	438	518	0	80	80	1.0000000
NODE_10403_length_848_cov_15.919893	492	568	0	17	76	0.2236842
NODE_10403_length_848_cov_15.919893	492	568	2	59	76	0.7763158
NODE_10403_length_848_cov_15.919893	541	621	0	70	80	0.8750000
NODE_10403_length_848_cov_15.919893	541	621	2	10	80	0.1250000
NODE_10404_length_848_cov_13.979973	269	349	2	73	80	0.9125000
NODE_10404_length_848_cov_13.979973	269	349	4	7	80	0.0875000
NODE_10404_length_848_cov_13.979973	322	402	0	21	80	0.2625000
NODE_10404_length_848_cov_13.979973	322	402	2	59	80	0.7375000
NODE_10405_length_848_cov_13.073431	343	423	2	41	80	0.5125000
NODE_10405_length_848_cov_13.073431	343	423	4	39	80	0.4875000
NODE_10405_length_848_cov_13.073431	396	476	2	79	80	0.9875000
NODE_10405_length_848_cov_13.073431	396	476	4	1	80	0.0125000
NODE_10406_length_848_cov_8.523364	232	312	0	80	80	1.0000000
NODE_10406_length_848_cov_8.523364	285	365	0	80	80	1.0000000
NODE_10406_length_848_cov_8.523364	361	441	0	80	80	1.0000000
NODE_10406_length_848_cov_8.523364	414	494	0	80	80	1.0000000
NODE_10408_length_848_cov_5.903872	251	331	0	12	80	0.1500000
NODE_10408_length_848_cov_5.903872	251	331	1	17	80	0.2125000
NODE_10408_length_848_cov_5.903872	251	331	2	8	80	0.1000000
NODE_10408_length_848_cov_5.903872	251	331	4	43	80	0.5375000
NODE_10408_length_848_cov_5.903872	304	383	2	9	79	0.1139240
NODE_10408_length_848_cov_5.903872	304	383	4	70	79	0.8860760
NODE_10409_length_848_cov_5.236315	378	458	0	80	80	1.0000000
NODE_10409_length_848_cov_5.236315	431	507	0	34	76	0.4473684
NODE_10409_length_848_cov_5.236315	431	507	2	42	76	0.5526316
NODE_10424_length_847_cov_56.417112	576	656	0	80	80	1.0000000
NODE_10424_length_847_cov_56.417112	629	709	0	80	80	1.0000000
NODE_10425_length_847_cov_27.292781	390	470	20	7	80	0.0875000
NODE_10425_length_847_cov_27.292781	390	470	21	1	80	0.0125000
NODE_10425_length_847_cov_27.292781	390	470	22	10	80	0.1250000
NODE_10425_length_847_cov_27.292781	390	470	24	34	80	0.4250000
NODE_10425_length_847_cov_27.292781	390	470	26	28	80	0.3500000
NODE_10425_length_847_cov_27.292781	443	523	0	18	80	0.2250000
NODE_10425_length_847_cov_27.292781	443	523	8	19	80	0.2375000
NODE_10425_length_847_cov_27.292781	443	523	10	8	80	0.1000000
NODE_10425_length_847_cov_27.292781	443	523	20	15	80	0.1875000
NODE_10425_length_847_cov_27.292781	443	523	22	3	80	0.0375000
NODE_10425_length_847_cov_27.292781	443	523	26	17	80	0.2125000
NODE_10426_length_847_cov_24.954545	342	422	0	80	80	1.0000000
NODE_10426_length_847_cov_24.954545	395	475	0	54	80	0.6750000
NODE_10426_length_847_cov_24.954545	395	475	2	10	80	0.1250000
NODE_10426_length_847_cov_24.954545	395	475	4	16	80	0.2000000
NODE_10427_length_847_cov_20.310160	341	421	0	80	80	1.0000000
NODE_10427_length_847_cov_20.310160	394	474	0	80	80	1.0000000
NODE_10428_length_847_cov_19.002674	368	448	0	80	80	1.0000000
NODE_10428_length_847_cov_19.002674	421	501	0	80	80	1.0000000
NODE_10429_length_847_cov_16.879679	218	298	2	53	80	0.6625000
NODE_10429_length_847_cov_16.879679	218	298	4	27	80	0.3375000
NODE_10429_length_847_cov_16.879679	271	351	2	73	80	0.9125000
NODE_10429_length_847_cov_16.879679	271	351	4	7	80	0.0875000
NODE_10431_length_847_cov_11.784759	298	378	0	80	80	1.0000000
NODE_10431_length_847_cov_11.784759	351	431	0	80	80	1.0000000
NODE_10431_length_847_cov_11.784759	427	507	0	80	80	1.0000000
NODE_10431_length_847_cov_11.784759	480	560	0	80	80	1.0000000
NODE_10432_length_847_cov_11.604278	407	487	4	16	80	0.2000000
NODE_10432_length_847_cov_11.604278	407	487	6	64	80	0.8000000
NODE_10432_length_847_cov_11.604278	460	540	0	26	80	0.3250000
NODE_10432_length_847_cov_11.604278	460	540	4	43	80	0.5375000
NODE_10432_length_847_cov_11.604278	460	540	6	11	80	0.1375000
NODE_10433_length_847_cov_10.221925	395	475	0	80	80	1.0000000
NODE_10433_length_847_cov_10.221925	448	528	0	77	80	0.9625000
NODE_10433_length_847_cov_10.221925	448	528	2	3	80	0.0375000
NODE_10434_length_847_cov_4.602941	97	154	16	1	57	0.0175439
NODE_10434_length_847_cov_4.602941	97	154	18	22	57	0.3859649
NODE_10434_length_847_cov_4.602941	97	154	20	15	57	0.2631579
NODE_10434_length_847_cov_4.602941	97	154	22	19	57	0.3333333
NODE_10434_length_847_cov_4.602941	127	207	2	13	80	0.1625000
NODE_10434_length_847_cov_4.602941	127	207	4	5	80	0.0625000
NODE_10434_length_847_cov_4.602941	127	207	6	11	80	0.1375000
NODE_10434_length_847_cov_4.602941	127	207	10	13	80	0.1625000
NODE_10434_length_847_cov_4.602941	127	207	12	5	80	0.0625000
NODE_10434_length_847_cov_4.602941	127	207	14	4	80	0.0500000
NODE_10434_length_847_cov_4.602941	127	207	16	3	80	0.0375000
NODE_10434_length_847_cov_4.602941	127	207	18	11	80	0.1375000
NODE_10434_length_847_cov_4.602941	127	207	20	15	80	0.1875000
NODE_10456_length_846_cov_39.476573	336	416	2	57	80	0.7125000
NODE_10456_length_846_cov_39.476573	336	416	4	23	80	0.2875000
NODE_10456_length_846_cov_39.476573	389	469	0	45	80	0.5625000
NODE_10456_length_846_cov_39.476573	389	469	2	35	80	0.4375000
NODE_10456_length_846_cov_39.476573	465	545	0	53	80	0.6625000
NODE_10456_length_846_cov_39.476573	465	545	9	27	80	0.3375000
NODE_10456_length_846_cov_39.476573	518	598	4	2	80	0.0250000
NODE_10456_length_846_cov_39.476573	518	598	7	3	80	0.0375000
NODE_10456_length_846_cov_39.476573	518	598	8	16	80	0.2000000
NODE_10456_length_846_cov_39.476573	518	598	9	40	80	0.5000000
NODE_10456_length_846_cov_39.476573	518	598	13	19	80	0.2375000
NODE_10457_length_846_cov_37.297189	312	392	0	80	80	1.0000000
NODE_10457_length_846_cov_37.297189	365	445	0	51	80	0.6375000
NODE_10457_length_846_cov_37.297189	365	445	2	29	80	0.3625000
NODE_10458_length_846_cov_32.852744	279	359	0	80	80	1.0000000
NODE_10458_length_846_cov_32.852744	332	412	0	80	80	1.0000000
NODE_10459_length_846_cov_31.717537	290	370	0	63	80	0.7875000
NODE_10459_length_846_cov_31.717537	290	370	2	17	80	0.2125000
NODE_10459_length_846_cov_31.717537	343	423	0	80	80	1.0000000
NODE_10460_length_846_cov_24.380187	350	430	0	80	80	1.0000000
NODE_10460_length_846_cov_24.380187	403	483	0	80	80	1.0000000
NODE_10461_length_846_cov_16.155288	364	444	1	80	80	1.0000000
NODE_10461_length_846_cov_16.155288	417	497	1	38	80	0.4750000
NODE_10461_length_846_cov_16.155288	417	497	2	32	80	0.4000000
NODE_10461_length_846_cov_16.155288	417	497	3	10	80	0.1250000
NODE_10462_length_846_cov_15.917001	398	478	0	80	80	1.0000000
NODE_10462_length_846_cov_15.917001	451	531	0	80	80	1.0000000
NODE_10463_length_846_cov_15.275770	355	435	0	80	80	1.0000000
NODE_10463_length_846_cov_15.275770	408	488	0	80	80	1.0000000
NODE_10464_length_846_cov_13.618474	216	296	0	80	80	1.0000000
NODE_10464_length_846_cov_13.618474	269	349	0	78	80	0.9750000
NODE_10464_length_846_cov_13.618474	269	349	2	2	80	0.0250000
NODE_10464_length_846_cov_13.618474	345	425	0	2	80	0.0250000
NODE_10464_length_846_cov_13.618474	345	425	2	7	80	0.0875000
NODE_10464_length_846_cov_13.618474	345	425	4	71	80	0.8875000
NODE_10464_length_846_cov_13.618474	398	478	0	36	80	0.4500000
NODE_10464_length_846_cov_13.618474	398	478	2	9	80	0.1125000
NODE_10464_length_846_cov_13.618474	398	478	4	35	80	0.4375000
NODE_10465_length_846_cov_12.878179	425	505	0	29	80	0.3625000
NODE_10465_length_846_cov_12.878179	425	505	2	51	80	0.6375000
NODE_10465_length_846_cov_12.878179	478	558	0	31	80	0.3875000
NODE_10465_length_846_cov_12.878179	478	558	2	49	80	0.6125000
NODE_10467_length_846_cov_7.232932	407	487	0	80	80	1.0000000
NODE_10467_length_846_cov_7.232932	460	540	0	80	80	1.0000000
NODE_10468_length_846_cov_6.776439	320	400	0	80	80	1.0000000
NODE_10468_length_846_cov_6.776439	373	453	0	80	80	1.0000000
NODE_10472_length_846_cov_3.025435	190	270	0	80	80	1.0000000
NODE_10472_length_846_cov_3.025435	243	323	0	80	80	1.0000000
NODE_10488_length_845_cov_34.458445	213	293	0	34	80	0.4250000
NODE_10488_length_845_cov_34.458445	213	293	2	17	80	0.2125000
NODE_10488_length_845_cov_34.458445	213	293	8	29	80	0.3625000
NODE_10488_length_845_cov_34.458445	266	346	6	17	80	0.2125000
NODE_10488_length_845_cov_34.458445	266	346	8	63	80	0.7875000
NODE_10489_length_845_cov_33.025469	309	389	0	80	80	1.0000000
NODE_10489_length_845_cov_33.025469	362	442	0	80	80	1.0000000
NODE_10490_length_845_cov_30.331099	288	368	2	80	80	1.0000000
NODE_10490_length_845_cov_30.331099	341	421	0	46	80	0.5750000
NODE_10490_length_845_cov_30.331099	341	421	2	34	80	0.4250000
NODE_10491_length_845_cov_22.042895	455	535	7	26	80	0.3250000
NODE_10491_length_845_cov_22.042895	455	535	9	54	80	0.6750000
NODE_10491_length_845_cov_22.042895	508	588	0	27	80	0.3375000
NODE_10491_length_845_cov_22.042895	508	588	2	13	80	0.1625000
NODE_10491_length_845_cov_22.042895	508	588	8	1	80	0.0125000
NODE_10491_length_845_cov_22.042895	508	588	9	39	80	0.4875000
NODE_10492_length_845_cov_20.662198	325	406	2	35	81	0.4320988
NODE_10492_length_845_cov_20.662198	325	406	6	17	81	0.2098765
NODE_10492_length_845_cov_20.662198	325	406	8	6	81	0.0740741
NODE_10492_length_845_cov_20.662198	325	406	10	23	81	0.2839506
NODE_10492_length_845_cov_20.662198	379	459	4	5	80	0.0625000
NODE_10492_length_845_cov_20.662198	379	459	8	54	80	0.6750000
NODE_10492_length_845_cov_20.662198	379	459	10	21	80	0.2625000
NODE_10493_length_845_cov_17.214477	352	432	0	80	80	1.0000000
NODE_10493_length_845_cov_17.214477	405	485	0	38	80	0.4750000
NODE_10493_length_845_cov_17.214477	405	485	2	42	80	0.5250000
NODE_10494_length_845_cov_15.805630	409	489	0	80	80	1.0000000
NODE_10494_length_845_cov_15.805630	462	542	0	80	80	1.0000000
NODE_10495_length_845_cov_13.443700	329	409	0	80	80	1.0000000
NODE_10495_length_845_cov_13.443700	382	462	0	80	80	1.0000000
NODE_10496_length_845_cov_12.301609	334	414	2	44	80	0.5500000
NODE_10496_length_845_cov_12.301609	334	414	4	36	80	0.4500000
NODE_10496_length_845_cov_12.301609	387	467	2	24	80	0.3000000
NODE_10496_length_845_cov_12.301609	387	467	4	56	80	0.7000000
NODE_10497_length_845_cov_11.836461	389	469	0	80	80	1.0000000
NODE_10497_length_845_cov_11.836461	442	522	0	80	80	1.0000000
NODE_10499_length_845_cov_8.140751	439	519	0	24	80	0.3000000
NODE_10499_length_845_cov_8.140751	439	519	2	56	80	0.7000000
NODE_10499_length_845_cov_8.140751	492	572	2	80	80	1.0000000
NODE_10516_length_845_cov_1.680965	447	491	0	44	44	1.0000000
NODE_10528_length_844_cov_43.778523	313	393	6	17	80	0.2125000
NODE_10528_length_844_cov_43.778523	313	393	8	1	80	0.0125000
NODE_10528_length_844_cov_43.778523	313	393	10	4	80	0.0500000
NODE_10528_length_844_cov_43.778523	313	393	12	58	80	0.7250000
NODE_10528_length_844_cov_43.778523	366	446	0	6	80	0.0750000
NODE_10528_length_844_cov_43.778523	366	446	5	2	80	0.0250000
NODE_10528_length_844_cov_43.778523	366	446	6	10	80	0.1250000
NODE_10528_length_844_cov_43.778523	366	446	8	17	80	0.2125000
NODE_10528_length_844_cov_43.778523	366	446	10	4	80	0.0500000
NODE_10528_length_844_cov_43.778523	366	446	12	41	80	0.5125000
NODE_10528_length_844_cov_43.778523	442	522	0	80	80	1.0000000
NODE_10528_length_844_cov_43.778523	495	575	0	80	80	1.0000000
NODE_10529_length_844_cov_36.762416	381	461	0	80	80	1.0000000
NODE_10529_length_844_cov_36.762416	434	514	0	80	80	1.0000000
NODE_10529_length_844_cov_36.762416	510	590	0	80	80	1.0000000
NODE_10529_length_844_cov_36.762416	563	644	0	81	81	1.0000000
NODE_10530_length_844_cov_35.765101	424	504	4	3	80	0.0375000
NODE_10530_length_844_cov_35.765101	424	504	5	61	80	0.7625000
NODE_10530_length_844_cov_35.765101	424	504	7	16	80	0.2000000
NODE_10530_length_844_cov_35.765101	477	557	4	26	80	0.3250000
NODE_10530_length_844_cov_35.765101	477	557	5	38	80	0.4750000
NODE_10530_length_844_cov_35.765101	477	557	6	12	80	0.1500000
NODE_10530_length_844_cov_35.765101	477	557	7	4	80	0.0500000
NODE_10531_length_844_cov_18.445638	353	420	0	67	67	1.0000000
NODE_10531_length_844_cov_18.445638	393	473	0	74	80	0.9250000
NODE_10531_length_844_cov_18.445638	393	473	1	2	80	0.0250000
NODE_10531_length_844_cov_18.445638	393	473	2	4	80	0.0500000
NODE_10532_length_844_cov_12.616107	363	443	0	80	80	1.0000000
NODE_10532_length_844_cov_12.616107	416	496	0	80	80	1.0000000
NODE_10533_length_844_cov_12.092617	171	251	0	80	80	1.0000000
NODE_10533_length_844_cov_12.092617	224	304	0	80	80	1.0000000
NODE_10534_length_844_cov_11.883221	341	421	0	80	80	1.0000000
NODE_10534_length_844_cov_11.883221	394	474	0	80	80	1.0000000
NODE_10535_length_844_cov_10.571812	390	448	0	2	58	0.0344828
NODE_10535_length_844_cov_10.571812	390	448	2	56	58	0.9655172
NODE_10537_length_844_cov_9.357047	370	450	0	80	80	1.0000000
NODE_10537_length_844_cov_9.357047	423	503	0	80	80	1.0000000
NODE_10538_length_844_cov_8.975839	355	435	0	80	80	1.0000000
NODE_10538_length_844_cov_8.975839	408	488	0	80	80	1.0000000
NODE_10539_length_844_cov_7.347651	357	438	0	81	81	1.0000000
NODE_10539_length_844_cov_7.347651	410	491	0	81	81	1.0000000
NODE_10540_length_844_cov_6.975839	444	524	0	59	80	0.7375000
NODE_10540_length_844_cov_6.975839	444	524	2	21	80	0.2625000
NODE_10540_length_844_cov_6.975839	497	577	0	6	80	0.0750000
NODE_10540_length_844_cov_6.975839	497	577	2	74	80	0.9250000
NODE_10567_length_843_cov_48.258065	203	262	284	3	59	0.0508475
NODE_10567_length_843_cov_48.258065	203	262	285	1	59	0.0169492
NODE_10567_length_843_cov_48.258065	203	262	286	4	59	0.0677966
NODE_10567_length_843_cov_48.258065	203	262	287	1	59	0.0169492
NODE_10567_length_843_cov_48.258065	203	262	288	2	59	0.0338983
NODE_10567_length_843_cov_48.258065	203	262	289	2	59	0.0338983
NODE_10567_length_843_cov_48.258065	203	262	290	1	59	0.0169492
NODE_10567_length_843_cov_48.258065	203	262	291	1	59	0.0169492
NODE_10567_length_843_cov_48.258065	203	262	292	1	59	0.0169492
NODE_10567_length_843_cov_48.258065	203	262	293	2	59	0.0338983
NODE_10567_length_843_cov_48.258065	203	262	295	4	59	0.0677966
NODE_10567_length_843_cov_48.258065	203	262	299	1	59	0.0169492
NODE_10567_length_843_cov_48.258065	203	262	300	2	59	0.0338983
NODE_10567_length_843_cov_48.258065	203	262	301	1	59	0.0169492
NODE_10567_length_843_cov_48.258065	203	262	303	3	59	0.0508475
NODE_10567_length_843_cov_48.258065	203	262	304	2	59	0.0338983
NODE_10567_length_843_cov_48.258065	203	262	305	1	59	0.0169492
NODE_10567_length_843_cov_48.258065	203	262	307	1	59	0.0169492
NODE_10567_length_843_cov_48.258065	203	262	309	2	59	0.0338983
NODE_10567_length_843_cov_48.258065	203	262	310	1	59	0.0169492
NODE_10567_length_843_cov_48.258065	203	262	311	3	59	0.0508475
NODE_10567_length_843_cov_48.258065	203	262	312	2	59	0.0338983
NODE_10567_length_843_cov_48.258065	203	262	313	1	59	0.0169492
NODE_10567_length_843_cov_48.258065	203	262	314	1	59	0.0169492
NODE_10567_length_843_cov_48.258065	203	262	315	6	59	0.1016949
NODE_10567_length_843_cov_48.258065	203	262	316	7	59	0.1186441
NODE_10567_length_843_cov_48.258065	203	262	317	2	59	0.0338983
NODE_10567_length_843_cov_48.258065	203	262	318	1	59	0.0169492
NODE_10568_length_843_cov_31.279570	351	431	0	14	80	0.1750000
NODE_10568_length_843_cov_31.279570	351	431	2	25	80	0.3125000
NODE_10568_length_843_cov_31.279570	351	431	4	41	80	0.5125000
NODE_10568_length_843_cov_31.279570	404	484	0	67	80	0.8375000
NODE_10568_length_843_cov_31.279570	404	484	2	13	80	0.1625000
NODE_10569_length_843_cov_27.060484	423	503	2	80	80	1.0000000
NODE_10569_length_843_cov_27.060484	476	556	2	80	80	1.0000000
NODE_10570_length_843_cov_22.725806	334	414	0	80	80	1.0000000
NODE_10570_length_843_cov_22.725806	339	396	0	57	57	1.0000000
NODE_10570_length_843_cov_22.725806	356	427	0	71	71	1.0000000
NODE_10570_length_843_cov_22.725806	387	455	0	68	68	1.0000000
NODE_10570_length_843_cov_22.725806	401	476	0	75	75	1.0000000
NODE_10570_length_843_cov_22.725806	418	486	0	68	68	1.0000000
NODE_10570_length_843_cov_22.725806	449	529	0	75	80	0.9375000
NODE_10570_length_843_cov_22.725806	449	529	2	5	80	0.0625000
NODE_10571_length_843_cov_22.387097	412	492	0	80	80	1.0000000
NODE_10571_length_843_cov_22.387097	465	545	0	80	80	1.0000000
NODE_10572_length_843_cov_16.326613	551	631	0	14	80	0.1750000
NODE_10572_length_843_cov_16.326613	551	631	2	66	80	0.8250000
NODE_10572_length_843_cov_16.326613	604	684	0	67	80	0.8375000
NODE_10572_length_843_cov_16.326613	604	684	2	13	80	0.1625000
NODE_10573_length_843_cov_13.478495	381	461	0	80	80	1.0000000
NODE_10573_length_843_cov_13.478495	434	514	0	80	80	1.0000000
NODE_10574_length_843_cov_13.150538	448	528	0	3	80	0.0375000
NODE_10574_length_843_cov_13.150538	448	528	2	77	80	0.9625000
NODE_10574_length_843_cov_13.150538	501	581	0	56	80	0.7000000
NODE_10574_length_843_cov_13.150538	501	581	2	24	80	0.3000000
NODE_10575_length_843_cov_12.510753	360	440	0	80	80	1.0000000
NODE_10575_length_843_cov_12.510753	413	493	0	44	80	0.5500000
NODE_10575_length_843_cov_12.510753	413	493	2	36	80	0.4500000
NODE_10576_length_843_cov_11.090054	457	537	0	80	80	1.0000000
NODE_10576_length_843_cov_11.090054	510	590	0	80	80	1.0000000
NODE_10577_length_843_cov_7.672043	472	552	0	80	80	1.0000000
NODE_10577_length_843_cov_7.672043	525	605	0	80	80	1.0000000
NODE_10601_length_842_cov_39.518170	390	470	2	80	80	1.0000000
NODE_10601_length_842_cov_39.518170	443	523	0	15	80	0.1875000
NODE_10601_length_842_cov_39.518170	443	523	2	65	80	0.8125000
NODE_10602_length_842_cov_21.567968	331	411	0	80	80	1.0000000
NODE_10602_length_842_cov_21.567968	384	464	0	80	80	1.0000000
NODE_10603_length_842_cov_19.761777	228	308	0	6	80	0.0750000
NODE_10603_length_842_cov_19.761777	228	308	2	74	80	0.9250000
NODE_10603_length_842_cov_19.761777	281	361	0	6	80	0.0750000
NODE_10603_length_842_cov_19.761777	281	361	2	60	80	0.7500000
NODE_10603_length_842_cov_19.761777	281	361	4	14	80	0.1750000
NODE_10605_length_842_cov_8.703903	641	722	0	81	81	1.0000000
NODE_10608_length_842_cov_5.305518	287	367	0	80	80	1.0000000
NODE_10608_length_842_cov_5.305518	340	420	0	80	80	1.0000000
NODE_10617_length_842_cov_1.751009	35	66	0	31	31	1.0000000
NODE_10622_length_841_cov_23.815364	292	372	0	80	80	1.0000000
NODE_10622_length_841_cov_23.815364	345	425	0	80	80	1.0000000
NODE_10623_length_841_cov_18.871968	338	418	0	6	80	0.0750000
NODE_10623_length_841_cov_18.871968	338	418	1	5	80	0.0625000
NODE_10623_length_841_cov_18.871968	338	418	2	11	80	0.1375000
NODE_10623_length_841_cov_18.871968	338	418	4	58	80	0.7250000
NODE_10623_length_841_cov_18.871968	391	471	2	14	80	0.1750000
NODE_10623_length_841_cov_18.871968	391	471	4	66	80	0.8250000
NODE_10624_length_841_cov_14.663073	345	425	0	80	80	1.0000000
NODE_10624_length_841_cov_14.663073	398	478	0	80	80	1.0000000
NODE_10625_length_841_cov_14.149596	341	421	0	80	80	1.0000000
NODE_10625_length_841_cov_14.149596	394	474	0	80	80	1.0000000
NODE_10626_length_841_cov_12.452830	240	320	0	80	80	1.0000000
NODE_10626_length_841_cov_12.452830	293	373	0	80	80	1.0000000
NODE_10628_length_841_cov_9.925876	394	474	2	80	80	1.0000000
NODE_10628_length_841_cov_9.925876	447	527	0	26	80	0.3250000
NODE_10628_length_841_cov_9.925876	447	527	2	54	80	0.6750000
NODE_10629_length_841_cov_7.407008	317	397	0	80	80	1.0000000
NODE_10629_length_841_cov_7.407008	370	450	0	80	80	1.0000000
NODE_10632_length_841_cov_3.865229	305	356	0	1	51	0.0196078
NODE_10632_length_841_cov_3.865229	305	356	2	50	51	0.9803922
NODE_10651_length_840_cov_63.726046	461	541	8	80	80	1.0000000
NODE_10651_length_840_cov_63.726046	514	594	0	6	80	0.0750000
NODE_10651_length_840_cov_63.726046	514	594	2	5	80	0.0625000
NODE_10651_length_840_cov_63.726046	514	594	8	69	80	0.8625000
NODE_10652_length_840_cov_35.874494	486	566	0	15	80	0.1875000
NODE_10652_length_840_cov_35.874494	486	566	2	65	80	0.8125000
NODE_10652_length_840_cov_35.874494	539	619	0	68	80	0.8500000
NODE_10652_length_840_cov_35.874494	539	619	2	12	80	0.1500000
NODE_10653_length_840_cov_24.499325	224	304	0	80	80	1.0000000
NODE_10653_length_840_cov_24.499325	277	357	0	80	80	1.0000000
NODE_10653_length_840_cov_24.499325	353	433	0	80	80	1.0000000
NODE_10653_length_840_cov_24.499325	406	486	0	80	80	1.0000000
NODE_10654_length_840_cov_23.272605	309	389	0	10	80	0.1250000
NODE_10654_length_840_cov_23.272605	309	389	5	15	80	0.1875000
NODE_10654_length_840_cov_23.272605	309	389	9	55	80	0.6875000
NODE_10654_length_840_cov_23.272605	362	442	0	5	80	0.0625000
NODE_10654_length_840_cov_23.272605	362	442	4	21	80	0.2625000
NODE_10654_length_840_cov_23.272605	362	442	9	54	80	0.6750000
NODE_10655_length_840_cov_22.221323	293	373	0	71	80	0.8875000
NODE_10655_length_840_cov_22.221323	293	373	2	9	80	0.1125000
NODE_10655_length_840_cov_22.221323	346	426	0	80	80	1.0000000
NODE_10656_length_840_cov_17.026991	348	432	0	84	84	1.0000000
NODE_10656_length_840_cov_17.026991	405	485	0	80	80	1.0000000
NODE_10657_length_840_cov_16.635628	347	427	0	80	80	1.0000000
NODE_10657_length_840_cov_16.635628	400	480	0	80	80	1.0000000
NODE_10658_length_840_cov_12.133603	336	416	0	80	80	1.0000000
NODE_10658_length_840_cov_12.133603	389	469	0	80	80	1.0000000
NODE_10659_length_840_cov_12.041835	332	412	0	30	80	0.3750000
NODE_10659_length_840_cov_12.041835	332	412	2	50	80	0.6250000
NODE_10659_length_840_cov_12.041835	385	465	0	64	80	0.8000000
NODE_10659_length_840_cov_12.041835	385	465	2	16	80	0.2000000
NODE_10660_length_840_cov_10.719298	275	354	0	79	79	1.0000000
NODE_10660_length_840_cov_10.719298	327	407	0	80	80	1.0000000
NODE_10663_length_840_cov_5.207827	427	507	0	80	80	1.0000000
NODE_10663_length_840_cov_5.207827	480	560	0	80	80	1.0000000
NODE_10683_length_839_cov_274.987838	450	530	39	4	80	0.0500000
NODE_10683_length_839_cov_274.987838	450	530	42	2	80	0.0250000
NODE_10683_length_839_cov_274.987838	450	530	49	4	80	0.0500000
NODE_10683_length_839_cov_274.987838	450	530	51	3	80	0.0375000
NODE_10683_length_839_cov_274.987838	450	530	53	2	80	0.0250000
NODE_10683_length_839_cov_274.987838	450	530	55	8	80	0.1000000
NODE_10683_length_839_cov_274.987838	450	530	56	3	80	0.0375000
NODE_10683_length_839_cov_274.987838	450	530	57	7	80	0.0875000
NODE_10683_length_839_cov_274.987838	450	530	59	8	80	0.1000000
NODE_10683_length_839_cov_274.987838	450	530	63	1	80	0.0125000
NODE_10683_length_839_cov_274.987838	450	530	64	1	80	0.0125000
NODE_10683_length_839_cov_274.987838	450	530	66	1	80	0.0125000
NODE_10683_length_839_cov_274.987838	450	530	67	5	80	0.0625000
NODE_10683_length_839_cov_274.987838	450	530	69	2	80	0.0250000
NODE_10683_length_839_cov_274.987838	450	530	72	6	80	0.0750000
NODE_10683_length_839_cov_274.987838	450	530	74	1	80	0.0125000
NODE_10683_length_839_cov_274.987838	450	530	76	1	80	0.0125000
NODE_10683_length_839_cov_274.987838	450	530	78	2	80	0.0250000
NODE_10683_length_839_cov_274.987838	450	530	80	1	80	0.0125000
NODE_10683_length_839_cov_274.987838	450	530	83	2	80	0.0250000
NODE_10683_length_839_cov_274.987838	450	530	85	4	80	0.0500000
NODE_10683_length_839_cov_274.987838	450	530	87	4	80	0.0500000
NODE_10683_length_839_cov_274.987838	450	530	89	1	80	0.0125000
NODE_10683_length_839_cov_274.987838	450	530	92	3	80	0.0375000
NODE_10683_length_839_cov_274.987838	450	530	94	3	80	0.0375000
NODE_10683_length_839_cov_274.987838	450	530	103	1	80	0.0125000
NODE_10683_length_839_cov_274.987838	503	583	72	4	80	0.0500000
NODE_10683_length_839_cov_274.987838	503	583	74	1	80	0.0125000
NODE_10683_length_839_cov_274.987838	503	583	76	1	80	0.0125000
NODE_10683_length_839_cov_274.987838	503	583	78	2	80	0.0250000
NODE_10683_length_839_cov_274.987838	503	583	80	1	80	0.0125000
NODE_10683_length_839_cov_274.987838	503	583	83	2	80	0.0250000
NODE_10683_length_839_cov_274.987838	503	583	85	4	80	0.0500000
NODE_10683_length_839_cov_274.987838	503	583	87	4	80	0.0500000
NODE_10683_length_839_cov_274.987838	503	583	89	1	80	0.0125000
NODE_10683_length_839_cov_274.987838	503	583	92	3	80	0.0375000
NODE_10683_length_839_cov_274.987838	503	583	94	3	80	0.0375000
NODE_10683_length_839_cov_274.987838	503	583	103	1	80	0.0125000
NODE_10683_length_839_cov_274.987838	503	583	105	1	80	0.0125000
NODE_10683_length_839_cov_274.987838	503	583	111	1	80	0.0125000
NODE_10683_length_839_cov_274.987838	503	583	119	1	80	0.0125000
NODE_10683_length_839_cov_274.987838	503	583	120	4	80	0.0500000
NODE_10683_length_839_cov_274.987838	503	583	122	2	80	0.0250000
NODE_10683_length_839_cov_274.987838	503	583	123	1	80	0.0125000
NODE_10683_length_839_cov_274.987838	503	583	125	2	80	0.0250000
NODE_10683_length_839_cov_274.987838	503	583	129	1	80	0.0125000
NODE_10683_length_839_cov_274.987838	503	583	131	3	80	0.0375000
NODE_10683_length_839_cov_274.987838	503	583	132	1	80	0.0125000
NODE_10683_length_839_cov_274.987838	503	583	133	2	80	0.0250000
NODE_10683_length_839_cov_274.987838	503	583	135	1	80	0.0125000
NODE_10683_length_839_cov_274.987838	503	583	137	3	80	0.0375000
NODE_10683_length_839_cov_274.987838	503	583	139	2	80	0.0250000
NODE_10683_length_839_cov_274.987838	503	583	140	2	80	0.0250000
NODE_10683_length_839_cov_274.987838	503	583	141	1	80	0.0125000
NODE_10683_length_839_cov_274.987838	503	583	142	7	80	0.0875000
NODE_10683_length_839_cov_274.987838	503	583	143	5	80	0.0625000
NODE_10683_length_839_cov_274.987838	503	583	144	2	80	0.0250000
NODE_10683_length_839_cov_274.987838	503	583	145	2	80	0.0250000
NODE_10683_length_839_cov_274.987838	503	583	146	6	80	0.0750000
NODE_10683_length_839_cov_274.987838	503	583	147	2	80	0.0250000
NODE_10683_length_839_cov_274.987838	503	583	149	1	80	0.0125000
NODE_10684_length_839_cov_24.500000	303	383	0	40	80	0.5000000
NODE_10684_length_839_cov_24.500000	303	383	2	40	80	0.5000000
NODE_10684_length_839_cov_24.500000	356	436	0	80	80	1.0000000
NODE_10685_length_839_cov_16.390541	477	557	2	80	80	1.0000000
NODE_10685_length_839_cov_16.390541	530	610	0	49	80	0.6125000
NODE_10685_length_839_cov_16.390541	530	610	2	31	80	0.3875000
NODE_10686_length_839_cov_10.006757	383	463	0	80	80	1.0000000
NODE_10686_length_839_cov_10.006757	436	516	0	80	80	1.0000000
NODE_10688_length_839_cov_7.612162	308	388	2	80	80	1.0000000
NODE_10688_length_839_cov_7.612162	361	441	0	4	80	0.0500000
NODE_10688_length_839_cov_7.612162	361	441	1	21	80	0.2625000
NODE_10688_length_839_cov_7.612162	361	441	2	55	80	0.6875000
NODE_10689_length_839_cov_6.693243	343	423	0	80	80	1.0000000
NODE_10706_length_838_cov_39.263870	383	463	0	22	80	0.2750000
NODE_10706_length_838_cov_39.263870	383	463	2	58	80	0.7250000
NODE_10706_length_838_cov_39.263870	436	516	0	75	80	0.9375000
NODE_10706_length_838_cov_39.263870	436	516	2	5	80	0.0625000
NODE_10707_length_838_cov_27.843031	473	553	0	61	80	0.7625000
NODE_10707_length_838_cov_27.843031	473	553	2	19	80	0.2375000
NODE_10707_length_838_cov_27.843031	526	606	0	10	80	0.1250000
NODE_10707_length_838_cov_27.843031	526	606	2	70	80	0.8750000
NODE_10708_length_838_cov_27.238160	432	512	2	80	80	1.0000000
NODE_10708_length_838_cov_27.238160	485	565	0	45	80	0.5625000
NODE_10708_length_838_cov_27.238160	485	565	2	35	80	0.4375000
NODE_10709_length_838_cov_22.691475	380	460	0	22	80	0.2750000
NODE_10709_length_838_cov_22.691475	380	460	3	13	80	0.1625000
NODE_10709_length_838_cov_22.691475	380	460	4	45	80	0.5625000
NODE_10709_length_838_cov_22.691475	433	513	0	75	80	0.9375000
NODE_10709_length_838_cov_22.691475	433	513	3	5	80	0.0625000
NODE_10710_length_838_cov_16.169147	312	392	0	80	80	1.0000000
NODE_10710_length_838_cov_16.169147	365	445	0	80	80	1.0000000
NODE_10711_length_838_cov_15.753721	328	408	2	4	80	0.0500000
NODE_10711_length_838_cov_15.753721	328	408	4	5	80	0.0625000
NODE_10711_length_838_cov_15.753721	328	408	5	2	80	0.0250000
NODE_10711_length_838_cov_15.753721	328	408	6	69	80	0.8625000
NODE_10711_length_838_cov_15.753721	381	461	0	20	80	0.2500000
NODE_10711_length_838_cov_15.753721	381	461	4	38	80	0.4750000
NODE_10711_length_838_cov_15.753721	381	461	6	22	80	0.2750000
NODE_10712_length_838_cov_15.514208	294	374	0	80	80	1.0000000
NODE_10712_length_838_cov_15.514208	347	427	0	80	80	1.0000000
NODE_10713_length_838_cov_7.733424	350	430	0	80	80	1.0000000
NODE_10713_length_838_cov_7.733424	403	483	0	80	80	1.0000000
NODE_10716_length_838_cov_4.511502	131	213	1	21	82	0.2560976
NODE_10716_length_838_cov_4.511502	131	213	2	18	82	0.2195122
NODE_10716_length_838_cov_4.511502	131	213	4	43	82	0.5243902
NODE_10716_length_838_cov_4.511502	184	252	4	68	68	1.0000000
NODE_10722_length_838_cov_2.247632	359	405	0	46	46	1.0000000
NODE_10727_length_838_cov_1.843031	732	752	0	11	20	0.5500000
NODE_10727_length_838_cov_1.843031	732	752	2	9	20	0.4500000
NODE_10740_length_837_cov_32.691057	401	481	0	80	80	1.0000000
NODE_10740_length_837_cov_32.691057	454	534	0	80	80	1.0000000
NODE_10741_length_837_cov_30.995935	399	479	0	18	80	0.2250000
NODE_10741_length_837_cov_30.995935	399	479	2	62	80	0.7750000
NODE_10741_length_837_cov_30.995935	452	532	2	40	80	0.5000000
NODE_10741_length_837_cov_30.995935	452	532	4	20	80	0.2500000
NODE_10741_length_837_cov_30.995935	452	532	10	20	80	0.2500000
NODE_10742_length_837_cov_30.883469	278	358	0	30	80	0.3750000
NODE_10742_length_837_cov_30.883469	278	358	2	50	80	0.6250000
NODE_10742_length_837_cov_30.883469	331	411	0	32	80	0.4000000
NODE_10742_length_837_cov_30.883469	331	411	2	48	80	0.6000000
NODE_10742_length_837_cov_30.883469	407	487	0	80	80	1.0000000
NODE_10742_length_837_cov_30.883469	460	540	0	80	80	1.0000000
NODE_10743_length_837_cov_14.573171	205	280	0	75	75	1.0000000
NODE_10743_length_837_cov_14.573171	258	337	0	79	79	1.0000000
NODE_10743_length_837_cov_14.573171	333	413	0	80	80	1.0000000
NODE_10743_length_837_cov_14.573171	386	466	0	80	80	1.0000000
NODE_10744_length_837_cov_12.582656	226	306	0	80	80	1.0000000
NODE_10744_length_837_cov_12.582656	279	359	0	80	80	1.0000000
NODE_10745_length_837_cov_6.998645	389	474	0	85	85	1.0000000
NODE_10745_length_837_cov_6.998645	447	527	0	80	80	1.0000000
NODE_10750_length_837_cov_3.119241	373	453	0	80	80	1.0000000
NODE_10750_length_837_cov_3.119241	426	506	0	80	80	1.0000000
NODE_10769_length_836_cov_40.141113	224	304	0	35	80	0.4375000
NODE_10769_length_836_cov_40.141113	224	304	2	7	80	0.0875000
NODE_10769_length_836_cov_40.141113	224	304	4	38	80	0.4750000
NODE_10769_length_836_cov_40.141113	277	357	4	43	80	0.5375000
NODE_10769_length_836_cov_40.141113	277	357	7	1	80	0.0125000
NODE_10769_length_836_cov_40.141113	277	357	8	36	80	0.4500000
NODE_10769_length_836_cov_40.141113	353	433	4	51	80	0.6375000
NODE_10769_length_836_cov_40.141113	353	433	6	23	80	0.2875000
NODE_10769_length_836_cov_40.141113	353	433	8	6	80	0.0750000
NODE_10769_length_836_cov_40.141113	406	486	4	37	80	0.4625000
NODE_10769_length_836_cov_40.141113	406	486	6	38	80	0.4750000
NODE_10769_length_836_cov_40.141113	406	486	8	5	80	0.0625000
NODE_10770_length_836_cov_27.610583	344	424	0	80	80	1.0000000
NODE_10770_length_836_cov_27.610583	397	477	0	80	80	1.0000000
NODE_10771_length_836_cov_15.719132	295	375	0	80	80	1.0000000
NODE_10771_length_836_cov_15.719132	348	428	0	80	80	1.0000000
NODE_10772_length_836_cov_9.309362	295	375	0	6	80	0.0750000
NODE_10772_length_836_cov_9.309362	295	375	2	7	80	0.0875000
NODE_10772_length_836_cov_9.309362	295	375	4	41	80	0.5125000
NODE_10772_length_836_cov_9.309362	295	375	6	26	80	0.3250000
NODE_10772_length_836_cov_9.309362	348	428	4	1	80	0.0125000
NODE_10772_length_836_cov_9.309362	348	428	6	79	80	0.9875000
NODE_10773_length_836_cov_6.283582	336	416	0	80	80	1.0000000
NODE_10773_length_836_cov_6.283582	389	469	0	80	80	1.0000000
NODE_10774_length_836_cov_4.979647	371	451	0	80	80	1.0000000
NODE_10774_length_836_cov_4.979647	424	504	0	80	80	1.0000000
NODE_10787_length_835_cov_61.033967	253	333	0	42	80	0.5250000
NODE_10787_length_835_cov_61.033967	253	333	2	31	80	0.3875000
NODE_10787_length_835_cov_61.033967	253	333	10	7	80	0.0875000
NODE_10787_length_835_cov_61.033967	306	386	2	20	80	0.2500000
NODE_10787_length_835_cov_61.033967	306	386	8	30	80	0.3750000
NODE_10787_length_835_cov_61.033967	306	386	10	30	80	0.3750000
NODE_10788_length_835_cov_32.380435	390	470	0	53	80	0.6625000
NODE_10788_length_835_cov_32.380435	390	470	2	27	80	0.3375000
NODE_10788_length_835_cov_32.380435	443	523	2	80	80	1.0000000
NODE_10789_length_835_cov_20.779891	415	495	0	75	80	0.9375000
NODE_10789_length_835_cov_20.779891	415	495	2	5	80	0.0625000
NODE_10789_length_835_cov_20.779891	468	548	0	28	80	0.3500000
NODE_10789_length_835_cov_20.779891	468	548	2	52	80	0.6500000
NODE_10808_length_835_cov_1.694293	18	80	2	62	62	1.0000000
NODE_10820_length_834_cov_13.689796	213	293	0	80	80	1.0000000
NODE_10820_length_834_cov_13.689796	266	346	0	80	80	1.0000000
NODE_10822_length_834_cov_12.609524	406	486	0	80	80	1.0000000
NODE_10822_length_834_cov_12.609524	459	539	0	80	80	1.0000000
NODE_10823_length_834_cov_11.492517	248	328	0	29	80	0.3625000
NODE_10823_length_834_cov_11.492517	248	328	6	51	80	0.6375000
NODE_10823_length_834_cov_11.492517	301	381	6	80	80	1.0000000
NODE_10824_length_834_cov_9.957823	212	292	0	80	80	1.0000000
NODE_10824_length_834_cov_9.957823	265	345	0	80	80	1.0000000
NODE_10825_length_834_cov_6.448980	482	546	1	11	64	0.1718750
NODE_10825_length_834_cov_6.448980	482	546	2	53	64	0.8281250
NODE_10833_length_834_cov_2.658503	589	641	2	52	52	1.0000000
NODE_10846_length_833_cov_57.702997	338	418	0	80	80	1.0000000
NODE_10846_length_833_cov_57.702997	391	471	0	80	80	1.0000000
NODE_10847_length_833_cov_38.153951	364	444	0	13	80	0.1625000
NODE_10847_length_833_cov_38.153951	364	444	2	23	80	0.2875000
NODE_10847_length_833_cov_38.153951	364	444	4	44	80	0.5500000
NODE_10847_length_833_cov_38.153951	417	497	0	12	80	0.1500000
NODE_10847_length_833_cov_38.153951	417	497	2	37	80	0.4625000
NODE_10847_length_833_cov_38.153951	417	497	4	31	80	0.3875000
NODE_10848_length_833_cov_34.302452	368	448	0	33	80	0.4125000
NODE_10848_length_833_cov_34.302452	368	448	4	28	80	0.3500000
NODE_10848_length_833_cov_34.302452	368	448	6	19	80	0.2375000
NODE_10848_length_833_cov_34.302452	421	501	4	8	80	0.1000000
NODE_10848_length_833_cov_34.302452	421	501	6	72	80	0.9000000
NODE_10849_length_833_cov_20.452316	311	392	0	81	81	1.0000000
NODE_10849_length_833_cov_20.452316	365	445	0	80	80	1.0000000
NODE_10850_length_833_cov_16.643052	238	318	0	80	80	1.0000000
NODE_10851_length_833_cov_16.536785	84	164	0	80	80	1.0000000
NODE_10851_length_833_cov_16.536785	137	217	0	80	80	1.0000000
NODE_10865_length_833_cov_3.089918	467	547	0	80	80	1.0000000
NODE_10865_length_833_cov_3.089918	520	600	0	80	80	1.0000000
NODE_10891_length_832_cov_35.728513	460	540	0	80	80	1.0000000
NODE_10891_length_832_cov_35.728513	513	593	0	80	80	1.0000000
NODE_10892_length_832_cov_25.450205	292	372	0	78	80	0.9750000
NODE_10892_length_832_cov_25.450205	292	372	4	2	80	0.0250000
NODE_10892_length_832_cov_25.450205	345	425	0	25	80	0.3125000
NODE_10892_length_832_cov_25.450205	345	425	4	55	80	0.6875000
NODE_10893_length_832_cov_18.858117	428	508	1	22	80	0.2750000
NODE_10893_length_832_cov_18.858117	428	508	2	58	80	0.7250000
NODE_10893_length_832_cov_18.858117	481	561	1	75	80	0.9375000
NODE_10893_length_832_cov_18.858117	481	561	2	5	80	0.0625000
NODE_10894_length_832_cov_17.799454	314	394	0	80	80	1.0000000
NODE_10894_length_832_cov_17.799454	367	447	0	80	80	1.0000000
NODE_10895_length_832_cov_14.811733	353	433	0	80	80	1.0000000
NODE_10896_length_832_cov_14.770805	259	339	0	80	80	1.0000000
NODE_10896_length_832_cov_14.770805	312	392	0	80	80	1.0000000
NODE_10897_length_832_cov_8.305593	266	346	0	80	80	1.0000000
NODE_10897_length_832_cov_8.305593	319	399	0	80	80	1.0000000
NODE_10918_length_831_cov_18.403005	371	451	0	80	80	1.0000000
NODE_10918_length_831_cov_18.403005	424	504	0	80	80	1.0000000
NODE_10919_length_831_cov_16.017760	357	437	0	7	80	0.0875000
NODE_10919_length_831_cov_16.017760	357	437	1	9	80	0.1125000
NODE_10919_length_831_cov_16.017760	357	437	2	25	80	0.3125000
NODE_10919_length_831_cov_16.017760	357	437	4	22	80	0.2750000
NODE_10919_length_831_cov_16.017760	357	437	10	17	80	0.2125000
NODE_10919_length_831_cov_16.017760	410	490	4	10	80	0.1250000
NODE_10919_length_831_cov_16.017760	410	490	8	23	80	0.2875000
NODE_10919_length_831_cov_16.017760	410	490	10	47	80	0.5875000
NODE_10920_length_831_cov_13.740437	405	485	0	80	80	1.0000000
NODE_10920_length_831_cov_13.740437	458	538	0	80	80	1.0000000
NODE_10921_length_831_cov_9.595628	281	361	0	48	80	0.6000000
NODE_10921_length_831_cov_9.595628	281	361	4	32	80	0.4000000
NODE_10921_length_831_cov_9.595628	334	414	0	39	80	0.4875000
NODE_10921_length_831_cov_9.595628	334	414	2	41	80	0.5125000
NODE_10922_length_831_cov_8.199454	433	482	14	49	49	1.0000000
NODE_10923_length_831_cov_7.607923	216	296	0	27	80	0.3375000
NODE_10923_length_831_cov_7.607923	216	296	2	53	80	0.6625000
NODE_10923_length_831_cov_7.607923	269	349	2	80	80	1.0000000
NODE_10924_length_831_cov_6.454918	334	409	0	75	75	1.0000000
NODE_10924_length_831_cov_6.454918	382	462	0	80	80	1.0000000
NODE_10960_length_830_cov_40.856361	238	318	0	80	80	1.0000000
NODE_10960_length_830_cov_40.856361	291	371	0	80	80	1.0000000
NODE_10961_length_830_cov_32.170999	302	378	0	76	76	1.0000000
NODE_10961_length_830_cov_32.170999	303	383	0	80	80	1.0000000
NODE_10961_length_830_cov_32.170999	356	436	0	80	80	1.0000000
NODE_10962_length_830_cov_28.041040	393	473	0	80	80	1.0000000
NODE_10962_length_830_cov_28.041040	446	526	0	80	80	1.0000000
NODE_10963_length_830_cov_20.280438	360	440	0	80	80	1.0000000
NODE_10963_length_830_cov_20.280438	413	492	0	79	79	1.0000000
NODE_10964_length_830_cov_19.495212	274	354	0	80	80	1.0000000
NODE_10964_length_830_cov_19.495212	327	407	0	80	80	1.0000000
NODE_10965_length_830_cov_18.522572	368	448	0	80	80	1.0000000
NODE_10965_length_830_cov_18.522572	421	501	0	80	80	1.0000000
NODE_10966_length_830_cov_13.830369	278	358	0	61	80	0.7625000
NODE_10966_length_830_cov_13.830369	278	358	2	19	80	0.2375000
NODE_10966_length_830_cov_13.830369	331	411	0	80	80	1.0000000
NODE_10967_length_830_cov_12.459644	201	281	0	40	80	0.5000000
NODE_10967_length_830_cov_12.459644	201	281	2	40	80	0.5000000
NODE_10967_length_830_cov_12.459644	254	334	0	21	80	0.2625000
NODE_10967_length_830_cov_12.459644	254	334	2	59	80	0.7375000
NODE_10968_length_830_cov_8.344733	450	530	0	11	80	0.1375000
NODE_10968_length_830_cov_8.344733	450	530	2	52	80	0.6500000
NODE_10968_length_830_cov_8.344733	450	530	4	17	80	0.2125000
NODE_10968_length_830_cov_8.344733	503	583	2	10	80	0.1250000
NODE_10968_length_830_cov_8.344733	503	583	4	59	80	0.7375000
NODE_10968_length_830_cov_8.344733	503	583	6	11	80	0.1375000
NODE_10969_length_830_cov_8.227086	634	714	3	80	80	1.0000000
NODE_10969_length_830_cov_8.227086	687	767	3	80	80	1.0000000
NODE_10995_length_829_cov_74.910959	271	351	0	16	80	0.2000000
NODE_10995_length_829_cov_74.910959	271	351	4	64	80	0.8000000
NODE_10995_length_829_cov_74.910959	324	404	4	80	80	1.0000000
NODE_10996_length_829_cov_34.068493	302	382	0	80	80	1.0000000
NODE_10996_length_829_cov_34.068493	355	435	0	80	80	1.0000000
NODE_10997_length_829_cov_24.027397	441	521	2	19	80	0.2375000
NODE_10997_length_829_cov_24.027397	441	521	4	40	80	0.5000000
NODE_10997_length_829_cov_24.027397	441	521	6	21	80	0.2625000
NODE_10997_length_829_cov_24.027397	494	574	2	62	80	0.7750000
NODE_10997_length_829_cov_24.027397	494	574	4	1	80	0.0125000
NODE_10997_length_829_cov_24.027397	494	574	6	17	80	0.2125000
NODE_10998_length_829_cov_21.735616	420	500	0	39	80	0.4875000
NODE_10998_length_829_cov_21.735616	420	500	4	41	80	0.5125000
NODE_10998_length_829_cov_21.735616	473	553	4	80	80	1.0000000
NODE_10999_length_829_cov_18.446575	407	487	0	80	80	1.0000000
NODE_10999_length_829_cov_18.446575	460	540	0	80	80	1.0000000
NODE_11000_length_829_cov_10.971233	368	448	0	22	80	0.2750000
NODE_11000_length_829_cov_10.971233	368	448	2	58	80	0.7250000
NODE_11000_length_829_cov_10.971233	421	501	0	75	80	0.9375000
NODE_11000_length_829_cov_10.971233	421	501	2	5	80	0.0625000
NODE_11001_length_829_cov_10.035616	387	467	0	80	80	1.0000000
NODE_11001_length_829_cov_10.035616	440	520	0	80	80	1.0000000
NODE_11002_length_829_cov_9.906849	326	406	0	80	80	1.0000000
NODE_11002_length_829_cov_9.906849	379	459	0	63	80	0.7875000
NODE_11002_length_829_cov_9.906849	379	459	1	17	80	0.2125000
NODE_11003_length_829_cov_8.809589	450	530	0	80	80	1.0000000
NODE_11003_length_829_cov_8.809589	503	583	0	80	80	1.0000000
NODE_11006_length_829_cov_4.310959	473	553	0	80	80	1.0000000
NODE_11006_length_829_cov_4.310959	526	606	0	80	80	1.0000000
NODE_11008_length_829_cov_3.079452	507	587	4	20	80	0.2500000
NODE_11008_length_829_cov_3.079452	507	587	6	60	80	0.7500000
NODE_11008_length_829_cov_3.079452	507	587	4	20	80	0.2500000
NODE_11008_length_829_cov_3.079452	507	587	6	60	80	0.7500000
NODE_11008_length_829_cov_3.079452	560	640	0	38	80	0.4750000
NODE_11008_length_829_cov_3.079452	560	640	4	31	80	0.3875000
NODE_11008_length_829_cov_3.079452	560	640	6	11	80	0.1375000
NODE_11025_length_828_cov_41.116598	436	516	0	28	80	0.3500000
NODE_11025_length_828_cov_41.116598	436	516	4	4	80	0.0500000
NODE_11025_length_828_cov_41.116598	436	516	6	48	80	0.6000000
NODE_11025_length_828_cov_41.116598	489	569	6	28	80	0.3500000
NODE_11025_length_828_cov_41.116598	489	569	7	18	80	0.2250000
NODE_11025_length_828_cov_41.116598	489	569	8	34	80	0.4250000
NODE_11026_length_828_cov_36.459534	372	452	0	57	80	0.7125000
NODE_11026_length_828_cov_36.459534	372	452	2	23	80	0.2875000
NODE_11026_length_828_cov_36.459534	425	505	0	4	80	0.0500000
NODE_11026_length_828_cov_36.459534	425	505	2	76	80	0.9500000
NODE_11027_length_828_cov_33.515775	443	523	2	4	80	0.0500000
NODE_11027_length_828_cov_33.515775	443	523	4	33	80	0.4125000
NODE_11027_length_828_cov_33.515775	443	523	6	12	80	0.1500000
NODE_11027_length_828_cov_33.515775	443	523	8	12	80	0.1500000
NODE_11027_length_828_cov_33.515775	443	523	10	19	80	0.2375000
NODE_11027_length_828_cov_33.515775	496	576	8	8	80	0.1000000
NODE_11027_length_828_cov_33.515775	496	576	10	72	80	0.9000000
NODE_11028_length_828_cov_21.123457	380	460	0	80	80	1.0000000
NODE_11028_length_828_cov_21.123457	433	513	0	80	80	1.0000000
NODE_11029_length_828_cov_17.406036	304	392	0	41	88	0.4659091
NODE_11029_length_828_cov_17.406036	304	392	2	37	88	0.4204545
NODE_11029_length_828_cov_17.406036	304	392	4	4	88	0.0454545
NODE_11029_length_828_cov_17.406036	304	392	6	6	88	0.0681818
NODE_11029_length_828_cov_17.406036	369	445	2	13	76	0.1710526
NODE_11029_length_828_cov_17.406036	369	445	4	4	76	0.0526316
NODE_11029_length_828_cov_17.406036	369	445	6	59	76	0.7763158
NODE_11030_length_828_cov_14.606310	287	367	2	7	80	0.0875000
NODE_11030_length_828_cov_14.606310	287	367	4	73	80	0.9125000
NODE_11030_length_828_cov_14.606310	340	420	0	14	80	0.1750000
NODE_11030_length_828_cov_14.606310	340	420	2	46	80	0.5750000
NODE_11030_length_828_cov_14.606310	340	420	4	20	80	0.2500000
NODE_11031_length_828_cov_14.493827	326	406	0	23	80	0.2875000
NODE_11031_length_828_cov_14.493827	326	406	2	13	80	0.1625000
NODE_11031_length_828_cov_14.493827	326	406	4	44	80	0.5500000
NODE_11031_length_828_cov_14.493827	379	459	0	18	80	0.2250000
NODE_11031_length_828_cov_14.493827	379	459	2	22	80	0.2750000
NODE_11031_length_828_cov_14.493827	379	459	4	40	80	0.5000000
NODE_11031_length_828_cov_14.493827	455	535	0	65	80	0.8125000
NODE_11031_length_828_cov_14.493827	455	535	2	15	80	0.1875000
NODE_11031_length_828_cov_14.493827	508	588	0	13	80	0.1625000
NODE_11031_length_828_cov_14.493827	508	588	2	67	80	0.8375000
NODE_11032_length_828_cov_10.550069	280	360	0	80	80	1.0000000
NODE_11032_length_828_cov_10.550069	333	413	0	80	80	1.0000000
NODE_11033_length_828_cov_9.292181	594	674	0	80	80	1.0000000
NODE_11033_length_828_cov_9.292181	647	727	0	80	80	1.0000000
NODE_11034_length_828_cov_8.747599	298	378	0	80	80	1.0000000
NODE_11034_length_828_cov_8.747599	351	431	0	80	80	1.0000000
NODE_11035_length_828_cov_8.098765	199	279	0	80	80	1.0000000
NODE_11035_length_828_cov_8.098765	252	332	0	80	80	1.0000000
NODE_11037_length_828_cov_7.473251	300	380	0	44	80	0.5500000
NODE_11037_length_828_cov_7.473251	300	380	2	36	80	0.4500000
NODE_11037_length_828_cov_7.473251	353	433	0	80	80	1.0000000
NODE_11039_length_828_cov_5.481481	543	623	0	64	80	0.8000000
NODE_11039_length_828_cov_5.481481	543	623	2	16	80	0.2000000
NODE_11039_length_828_cov_5.481481	596	676	0	11	80	0.1375000
NODE_11039_length_828_cov_5.481481	596	676	2	69	80	0.8625000
NODE_11041_length_828_cov_5.069959	259	339	0	80	80	1.0000000
NODE_11066_length_827_cov_34.567308	269	349	0	80	80	1.0000000
NODE_11066_length_827_cov_34.567308	322	402	0	80	80	1.0000000
NODE_11066_length_827_cov_34.567308	398	478	0	80	80	1.0000000
NODE_11066_length_827_cov_34.567308	451	531	0	63	80	0.7875000
NODE_11066_length_827_cov_34.567308	451	531	2	17	80	0.2125000
NODE_11067_length_827_cov_31.538462	320	400	0	32	80	0.4000000
NODE_11067_length_827_cov_31.538462	320	400	10	1	80	0.0125000
NODE_11067_length_827_cov_31.538462	320	400	11	12	80	0.1500000
NODE_11067_length_827_cov_31.538462	320	400	15	19	80	0.2375000
NODE_11067_length_827_cov_31.538462	320	400	16	16	80	0.2000000
NODE_11067_length_827_cov_31.538462	373	453	4	3	80	0.0375000
NODE_11067_length_827_cov_31.538462	373	453	15	11	80	0.1375000
NODE_11067_length_827_cov_31.538462	373	453	16	66	80	0.8250000
NODE_11068_length_827_cov_19.548077	464	544	0	60	80	0.7500000
NODE_11068_length_827_cov_19.548077	464	544	2	20	80	0.2500000
NODE_11068_length_827_cov_19.548077	517	597	0	24	80	0.3000000
NODE_11068_length_827_cov_19.548077	517	597	2	56	80	0.7000000
NODE_11069_length_827_cov_17.490385	320	400	0	2	80	0.0250000
NODE_11069_length_827_cov_17.490385	320	400	4	78	80	0.9750000
NODE_11069_length_827_cov_17.490385	373	453	0	14	80	0.1750000
NODE_11069_length_827_cov_17.490385	373	453	4	66	80	0.8250000
NODE_11070_length_827_cov_15.247253	205	285	0	80	80	1.0000000
NODE_11070_length_827_cov_15.247253	258	338	0	80	80	1.0000000
NODE_11071_length_827_cov_14.151099	372	452	0	80	80	1.0000000
NODE_11071_length_827_cov_14.151099	425	505	0	80	80	1.0000000
NODE_11072_length_827_cov_12.157967	262	342	0	80	80	1.0000000
NODE_11072_length_827_cov_12.157967	315	395	0	80	80	1.0000000
NODE_11073_length_827_cov_11.777473	316	396	0	80	80	1.0000000
NODE_11073_length_827_cov_11.777473	369	449	0	80	80	1.0000000
NODE_11074_length_827_cov_11.651099	393	473	0	19	80	0.2375000
NODE_11074_length_827_cov_11.651099	393	473	4	61	80	0.7625000
NODE_11074_length_827_cov_11.651099	446	526	2	14	80	0.1750000
NODE_11074_length_827_cov_11.651099	446	526	4	56	80	0.7000000
NODE_11074_length_827_cov_11.651099	446	526	6	10	80	0.1250000
NODE_11075_length_827_cov_10.711538	286	366	0	80	80	1.0000000
NODE_11075_length_827_cov_10.711538	339	419	0	80	80	1.0000000
NODE_11076_length_827_cov_10.262363	273	353	0	80	80	1.0000000
NODE_11076_length_827_cov_10.262363	326	406	0	80	80	1.0000000
NODE_11077_length_827_cov_10.221154	256	336	0	10	80	0.1250000
NODE_11077_length_827_cov_10.221154	256	336	6	70	80	0.8750000
NODE_11078_length_827_cov_9.576923	359	439	0	3	80	0.0375000
NODE_11078_length_827_cov_9.576923	359	439	6	77	80	0.9625000
NODE_11078_length_827_cov_9.576923	412	492	0	45	80	0.5625000
NODE_11078_length_827_cov_9.576923	412	492	2	11	80	0.1375000
NODE_11078_length_827_cov_9.576923	412	492	6	24	80	0.3000000
NODE_11079_length_827_cov_8.780220	361	441	0	6	80	0.0750000
NODE_11079_length_827_cov_8.780220	361	441	2	29	80	0.3625000
NODE_11079_length_827_cov_8.780220	361	441	5	1	80	0.0125000
NODE_11079_length_827_cov_8.780220	361	441	6	12	80	0.1500000
NODE_11079_length_827_cov_8.780220	361	441	10	4	80	0.0500000
NODE_11079_length_827_cov_8.780220	361	441	12	28	80	0.3500000
NODE_11079_length_827_cov_8.780220	414	494	9	14	80	0.1750000
NODE_11079_length_827_cov_8.780220	414	494	10	10	80	0.1250000
NODE_11079_length_827_cov_8.780220	414	494	11	6	80	0.0750000
NODE_11079_length_827_cov_8.780220	414	494	12	50	80	0.6250000
NODE_11093_length_827_cov_1.412088	736	784	2	48	48	1.0000000
NODE_11106_length_826_cov_34.026135	211	291	0	37	80	0.4625000
NODE_11106_length_826_cov_34.026135	211	291	4	43	80	0.5375000
NODE_11106_length_826_cov_34.026135	264	344	0	13	80	0.1625000
NODE_11106_length_826_cov_34.026135	264	344	4	67	80	0.8375000
NODE_11107_length_826_cov_24.093535	282	362	0	80	80	1.0000000
NODE_11107_length_826_cov_24.093535	335	415	0	80	80	1.0000000
NODE_11108_length_826_cov_20.943604	207	287	2	80	80	1.0000000
NODE_11108_length_826_cov_20.943604	260	340	0	46	80	0.5750000
NODE_11108_length_826_cov_20.943604	260	340	2	34	80	0.4250000
NODE_11109_length_826_cov_20.437414	413	493	0	80	80	1.0000000
NODE_11109_length_826_cov_20.437414	466	546	0	80	80	1.0000000
NODE_11110_length_826_cov_20.200825	432	512	0	80	80	1.0000000
NODE_11110_length_826_cov_20.200825	485	565	0	80	80	1.0000000
NODE_11111_length_826_cov_18.489684	345	425	0	33	80	0.4125000
NODE_11111_length_826_cov_18.489684	345	425	4	47	80	0.5875000
NODE_11111_length_826_cov_18.489684	398	478	4	80	80	1.0000000
NODE_11112_length_826_cov_17.998624	336	416	0	80	80	1.0000000
NODE_11112_length_826_cov_17.998624	389	469	0	80	80	1.0000000
NODE_11113_length_826_cov_17.038514	358	438	0	43	80	0.5375000
NODE_11113_length_826_cov_17.038514	358	438	2	37	80	0.4625000
NODE_11113_length_826_cov_17.038514	411	491	0	80	80	1.0000000
NODE_11114_length_826_cov_16.777166	514	603	0	89	89	1.0000000
NODE_11115_length_826_cov_16.177442	361	441	4	80	80	1.0000000
NODE_11115_length_826_cov_16.177442	414	494	2	25	80	0.3125000
NODE_11115_length_826_cov_16.177442	414	494	4	55	80	0.6875000
NODE_11116_length_826_cov_15.134801	346	426	0	80	80	1.0000000
NODE_11116_length_826_cov_15.134801	399	479	0	80	80	1.0000000
NODE_11117_length_826_cov_9.943604	320	400	0	80	80	1.0000000
NODE_11117_length_826_cov_9.943604	373	453	0	80	80	1.0000000
NODE_11120_length_826_cov_4.852820	501	579	0	78	78	1.0000000
NODE_11120_length_826_cov_4.852820	552	632	0	80	80	1.0000000
NODE_11161_length_825_cov_61.804408	382	462	0	33	80	0.4125000
NODE_11161_length_825_cov_61.804408	382	462	2	47	80	0.5875000
NODE_11161_length_825_cov_61.804408	435	514	0	27	79	0.3417721
NODE_11161_length_825_cov_61.804408	435	514	1	1	79	0.0126582
NODE_11161_length_825_cov_61.804408	435	514	2	51	79	0.6455696
NODE_11162_length_825_cov_43.825069	488	568	0	48	80	0.6000000
NODE_11162_length_825_cov_43.825069	488	568	2	20	80	0.2500000
NODE_11162_length_825_cov_43.825069	488	568	4	12	80	0.1500000
NODE_11162_length_825_cov_43.825069	541	621	2	15	80	0.1875000
NODE_11162_length_825_cov_43.825069	541	621	4	65	80	0.8125000
NODE_11162_length_825_cov_43.825069	617	697	0	62	80	0.7750000
NODE_11162_length_825_cov_43.825069	617	697	2	6	80	0.0750000
NODE_11162_length_825_cov_43.825069	617	697	4	12	80	0.1500000
NODE_11162_length_825_cov_43.825069	670	750	0	80	80	1.0000000
NODE_11163_length_825_cov_43.389807	496	576	0	20	80	0.2500000
NODE_11163_length_825_cov_43.389807	496	576	2	8	80	0.1000000
NODE_11163_length_825_cov_43.389807	496	576	4	52	80	0.6500000
NODE_11163_length_825_cov_43.389807	549	629	0	42	80	0.5250000
NODE_11163_length_825_cov_43.389807	549	629	4	38	80	0.4750000
NODE_11164_length_825_cov_39.603306	386	466	0	80	80	1.0000000
NODE_11164_length_825_cov_39.603306	439	519	0	80	80	1.0000000
NODE_11165_length_825_cov_32.205234	354	434	8	2	80	0.0250000
NODE_11165_length_825_cov_32.205234	354	434	15	1	80	0.0125000
NODE_11165_length_825_cov_32.205234	354	434	16	77	80	0.9625000
NODE_11165_length_825_cov_32.205234	407	487	0	14	80	0.1750000
NODE_11165_length_825_cov_32.205234	407	487	8	41	80	0.5125000
NODE_11165_length_825_cov_32.205234	407	487	15	1	80	0.0125000
NODE_11165_length_825_cov_32.205234	407	487	16	24	80	0.3000000
NODE_11166_length_825_cov_29.411846	503	583	0	80	80	1.0000000
NODE_11166_length_825_cov_29.411846	556	636	0	80	80	1.0000000
NODE_11167_length_825_cov_22.428375	312	392	0	10	80	0.1250000
NODE_11167_length_825_cov_22.428375	312	392	4	70	80	0.8750000
NODE_11167_length_825_cov_22.428375	365	445	0	1	80	0.0125000
NODE_11167_length_825_cov_22.428375	365	445	2	51	80	0.6375000
NODE_11167_length_825_cov_22.428375	365	445	3	1	80	0.0125000
NODE_11167_length_825_cov_22.428375	365	445	4	27	80	0.3375000
NODE_11167_length_825_cov_22.428375	441	521	2	31	80	0.3875000
NODE_11167_length_825_cov_22.428375	441	521	4	36	80	0.4500000
NODE_11167_length_825_cov_22.428375	441	521	6	13	80	0.1625000
NODE_11167_length_825_cov_22.428375	494	574	2	30	80	0.3750000
NODE_11167_length_825_cov_22.428375	494	574	4	37	80	0.4625000
NODE_11167_length_825_cov_22.428375	494	574	6	13	80	0.1625000
NODE_11168_length_825_cov_19.964187	249	329	0	4	80	0.0500000
NODE_11168_length_825_cov_19.964187	249	329	2	76	80	0.9500000
NODE_11168_length_825_cov_19.964187	302	382	0	26	80	0.3250000
NODE_11168_length_825_cov_19.964187	302	382	2	54	80	0.6750000
NODE_11169_length_825_cov_13.790634	273	353	6	80	80	1.0000000
NODE_11169_length_825_cov_13.790634	326	406	0	39	80	0.4875000
NODE_11169_length_825_cov_13.790634	326	406	6	41	80	0.5125000
NODE_11170_length_825_cov_11.834711	331	411	0	80	80	1.0000000
NODE_11170_length_825_cov_11.834711	384	464	0	80	80	1.0000000
NODE_11171_length_825_cov_11.477961	392	472	2	2	80	0.0250000
NODE_11171_length_825_cov_11.477961	392	472	4	17	80	0.2125000
NODE_11171_length_825_cov_11.477961	392	472	6	35	80	0.4375000
NODE_11171_length_825_cov_11.477961	392	472	8	26	80	0.3250000
NODE_11172_length_825_cov_8.947658	259	339	0	80	80	1.0000000
NODE_11172_length_825_cov_8.947658	312	392	0	80	80	1.0000000
NODE_11173_length_825_cov_7.811295	379	459	0	80	80	1.0000000
NODE_11173_length_825_cov_7.811295	432	512	0	77	80	0.9625000
NODE_11173_length_825_cov_7.811295	432	512	2	3	80	0.0375000
NODE_11174_length_825_cov_7.104683	464	544	0	80	80	1.0000000
NODE_11174_length_825_cov_7.104683	517	597	0	80	80	1.0000000
NODE_11176_length_825_cov_6.252066	542	622	0	80	80	1.0000000
NODE_11176_length_825_cov_6.252066	595	675	0	80	80	1.0000000
NODE_11178_length_825_cov_5.230028	264	344	0	80	80	1.0000000
NODE_11178_length_825_cov_5.230028	317	372	0	55	55	1.0000000
NODE_11178_length_825_cov_5.230028	383	463	0	3	80	0.0375000
NODE_11178_length_825_cov_5.230028	383	463	3	10	80	0.1250000
NODE_11178_length_825_cov_5.230028	383	463	6	67	80	0.8375000
NODE_11178_length_825_cov_5.230028	436	516	6	80	80	1.0000000
NODE_11205_length_825_cov_0.765840	0	50	0	50	50	1.0000000
NODE_11207_length_824_cov_27.074483	337	412	0	75	75	1.0000000
NODE_11207_length_824_cov_27.074483	390	470	0	80	80	1.0000000
NODE_11208_length_824_cov_23.936552	365	445	0	80	80	1.0000000
NODE_11208_length_824_cov_23.936552	418	493	0	75	75	1.0000000
NODE_11209_length_824_cov_22.129655	377	457	2	80	80	1.0000000
NODE_11209_length_824_cov_22.129655	430	510	0	51	80	0.6375000
NODE_11209_length_824_cov_22.129655	430	510	2	29	80	0.3625000
NODE_11210_length_824_cov_17.914483	387	467	0	80	80	1.0000000
NODE_11210_length_824_cov_17.914483	440	520	0	80	80	1.0000000
NODE_11211_length_824_cov_16.662069	362	442	0	80	80	1.0000000
NODE_11211_length_824_cov_16.662069	415	495	0	80	80	1.0000000
NODE_11212_length_824_cov_16.306207	352	432	0	80	80	1.0000000
NODE_11212_length_824_cov_16.306207	405	485	0	80	80	1.0000000
NODE_11213_length_824_cov_15.891034	342	422	0	26	80	0.3250000
NODE_11213_length_824_cov_15.891034	342	422	2	54	80	0.6750000
NODE_11213_length_824_cov_15.891034	395	475	0	13	80	0.1625000
NODE_11213_length_824_cov_15.891034	395	475	2	67	80	0.8375000
NODE_11214_length_824_cov_12.485517	280	360	2	18	80	0.2250000
NODE_11214_length_824_cov_12.485517	280	360	4	45	80	0.5625000
NODE_11214_length_824_cov_12.485517	280	360	6	17	80	0.2125000
NODE_11214_length_824_cov_12.485517	333	413	2	71	80	0.8875000
NODE_11214_length_824_cov_12.485517	333	413	6	9	80	0.1125000
NODE_11216_length_824_cov_5.924138	269	349	2	80	80	1.0000000
NODE_11216_length_824_cov_5.924138	322	402	0	51	80	0.6375000
NODE_11216_length_824_cov_5.924138	322	402	2	29	80	0.3625000
NODE_11222_length_824_cov_3.849655	191	271	0	80	80	1.0000000
NODE_11251_length_823_cov_75.169890	207	287	5	4	80	0.0500000
NODE_11251_length_823_cov_75.169890	207	287	6	76	80	0.9500000
NODE_11251_length_823_cov_75.169890	260	340	5	57	80	0.7125000
NODE_11251_length_823_cov_75.169890	260	340	6	23	80	0.2875000
NODE_11251_length_823_cov_75.169890	336	416	0	51	80	0.6375000
NODE_11251_length_823_cov_75.169890	336	416	3	14	80	0.1750000
NODE_11251_length_823_cov_75.169890	336	416	5	15	80	0.1875000
NODE_11251_length_823_cov_75.169890	389	469	0	80	80	1.0000000
NODE_11253_length_823_cov_37.738950	332	412	0	79	80	0.9875000
NODE_11253_length_823_cov_37.738950	332	412	2	1	80	0.0125000
NODE_11253_length_823_cov_37.738950	385	466	0	81	81	1.0000000
NODE_11254_length_823_cov_29.349448	400	480	0	80	80	1.0000000
NODE_11254_length_823_cov_29.349448	453	533	0	80	80	1.0000000
NODE_11255_length_823_cov_25.730663	338	418	5	8	80	0.1000000
NODE_11255_length_823_cov_25.730663	338	418	9	44	80	0.5500000
NODE_11255_length_823_cov_25.730663	338	418	17	28	80	0.3500000
NODE_11255_length_823_cov_25.730663	391	471	8	20	80	0.2500000
NODE_11255_length_823_cov_25.730663	391	471	12	12	80	0.1500000
NODE_11255_length_823_cov_25.730663	391	471	14	3	80	0.0375000
NODE_11255_length_823_cov_25.730663	391	471	17	45	80	0.5625000
NODE_11256_length_823_cov_24.599448	349	429	0	4	80	0.0500000
NODE_11256_length_823_cov_24.599448	349	429	2	76	80	0.9500000
NODE_11256_length_823_cov_24.599448	402	482	0	35	80	0.4375000
NODE_11256_length_823_cov_24.599448	402	482	2	45	80	0.5625000
NODE_11257_length_823_cov_22.149171	356	436	0	29	80	0.3625000
NODE_11257_length_823_cov_22.149171	356	436	2	51	80	0.6375000
NODE_11257_length_823_cov_22.149171	409	489	0	80	80	1.0000000
NODE_11257_length_823_cov_22.149171	485	565	0	80	80	1.0000000
NODE_11257_length_823_cov_22.149171	538	618	0	80	80	1.0000000
NODE_11258_length_823_cov_20.892265	329	409	0	80	80	1.0000000
NODE_11258_length_823_cov_20.892265	382	462	0	33	80	0.4125000
NODE_11258_length_823_cov_20.892265	382	462	4	47	80	0.5875000
NODE_11259_length_823_cov_19.281768	305	385	0	16	80	0.2000000
NODE_11259_length_823_cov_19.281768	305	385	2	64	80	0.8000000
NODE_11259_length_823_cov_19.281768	358	438	2	53	80	0.6625000
NODE_11259_length_823_cov_19.281768	358	438	4	27	80	0.3375000
NODE_11260_length_823_cov_15.738950	409	489	0	80	80	1.0000000
NODE_11260_length_823_cov_15.738950	462	542	0	80	80	1.0000000
NODE_11261_length_823_cov_10.729282	362	437	0	75	75	1.0000000
NODE_11261_length_823_cov_10.729282	410	484	0	74	74	1.0000000
NODE_11262_length_823_cov_9.110497	394	474	0	80	80	1.0000000
NODE_11262_length_823_cov_9.110497	447	527	0	80	80	1.0000000
NODE_11265_length_823_cov_5.511050	168	248	4	76	80	0.9500000
NODE_11265_length_823_cov_5.511050	168	248	6	4	80	0.0500000
NODE_11265_length_823_cov_5.511050	434	485	0	9	51	0.1764706
NODE_11265_length_823_cov_5.511050	434	485	2	42	51	0.8235294
NODE_11292_length_823_cov_0.968232	86	154	0	20	68	0.2941177
NODE_11292_length_823_cov_0.968232	86	154	2	3	68	0.0441176
NODE_11292_length_823_cov_0.968232	86	154	4	13	68	0.1911765
NODE_11292_length_823_cov_0.968232	86	154	6	27	68	0.3970588
NODE_11292_length_823_cov_0.968232	86	154	8	5	68	0.0735294
NODE_11298_length_822_cov_25.423237	377	459	4	82	82	1.0000000
NODE_11298_length_822_cov_25.423237	432	512	0	42	80	0.5250000
NODE_11298_length_822_cov_25.423237	432	512	3	1	80	0.0125000
NODE_11298_length_822_cov_25.423237	432	512	4	37	80	0.4625000
NODE_11299_length_822_cov_16.381743	394	474	0	80	80	1.0000000
NODE_11299_length_822_cov_16.381743	447	527	0	80	80	1.0000000
NODE_11300_length_822_cov_12.426003	223	296	0	57	73	0.7808219
NODE_11300_length_822_cov_12.426003	223	296	4	16	73	0.2191781
NODE_11300_length_822_cov_12.426003	278	349	0	2	71	0.0281690
NODE_11300_length_822_cov_12.426003	278	349	4	69	71	0.9718310
NODE_11301_length_822_cov_10.608575	464	544	0	31	80	0.3875000
NODE_11301_length_822_cov_10.608575	464	544	1	10	80	0.1250000
NODE_11301_length_822_cov_10.608575	464	544	2	14	80	0.1750000
NODE_11301_length_822_cov_10.608575	464	544	4	25	80	0.3125000
NODE_11301_length_822_cov_10.608575	517	597	2	24	80	0.3000000
NODE_11301_length_822_cov_10.608575	517	597	4	56	80	0.7000000
NODE_11302_length_822_cov_9.496542	363	443	0	80	80	1.0000000
NODE_11302_length_822_cov_9.496542	416	496	0	80	80	1.0000000
NODE_11333_length_821_cov_39.818560	341	420	2	64	79	0.8101266
NODE_11333_length_821_cov_39.818560	341	420	6	15	79	0.1898734
NODE_11333_length_821_cov_39.818560	393	473	2	12	80	0.1500000
NODE_11333_length_821_cov_39.818560	393	473	4	19	80	0.2375000
NODE_11333_length_821_cov_39.818560	393	473	6	49	80	0.6125000
NODE_11334_length_821_cov_27.721607	299	379	0	50	80	0.6250000
NODE_11334_length_821_cov_27.721607	299	379	2	30	80	0.3750000
NODE_11334_length_821_cov_27.721607	352	432	0	80	80	1.0000000
NODE_11335_length_821_cov_26.252078	386	466	6	14	80	0.1750000
NODE_11335_length_821_cov_26.252078	386	466	8	1	80	0.0125000
NODE_11335_length_821_cov_26.252078	386	466	9	19	80	0.2375000
NODE_11335_length_821_cov_26.252078	386	466	11	4	80	0.0500000
NODE_11335_length_821_cov_26.252078	386	466	13	1	80	0.0125000
NODE_11335_length_821_cov_26.252078	386	466	14	41	80	0.5125000
NODE_11335_length_821_cov_26.252078	439	519	0	42	80	0.5250000
NODE_11335_length_821_cov_26.252078	439	519	5	1	80	0.0125000
NODE_11335_length_821_cov_26.252078	439	519	6	24	80	0.3000000
NODE_11335_length_821_cov_26.252078	439	519	8	1	80	0.0125000
NODE_11335_length_821_cov_26.252078	439	519	9	12	80	0.1500000
NODE_11336_length_821_cov_19.603878	353	433	0	80	80	1.0000000
NODE_11336_length_821_cov_19.603878	406	486	0	80	80	1.0000000
NODE_11337_length_821_cov_15.945983	310	390	0	80	80	1.0000000
NODE_11337_length_821_cov_15.945983	363	443	0	80	80	1.0000000
NODE_11339_length_821_cov_8.711911	288	368	0	80	80	1.0000000
NODE_11339_length_821_cov_8.711911	341	421	0	80	80	1.0000000
NODE_11349_length_821_cov_3.026316	310	390	0	80	80	1.0000000
NODE_11349_length_821_cov_3.026316	363	443	0	80	80	1.0000000
NODE_11361_length_820_cov_67.292649	328	408	0	51	80	0.6375000
NODE_11361_length_820_cov_67.292649	328	408	2	5	80	0.0625000
NODE_11361_length_820_cov_67.292649	328	408	5	1	80	0.0125000
NODE_11361_length_820_cov_67.292649	328	408	6	4	80	0.0500000
NODE_11361_length_820_cov_67.292649	328	408	12	19	80	0.2375000
NODE_11361_length_820_cov_67.292649	381	461	0	3	80	0.0375000
NODE_11361_length_820_cov_67.292649	381	461	5	1	80	0.0125000
NODE_11361_length_820_cov_67.292649	381	461	6	6	80	0.0750000
NODE_11361_length_820_cov_67.292649	381	461	12	70	80	0.8750000
NODE_11362_length_820_cov_26.915395	308	388	0	23	80	0.2875000
NODE_11362_length_820_cov_26.915395	308	388	2	57	80	0.7125000
NODE_11363_length_820_cov_25.253814	301	381	2	9	80	0.1125000
NODE_11363_length_820_cov_25.253814	301	381	4	46	80	0.5750000
NODE_11363_length_820_cov_25.253814	301	381	6	10	80	0.1250000
NODE_11363_length_820_cov_25.253814	301	381	8	15	80	0.1875000
NODE_11363_length_820_cov_25.253814	354	434	0	35	80	0.4375000
NODE_11363_length_820_cov_25.253814	354	434	2	27	80	0.3375000
NODE_11363_length_820_cov_25.253814	354	434	4	18	80	0.2250000
NODE_11363_length_820_cov_25.253814	430	510	0	11	80	0.1375000
NODE_11363_length_820_cov_25.253814	430	510	2	13	80	0.1625000
NODE_11363_length_820_cov_25.253814	430	510	4	56	80	0.7000000
NODE_11363_length_820_cov_25.253814	483	563	0	5	80	0.0625000
NODE_11363_length_820_cov_25.253814	483	563	2	37	80	0.4625000
NODE_11363_length_820_cov_25.253814	483	563	4	38	80	0.4750000
NODE_11364_length_820_cov_16.015257	325	405	0	80	80	1.0000000
NODE_11364_length_820_cov_16.015257	378	458	0	80	80	1.0000000
NODE_11365_length_820_cov_14.703190	371	451	0	80	80	1.0000000
NODE_11365_length_820_cov_14.703190	424	504	0	80	80	1.0000000
NODE_11366_length_820_cov_14.527046	249	329	0	61	80	0.7625000
NODE_11366_length_820_cov_14.527046	249	329	3	19	80	0.2375000
NODE_11366_length_820_cov_14.527046	302	382	0	8	80	0.1000000
NODE_11366_length_820_cov_14.527046	302	382	3	22	80	0.2750000
NODE_11366_length_820_cov_14.527046	302	382	4	48	80	0.6000000
NODE_11366_length_820_cov_14.527046	302	382	6	2	80	0.0250000
NODE_11367_length_820_cov_14.284327	286	366	0	21	80	0.2625000
NODE_11367_length_820_cov_14.284327	286	366	2	38	80	0.4750000
NODE_11367_length_820_cov_14.284327	286	366	4	21	80	0.2625000
NODE_11367_length_820_cov_14.284327	339	419	2	6	80	0.0750000
NODE_11367_length_820_cov_14.284327	339	419	4	70	80	0.8750000
NODE_11367_length_820_cov_14.284327	339	419	6	4	80	0.0500000
NODE_11367_length_820_cov_14.284327	619	699	0	80	80	1.0000000
NODE_11368_length_820_cov_13.036061	364	444	0	80	80	1.0000000
NODE_11368_length_820_cov_13.036061	417	497	0	80	80	1.0000000
NODE_11369_length_820_cov_12.830791	313	393	0	80	80	1.0000000
NODE_11369_length_820_cov_12.830791	366	446	0	80	80	1.0000000
NODE_11370_length_820_cov_12.768377	366	443	0	77	77	1.0000000
NODE_11370_length_820_cov_12.768377	496	525	0	29	29	1.0000000
NODE_11371_length_820_cov_12.223301	452	519	0	67	67	1.0000000
NODE_11371_length_820_cov_12.223301	492	572	0	80	80	1.0000000
NODE_11396_length_819_cov_43.027778	403	483	0	80	80	1.0000000
NODE_11396_length_819_cov_43.027778	456	536	0	80	80	1.0000000
NODE_11396_length_819_cov_43.027778	532	612	0	80	80	1.0000000
NODE_11396_length_819_cov_43.027778	585	665	0	42	80	0.5250000
NODE_11396_length_819_cov_43.027778	585	665	2	6	80	0.0750000
NODE_11396_length_819_cov_43.027778	585	665	4	32	80	0.4000000
NODE_11397_length_819_cov_42.758333	391	471	0	6	80	0.0750000
NODE_11397_length_819_cov_42.758333	391	471	2	74	80	0.9250000
NODE_11397_length_819_cov_42.758333	444	524	0	8	80	0.1000000
NODE_11397_length_819_cov_42.758333	444	524	2	72	80	0.9000000
NODE_11398_length_819_cov_41.341667	86	166	2	80	80	1.0000000
NODE_11398_length_819_cov_41.341667	139	219	0	43	80	0.5375000
NODE_11398_length_819_cov_41.341667	139	219	2	37	80	0.4625000
NODE_11398_length_819_cov_41.341667	215	295	0	80	80	1.0000000
NODE_11398_length_819_cov_41.341667	268	348	0	80	80	1.0000000
NODE_11399_length_819_cov_23.656944	335	415	0	19	80	0.2375000
NODE_11399_length_819_cov_23.656944	335	415	2	61	80	0.7625000
NODE_11399_length_819_cov_23.656944	388	468	0	48	80	0.6000000
NODE_11399_length_819_cov_23.656944	388	468	2	32	80	0.4000000
NODE_11400_length_819_cov_20.633333	475	555	0	80	80	1.0000000
NODE_11400_length_819_cov_20.633333	528	608	0	80	80	1.0000000
NODE_11401_length_819_cov_18.941667	307	387	0	80	80	1.0000000
NODE_11401_length_819_cov_18.941667	360	440	0	80	80	1.0000000
NODE_11401_length_819_cov_18.941667	436	516	0	80	80	1.0000000
NODE_11401_length_819_cov_18.941667	489	569	0	78	80	0.9750000
NODE_11401_length_819_cov_18.941667	489	569	2	2	80	0.0250000
NODE_11402_length_819_cov_12.225000	431	511	0	18	80	0.2250000
NODE_11402_length_819_cov_12.225000	431	511	2	62	80	0.7750000
NODE_11402_length_819_cov_12.225000	484	564	0	14	80	0.1750000
NODE_11402_length_819_cov_12.225000	484	564	2	66	80	0.8250000
NODE_11403_length_819_cov_11.562500	273	353	0	80	80	1.0000000
NODE_11403_length_819_cov_11.562500	326	406	0	80	80	1.0000000
NODE_11404_length_819_cov_8.905556	477	557	0	80	80	1.0000000
NODE_11404_length_819_cov_8.905556	530	610	0	80	80	1.0000000
NODE_11405_length_819_cov_5.675000	232	312	0	80	80	1.0000000
NODE_11405_length_819_cov_5.675000	285	365	0	80	80	1.0000000
NODE_11431_length_818_cov_21.979138	342	422	0	80	80	1.0000000
NODE_11431_length_818_cov_21.979138	395	475	0	80	80	1.0000000
NODE_11432_length_818_cov_15.326843	334	414	0	8	80	0.1000000
NODE_11432_length_818_cov_15.326843	334	414	2	72	80	0.9000000
NODE_11432_length_818_cov_15.326843	387	467	0	24	80	0.3000000
NODE_11432_length_818_cov_15.326843	387	467	2	56	80	0.7000000
NODE_11433_length_818_cov_14.880389	392	472	0	80	80	1.0000000
NODE_11433_length_818_cov_14.880389	445	525	0	80	80	1.0000000
NODE_11434_length_818_cov_12.369958	390	470	0	80	80	1.0000000
NODE_11434_length_818_cov_12.369958	443	523	0	80	80	1.0000000
NODE_11436_length_818_cov_8.421419	370	450	0	80	80	1.0000000
NODE_11436_length_818_cov_8.421419	423	503	0	80	80	1.0000000
NODE_11437_length_818_cov_6.439499	706	741	2	33	35	0.9428571
NODE_11437_length_818_cov_6.439499	706	741	4	2	35	0.0571429
NODE_11439_length_818_cov_4.098748	320	390	0	14	70	0.2000000
NODE_11439_length_818_cov_4.098748	320	390	2	56	70	0.8000000
NODE_11439_length_818_cov_4.098748	416	472	2	18	56	0.3214286
NODE_11439_length_818_cov_4.098748	416	472	4	38	56	0.6785714
NODE_11457_length_817_cov_7.238162	494	574	0	80	80	1.0000000
NODE_11457_length_817_cov_7.238162	547	627	0	80	80	1.0000000
NODE_11458_length_817_cov_5.789694	400	480	4	2	80	0.0250000
NODE_11458_length_817_cov_5.789694	400	480	6	78	80	0.9750000
NODE_11458_length_817_cov_5.789694	476	555	0	28	79	0.3544304
NODE_11458_length_817_cov_5.789694	476	555	4	49	79	0.6202531
NODE_11458_length_817_cov_5.789694	476	555	6	2	79	0.0253165
NODE_11458_length_817_cov_5.789694	528	608	0	80	80	1.0000000
NODE_11462_length_817_cov_4.357939	433	513	0	80	80	1.0000000
NODE_11462_length_817_cov_4.357939	486	566	0	80	80	1.0000000
NODE_11486_length_817_cov_0.692201	626	696	2	4	70	0.0571429
NODE_11486_length_817_cov_0.692201	626	696	6	16	70	0.2285714
NODE_11486_length_817_cov_0.692201	626	696	8	24	70	0.3428572
NODE_11486_length_817_cov_0.692201	626	696	10	3	70	0.0428571
NODE_11486_length_817_cov_0.692201	626	696	12	7	70	0.1000000
NODE_11486_length_817_cov_0.692201	626	696	14	6	70	0.0857143
NODE_11486_length_817_cov_0.692201	626	696	16	1	70	0.0142857
NODE_11486_length_817_cov_0.692201	626	696	18	4	70	0.0571429
NODE_11486_length_817_cov_0.692201	626	696	20	5	70	0.0714286
NODE_11488_length_816_cov_69.800558	395	475	6	25	80	0.3125000
NODE_11488_length_816_cov_69.800558	395	475	8	5	80	0.0625000
NODE_11488_length_816_cov_69.800558	395	475	10	4	80	0.0500000
NODE_11488_length_816_cov_69.800558	395	475	37	1	80	0.0125000
NODE_11488_length_816_cov_69.800558	395	475	38	1	80	0.0125000
NODE_11488_length_816_cov_69.800558	395	475	39	29	80	0.3625000
NODE_11488_length_816_cov_69.800558	395	475	40	15	80	0.1875000
NODE_11488_length_816_cov_69.800558	448	520	9	5	72	0.0694444
NODE_11488_length_816_cov_69.800558	448	520	10	1	72	0.0138889
NODE_11488_length_816_cov_69.800558	448	520	11	1	72	0.0138889
NODE_11488_length_816_cov_69.800558	448	520	17	4	72	0.0555556
NODE_11488_length_816_cov_69.800558	448	520	19	2	72	0.0277778
NODE_11488_length_816_cov_69.800558	448	520	20	2	72	0.0277778
NODE_11488_length_816_cov_69.800558	448	520	21	1	72	0.0138889
NODE_11488_length_816_cov_69.800558	448	520	23	1	72	0.0138889
NODE_11488_length_816_cov_69.800558	448	520	27	8	72	0.1111111
NODE_11488_length_816_cov_69.800558	448	520	29	2	72	0.0277778
NODE_11488_length_816_cov_69.800558	448	520	34	1	72	0.0138889
NODE_11488_length_816_cov_69.800558	448	520	35	1	72	0.0138889
NODE_11488_length_816_cov_69.800558	448	520	36	6	72	0.0833333
NODE_11488_length_816_cov_69.800558	448	520	37	5	72	0.0694444
NODE_11488_length_816_cov_69.800558	448	520	39	17	72	0.2361111
NODE_11488_length_816_cov_69.800558	448	520	40	15	72	0.2083333
NODE_11489_length_816_cov_19.044630	77	154	0	77	77	1.0000000
NODE_11489_length_816_cov_19.044630	130	212	0	82	82	1.0000000
NODE_11490_length_816_cov_16.418410	381	461	0	45	80	0.5625000
NODE_11490_length_816_cov_16.418410	381	461	2	35	80	0.4375000
NODE_11490_length_816_cov_16.418410	434	514	2	61	80	0.7625000
NODE_11490_length_816_cov_16.418410	434	514	4	19	80	0.2375000
NODE_11491_length_816_cov_15.945607	319	399	0	46	80	0.5750000
NODE_11491_length_816_cov_15.945607	319	399	4	34	80	0.4250000
NODE_11491_length_816_cov_15.945607	372	452	4	80	80	1.0000000
NODE_11492_length_816_cov_12.797768	358	438	0	27	80	0.3375000
NODE_11492_length_816_cov_12.797768	358	438	2	49	80	0.6125000
NODE_11492_length_816_cov_12.797768	358	438	6	4	80	0.0500000
NODE_11492_length_816_cov_12.797768	411	491	2	23	80	0.2875000
NODE_11492_length_816_cov_12.797768	411	491	4	8	80	0.1000000
NODE_11492_length_816_cov_12.797768	411	491	6	49	80	0.6125000
NODE_11493_length_816_cov_12.086471	242	322	0	80	80	1.0000000
NODE_11493_length_816_cov_12.086471	295	375	0	80	80	1.0000000
NODE_11495_length_816_cov_3.873082	412	492	0	80	80	1.0000000
NODE_11495_length_816_cov_3.873082	465	545	0	80	80	1.0000000
NODE_11516_length_815_cov_48.090782	334	414	0	80	80	1.0000000
NODE_11516_length_815_cov_48.090782	387	467	0	80	80	1.0000000
NODE_11517_length_815_cov_27.748603	290	370	0	2	80	0.0250000
NODE_11517_length_815_cov_27.748603	290	370	5	19	80	0.2375000
NODE_11517_length_815_cov_27.748603	290	370	9	1	80	0.0125000
NODE_11517_length_815_cov_27.748603	290	370	10	3	80	0.0375000
NODE_11517_length_815_cov_27.748603	290	370	16	5	80	0.0625000
NODE_11517_length_815_cov_27.748603	290	370	20	50	80	0.6250000
NODE_11517_length_815_cov_27.748603	343	423	18	4	80	0.0500000
NODE_11517_length_815_cov_27.748603	343	423	20	46	80	0.5750000
NODE_11517_length_815_cov_27.748603	343	423	22	30	80	0.3750000
NODE_11518_length_815_cov_23.748603	429	509	0	80	80	1.0000000
NODE_11518_length_815_cov_23.748603	482	562	0	80	80	1.0000000
NODE_11519_length_815_cov_14.870112	318	398	0	80	80	1.0000000
NODE_11519_length_815_cov_14.870112	371	451	0	80	80	1.0000000
NODE_11520_length_815_cov_13.317039	338	418	0	80	80	1.0000000
NODE_11520_length_815_cov_13.317039	391	471	0	41	80	0.5125000
NODE_11520_length_815_cov_13.317039	391	471	1	2	80	0.0250000
NODE_11520_length_815_cov_13.317039	391	471	2	14	80	0.1750000
NODE_11520_length_815_cov_13.317039	391	471	3	23	80	0.2875000
NODE_11521_length_815_cov_12.270950	315	395	0	80	80	1.0000000
NODE_11521_length_815_cov_12.270950	368	448	0	80	80	1.0000000
NODE_11522_length_815_cov_9.304469	150	230	2	19	80	0.2375000
NODE_11522_length_815_cov_9.304469	150	230	4	60	80	0.7500000
NODE_11522_length_815_cov_9.304469	150	230	6	1	80	0.0125000
NODE_11522_length_815_cov_9.304469	203	283	0	25	80	0.3125000
NODE_11522_length_815_cov_9.304469	203	283	2	47	80	0.5875000
NODE_11522_length_815_cov_9.304469	203	283	4	8	80	0.1000000
NODE_11524_length_815_cov_8.117318	437	517	0	80	80	1.0000000
NODE_11524_length_815_cov_8.117318	490	570	0	80	80	1.0000000
NODE_11530_length_815_cov_3.963687	275	355	0	76	80	0.9500000
NODE_11530_length_815_cov_3.963687	275	355	2	4	80	0.0500000
NODE_11530_length_815_cov_3.963687	328	408	0	40	80	0.5000000
NODE_11530_length_815_cov_3.963687	328	408	2	40	80	0.5000000
NODE_11532_length_815_cov_2.976257	441	508	3	19	67	0.2835821
NODE_11532_length_815_cov_2.976257	441	508	4	37	67	0.5522388
NODE_11532_length_815_cov_2.976257	441	508	6	11	67	0.1641791
NODE_11554_length_814_cov_55.545455	304	384	0	34	80	0.4250000
NODE_11554_length_814_cov_55.545455	304	384	6	22	80	0.2750000
NODE_11554_length_814_cov_55.545455	304	384	8	24	80	0.3000000
NODE_11554_length_814_cov_55.545455	357	437	0	80	80	1.0000000
NODE_11554_length_814_cov_55.545455	517	559	2	42	42	1.0000000
NODE_11554_length_814_cov_55.545455	724	804	4	2	80	0.0250000
NODE_11554_length_814_cov_55.545455	724	804	6	2	80	0.0250000
NODE_11554_length_814_cov_55.545455	724	804	8	4	80	0.0500000
NODE_11554_length_814_cov_55.545455	724	804	10	2	80	0.0250000
NODE_11554_length_814_cov_55.545455	724	804	11	1	80	0.0125000
NODE_11554_length_814_cov_55.545455	724	804	12	2	80	0.0250000
NODE_11554_length_814_cov_55.545455	724	804	14	5	80	0.0625000
NODE_11554_length_814_cov_55.545455	724	804	17	4	80	0.0500000
NODE_11554_length_814_cov_55.545455	724	804	20	2	80	0.0250000
NODE_11554_length_814_cov_55.545455	724	804	22	1	80	0.0125000
NODE_11554_length_814_cov_55.545455	724	804	28	6	80	0.0750000
NODE_11554_length_814_cov_55.545455	724	804	30	8	80	0.1000000
NODE_11554_length_814_cov_55.545455	724	804	32	14	80	0.1750000
NODE_11554_length_814_cov_55.545455	724	804	35	2	80	0.0250000
NODE_11554_length_814_cov_55.545455	724	804	36	25	80	0.3125000
NODE_11555_length_814_cov_32.216783	317	397	1	14	80	0.1750000
NODE_11555_length_814_cov_32.216783	317	397	2	52	80	0.6500000
NODE_11555_length_814_cov_32.216783	317	397	9	14	80	0.1750000
NODE_11555_length_814_cov_32.216783	370	450	2	13	80	0.1625000
NODE_11555_length_814_cov_32.216783	370	450	8	14	80	0.1750000
NODE_11555_length_814_cov_32.216783	370	450	9	53	80	0.6625000
NODE_11556_length_814_cov_19.507692	174	254	0	80	80	1.0000000
NODE_11556_length_814_cov_19.507692	227	307	0	80	80	1.0000000
NODE_11556_length_814_cov_19.507692	303	383	0	80	80	1.0000000
NODE_11556_length_814_cov_19.507692	356	436	0	80	80	1.0000000
NODE_11557_length_814_cov_18.579021	433	513	0	41	80	0.5125000
NODE_11557_length_814_cov_18.579021	433	513	2	39	80	0.4875000
NODE_11557_length_814_cov_18.579021	486	566	2	80	80	1.0000000
NODE_11558_length_814_cov_17.183217	339	419	2	80	80	1.0000000
NODE_11558_length_814_cov_17.183217	392	472	0	52	80	0.6500000
NODE_11558_length_814_cov_17.183217	392	472	2	28	80	0.3500000
NODE_11559_length_814_cov_15.306294	238	318	0	40	80	0.5000000
NODE_11559_length_814_cov_15.306294	238	318	2	40	80	0.5000000
NODE_11559_length_814_cov_15.306294	291	371	0	21	80	0.2625000
NODE_11559_length_814_cov_15.306294	291	371	2	59	80	0.7375000
NODE_11560_length_814_cov_11.511888	397	477	0	31	80	0.3875000
NODE_11560_length_814_cov_11.511888	397	477	2	49	80	0.6125000
NODE_11560_length_814_cov_11.511888	459	530	0	26	71	0.3661972
NODE_11560_length_814_cov_11.511888	459	530	2	45	71	0.6338028
NODE_11561_length_814_cov_10.395804	305	385	2	80	80	1.0000000
NODE_11561_length_814_cov_10.395804	358	438	0	23	80	0.2875000
NODE_11561_length_814_cov_10.395804	358	438	1	3	80	0.0375000
NODE_11561_length_814_cov_10.395804	358	438	2	54	80	0.6750000
NODE_11562_length_814_cov_9.692308	347	427	2	28	80	0.3500000
NODE_11562_length_814_cov_9.692308	347	427	4	52	80	0.6500000
NODE_11562_length_814_cov_9.692308	400	480	0	5	80	0.0625000
NODE_11562_length_814_cov_9.692308	400	480	2	25	80	0.3125000
NODE_11562_length_814_cov_9.692308	400	480	4	50	80	0.6250000
NODE_11564_length_814_cov_9.274126	245	325	0	80	80	1.0000000
NODE_11564_length_814_cov_9.274126	298	378	0	80	80	1.0000000
NODE_11565_length_814_cov_8.973427	271	351	0	80	80	1.0000000
NODE_11565_length_814_cov_8.973427	324	404	0	80	80	1.0000000
NODE_11573_length_814_cov_2.145455	273	327	0	54	54	1.0000000
NODE_11573_length_814_cov_2.145455	307	371	0	64	64	1.0000000
NODE_11587_length_813_cov_39.228291	225	305	0	36	80	0.4500000
NODE_11587_length_813_cov_39.228291	225	305	2	33	80	0.4125000
NODE_11587_length_813_cov_39.228291	225	305	4	11	80	0.1375000
NODE_11587_length_813_cov_39.228291	278	358	2	33	80	0.4125000
NODE_11587_length_813_cov_39.228291	278	358	4	47	80	0.5875000
NODE_11588_length_813_cov_36.570028	406	486	0	23	80	0.2875000
NODE_11588_length_813_cov_36.570028	406	486	6	51	80	0.6375000
NODE_11588_length_813_cov_36.570028	406	486	8	6	80	0.0750000
NODE_11588_length_813_cov_36.570028	459	539	0	76	80	0.9500000
NODE_11588_length_813_cov_36.570028	459	539	6	4	80	0.0500000
NODE_11589_length_813_cov_26.718487	209	289	0	47	80	0.5875000
NODE_11589_length_813_cov_26.718487	209	289	2	15	80	0.1875000
NODE_11589_length_813_cov_26.718487	209	289	4	18	80	0.2250000
NODE_11589_length_813_cov_26.718487	262	342	2	34	80	0.4250000
NODE_11589_length_813_cov_26.718487	262	342	4	46	80	0.5750000
NODE_11590_length_813_cov_17.537815	335	415	0	80	80	1.0000000
NODE_11590_length_813_cov_17.537815	388	468	0	80	80	1.0000000
NODE_11591_length_813_cov_14.243697	279	359	0	80	80	1.0000000
NODE_11591_length_813_cov_14.243697	332	412	0	80	80	1.0000000
NODE_11592_length_813_cov_13.984594	307	387	0	80	80	1.0000000
NODE_11592_length_813_cov_13.984594	360	440	0	80	80	1.0000000
NODE_11593_length_813_cov_13.242297	336	416	0	47	80	0.5875000
NODE_11593_length_813_cov_13.242297	336	416	2	33	80	0.4125000
NODE_11593_length_813_cov_13.242297	389	469	0	11	80	0.1375000
NODE_11593_length_813_cov_13.242297	389	469	2	69	80	0.8625000
NODE_11594_length_813_cov_11.985994	374	454	0	65	80	0.8125000
NODE_11594_length_813_cov_11.985994	374	454	2	15	80	0.1875000
NODE_11594_length_813_cov_11.985994	427	507	0	80	80	1.0000000
NODE_11595_length_813_cov_11.668067	279	359	0	80	80	1.0000000
NODE_11595_length_813_cov_11.668067	332	412	0	80	80	1.0000000
NODE_11596_length_813_cov_8.149860	538	618	0	80	80	1.0000000
NODE_11596_length_813_cov_8.149860	591	671	0	80	80	1.0000000
NODE_11597_length_813_cov_7.098039	234	314	0	80	80	1.0000000
NODE_11597_length_813_cov_7.098039	287	367	0	80	80	1.0000000
NODE_11613_length_812_cov_45.183731	435	515	0	80	80	1.0000000
NODE_11613_length_812_cov_45.183731	488	568	0	80	80	1.0000000
NODE_11614_length_812_cov_23.862553	386	466	0	30	80	0.3750000
NODE_11614_length_812_cov_23.862553	386	466	2	50	80	0.6250000
NODE_11614_length_812_cov_23.862553	439	519	0	80	80	1.0000000
NODE_11615_length_812_cov_23.516129	295	375	0	51	80	0.6375000
NODE_11615_length_812_cov_23.516129	295	375	2	29	80	0.3625000
NODE_11615_length_812_cov_23.516129	348	428	2	80	80	1.0000000
NODE_11616_length_812_cov_15.577840	509	589	0	4	80	0.0500000
NODE_11616_length_812_cov_15.577840	509	589	2	76	80	0.9500000
NODE_11616_length_812_cov_15.577840	562	644	0	50	82	0.6097561
NODE_11616_length_812_cov_15.577840	562	644	2	32	82	0.3902439
NODE_11617_length_812_cov_13.277700	257	331	0	32	74	0.4324324
NODE_11617_length_812_cov_13.277700	257	331	2	42	74	0.5675676
NODE_11617_length_812_cov_13.277700	304	384	0	12	80	0.1500000
NODE_11617_length_812_cov_13.277700	304	384	2	68	80	0.8500000
NODE_11619_length_812_cov_6.697055	309	389	0	80	80	1.0000000
NODE_11619_length_812_cov_6.697055	362	442	0	80	80	1.0000000
NODE_11642_length_811_cov_65.762640	418	492	20	1	74	0.0135135
NODE_11642_length_811_cov_65.762640	418	492	26	28	74	0.3783784
NODE_11642_length_811_cov_65.762640	418	492	28	45	74	0.6081081
NODE_11642_length_811_cov_65.762640	471	545	4	4	74	0.0540541
NODE_11642_length_811_cov_65.762640	471	545	7	15	74	0.2027027
NODE_11642_length_811_cov_65.762640	471	545	9	10	74	0.1351351
NODE_11642_length_811_cov_65.762640	471	545	15	11	74	0.1486486
NODE_11642_length_811_cov_65.762640	471	545	18	13	74	0.1756757
NODE_11642_length_811_cov_65.762640	471	545	20	1	74	0.0135135
NODE_11642_length_811_cov_65.762640	471	545	26	2	74	0.0270270
NODE_11642_length_811_cov_65.762640	471	545	28	18	74	0.2432432
NODE_11643_length_811_cov_62.933989	457	537	0	15	80	0.1875000
NODE_11643_length_811_cov_62.933989	457	537	2	36	80	0.4500000
NODE_11643_length_811_cov_62.933989	457	537	6	29	80	0.3625000
NODE_11643_length_811_cov_62.933989	510	590	2	4	80	0.0500000
NODE_11643_length_811_cov_62.933989	510	590	4	24	80	0.3000000
NODE_11643_length_811_cov_62.933989	510	590	6	52	80	0.6500000
NODE_11644_length_811_cov_26.401685	397	477	0	80	80	1.0000000
NODE_11644_length_811_cov_26.401685	450	530	0	80	80	1.0000000
NODE_11645_length_811_cov_23.009831	189	269	0	17	80	0.2125000
NODE_11645_length_811_cov_23.009831	189	269	4	9	80	0.1125000
NODE_11645_length_811_cov_23.009831	189	269	6	54	80	0.6750000
NODE_11645_length_811_cov_23.009831	242	322	0	70	80	0.8750000
NODE_11645_length_811_cov_23.009831	242	322	4	9	80	0.1125000
NODE_11645_length_811_cov_23.009831	242	322	6	1	80	0.0125000
NODE_11646_length_811_cov_20.523876	375	455	0	80	80	1.0000000
NODE_11646_length_811_cov_20.523876	428	508	0	80	80	1.0000000
NODE_11647_length_811_cov_17.386236	421	501	0	80	80	1.0000000
NODE_11647_length_811_cov_17.386236	474	554	0	80	80	1.0000000
NODE_11648_length_811_cov_15.279494	368	448	0	80	80	1.0000000
NODE_11648_length_811_cov_15.279494	421	502	0	81	81	1.0000000
NODE_11649_length_811_cov_14.543539	222	302	2	76	80	0.9500000
NODE_11649_length_811_cov_14.543539	222	302	4	4	80	0.0500000
NODE_11649_length_811_cov_14.543539	275	355	2	76	80	0.9500000
NODE_11649_length_811_cov_14.543539	275	355	4	4	80	0.0500000
NODE_11650_length_811_cov_12.196629	402	482	0	80	80	1.0000000
NODE_11650_length_811_cov_12.196629	455	535	0	80	80	1.0000000
NODE_11651_length_811_cov_12.117978	289	369	0	80	80	1.0000000
NODE_11651_length_811_cov_12.117978	342	422	0	80	80	1.0000000
NODE_11652_length_811_cov_11.886236	330	410	0	60	80	0.7500000
NODE_11652_length_811_cov_11.886236	330	410	2	20	80	0.2500000
NODE_11652_length_811_cov_11.886236	383	463	0	7	80	0.0875000
NODE_11652_length_811_cov_11.886236	383	463	2	73	80	0.9125000
NODE_11653_length_811_cov_10.602528	342	422	0	19	80	0.2375000
NODE_11653_length_811_cov_10.602528	342	422	8	4	80	0.0500000
NODE_11653_length_811_cov_10.602528	342	422	10	57	80	0.7125000
NODE_11653_length_811_cov_10.602528	395	461	8	1	66	0.0151515
NODE_11653_length_811_cov_10.602528	395	461	10	65	66	0.9848485
NODE_11653_length_811_cov_10.602528	452	519	0	12	67	0.1791045
NODE_11653_length_811_cov_10.602528	452	519	8	47	67	0.7014925
NODE_11653_length_811_cov_10.602528	452	519	10	8	67	0.1194030
NODE_11653_length_811_cov_10.602528	492	572	0	14	80	0.1750000
NODE_11653_length_811_cov_10.602528	492	572	2	51	80	0.6375000
NODE_11653_length_811_cov_10.602528	492	572	8	15	80	0.1875000
NODE_11654_length_811_cov_7.539326	324	404	0	80	80	1.0000000
NODE_11654_length_811_cov_7.539326	377	457	0	80	80	1.0000000
NODE_11655_length_811_cov_6.398876	419	499	0	80	80	1.0000000
NODE_11655_length_811_cov_6.398876	472	552	0	80	80	1.0000000
NODE_11657_length_811_cov_5.939607	496	527	4	5	31	0.1612903
NODE_11657_length_811_cov_5.939607	496	527	6	14	31	0.4516129
NODE_11657_length_811_cov_5.939607	496	527	7	11	31	0.3548387
NODE_11657_length_811_cov_5.939607	496	527	8	1	31	0.0322581
NODE_11657_length_811_cov_5.939607	528	603	6	18	75	0.2400000
NODE_11657_length_811_cov_5.939607	528	603	7	4	75	0.0533333
NODE_11657_length_811_cov_5.939607	528	603	8	16	75	0.2133333
NODE_11657_length_811_cov_5.939607	528	603	10	37	75	0.4933333
NODE_11669_length_811_cov_1.501404	645	676	0	24	31	0.7741935
NODE_11669_length_811_cov_1.501404	645	676	2	7	31	0.2258064
NODE_11684_length_810_cov_42.358650	484	564	2	80	80	1.0000000
NODE_11684_length_810_cov_42.358650	537	617	0	40	80	0.5000000
NODE_11684_length_810_cov_42.358650	537	617	2	40	80	0.5000000
NODE_11685_length_810_cov_38.604782	370	450	0	80	80	1.0000000
NODE_11685_length_810_cov_38.604782	423	499	0	76	76	1.0000000
NODE_11686_length_810_cov_20.354430	338	418	0	80	80	1.0000000
NODE_11686_length_810_cov_20.354430	391	471	0	80	80	1.0000000
NODE_11688_length_810_cov_12.367089	144	224	0	33	80	0.4125000
NODE_11688_length_810_cov_12.367089	144	224	2	47	80	0.5875000
NODE_11688_length_810_cov_12.367089	197	277	0	23	80	0.2875000
NODE_11688_length_810_cov_12.367089	197	277	2	57	80	0.7125000
NODE_11689_length_810_cov_8.886076	333	399	2	66	66	1.0000000
NODE_11690_length_810_cov_8.291139	446	526	0	80	80	1.0000000
NODE_11690_length_810_cov_8.291139	499	579	0	54	80	0.6750000
NODE_11690_length_810_cov_8.291139	499	579	2	26	80	0.3250000
NODE_11692_length_810_cov_7.213783	335	406	0	42	71	0.5915493
NODE_11692_length_810_cov_7.213783	335	406	2	29	71	0.4084507
NODE_11692_length_810_cov_7.213783	335	416	0	42	81	0.5185185
NODE_11692_length_810_cov_7.213783	335	416	2	39	81	0.4814815
NODE_11692_length_810_cov_7.213783	379	459	2	80	80	1.0000000
NODE_11714_length_809_cov_40.536620	428	500	0	72	72	1.0000000
NODE_11714_length_809_cov_40.536620	473	553	0	80	80	1.0000000
NODE_11715_length_809_cov_15.871831	385	465	0	80	80	1.0000000
NODE_11715_length_809_cov_15.871831	402	465	0	63	63	1.0000000
NODE_11715_length_809_cov_15.871831	438	518	0	80	80	1.0000000
NODE_11715_length_809_cov_15.871831	438	518	0	80	80	1.0000000
NODE_11716_length_809_cov_15.019718	286	366	0	35	80	0.4375000
NODE_11716_length_809_cov_15.019718	286	366	8	45	80	0.5625000
NODE_11716_length_809_cov_15.019718	339	419	0	8	80	0.1000000
NODE_11716_length_809_cov_15.019718	339	419	8	72	80	0.9000000
NODE_11718_length_809_cov_4.483099	244	324	2	80	80	1.0000000
NODE_11718_length_809_cov_4.483099	278	324	2	46	46	1.0000000
NODE_11718_length_809_cov_4.483099	298	377	0	14	79	0.1772152
NODE_11718_length_809_cov_4.483099	298	377	2	65	79	0.8227848
NODE_11718_length_809_cov_4.483099	308	377	0	14	69	0.2028985
NODE_11718_length_809_cov_4.483099	308	377	2	55	69	0.7971014
NODE_11738_length_808_cov_45.023977	325	405	0	51	80	0.6375000
NODE_11738_length_808_cov_45.023977	325	405	2	29	80	0.3625000
NODE_11738_length_808_cov_45.023977	378	458	2	42	80	0.5250000
NODE_11738_length_808_cov_45.023977	378	458	4	21	80	0.2625000
NODE_11738_length_808_cov_45.023977	378	458	6	17	80	0.2125000
NODE_11739_length_808_cov_24.087447	287	367	0	80	80	1.0000000
NODE_11739_length_808_cov_24.087447	340	420	0	80	80	1.0000000
NODE_11740_length_808_cov_21.867419	324	404	0	80	80	1.0000000
NODE_11740_length_808_cov_21.867419	377	457	0	80	80	1.0000000
NODE_11741_length_808_cov_16.289140	333	413	0	80	80	1.0000000
NODE_11741_length_808_cov_16.289140	386	466	0	80	80	1.0000000
NODE_11742_length_808_cov_14.489422	307	387	0	15	80	0.1875000
NODE_11742_length_808_cov_14.489422	307	387	2	65	80	0.8125000
NODE_11742_length_808_cov_14.489422	360	440	0	68	80	0.8500000
NODE_11742_length_808_cov_14.489422	360	440	2	12	80	0.1500000
NODE_11744_length_808_cov_10.507757	317	397	0	12	80	0.1500000
NODE_11744_length_808_cov_10.507757	317	397	2	68	80	0.8500000
NODE_11744_length_808_cov_10.507757	370	450	0	29	80	0.3625000
NODE_11744_length_808_cov_10.507757	370	450	2	51	80	0.6375000
NODE_11745_length_808_cov_10.066291	483	563	0	80	80	1.0000000
NODE_11745_length_808_cov_10.066291	536	616	0	80	80	1.0000000
NODE_11746_length_808_cov_7.581100	358	438	0	23	80	0.2875000
NODE_11746_length_808_cov_7.581100	358	438	2	57	80	0.7125000
NODE_11746_length_808_cov_7.581100	411	491	2	80	80	1.0000000
NODE_11756_length_808_cov_3.283498	471	551	0	80	80	1.0000000
NODE_11756_length_808_cov_3.283498	524	604	0	80	80	1.0000000
NODE_11783_length_807_cov_67.341808	2	25	47	1	23	0.0434783
NODE_11783_length_807_cov_67.341808	2	25	50	1	23	0.0434783
NODE_11783_length_807_cov_67.341808	2	25	53	2	23	0.0869565
NODE_11783_length_807_cov_67.341808	2	25	60	1	23	0.0434783
NODE_11783_length_807_cov_67.341808	2	25	62	1	23	0.0434783
NODE_11783_length_807_cov_67.341808	2	25	65	1	23	0.0434783
NODE_11783_length_807_cov_67.341808	2	25	69	1	23	0.0434783
NODE_11783_length_807_cov_67.341808	2	25	70	1	23	0.0434783
NODE_11783_length_807_cov_67.341808	2	25	77	1	23	0.0434783
NODE_11783_length_807_cov_67.341808	2	25	81	1	23	0.0434783
NODE_11783_length_807_cov_67.341808	2	25	83	1	23	0.0434783
NODE_11783_length_807_cov_67.341808	2	25	87	1	23	0.0434783
NODE_11783_length_807_cov_67.341808	2	25	89	1	23	0.0434783
NODE_11783_length_807_cov_67.341808	2	25	93	1	23	0.0434783
NODE_11783_length_807_cov_67.341808	2	25	95	1	23	0.0434783
NODE_11783_length_807_cov_67.341808	2	25	102	1	23	0.0434783
NODE_11783_length_807_cov_67.341808	2	25	103	1	23	0.0434783
NODE_11783_length_807_cov_67.341808	2	25	107	1	23	0.0434783
NODE_11783_length_807_cov_67.341808	2	25	112	1	23	0.0434783
NODE_11783_length_807_cov_67.341808	2	25	116	1	23	0.0434783
NODE_11783_length_807_cov_67.341808	2	25	120	2	23	0.0869565
NODE_11783_length_807_cov_67.341808	339	370	191	1	31	0.0322581
NODE_11783_length_807_cov_67.341808	339	370	195	1	31	0.0322581
NODE_11783_length_807_cov_67.341808	339	370	201	2	31	0.0645161
NODE_11783_length_807_cov_67.341808	339	370	202	2	31	0.0645161
NODE_11783_length_807_cov_67.341808	339	370	204	1	31	0.0322581
NODE_11783_length_807_cov_67.341808	339	370	208	1	31	0.0322581
NODE_11783_length_807_cov_67.341808	339	370	214	1	31	0.0322581
NODE_11783_length_807_cov_67.341808	339	370	232	2	31	0.0645161
NODE_11783_length_807_cov_67.341808	339	370	234	1	31	0.0322581
NODE_11783_length_807_cov_67.341808	339	370	241	1	31	0.0322581
NODE_11783_length_807_cov_67.341808	339	370	246	1	31	0.0322581
NODE_11783_length_807_cov_67.341808	339	370	255	1	31	0.0322581
NODE_11783_length_807_cov_67.341808	339	370	258	1	31	0.0322581
NODE_11783_length_807_cov_67.341808	339	370	264	1	31	0.0322581
NODE_11783_length_807_cov_67.341808	339	370	278	3	31	0.0967742
NODE_11783_length_807_cov_67.341808	339	370	286	1	31	0.0322581
NODE_11783_length_807_cov_67.341808	339	370	287	1	31	0.0322581
NODE_11783_length_807_cov_67.341808	339	370	290	2	31	0.0645161
NODE_11783_length_807_cov_67.341808	339	370	292	1	31	0.0322581
NODE_11783_length_807_cov_67.341808	339	370	296	1	31	0.0322581
NODE_11783_length_807_cov_67.341808	339	370	297	2	31	0.0645161
NODE_11783_length_807_cov_67.341808	339	370	299	1	31	0.0322581
NODE_11783_length_807_cov_67.341808	339	370	300	2	31	0.0645161
NODE_11783_length_807_cov_67.341808	343	423	201	1	80	0.0125000
NODE_11783_length_807_cov_67.341808	343	423	202	1	80	0.0125000
NODE_11783_length_807_cov_67.341808	343	423	204	1	80	0.0125000
NODE_11783_length_807_cov_67.341808	343	423	208	1	80	0.0125000
NODE_11783_length_807_cov_67.341808	343	423	214	1	80	0.0125000
NODE_11783_length_807_cov_67.341808	343	423	232	2	80	0.0250000
NODE_11783_length_807_cov_67.341808	343	423	234	1	80	0.0125000
NODE_11783_length_807_cov_67.341808	343	423	241	1	80	0.0125000
NODE_11783_length_807_cov_67.341808	343	423	246	1	80	0.0125000
NODE_11783_length_807_cov_67.341808	343	423	255	1	80	0.0125000
NODE_11783_length_807_cov_67.341808	343	423	258	1	80	0.0125000
NODE_11783_length_807_cov_67.341808	343	423	264	1	80	0.0125000
NODE_11783_length_807_cov_67.341808	343	423	278	3	80	0.0375000
NODE_11783_length_807_cov_67.341808	343	423	286	1	80	0.0125000
NODE_11783_length_807_cov_67.341808	343	423	287	1	80	0.0125000
NODE_11783_length_807_cov_67.341808	343	423	290	2	80	0.0250000
NODE_11783_length_807_cov_67.341808	343	423	292	1	80	0.0125000
NODE_11783_length_807_cov_67.341808	343	423	296	1	80	0.0125000
NODE_11783_length_807_cov_67.341808	343	423	297	2	80	0.0250000
NODE_11783_length_807_cov_67.341808	343	423	299	1	80	0.0125000
NODE_11783_length_807_cov_67.341808	343	423	300	4	80	0.0500000
NODE_11783_length_807_cov_67.341808	343	423	303	1	80	0.0125000
NODE_11783_length_807_cov_67.341808	343	423	305	2	80	0.0250000
NODE_11783_length_807_cov_67.341808	343	423	307	1	80	0.0125000
NODE_11783_length_807_cov_67.341808	343	423	312	1	80	0.0125000
NODE_11783_length_807_cov_67.341808	343	423	313	1	80	0.0125000
NODE_11783_length_807_cov_67.341808	343	423	315	1	80	0.0125000
NODE_11783_length_807_cov_67.341808	343	423	319	1	80	0.0125000
NODE_11783_length_807_cov_67.341808	343	423	320	1	80	0.0125000
NODE_11783_length_807_cov_67.341808	343	423	321	1	80	0.0125000
NODE_11783_length_807_cov_67.341808	343	423	322	1	80	0.0125000
NODE_11783_length_807_cov_67.341808	343	423	325	1	80	0.0125000
NODE_11783_length_807_cov_67.341808	343	423	326	1	80	0.0125000
NODE_11783_length_807_cov_67.341808	343	423	327	1	80	0.0125000
NODE_11783_length_807_cov_67.341808	343	423	328	1	80	0.0125000
NODE_11783_length_807_cov_67.341808	343	423	329	1	80	0.0125000
NODE_11783_length_807_cov_67.341808	343	423	331	3	80	0.0375000
NODE_11783_length_807_cov_67.341808	343	423	333	3	80	0.0375000
NODE_11783_length_807_cov_67.341808	343	423	334	1	80	0.0125000
NODE_11783_length_807_cov_67.341808	343	423	335	1	80	0.0125000
NODE_11783_length_807_cov_67.341808	343	423	336	3	80	0.0375000
NODE_11783_length_807_cov_67.341808	343	423	337	1	80	0.0125000
NODE_11783_length_807_cov_67.341808	343	423	338	1	80	0.0125000
NODE_11783_length_807_cov_67.341808	343	423	344	5	80	0.0625000
NODE_11783_length_807_cov_67.341808	343	423	345	3	80	0.0375000
NODE_11783_length_807_cov_67.341808	343	423	346	2	80	0.0250000
NODE_11783_length_807_cov_67.341808	343	423	347	3	80	0.0375000
NODE_11783_length_807_cov_67.341808	343	423	349	1	80	0.0125000
NODE_11783_length_807_cov_67.341808	343	423	352	1	80	0.0125000
NODE_11783_length_807_cov_67.341808	343	423	359	1	80	0.0125000
NODE_11783_length_807_cov_67.341808	343	423	360	1	80	0.0125000
NODE_11783_length_807_cov_67.341808	343	423	365	2	80	0.0250000
NODE_11783_length_807_cov_67.341808	343	423	367	1	80	0.0125000
NODE_11783_length_807_cov_67.341808	343	423	369	1	80	0.0125000
NODE_11783_length_807_cov_67.341808	343	423	376	1	80	0.0125000
NODE_11784_length_807_cov_54.980226	683	749	66	3	66	0.0454545
NODE_11784_length_807_cov_54.980226	683	749	68	1	66	0.0151515
NODE_11784_length_807_cov_54.980226	683	749	70	3	66	0.0454545
NODE_11784_length_807_cov_54.980226	683	749	72	2	66	0.0303030
NODE_11784_length_807_cov_54.980226	683	749	78	14	66	0.2121212
NODE_11784_length_807_cov_54.980226	683	749	80	2	66	0.0303030
NODE_11784_length_807_cov_54.980226	683	749	82	1	66	0.0151515
NODE_11784_length_807_cov_54.980226	683	749	84	3	66	0.0454545
NODE_11784_length_807_cov_54.980226	683	749	86	6	66	0.0909091
NODE_11784_length_807_cov_54.980226	683	749	87	2	66	0.0303030
NODE_11784_length_807_cov_54.980226	683	749	88	3	66	0.0454545
NODE_11784_length_807_cov_54.980226	683	749	89	2	66	0.0303030
NODE_11784_length_807_cov_54.980226	683	749	92	4	66	0.0606061
NODE_11784_length_807_cov_54.980226	683	749	94	11	66	0.1666667
NODE_11784_length_807_cov_54.980226	683	749	96	9	66	0.1363636
NODE_11784_length_807_cov_54.980226	727	802	10	1	75	0.0133333
NODE_11784_length_807_cov_54.980226	727	802	14	5	75	0.0666667
NODE_11784_length_807_cov_54.980226	727	802	16	7	75	0.0933333
NODE_11784_length_807_cov_54.980226	727	802	18	2	75	0.0266667
NODE_11784_length_807_cov_54.980226	727	802	20	2	75	0.0266667
NODE_11784_length_807_cov_54.980226	727	802	22	2	75	0.0266667
NODE_11784_length_807_cov_54.980226	727	802	24	1	75	0.0133333
NODE_11784_length_807_cov_54.980226	727	802	36	10	75	0.1333333
NODE_11784_length_807_cov_54.980226	727	802	38	1	75	0.0133333
NODE_11784_length_807_cov_54.980226	727	802	42	5	75	0.0666667
NODE_11784_length_807_cov_54.980226	727	802	44	4	75	0.0533333
NODE_11784_length_807_cov_54.980226	727	802	46	1	75	0.0133333
NODE_11784_length_807_cov_54.980226	727	802	48	2	75	0.0266667
NODE_11784_length_807_cov_54.980226	727	802	52	1	75	0.0133333
NODE_11784_length_807_cov_54.980226	727	802	54	5	75	0.0666667
NODE_11784_length_807_cov_54.980226	727	802	56	2	75	0.0266667
NODE_11784_length_807_cov_54.980226	727	802	58	1	75	0.0133333
NODE_11784_length_807_cov_54.980226	727	802	60	1	75	0.0133333
NODE_11784_length_807_cov_54.980226	727	802	66	3	75	0.0400000
NODE_11784_length_807_cov_54.980226	727	802	68	1	75	0.0133333
NODE_11784_length_807_cov_54.980226	727	802	70	3	75	0.0400000
NODE_11784_length_807_cov_54.980226	727	802	72	2	75	0.0266667
NODE_11784_length_807_cov_54.980226	727	802	78	13	75	0.1733333
NODE_11785_length_807_cov_37.306497	435	515	2	66	80	0.8250000
NODE_11785_length_807_cov_37.306497	435	515	4	14	80	0.1750000
NODE_11785_length_807_cov_37.306497	488	568	2	55	80	0.6875000
NODE_11785_length_807_cov_37.306497	488	568	4	25	80	0.3125000
NODE_11786_length_807_cov_31.177966	287	367	0	80	80	1.0000000
NODE_11786_length_807_cov_31.177966	340	420	0	31	80	0.3875000
NODE_11786_length_807_cov_31.177966	340	420	2	49	80	0.6125000
NODE_11787_length_807_cov_30.638418	250	329	0	79	79	1.0000000
NODE_11787_length_807_cov_30.638418	302	382	0	80	80	1.0000000
NODE_11787_length_807_cov_30.638418	378	458	0	80	80	1.0000000
NODE_11787_length_807_cov_30.638418	431	511	0	80	80	1.0000000
NODE_11788_length_807_cov_29.725989	362	442	0	37	80	0.4625000
NODE_11788_length_807_cov_29.725989	362	442	4	43	80	0.5375000
NODE_11788_length_807_cov_29.725989	415	495	4	80	80	1.0000000
NODE_11789_length_807_cov_23.200565	441	521	10	3	80	0.0375000
NODE_11789_length_807_cov_23.200565	441	521	12	37	80	0.4625000
NODE_11789_length_807_cov_23.200565	441	521	16	7	80	0.0875000
NODE_11789_length_807_cov_23.200565	441	521	17	1	80	0.0125000
NODE_11789_length_807_cov_23.200565	441	521	18	32	80	0.4000000
NODE_11789_length_807_cov_23.200565	494	574	0	16	80	0.2000000
NODE_11789_length_807_cov_23.200565	494	574	2	17	80	0.2125000
NODE_11789_length_807_cov_23.200565	494	574	4	15	80	0.1875000
NODE_11789_length_807_cov_23.200565	494	574	5	1	80	0.0125000
NODE_11789_length_807_cov_23.200565	494	574	6	1	80	0.0125000
NODE_11789_length_807_cov_23.200565	494	574	12	30	80	0.3750000
NODE_11790_length_807_cov_21.888418	319	386	0	67	67	1.0000000
NODE_11790_length_807_cov_21.888418	390	440	0	50	50	1.0000000
NODE_11791_length_807_cov_17.480226	339	419	0	80	80	1.0000000
NODE_11791_length_807_cov_17.480226	392	472	0	80	80	1.0000000
NODE_11792_length_807_cov_14.895480	350	430	0	80	80	1.0000000
NODE_11792_length_807_cov_14.895480	403	483	0	80	80	1.0000000
NODE_11794_length_807_cov_12.255650	440	520	0	10	80	0.1250000
NODE_11794_length_807_cov_12.255650	440	520	4	70	80	0.8750000
NODE_11794_length_807_cov_12.255650	493	573	0	63	80	0.7875000
NODE_11794_length_807_cov_12.255650	493	573	4	17	80	0.2125000
NODE_11795_length_807_cov_11.129944	359	439	4	80	80	1.0000000
NODE_11795_length_807_cov_11.129944	412	492	0	29	80	0.3625000
NODE_11795_length_807_cov_11.129944	412	492	4	51	80	0.6375000
NODE_11801_length_807_cov_3.847458	322	385	0	63	63	1.0000000
NODE_11822_length_806_cov_35.650636	397	477	0	80	80	1.0000000
NODE_11822_length_806_cov_35.650636	450	530	0	80	80	1.0000000
NODE_11822_length_806_cov_35.650636	526	606	0	80	80	1.0000000
NODE_11822_length_806_cov_35.650636	579	667	0	51	88	0.5795454
NODE_11822_length_806_cov_35.650636	579	667	2	37	88	0.4204545
NODE_11823_length_806_cov_29.615276	377	457	0	12	80	0.1500000
NODE_11823_length_806_cov_29.615276	377	457	1	31	80	0.3875000
NODE_11823_length_806_cov_29.615276	377	457	2	4	80	0.0500000
NODE_11823_length_806_cov_29.615276	377	457	4	33	80	0.4125000
NODE_11823_length_806_cov_29.615276	430	510	0	65	80	0.8125000
NODE_11823_length_806_cov_29.615276	430	510	1	15	80	0.1875000
NODE_11824_length_806_cov_23.680339	394	474	0	80	80	1.0000000
NODE_11824_length_806_cov_23.680339	447	527	0	80	80	1.0000000
NODE_11825_length_806_cov_19.107496	239	293	0	54	54	1.0000000
NODE_11825_length_806_cov_19.107496	248	293	0	45	45	1.0000000
NODE_11825_length_806_cov_19.107496	266	345	0	79	79	1.0000000
NODE_11825_length_806_cov_19.107496	266	345	0	79	79	1.0000000
NODE_11825_length_806_cov_19.107496	421	501	0	34	80	0.4250000
NODE_11825_length_806_cov_19.107496	421	501	2	46	80	0.5750000
NODE_11826_length_806_cov_17.551627	308	388	0	80	80	1.0000000
NODE_11826_length_806_cov_17.551627	361	441	0	80	80	1.0000000
NODE_11827_length_806_cov_15.608204	408	488	0	80	80	1.0000000
NODE_11827_length_806_cov_15.608204	461	543	0	82	82	1.0000000
NODE_11864_length_805_cov_94.121813	398	478	0	80	80	1.0000000
NODE_11864_length_805_cov_94.121813	451	531	0	80	80	1.0000000
NODE_11865_length_805_cov_54.001416	284	364	0	80	80	1.0000000
NODE_11865_length_805_cov_54.001416	337	417	0	80	80	1.0000000
NODE_11865_length_805_cov_54.001416	413	493	0	80	80	1.0000000
NODE_11865_length_805_cov_54.001416	466	546	0	80	80	1.0000000
NODE_11866_length_805_cov_42.325779	377	457	12	33	80	0.4125000
NODE_11866_length_805_cov_42.325779	377	457	14	14	80	0.1750000
NODE_11866_length_805_cov_42.325779	377	457	16	22	80	0.2750000
NODE_11866_length_805_cov_42.325779	377	457	18	11	80	0.1375000
NODE_11866_length_805_cov_42.325779	430	510	10	16	80	0.2000000
NODE_11866_length_805_cov_42.325779	430	510	14	51	80	0.6375000
NODE_11866_length_805_cov_42.325779	430	510	16	2	80	0.0250000
NODE_11866_length_805_cov_42.325779	430	510	18	11	80	0.1375000
NODE_11867_length_805_cov_36.742210	345	425	4	26	80	0.3250000
NODE_11867_length_805_cov_36.742210	345	425	6	6	80	0.0750000
NODE_11867_length_805_cov_36.742210	345	425	8	2	80	0.0250000
NODE_11867_length_805_cov_36.742210	345	425	10	6	80	0.0750000
NODE_11867_length_805_cov_36.742210	345	425	11	1	80	0.0125000
NODE_11867_length_805_cov_36.742210	345	425	12	39	80	0.4875000
NODE_11867_length_805_cov_36.742210	398	478	0	49	80	0.6125000
NODE_11867_length_805_cov_36.742210	398	478	4	30	80	0.3750000
NODE_11867_length_805_cov_36.742210	398	478	6	1	80	0.0125000
NODE_11868_length_805_cov_25.879603	361	441	0	80	80	1.0000000
NODE_11868_length_805_cov_25.879603	414	494	0	80	80	1.0000000
NODE_11869_length_805_cov_25.048159	306	386	0	80	80	1.0000000
NODE_11869_length_805_cov_25.048159	359	439	0	80	80	1.0000000
NODE_11870_length_805_cov_15.453258	311	391	6	80	80	1.0000000
NODE_11870_length_805_cov_15.453258	364	444	0	36	80	0.4500000
NODE_11870_length_805_cov_15.453258	364	444	6	44	80	0.5500000
NODE_11871_length_805_cov_14.930595	264	344	0	80	80	1.0000000
NODE_11871_length_805_cov_14.930595	317	397	0	80	80	1.0000000
NODE_11872_length_805_cov_10.888102	259	339	0	31	80	0.3875000
NODE_11872_length_805_cov_10.888102	259	339	2	49	80	0.6125000
NODE_11872_length_805_cov_10.888102	312	392	0	21	80	0.2625000
NODE_11872_length_805_cov_10.888102	312	392	2	59	80	0.7375000
NODE_11873_length_805_cov_10.716714	348	428	0	80	80	1.0000000
NODE_11873_length_805_cov_10.716714	401	481	0	80	80	1.0000000
NODE_11876_length_805_cov_7.212465	374	454	2	80	80	1.0000000
NODE_11876_length_805_cov_7.212465	427	507	0	22	80	0.2750000
NODE_11876_length_805_cov_7.212465	427	507	2	58	80	0.7250000
NODE_11877_length_805_cov_5.637394	323	403	0	80	80	1.0000000
NODE_11877_length_805_cov_5.637394	376	456	0	80	80	1.0000000
NODE_11878_length_805_cov_4.001416	304	384	0	80	80	1.0000000
NODE_11878_length_805_cov_4.001416	357	437	0	80	80	1.0000000
NODE_11903_length_804_cov_26.204255	319	399	0	80	80	1.0000000
NODE_11903_length_804_cov_26.204255	372	452	0	80	80	1.0000000
NODE_11904_length_804_cov_25.978723	242	322	0	55	80	0.6875000
NODE_11904_length_804_cov_25.978723	242	322	2	25	80	0.3125000
NODE_11904_length_804_cov_25.978723	295	375	0	44	80	0.5500000
NODE_11904_length_804_cov_25.978723	295	375	2	36	80	0.4500000
NODE_11904_length_804_cov_25.978723	371	451	2	80	80	1.0000000
NODE_11904_length_804_cov_25.978723	424	504	0	44	80	0.5500000
NODE_11904_length_804_cov_25.978723	424	504	2	36	80	0.4500000
NODE_11905_length_804_cov_25.628369	444	524	0	80	80	1.0000000
NODE_11905_length_804_cov_25.628369	497	577	0	80	80	1.0000000
NODE_11906_length_804_cov_22.438298	269	349	0	80	80	1.0000000
NODE_11906_length_804_cov_22.438298	322	402	0	80	80	1.0000000
NODE_11907_length_804_cov_17.425532	273	353	0	48	80	0.6000000
NODE_11907_length_804_cov_17.425532	273	353	4	32	80	0.4000000
NODE_11907_length_804_cov_17.425532	326	406	0	80	80	1.0000000
NODE_11908_length_804_cov_16.849645	229	309	0	80	80	1.0000000
NODE_11908_length_804_cov_16.849645	282	362	0	30	80	0.3750000
NODE_11908_length_804_cov_16.849645	282	362	2	50	80	0.6250000
NODE_11909_length_804_cov_16.024113	499	579	2	80	80	1.0000000
NODE_11909_length_804_cov_16.024113	552	632	0	11	80	0.1375000
NODE_11909_length_804_cov_16.024113	552	632	2	69	80	0.8625000
NODE_11910_length_804_cov_14.567376	375	455	0	4	80	0.0500000
NODE_11910_length_804_cov_14.567376	375	455	2	8	80	0.1000000
NODE_11910_length_804_cov_14.567376	375	455	4	68	80	0.8500000
NODE_11910_length_804_cov_14.567376	428	508	0	34	80	0.4250000
NODE_11910_length_804_cov_14.567376	428	508	4	46	80	0.5750000
NODE_11911_length_804_cov_14.011348	262	342	0	64	80	0.8000000
NODE_11911_length_804_cov_14.011348	262	342	2	16	80	0.2000000
NODE_11911_length_804_cov_14.011348	315	395	0	11	80	0.1375000
NODE_11911_length_804_cov_14.011348	315	395	2	69	80	0.8625000
NODE_11912_length_804_cov_13.800000	289	318	0	29	29	1.0000000
NODE_11913_length_804_cov_12.585816	396	476	0	80	80	1.0000000
NODE_11913_length_804_cov_12.585816	449	529	0	76	80	0.9500000
NODE_11913_length_804_cov_12.585816	449	529	2	4	80	0.0500000
NODE_11914_length_804_cov_12.375887	190	270	2	44	80	0.5500000
NODE_11914_length_804_cov_12.375887	190	270	4	36	80	0.4500000
NODE_11914_length_804_cov_12.375887	243	323	2	44	80	0.5500000
NODE_11914_length_804_cov_12.375887	243	323	4	36	80	0.4500000
NODE_11915_length_804_cov_10.947518	363	443	0	7	80	0.0875000
NODE_11915_length_804_cov_10.947518	363	443	4	73	80	0.9125000
NODE_11915_length_804_cov_10.947518	416	496	0	15	80	0.1875000
NODE_11915_length_804_cov_10.947518	416	496	4	65	80	0.8125000
NODE_11916_length_804_cov_8.164539	427	507	9	18	80	0.2250000
NODE_11916_length_804_cov_8.164539	427	507	11	52	80	0.6500000
NODE_11916_length_804_cov_8.164539	427	507	12	10	80	0.1250000
NODE_11916_length_804_cov_8.164539	480	560	0	19	80	0.2375000
NODE_11916_length_804_cov_8.164539	480	560	9	12	80	0.1500000
NODE_11916_length_804_cov_8.164539	480	560	11	49	80	0.6125000
NODE_11917_length_804_cov_7.462411	345	425	0	71	80	0.8875000
NODE_11917_length_804_cov_7.462411	345	425	2	9	80	0.1125000
NODE_11917_length_804_cov_7.462411	398	478	0	18	80	0.2250000
NODE_11917_length_804_cov_7.462411	398	478	2	62	80	0.7750000
NODE_11919_length_804_cov_3.663830	736	799	0	63	63	1.0000000
NODE_11933_length_804_cov_1.303546	480	560	0	30	80	0.3750000
NODE_11933_length_804_cov_1.303546	480	560	2	50	80	0.6250000
NODE_11933_length_804_cov_1.303546	533	613	0	80	80	1.0000000
NODE_11942_length_803_cov_40.930398	374	454	0	10	80	0.1250000
NODE_11942_length_803_cov_40.930398	374	454	4	70	80	0.8750000
NODE_11942_length_803_cov_40.930398	427	507	0	17	80	0.2125000
NODE_11942_length_803_cov_40.930398	427	507	4	63	80	0.7875000
NODE_11944_length_803_cov_28.346591	242	322	0	80	80	1.0000000
NODE_11944_length_803_cov_28.346591	295	375	0	80	80	1.0000000
NODE_11945_length_803_cov_23.420455	288	368	0	40	80	0.5000000
NODE_11945_length_803_cov_23.420455	288	368	2	40	80	0.5000000
NODE_11945_length_803_cov_23.420455	341	421	0	80	80	1.0000000
NODE_11946_length_803_cov_20.977273	316	396	0	80	80	1.0000000
NODE_11946_length_803_cov_20.977273	369	449	0	80	80	1.0000000
NODE_11947_length_803_cov_18.458807	307	387	0	36	80	0.4500000
NODE_11947_length_803_cov_18.458807	307	387	2	44	80	0.5500000
NODE_11947_length_803_cov_18.458807	360	440	0	80	80	1.0000000
NODE_11948_length_803_cov_14.411932	386	466	0	74	80	0.9250000
NODE_11948_length_803_cov_14.411932	386	466	2	6	80	0.0750000
NODE_11948_length_803_cov_14.411932	439	519	0	80	80	1.0000000
NODE_11949_length_803_cov_10.157670	319	399	0	80	80	1.0000000
NODE_11949_length_803_cov_10.157670	372	452	0	80	80	1.0000000
NODE_11950_length_803_cov_8.977273	362	442	1	19	80	0.2375000
NODE_11950_length_803_cov_8.977273	362	442	2	61	80	0.7625000
NODE_11950_length_803_cov_8.977273	415	485	0	35	70	0.5000000
NODE_11950_length_803_cov_8.977273	415	485	2	35	70	0.5000000
NODE_11951_length_803_cov_7.735795	195	275	4	4	80	0.0500000
NODE_11951_length_803_cov_7.735795	195	275	6	20	80	0.2500000
NODE_11951_length_803_cov_7.735795	195	275	8	14	80	0.1750000
NODE_11951_length_803_cov_7.735795	195	275	10	42	80	0.5250000
NODE_11951_length_803_cov_7.735795	248	328	0	6	80	0.0750000
NODE_11951_length_803_cov_7.735795	248	328	1	1	80	0.0125000
NODE_11951_length_803_cov_7.735795	248	328	2	46	80	0.5750000
NODE_11951_length_803_cov_7.735795	248	328	4	4	80	0.0500000
NODE_11951_length_803_cov_7.735795	248	328	6	20	80	0.2500000
NODE_11951_length_803_cov_7.735795	248	328	10	3	80	0.0375000
NODE_11955_length_803_cov_4.613636	266	346	0	68	80	0.8500000
NODE_11955_length_803_cov_4.613636	266	346	2	12	80	0.1500000
NODE_11955_length_803_cov_4.613636	319	399	0	15	80	0.1875000
NODE_11955_length_803_cov_4.613636	319	399	2	65	80	0.8125000
NODE_11957_length_803_cov_4.220170	72	152	0	16	80	0.2000000
NODE_11957_length_803_cov_4.220170	72	152	2	3	80	0.0375000
NODE_11957_length_803_cov_4.220170	72	152	4	8	80	0.1000000
NODE_11957_length_803_cov_4.220170	72	152	6	2	80	0.0250000
NODE_11957_length_803_cov_4.220170	72	152	8	51	80	0.6375000
NODE_11957_length_803_cov_4.220170	130	207	0	17	77	0.2207792
NODE_11957_length_803_cov_4.220170	130	207	2	4	77	0.0519481
NODE_11957_length_803_cov_4.220170	130	207	4	19	77	0.2467532
NODE_11957_length_803_cov_4.220170	130	207	6	10	77	0.1298701
NODE_11957_length_803_cov_4.220170	130	207	8	27	77	0.3506494
NODE_11985_length_802_cov_42.294452	289	369	0	80	80	1.0000000
NODE_11985_length_802_cov_42.294452	342	422	0	80	80	1.0000000
NODE_11986_length_802_cov_31.896159	246	326	0	80	80	1.0000000
NODE_11986_length_802_cov_31.896159	299	379	0	80	80	1.0000000
NODE_11987_length_802_cov_30.786629	419	499	0	17	80	0.2125000
NODE_11987_length_802_cov_30.786629	419	499	2	63	80	0.7875000
NODE_11987_length_802_cov_30.786629	472	552	0	70	80	0.8750000
NODE_11987_length_802_cov_30.786629	472	552	2	10	80	0.1250000
NODE_11988_length_802_cov_19.540541	368	448	0	20	80	0.2500000
NODE_11988_length_802_cov_19.540541	368	448	4	60	80	0.7500000
NODE_11988_length_802_cov_19.540541	421	501	0	30	80	0.3750000
NODE_11988_length_802_cov_19.540541	421	501	4	50	80	0.6250000
NODE_11989_length_802_cov_17.689900	268	348	0	57	80	0.7125000
NODE_11989_length_802_cov_17.689900	268	348	4	23	80	0.2875000
NODE_11989_length_802_cov_17.689900	321	401	0	4	80	0.0500000
NODE_11989_length_802_cov_17.689900	321	401	4	55	80	0.6875000
NODE_11989_length_802_cov_17.689900	321	401	8	21	80	0.2625000
NODE_11990_length_802_cov_16.432432	364	444	0	80	80	1.0000000
NODE_11990_length_802_cov_16.432432	417	497	0	80	80	1.0000000
NODE_11991_length_802_cov_15.409673	317	397	0	80	80	1.0000000
NODE_11991_length_802_cov_15.409673	370	450	0	80	80	1.0000000
NODE_11992_length_802_cov_12.507824	340	420	0	80	80	1.0000000
NODE_11992_length_802_cov_12.507824	393	473	0	80	80	1.0000000
NODE_11993_length_802_cov_9.310100	374	454	0	80	80	1.0000000
NODE_11993_length_802_cov_9.310100	427	507	0	80	80	1.0000000
NODE_11994_length_802_cov_8.421053	272	351	0	46	79	0.5822785
NODE_11994_length_802_cov_8.421053	272	351	2	33	79	0.4177215
NODE_11994_length_802_cov_8.421053	324	404	2	80	80	1.0000000
NODE_11997_length_802_cov_5.576102	294	374	0	80	80	1.0000000
NODE_11997_length_802_cov_5.576102	347	427	0	80	80	1.0000000
NODE_12025_length_801_cov_35.199430	334	414	0	80	80	1.0000000
NODE_12025_length_801_cov_35.199430	387	467	0	80	80	1.0000000
NODE_12026_length_801_cov_20.096866	347	427	2	33	80	0.4125000
NODE_12026_length_801_cov_20.096866	347	427	4	47	80	0.5875000
NODE_12026_length_801_cov_20.096866	400	480	2	16	80	0.2000000
NODE_12026_length_801_cov_20.096866	400	480	4	64	80	0.8000000
NODE_12027_length_801_cov_18.643875	355	435	0	80	80	1.0000000
NODE_12027_length_801_cov_18.643875	408	488	0	80	80	1.0000000
NODE_12028_length_801_cov_16.099715	427	507	0	34	80	0.4250000
NODE_12028_length_801_cov_16.099715	427	507	2	46	80	0.5750000
NODE_12028_length_801_cov_16.099715	480	560	2	80	80	1.0000000
NODE_12029_length_801_cov_12.307692	332	412	0	40	80	0.5000000
NODE_12029_length_801_cov_12.307692	332	412	2	40	80	0.5000000
NODE_12029_length_801_cov_12.307692	385	465	2	80	80	1.0000000
NODE_12030_length_801_cov_11.464387	293	373	0	36	80	0.4500000
NODE_12030_length_801_cov_11.464387	293	373	2	29	80	0.3625000
NODE_12030_length_801_cov_11.464387	293	373	4	15	80	0.1875000
NODE_12030_length_801_cov_11.464387	346	426	2	12	80	0.1500000
NODE_12030_length_801_cov_11.464387	346	426	4	68	80	0.8500000
NODE_12031_length_801_cov_8.562678	309	389	2	80	80	1.0000000
NODE_12031_length_801_cov_8.562678	362	442	0	8	80	0.1000000
NODE_12031_length_801_cov_8.562678	362	442	2	72	80	0.9000000
NODE_12032_length_801_cov_3.927350	339	419	0	80	80	1.0000000
NODE_12032_length_801_cov_3.927350	392	472	0	80	80	1.0000000
NODE_12053_length_800_cov_72.029957	245	325	0	80	80	1.0000000
NODE_12053_length_800_cov_72.029957	298	378	0	80	80	1.0000000
NODE_12054_length_800_cov_22.631954	297	377	10	5	80	0.0625000
NODE_12054_length_800_cov_22.631954	297	377	13	7	80	0.0875000
NODE_12054_length_800_cov_22.631954	297	377	14	68	80	0.8500000
NODE_12054_length_800_cov_22.631954	350	430	0	32	80	0.4000000
NODE_12054_length_800_cov_22.631954	350	430	5	15	80	0.1875000
NODE_12054_length_800_cov_22.631954	350	430	9	3	80	0.0375000
NODE_12054_length_800_cov_22.631954	350	430	10	8	80	0.1000000
NODE_12054_length_800_cov_22.631954	350	430	13	7	80	0.0875000
NODE_12054_length_800_cov_22.631954	350	430	14	15	80	0.1875000
NODE_12055_length_800_cov_9.457917	409	489	2	13	80	0.1625000
NODE_12055_length_800_cov_9.457917	409	489	4	67	80	0.8375000
NODE_12055_length_800_cov_9.457917	462	542	0	19	80	0.2375000
NODE_12055_length_800_cov_9.457917	462	542	2	47	80	0.5875000
NODE_12055_length_800_cov_9.457917	462	542	4	14	80	0.1750000
NODE_12084_length_799_cov_101.640000	101	132	45	1	31	0.0322581
NODE_12084_length_799_cov_101.640000	101	132	49	2	31	0.0645161
NODE_12084_length_799_cov_101.640000	101	132	53	1	31	0.0322581
NODE_12084_length_799_cov_101.640000	101	132	55	1	31	0.0322581
NODE_12084_length_799_cov_101.640000	101	132	57	4	31	0.1290323
NODE_12084_length_799_cov_101.640000	101	132	61	1	31	0.0322581
NODE_12084_length_799_cov_101.640000	101	132	64	1	31	0.0322581
NODE_12084_length_799_cov_101.640000	101	132	70	3	31	0.0967742
NODE_12084_length_799_cov_101.640000	101	132	82	1	31	0.0322581
NODE_12084_length_799_cov_101.640000	101	132	86	1	31	0.0322581
NODE_12084_length_799_cov_101.640000	101	132	90	1	31	0.0322581
NODE_12084_length_799_cov_101.640000	101	132	92	1	31	0.0322581
NODE_12084_length_799_cov_101.640000	101	132	94	1	31	0.0322581
NODE_12084_length_799_cov_101.640000	101	132	96	1	31	0.0322581
NODE_12084_length_799_cov_101.640000	101	132	97	1	31	0.0322581
NODE_12084_length_799_cov_101.640000	101	132	101	1	31	0.0322581
NODE_12084_length_799_cov_101.640000	101	132	105	1	31	0.0322581
NODE_12084_length_799_cov_101.640000	101	132	109	1	31	0.0322581
NODE_12084_length_799_cov_101.640000	101	132	113	2	31	0.0645161
NODE_12084_length_799_cov_101.640000	101	132	115	2	31	0.0645161
NODE_12084_length_799_cov_101.640000	101	132	119	1	31	0.0322581
NODE_12084_length_799_cov_101.640000	101	132	126	2	31	0.0645161
NODE_12085_length_799_cov_33.630000	367	447	0	56	80	0.7000000
NODE_12085_length_799_cov_33.630000	367	447	2	24	80	0.3000000
NODE_12085_length_799_cov_33.630000	420	500	0	3	80	0.0375000
NODE_12085_length_799_cov_33.630000	420	500	2	77	80	0.9625000
NODE_12086_length_799_cov_15.717143	408	488	0	12	80	0.1500000
NODE_12086_length_799_cov_15.717143	408	488	2	58	80	0.7250000
NODE_12086_length_799_cov_15.717143	408	488	5	1	80	0.0125000
NODE_12086_length_799_cov_15.717143	408	488	8	9	80	0.1125000
NODE_12086_length_799_cov_15.717143	461	541	2	17	80	0.2125000
NODE_12086_length_799_cov_15.717143	461	541	5	1	80	0.0125000
NODE_12086_length_799_cov_15.717143	461	541	6	26	80	0.3250000
NODE_12086_length_799_cov_15.717143	461	541	8	36	80	0.4500000
NODE_12087_length_799_cov_15.175714	293	373	0	50	80	0.6250000
NODE_12087_length_799_cov_15.175714	293	373	2	30	80	0.3750000
NODE_12087_length_799_cov_15.175714	346	426	2	37	80	0.4625000
NODE_12087_length_799_cov_15.175714	346	426	8	43	80	0.5375000
NODE_12088_length_799_cov_8.444286	408	488	0	80	80	1.0000000
NODE_12088_length_799_cov_8.444286	461	541	0	80	80	1.0000000
NODE_12120_length_798_cov_42.629471	148	228	0	32	80	0.4000000
NODE_12120_length_798_cov_42.629471	148	228	3	1	80	0.0125000
NODE_12120_length_798_cov_42.629471	148	228	4	18	80	0.2250000
NODE_12120_length_798_cov_42.629471	148	228	8	18	80	0.2250000
NODE_12120_length_798_cov_42.629471	148	228	10	11	80	0.1375000
NODE_12120_length_798_cov_42.629471	201	281	6	5	80	0.0625000
NODE_12120_length_798_cov_42.629471	201	281	8	16	80	0.2000000
NODE_12120_length_798_cov_42.629471	201	281	9	24	80	0.3000000
NODE_12120_length_798_cov_42.629471	201	281	10	35	80	0.4375000
NODE_12121_length_798_cov_23.658083	368	448	2	80	80	1.0000000
NODE_12121_length_798_cov_23.658083	421	501	0	47	80	0.5875000
NODE_12121_length_798_cov_23.658083	421	501	2	33	80	0.4125000
NODE_12122_length_798_cov_15.037196	341	421	0	80	80	1.0000000
NODE_12122_length_798_cov_15.037196	394	474	0	80	80	1.0000000
NODE_12123_length_798_cov_6.816881	404	483	0	79	79	1.0000000
NODE_12123_length_798_cov_6.816881	457	536	0	79	79	1.0000000
NODE_12129_length_798_cov_2.796853	246	326	0	80	80	1.0000000
NODE_12129_length_798_cov_2.796853	299	379	0	80	80	1.0000000
NODE_12151_length_797_cov_24.340974	207	287	4	22	80	0.2750000
NODE_12151_length_797_cov_24.340974	207	287	6	29	80	0.3625000
NODE_12151_length_797_cov_24.340974	207	287	10	29	80	0.3625000
NODE_12151_length_797_cov_24.340974	260	340	4	18	80	0.2250000
NODE_12151_length_797_cov_24.340974	260	340	6	9	80	0.1125000
NODE_12151_length_797_cov_24.340974	260	340	10	53	80	0.6625000
NODE_12152_length_797_cov_21.071633	372	452	4	21	80	0.2625000
NODE_12152_length_797_cov_21.071633	372	452	7	1	80	0.0125000
NODE_12152_length_797_cov_21.071633	372	452	8	16	80	0.2000000
NODE_12152_length_797_cov_21.071633	372	452	12	28	80	0.3500000
NODE_12152_length_797_cov_21.071633	372	452	14	10	80	0.1250000
NODE_12152_length_797_cov_21.071633	372	452	20	4	80	0.0500000
NODE_12152_length_797_cov_21.071633	425	505	12	13	80	0.1625000
NODE_12152_length_797_cov_21.071633	425	505	14	10	80	0.1250000
NODE_12152_length_797_cov_21.071633	425	505	20	10	80	0.1250000
NODE_12152_length_797_cov_21.071633	425	505	22	6	80	0.0750000
NODE_12152_length_797_cov_21.071633	425	505	24	41	80	0.5125000
NODE_12153_length_797_cov_18.286533	346	426	0	80	80	1.0000000
NODE_12153_length_797_cov_18.286533	399	479	0	80	80	1.0000000
NODE_12154_length_797_cov_16.628940	322	402	0	62	80	0.7750000
NODE_12154_length_797_cov_16.628940	322	402	1	18	80	0.2250000
NODE_12154_length_797_cov_16.628940	375	455	0	9	80	0.1125000
NODE_12154_length_797_cov_16.628940	375	455	1	71	80	0.8875000
NODE_12155_length_797_cov_15.266476	299	379	0	36	80	0.4500000
NODE_12155_length_797_cov_15.266476	299	379	2	44	80	0.5500000
NODE_12155_length_797_cov_15.266476	352	432	0	7	80	0.0875000
NODE_12155_length_797_cov_15.266476	352	432	2	73	80	0.9125000
NODE_12156_length_797_cov_15.035817	263	343	0	80	80	1.0000000
NODE_12156_length_797_cov_15.035817	316	396	0	80	80	1.0000000
NODE_12157_length_797_cov_12.934097	403	484	0	81	81	1.0000000
NODE_12157_length_797_cov_12.934097	457	537	0	80	80	1.0000000
NODE_12158_length_797_cov_11.140401	201	281	0	80	80	1.0000000
NODE_12158_length_797_cov_11.140401	254	334	0	80	80	1.0000000
NODE_12159_length_797_cov_8.681948	284	364	0	52	80	0.6500000
NODE_12159_length_797_cov_8.681948	284	364	2	28	80	0.3500000
NODE_12159_length_797_cov_8.681948	337	417	0	80	80	1.0000000
NODE_12160_length_797_cov_7.616046	314	397	0	42	83	0.5060241
NODE_12160_length_797_cov_7.616046	314	397	2	41	83	0.4939759
NODE_12160_length_797_cov_7.616046	370	450	0	80	80	1.0000000
NODE_12161_length_797_cov_7.487106	275	347	2	17	72	0.2361111
NODE_12161_length_797_cov_7.487106	275	347	4	55	72	0.7638889
NODE_12161_length_797_cov_7.487106	320	400	0	27	80	0.3375000
NODE_12161_length_797_cov_7.487106	320	400	4	53	80	0.6625000
NODE_12163_length_797_cov_6.068768	357	437	0	80	80	1.0000000
NODE_12163_length_797_cov_6.068768	410	490	0	80	80	1.0000000
NODE_12186_length_796_cov_20.862267	262	342	0	80	80	1.0000000
NODE_12186_length_796_cov_20.862267	315	395	0	80	80	1.0000000
NODE_12187_length_796_cov_18.291248	283	363	0	50	80	0.6250000
NODE_12187_length_796_cov_18.291248	283	363	2	30	80	0.3750000
NODE_12187_length_796_cov_18.291248	336	416	1	40	80	0.5000000
NODE_12187_length_796_cov_18.291248	336	416	2	40	80	0.5000000
NODE_12189_length_796_cov_7.880918	388	460	0	72	72	1.0000000
NODE_12189_length_796_cov_7.880918	442	513	0	71	71	1.0000000
NODE_12216_length_795_cov_31.729885	298	378	0	12	80	0.1500000
NODE_12216_length_795_cov_31.729885	298	378	2	68	80	0.8500000
NODE_12216_length_795_cov_31.729885	351	431	0	9	80	0.1125000
NODE_12216_length_795_cov_31.729885	351	431	2	71	80	0.8875000
NODE_12217_length_795_cov_26.760057	367	447	2	5	80	0.0625000
NODE_12217_length_795_cov_26.760057	367	447	7	1	80	0.0125000
NODE_12217_length_795_cov_26.760057	367	447	8	74	80	0.9250000
NODE_12217_length_795_cov_26.760057	420	500	2	17	80	0.2125000
NODE_12217_length_795_cov_26.760057	420	500	6	22	80	0.2750000
NODE_12217_length_795_cov_26.760057	420	500	7	1	80	0.0125000
NODE_12217_length_795_cov_26.760057	420	500	8	40	80	0.5000000
NODE_12218_length_795_cov_24.522989	352	432	0	80	80	1.0000000
NODE_12218_length_795_cov_24.522989	405	485	0	80	80	1.0000000
NODE_12219_length_795_cov_22.747126	363	443	0	80	80	1.0000000
NODE_12219_length_795_cov_22.747126	416	496	0	31	80	0.3875000
NODE_12219_length_795_cov_22.747126	416	496	5	1	80	0.0125000
NODE_12219_length_795_cov_22.747126	416	496	6	48	80	0.6000000
NODE_12220_length_795_cov_9.439655	425	505	0	27	80	0.3375000
NODE_12220_length_795_cov_9.439655	425	505	2	53	80	0.6625000
NODE_12220_length_795_cov_9.439655	478	558	0	48	80	0.6000000
NODE_12220_length_795_cov_9.439655	478	558	2	32	80	0.4000000
NODE_12232_length_795_cov_3.359195	349	429	0	80	80	1.0000000
NODE_12232_length_795_cov_3.359195	402	482	0	80	80	1.0000000
NODE_12256_length_794_cov_24.680576	326	406	4	35	80	0.4375000
NODE_12256_length_794_cov_24.680576	326	406	6	15	80	0.1875000
NODE_12256_length_794_cov_24.680576	326	406	8	30	80	0.3750000
NODE_12256_length_794_cov_24.680576	379	459	0	6	80	0.0750000
NODE_12256_length_794_cov_24.680576	379	459	2	28	80	0.3500000
NODE_12256_length_794_cov_24.680576	379	459	4	19	80	0.2375000
NODE_12256_length_794_cov_24.680576	379	459	8	27	80	0.3375000
NODE_12257_length_794_cov_20.057554	153	233	2	80	80	1.0000000
NODE_12257_length_794_cov_20.057554	206	286	0	29	80	0.3625000
NODE_12257_length_794_cov_20.057554	206	286	2	51	80	0.6375000
NODE_12257_length_794_cov_20.057554	282	362	0	72	80	0.9000000
NODE_12257_length_794_cov_20.057554	282	362	2	8	80	0.1000000
NODE_12257_length_794_cov_20.057554	335	415	0	19	80	0.2375000
NODE_12257_length_794_cov_20.057554	335	415	2	61	80	0.7625000
NODE_12258_length_794_cov_16.602878	361	441	0	80	80	1.0000000
NODE_12258_length_794_cov_16.602878	414	494	0	80	80	1.0000000
NODE_12259_length_794_cov_16.362590	337	417	7	56	80	0.7000000
NODE_12259_length_794_cov_16.362590	337	417	8	24	80	0.3000000
NODE_12259_length_794_cov_16.362590	390	470	0	15	80	0.1875000
NODE_12259_length_794_cov_16.362590	390	470	5	1	80	0.0125000
NODE_12259_length_794_cov_16.362590	390	470	7	48	80	0.6000000
NODE_12259_length_794_cov_16.362590	390	470	8	16	80	0.2000000
NODE_12260_length_794_cov_14.444604	101	160	0	59	59	1.0000000
NODE_12260_length_794_cov_14.444604	409	489	0	80	80	1.0000000
NODE_12260_length_794_cov_14.444604	462	542	0	80	80	1.0000000
NODE_12261_length_794_cov_12.866187	442	522	0	14	80	0.1750000
NODE_12261_length_794_cov_12.866187	442	522	2	66	80	0.8250000
NODE_12261_length_794_cov_12.866187	495	575	0	49	80	0.6125000
NODE_12261_length_794_cov_12.866187	495	575	2	31	80	0.3875000
NODE_12262_length_794_cov_12.287770	235	315	0	80	80	1.0000000
NODE_12262_length_794_cov_12.287770	288	368	0	80	80	1.0000000
NODE_12263_length_794_cov_11.210072	315	395	0	34	80	0.4250000
NODE_12263_length_794_cov_11.210072	315	395	4	18	80	0.2250000
NODE_12263_length_794_cov_11.210072	315	395	6	28	80	0.3500000
NODE_12263_length_794_cov_11.210072	368	448	6	80	80	1.0000000
NODE_12264_length_794_cov_10.638849	325	406	0	2	81	0.0246914
NODE_12264_length_794_cov_10.638849	325	406	2	79	81	0.9753087
NODE_12264_length_794_cov_10.638849	379	459	0	55	80	0.6875000
NODE_12264_length_794_cov_10.638849	379	459	2	25	80	0.3125000
NODE_12266_length_794_cov_6.274820	412	492	0	80	80	1.0000000
NODE_12266_length_794_cov_6.274820	465	545	0	80	80	1.0000000
NODE_12271_length_794_cov_3.197122	273	338	0	65	65	1.0000000
NODE_12282_length_794_cov_1.848921	246	326	0	27	80	0.3375000
NODE_12282_length_794_cov_1.848921	246	326	2	53	80	0.6625000
NODE_12282_length_794_cov_1.848921	299	379	0	80	80	1.0000000
NODE_12295_length_793_cov_29.878963	326	406	0	80	80	1.0000000
NODE_12295_length_793_cov_29.878963	379	459	0	80	80	1.0000000
NODE_12296_length_793_cov_25.981268	310	390	0	80	80	1.0000000
NODE_12296_length_793_cov_25.981268	363	445	0	82	82	1.0000000
NODE_12297_length_793_cov_24.840058	331	411	2	80	80	1.0000000
NODE_12297_length_793_cov_24.840058	384	464	0	50	80	0.6250000
NODE_12297_length_793_cov_24.840058	384	464	2	30	80	0.3750000
NODE_12298_length_793_cov_21.707493	398	478	0	35	80	0.4375000
NODE_12298_length_793_cov_21.707493	398	478	2	45	80	0.5625000
NODE_12298_length_793_cov_21.707493	451	531	0	27	80	0.3375000
NODE_12298_length_793_cov_21.707493	451	531	2	53	80	0.6625000
NODE_12299_length_793_cov_8.358790	257	337	5	10	80	0.1250000
NODE_12299_length_793_cov_8.358790	257	337	6	70	80	0.8750000
NODE_12299_length_793_cov_8.358790	310	390	0	11	80	0.1375000
NODE_12299_length_793_cov_8.358790	310	390	5	1	80	0.0125000
NODE_12299_length_793_cov_8.358790	310	390	6	68	80	0.8500000
NODE_12300_length_793_cov_8.236311	477	557	0	80	80	1.0000000
NODE_12300_length_793_cov_8.236311	530	610	0	80	80	1.0000000
NODE_12302_length_793_cov_6.763689	461	541	2	34	80	0.4250000
NODE_12302_length_793_cov_6.763689	461	541	4	46	80	0.5750000
NODE_12302_length_793_cov_6.763689	514	594	0	6	80	0.0750000
NODE_12302_length_793_cov_6.763689	514	594	2	6	80	0.0750000
NODE_12302_length_793_cov_6.763689	514	594	4	68	80	0.8500000
NODE_12307_length_793_cov_4.465418	501	549	0	48	48	1.0000000
NODE_12311_length_793_cov_4.138329	174	254	0	80	80	1.0000000
NODE_12311_length_793_cov_4.138329	227	307	0	80	80	1.0000000
NODE_12338_length_792_cov_40.025974	198	278	0	10	80	0.1250000
NODE_12338_length_792_cov_40.025974	198	278	2	70	80	0.8750000
NODE_12338_length_792_cov_40.025974	251	331	2	47	80	0.5875000
NODE_12338_length_792_cov_40.025974	251	331	4	33	80	0.4125000
NODE_12338_length_792_cov_40.025974	327	408	2	50	81	0.6172839
NODE_12338_length_792_cov_40.025974	327	408	4	31	81	0.3827161
NODE_12338_length_792_cov_40.025974	381	461	0	18	80	0.2250000
NODE_12338_length_792_cov_40.025974	381	461	2	61	80	0.7625000
NODE_12338_length_792_cov_40.025974	381	461	4	1	80	0.0125000
NODE_12339_length_792_cov_31.176046	331	411	0	80	80	1.0000000
NODE_12339_length_792_cov_31.176046	384	463	0	79	79	1.0000000
NODE_12339_length_792_cov_31.176046	459	539	0	80	80	1.0000000
NODE_12339_length_792_cov_31.176046	512	546	0	34	34	1.0000000
NODE_12340_length_792_cov_21.347763	303	383	0	4	80	0.0500000
NODE_12340_length_792_cov_21.347763	303	383	4	37	80	0.4625000
NODE_12340_length_792_cov_21.347763	303	383	6	39	80	0.4875000
NODE_12340_length_792_cov_21.347763	356	436	2	38	80	0.4750000
NODE_12340_length_792_cov_21.347763	356	436	5	1	80	0.0125000
NODE_12340_length_792_cov_21.347763	356	436	6	41	80	0.5125000
NODE_12341_length_792_cov_20.142857	361	441	0	80	80	1.0000000
NODE_12341_length_792_cov_20.142857	414	494	0	80	80	1.0000000
NODE_12342_length_792_cov_18.733045	320	400	2	1	80	0.0125000
NODE_12342_length_792_cov_18.733045	320	400	4	1	80	0.0125000
NODE_12342_length_792_cov_18.733045	320	400	5	15	80	0.1875000
NODE_12342_length_792_cov_18.733045	320	400	6	63	80	0.7875000
NODE_12342_length_792_cov_18.733045	373	453	2	51	80	0.6375000
NODE_12342_length_792_cov_18.733045	373	453	4	4	80	0.0500000
NODE_12342_length_792_cov_18.733045	373	453	5	15	80	0.1875000
NODE_12342_length_792_cov_18.733045	373	453	6	10	80	0.1250000
NODE_12343_length_792_cov_12.024531	369	449	0	80	80	1.0000000
NODE_12343_length_792_cov_12.024531	422	502	0	80	80	1.0000000
NODE_12372_length_791_cov_53.573699	287	359	0	42	72	0.5833333
NODE_12372_length_791_cov_53.573699	287	359	2	30	72	0.4166667
NODE_12372_length_791_cov_53.573699	332	412	2	80	80	1.0000000
NODE_12373_length_791_cov_40.416185	238	318	0	80	80	1.0000000
NODE_12373_length_791_cov_40.416185	291	371	0	80	80	1.0000000
NODE_12374_length_791_cov_38.791908	309	389	0	80	80	1.0000000
NODE_12374_length_791_cov_38.791908	362	442	0	80	80	1.0000000
NODE_12375_length_791_cov_23.468208	328	408	0	56	80	0.7000000
NODE_12375_length_791_cov_23.468208	328	408	2	24	80	0.3000000
NODE_12375_length_791_cov_23.468208	381	461	0	3	80	0.0375000
NODE_12375_length_791_cov_23.468208	381	461	2	77	80	0.9625000
NODE_12376_length_791_cov_20.897399	299	379	0	4	80	0.0500000
NODE_12376_length_791_cov_20.897399	299	379	6	76	80	0.9500000
NODE_12376_length_791_cov_20.897399	352	432	0	29	80	0.3625000
NODE_12376_length_791_cov_20.897399	352	432	6	51	80	0.6375000
NODE_12377_length_791_cov_13.504335	339	419	0	80	80	1.0000000
NODE_12377_length_791_cov_13.504335	392	472	0	80	80	1.0000000
NODE_12379_length_791_cov_12.547688	338	418	0	10	80	0.1250000
NODE_12379_length_791_cov_12.547688	338	418	2	54	80	0.6750000
NODE_12379_length_791_cov_12.547688	338	418	4	16	80	0.2000000
NODE_12379_length_791_cov_12.547688	391	471	0	63	80	0.7875000
NODE_12379_length_791_cov_12.547688	391	471	2	17	80	0.2125000
NODE_12380_length_791_cov_11.791908	440	520	0	80	80	1.0000000
NODE_12380_length_791_cov_11.791908	493	573	0	80	80	1.0000000
NODE_12381_length_791_cov_11.011561	337	417	0	80	80	1.0000000
NODE_12381_length_791_cov_11.011561	390	470	0	80	80	1.0000000
NODE_12382_length_791_cov_8.757225	325	405	2	80	80	1.0000000
NODE_12382_length_791_cov_8.757225	378	458	2	76	80	0.9500000
NODE_12382_length_791_cov_8.757225	378	458	4	4	80	0.0500000
NODE_12384_length_791_cov_8.125723	416	496	0	80	80	1.0000000
NODE_12384_length_791_cov_8.125723	469	549	0	80	80	1.0000000
NODE_12409_length_790_cov_48.021708	526	606	0	2	80	0.0250000
NODE_12409_length_790_cov_48.021708	526	606	4	78	80	0.9750000
NODE_12409_length_790_cov_48.021708	579	659	0	55	80	0.6875000
NODE_12409_length_790_cov_48.021708	579	659	4	25	80	0.3125000
NODE_12410_length_790_cov_44.151954	343	423	0	33	80	0.4125000
NODE_12410_length_790_cov_44.151954	343	423	2	47	80	0.5875000
NODE_12410_length_790_cov_44.151954	396	438	2	42	42	1.0000000
NODE_12410_length_790_cov_44.151954	696	776	37	1	80	0.0125000
NODE_12410_length_790_cov_44.151954	696	776	39	4	80	0.0500000
NODE_12410_length_790_cov_44.151954	696	776	45	2	80	0.0250000
NODE_12410_length_790_cov_44.151954	696	776	47	1	80	0.0125000
NODE_12410_length_790_cov_44.151954	696	776	51	5	80	0.0625000
NODE_12410_length_790_cov_44.151954	696	776	56	1	80	0.0125000
NODE_12410_length_790_cov_44.151954	696	776	70	1	80	0.0125000
NODE_12410_length_790_cov_44.151954	696	776	80	1	80	0.0125000
NODE_12410_length_790_cov_44.151954	696	776	86	1	80	0.0125000
NODE_12410_length_790_cov_44.151954	696	776	98	2	80	0.0250000
NODE_12410_length_790_cov_44.151954	696	776	100	1	80	0.0125000
NODE_12410_length_790_cov_44.151954	696	776	101	1	80	0.0125000
NODE_12410_length_790_cov_44.151954	696	776	103	1	80	0.0125000
NODE_12410_length_790_cov_44.151954	696	776	107	1	80	0.0125000
NODE_12410_length_790_cov_44.151954	696	776	109	2	80	0.0250000
NODE_12410_length_790_cov_44.151954	696	776	116	1	80	0.0125000
NODE_12410_length_790_cov_44.151954	696	776	121	1	80	0.0125000
NODE_12410_length_790_cov_44.151954	696	776	122	1	80	0.0125000
NODE_12410_length_790_cov_44.151954	696	776	124	3	80	0.0375000
NODE_12410_length_790_cov_44.151954	696	776	134	2	80	0.0250000
NODE_12410_length_790_cov_44.151954	696	776	138	3	80	0.0375000
NODE_12410_length_790_cov_44.151954	696	776	140	3	80	0.0375000
NODE_12410_length_790_cov_44.151954	696	776	144	2	80	0.0250000
NODE_12410_length_790_cov_44.151954	696	776	152	3	80	0.0375000
NODE_12410_length_790_cov_44.151954	696	776	154	2	80	0.0250000
NODE_12410_length_790_cov_44.151954	696	776	158	2	80	0.0250000
NODE_12410_length_790_cov_44.151954	696	776	161	9	80	0.1125000
NODE_12410_length_790_cov_44.151954	696	776	162	4	80	0.0500000
NODE_12410_length_790_cov_44.151954	696	776	164	1	80	0.0125000
NODE_12410_length_790_cov_44.151954	696	776	165	3	80	0.0375000
NODE_12410_length_790_cov_44.151954	696	776	166	3	80	0.0375000
NODE_12410_length_790_cov_44.151954	696	776	168	3	80	0.0375000
NODE_12410_length_790_cov_44.151954	696	776	170	3	80	0.0375000
NODE_12410_length_790_cov_44.151954	696	776	172	1	80	0.0125000
NODE_12410_length_790_cov_44.151954	696	776	173	5	80	0.0625000
NODE_12411_length_790_cov_27.144718	291	371	0	20	80	0.2500000
NODE_12411_length_790_cov_27.144718	291	371	13	13	80	0.1625000
NODE_12411_length_790_cov_27.144718	291	371	14	16	80	0.2000000
NODE_12411_length_790_cov_27.144718	291	371	15	1	80	0.0125000
NODE_12411_length_790_cov_27.144718	291	371	17	3	80	0.0375000
NODE_12411_length_790_cov_27.144718	291	371	18	27	80	0.3375000
NODE_12411_length_790_cov_27.144718	344	424	0	18	80	0.2250000
NODE_12411_length_790_cov_27.144718	344	424	2	11	80	0.1375000
NODE_12411_length_790_cov_27.144718	344	424	18	51	80	0.6375000
NODE_12412_length_790_cov_16.973951	232	312	0	80	80	1.0000000
NODE_12412_length_790_cov_16.973951	285	365	0	80	80	1.0000000
NODE_12413_length_790_cov_13.374819	204	284	2	27	80	0.3375000
NODE_12413_length_790_cov_13.374819	204	284	3	12	80	0.1500000
NODE_12413_length_790_cov_13.374819	204	284	5	41	80	0.5125000
NODE_12413_length_790_cov_13.374819	257	337	0	6	80	0.0750000
NODE_12413_length_790_cov_13.374819	257	337	2	74	80	0.9250000
NODE_12415_length_790_cov_10.613603	302	382	0	10	80	0.1250000
NODE_12415_length_790_cov_10.613603	302	382	2	1	80	0.0125000
NODE_12415_length_790_cov_10.613603	302	382	6	69	80	0.8625000
NODE_12415_length_790_cov_10.613603	355	435	0	63	80	0.7875000
NODE_12415_length_790_cov_10.613603	355	435	2	1	80	0.0125000
NODE_12415_length_790_cov_10.613603	355	435	6	16	80	0.2000000
NODE_12418_length_790_cov_5.493488	271	351	8	80	80	1.0000000
NODE_12418_length_790_cov_5.493488	324	404	0	31	80	0.3875000
NODE_12418_length_790_cov_5.493488	324	404	4	11	80	0.1375000
NODE_12418_length_790_cov_5.493488	324	404	7	1	80	0.0125000
NODE_12418_length_790_cov_5.493488	324	404	8	37	80	0.4625000
NODE_12434_length_790_cov_1.463097	313	376	0	63	63	1.0000000
NODE_12452_length_789_cov_39.123188	226	306	0	16	80	0.2000000
NODE_12452_length_789_cov_39.123188	226	306	1	3	80	0.0375000
NODE_12452_length_789_cov_39.123188	226	306	2	61	80	0.7625000
NODE_12452_length_789_cov_39.123188	279	359	0	52	80	0.6500000
NODE_12452_length_789_cov_39.123188	279	359	1	4	80	0.0500000
NODE_12452_length_789_cov_39.123188	279	359	2	24	80	0.3000000
NODE_12453_length_789_cov_37.205797	423	503	0	80	80	1.0000000
NODE_12453_length_789_cov_37.205797	476	556	0	80	80	1.0000000
NODE_12454_length_789_cov_31.311594	223	303	0	80	80	1.0000000
NODE_12454_length_789_cov_31.311594	276	356	0	80	80	1.0000000
NODE_12455_length_789_cov_30.536232	306	386	28	12	80	0.1500000
NODE_12455_length_789_cov_30.536232	306	386	29	26	80	0.3250000
NODE_12455_length_789_cov_30.536232	306	386	30	1	80	0.0125000
NODE_12455_length_789_cov_30.536232	306	386	31	41	80	0.5125000
NODE_12455_length_789_cov_30.536232	359	439	0	39	80	0.4875000
NODE_12455_length_789_cov_30.536232	359	439	2	7	80	0.0875000
NODE_12455_length_789_cov_30.536232	359	439	28	19	80	0.2375000
NODE_12455_length_789_cov_30.536232	359	439	29	13	80	0.1625000
NODE_12455_length_789_cov_30.536232	359	439	30	1	80	0.0125000
NODE_12455_length_789_cov_30.536232	359	439	31	1	80	0.0125000
NODE_12456_length_789_cov_24.886957	343	423	0	80	80	1.0000000
NODE_12456_length_789_cov_24.886957	396	476	0	80	80	1.0000000
NODE_12457_length_789_cov_23.539130	357	437	0	4	80	0.0500000
NODE_12457_length_789_cov_23.539130	357	437	1	3	80	0.0375000
NODE_12457_length_789_cov_23.539130	357	437	2	24	80	0.3000000
NODE_12457_length_789_cov_23.539130	357	437	4	15	80	0.1875000
NODE_12457_length_789_cov_23.539130	357	437	8	34	80	0.4250000
NODE_12457_length_789_cov_23.539130	410	490	6	36	80	0.4500000
NODE_12457_length_789_cov_23.539130	410	490	8	44	80	0.5500000
NODE_12458_length_789_cov_16.169565	392	472	0	80	80	1.0000000
NODE_12458_length_789_cov_16.169565	445	525	0	80	80	1.0000000
NODE_12459_length_789_cov_15.175362	242	322	0	80	80	1.0000000
NODE_12459_length_789_cov_15.175362	295	375	0	80	80	1.0000000
NODE_12459_length_789_cov_15.175362	371	451	0	80	80	1.0000000
NODE_12459_length_789_cov_15.175362	424	504	0	80	80	1.0000000
NODE_12460_length_789_cov_7.276812	306	386	0	80	80	1.0000000
NODE_12460_length_789_cov_7.276812	359	439	0	80	80	1.0000000
NODE_12482_length_788_cov_43.091437	335	415	0	80	80	1.0000000
NODE_12482_length_788_cov_43.091437	388	460	0	72	72	1.0000000
NODE_12483_length_788_cov_38.914369	345	425	2	70	80	0.8750000
NODE_12483_length_788_cov_38.914369	345	425	4	10	80	0.1250000
NODE_12483_length_788_cov_38.914369	398	478	2	70	80	0.8750000
NODE_12483_length_788_cov_38.914369	398	478	4	10	80	0.1250000
NODE_12484_length_788_cov_36.148041	320	400	0	61	80	0.7625000
NODE_12484_length_788_cov_36.148041	320	400	1	19	80	0.2375000
NODE_12484_length_788_cov_36.148041	373	453	0	11	80	0.1375000
NODE_12484_length_788_cov_36.148041	373	453	1	69	80	0.8625000
NODE_12485_length_788_cov_35.460087	346	426	4	16	80	0.2000000
NODE_12485_length_788_cov_35.460087	346	426	8	29	80	0.3625000
NODE_12485_length_788_cov_35.460087	346	426	12	35	80	0.4375000
NODE_12485_length_788_cov_35.460087	399	479	0	17	80	0.2125000
NODE_12485_length_788_cov_35.460087	399	479	4	52	80	0.6500000
NODE_12485_length_788_cov_35.460087	399	479	12	11	80	0.1375000
NODE_12486_length_788_cov_30.785196	278	358	0	20	80	0.2500000
NODE_12486_length_788_cov_30.785196	278	358	2	59	80	0.7375000
NODE_12486_length_788_cov_30.785196	278	358	4	1	80	0.0125000
NODE_12486_length_788_cov_30.785196	331	411	2	71	80	0.8875000
NODE_12486_length_788_cov_30.785196	331	411	4	9	80	0.1125000
NODE_12488_length_788_cov_20.867925	300	380	0	44	80	0.5500000
NODE_12488_length_788_cov_20.867925	300	380	2	36	80	0.4500000
NODE_12488_length_788_cov_20.867925	353	430	0	17	77	0.2207792
NODE_12488_length_788_cov_20.867925	353	430	2	60	77	0.7792208
NODE_12489_length_788_cov_20.821480	322	402	0	80	80	1.0000000
NODE_12489_length_788_cov_20.821480	375	455	0	80	80	1.0000000
NODE_12490_length_788_cov_15.570392	342	422	0	80	80	1.0000000
NODE_12490_length_788_cov_15.570392	395	475	0	80	80	1.0000000
NODE_12491_length_788_cov_12.235123	241	321	0	9	80	0.1125000
NODE_12491_length_788_cov_12.235123	241	321	2	71	80	0.8875000
NODE_12491_length_788_cov_12.235123	294	374	0	18	80	0.2250000
NODE_12491_length_788_cov_12.235123	294	374	2	62	80	0.7750000
NODE_12492_length_788_cov_10.509434	405	480	0	47	75	0.6266667
NODE_12492_length_788_cov_10.509434	405	480	2	1	75	0.0133333
NODE_12492_length_788_cov_10.509434	405	480	4	27	75	0.3600000
NODE_12493_length_788_cov_9.737300	310	390	0	55	80	0.6875000
NODE_12493_length_788_cov_9.737300	310	390	2	25	80	0.3125000
NODE_12493_length_788_cov_9.737300	363	443	0	4	80	0.0500000
NODE_12493_length_788_cov_9.737300	363	443	2	76	80	0.9500000
NODE_12494_length_788_cov_8.872279	280	360	0	34	80	0.4250000
NODE_12494_length_788_cov_8.872279	280	360	2	18	80	0.2250000
NODE_12494_length_788_cov_8.872279	280	360	4	28	80	0.3500000
NODE_12494_length_788_cov_8.872279	333	413	2	10	80	0.1250000
NODE_12494_length_788_cov_8.872279	333	413	4	70	80	0.8750000
NODE_12516_length_787_cov_34.683140	274	335	0	61	61	1.0000000
NODE_12516_length_787_cov_34.683140	319	380	0	61	61	1.0000000
NODE_12517_length_787_cov_28.039244	252	329	0	77	77	1.0000000
NODE_12517_length_787_cov_28.039244	302	370	0	68	68	1.0000000
NODE_12518_length_787_cov_25.422965	351	431	0	80	80	1.0000000
NODE_12518_length_787_cov_25.422965	404	484	0	80	80	1.0000000
NODE_12519_length_787_cov_24.857558	319	399	8	80	80	1.0000000
NODE_12519_length_787_cov_24.857558	372	452	0	34	80	0.4250000
NODE_12519_length_787_cov_24.857558	372	452	8	46	80	0.5750000
NODE_12520_length_787_cov_21.357558	291	371	0	80	80	1.0000000
NODE_12520_length_787_cov_21.357558	344	424	0	80	80	1.0000000
NODE_12521_length_787_cov_17.360465	396	476	0	76	80	0.9500000
NODE_12521_length_787_cov_17.360465	396	476	2	4	80	0.0500000
NODE_12521_length_787_cov_17.360465	449	529	0	23	80	0.2875000
NODE_12521_length_787_cov_17.360465	449	529	2	57	80	0.7125000
NODE_12522_length_787_cov_14.677326	178	258	0	61	80	0.7625000
NODE_12522_length_787_cov_14.677326	178	258	3	1	80	0.0125000
NODE_12522_length_787_cov_14.677326	178	258	4	18	80	0.2250000
NODE_12522_length_787_cov_14.677326	231	311	0	8	80	0.1000000
NODE_12522_length_787_cov_14.677326	231	311	3	1	80	0.0125000
NODE_12522_length_787_cov_14.677326	231	311	4	71	80	0.8875000
NODE_12523_length_787_cov_12.959302	331	411	2	64	80	0.8000000
NODE_12523_length_787_cov_12.959302	331	411	4	16	80	0.2000000
NODE_12523_length_787_cov_12.959302	384	464	0	39	80	0.4875000
NODE_12523_length_787_cov_12.959302	384	464	2	41	80	0.5125000
NODE_12524_length_787_cov_12.748547	426	506	0	9	80	0.1125000
NODE_12524_length_787_cov_12.748547	426	506	2	71	80	0.8875000
NODE_12524_length_787_cov_12.748547	479	559	0	21	80	0.2625000
NODE_12524_length_787_cov_12.748547	479	559	2	59	80	0.7375000
NODE_12525_length_787_cov_12.369186	338	418	0	80	80	1.0000000
NODE_12525_length_787_cov_12.369186	391	471	0	80	80	1.0000000
NODE_12526_length_787_cov_9.213663	376	456	0	80	80	1.0000000
NODE_12527_length_787_cov_8.857558	344	424	0	80	80	1.0000000
NODE_12527_length_787_cov_8.857558	397	477	0	60	80	0.7500000
NODE_12527_length_787_cov_8.857558	397	477	2	20	80	0.2500000
NODE_12529_length_787_cov_8.186047	508	552	0	44	44	1.0000000
NODE_12541_length_787_cov_2.188953	505	552	0	47	47	1.0000000
NODE_12562_length_786_cov_36.441048	431	511	2	80	80	1.0000000
NODE_12562_length_786_cov_36.441048	484	564	0	52	80	0.6500000
NODE_12562_length_786_cov_36.441048	484	564	2	28	80	0.3500000
NODE_12563_length_786_cov_23.771470	235	315	0	80	80	1.0000000
NODE_12563_length_786_cov_23.771470	288	368	0	80	80	1.0000000
NODE_12564_length_786_cov_23.333333	361	436	7	8	75	0.1066667
NODE_12564_length_786_cov_23.333333	361	436	8	35	75	0.4666667
NODE_12564_length_786_cov_23.333333	361	436	9	30	75	0.4000000
NODE_12564_length_786_cov_23.333333	361	436	17	2	75	0.0266667
NODE_12564_length_786_cov_23.333333	362	436	7	8	74	0.1081081
NODE_12564_length_786_cov_23.333333	362	436	8	34	74	0.4594595
NODE_12564_length_786_cov_23.333333	362	436	9	30	74	0.4054054
NODE_12564_length_786_cov_23.333333	362	436	17	2	74	0.0270270
NODE_12564_length_786_cov_23.333333	375	436	7	8	61	0.1311475
NODE_12564_length_786_cov_23.333333	375	436	8	21	61	0.3442623
NODE_12564_length_786_cov_23.333333	375	436	9	30	61	0.4918033
NODE_12564_length_786_cov_23.333333	375	436	17	2	61	0.0327869
NODE_12564_length_786_cov_23.333333	414	489	9	20	75	0.2666667
NODE_12564_length_786_cov_23.333333	414	489	17	4	75	0.0533333
NODE_12564_length_786_cov_23.333333	414	489	19	1	75	0.0133333
NODE_12564_length_786_cov_23.333333	414	489	20	21	75	0.2800000
NODE_12564_length_786_cov_23.333333	414	489	21	18	75	0.2400000
NODE_12564_length_786_cov_23.333333	414	489	24	11	75	0.1466667
NODE_12564_length_786_cov_23.333333	414	489	9	20	75	0.2666667
NODE_12564_length_786_cov_23.333333	414	489	17	4	75	0.0533333
NODE_12564_length_786_cov_23.333333	414	489	19	1	75	0.0133333
NODE_12564_length_786_cov_23.333333	414	489	20	21	75	0.2800000
NODE_12564_length_786_cov_23.333333	414	489	21	18	75	0.2400000
NODE_12564_length_786_cov_23.333333	414	489	24	11	75	0.1466667
NODE_12564_length_786_cov_23.333333	414	489	9	20	75	0.2666667
NODE_12564_length_786_cov_23.333333	414	489	17	4	75	0.0533333
NODE_12564_length_786_cov_23.333333	414	489	19	1	75	0.0133333
NODE_12564_length_786_cov_23.333333	414	489	20	21	75	0.2800000
NODE_12564_length_786_cov_23.333333	414	489	21	18	75	0.2400000
NODE_12564_length_786_cov_23.333333	414	489	24	11	75	0.1466667
NODE_12564_length_786_cov_23.333333	490	564	10	22	74	0.2972973
NODE_12564_length_786_cov_23.333333	490	564	12	13	74	0.1756757
NODE_12564_length_786_cov_23.333333	490	564	14	22	74	0.2972973
NODE_12564_length_786_cov_23.333333	490	564	20	17	74	0.2297297
NODE_12565_length_786_cov_19.279476	310	375	0	65	65	1.0000000
NODE_12565_length_786_cov_19.279476	371	441	0	70	70	1.0000000
NODE_12565_length_786_cov_19.279476	371	451	0	80	80	1.0000000
NODE_12565_length_786_cov_19.279476	424	491	0	67	67	1.0000000
NODE_12566_length_786_cov_18.652111	251	331	0	80	80	1.0000000
NODE_12566_length_786_cov_18.652111	304	384	0	80	80	1.0000000
NODE_12567_length_786_cov_16.704512	319	399	0	80	80	1.0000000
NODE_12567_length_786_cov_16.704512	372	452	0	80	80	1.0000000
NODE_12568_length_786_cov_16.254731	378	458	4	12	80	0.1500000
NODE_12568_length_786_cov_16.254731	378	458	6	2	80	0.0250000
NODE_12568_length_786_cov_16.254731	378	458	10	66	80	0.8250000
NODE_12568_length_786_cov_16.254731	431	511	0	53	80	0.6625000
NODE_12568_length_786_cov_16.254731	431	511	4	12	80	0.1500000
NODE_12568_length_786_cov_16.254731	431	511	6	1	80	0.0125000
NODE_12568_length_786_cov_16.254731	431	511	10	14	80	0.1750000
NODE_12571_length_786_cov_10.053857	381	461	0	72	80	0.9000000
NODE_12571_length_786_cov_10.053857	381	461	2	8	80	0.1000000
NODE_12571_length_786_cov_10.053857	434	514	0	80	80	1.0000000
NODE_12572_length_786_cov_7.455604	400	473	0	12	73	0.1643836
NODE_12572_length_786_cov_7.455604	400	473	2	1	73	0.0136986
NODE_12572_length_786_cov_7.455604	400	473	4	60	73	0.8219178
NODE_12572_length_786_cov_7.455604	453	533	0	32	80	0.4000000
NODE_12572_length_786_cov_7.455604	453	533	2	10	80	0.1250000
NODE_12572_length_786_cov_7.455604	453	533	4	38	80	0.4750000
NODE_12573_length_786_cov_7.119360	276	356	0	80	80	1.0000000
NODE_12573_length_786_cov_7.119360	329	409	0	80	80	1.0000000
NODE_12575_length_786_cov_6.771470	382	462	0	10	80	0.1250000
NODE_12575_length_786_cov_6.771470	382	462	2	70	80	0.8750000
NODE_12575_length_786_cov_6.771470	435	515	0	14	80	0.1750000
NODE_12575_length_786_cov_6.771470	435	515	2	66	80	0.8250000
NODE_12603_length_785_cov_83.972303	315	395	0	80	80	1.0000000
NODE_12603_length_785_cov_83.972303	368	448	0	80	80	1.0000000
NODE_12604_length_785_cov_33.911079	477	557	0	80	80	1.0000000
NODE_12604_length_785_cov_33.911079	530	610	0	80	80	1.0000000
NODE_12605_length_785_cov_21.174927	265	299	0	34	34	1.0000000
NODE_12605_length_785_cov_21.174927	295	375	0	48	80	0.6000000
NODE_12605_length_785_cov_21.174927	295	375	2	5	80	0.0625000
NODE_12605_length_785_cov_21.174927	295	375	6	27	80	0.3375000
NODE_12605_length_785_cov_21.174927	348	428	4	18	80	0.2250000
NODE_12605_length_785_cov_21.174927	348	428	6	62	80	0.7750000
NODE_12606_length_785_cov_18.612245	291	371	0	80	80	1.0000000
NODE_12606_length_785_cov_18.612245	344	424	0	80	80	1.0000000
NODE_12606_length_785_cov_18.612245	684	705	2	21	21	1.0000000
NODE_12607_length_785_cov_9.893586	153	233	2	41	80	0.5125000
NODE_12607_length_785_cov_9.893586	153	233	4	39	80	0.4875000
NODE_12607_length_785_cov_9.893586	206	286	0	5	80	0.0625000
NODE_12607_length_785_cov_9.893586	206	286	2	75	80	0.9375000
NODE_12645_length_784_cov_203.604380	5	85	118	1	80	0.0125000
NODE_12645_length_784_cov_203.604380	5	85	127	1	80	0.0125000
NODE_12645_length_784_cov_203.604380	5	85	151	1	80	0.0125000
NODE_12645_length_784_cov_203.604380	5	85	163	1	80	0.0125000
NODE_12645_length_784_cov_203.604380	5	85	171	1	80	0.0125000
NODE_12645_length_784_cov_203.604380	5	85	199	1	80	0.0125000
NODE_12645_length_784_cov_203.604380	5	85	212	1	80	0.0125000
NODE_12645_length_784_cov_203.604380	5	85	219	1	80	0.0125000
NODE_12645_length_784_cov_203.604380	5	85	242	1	80	0.0125000
NODE_12645_length_784_cov_203.604380	5	85	245	1	80	0.0125000
NODE_12645_length_784_cov_203.604380	5	85	258	1	80	0.0125000
NODE_12645_length_784_cov_203.604380	5	85	264	1	80	0.0125000
NODE_12645_length_784_cov_203.604380	5	85	266	1	80	0.0125000
NODE_12645_length_784_cov_203.604380	5	85	297	1	80	0.0125000
NODE_12645_length_784_cov_203.604380	5	85	307	1	80	0.0125000
NODE_12645_length_784_cov_203.604380	5	85	310	1	80	0.0125000
NODE_12645_length_784_cov_203.604380	5	85	326	1	80	0.0125000
NODE_12645_length_784_cov_203.604380	5	85	332	1	80	0.0125000
NODE_12645_length_784_cov_203.604380	5	85	333	1	80	0.0125000
NODE_12645_length_784_cov_203.604380	5	85	341	1	80	0.0125000
NODE_12645_length_784_cov_203.604380	5	85	360	1	80	0.0125000
NODE_12645_length_784_cov_203.604380	5	85	386	1	80	0.0125000
NODE_12645_length_784_cov_203.604380	5	85	392	1	80	0.0125000
NODE_12645_length_784_cov_203.604380	5	85	400	1	80	0.0125000
NODE_12645_length_784_cov_203.604380	5	85	409	1	80	0.0125000
NODE_12645_length_784_cov_203.604380	5	85	438	1	80	0.0125000
NODE_12645_length_784_cov_203.604380	5	85	443	1	80	0.0125000
NODE_12645_length_784_cov_203.604380	5	85	448	1	80	0.0125000
NODE_12645_length_784_cov_203.604380	5	85	451	2	80	0.0250000
NODE_12645_length_784_cov_203.604380	5	85	453	2	80	0.0250000
NODE_12645_length_784_cov_203.604380	5	85	459	1	80	0.0125000
NODE_12645_length_784_cov_203.604380	5	85	462	1	80	0.0125000
NODE_12645_length_784_cov_203.604380	5	85	466	1	80	0.0125000
NODE_12645_length_784_cov_203.604380	5	85	475	1	80	0.0125000
NODE_12645_length_784_cov_203.604380	5	85	488	1	80	0.0125000
NODE_12645_length_784_cov_203.604380	5	85	496	1	80	0.0125000
NODE_12645_length_784_cov_203.604380	5	85	517	1	80	0.0125000
NODE_12645_length_784_cov_203.604380	5	85	518	1	80	0.0125000
NODE_12645_length_784_cov_203.604380	5	85	522	1	80	0.0125000
NODE_12645_length_784_cov_203.604380	5	85	530	1	80	0.0125000
NODE_12645_length_784_cov_203.604380	5	85	537	1	80	0.0125000
NODE_12645_length_784_cov_203.604380	5	85	539	1	80	0.0125000
NODE_12645_length_784_cov_203.604380	5	85	540	2	80	0.0250000
NODE_12645_length_784_cov_203.604380	5	85	546	1	80	0.0125000
NODE_12645_length_784_cov_203.604380	5	85	551	1	80	0.0125000
NODE_12645_length_784_cov_203.604380	5	85	560	1	80	0.0125000
NODE_12645_length_784_cov_203.604380	5	85	565	1	80	0.0125000
NODE_12645_length_784_cov_203.604380	5	85	576	1	80	0.0125000
NODE_12645_length_784_cov_203.604380	5	85	580	1	80	0.0125000
NODE_12645_length_784_cov_203.604380	5	85	584	1	80	0.0125000
NODE_12645_length_784_cov_203.604380	5	85	585	1	80	0.0125000
NODE_12645_length_784_cov_203.604380	5	85	586	1	80	0.0125000
NODE_12645_length_784_cov_203.604380	5	85	587	1	80	0.0125000
NODE_12645_length_784_cov_203.604380	5	85	589	2	80	0.0250000
NODE_12645_length_784_cov_203.604380	5	85	596	1	80	0.0125000
NODE_12645_length_784_cov_203.604380	5	85	598	3	80	0.0375000
NODE_12645_length_784_cov_203.604380	5	85	599	1	80	0.0125000
NODE_12645_length_784_cov_203.604380	5	85	602	2	80	0.0250000
NODE_12645_length_784_cov_203.604380	5	85	606	1	80	0.0125000
NODE_12645_length_784_cov_203.604380	5	85	617	1	80	0.0125000
NODE_12645_length_784_cov_203.604380	5	85	623	1	80	0.0125000
NODE_12645_length_784_cov_203.604380	5	85	625	1	80	0.0125000
NODE_12645_length_784_cov_203.604380	5	85	630	2	80	0.0250000
NODE_12645_length_784_cov_203.604380	5	85	631	1	80	0.0125000
NODE_12645_length_784_cov_203.604380	5	85	641	1	80	0.0125000
NODE_12645_length_784_cov_203.604380	5	85	643	1	80	0.0125000
NODE_12645_length_784_cov_203.604380	5	85	648	1	80	0.0125000
NODE_12645_length_784_cov_203.604380	5	85	650	2	80	0.0250000
NODE_12645_length_784_cov_203.604380	5	85	654	1	80	0.0125000
NODE_12645_length_784_cov_203.604380	5	85	661	1	80	0.0125000
NODE_12645_length_784_cov_203.604380	5	85	669	1	80	0.0125000
NODE_12645_length_784_cov_203.604380	58	138	530	1	80	0.0125000
NODE_12645_length_784_cov_203.604380	58	138	532	2	80	0.0250000
NODE_12645_length_784_cov_203.604380	58	138	536	1	80	0.0125000
NODE_12645_length_784_cov_203.604380	58	138	537	1	80	0.0125000
NODE_12645_length_784_cov_203.604380	58	138	538	1	80	0.0125000
NODE_12645_length_784_cov_203.604380	58	138	555	1	80	0.0125000
NODE_12645_length_784_cov_203.604380	58	138	556	1	80	0.0125000
NODE_12645_length_784_cov_203.604380	58	138	560	1	80	0.0125000
NODE_12645_length_784_cov_203.604380	58	138	571	1	80	0.0125000
NODE_12645_length_784_cov_203.604380	58	138	578	1	80	0.0125000
NODE_12645_length_784_cov_203.604380	58	138	579	1	80	0.0125000
NODE_12645_length_784_cov_203.604380	58	138	585	1	80	0.0125000
NODE_12645_length_784_cov_203.604380	58	138	586	2	80	0.0250000
NODE_12645_length_784_cov_203.604380	58	138	587	1	80	0.0125000
NODE_12645_length_784_cov_203.604380	58	138	589	2	80	0.0250000
NODE_12645_length_784_cov_203.604380	58	138	591	1	80	0.0125000
NODE_12645_length_784_cov_203.604380	58	138	596	1	80	0.0125000
NODE_12645_length_784_cov_203.604380	58	138	598	3	80	0.0375000
NODE_12645_length_784_cov_203.604380	58	138	599	1	80	0.0125000
NODE_12645_length_784_cov_203.604380	58	138	602	3	80	0.0375000
NODE_12645_length_784_cov_203.604380	58	138	606	1	80	0.0125000
NODE_12645_length_784_cov_203.604380	58	138	608	1	80	0.0125000
NODE_12645_length_784_cov_203.604380	58	138	617	1	80	0.0125000
NODE_12645_length_784_cov_203.604380	58	138	622	1	80	0.0125000
NODE_12645_length_784_cov_203.604380	58	138	623	1	80	0.0125000
NODE_12645_length_784_cov_203.604380	58	138	625	1	80	0.0125000
NODE_12645_length_784_cov_203.604380	58	138	627	1	80	0.0125000
NODE_12645_length_784_cov_203.604380	58	138	629	4	80	0.0500000
NODE_12645_length_784_cov_203.604380	58	138	630	2	80	0.0250000
NODE_12645_length_784_cov_203.604380	58	138	631	3	80	0.0375000
NODE_12645_length_784_cov_203.604380	58	138	632	1	80	0.0125000
NODE_12645_length_784_cov_203.604380	58	138	634	1	80	0.0125000
NODE_12645_length_784_cov_203.604380	58	138	641	1	80	0.0125000
NODE_12645_length_784_cov_203.604380	58	138	643	1	80	0.0125000
NODE_12645_length_784_cov_203.604380	58	138	648	1	80	0.0125000
NODE_12645_length_784_cov_203.604380	58	138	650	2	80	0.0250000
NODE_12645_length_784_cov_203.604380	58	138	654	1	80	0.0125000
NODE_12645_length_784_cov_203.604380	58	138	658	2	80	0.0250000
NODE_12645_length_784_cov_203.604380	58	138	660	1	80	0.0125000
NODE_12645_length_784_cov_203.604380	58	138	661	1	80	0.0125000
NODE_12645_length_784_cov_203.604380	58	138	669	1	80	0.0125000
NODE_12645_length_784_cov_203.604380	58	138	670	1	80	0.0125000
NODE_12645_length_784_cov_203.604380	58	138	674	3	80	0.0375000
NODE_12645_length_784_cov_203.604380	58	138	675	2	80	0.0250000
NODE_12645_length_784_cov_203.604380	58	138	676	1	80	0.0125000
NODE_12645_length_784_cov_203.604380	58	138	685	1	80	0.0125000
NODE_12645_length_784_cov_203.604380	58	138	687	1	80	0.0125000
NODE_12645_length_784_cov_203.604380	58	138	688	1	80	0.0125000
NODE_12645_length_784_cov_203.604380	58	138	691	1	80	0.0125000
NODE_12645_length_784_cov_203.604380	58	138	693	1	80	0.0125000
NODE_12645_length_784_cov_203.604380	58	138	696	1	80	0.0125000
NODE_12645_length_784_cov_203.604380	58	138	698	1	80	0.0125000
NODE_12645_length_784_cov_203.604380	58	138	704	1	80	0.0125000
NODE_12645_length_784_cov_203.604380	58	138	707	1	80	0.0125000
NODE_12645_length_784_cov_203.604380	58	138	710	1	80	0.0125000
NODE_12645_length_784_cov_203.604380	58	138	711	2	80	0.0250000
NODE_12645_length_784_cov_203.604380	58	138	716	1	80	0.0125000
NODE_12645_length_784_cov_203.604380	58	138	717	1	80	0.0125000
NODE_12645_length_784_cov_203.604380	58	138	720	2	80	0.0250000
NODE_12645_length_784_cov_203.604380	58	138	721	1	80	0.0125000
NODE_12646_length_784_cov_45.210219	49	129	0	80	80	1.0000000
NODE_12646_length_784_cov_45.210219	102	182	0	80	80	1.0000000
NODE_12646_length_784_cov_45.210219	218	298	0	80	80	1.0000000
NODE_12646_length_784_cov_45.210219	271	351	0	80	80	1.0000000
NODE_12646_length_784_cov_45.210219	347	427	0	80	80	1.0000000
NODE_12646_length_784_cov_45.210219	347	427	0	80	80	1.0000000
NODE_12646_length_784_cov_45.210219	347	427	0	80	80	1.0000000
NODE_12646_length_784_cov_45.210219	400	447	0	47	47	1.0000000
NODE_12646_length_784_cov_45.210219	400	480	0	80	80	1.0000000
NODE_12646_length_784_cov_45.210219	400	455	0	55	55	1.0000000
NODE_12647_length_784_cov_33.543066	405	485	2	11	80	0.1375000
NODE_12647_length_784_cov_33.543066	405	485	4	69	80	0.8625000
NODE_12647_length_784_cov_33.543066	458	538	0	6	80	0.0750000
NODE_12647_length_784_cov_33.543066	458	538	2	52	80	0.6500000
NODE_12647_length_784_cov_33.543066	458	538	4	22	80	0.2750000
NODE_12648_length_784_cov_21.762044	318	398	0	80	80	1.0000000
NODE_12648_length_784_cov_21.762044	371	451	0	80	80	1.0000000
NODE_12649_length_784_cov_20.583942	286	366	0	80	80	1.0000000
NODE_12649_length_784_cov_20.583942	339	419	0	80	80	1.0000000
NODE_12649_length_784_cov_20.583942	415	495	0	80	80	1.0000000
NODE_12649_length_784_cov_20.583942	468	548	0	80	80	1.0000000
NODE_12650_length_784_cov_19.448175	217	297	0	80	80	1.0000000
NODE_12650_length_784_cov_19.448175	270	350	0	80	80	1.0000000
NODE_12652_length_784_cov_12.480292	297	377	0	10	80	0.1250000
NODE_12652_length_784_cov_12.480292	297	377	4	70	80	0.8750000
NODE_12652_length_784_cov_12.480292	350	430	0	63	80	0.7875000
NODE_12652_length_784_cov_12.480292	350	430	4	17	80	0.2125000
NODE_12653_length_784_cov_9.296350	250	330	0	80	80	1.0000000
NODE_12653_length_784_cov_9.296350	303	383	0	80	80	1.0000000
NODE_12653_length_784_cov_9.296350	379	459	0	80	80	1.0000000
NODE_12653_length_784_cov_9.296350	432	512	0	80	80	1.0000000
NODE_12654_length_784_cov_6.316788	274	354	0	80	80	1.0000000
NODE_12654_length_784_cov_6.316788	327	407	0	80	80	1.0000000
NODE_12688_length_783_cov_41.849415	459	539	0	80	80	1.0000000
NODE_12688_length_783_cov_41.849415	512	592	0	80	80	1.0000000
NODE_12689_length_783_cov_39.881579	230	310	0	28	80	0.3500000
NODE_12689_length_783_cov_39.881579	230	310	2	52	80	0.6500000
NODE_12689_length_783_cov_39.881579	283	363	0	55	80	0.6875000
NODE_12689_length_783_cov_39.881579	283	363	2	25	80	0.3125000
NODE_12689_length_783_cov_39.881579	359	439	2	80	80	1.0000000
NODE_12689_length_783_cov_39.881579	412	492	0	42	80	0.5250000
NODE_12689_length_783_cov_39.881579	412	492	2	38	80	0.4750000
NODE_12690_length_783_cov_35.967836	229	309	0	78	80	0.9750000
NODE_12690_length_783_cov_35.967836	229	309	2	2	80	0.0250000
NODE_12690_length_783_cov_35.967836	282	362	0	25	80	0.3125000
NODE_12690_length_783_cov_35.967836	282	362	2	2	80	0.0250000
NODE_12690_length_783_cov_35.967836	282	362	6	53	80	0.6625000
NODE_12691_length_783_cov_28.203216	292	372	0	80	80	1.0000000
NODE_12691_length_783_cov_28.203216	345	425	0	80	80	1.0000000
NODE_12692_length_783_cov_16.695906	393	473	0	45	80	0.5625000
NODE_12692_length_783_cov_16.695906	393	473	2	35	80	0.4375000
NODE_12692_length_783_cov_16.695906	446	526	0	80	80	1.0000000
NODE_12693_length_783_cov_15.656433	418	498	0	80	80	1.0000000
NODE_12693_length_783_cov_15.656433	471	551	0	33	80	0.4125000
NODE_12693_length_783_cov_15.656433	471	551	1	22	80	0.2750000
NODE_12693_length_783_cov_15.656433	471	551	2	25	80	0.3125000
NODE_12694_length_783_cov_14.904971	321	401	0	35	80	0.4375000
NODE_12694_length_783_cov_14.904971	321	401	2	45	80	0.5625000
NODE_12694_length_783_cov_14.904971	374	454	2	43	80	0.5375000
NODE_12694_length_783_cov_14.904971	374	454	4	37	80	0.4625000
NODE_12728_length_782_cov_22.461201	347	427	0	80	80	1.0000000
NODE_12728_length_782_cov_22.461201	400	480	0	80	80	1.0000000
NODE_12729_length_782_cov_19.163982	306	386	0	4	80	0.0500000
NODE_12729_length_782_cov_19.163982	306	386	2	69	80	0.8625000
NODE_12729_length_782_cov_19.163982	306	386	3	2	80	0.0250000
NODE_12729_length_782_cov_19.163982	306	386	4	1	80	0.0125000
NODE_12729_length_782_cov_19.163982	306	386	5	4	80	0.0500000
NODE_12729_length_782_cov_19.163982	382	462	3	9	80	0.1125000
NODE_12729_length_782_cov_19.163982	382	462	5	6	80	0.0750000
NODE_12729_length_782_cov_19.163982	382	462	6	22	80	0.2750000
NODE_12729_length_782_cov_19.163982	382	462	8	30	80	0.3750000
NODE_12729_length_782_cov_19.163982	382	462	12	13	80	0.1625000
NODE_12729_length_782_cov_19.163982	435	515	6	6	80	0.0750000
NODE_12729_length_782_cov_19.163982	435	515	8	29	80	0.3625000
NODE_12729_length_782_cov_19.163982	435	515	10	9	80	0.1125000
NODE_12729_length_782_cov_19.163982	435	515	12	36	80	0.4500000
NODE_12730_length_782_cov_19.090776	295	375	0	32	80	0.4000000
NODE_12730_length_782_cov_19.090776	295	375	4	48	80	0.6000000
NODE_12730_length_782_cov_19.090776	348	428	0	17	80	0.2125000
NODE_12730_length_782_cov_19.090776	348	428	4	63	80	0.7875000
NODE_12731_length_782_cov_13.509517	323	403	0	7	80	0.0875000
NODE_12731_length_782_cov_13.509517	323	403	2	73	80	0.9125000
NODE_12731_length_782_cov_13.509517	376	456	0	46	80	0.5750000
NODE_12731_length_782_cov_13.509517	376	456	2	34	80	0.4250000
NODE_12732_length_782_cov_11.364568	367	447	0	80	80	1.0000000
NODE_12732_length_782_cov_11.364568	420	500	0	80	80	1.0000000
NODE_12735_length_782_cov_7.976574	245	325	0	80	80	1.0000000
NODE_12735_length_782_cov_7.976574	298	378	0	46	80	0.5750000
NODE_12735_length_782_cov_7.976574	298	378	2	34	80	0.4250000
NODE_12737_length_782_cov_5.500732	384	464	0	21	80	0.2625000
NODE_12737_length_782_cov_5.500732	384	464	2	3	80	0.0375000
NODE_12737_length_782_cov_5.500732	384	464	4	7	80	0.0875000
NODE_12737_length_782_cov_5.500732	384	464	5	19	80	0.2375000
NODE_12737_length_782_cov_5.500732	384	464	6	30	80	0.3750000
NODE_12737_length_782_cov_5.500732	437	517	4	42	80	0.5250000
NODE_12737_length_782_cov_5.500732	437	517	6	38	80	0.4750000
NODE_12739_length_782_cov_4.434846	309	389	0	80	80	1.0000000
NODE_12739_length_782_cov_4.434846	362	442	0	80	80	1.0000000
NODE_12740_length_782_cov_3.352855	177	196	0	19	19	1.0000000
NODE_12741_length_782_cov_3.231332	160	240	0	5	80	0.0625000
NODE_12741_length_782_cov_3.231332	160	240	2	75	80	0.9375000
NODE_12741_length_782_cov_3.231332	213	298	0	63	85	0.7411765
NODE_12741_length_782_cov_3.231332	213	298	2	22	85	0.2588235
NODE_12765_length_781_cov_34.247801	174	254	0	80	80	1.0000000
NODE_12765_length_781_cov_34.247801	227	307	0	80	80	1.0000000
NODE_12766_length_781_cov_27.530792	490	570	2	21	80	0.2625000
NODE_12766_length_781_cov_27.530792	490	570	4	10	80	0.1250000
NODE_12766_length_781_cov_27.530792	490	570	6	49	80	0.6125000
NODE_12766_length_781_cov_27.530792	543	623	0	6	80	0.0750000
NODE_12766_length_781_cov_27.530792	543	623	4	57	80	0.7125000
NODE_12766_length_781_cov_27.530792	543	623	6	17	80	0.2125000
NODE_12766_length_781_cov_27.530792	619	699	0	80	80	1.0000000
NODE_12766_length_781_cov_27.530792	672	752	0	80	80	1.0000000
NODE_12767_length_781_cov_22.768328	427	507	2	22	80	0.2750000
NODE_12767_length_781_cov_22.768328	427	507	4	5	80	0.0625000
NODE_12767_length_781_cov_22.768328	427	507	6	36	80	0.4500000
NODE_12767_length_781_cov_22.768328	427	507	8	17	80	0.2125000
NODE_12767_length_781_cov_22.768328	480	560	0	31	80	0.3875000
NODE_12767_length_781_cov_22.768328	480	560	2	44	80	0.5500000
NODE_12767_length_781_cov_22.768328	480	560	4	5	80	0.0625000
NODE_12768_length_781_cov_17.894428	411	491	0	6	80	0.0750000
NODE_12768_length_781_cov_17.894428	411	491	4	74	80	0.9250000
NODE_12768_length_781_cov_17.894428	464	544	0	27	80	0.3375000
NODE_12768_length_781_cov_17.894428	464	544	4	53	80	0.6625000
NODE_12769_length_781_cov_14.922287	486	565	4	4	79	0.0506329
NODE_12769_length_781_cov_14.922287	486	565	6	75	79	0.9493671
NODE_12769_length_781_cov_14.922287	538	618	0	28	80	0.3500000
NODE_12769_length_781_cov_14.922287	538	618	3	1	80	0.0125000
NODE_12769_length_781_cov_14.922287	538	618	4	28	80	0.3500000
NODE_12769_length_781_cov_14.922287	538	618	6	23	80	0.2875000
NODE_12770_length_781_cov_12.529326	318	398	0	80	80	1.0000000
NODE_12770_length_781_cov_12.529326	371	451	0	80	80	1.0000000
NODE_12771_length_781_cov_10.303519	444	524	4	4	80	0.0500000
NODE_12771_length_781_cov_10.303519	444	524	10	8	80	0.1000000
NODE_12771_length_781_cov_10.303519	444	524	12	68	80	0.8500000
NODE_12772_length_781_cov_9.851906	374	454	0	80	80	1.0000000
NODE_12772_length_781_cov_9.851906	427	507	0	80	80	1.0000000
NODE_12775_length_781_cov_8.557185	113	194	0	81	81	1.0000000
NODE_12775_length_781_cov_8.557185	166	239	0	73	73	1.0000000
NODE_12778_length_781_cov_4.734604	30	110	2	58	80	0.7250000
NODE_12778_length_781_cov_4.734604	30	110	4	19	80	0.2375000
NODE_12778_length_781_cov_4.734604	30	110	6	3	80	0.0375000
NODE_12778_length_781_cov_4.734604	83	163	2	5	80	0.0625000
NODE_12778_length_781_cov_4.734604	83	163	4	37	80	0.4625000
NODE_12778_length_781_cov_4.734604	83	163	6	38	80	0.4750000
NODE_12780_length_781_cov_4.077713	269	349	0	80	80	1.0000000
NODE_12780_length_781_cov_4.077713	322	402	0	80	80	1.0000000
NODE_12812_length_780_cov_37.693098	165	245	0	80	80	1.0000000
NODE_12812_length_780_cov_37.693098	218	298	0	80	80	1.0000000
NODE_12813_length_780_cov_22.132159	407	487	2	1	80	0.0125000
NODE_12813_length_780_cov_22.132159	407	487	3	77	80	0.9625000
NODE_12813_length_780_cov_22.132159	407	487	4	2	80	0.0250000
NODE_12813_length_780_cov_22.132159	460	540	0	53	80	0.6625000
NODE_12813_length_780_cov_22.132159	460	540	2	1	80	0.0125000
NODE_12813_length_780_cov_22.132159	460	540	3	26	80	0.3250000
NODE_12814_length_780_cov_21.831131	299	379	0	52	80	0.6500000
NODE_12814_length_780_cov_21.831131	299	379	2	24	80	0.3000000
NODE_12814_length_780_cov_21.831131	299	379	4	4	80	0.0500000
NODE_12814_length_780_cov_21.831131	352	432	2	23	80	0.2875000
NODE_12814_length_780_cov_21.831131	352	432	4	30	80	0.3750000
NODE_12814_length_780_cov_21.831131	352	432	5	22	80	0.2750000
NODE_12814_length_780_cov_21.831131	352	432	7	5	80	0.0625000
NODE_12815_length_780_cov_16.722467	165	245	0	80	80	1.0000000
NODE_12815_length_780_cov_16.722467	218	298	0	80	80	1.0000000
NODE_12816_length_780_cov_13.189427	150	254	0	85	104	0.8173077
NODE_12816_length_780_cov_13.189427	150	254	2	19	104	0.1826923
NODE_12816_length_780_cov_13.189427	227	307	0	80	80	1.0000000
NODE_12817_length_780_cov_12.910426	276	356	0	10	80	0.1250000
NODE_12817_length_780_cov_12.910426	276	356	2	70	80	0.8750000
NODE_12817_length_780_cov_12.910426	329	409	0	45	80	0.5625000
NODE_12817_length_780_cov_12.910426	329	409	2	35	80	0.4375000
NODE_12818_length_780_cov_8.455213	141	221	2	10	80	0.1250000
NODE_12818_length_780_cov_8.455213	141	221	6	28	80	0.3500000
NODE_12818_length_780_cov_8.455213	141	221	8	42	80	0.5250000
NODE_12818_length_780_cov_8.455213	194	274	0	12	80	0.1500000
NODE_12818_length_780_cov_8.455213	194	274	6	68	80	0.8500000
NODE_12848_length_779_cov_51.022059	8	43	0	35	35	1.0000000
NODE_12848_length_779_cov_51.022059	53	96	0	43	43	1.0000000
NODE_12848_length_779_cov_51.022059	97	177	0	30	80	0.3750000
NODE_12848_length_779_cov_51.022059	97	177	4	50	80	0.6250000
NODE_12848_length_779_cov_51.022059	150	230	4	80	80	1.0000000
NODE_12849_length_779_cov_23.682353	362	442	0	80	80	1.0000000
NODE_12849_length_779_cov_23.682353	415	495	0	80	80	1.0000000
NODE_12850_length_779_cov_15.994118	320	400	0	78	80	0.9750000
NODE_12850_length_779_cov_15.994118	320	400	2	2	80	0.0250000
NODE_12850_length_779_cov_15.994118	373	453	0	25	80	0.3125000
NODE_12850_length_779_cov_15.994118	373	453	2	55	80	0.6875000
NODE_12851_length_779_cov_14.386765	258	320	0	4	62	0.0645161
NODE_12851_length_779_cov_14.386765	258	320	8	35	62	0.5645161
NODE_12851_length_779_cov_14.386765	258	320	16	19	62	0.3064516
NODE_12851_length_779_cov_14.386765	258	320	20	4	62	0.0645161
NODE_12851_length_779_cov_14.386765	293	368	8	4	75	0.0533333
NODE_12851_length_779_cov_14.386765	293	368	12	13	75	0.1733333
NODE_12851_length_779_cov_14.386765	293	368	16	19	75	0.2533333
NODE_12851_length_779_cov_14.386765	293	368	20	39	75	0.5200000
NODE_12851_length_779_cov_14.386765	369	443	10	14	74	0.1891892
NODE_12851_length_779_cov_14.386765	369	443	20	6	74	0.0810811
NODE_12851_length_779_cov_14.386765	369	443	22	54	74	0.7297297
NODE_12852_length_779_cov_11.861765	180	263	1	14	83	0.1686747
NODE_12852_length_779_cov_11.861765	180	263	2	43	83	0.5180723
NODE_12852_length_779_cov_11.861765	180	263	3	26	83	0.3132530
NODE_12852_length_779_cov_11.861765	236	316	2	33	80	0.4125000
NODE_12852_length_779_cov_11.861765	236	316	4	25	80	0.3125000
NODE_12852_length_779_cov_11.861765	236	316	6	16	80	0.2000000
NODE_12852_length_779_cov_11.861765	236	316	8	6	80	0.0750000
NODE_12852_length_779_cov_11.861765	312	392	4	28	80	0.3500000
NODE_12852_length_779_cov_11.861765	312	392	6	52	80	0.6500000
NODE_12852_length_779_cov_11.861765	365	445	0	40	80	0.5000000
NODE_12852_length_779_cov_11.861765	365	445	4	40	80	0.5000000
NODE_12853_length_779_cov_11.735294	285	365	0	80	80	1.0000000
NODE_12853_length_779_cov_11.735294	338	418	0	80	80	1.0000000
NODE_12854_length_779_cov_7.211765	333	413	0	80	80	1.0000000
NODE_12854_length_779_cov_7.211765	386	466	0	80	80	1.0000000
NODE_12857_length_779_cov_5.611765	271	351	0	10	80	0.1250000
NODE_12857_length_779_cov_5.611765	271	351	2	70	80	0.8750000
NODE_12857_length_779_cov_5.611765	324	404	2	76	80	0.9500000
NODE_12857_length_779_cov_5.611765	324	404	4	4	80	0.0500000
NODE_12859_length_779_cov_4.695588	216	296	0	53	80	0.6625000
NODE_12859_length_779_cov_4.695588	216	296	4	27	80	0.3375000
NODE_12859_length_779_cov_4.695588	269	349	0	80	80	1.0000000
NODE_12863_length_779_cov_2.329412	615	672	0	6	57	0.1052632
NODE_12863_length_779_cov_2.329412	615	672	2	51	57	0.8947368
NODE_12883_length_778_cov_21.615611	325	405	0	37	80	0.4625000
NODE_12883_length_778_cov_21.615611	325	405	2	43	80	0.5375000
NODE_12883_length_778_cov_21.615611	378	458	0	22	80	0.2750000
NODE_12883_length_778_cov_21.615611	378	458	2	58	80	0.7250000
NODE_12884_length_778_cov_19.549337	348	428	0	80	80	1.0000000
NODE_12884_length_778_cov_19.549337	401	481	0	80	80	1.0000000
NODE_12885_length_778_cov_15.403535	312	392	0	64	80	0.8000000
NODE_12885_length_778_cov_15.403535	312	392	2	6	80	0.0750000
NODE_12885_length_778_cov_15.403535	312	392	4	10	80	0.1250000
NODE_12885_length_778_cov_15.403535	365	445	0	80	80	1.0000000
NODE_12886_length_778_cov_14.614138	101	181	0	80	80	1.0000000
NODE_12886_length_778_cov_14.614138	154	234	0	80	80	1.0000000
NODE_12887_length_778_cov_13.368189	256	336	0	80	80	1.0000000
NODE_12887_length_778_cov_13.368189	309	389	0	80	80	1.0000000
NODE_12891_length_778_cov_6.307806	349	429	0	2	80	0.0250000
NODE_12891_length_778_cov_6.307806	349	429	2	78	80	0.9750000
NODE_12891_length_778_cov_6.307806	402	482	0	24	80	0.3000000
NODE_12891_length_778_cov_6.307806	402	482	2	56	80	0.7000000
NODE_12893_length_778_cov_5.985272	385	465	0	80	80	1.0000000
NODE_12893_length_778_cov_5.985272	438	518	0	80	80	1.0000000
NODE_12928_length_777_cov_25.504425	323	403	0	80	80	1.0000000
NODE_12928_length_777_cov_25.504425	376	456	0	80	80	1.0000000
NODE_12929_length_777_cov_25.410029	346	426	0	80	80	1.0000000
NODE_12929_length_777_cov_25.410029	399	479	0	80	80	1.0000000
NODE_12930_length_777_cov_25.333333	97	177	0	80	80	1.0000000
NODE_12930_length_777_cov_25.333333	150	230	0	80	80	1.0000000
NODE_12931_length_777_cov_21.600295	408	485	0	77	77	1.0000000
NODE_12931_length_777_cov_21.600295	458	538	0	80	80	1.0000000
NODE_12932_length_777_cov_19.561947	343	423	0	9	80	0.1125000
NODE_12932_length_777_cov_19.561947	343	423	2	71	80	0.8875000
NODE_12932_length_777_cov_19.561947	396	476	0	45	80	0.5625000
NODE_12932_length_777_cov_19.561947	396	476	2	35	80	0.4375000
NODE_12933_length_777_cov_16.961652	264	344	0	80	80	1.0000000
NODE_12933_length_777_cov_16.961652	317	397	0	80	80	1.0000000
NODE_12934_length_777_cov_16.081121	299	379	2	3	80	0.0375000
NODE_12934_length_777_cov_16.081121	299	379	4	22	80	0.2750000
NODE_12934_length_777_cov_16.081121	299	379	6	42	80	0.5250000
NODE_12934_length_777_cov_16.081121	299	379	8	13	80	0.1625000
NODE_12934_length_777_cov_16.081121	352	432	6	44	80	0.5500000
NODE_12934_length_777_cov_16.081121	352	432	8	36	80	0.4500000
NODE_12935_length_777_cov_13.827434	380	460	36	1	80	0.0125000
NODE_12935_length_777_cov_13.827434	380	460	37	8	80	0.1000000
NODE_12935_length_777_cov_13.827434	380	460	38	11	80	0.1375000
NODE_12935_length_777_cov_13.827434	380	460	39	11	80	0.1375000
NODE_12935_length_777_cov_13.827434	380	460	41	6	80	0.0750000
NODE_12935_length_777_cov_13.827434	380	460	44	7	80	0.0875000
NODE_12935_length_777_cov_13.827434	380	460	46	5	80	0.0625000
NODE_12935_length_777_cov_13.827434	380	460	48	9	80	0.1125000
NODE_12935_length_777_cov_13.827434	380	460	49	2	80	0.0250000
NODE_12935_length_777_cov_13.827434	380	460	51	13	80	0.1625000
NODE_12935_length_777_cov_13.827434	380	460	52	1	80	0.0125000
NODE_12935_length_777_cov_13.827434	380	460	53	6	80	0.0750000
NODE_12935_length_777_cov_13.827434	433	513	28	1	80	0.0125000
NODE_12935_length_777_cov_13.827434	433	513	29	1	80	0.0125000
NODE_12935_length_777_cov_13.827434	433	513	30	22	80	0.2750000
NODE_12935_length_777_cov_13.827434	433	513	31	3	80	0.0375000
NODE_12935_length_777_cov_13.827434	433	513	32	12	80	0.1500000
NODE_12935_length_777_cov_13.827434	433	513	33	3	80	0.0375000
NODE_12935_length_777_cov_13.827434	433	513	34	3	80	0.0375000
NODE_12935_length_777_cov_13.827434	433	513	35	1	80	0.0125000
NODE_12935_length_777_cov_13.827434	433	513	37	15	80	0.1875000
NODE_12935_length_777_cov_13.827434	433	513	38	3	80	0.0375000
NODE_12935_length_777_cov_13.827434	433	513	39	10	80	0.1250000
NODE_12935_length_777_cov_13.827434	433	513	41	6	80	0.0750000
NODE_12936_length_777_cov_12.497050	413	493	0	34	80	0.4250000
NODE_12936_length_777_cov_12.497050	413	493	4	46	80	0.5750000
NODE_12936_length_777_cov_12.497050	466	546	0	24	80	0.3000000
NODE_12936_length_777_cov_12.497050	466	546	2	4	80	0.0500000
NODE_12936_length_777_cov_12.497050	466	546	3	1	80	0.0125000
NODE_12936_length_777_cov_12.497050	466	546	4	51	80	0.6375000
NODE_12937_length_777_cov_10.787611	213	286	0	68	73	0.9315069
NODE_12937_length_777_cov_10.787611	213	286	2	5	73	0.0684932
NODE_12938_length_777_cov_8.530973	362	422	0	60	60	1.0000000
NODE_12939_length_777_cov_7.634218	79	159	0	74	80	0.9250000
NODE_12939_length_777_cov_7.634218	79	159	2	6	80	0.0750000
NODE_12939_length_777_cov_7.634218	132	212	0	21	80	0.2625000
NODE_12939_length_777_cov_7.634218	132	212	2	59	80	0.7375000
NODE_12940_length_777_cov_6.963127	256	336	0	80	80	1.0000000
NODE_12940_length_777_cov_6.963127	309	389	0	80	80	1.0000000
NODE_12941_length_777_cov_6.417404	565	638	0	73	73	1.0000000
NODE_12942_length_777_cov_5.868732	443	523	0	80	80	1.0000000
NODE_12942_length_777_cov_5.868732	496	576	0	80	80	1.0000000
NODE_12971_length_776_cov_81.002954	237	317	2	5	80	0.0625000
NODE_12971_length_776_cov_81.002954	237	317	4	16	80	0.2000000
NODE_12971_length_776_cov_81.002954	237	317	6	30	80	0.3750000
NODE_12971_length_776_cov_81.002954	237	317	8	16	80	0.2000000
NODE_12971_length_776_cov_81.002954	237	317	16	1	80	0.0125000
NODE_12971_length_776_cov_81.002954	237	317	19	1	80	0.0125000
NODE_12971_length_776_cov_81.002954	237	317	24	1	80	0.0125000
NODE_12971_length_776_cov_81.002954	237	317	25	1	80	0.0125000
NODE_12971_length_776_cov_81.002954	237	317	27	1	80	0.0125000
NODE_12971_length_776_cov_81.002954	237	317	32	1	80	0.0125000
NODE_12971_length_776_cov_81.002954	237	317	41	1	80	0.0125000
NODE_12971_length_776_cov_81.002954	237	317	49	1	80	0.0125000
NODE_12971_length_776_cov_81.002954	237	317	54	1	80	0.0125000
NODE_12971_length_776_cov_81.002954	237	317	56	1	80	0.0125000
NODE_12971_length_776_cov_81.002954	237	317	59	1	80	0.0125000
NODE_12971_length_776_cov_81.002954	237	317	68	2	80	0.0250000
NODE_12971_length_776_cov_81.002954	290	370	4	9	80	0.1125000
NODE_12971_length_776_cov_81.002954	290	370	6	55	80	0.6875000
NODE_12971_length_776_cov_81.002954	290	370	8	16	80	0.2000000
NODE_12972_length_776_cov_40.502216	345	425	0	80	80	1.0000000
NODE_12972_length_776_cov_40.502216	398	478	0	80	80	1.0000000
NODE_12973_length_776_cov_34.921713	204	284	0	8	80	0.1000000
NODE_12973_length_776_cov_34.921713	204	284	2	63	80	0.7875000
NODE_12973_length_776_cov_34.921713	204	284	4	9	80	0.1125000
NODE_12973_length_776_cov_34.921713	257	337	0	8	80	0.1000000
NODE_12973_length_776_cov_34.921713	257	337	2	10	80	0.1250000
NODE_12973_length_776_cov_34.921713	257	337	4	62	80	0.7750000
NODE_12974_length_776_cov_29.998523	177	257	0	15	80	0.1875000
NODE_12974_length_776_cov_29.998523	177	257	2	65	80	0.8125000
NODE_12974_length_776_cov_29.998523	230	310	0	42	80	0.5250000
NODE_12974_length_776_cov_29.998523	230	310	2	38	80	0.4750000
NODE_12975_length_776_cov_25.683900	417	497	0	32	80	0.4000000
NODE_12975_length_776_cov_25.683900	417	497	5	2	80	0.0250000
NODE_12975_length_776_cov_25.683900	417	497	6	46	80	0.5750000
NODE_12975_length_776_cov_25.683900	470	550	0	4	80	0.0500000
NODE_12975_length_776_cov_25.683900	470	550	5	1	80	0.0125000
NODE_12975_length_776_cov_25.683900	470	550	6	75	80	0.9375000
NODE_12976_length_776_cov_22.276219	367	447	2	52	80	0.6500000
NODE_12976_length_776_cov_22.276219	367	447	4	28	80	0.3500000
NODE_12976_length_776_cov_22.276219	420	500	2	80	80	1.0000000
NODE_12977_length_776_cov_19.574594	242	322	0	66	80	0.8250000
NODE_12977_length_776_cov_19.574594	242	322	2	14	80	0.1750000
NODE_12977_length_776_cov_19.574594	295	375	0	13	80	0.1625000
NODE_12977_length_776_cov_19.574594	295	375	2	67	80	0.8375000
NODE_12978_length_776_cov_18.262925	384	464	0	50	80	0.6250000
NODE_12978_length_776_cov_18.262925	384	464	2	30	80	0.3750000
NODE_12978_length_776_cov_18.262925	437	517	2	80	80	1.0000000
NODE_12979_length_776_cov_16.023634	334	414	0	25	80	0.3125000
NODE_12979_length_776_cov_16.023634	334	414	4	55	80	0.6875000
NODE_12979_length_776_cov_16.023634	387	467	0	78	80	0.9750000
NODE_12979_length_776_cov_16.023634	387	467	4	2	80	0.0250000
NODE_12980_length_776_cov_15.841950	282	362	0	31	80	0.3875000
NODE_12980_length_776_cov_15.841950	282	362	2	49	80	0.6125000
NODE_12980_length_776_cov_15.841950	335	415	0	29	80	0.3625000
NODE_12980_length_776_cov_15.841950	335	415	2	51	80	0.6375000
NODE_12981_length_776_cov_14.131462	240	320	0	80	80	1.0000000
NODE_12981_length_776_cov_14.131462	293	373	0	80	80	1.0000000
NODE_12981_length_776_cov_14.131462	369	449	0	80	80	1.0000000
NODE_12981_length_776_cov_14.131462	422	502	0	80	80	1.0000000
NODE_12983_length_776_cov_13.890694	302	382	0	14	80	0.1750000
NODE_12983_length_776_cov_13.890694	302	382	2	66	80	0.8250000
NODE_12983_length_776_cov_13.890694	355	435	0	67	80	0.8375000
NODE_12983_length_776_cov_13.890694	355	435	2	13	80	0.1625000
NODE_12984_length_776_cov_12.097489	488	568	0	1	80	0.0125000
NODE_12984_length_776_cov_12.097489	488	568	2	79	80	0.9875000
NODE_12984_length_776_cov_12.097489	541	621	0	54	80	0.6750000
NODE_12984_length_776_cov_12.097489	541	621	2	26	80	0.3250000
NODE_12985_length_776_cov_11.923191	422	498	0	76	76	1.0000000
NODE_12985_length_776_cov_11.923191	475	551	0	76	76	1.0000000
NODE_12986_length_776_cov_11.163959	312	392	0	80	80	1.0000000
NODE_12986_length_776_cov_11.163959	365	445	0	80	80	1.0000000
NODE_12987_length_776_cov_9.754801	370	450	0	4	80	0.0500000
NODE_12987_length_776_cov_9.754801	370	450	2	27	80	0.3375000
NODE_12987_length_776_cov_9.754801	370	450	4	3	80	0.0375000
NODE_12987_length_776_cov_9.754801	370	450	6	46	80	0.5750000
NODE_12987_length_776_cov_9.754801	423	503	6	80	80	1.0000000
NODE_12989_length_776_cov_8.271787	332	412	2	34	80	0.4250000
NODE_12989_length_776_cov_8.271787	332	412	4	46	80	0.5750000
NODE_12989_length_776_cov_8.271787	385	465	0	25	80	0.3125000
NODE_12989_length_776_cov_8.271787	385	465	2	41	80	0.5125000
NODE_12989_length_776_cov_8.271787	385	465	4	14	80	0.1750000
NODE_12990_length_776_cov_4.874446	330	410	0	80	80	1.0000000
NODE_12990_length_776_cov_4.874446	383	463	0	80	80	1.0000000
NODE_13022_length_775_cov_33.612426	372	452	4	3	80	0.0375000
NODE_13022_length_775_cov_33.612426	372	452	6	11	80	0.1375000
NODE_13022_length_775_cov_33.612426	372	452	10	9	80	0.1125000
NODE_13022_length_775_cov_33.612426	372	452	12	2	80	0.0250000
NODE_13022_length_775_cov_33.612426	372	452	14	10	80	0.1250000
NODE_13022_length_775_cov_33.612426	372	452	16	45	80	0.5625000
NODE_13022_length_775_cov_33.612426	425	505	4	30	80	0.3750000
NODE_13022_length_775_cov_33.612426	425	505	8	23	80	0.2875000
NODE_13022_length_775_cov_33.612426	425	505	10	9	80	0.1125000
NODE_13022_length_775_cov_33.612426	425	505	12	2	80	0.0250000
NODE_13022_length_775_cov_33.612426	425	505	16	16	80	0.2000000
NODE_13023_length_775_cov_25.500000	361	434	0	53	73	0.7260274
NODE_13023_length_775_cov_25.500000	361	434	2	20	73	0.2739726
NODE_13023_length_775_cov_25.500000	413	487	0	5	74	0.0675676
NODE_13023_length_775_cov_25.500000	413	487	2	69	74	0.9324324
NODE_13024_length_775_cov_24.128698	220	300	0	80	80	1.0000000
NODE_13024_length_775_cov_24.128698	273	353	0	80	80	1.0000000
NODE_13026_length_775_cov_16.165680	358	438	8	80	80	1.0000000
NODE_13026_length_775_cov_16.165680	411	491	0	22	80	0.2750000
NODE_13026_length_775_cov_16.165680	411	491	4	31	80	0.3875000
NODE_13026_length_775_cov_16.165680	411	491	8	27	80	0.3375000
NODE_13027_length_775_cov_8.522189	440	520	2	8	80	0.1000000
NODE_13027_length_775_cov_8.522189	440	520	4	42	80	0.5250000
NODE_13027_length_775_cov_8.522189	440	520	6	30	80	0.3750000
NODE_13027_length_775_cov_8.522189	493	573	0	43	80	0.5375000
NODE_13027_length_775_cov_8.522189	493	573	2	18	80	0.2250000
NODE_13027_length_775_cov_8.522189	493	573	4	19	80	0.2375000
NODE_13028_length_775_cov_8.258876	247	327	0	80	80	1.0000000
NODE_13028_length_775_cov_8.258876	300	380	0	80	80	1.0000000
NODE_13031_length_775_cov_3.786982	299	379	0	80	80	1.0000000
NODE_13031_length_775_cov_3.786982	352	432	0	80	80	1.0000000
NODE_13059_length_774_cov_27.386667	433	514	0	81	81	1.0000000
NODE_13059_length_774_cov_27.386667	487	567	0	80	80	1.0000000
NODE_13060_length_774_cov_19.721481	239	319	0	80	80	1.0000000
NODE_13060_length_774_cov_19.721481	292	372	0	80	80	1.0000000
NODE_13063_length_774_cov_4.594074	216	294	0	22	78	0.2820513
NODE_13063_length_774_cov_4.594074	216	294	2	45	78	0.5769231
NODE_13063_length_774_cov_4.594074	216	294	4	11	78	0.1410256
NODE_13063_length_774_cov_4.594074	269	347	2	22	78	0.2820513
NODE_13063_length_774_cov_4.594074	269	347	4	56	78	0.7179487
NODE_13063_length_774_cov_4.594074	405	485	0	80	80	1.0000000
NODE_13103_length_773_cov_60.566766	249	328	0	9	79	0.1139240
NODE_13103_length_773_cov_60.566766	249	328	2	54	79	0.6835443
NODE_13103_length_773_cov_60.566766	249	328	4	16	79	0.2025317
NODE_13103_length_773_cov_60.566766	304	381	0	5	77	0.0649351
NODE_13103_length_773_cov_60.566766	304	381	2	8	77	0.1038961
NODE_13103_length_773_cov_60.566766	304	381	4	64	77	0.8311688
NODE_13104_length_773_cov_27.299703	230	310	0	80	80	1.0000000
NODE_13104_length_773_cov_27.299703	283	363	0	39	80	0.4875000
NODE_13104_length_773_cov_27.299703	283	363	2	41	80	0.5125000
NODE_13105_length_773_cov_24.250742	392	470	0	9	78	0.1153846
NODE_13105_length_773_cov_24.250742	392	470	6	69	78	0.8846154
NODE_13105_length_773_cov_24.250742	443	523	0	36	80	0.4500000
NODE_13105_length_773_cov_24.250742	443	523	6	44	80	0.5500000
NODE_13106_length_773_cov_20.683976	367	447	0	80	80	1.0000000
NODE_13106_length_773_cov_20.683976	420	500	0	80	80	1.0000000
NODE_13107_length_773_cov_18.498516	248	328	0	19	80	0.2375000
NODE_13107_length_773_cov_18.498516	248	328	2	61	80	0.7625000
NODE_13107_length_773_cov_18.498516	301	381	0	28	80	0.3500000
NODE_13107_length_773_cov_18.498516	301	381	2	52	80	0.6500000
NODE_13108_length_773_cov_14.063798	405	485	0	14	80	0.1750000
NODE_13108_length_773_cov_14.063798	405	485	4	66	80	0.8250000
NODE_13108_length_773_cov_14.063798	458	538	0	67	80	0.8375000
NODE_13108_length_773_cov_14.063798	458	538	4	13	80	0.1625000
NODE_13109_length_773_cov_12.482196	421	501	0	80	80	1.0000000
NODE_13109_length_773_cov_12.482196	474	554	0	80	80	1.0000000
NODE_13114_length_773_cov_9.136499	214	294	2	16	80	0.2000000
NODE_13114_length_773_cov_9.136499	214	294	4	17	80	0.2125000
NODE_13114_length_773_cov_9.136499	214	294	6	47	80	0.5875000
NODE_13114_length_773_cov_9.136499	267	347	0	14	80	0.1750000
NODE_13114_length_773_cov_9.136499	267	347	2	10	80	0.1250000
NODE_13114_length_773_cov_9.136499	267	347	4	15	80	0.1875000
NODE_13114_length_773_cov_9.136499	267	347	6	41	80	0.5125000
NODE_13115_length_773_cov_8.609792	461	541	0	9	80	0.1125000
NODE_13115_length_773_cov_8.609792	461	541	2	71	80	0.8875000
NODE_13115_length_773_cov_8.609792	514	594	2	80	80	1.0000000
NODE_13116_length_773_cov_7.224036	200	280	0	13	80	0.1625000
NODE_13116_length_773_cov_7.224036	200	280	2	67	80	0.8375000
NODE_13116_length_773_cov_7.224036	253	333	0	66	80	0.8250000
NODE_13116_length_773_cov_7.224036	253	333	2	14	80	0.1750000
NODE_13117_length_773_cov_6.910979	522	615	0	93	93	1.0000000
NODE_13117_length_773_cov_6.910979	588	668	0	80	80	1.0000000
NODE_13147_length_772_cov_28.044577	231	311	0	23	80	0.2875000
NODE_13147_length_772_cov_28.044577	231	311	2	5	80	0.0625000
NODE_13147_length_772_cov_28.044577	231	311	6	52	80	0.6500000
NODE_13147_length_772_cov_28.044577	284	364	5	30	80	0.3750000
NODE_13147_length_772_cov_28.044577	284	364	6	50	80	0.6250000
NODE_13149_length_772_cov_9.523031	288	368	0	59	80	0.7375000
NODE_13149_length_772_cov_9.523031	288	368	2	19	80	0.2375000
NODE_13149_length_772_cov_9.523031	288	368	4	2	80	0.0250000
NODE_13149_length_772_cov_9.523031	341	421	0	6	80	0.0750000
NODE_13149_length_772_cov_9.523031	341	421	2	19	80	0.2375000
NODE_13149_length_772_cov_9.523031	341	421	4	55	80	0.6875000
NODE_13150_length_772_cov_8.778603	133	213	0	80	80	1.0000000
NODE_13150_length_772_cov_8.778603	186	266	0	77	80	0.9625000
NODE_13150_length_772_cov_8.778603	186	266	2	3	80	0.0375000
NODE_13151_length_772_cov_7.921248	351	431	0	80	80	1.0000000
NODE_13151_length_772_cov_7.921248	404	480	0	76	76	1.0000000
NODE_13152_length_772_cov_7.059435	276	356	0	80	80	1.0000000
NODE_13152_length_772_cov_7.059435	329	409	0	80	80	1.0000000
NODE_13153_length_772_cov_5.536404	269	299	0	30	30	1.0000000
NODE_13153_length_772_cov_5.536404	272	341	0	69	69	1.0000000
NODE_13156_length_772_cov_4.838039	430	510	0	80	80	1.0000000
NODE_13156_length_772_cov_4.838039	483	563	0	80	80	1.0000000
NODE_13162_length_772_cov_3.041605	339	419	0	80	80	1.0000000
NODE_13162_length_772_cov_3.041605	392	472	0	80	80	1.0000000
NODE_13195_length_771_cov_36.729167	223	304	0	81	81	1.0000000
NODE_13195_length_771_cov_36.729167	277	357	0	80	80	1.0000000
NODE_13195_length_771_cov_36.729167	353	434	0	43	81	0.5308642
NODE_13195_length_771_cov_36.729167	353	434	2	38	81	0.4691358
NODE_13195_length_771_cov_36.729167	407	487	0	38	80	0.4750000
NODE_13195_length_771_cov_36.729167	407	487	2	42	80	0.5250000
NODE_13196_length_771_cov_28.903274	337	417	0	38	80	0.4750000
NODE_13196_length_771_cov_28.903274	337	417	2	15	80	0.1875000
NODE_13196_length_771_cov_28.903274	337	417	6	27	80	0.3375000
NODE_13196_length_771_cov_28.903274	390	470	3	12	80	0.1500000
NODE_13196_length_771_cov_28.903274	390	470	4	1	80	0.0125000
NODE_13196_length_771_cov_28.903274	390	470	6	67	80	0.8375000
NODE_13197_length_771_cov_28.165179	453	533	0	66	80	0.8250000
NODE_13197_length_771_cov_28.165179	453	533	2	14	80	0.1750000
NODE_13197_length_771_cov_28.165179	506	586	0	13	80	0.1625000
NODE_13197_length_771_cov_28.165179	506	586	2	67	80	0.8375000
NODE_13198_length_771_cov_14.336310	259	339	0	80	80	1.0000000
NODE_13198_length_771_cov_14.336310	312	392	0	33	80	0.4125000
NODE_13198_length_771_cov_14.336310	312	392	2	47	80	0.5875000
NODE_13199_length_771_cov_13.592262	428	508	0	8	80	0.1000000
NODE_13199_length_771_cov_13.592262	428	508	2	72	80	0.9000000
NODE_13199_length_771_cov_13.592262	481	561	0	47	80	0.5875000
NODE_13199_length_771_cov_13.592262	481	561	2	33	80	0.4125000
NODE_13200_length_771_cov_12.226190	407	487	0	80	80	1.0000000
NODE_13200_length_771_cov_12.226190	460	540	0	80	80	1.0000000
NODE_13201_length_771_cov_11.188988	348	428	0	24	80	0.3000000
NODE_13201_length_771_cov_11.188988	348	428	2	25	80	0.3125000
NODE_13201_length_771_cov_11.188988	348	428	4	31	80	0.3875000
NODE_13201_length_771_cov_11.188988	401	481	2	37	80	0.4625000
NODE_13201_length_771_cov_11.188988	401	481	4	43	80	0.5375000
NODE_13202_length_771_cov_10.525298	171	251	2	15	80	0.1875000
NODE_13202_length_771_cov_10.525298	171	251	4	65	80	0.8125000
NODE_13202_length_771_cov_10.525298	224	304	0	45	80	0.5625000
NODE_13202_length_771_cov_10.525298	224	304	4	35	80	0.4375000
NODE_13207_length_771_cov_3.357143	238	318	0	80	80	1.0000000
NODE_13207_length_771_cov_3.357143	291	371	0	80	80	1.0000000
NODE_13209_length_771_cov_3.129464	476	518	0	2	42	0.0476190
NODE_13209_length_771_cov_3.129464	476	518	4	40	42	0.9523810
NODE_13238_length_770_cov_45.312966	212	292	0	65	80	0.8125000
NODE_13238_length_770_cov_45.312966	212	292	4	15	80	0.1875000
NODE_13238_length_770_cov_45.312966	265	345	0	12	80	0.1500000
NODE_13238_length_770_cov_45.312966	265	345	4	68	80	0.8500000
NODE_13239_length_770_cov_23.153502	348	428	0	52	80	0.6500000
NODE_13239_length_770_cov_23.153502	348	428	4	14	80	0.1750000
NODE_13239_length_770_cov_23.153502	348	428	7	14	80	0.1750000
NODE_13239_length_770_cov_23.153502	401	481	4	13	80	0.1625000
NODE_13239_length_770_cov_23.153502	401	481	7	20	80	0.2500000
NODE_13239_length_770_cov_23.153502	401	481	10	47	80	0.5875000
NODE_13240_length_770_cov_22.463487	340	420	2	3	80	0.0375000
NODE_13240_length_770_cov_22.463487	340	420	4	77	80	0.9625000
NODE_13240_length_770_cov_22.463487	393	473	2	7	80	0.0875000
NODE_13240_length_770_cov_22.463487	393	473	4	47	80	0.5875000
NODE_13240_length_770_cov_22.463487	393	473	6	26	80	0.3250000
NODE_13241_length_770_cov_18.594635	335	416	0	81	81	1.0000000
NODE_13241_length_770_cov_18.594635	389	469	0	80	80	1.0000000
NODE_13242_length_770_cov_18.092399	292	372	0	26	80	0.3250000
NODE_13242_length_770_cov_18.092399	292	372	4	3	80	0.0375000
NODE_13242_length_770_cov_18.092399	292	372	6	12	80	0.1500000
NODE_13242_length_770_cov_18.092399	292	372	8	29	80	0.3625000
NODE_13242_length_770_cov_18.092399	292	372	10	2	80	0.0250000
NODE_13242_length_770_cov_18.092399	292	372	13	4	80	0.0500000
NODE_13242_length_770_cov_18.092399	292	372	14	4	80	0.0500000
NODE_13242_length_770_cov_18.092399	345	425	6	4	80	0.0500000
NODE_13242_length_770_cov_18.092399	345	425	8	17	80	0.2125000
NODE_13242_length_770_cov_18.092399	345	425	10	23	80	0.2875000
NODE_13242_length_770_cov_18.092399	345	425	12	6	80	0.0750000
NODE_13242_length_770_cov_18.092399	345	425	13	4	80	0.0500000
NODE_13242_length_770_cov_18.092399	345	425	14	26	80	0.3250000
NODE_13243_length_770_cov_7.064083	294	374	0	80	80	1.0000000
NODE_13243_length_770_cov_7.064083	347	426	0	73	79	0.9240506
NODE_13243_length_770_cov_7.064083	347	426	2	6	79	0.0759494
NODE_13246_length_770_cov_5.184799	341	421	0	80	80	1.0000000
NODE_13246_length_770_cov_5.184799	394	474	0	80	80	1.0000000
NODE_13250_length_770_cov_4.120715	325	405	0	39	80	0.4875000
NODE_13250_length_770_cov_4.120715	325	405	2	41	80	0.5125000
NODE_13250_length_770_cov_4.120715	378	458	2	80	80	1.0000000
NODE_13272_length_769_cov_11.008955	355	435	0	13	80	0.1625000
NODE_13272_length_769_cov_11.008955	355	435	2	45	80	0.5625000
NODE_13272_length_769_cov_11.008955	355	435	4	22	80	0.2750000
NODE_13272_length_769_cov_11.008955	408	488	2	32	80	0.4000000
NODE_13272_length_769_cov_11.008955	408	488	4	48	80	0.6000000
NODE_13274_length_769_cov_9.077612	263	343	0	17	80	0.2125000
NODE_13274_length_769_cov_9.077612	263	343	4	14	80	0.1750000
NODE_13274_length_769_cov_9.077612	263	343	6	49	80	0.6125000
NODE_13274_length_769_cov_9.077612	316	396	0	13	80	0.1625000
NODE_13274_length_769_cov_9.077612	316	396	2	32	80	0.4000000
NODE_13274_length_769_cov_9.077612	316	396	6	35	80	0.4375000
NODE_13275_length_769_cov_7.034328	289	367	0	78	78	1.0000000
NODE_13275_length_769_cov_7.034328	340	420	0	80	80	1.0000000
NODE_13307_length_769_cov_1.262687	620	668	2	48	48	1.0000000
NODE_13316_length_768_cov_19.195815	266	346	0	80	80	1.0000000
NODE_13316_length_768_cov_19.195815	319	399	0	80	80	1.0000000
NODE_13316_length_768_cov_19.195815	395	475	0	80	80	1.0000000
NODE_13316_length_768_cov_19.195815	448	528	0	80	80	1.0000000
NODE_13317_length_768_cov_16.420030	246	326	0	80	80	1.0000000
NODE_13317_length_768_cov_16.420030	299	379	0	80	80	1.0000000
NODE_13318_length_768_cov_14.508221	309	389	0	80	80	1.0000000
NODE_13318_length_768_cov_14.508221	362	442	0	80	80	1.0000000
NODE_13319_length_768_cov_11.635277	309	389	0	80	80	1.0000000
NODE_13319_length_768_cov_11.635277	362	442	0	80	80	1.0000000
NODE_13321_length_768_cov_9.064275	392	472	0	80	80	1.0000000
NODE_13321_length_768_cov_9.064275	445	525	0	80	80	1.0000000
NODE_13324_length_768_cov_3.605381	512	592	0	80	80	1.0000000
NODE_13324_length_768_cov_3.605381	565	645	0	80	80	1.0000000
NODE_13354_length_767_cov_38.161677	28	108	4	2	80	0.0250000
NODE_13354_length_767_cov_38.161677	28	108	6	13	80	0.1625000
NODE_13354_length_767_cov_38.161677	28	108	8	5	80	0.0625000
NODE_13354_length_767_cov_38.161677	28	108	10	60	80	0.7500000
NODE_13354_length_767_cov_38.161677	254	334	0	80	80	1.0000000
NODE_13354_length_767_cov_38.161677	307	387	0	80	80	1.0000000
NODE_13355_length_767_cov_24.107784	279	359	0	80	80	1.0000000
NODE_13355_length_767_cov_24.107784	332	412	0	80	80	1.0000000
NODE_13356_length_767_cov_22.823353	286	366	2	80	80	1.0000000
NODE_13356_length_767_cov_22.823353	339	419	0	43	80	0.5375000
NODE_13356_length_767_cov_22.823353	339	419	2	37	80	0.4625000
NODE_13357_length_767_cov_20.898204	312	392	2	19	80	0.2375000
NODE_13357_length_767_cov_20.898204	312	392	4	34	80	0.4250000
NODE_13357_length_767_cov_20.898204	312	392	6	12	80	0.1500000
NODE_13357_length_767_cov_20.898204	312	392	8	15	80	0.1875000
NODE_13357_length_767_cov_20.898204	365	445	4	43	80	0.5375000
NODE_13357_length_767_cov_20.898204	365	445	6	22	80	0.2750000
NODE_13357_length_767_cov_20.898204	365	445	8	15	80	0.1875000
NODE_13358_length_767_cov_20.058383	357	439	0	82	82	1.0000000
NODE_13358_length_767_cov_20.058383	410	490	0	80	80	1.0000000
NODE_13359_length_767_cov_20.020958	191	271	2	21	80	0.2625000
NODE_13359_length_767_cov_20.020958	191	271	3	59	80	0.7375000
NODE_13359_length_767_cov_20.020958	244	324	1	42	80	0.5250000
NODE_13359_length_767_cov_20.020958	244	324	3	38	80	0.4750000
NODE_13360_length_767_cov_18.687126	270	350	0	80	80	1.0000000
NODE_13360_length_767_cov_18.687126	323	403	0	80	80	1.0000000
NODE_13362_length_767_cov_13.323353	45	125	0	80	80	1.0000000
NODE_13362_length_767_cov_13.323353	98	178	0	80	80	1.0000000
NODE_13366_length_767_cov_8.787425	377	447	0	4	70	0.0571429
NODE_13366_length_767_cov_8.787425	377	447	2	66	70	0.9428571
NODE_13366_length_767_cov_8.787425	420	500	0	1	80	0.0125000
NODE_13366_length_767_cov_8.787425	420	500	2	79	80	0.9875000
NODE_13367_length_767_cov_7.206587	306	386	2	80	80	1.0000000
NODE_13367_length_767_cov_7.206587	359	440	0	45	81	0.5555556
NODE_13367_length_767_cov_7.206587	359	440	2	36	81	0.4444444
NODE_13403_length_766_cov_59.388306	322	402	4	59	80	0.7375000
NODE_13403_length_766_cov_59.388306	322	402	5	9	80	0.1125000
NODE_13403_length_766_cov_59.388306	322	402	9	12	80	0.1500000
NODE_13403_length_766_cov_59.388306	375	455	4	6	80	0.0750000
NODE_13403_length_766_cov_59.388306	375	455	5	10	80	0.1250000
NODE_13403_length_766_cov_59.388306	375	455	6	52	80	0.6500000
NODE_13403_length_766_cov_59.388306	375	455	9	12	80	0.1500000
NODE_13403_length_766_cov_59.388306	451	531	0	21	80	0.2625000
NODE_13403_length_766_cov_59.388306	451	531	5	50	80	0.6250000
NODE_13403_length_766_cov_59.388306	451	531	6	9	80	0.1125000
NODE_13403_length_766_cov_59.388306	504	584	0	74	80	0.9250000
NODE_13403_length_766_cov_59.388306	504	584	5	6	80	0.0750000
NODE_13404_length_766_cov_23.361319	308	388	0	80	80	1.0000000
NODE_13404_length_766_cov_23.361319	361	441	0	80	80	1.0000000
NODE_13405_length_766_cov_22.751124	229	309	0	21	80	0.2625000
NODE_13405_length_766_cov_22.751124	229	309	2	59	80	0.7375000
NODE_13405_length_766_cov_22.751124	282	362	2	68	80	0.8500000
NODE_13405_length_766_cov_22.751124	282	362	4	12	80	0.1500000
NODE_13406_length_766_cov_20.011994	285	363	0	78	78	1.0000000
NODE_13406_length_766_cov_20.011994	336	416	0	80	80	1.0000000
NODE_13407_length_766_cov_18.685157	288	368	0	62	80	0.7750000
NODE_13407_length_766_cov_18.685157	288	368	8	17	80	0.2125000
NODE_13407_length_766_cov_18.685157	288	368	10	1	80	0.0125000
NODE_13407_length_766_cov_18.685157	341	421	0	9	80	0.1125000
NODE_13407_length_766_cov_18.685157	341	421	8	17	80	0.2125000
NODE_13407_length_766_cov_18.685157	341	421	10	54	80	0.6750000
NODE_13408_length_766_cov_13.131934	271	351	0	44	80	0.5500000
NODE_13408_length_766_cov_13.131934	271	351	2	36	80	0.4500000
NODE_13408_length_766_cov_13.131934	324	404	2	80	80	1.0000000
NODE_13410_length_766_cov_9.479760	274	354	0	80	80	1.0000000
NODE_13410_length_766_cov_9.479760	327	407	0	80	80	1.0000000
NODE_13415_length_766_cov_4.500750	333	413	8	16	80	0.2000000
NODE_13415_length_766_cov_4.500750	333	413	10	22	80	0.2750000
NODE_13415_length_766_cov_4.500750	333	413	12	42	80	0.5250000
NODE_13415_length_766_cov_4.500750	369	404	8	7	35	0.2000000
NODE_13415_length_766_cov_4.500750	369	404	12	28	35	0.8000000
NODE_13415_length_766_cov_4.500750	371	413	8	16	42	0.3809524
NODE_13415_length_766_cov_4.500750	371	413	12	26	42	0.6190476
NODE_13415_length_766_cov_4.500750	397	466	0	18	69	0.2608696
NODE_13415_length_766_cov_4.500750	397	466	2	14	69	0.2028985
NODE_13415_length_766_cov_4.500750	397	466	4	9	69	0.1304348
NODE_13415_length_766_cov_4.500750	397	466	8	28	69	0.4057971
NODE_13447_length_765_cov_92.851351	16	96	20	7	80	0.0875000
NODE_13447_length_765_cov_92.851351	16	96	24	13	80	0.1625000
NODE_13447_length_765_cov_92.851351	16	96	26	4	80	0.0500000
NODE_13447_length_765_cov_92.851351	16	96	28	1	80	0.0125000
NODE_13447_length_765_cov_92.851351	16	96	32	10	80	0.1250000
NODE_13447_length_765_cov_92.851351	16	96	34	1	80	0.0125000
NODE_13447_length_765_cov_92.851351	16	96	36	3	80	0.0375000
NODE_13447_length_765_cov_92.851351	16	96	38	1	80	0.0125000
NODE_13447_length_765_cov_92.851351	16	96	40	1	80	0.0125000
NODE_13447_length_765_cov_92.851351	16	96	42	2	80	0.0250000
NODE_13447_length_765_cov_92.851351	16	96	45	1	80	0.0125000
NODE_13447_length_765_cov_92.851351	16	96	46	1	80	0.0125000
NODE_13447_length_765_cov_92.851351	16	96	48	2	80	0.0250000
NODE_13447_length_765_cov_92.851351	16	96	50	2	80	0.0250000
NODE_13447_length_765_cov_92.851351	16	96	56	1	80	0.0125000
NODE_13447_length_765_cov_92.851351	16	96	57	1	80	0.0125000
NODE_13447_length_765_cov_92.851351	16	96	59	1	80	0.0125000
NODE_13447_length_765_cov_92.851351	16	96	63	3	80	0.0375000
NODE_13447_length_765_cov_92.851351	16	96	65	8	80	0.1000000
NODE_13447_length_765_cov_92.851351	16	96	71	2	80	0.0250000
NODE_13447_length_765_cov_92.851351	16	96	73	2	80	0.0250000
NODE_13447_length_765_cov_92.851351	16	96	77	5	80	0.0625000
NODE_13447_length_765_cov_92.851351	16	96	81	3	80	0.0375000
NODE_13447_length_765_cov_92.851351	16	96	83	5	80	0.0625000
NODE_13448_length_765_cov_36.345345	504	584	0	80	80	1.0000000
NODE_13448_length_765_cov_36.345345	557	637	0	80	80	1.0000000
NODE_13449_length_765_cov_27.334835	370	450	0	80	80	1.0000000
NODE_13449_length_765_cov_27.334835	423	503	0	80	80	1.0000000
NODE_13450_length_765_cov_23.355856	251	331	0	80	80	1.0000000
NODE_13450_length_765_cov_23.355856	304	384	0	57	80	0.7125000
NODE_13450_length_765_cov_23.355856	304	384	4	23	80	0.2875000
NODE_13450_length_765_cov_23.355856	380	460	2	23	80	0.2875000
NODE_13450_length_765_cov_23.355856	380	460	4	48	80	0.6000000
NODE_13450_length_765_cov_23.355856	380	460	6	9	80	0.1125000
NODE_13450_length_765_cov_23.355856	433	506	2	69	73	0.9452055
NODE_13450_length_765_cov_23.355856	433	506	6	4	73	0.0547945
NODE_13451_length_765_cov_23.322823	256	336	0	48	80	0.6000000
NODE_13451_length_765_cov_23.322823	256	336	2	32	80	0.4000000
NODE_13451_length_765_cov_23.322823	309	389	0	30	80	0.3750000
NODE_13451_length_765_cov_23.322823	309	389	1	7	80	0.0875000
NODE_13451_length_765_cov_23.322823	309	389	2	43	80	0.5375000
NODE_13452_length_765_cov_21.741742	379	452	0	73	73	1.0000000
NODE_13452_length_765_cov_21.741742	425	505	0	80	80	1.0000000
NODE_13453_length_765_cov_14.253754	450	530	4	9	80	0.1125000
NODE_13453_length_765_cov_14.253754	450	530	6	71	80	0.8875000
NODE_13453_length_765_cov_14.253754	503	583	0	10	80	0.1250000
NODE_13453_length_765_cov_14.253754	503	583	2	40	80	0.5000000
NODE_13453_length_765_cov_14.253754	503	583	4	12	80	0.1500000
NODE_13453_length_765_cov_14.253754	503	583	6	18	80	0.2250000
NODE_13454_length_765_cov_13.627628	313	393	0	58	80	0.7250000
NODE_13454_length_765_cov_13.627628	313	393	2	22	80	0.2750000
NODE_13454_length_765_cov_13.627628	366	446	0	5	80	0.0625000
NODE_13454_length_765_cov_13.627628	366	446	2	75	80	0.9375000
NODE_13455_length_765_cov_5.561562	319	349	0	30	30	1.0000000
NODE_13458_length_765_cov_4.367868	433	513	0	66	80	0.8250000
NODE_13458_length_765_cov_4.367868	433	513	2	14	80	0.1750000
NODE_13458_length_765_cov_4.367868	486	566	0	13	80	0.1625000
NODE_13458_length_765_cov_4.367868	486	566	2	67	80	0.8375000
NODE_13483_length_764_cov_30.096241	436	516	0	80	80	1.0000000
NODE_13483_length_764_cov_30.096241	489	569	0	80	80	1.0000000
NODE_13484_length_764_cov_29.218045	304	384	0	76	80	0.9500000
NODE_13484_length_764_cov_29.218045	304	384	2	4	80	0.0500000
NODE_13484_length_764_cov_29.218045	357	437	0	23	80	0.2875000
NODE_13484_length_764_cov_29.218045	357	437	2	57	80	0.7125000
NODE_13485_length_764_cov_25.951880	421	501	0	80	80	1.0000000
NODE_13485_length_764_cov_25.951880	474	554	0	80	80	1.0000000
NODE_13486_length_764_cov_23.590977	204	284	0	80	80	1.0000000
NODE_13486_length_764_cov_23.590977	257	337	0	80	80	1.0000000
NODE_13488_length_764_cov_6.804511	281	361	0	80	80	1.0000000
NODE_13488_length_764_cov_6.804511	334	414	0	80	80	1.0000000
NODE_13489_length_764_cov_6.700752	392	458	0	13	66	0.1969697
NODE_13489_length_764_cov_6.700752	392	458	1	53	66	0.8030303
NODE_13508_length_764_cov_1.171429	475	537	0	59	62	0.9516129
NODE_13508_length_764_cov_1.171429	475	537	1	3	62	0.0483871
NODE_13520_length_763_cov_28.807229	311	391	0	80	80	1.0000000
NODE_13520_length_763_cov_28.807229	364	444	0	80	80	1.0000000
NODE_13521_length_763_cov_25.299699	598	673	2	51	75	0.6800000
NODE_13521_length_763_cov_25.299699	598	673	4	24	75	0.3200000
NODE_13521_length_763_cov_25.299699	598	678	2	51	80	0.6375000
NODE_13521_length_763_cov_25.299699	598	678	4	29	80	0.3625000
NODE_13521_length_763_cov_25.299699	605	675	2	46	70	0.6571429
NODE_13521_length_763_cov_25.299699	605	675	4	24	70	0.3428572
NODE_13521_length_763_cov_25.299699	607	678	2	44	71	0.6197183
NODE_13521_length_763_cov_25.299699	607	678	4	27	71	0.3802817
NODE_13521_length_763_cov_25.299699	651	731	2	49	80	0.6125000
NODE_13521_length_763_cov_25.299699	651	731	4	31	80	0.3875000
NODE_13521_length_763_cov_25.299699	651	731	2	49	80	0.6125000
NODE_13521_length_763_cov_25.299699	651	731	4	31	80	0.3875000
NODE_13521_length_763_cov_25.299699	651	731	2	49	80	0.6125000
NODE_13521_length_763_cov_25.299699	651	731	4	31	80	0.3875000
NODE_13521_length_763_cov_25.299699	651	731	2	49	80	0.6125000
NODE_13521_length_763_cov_25.299699	651	731	4	31	80	0.3875000
NODE_13522_length_763_cov_12.887048	336	416	0	80	80	1.0000000
NODE_13522_length_763_cov_12.887048	389	469	0	80	80	1.0000000
NODE_13523_length_763_cov_11.599398	547	627	0	80	80	1.0000000
NODE_13523_length_763_cov_11.599398	600	680	0	80	80	1.0000000
NODE_13524_length_763_cov_9.378012	297	377	0	3	80	0.0375000
NODE_13524_length_763_cov_9.378012	297	377	2	28	80	0.3500000
NODE_13524_length_763_cov_9.378012	297	377	4	49	80	0.6125000
NODE_13524_length_763_cov_9.378012	350	430	2	16	80	0.2000000
NODE_13524_length_763_cov_9.378012	350	430	4	64	80	0.8000000
NODE_13526_length_763_cov_7.246988	368	448	0	80	80	1.0000000
NODE_13526_length_763_cov_7.246988	421	501	0	73	80	0.9125000
NODE_13526_length_763_cov_7.246988	421	501	2	7	80	0.0875000
NODE_13527_length_763_cov_6.414157	371	451	0	80	80	1.0000000
NODE_13527_length_763_cov_6.414157	424	504	0	80	80	1.0000000
NODE_13558_length_762_cov_21.236802	368	448	0	80	80	1.0000000
NODE_13558_length_762_cov_21.236802	421	501	0	80	80	1.0000000
NODE_13559_length_762_cov_19.984917	327	407	4	2	80	0.0250000
NODE_13559_length_762_cov_19.984917	327	407	6	14	80	0.1750000
NODE_13559_length_762_cov_19.984917	327	407	8	15	80	0.1875000
NODE_13559_length_762_cov_19.984917	327	407	10	35	80	0.4375000
NODE_13559_length_762_cov_19.984917	327	407	12	14	80	0.1750000
NODE_13559_length_762_cov_19.984917	380	460	0	14	80	0.1750000
NODE_13559_length_762_cov_19.984917	380	460	1	6	80	0.0750000
NODE_13559_length_762_cov_19.984917	380	460	3	7	80	0.0875000
NODE_13559_length_762_cov_19.984917	380	460	4	15	80	0.1875000
NODE_13559_length_762_cov_19.984917	380	460	8	23	80	0.2875000
NODE_13559_length_762_cov_19.984917	380	460	10	15	80	0.1875000
NODE_13560_length_762_cov_15.975867	318	398	0	43	80	0.5375000
NODE_13560_length_762_cov_15.975867	318	398	2	37	80	0.4625000
NODE_13560_length_762_cov_15.975867	371	439	0	25	68	0.3676471
NODE_13560_length_762_cov_15.975867	371	439	2	43	68	0.6323529
NODE_13561_length_762_cov_12.728507	381	461	0	80	80	1.0000000
NODE_13561_length_762_cov_12.728507	434	514	0	80	80	1.0000000
NODE_13562_length_762_cov_10.078431	277	357	2	80	80	1.0000000
NODE_13562_length_762_cov_10.078431	330	410	0	17	80	0.2125000
NODE_13562_length_762_cov_10.078431	330	410	1	1	80	0.0125000
NODE_13562_length_762_cov_10.078431	330	410	2	62	80	0.7750000
NODE_13563_length_762_cov_9.705882	339	419	0	80	80	1.0000000
NODE_13563_length_762_cov_9.705882	392	472	0	80	80	1.0000000
NODE_13564_length_762_cov_7.276018	316	395	0	46	79	0.5822785
NODE_13564_length_762_cov_7.276018	316	395	6	19	79	0.2405063
NODE_13564_length_762_cov_7.276018	316	395	8	14	79	0.1772152
NODE_13564_length_762_cov_7.276018	368	448	6	13	80	0.1625000
NODE_13564_length_762_cov_7.276018	368	448	8	17	80	0.2125000
NODE_13564_length_762_cov_7.276018	368	448	10	50	80	0.6250000
NODE_13565_length_762_cov_6.168929	222	302	0	80	80	1.0000000
NODE_13565_length_762_cov_6.168929	275	355	0	80	80	1.0000000
NODE_13613_length_761_cov_44.243202	531	582	0	51	51	1.0000000
NODE_13614_length_761_cov_38.809668	342	422	0	25	80	0.3125000
NODE_13614_length_761_cov_38.809668	342	422	2	55	80	0.6875000
NODE_13614_length_761_cov_38.809668	395	475	0	32	80	0.4000000
NODE_13614_length_761_cov_38.809668	395	475	2	48	80	0.6000000
NODE_13615_length_761_cov_38.694864	314	394	2	15	80	0.1875000
NODE_13615_length_761_cov_38.694864	314	394	4	26	80	0.3250000
NODE_13615_length_761_cov_38.694864	314	394	5	9	80	0.1125000
NODE_13615_length_761_cov_38.694864	314	394	6	8	80	0.1000000
NODE_13615_length_761_cov_38.694864	314	394	7	14	80	0.1750000
NODE_13615_length_761_cov_38.694864	314	394	8	8	80	0.1000000
NODE_13615_length_761_cov_38.694864	367	447	0	11	80	0.1375000
NODE_13615_length_761_cov_38.694864	367	447	4	67	80	0.8375000
NODE_13615_length_761_cov_38.694864	367	447	6	2	80	0.0250000
NODE_13616_length_761_cov_32.382175	432	512	0	80	80	1.0000000
NODE_13616_length_761_cov_32.382175	485	565	0	80	80	1.0000000
NODE_13617_length_761_cov_31.444109	323	403	2	80	80	1.0000000
NODE_13617_length_761_cov_31.444109	376	467	0	46	91	0.5054945
NODE_13617_length_761_cov_31.444109	376	467	2	45	91	0.4945055
NODE_13618_length_761_cov_14.004532	366	446	0	80	80	1.0000000
NODE_13618_length_761_cov_14.004532	419	499	0	80	80	1.0000000
NODE_13619_length_761_cov_13.287009	336	415	4	79	79	1.0000000
NODE_13619_length_761_cov_13.287009	388	468	0	25	80	0.3125000
NODE_13619_length_761_cov_13.287009	388	468	4	55	80	0.6875000
NODE_13621_length_761_cov_9.654079	274	354	0	80	80	1.0000000
NODE_13621_length_761_cov_9.654079	327	407	0	80	80	1.0000000
NODE_13622_length_761_cov_7.306647	308	388	2	80	80	1.0000000
NODE_13622_length_761_cov_7.306647	361	441	0	29	80	0.3625000
NODE_13622_length_761_cov_7.306647	361	441	2	51	80	0.6375000
NODE_13625_length_761_cov_4.314199	354	434	0	80	80	1.0000000
NODE_13625_length_761_cov_4.314199	407	487	0	80	80	1.0000000
NODE_13658_length_760_cov_48.290469	215	295	4	10	80	0.1250000
NODE_13658_length_760_cov_48.290469	215	295	8	70	80	0.8750000
NODE_13658_length_760_cov_48.290469	268	348	0	17	80	0.2125000
NODE_13658_length_760_cov_48.290469	268	348	4	26	80	0.3250000
NODE_13658_length_760_cov_48.290469	268	348	8	37	80	0.4625000
NODE_13658_length_760_cov_48.290469	344	424	0	80	80	1.0000000
NODE_13658_length_760_cov_48.290469	397	477	0	80	80	1.0000000
NODE_13659_length_760_cov_28.314675	384	464	0	80	80	1.0000000
NODE_13659_length_760_cov_28.314675	437	517	0	80	80	1.0000000
NODE_13660_length_760_cov_27.981846	432	512	0	11	80	0.1375000
NODE_13660_length_760_cov_27.981846	432	512	2	69	80	0.8625000
NODE_13660_length_760_cov_27.981846	485	565	0	41	80	0.5125000
NODE_13660_length_760_cov_27.981846	485	565	2	39	80	0.4875000
NODE_13661_length_760_cov_17.500756	372	452	0	80	80	1.0000000
NODE_13661_length_760_cov_17.500756	425	505	0	80	80	1.0000000
NODE_13662_length_760_cov_17.420575	183	263	0	80	80	1.0000000
NODE_13662_length_760_cov_17.420575	236	316	0	80	80	1.0000000
NODE_13663_length_760_cov_13.444781	357	437	4	10	80	0.1250000
NODE_13663_length_760_cov_13.444781	357	437	6	70	80	0.8750000
NODE_13663_length_760_cov_13.444781	410	490	0	10	80	0.1250000
NODE_13663_length_760_cov_13.444781	410	490	2	26	80	0.3250000
NODE_13663_length_760_cov_13.444781	410	490	6	44	80	0.5500000
NODE_13664_length_760_cov_13.196672	282	362	0	80	80	1.0000000
NODE_13664_length_760_cov_13.196672	335	415	0	80	80	1.0000000
NODE_13665_length_760_cov_12.692890	295	375	0	33	80	0.4125000
NODE_13665_length_760_cov_12.692890	295	375	4	47	80	0.5875000
NODE_13665_length_760_cov_12.692890	348	428	0	10	80	0.1250000
NODE_13665_length_760_cov_12.692890	348	428	4	70	80	0.8750000
NODE_13671_length_760_cov_4.282905	388	468	0	80	80	1.0000000
NODE_13671_length_760_cov_4.282905	441	521	0	80	80	1.0000000
NODE_13671_length_760_cov_4.282905	517	597	0	56	80	0.7000000
NODE_13671_length_760_cov_4.282905	517	597	2	24	80	0.3000000
NODE_13683_length_760_cov_1.990923	490	570	0	68	80	0.8500000
NODE_13683_length_760_cov_1.990923	490	570	2	6	80	0.0750000
NODE_13683_length_760_cov_1.990923	490	570	4	6	80	0.0750000
NODE_13683_length_760_cov_1.990923	543	623	0	15	80	0.1875000
NODE_13683_length_760_cov_1.990923	543	623	2	6	80	0.0750000
NODE_13683_length_760_cov_1.990923	543	623	4	29	80	0.3625000
NODE_13683_length_760_cov_1.990923	543	623	6	11	80	0.1375000
NODE_13683_length_760_cov_1.990923	543	623	8	19	80	0.2375000
NODE_13709_length_759_cov_24.757576	376	456	0	14	80	0.1750000
NODE_13709_length_759_cov_24.757576	376	456	2	3	80	0.0375000
NODE_13709_length_759_cov_24.757576	376	456	8	63	80	0.7875000
NODE_13709_length_759_cov_24.757576	429	509	0	67	80	0.8375000
NODE_13709_length_759_cov_24.757576	429	509	2	3	80	0.0375000
NODE_13709_length_759_cov_24.757576	429	509	8	10	80	0.1250000
NODE_13710_length_759_cov_14.356061	210	290	0	80	80	1.0000000
NODE_13710_length_759_cov_14.356061	263	343	0	80	80	1.0000000
NODE_13711_length_759_cov_10.956061	328	408	0	80	80	1.0000000
NODE_13711_length_759_cov_10.956061	381	461	0	80	80	1.0000000
NODE_13712_length_759_cov_10.639394	330	410	2	80	80	1.0000000
NODE_13712_length_759_cov_10.639394	383	463	0	45	80	0.5625000
NODE_13712_length_759_cov_10.639394	383	463	2	35	80	0.4375000
NODE_13713_length_759_cov_9.192424	209	290	14	3	81	0.0370370
NODE_13713_length_759_cov_9.192424	209	290	16	5	81	0.0617284
NODE_13713_length_759_cov_9.192424	209	290	20	2	81	0.0246914
NODE_13713_length_759_cov_9.192424	209	290	22	3	81	0.0370370
NODE_13713_length_759_cov_9.192424	209	290	28	26	81	0.3209876
NODE_13713_length_759_cov_9.192424	209	290	30	7	81	0.0864198
NODE_13713_length_759_cov_9.192424	209	290	32	5	81	0.0617284
NODE_13713_length_759_cov_9.192424	209	290	34	14	81	0.1728395
NODE_13713_length_759_cov_9.192424	209	290	36	10	81	0.1234568
NODE_13713_length_759_cov_9.192424	209	290	38	1	81	0.0123457
NODE_13713_length_759_cov_9.192424	209	290	40	3	81	0.0370370
NODE_13713_length_759_cov_9.192424	209	290	44	2	81	0.0246914
NODE_13713_length_759_cov_9.192424	262	310	6	8	48	0.1666667
NODE_13713_length_759_cov_9.192424	262	310	8	7	48	0.1458333
NODE_13713_length_759_cov_9.192424	262	310	10	1	48	0.0208333
NODE_13713_length_759_cov_9.192424	262	310	12	2	48	0.0416667
NODE_13713_length_759_cov_9.192424	262	310	14	5	48	0.1041667
NODE_13713_length_759_cov_9.192424	262	310	16	5	48	0.1041667
NODE_13713_length_759_cov_9.192424	262	310	20	2	48	0.0416667
NODE_13713_length_759_cov_9.192424	262	310	22	3	48	0.0625000
NODE_13713_length_759_cov_9.192424	262	310	28	15	48	0.3125000
NODE_13714_length_759_cov_8.771212	292	372	0	80	80	1.0000000
NODE_13714_length_759_cov_8.771212	345	425	0	80	80	1.0000000
NODE_13715_length_759_cov_8.650000	324	404	0	80	80	1.0000000
NODE_13715_length_759_cov_8.650000	377	457	0	80	80	1.0000000
NODE_13716_length_759_cov_8.268182	604	684	0	80	80	1.0000000
NODE_13716_length_759_cov_8.268182	657	737	0	80	80	1.0000000
NODE_13717_length_759_cov_6.833333	381	461	0	44	80	0.5500000
NODE_13717_length_759_cov_6.833333	381	461	4	36	80	0.4500000
NODE_13717_length_759_cov_6.833333	434	515	4	81	81	1.0000000
NODE_13718_length_759_cov_6.407576	319	399	0	80	80	1.0000000
NODE_13718_length_759_cov_6.407576	372	452	0	80	80	1.0000000
NODE_13725_length_759_cov_3.400000	355	435	0	80	80	1.0000000
NODE_13725_length_759_cov_3.400000	408	488	0	52	80	0.6500000
NODE_13725_length_759_cov_3.400000	408	488	2	28	80	0.3500000
NODE_13726_length_759_cov_3.346970	240	322	0	82	82	1.0000000
NODE_13760_length_758_cov_38.414264	215	295	0	6	80	0.0750000
NODE_13760_length_758_cov_38.414264	215	295	4	17	80	0.2125000
NODE_13760_length_758_cov_38.414264	215	295	8	57	80	0.7125000
NODE_13760_length_758_cov_38.414264	268	348	0	59	80	0.7375000
NODE_13760_length_758_cov_38.414264	268	348	4	15	80	0.1875000
NODE_13760_length_758_cov_38.414264	268	348	8	6	80	0.0750000
NODE_13760_length_758_cov_38.414264	344	424	0	80	80	1.0000000
NODE_13760_length_758_cov_38.414264	397	477	0	67	80	0.8375000
NODE_13760_length_758_cov_38.414264	397	477	2	13	80	0.1625000
NODE_13761_length_758_cov_36.722307	331	411	11	15	80	0.1875000
NODE_13761_length_758_cov_36.722307	331	411	12	16	80	0.2000000
NODE_13761_length_758_cov_36.722307	331	411	13	49	80	0.6125000
NODE_13761_length_758_cov_36.722307	384	464	0	6	80	0.0750000
NODE_13761_length_758_cov_36.722307	384	464	3	13	80	0.1625000
NODE_13761_length_758_cov_36.722307	384	464	6	14	80	0.1750000
NODE_13761_length_758_cov_36.722307	384	464	8	18	80	0.2250000
NODE_13761_length_758_cov_36.722307	384	464	13	29	80	0.3625000
NODE_13762_length_758_cov_29.910470	235	315	0	80	80	1.0000000
NODE_13762_length_758_cov_29.910470	288	368	0	80	80	1.0000000
NODE_13763_length_758_cov_16.226100	386	466	0	62	80	0.7750000
NODE_13763_length_758_cov_16.226100	386	466	4	18	80	0.2250000
NODE_13763_length_758_cov_16.226100	439	519	0	9	80	0.1125000
NODE_13763_length_758_cov_16.226100	439	519	4	71	80	0.8875000
NODE_13764_length_758_cov_16.097117	311	391	0	80	80	1.0000000
NODE_13764_length_758_cov_16.097117	364	444	0	80	80	1.0000000
NODE_13765_length_758_cov_15.525038	260	340	0	47	80	0.5875000
NODE_13765_length_758_cov_15.525038	260	340	2	33	80	0.4125000
NODE_13765_length_758_cov_15.525038	313	393	2	80	80	1.0000000
NODE_13768_length_758_cov_9.153263	224	299	0	75	75	1.0000000
NODE_13771_length_758_cov_4.241275	508	588	0	40	80	0.5000000
NODE_13771_length_758_cov_4.241275	508	588	2	29	80	0.3625000
NODE_13771_length_758_cov_4.241275	508	588	4	7	80	0.0875000
NODE_13771_length_758_cov_4.241275	508	588	6	4	80	0.0500000
NODE_13772_length_758_cov_3.902883	346	426	0	80	80	1.0000000
NODE_13772_length_758_cov_3.902883	399	479	0	80	80	1.0000000
NODE_13794_length_757_cov_49.057751	155	235	0	80	80	1.0000000
NODE_13794_length_757_cov_49.057751	208	288	0	80	80	1.0000000
NODE_13795_length_757_cov_29.954407	181	262	0	81	81	1.0000000
NODE_13795_length_757_cov_29.954407	235	315	0	80	80	1.0000000
NODE_13795_length_757_cov_29.954407	311	391	0	80	80	1.0000000
NODE_13795_length_757_cov_29.954407	364	444	0	80	80	1.0000000
NODE_13796_length_757_cov_25.565350	352	432	0	80	80	1.0000000
NODE_13796_length_757_cov_25.565350	405	483	0	78	78	1.0000000
NODE_13797_length_757_cov_18.338906	264	344	0	80	80	1.0000000
NODE_13797_length_757_cov_18.338906	317	397	0	80	80	1.0000000
NODE_13798_length_757_cov_15.879939	58	138	0	80	80	1.0000000
NODE_13798_length_757_cov_15.879939	111	191	0	80	80	1.0000000
NODE_13800_length_757_cov_15.291793	314	394	0	25	80	0.3125000
NODE_13800_length_757_cov_15.291793	314	394	2	52	80	0.6500000
NODE_13800_length_757_cov_15.291793	314	394	4	3	80	0.0375000
NODE_13800_length_757_cov_15.291793	367	447	2	68	80	0.8500000
NODE_13800_length_757_cov_15.291793	367	447	4	12	80	0.1500000
NODE_13807_length_757_cov_3.182371	423	503	0	80	80	1.0000000
NODE_13807_length_757_cov_3.182371	476	556	0	80	80	1.0000000
NODE_13832_length_756_cov_26.441400	287	367	0	80	80	1.0000000
NODE_13832_length_756_cov_26.441400	340	420	0	80	80	1.0000000
NODE_13834_length_756_cov_13.097412	154	234	0	80	80	1.0000000
NODE_13834_length_756_cov_13.097412	207	287	0	80	80	1.0000000
NODE_13835_length_756_cov_12.732116	377	457	4	21	80	0.2625000
NODE_13835_length_756_cov_12.732116	377	457	6	59	80	0.7375000
NODE_13836_length_756_cov_9.254186	241	321	0	80	80	1.0000000
NODE_13836_length_756_cov_9.254186	294	374	0	80	80	1.0000000
NODE_13837_length_756_cov_8.304414	363	409	0	46	46	1.0000000
NODE_13838_length_756_cov_8.105023	271	351	0	80	80	1.0000000
NODE_13838_length_756_cov_8.105023	324	404	0	80	80	1.0000000
NODE_13840_length_756_cov_6.622527	431	511	0	80	80	1.0000000
NODE_13840_length_756_cov_6.622527	484	565	0	81	81	1.0000000
NODE_13888_length_755_cov_64.705793	303	383	0	80	80	1.0000000
NODE_13888_length_755_cov_64.705793	356	436	0	80	80	1.0000000
NODE_13889_length_755_cov_58.214939	425	505	0	80	80	1.0000000
NODE_13889_length_755_cov_58.214939	425	505	0	80	80	1.0000000
NODE_13889_length_755_cov_58.214939	478	556	0	78	78	1.0000000
NODE_13889_length_755_cov_58.214939	478	556	0	78	78	1.0000000
NODE_13890_length_755_cov_25.945122	237	317	0	11	80	0.1375000
NODE_13890_length_755_cov_25.945122	237	317	1	1	80	0.0125000
NODE_13890_length_755_cov_25.945122	237	317	2	31	80	0.3875000
NODE_13890_length_755_cov_25.945122	237	317	4	37	80	0.4625000
NODE_13890_length_755_cov_25.945122	290	370	0	64	80	0.8000000
NODE_13890_length_755_cov_25.945122	290	370	1	1	80	0.0125000
NODE_13890_length_755_cov_25.945122	290	370	2	15	80	0.1875000
NODE_13891_length_755_cov_24.263720	334	414	0	80	80	1.0000000
NODE_13891_length_755_cov_24.263720	387	467	0	80	80	1.0000000
NODE_13892_length_755_cov_15.559451	306	386	0	80	80	1.0000000
NODE_13892_length_755_cov_15.559451	359	439	0	80	80	1.0000000
NODE_13894_length_755_cov_10.196646	332	412	0	80	80	1.0000000
NODE_13894_length_755_cov_10.196646	385	465	0	80	80	1.0000000
NODE_13895_length_755_cov_9.772866	210	290	0	80	80	1.0000000
NODE_13895_length_755_cov_9.772866	263	343	0	46	80	0.5750000
NODE_13895_length_755_cov_9.772866	263	343	4	19	80	0.2375000
NODE_13895_length_755_cov_9.772866	263	343	6	15	80	0.1875000
NODE_13936_length_754_cov_87.432061	208	288	0	80	80	1.0000000
NODE_13936_length_754_cov_87.432061	261	341	0	80	80	1.0000000
NODE_13937_length_754_cov_16.549618	156	236	0	80	80	1.0000000
NODE_13937_length_754_cov_16.549618	209	289	0	80	80	1.0000000
NODE_13939_length_754_cov_9.068702	316	396	0	80	80	1.0000000
NODE_13939_length_754_cov_9.068702	369	449	0	80	80	1.0000000
NODE_13940_length_754_cov_5.925191	287	367	0	80	80	1.0000000
NODE_13940_length_754_cov_5.925191	340	420	0	80	80	1.0000000
NODE_13974_length_753_cov_10.434251	386	466	0	80	80	1.0000000
NODE_13974_length_753_cov_10.434251	439	519	0	80	80	1.0000000
NODE_13976_length_753_cov_7.056575	344	424	0	80	80	1.0000000
NODE_13976_length_753_cov_7.056575	397	477	0	80	80	1.0000000
NODE_13977_length_753_cov_4.597859	321	401	0	80	80	1.0000000
NODE_13977_length_753_cov_4.597859	374	454	0	80	80	1.0000000
NODE_14003_length_752_cov_66.281776	617	697	29	2	80	0.0250000
NODE_14003_length_752_cov_66.281776	617	697	31	2	80	0.0250000
NODE_14003_length_752_cov_66.281776	617	697	35	10	80	0.1250000
NODE_14003_length_752_cov_66.281776	617	697	37	13	80	0.1625000
NODE_14003_length_752_cov_66.281776	617	697	38	11	80	0.1375000
NODE_14003_length_752_cov_66.281776	617	697	39	5	80	0.0625000
NODE_14003_length_752_cov_66.281776	617	697	40	30	80	0.3750000
NODE_14003_length_752_cov_66.281776	617	697	41	5	80	0.0625000
NODE_14003_length_752_cov_66.281776	617	697	42	2	80	0.0250000
NODE_14003_length_752_cov_66.281776	670	751	0	2	81	0.0246914
NODE_14003_length_752_cov_66.281776	670	751	9	26	81	0.3209876
NODE_14003_length_752_cov_66.281776	670	751	12	2	81	0.0246914
NODE_14003_length_752_cov_66.281776	670	751	13	2	81	0.0246914
NODE_14003_length_752_cov_66.281776	670	751	15	8	81	0.0987654
NODE_14003_length_752_cov_66.281776	670	751	19	8	81	0.0987654
NODE_14003_length_752_cov_66.281776	670	751	21	4	81	0.0493827
NODE_14003_length_752_cov_66.281776	670	751	29	4	81	0.0493827
NODE_14003_length_752_cov_66.281776	670	751	31	2	81	0.0246914
NODE_14003_length_752_cov_66.281776	670	751	35	10	81	0.1234568
NODE_14003_length_752_cov_66.281776	670	751	37	13	81	0.1604938
NODE_14004_length_752_cov_60.274119	193	273	0	80	80	1.0000000
NODE_14004_length_752_cov_60.274119	246	326	0	80	80	1.0000000
NODE_14005_length_752_cov_19.811639	299	379	2	7	80	0.0875000
NODE_14005_length_752_cov_19.811639	299	379	4	73	80	0.9125000
NODE_14005_length_752_cov_19.811639	352	432	0	50	80	0.6250000
NODE_14005_length_752_cov_19.811639	352	432	2	10	80	0.1250000
NODE_14005_length_752_cov_19.811639	352	432	4	20	80	0.2500000
NODE_14006_length_752_cov_17.661562	118	198	2	6	80	0.0750000
NODE_14006_length_752_cov_17.661562	118	198	4	49	80	0.6125000
NODE_14006_length_752_cov_17.661562	118	198	6	20	80	0.2500000
NODE_14006_length_752_cov_17.661562	118	198	8	3	80	0.0375000
NODE_14006_length_752_cov_17.661562	118	198	10	2	80	0.0250000
NODE_14006_length_752_cov_17.661562	171	251	4	2	80	0.0250000
NODE_14006_length_752_cov_17.661562	171	251	6	20	80	0.2500000
NODE_14006_length_752_cov_17.661562	171	251	8	41	80	0.5125000
NODE_14006_length_752_cov_17.661562	171	251	10	17	80	0.2125000
NODE_14007_length_752_cov_13.275651	241	321	4	28	80	0.3500000
NODE_14007_length_752_cov_13.275651	241	321	6	6	80	0.0750000
NODE_14007_length_752_cov_13.275651	241	321	7	10	80	0.1250000
NODE_14007_length_752_cov_13.275651	241	321	8	3	80	0.0375000
NODE_14007_length_752_cov_13.275651	241	321	10	28	80	0.3500000
NODE_14007_length_752_cov_13.275651	241	321	12	5	80	0.0625000
NODE_14007_length_752_cov_13.275651	294	374	10	22	80	0.2750000
NODE_14007_length_752_cov_13.275651	294	374	12	38	80	0.4750000
NODE_14007_length_752_cov_13.275651	294	374	14	10	80	0.1250000
NODE_14007_length_752_cov_13.275651	294	374	16	10	80	0.1250000
NODE_14008_length_752_cov_10.928025	313	393	4	4	80	0.0500000
NODE_14008_length_752_cov_10.928025	313	393	8	13	80	0.1625000
NODE_14008_length_752_cov_10.928025	313	393	10	20	80	0.2500000
NODE_14008_length_752_cov_10.928025	313	393	12	34	80	0.4250000
NODE_14008_length_752_cov_10.928025	313	393	13	1	80	0.0125000
NODE_14008_length_752_cov_10.928025	313	393	14	8	80	0.1000000
NODE_14011_length_752_cov_9.558959	249	329	0	46	80	0.5750000
NODE_14011_length_752_cov_9.558959	249	329	7	23	80	0.2875000
NODE_14011_length_752_cov_9.558959	249	329	9	11	80	0.1375000
NODE_14011_length_752_cov_9.558959	302	382	7	16	80	0.2000000
NODE_14011_length_752_cov_9.558959	302	382	9	55	80	0.6875000
NODE_14011_length_752_cov_9.558959	302	382	11	9	80	0.1125000
NODE_14014_length_752_cov_8.281776	237	317	0	5	80	0.0625000
NODE_14014_length_752_cov_8.281776	237	317	2	75	80	0.9375000
NODE_14014_length_752_cov_8.281776	290	370	0	49	80	0.6125000
NODE_14014_length_752_cov_8.281776	290	370	2	31	80	0.3875000
NODE_14015_length_752_cov_8.082695	352	432	0	7	80	0.0875000
NODE_14015_length_752_cov_8.082695	352	432	2	73	80	0.9125000
NODE_14015_length_752_cov_8.082695	405	485	0	46	80	0.5750000
NODE_14015_length_752_cov_8.082695	405	485	2	34	80	0.4250000
NODE_14044_length_751_cov_20.730061	238	318	0	80	80	1.0000000
NODE_14044_length_751_cov_20.730061	291	371	0	80	80	1.0000000
NODE_14045_length_751_cov_18.478528	328	409	0	9	81	0.1111111
NODE_14045_length_751_cov_18.478528	328	409	2	72	81	0.8888889
NODE_14045_length_751_cov_18.478528	382	462	0	29	80	0.3625000
NODE_14045_length_751_cov_18.478528	382	462	2	51	80	0.6375000
NODE_14046_length_751_cov_13.016871	172	252	0	80	80	1.0000000
NODE_14046_length_751_cov_13.016871	225	305	0	80	80	1.0000000
NODE_14047_length_751_cov_12.363497	397	477	0	80	80	1.0000000
NODE_14047_length_751_cov_12.363497	450	530	0	80	80	1.0000000
NODE_14085_length_750_cov_46.371736	396	476	0	80	80	1.0000000
NODE_14085_length_750_cov_46.371736	449	529	0	80	80	1.0000000
NODE_14086_length_750_cov_24.428571	524	604	24	1	80	0.0125000
NODE_14086_length_750_cov_24.428571	524	604	28	1	80	0.0125000
NODE_14086_length_750_cov_24.428571	524	604	36	1	80	0.0125000
NODE_14086_length_750_cov_24.428571	524	604	41	1	80	0.0125000
NODE_14086_length_750_cov_24.428571	524	604	44	1	80	0.0125000
NODE_14086_length_750_cov_24.428571	524	604	46	1	80	0.0125000
NODE_14086_length_750_cov_24.428571	524	604	50	1	80	0.0125000
NODE_14086_length_750_cov_24.428571	524	604	57	1	80	0.0125000
NODE_14086_length_750_cov_24.428571	524	604	58	2	80	0.0250000
NODE_14086_length_750_cov_24.428571	524	604	60	17	80	0.2125000
NODE_14086_length_750_cov_24.428571	524	604	61	2	80	0.0250000
NODE_14086_length_750_cov_24.428571	524	604	62	3	80	0.0375000
NODE_14086_length_750_cov_24.428571	524	604	63	1	80	0.0125000
NODE_14086_length_750_cov_24.428571	524	604	64	2	80	0.0250000
NODE_14086_length_750_cov_24.428571	524	604	65	20	80	0.2500000
NODE_14086_length_750_cov_24.428571	524	604	66	8	80	0.1000000
NODE_14086_length_750_cov_24.428571	524	604	67	17	80	0.2125000
NODE_14086_length_750_cov_24.428571	683	746	0	63	63	1.0000000
NODE_14087_length_750_cov_24.311828	325	405	0	13	80	0.1625000
NODE_14087_length_750_cov_24.311828	325	405	2	67	80	0.8375000
NODE_14087_length_750_cov_24.311828	378	458	0	62	80	0.7750000
NODE_14087_length_750_cov_24.311828	378	458	2	18	80	0.2250000
NODE_14089_length_750_cov_8.529954	336	416	0	80	80	1.0000000
NODE_14089_length_750_cov_8.529954	395	469	0	32	74	0.4324324
NODE_14089_length_750_cov_8.529954	395	469	2	42	74	0.5675676
NODE_14137_length_749_cov_18.986154	221	301	0	80	80	1.0000000
NODE_14137_length_749_cov_18.986154	274	354	0	80	80	1.0000000
NODE_14138_length_749_cov_18.836923	273	355	0	82	82	1.0000000
NODE_14138_length_749_cov_18.836923	328	408	0	45	80	0.5625000
NODE_14138_length_749_cov_18.836923	328	408	2	35	80	0.4375000
NODE_14138_length_749_cov_18.836923	404	484	2	46	80	0.5750000
NODE_14138_length_749_cov_18.836923	404	484	4	34	80	0.4250000
NODE_14138_length_749_cov_18.836923	457	535	2	58	78	0.7435898
NODE_14138_length_749_cov_18.836923	457	535	4	20	78	0.2564103
NODE_14139_length_749_cov_16.160000	232	253	0	21	21	1.0000000
NODE_14139_length_749_cov_16.160000	232	306	0	74	74	1.0000000
NODE_14140_length_749_cov_16.115385	307	387	0	80	80	1.0000000
NODE_14140_length_749_cov_16.115385	360	440	0	80	80	1.0000000
NODE_14141_length_749_cov_11.210769	340	420	0	80	80	1.0000000
NODE_14141_length_749_cov_11.210769	393	473	0	80	80	1.0000000
NODE_14142_length_749_cov_8.424615	372	452	0	80	80	1.0000000
NODE_14142_length_749_cov_8.424615	425	505	0	80	80	1.0000000
NODE_14145_length_749_cov_4.521538	550	630	0	80	80	1.0000000
NODE_14145_length_749_cov_4.521538	603	683	0	80	80	1.0000000
NODE_14185_length_748_cov_55.348228	393	473	0	53	80	0.6625000
NODE_14185_length_748_cov_55.348228	393	473	14	27	80	0.3375000
NODE_14185_length_748_cov_55.348228	446	526	12	5	80	0.0625000
NODE_14185_length_748_cov_55.348228	446	526	13	6	80	0.0750000
NODE_14185_length_748_cov_55.348228	446	526	14	69	80	0.8625000
NODE_14186_length_748_cov_51.838213	369	449	0	26	80	0.3250000
NODE_14186_length_748_cov_51.838213	369	449	7	1	80	0.0125000
NODE_14186_length_748_cov_51.838213	369	449	9	38	80	0.4750000
NODE_14186_length_748_cov_51.838213	369	449	10	15	80	0.1875000
NODE_14186_length_748_cov_51.838213	422	502	9	51	80	0.6375000
NODE_14186_length_748_cov_51.838213	422	502	10	29	80	0.3625000
NODE_14187_length_748_cov_46.952234	293	373	2	4	80	0.0500000
NODE_14187_length_748_cov_46.952234	293	373	4	1	80	0.0125000
NODE_14187_length_748_cov_46.952234	293	373	5	16	80	0.2000000
NODE_14187_length_748_cov_46.952234	293	373	6	2	80	0.0250000
NODE_14187_length_748_cov_46.952234	293	373	7	57	80	0.7125000
NODE_14187_length_748_cov_46.952234	346	426	4	29	80	0.3625000
NODE_14187_length_748_cov_46.952234	346	426	5	21	80	0.2625000
NODE_14187_length_748_cov_46.952234	346	426	6	19	80	0.2375000
NODE_14187_length_748_cov_46.952234	346	426	7	11	80	0.1375000
NODE_14188_length_748_cov_45.001541	272	352	0	80	80	1.0000000
NODE_14188_length_748_cov_45.001541	325	405	0	80	80	1.0000000
NODE_14189_length_748_cov_34.355932	488	568	0	17	80	0.2125000
NODE_14189_length_748_cov_34.355932	488	568	12	37	80	0.4625000
NODE_14189_length_748_cov_34.355932	488	568	21	1	80	0.0125000
NODE_14189_length_748_cov_34.355932	488	568	24	25	80	0.3125000
NODE_14189_length_748_cov_34.355932	541	621	12	1	80	0.0125000
NODE_14189_length_748_cov_34.355932	541	621	21	1	80	0.0125000
NODE_14189_length_748_cov_34.355932	541	621	23	20	80	0.2500000
NODE_14189_length_748_cov_34.355932	541	621	24	58	80	0.7250000
NODE_14190_length_748_cov_25.972265	297	377	14	17	80	0.2125000
NODE_14190_length_748_cov_25.972265	297	377	16	13	80	0.1625000
NODE_14190_length_748_cov_25.972265	297	377	18	50	80	0.6250000
NODE_14190_length_748_cov_25.972265	350	430	0	33	80	0.4125000
NODE_14190_length_748_cov_25.972265	350	430	4	8	80	0.1000000
NODE_14190_length_748_cov_25.972265	350	430	10	5	80	0.0625000
NODE_14190_length_748_cov_25.972265	350	430	14	24	80	0.3000000
NODE_14190_length_748_cov_25.972265	350	430	16	10	80	0.1250000
NODE_14191_length_748_cov_21.050847	362	442	0	48	80	0.6000000
NODE_14191_length_748_cov_21.050847	362	442	2	32	80	0.4000000
NODE_14191_length_748_cov_21.050847	415	495	0	80	80	1.0000000
NODE_14192_length_748_cov_20.682589	353	433	0	80	80	1.0000000
NODE_14192_length_748_cov_20.682589	406	486	0	80	80	1.0000000
NODE_14193_length_748_cov_19.081664	261	341	0	80	80	1.0000000
NODE_14193_length_748_cov_19.081664	314	394	0	64	80	0.8000000
NODE_14193_length_748_cov_19.081664	314	394	2	16	80	0.2000000
NODE_14193_length_748_cov_19.081664	390	470	0	13	80	0.1625000
NODE_14193_length_748_cov_19.081664	390	470	2	67	80	0.8375000
NODE_14193_length_748_cov_19.081664	443	522	0	65	79	0.8227848
NODE_14193_length_748_cov_19.081664	443	522	2	14	79	0.1772152
NODE_14194_length_748_cov_16.579353	81	161	0	50	80	0.6250000
NODE_14194_length_748_cov_16.579353	81	161	2	24	80	0.3000000
NODE_14194_length_748_cov_16.579353	81	161	4	6	80	0.0750000
NODE_14194_length_748_cov_16.579353	134	214	2	21	80	0.2625000
NODE_14194_length_748_cov_16.579353	134	214	4	59	80	0.7375000
NODE_14194_length_748_cov_16.579353	210	290	0	15	80	0.1875000
NODE_14194_length_748_cov_16.579353	210	290	2	20	80	0.2500000
NODE_14194_length_748_cov_16.579353	210	290	4	45	80	0.5625000
NODE_14194_length_748_cov_16.579353	263	343	0	15	80	0.1875000
NODE_14194_length_748_cov_16.579353	263	343	2	6	80	0.0750000
NODE_14194_length_748_cov_16.579353	263	343	4	59	80	0.7375000
NODE_14196_length_748_cov_11.983051	375	455	0	7	80	0.0875000
NODE_14196_length_748_cov_11.983051	375	455	2	73	80	0.9125000
NODE_14196_length_748_cov_11.983051	428	508	0	46	80	0.5750000
NODE_14196_length_748_cov_11.983051	428	508	2	34	80	0.4250000
NODE_14197_length_748_cov_11.474576	257	337	0	80	80	1.0000000
NODE_14197_length_748_cov_11.474576	310	390	0	80	80	1.0000000
NODE_14200_length_748_cov_7.979969	223	303	0	80	80	1.0000000
NODE_14200_length_748_cov_7.979969	276	356	0	80	80	1.0000000
NODE_14240_length_747_cov_24.279321	205	285	2	80	80	1.0000000
NODE_14240_length_747_cov_24.279321	258	338	0	48	80	0.6000000
NODE_14240_length_747_cov_24.279321	258	338	2	32	80	0.4000000
NODE_14241_length_747_cov_15.438272	352	432	0	16	80	0.2000000
NODE_14241_length_747_cov_15.438272	352	432	4	7	80	0.0875000
NODE_14241_length_747_cov_15.438272	352	432	6	57	80	0.7125000
NODE_14241_length_747_cov_15.438272	405	485	0	12	80	0.1500000
NODE_14241_length_747_cov_15.438272	405	485	4	5	80	0.0625000
NODE_14241_length_747_cov_15.438272	405	485	6	63	80	0.7875000
NODE_14244_length_747_cov_7.979938	237	317	0	80	80	1.0000000
NODE_14244_length_747_cov_7.979938	290	370	0	80	80	1.0000000
NODE_14248_length_747_cov_4.918210	157	237	0	80	80	1.0000000
NODE_14248_length_747_cov_4.918210	210	290	0	80	80	1.0000000
NODE_14277_length_746_cov_44.041731	153	233	0	80	80	1.0000000
NODE_14277_length_746_cov_44.041731	206	286	0	80	80	1.0000000
NODE_14278_length_746_cov_24.435858	334	414	2	26	80	0.3250000
NODE_14278_length_746_cov_24.435858	334	414	4	22	80	0.2750000
NODE_14278_length_746_cov_24.435858	334	414	6	32	80	0.4000000
NODE_14278_length_746_cov_24.435858	387	467	0	6	80	0.0750000
NODE_14278_length_746_cov_24.435858	387	467	2	21	80	0.2625000
NODE_14278_length_746_cov_24.435858	387	467	3	12	80	0.1500000
NODE_14278_length_746_cov_24.435858	387	467	4	36	80	0.4500000
NODE_14278_length_746_cov_24.435858	387	467	6	5	80	0.0625000
NODE_14279_length_746_cov_20.225657	114	194	0	11	80	0.1375000
NODE_14279_length_746_cov_20.225657	114	194	4	69	80	0.8625000
NODE_14279_length_746_cov_20.225657	167	247	2	15	80	0.1875000
NODE_14279_length_746_cov_20.225657	167	247	4	46	80	0.5750000
NODE_14279_length_746_cov_20.225657	167	247	5	18	80	0.2250000
NODE_14279_length_746_cov_20.225657	167	247	6	1	80	0.0125000
NODE_14280_length_746_cov_17.919629	330	410	0	80	80	1.0000000
NODE_14280_length_746_cov_17.919629	383	463	0	80	80	1.0000000
NODE_14281_length_746_cov_17.523957	292	372	0	4	80	0.0500000
NODE_14281_length_746_cov_17.523957	292	372	4	76	80	0.9500000
NODE_14281_length_746_cov_17.523957	345	425	0	57	80	0.7125000
NODE_14281_length_746_cov_17.523957	345	425	4	23	80	0.2875000
NODE_14282_length_746_cov_17.214838	306	386	0	80	80	1.0000000
NODE_14282_length_746_cov_17.214838	359	439	0	80	80	1.0000000
NODE_14283_length_746_cov_16.765070	344	424	0	80	80	1.0000000
NODE_14283_length_746_cov_16.765070	397	477	0	80	80	1.0000000
NODE_14284_length_746_cov_13.153014	126	206	0	80	80	1.0000000
NODE_14284_length_746_cov_13.153014	179	259	0	80	80	1.0000000
NODE_14284_length_746_cov_13.153014	244	263	0	19	19	1.0000000
NODE_14285_length_746_cov_12.316847	364	442	6	78	78	1.0000000
NODE_14286_length_746_cov_11.301391	349	429	0	5	80	0.0625000
NODE_14286_length_746_cov_11.301391	349	429	2	26	80	0.3250000
NODE_14286_length_746_cov_11.301391	349	429	4	49	80	0.6125000
NODE_14286_length_746_cov_11.301391	402	482	0	58	80	0.7250000
NODE_14286_length_746_cov_11.301391	402	482	2	22	80	0.2750000
NODE_14302_length_746_cov_2.639876	331	411	8	22	80	0.2750000
NODE_14302_length_746_cov_2.639876	331	411	10	3	80	0.0375000
NODE_14302_length_746_cov_2.639876	331	411	16	2	80	0.0250000
NODE_14302_length_746_cov_2.639876	331	411	18	2	80	0.0250000
NODE_14302_length_746_cov_2.639876	331	411	20	22	80	0.2750000
NODE_14302_length_746_cov_2.639876	331	411	22	29	80	0.3625000
NODE_14307_length_746_cov_1.879444	435	502	0	67	67	1.0000000
NODE_14310_length_746_cov_1.727975	65	121	0	56	56	1.0000000
NODE_14310_length_746_cov_1.727975	494	540	0	46	46	1.0000000
NODE_14329_length_745_cov_40.360681	257	337	0	80	80	1.0000000
NODE_14329_length_745_cov_40.360681	310	390	0	80	80	1.0000000
NODE_14330_length_745_cov_30.817337	339	419	0	72	80	0.9000000
NODE_14330_length_745_cov_30.817337	339	419	2	8	80	0.1000000
NODE_14330_length_745_cov_30.817337	392	459	0	19	67	0.2835821
NODE_14330_length_745_cov_30.817337	392	459	2	48	67	0.7164179
NODE_14335_length_745_cov_8.620743	225	275	0	50	50	1.0000000
NODE_14335_length_745_cov_8.620743	248	328	0	80	80	1.0000000
NODE_14343_length_745_cov_3.922601	249	280	29	1	31	0.0322581
NODE_14343_length_745_cov_3.922601	249	280	31	2	31	0.0645161
NODE_14343_length_745_cov_3.922601	249	280	33	4	31	0.1290323
NODE_14343_length_745_cov_3.922601	249	280	34	21	31	0.6774194
NODE_14343_length_745_cov_3.922601	249	280	35	1	31	0.0322581
NODE_14343_length_745_cov_3.922601	249	280	36	2	31	0.0645161
NODE_14343_length_745_cov_3.922601	253	333	26	4	80	0.0500000
NODE_14343_length_745_cov_3.922601	253	333	28	7	80	0.0875000
NODE_14343_length_745_cov_3.922601	253	333	30	27	80	0.3375000
NODE_14343_length_745_cov_3.922601	253	333	31	11	80	0.1375000
NODE_14343_length_745_cov_3.922601	253	333	33	6	80	0.0750000
NODE_14343_length_745_cov_3.922601	253	333	34	22	80	0.2750000
NODE_14343_length_745_cov_3.922601	253	333	35	1	80	0.0125000
NODE_14343_length_745_cov_3.922601	253	333	36	2	80	0.0250000
NODE_14381_length_744_cov_44.953488	553	633	0	20	80	0.2500000
NODE_14381_length_744_cov_44.953488	553	633	4	59	80	0.7375000
NODE_14381_length_744_cov_44.953488	553	633	8	1	80	0.0125000
NODE_14381_length_744_cov_44.953488	553	633	0	20	80	0.2500000
NODE_14381_length_744_cov_44.953488	553	633	4	59	80	0.7375000
NODE_14381_length_744_cov_44.953488	553	633	8	1	80	0.0125000
NODE_14381_length_744_cov_44.953488	553	633	0	20	80	0.2500000
NODE_14381_length_744_cov_44.953488	553	633	4	59	80	0.7375000
NODE_14381_length_744_cov_44.953488	553	633	8	1	80	0.0125000
NODE_14381_length_744_cov_44.953488	553	633	0	20	80	0.2500000
NODE_14381_length_744_cov_44.953488	553	633	4	59	80	0.7375000
NODE_14381_length_744_cov_44.953488	553	633	8	1	80	0.0125000
NODE_14382_length_744_cov_35.333333	163	243	2	12	80	0.1500000
NODE_14382_length_744_cov_35.333333	163	243	7	1	80	0.0125000
NODE_14382_length_744_cov_35.333333	163	243	9	12	80	0.1500000
NODE_14382_length_744_cov_35.333333	163	243	14	19	80	0.2375000
NODE_14382_length_744_cov_35.333333	163	243	16	36	80	0.4500000
NODE_14382_length_744_cov_35.333333	216	296	14	72	80	0.9000000
NODE_14382_length_744_cov_35.333333	216	296	16	8	80	0.1000000
NODE_14382_length_744_cov_35.333333	292	372	12	34	80	0.4250000
NODE_14382_length_744_cov_35.333333	292	372	14	9	80	0.1125000
NODE_14382_length_744_cov_35.333333	292	372	18	1	80	0.0125000
NODE_14382_length_744_cov_35.333333	292	372	19	12	80	0.1500000
NODE_14382_length_744_cov_35.333333	292	372	20	20	80	0.2500000
NODE_14382_length_744_cov_35.333333	292	372	26	4	80	0.0500000
NODE_14382_length_744_cov_35.333333	345	425	12	80	80	1.0000000
NODE_14383_length_744_cov_34.503876	294	374	0	80	80	1.0000000
NODE_14383_length_744_cov_34.503876	347	427	0	80	80	1.0000000
NODE_14384_length_744_cov_32.282171	333	403	0	70	70	1.0000000
NODE_14384_length_744_cov_32.282171	440	520	0	80	80	1.0000000
NODE_14384_length_744_cov_32.282171	493	573	0	80	80	1.0000000
NODE_14390_length_744_cov_4.537984	260	340	0	80	80	1.0000000
NODE_14390_length_744_cov_4.537984	313	393	0	80	80	1.0000000
NODE_14396_length_744_cov_2.784496	335	387	0	1	52	0.0192308
NODE_14396_length_744_cov_2.784496	335	387	2	5	52	0.0961538
NODE_14396_length_744_cov_2.784496	335	387	4	1	52	0.0192308
NODE_14396_length_744_cov_2.784496	335	387	6	7	52	0.1346154
NODE_14396_length_744_cov_2.784496	335	387	8	38	52	0.7307692
NODE_14396_length_744_cov_2.784496	360	437	2	4	77	0.0519481
NODE_14396_length_744_cov_2.784496	360	437	4	11	77	0.1428571
NODE_14396_length_744_cov_2.784496	360	437	6	7	77	0.0909091
NODE_14396_length_744_cov_2.784496	360	437	8	55	77	0.7142857
NODE_14427_length_743_cov_26.369565	354	434	0	20	80	0.2500000
NODE_14427_length_743_cov_26.369565	354	434	2	60	80	0.7500000
NODE_14427_length_743_cov_26.369565	407	487	0	61	80	0.7625000
NODE_14427_length_743_cov_26.369565	407	487	2	19	80	0.2375000
NODE_14428_length_743_cov_21.759317	138	218	0	41	80	0.5125000
NODE_14428_length_743_cov_21.759317	138	218	2	39	80	0.4875000
NODE_14428_length_743_cov_21.759317	191	271	2	80	80	1.0000000
NODE_14429_length_743_cov_18.173913	213	293	0	80	80	1.0000000
NODE_14429_length_743_cov_18.173913	266	346	0	80	80	1.0000000
NODE_14431_length_743_cov_17.066770	400	480	2	7	80	0.0875000
NODE_14431_length_743_cov_17.066770	400	480	5	7	80	0.0875000
NODE_14431_length_743_cov_17.066770	400	480	8	65	80	0.8125000
NODE_14431_length_743_cov_17.066770	400	480	10	1	80	0.0125000
NODE_14431_length_743_cov_17.066770	453	532	2	10	79	0.1265823
NODE_14431_length_743_cov_17.066770	453	532	4	4	79	0.0506329
NODE_14431_length_743_cov_17.066770	453	532	8	64	79	0.8101266
NODE_14431_length_743_cov_17.066770	453	532	10	1	79	0.0126582
NODE_14432_length_743_cov_16.354037	350	430	0	4	80	0.0500000
NODE_14432_length_743_cov_16.354037	350	430	4	76	80	0.9500000
NODE_14432_length_743_cov_16.354037	403	483	0	32	80	0.4000000
NODE_14432_length_743_cov_16.354037	403	483	2	25	80	0.3125000
NODE_14432_length_743_cov_16.354037	403	483	4	23	80	0.2875000
NODE_14433_length_743_cov_15.667702	220	300	0	80	80	1.0000000
NODE_14433_length_743_cov_15.667702	273	353	0	80	80	1.0000000
NODE_14433_length_743_cov_15.667702	349	429	0	80	80	1.0000000
NODE_14433_length_743_cov_15.667702	402	482	0	68	80	0.8500000
NODE_14433_length_743_cov_15.667702	402	482	4	12	80	0.1500000
NODE_14434_length_743_cov_14.975155	289	362	10	7	73	0.0958904
NODE_14434_length_743_cov_14.975155	289	362	12	5	73	0.0684932
NODE_14434_length_743_cov_14.975155	289	362	14	61	73	0.8356164
NODE_14435_length_743_cov_14.100932	232	312	0	80	80	1.0000000
NODE_14435_length_743_cov_14.100932	285	365	0	80	80	1.0000000
NODE_14435_length_743_cov_14.100932	361	441	0	80	80	1.0000000
NODE_14435_length_743_cov_14.100932	414	494	0	80	80	1.0000000
NODE_14436_length_743_cov_12.968944	268	348	7	8	80	0.1000000
NODE_14436_length_743_cov_12.968944	268	348	8	49	80	0.6125000
NODE_14436_length_743_cov_12.968944	268	348	10	3	80	0.0375000
NODE_14436_length_743_cov_12.968944	268	348	12	20	80	0.2500000
NODE_14436_length_743_cov_12.968944	321	401	8	4	80	0.0500000
NODE_14436_length_743_cov_12.968944	321	401	10	7	80	0.0875000
NODE_14436_length_743_cov_12.968944	321	401	12	39	80	0.4875000
NODE_14436_length_743_cov_12.968944	321	401	13	1	80	0.0125000
NODE_14436_length_743_cov_12.968944	321	401	14	29	80	0.3625000
NODE_14437_length_743_cov_12.847826	485	565	0	80	80	1.0000000
NODE_14437_length_743_cov_12.847826	538	618	0	80	80	1.0000000
NODE_14438_length_743_cov_11.871118	403	483	0	80	80	1.0000000
NODE_14438_length_743_cov_11.871118	456	536	0	80	80	1.0000000
NODE_14439_length_743_cov_11.760870	337	417	0	2	80	0.0250000
NODE_14439_length_743_cov_11.760870	337	417	2	78	80	0.9750000
NODE_14439_length_743_cov_11.760870	390	470	0	5	80	0.0625000
NODE_14439_length_743_cov_11.760870	390	470	2	75	80	0.9375000
NODE_14440_length_743_cov_9.006211	351	431	0	80	80	1.0000000
NODE_14440_length_743_cov_9.006211	404	484	0	80	80	1.0000000
NODE_14441_length_743_cov_8.063665	290	370	0	80	80	1.0000000
NODE_14441_length_743_cov_8.063665	343	423	0	80	80	1.0000000
NODE_14456_length_743_cov_2.029503	260	284	0	24	24	1.0000000
NODE_14456_length_743_cov_2.029503	301	363	2	62	62	1.0000000
NODE_14473_length_743_cov_0.989130	592	670	6	2	78	0.0256410
NODE_14473_length_743_cov_0.989130	592	670	8	2	78	0.0256410
NODE_14473_length_743_cov_0.989130	592	670	14	9	78	0.1153846
NODE_14473_length_743_cov_0.989130	592	670	18	1	78	0.0128205
NODE_14473_length_743_cov_0.989130	592	670	20	1	78	0.0128205
NODE_14473_length_743_cov_0.989130	592	670	45	2	78	0.0256410
NODE_14473_length_743_cov_0.989130	592	670	47	1	78	0.0128205
NODE_14473_length_743_cov_0.989130	592	670	56	5	78	0.0641026
NODE_14473_length_743_cov_0.989130	592	670	58	5	78	0.0641026
NODE_14473_length_743_cov_0.989130	592	670	62	3	78	0.0384615
NODE_14473_length_743_cov_0.989130	592	670	64	7	78	0.0897436
NODE_14473_length_743_cov_0.989130	592	670	65	4	78	0.0512821
NODE_14473_length_743_cov_0.989130	592	670	68	2	78	0.0256410
NODE_14473_length_743_cov_0.989130	592	670	70	7	78	0.0897436
NODE_14473_length_743_cov_0.989130	592	670	72	27	78	0.3461539
NODE_14477_length_742_cov_23.664075	271	351	0	80	80	1.0000000
NODE_14477_length_742_cov_23.664075	324	404	0	80	80	1.0000000
NODE_14478_length_742_cov_19.488336	288	368	0	10	80	0.1250000
NODE_14478_length_742_cov_19.488336	288	368	2	11	80	0.1375000
NODE_14478_length_742_cov_19.488336	288	368	4	57	80	0.7125000
NODE_14478_length_742_cov_19.488336	288	368	6	2	80	0.0250000
NODE_14478_length_742_cov_19.488336	341	421	2	64	80	0.8000000
NODE_14478_length_742_cov_19.488336	341	421	4	14	80	0.1750000
NODE_14478_length_742_cov_19.488336	341	421	6	2	80	0.0250000
NODE_14479_length_742_cov_18.528771	319	399	0	80	80	1.0000000
NODE_14479_length_742_cov_18.528771	372	452	0	80	80	1.0000000
NODE_14480_length_742_cov_17.401244	126	206	0	80	80	1.0000000
NODE_14480_length_742_cov_17.401244	179	259	0	80	80	1.0000000
NODE_14482_length_742_cov_7.679627	274	354	0	80	80	1.0000000
NODE_14482_length_742_cov_7.679627	327	407	0	80	80	1.0000000
NODE_14521_length_741_cov_12.168224	316	392	6	42	76	0.5526316
NODE_14521_length_741_cov_12.168224	316	392	8	34	76	0.4473684
NODE_14521_length_741_cov_12.168224	598	663	0	65	65	1.0000000
NODE_14522_length_741_cov_8.542056	198	278	0	80	80	1.0000000
NODE_14522_length_741_cov_8.542056	251	331	0	58	80	0.7250000
NODE_14522_length_741_cov_8.542056	251	331	2	22	80	0.2750000
NODE_14525_length_741_cov_5.989097	457	538	6	22	81	0.2716049
NODE_14525_length_741_cov_5.989097	457	538	8	24	81	0.2962963
NODE_14525_length_741_cov_5.989097	457	538	10	35	81	0.4320988
NODE_14536_length_741_cov_2.556075	212	289	0	76	77	0.9870130
NODE_14536_length_741_cov_2.556075	212	289	4	1	77	0.0129870
NODE_14571_length_740_cov_54.372855	192	272	0	80	80	1.0000000
NODE_14571_length_740_cov_54.372855	245	325	0	80	80	1.0000000
NODE_14571_length_740_cov_54.372855	321	401	0	80	80	1.0000000
NODE_14571_length_740_cov_54.372855	374	454	0	80	80	1.0000000
NODE_14572_length_740_cov_51.758190	194	274	0	6	80	0.0750000
NODE_14572_length_740_cov_51.758190	194	274	2	4	80	0.0500000
NODE_14572_length_740_cov_51.758190	194	274	4	70	80	0.8750000
NODE_14572_length_740_cov_51.758190	247	327	0	12	80	0.1500000
NODE_14572_length_740_cov_51.758190	247	327	2	37	80	0.4625000
NODE_14572_length_740_cov_51.758190	247	327	4	31	80	0.3875000
NODE_14573_length_740_cov_34.185647	359	439	0	80	80	1.0000000
NODE_14573_length_740_cov_34.185647	412	492	0	80	80	1.0000000
NODE_14574_length_740_cov_24.794072	286	366	4	70	80	0.8750000
NODE_14574_length_740_cov_24.794072	286	366	8	10	80	0.1250000
NODE_14574_length_740_cov_24.794072	339	419	4	20	80	0.2500000
NODE_14574_length_740_cov_24.794072	339	419	8	60	80	0.7500000
NODE_14575_length_740_cov_20.361934	316	396	0	63	80	0.7875000
NODE_14575_length_740_cov_20.361934	316	396	2	17	80	0.2125000
NODE_14575_length_740_cov_20.361934	369	449	0	10	80	0.1250000
NODE_14575_length_740_cov_20.361934	369	449	2	70	80	0.8750000
NODE_14576_length_740_cov_18.982839	266	348	0	22	82	0.2682927
NODE_14576_length_740_cov_18.982839	266	348	10	60	82	0.7317073
NODE_14576_length_740_cov_18.982839	321	401	10	80	80	1.0000000
NODE_14577_length_740_cov_16.755070	354	434	0	24	80	0.3000000
NODE_14577_length_740_cov_16.755070	354	434	2	1	80	0.0125000
NODE_14577_length_740_cov_16.755070	354	434	4	55	80	0.6875000
NODE_14577_length_740_cov_16.755070	407	487	2	29	80	0.3625000
NODE_14577_length_740_cov_16.755070	407	487	4	51	80	0.6375000
NODE_14579_length_740_cov_7.585023	206	286	0	80	80	1.0000000
NODE_14579_length_740_cov_7.585023	259	339	0	80	80	1.0000000
NODE_14580_length_740_cov_7.174727	165	245	4	21	80	0.2625000
NODE_14580_length_740_cov_7.174727	165	245	6	59	80	0.7375000
NODE_14580_length_740_cov_7.174727	218	298	0	10	80	0.1250000
NODE_14580_length_740_cov_7.174727	218	298	2	15	80	0.1875000
NODE_14580_length_740_cov_7.174727	218	298	4	7	80	0.0875000
NODE_14580_length_740_cov_7.174727	218	298	6	48	80	0.6000000
NODE_14614_length_739_cov_52.970312	346	426	0	80	80	1.0000000
NODE_14614_length_739_cov_52.970312	399	479	0	80	80	1.0000000
NODE_14615_length_739_cov_31.175000	204	284	0	2	80	0.0250000
NODE_14615_length_739_cov_31.175000	204	284	2	58	80	0.7250000
NODE_14615_length_739_cov_31.175000	204	284	7	20	80	0.2500000
NODE_14615_length_739_cov_31.175000	257	337	0	9	80	0.1125000
NODE_14615_length_739_cov_31.175000	257	337	2	7	80	0.0875000
NODE_14615_length_739_cov_31.175000	257	337	5	8	80	0.1000000
NODE_14615_length_739_cov_31.175000	257	337	7	56	80	0.7000000
NODE_14616_length_739_cov_25.482813	487	567	0	80	80	1.0000000
NODE_14616_length_739_cov_25.482813	540	620	0	80	80	1.0000000
NODE_14617_length_739_cov_24.871875	191	271	0	80	80	1.0000000
NODE_14617_length_739_cov_24.871875	244	324	0	80	80	1.0000000
NODE_14618_length_739_cov_18.360937	146	226	2	17	80	0.2125000
NODE_14618_length_739_cov_18.360937	146	226	4	63	80	0.7875000
NODE_14618_length_739_cov_18.360937	199	279	0	5	80	0.0625000
NODE_14618_length_739_cov_18.360937	199	279	2	53	80	0.6625000
NODE_14618_length_739_cov_18.360937	199	279	4	22	80	0.2750000
NODE_14619_length_739_cov_13.195312	273	353	0	80	80	1.0000000
NODE_14619_length_739_cov_13.195312	326	406	0	80	80	1.0000000
NODE_14620_length_739_cov_10.314063	231	311	0	80	80	1.0000000
NODE_14620_length_739_cov_10.314063	284	364	0	80	80	1.0000000
NODE_14622_length_739_cov_8.523438	468	548	0	80	80	1.0000000
NODE_14622_length_739_cov_8.523438	521	600	0	79	79	1.0000000
NODE_14623_length_739_cov_7.398438	342	422	2	8	80	0.1000000
NODE_14623_length_739_cov_7.398438	342	422	4	31	80	0.3875000
NODE_14623_length_739_cov_7.398438	342	422	6	41	80	0.5125000
NODE_14623_length_739_cov_7.398438	395	475	0	4	80	0.0500000
NODE_14623_length_739_cov_7.398438	395	475	2	57	80	0.7125000
NODE_14623_length_739_cov_7.398438	395	475	4	19	80	0.2375000
NODE_14625_length_739_cov_5.826562	252	332	4	6	80	0.0750000
NODE_14625_length_739_cov_5.826562	252	332	6	74	80	0.9250000
NODE_14625_length_739_cov_5.826562	305	385	2	8	80	0.1000000
NODE_14625_length_739_cov_5.826562	305	385	4	6	80	0.0750000
NODE_14625_length_739_cov_5.826562	305	385	6	66	80	0.8250000
NODE_14634_length_739_cov_3.232813	355	435	0	80	80	1.0000000
NODE_14634_length_739_cov_3.232813	408	488	0	80	80	1.0000000
NODE_14679_length_738_cov_35.278560	274	318	58	2	44	0.0454545
NODE_14679_length_738_cov_35.278560	274	318	60	5	44	0.1136364
NODE_14679_length_738_cov_35.278560	274	318	62	5	44	0.1136364
NODE_14679_length_738_cov_35.278560	274	318	66	4	44	0.0909091
NODE_14679_length_738_cov_35.278560	274	318	67	2	44	0.0454545
NODE_14679_length_738_cov_35.278560	274	318	68	12	44	0.2727273
NODE_14679_length_738_cov_35.278560	274	318	70	9	44	0.2045455
NODE_14679_length_738_cov_35.278560	274	318	71	3	44	0.0681818
NODE_14679_length_738_cov_35.278560	274	318	72	1	44	0.0227273
NODE_14679_length_738_cov_35.278560	274	318	73	1	44	0.0227273
NODE_14680_length_738_cov_21.672926	208	288	0	31	80	0.3875000
NODE_14680_length_738_cov_21.672926	208	288	2	49	80	0.6125000
NODE_14680_length_738_cov_21.672926	261	341	0	23	80	0.2875000
NODE_14680_length_738_cov_21.672926	261	341	2	57	80	0.7125000
NODE_14681_length_738_cov_15.665102	302	382	0	80	80	1.0000000
NODE_14681_length_738_cov_15.665102	355	435	0	80	80	1.0000000
NODE_14682_length_738_cov_15.661972	338	418	0	80	80	1.0000000
NODE_14682_length_738_cov_15.661972	391	471	0	80	80	1.0000000
NODE_14683_length_738_cov_12.594679	49	129	0	80	80	1.0000000
NODE_14683_length_738_cov_12.594679	102	182	0	80	80	1.0000000
NODE_14683_length_738_cov_12.594679	178	258	0	42	80	0.5250000
NODE_14683_length_738_cov_12.594679	178	258	2	38	80	0.4750000
NODE_14683_length_738_cov_12.594679	231	311	0	10	80	0.1250000
NODE_14683_length_738_cov_12.594679	231	311	2	70	80	0.8750000
NODE_14691_length_738_cov_4.056338	254	326	0	17	72	0.2361111
NODE_14691_length_738_cov_4.056338	254	326	2	55	72	0.7638889
NODE_14691_length_738_cov_4.056338	437	528	0	61	91	0.6703297
NODE_14691_length_738_cov_4.056338	437	528	2	30	91	0.3296703
NODE_14724_length_737_cov_22.363636	303	383	6	80	80	1.0000000
NODE_14724_length_737_cov_22.363636	356	436	0	24	80	0.3000000
NODE_14724_length_737_cov_22.363636	356	436	2	20	80	0.2500000
NODE_14724_length_737_cov_22.363636	356	436	6	36	80	0.4500000
NODE_14725_length_737_cov_21.318182	208	288	0	80	80	1.0000000
NODE_14725_length_737_cov_21.318182	261	341	0	80	80	1.0000000
NODE_14726_length_737_cov_17.161442	346	426	4	3	80	0.0375000
NODE_14726_length_737_cov_17.161442	346	426	6	46	80	0.5750000
NODE_14726_length_737_cov_17.161442	346	426	8	31	80	0.3875000
NODE_14726_length_737_cov_17.161442	399	479	2	21	80	0.2625000
NODE_14726_length_737_cov_17.161442	399	479	4	24	80	0.3000000
NODE_14726_length_737_cov_17.161442	399	479	8	35	80	0.4375000
NODE_14727_length_737_cov_11.835423	211	291	0	80	80	1.0000000
NODE_14727_length_737_cov_11.835423	264	344	0	80	80	1.0000000
NODE_14729_length_737_cov_6.782132	488	548	0	60	60	1.0000000
NODE_14732_length_737_cov_6.089342	241	321	0	1	80	0.0125000
NODE_14732_length_737_cov_6.089342	241	321	2	13	80	0.1625000
NODE_14732_length_737_cov_6.089342	241	321	4	66	80	0.8250000
NODE_14732_length_737_cov_6.089342	294	374	0	54	80	0.6750000
NODE_14732_length_737_cov_6.089342	294	374	2	13	80	0.1625000
NODE_14732_length_737_cov_6.089342	294	374	4	13	80	0.1625000
NODE_14747_length_737_cov_2.548589	386	416	0	30	30	1.0000000
NODE_14781_length_736_cov_46.601256	226	306	0	23	80	0.2875000
NODE_14781_length_736_cov_46.601256	226	306	2	33	80	0.4125000
NODE_14781_length_736_cov_46.601256	226	306	8	24	80	0.3000000
NODE_14781_length_736_cov_46.601256	279	359	2	3	80	0.0375000
NODE_14781_length_736_cov_46.601256	279	359	6	11	80	0.1375000
NODE_14781_length_736_cov_46.601256	279	359	8	66	80	0.8250000
NODE_14782_length_736_cov_32.442700	215	295	0	27	80	0.3375000
NODE_14782_length_736_cov_32.442700	215	295	4	53	80	0.6625000
NODE_14782_length_736_cov_32.442700	268	350	0	43	82	0.5243902
NODE_14782_length_736_cov_32.442700	268	350	2	39	82	0.4756097
NODE_14783_length_736_cov_26.364207	220	300	0	80	80	1.0000000
NODE_14783_length_736_cov_26.364207	273	353	0	80	80	1.0000000
NODE_14785_length_736_cov_10.317111	313	393	0	44	80	0.5500000
NODE_14785_length_736_cov_10.317111	313	393	2	36	80	0.4500000
NODE_14785_length_736_cov_10.317111	366	446	0	10	80	0.1250000
NODE_14785_length_736_cov_10.317111	366	446	2	70	80	0.8750000
NODE_14786_length_736_cov_9.188383	292	372	0	80	80	1.0000000
NODE_14786_length_736_cov_9.188383	345	425	0	80	80	1.0000000
NODE_14787_length_736_cov_8.149137	315	391	0	25	76	0.3289474
NODE_14787_length_736_cov_8.149137	315	391	2	51	76	0.6710526
NODE_14787_length_736_cov_8.149137	365	445	0	79	80	0.9875000
NODE_14787_length_736_cov_8.149137	365	445	2	1	80	0.0125000
NODE_14788_length_736_cov_8.103611	295	375	0	80	80	1.0000000
NODE_14788_length_736_cov_8.103611	348	428	0	80	80	1.0000000
NODE_14789_length_736_cov_7.513344	239	319	0	66	80	0.8250000
NODE_14789_length_736_cov_7.513344	239	319	2	14	80	0.1750000
NODE_14789_length_736_cov_7.513344	292	372	0	80	80	1.0000000
NODE_14792_length_736_cov_5.967033	253	333	0	80	80	1.0000000
NODE_14792_length_736_cov_5.967033	306	386	0	75	80	0.9375000
NODE_14792_length_736_cov_5.967033	306	386	2	5	80	0.0625000
NODE_14795_length_736_cov_4.908948	258	338	0	80	80	1.0000000
NODE_14795_length_736_cov_4.908948	311	391	0	80	80	1.0000000
NODE_14825_length_735_cov_21.099057	265	345	0	80	80	1.0000000
NODE_14825_length_735_cov_21.099057	318	398	0	80	80	1.0000000
NODE_14826_length_735_cov_16.696541	190	270	0	80	80	1.0000000
NODE_14826_length_735_cov_16.696541	243	323	0	70	80	0.8750000
NODE_14826_length_735_cov_16.696541	243	323	2	10	80	0.1250000
NODE_14826_length_735_cov_16.696541	479	538	0	33	59	0.5593221
NODE_14826_length_735_cov_16.696541	479	538	2	9	59	0.1525424
NODE_14826_length_735_cov_16.696541	479	538	4	17	59	0.2881356
NODE_14827_length_735_cov_13.143082	231	311	0	13	80	0.1625000
NODE_14827_length_735_cov_13.143082	231	311	2	67	80	0.8375000
NODE_14827_length_735_cov_13.143082	284	364	0	17	80	0.2125000
NODE_14827_length_735_cov_13.143082	284	364	2	63	80	0.7875000
NODE_14828_length_735_cov_12.415094	434	514	0	80	80	1.0000000
NODE_14828_length_735_cov_12.415094	487	567	0	80	80	1.0000000
NODE_14836_length_735_cov_5.603774	326	394	0	68	68	1.0000000
NODE_14836_length_735_cov_5.603774	367	409	0	42	42	1.0000000
NODE_14880_length_734_cov_26.787402	209	289	4	5	80	0.0625000
NODE_14880_length_734_cov_26.787402	209	289	8	4	80	0.0500000
NODE_14880_length_734_cov_26.787402	209	289	10	2	80	0.0250000
NODE_14880_length_734_cov_26.787402	209	289	12	69	80	0.8625000
NODE_14880_length_734_cov_26.787402	262	342	2	7	80	0.0875000
NODE_14880_length_734_cov_26.787402	262	342	8	11	80	0.1375000
NODE_14880_length_734_cov_26.787402	262	342	10	41	80	0.5125000
NODE_14880_length_734_cov_26.787402	262	342	12	21	80	0.2625000
NODE_14881_length_734_cov_23.214173	200	280	0	80	80	1.0000000
NODE_14881_length_734_cov_23.214173	253	333	0	80	80	1.0000000
NODE_14883_length_734_cov_21.645669	245	325	0	80	80	1.0000000
NODE_14883_length_734_cov_21.645669	298	378	0	80	80	1.0000000
NODE_14884_length_734_cov_14.393701	249	329	0	41	80	0.5125000
NODE_14884_length_734_cov_14.393701	249	329	2	34	80	0.4250000
NODE_14884_length_734_cov_14.393701	249	329	3	1	80	0.0125000
NODE_14884_length_734_cov_14.393701	249	329	4	4	80	0.0500000
NODE_14884_length_734_cov_14.393701	302	382	2	22	80	0.2750000
NODE_14884_length_734_cov_14.393701	302	382	3	1	80	0.0125000
NODE_14884_length_734_cov_14.393701	302	382	4	57	80	0.7125000
NODE_14885_length_734_cov_11.324409	133	196	4	47	63	0.7460318
NODE_14885_length_734_cov_11.324409	133	196	8	16	63	0.2539683
NODE_14885_length_734_cov_11.324409	169	229	4	60	60	1.0000000
NODE_14886_length_734_cov_10.872441	302	331	0	16	29	0.5517241
NODE_14886_length_734_cov_10.872441	302	331	2	8	29	0.2758621
NODE_14886_length_734_cov_10.872441	302	331	3	5	29	0.1724138
NODE_14890_length_734_cov_6.352756	371	451	0	47	80	0.5875000
NODE_14890_length_734_cov_6.352756	371	451	2	13	80	0.1625000
NODE_14890_length_734_cov_6.352756	371	451	4	1	80	0.0125000
NODE_14890_length_734_cov_6.352756	371	451	5	1	80	0.0125000
NODE_14890_length_734_cov_6.352756	371	451	6	18	80	0.2250000
NODE_14890_length_734_cov_6.352756	424	504	2	7	80	0.0875000
NODE_14890_length_734_cov_6.352756	424	504	4	12	80	0.1500000
NODE_14890_length_734_cov_6.352756	424	504	5	1	80	0.0125000
NODE_14890_length_734_cov_6.352756	424	504	6	60	80	0.7500000
NODE_14896_length_734_cov_2.705512	231	302	0	71	71	1.0000000
NODE_14934_length_733_cov_35.041009	268	348	2	80	80	1.0000000
NODE_14934_length_733_cov_35.041009	321	402	0	54	81	0.6666667
NODE_14934_length_733_cov_35.041009	321	402	2	27	81	0.3333333
NODE_14935_length_733_cov_29.810726	28	108	0	80	80	1.0000000
NODE_14935_length_733_cov_29.810726	81	161	0	80	80	1.0000000
NODE_14935_length_733_cov_29.810726	157	237	0	12	80	0.1500000
NODE_14935_length_733_cov_29.810726	157	237	7	16	80	0.2000000
NODE_14935_length_733_cov_29.810726	157	237	8	1	80	0.0125000
NODE_14935_length_733_cov_29.810726	157	237	13	1	80	0.0125000
NODE_14935_length_733_cov_29.810726	157	237	14	19	80	0.2375000
NODE_14935_length_733_cov_29.810726	157	237	20	31	80	0.3875000
NODE_14935_length_733_cov_29.810726	210	290	20	80	80	1.0000000
NODE_14936_length_733_cov_13.738170	333	413	0	30	80	0.3750000
NODE_14936_length_733_cov_13.738170	333	413	4	50	80	0.6250000
NODE_14936_length_733_cov_13.738170	386	466	0	8	80	0.1000000
NODE_14936_length_733_cov_13.738170	386	466	4	72	80	0.9000000
NODE_14937_length_733_cov_11.471609	314	389	0	75	75	1.0000000
NODE_14938_length_733_cov_11.321767	245	325	0	80	80	1.0000000
NODE_14938_length_733_cov_11.321767	298	378	0	80	80	1.0000000
NODE_14940_length_733_cov_8.481073	318	395	0	77	77	1.0000000
NODE_14940_length_733_cov_8.481073	371	451	0	77	80	0.9625000
NODE_14940_length_733_cov_8.481073	371	451	2	3	80	0.0375000
NODE_14944_length_733_cov_5.485804	659	715	12	5	56	0.0892857
NODE_14944_length_733_cov_5.485804	659	715	14	1	56	0.0178571
NODE_14944_length_733_cov_5.485804	659	715	15	9	56	0.1607143
NODE_14944_length_733_cov_5.485804	659	715	17	32	56	0.5714286
NODE_14944_length_733_cov_5.485804	659	715	21	5	56	0.0892857
NODE_14944_length_733_cov_5.485804	659	715	22	4	56	0.0714286
NODE_14944_length_733_cov_5.485804	696	733	4	3	37	0.0810811
NODE_14944_length_733_cov_5.485804	696	733	6	1	37	0.0270270
NODE_14944_length_733_cov_5.485804	696	733	8	6	37	0.1621622
NODE_14944_length_733_cov_5.485804	696	733	10	2	37	0.0540541
NODE_14944_length_733_cov_5.485804	696	733	12	11	37	0.2972973
NODE_14944_length_733_cov_5.485804	696	733	14	1	37	0.0270270
NODE_14944_length_733_cov_5.485804	696	733	15	9	37	0.2432432
NODE_14944_length_733_cov_5.485804	696	733	17	4	37	0.1081081
NODE_14957_length_733_cov_2.272871	312	392	0	80	80	1.0000000
NODE_14957_length_733_cov_2.272871	365	445	0	80	80	1.0000000
NODE_14975_length_732_cov_19.519747	229	309	0	69	80	0.8625000
NODE_14975_length_732_cov_19.519747	229	309	4	11	80	0.1375000
NODE_14975_length_732_cov_19.519747	282	362	0	16	80	0.2000000
NODE_14975_length_732_cov_19.519747	282	362	4	64	80	0.8000000
NODE_14976_length_732_cov_10.846761	247	327	0	80	80	1.0000000
NODE_14976_length_732_cov_10.846761	300	380	0	80	80	1.0000000
NODE_14977_length_732_cov_9.807267	276	356	0	80	80	1.0000000
NODE_14977_length_732_cov_9.807267	329	409	0	80	80	1.0000000
NODE_14978_length_732_cov_8.053712	415	495	0	80	80	1.0000000
NODE_14978_length_732_cov_8.053712	468	548	0	80	80	1.0000000
NODE_14980_length_732_cov_5.194313	319	399	0	80	80	1.0000000
NODE_14980_length_732_cov_5.194313	372	452	0	80	80	1.0000000
NODE_14981_length_732_cov_4.998420	293	373	0	80	80	1.0000000
NODE_14981_length_732_cov_4.998420	346	426	0	80	80	1.0000000
NODE_14983_length_732_cov_4.758294	483	524	0	41	41	1.0000000
NODE_15021_length_731_cov_36.123418	464	544	3	8	80	0.1000000
NODE_15021_length_731_cov_36.123418	464	544	5	22	80	0.2750000
NODE_15021_length_731_cov_36.123418	464	544	8	50	80	0.6250000
NODE_15021_length_731_cov_36.123418	517	597	0	26	80	0.3250000
NODE_15021_length_731_cov_36.123418	517	597	3	35	80	0.4375000
NODE_15021_length_731_cov_36.123418	517	597	5	19	80	0.2375000
NODE_15022_length_731_cov_27.721519	294	374	0	43	80	0.5375000
NODE_15022_length_731_cov_27.721519	294	374	1	1	80	0.0125000
NODE_15022_length_731_cov_27.721519	294	374	2	36	80	0.4500000
NODE_15022_length_731_cov_27.721519	347	427	0	26	80	0.3250000
NODE_15022_length_731_cov_27.721519	347	427	2	54	80	0.6750000
NODE_15023_length_731_cov_19.655063	394	474	0	25	80	0.3125000
NODE_15023_length_731_cov_19.655063	394	474	2	55	80	0.6875000
NODE_15023_length_731_cov_19.655063	447	527	0	20	80	0.2500000
NODE_15023_length_731_cov_19.655063	447	527	2	60	80	0.7500000
NODE_15024_length_731_cov_16.346519	429	509	0	71	80	0.8875000
NODE_15024_length_731_cov_16.346519	429	509	2	9	80	0.1125000
NODE_15024_length_731_cov_16.346519	482	562	0	18	80	0.2250000
NODE_15024_length_731_cov_16.346519	482	562	2	62	80	0.7750000
NODE_15025_length_731_cov_13.892405	321	401	0	80	80	1.0000000
NODE_15025_length_731_cov_13.892405	374	454	0	80	80	1.0000000
NODE_15027_length_731_cov_8.800633	218	298	0	6	80	0.0750000
NODE_15027_length_731_cov_8.800633	218	298	2	74	80	0.9250000
NODE_15027_length_731_cov_8.800633	271	352	0	60	81	0.7407407
NODE_15027_length_731_cov_8.800633	271	352	2	21	81	0.2592593
NODE_15028_length_731_cov_7.658228	335	406	0	30	71	0.4225352
NODE_15028_length_731_cov_7.658228	335	406	1	5	71	0.0704225
NODE_15028_length_731_cov_7.658228	335	406	2	16	71	0.2253521
NODE_15028_length_731_cov_7.658228	335	406	4	20	71	0.2816902
NODE_15028_length_731_cov_7.658228	387	468	2	21	81	0.2592593
NODE_15028_length_731_cov_7.658228	387	468	4	60	81	0.7407407
NODE_15031_length_731_cov_5.471519	261	341	0	80	80	1.0000000
NODE_15031_length_731_cov_5.471519	314	394	0	80	80	1.0000000
NODE_15034_length_731_cov_4.083861	361	441	0	80	80	1.0000000
NODE_15034_length_731_cov_4.083861	458	482	0	24	24	1.0000000
NODE_15050_length_731_cov_2.226266	466	548	0	35	82	0.4268293
NODE_15050_length_731_cov_2.226266	466	548	1	47	82	0.5731707
NODE_15077_length_730_cov_51.556260	349	429	4	18	80	0.2250000
NODE_15077_length_730_cov_51.556260	349	429	6	25	80	0.3125000
NODE_15077_length_730_cov_51.556260	349	429	8	37	80	0.4625000
NODE_15077_length_730_cov_51.556260	402	482	0	51	80	0.6375000
NODE_15077_length_730_cov_51.556260	402	482	4	20	80	0.2500000
NODE_15077_length_730_cov_51.556260	402	482	6	9	80	0.1125000
NODE_15078_length_730_cov_39.862124	370	450	0	59	80	0.7375000
NODE_15078_length_730_cov_39.862124	370	450	2	21	80	0.2625000
NODE_15078_length_730_cov_39.862124	423	503	0	12	80	0.1500000
NODE_15078_length_730_cov_39.862124	423	503	2	68	80	0.8500000
NODE_15079_length_730_cov_15.801902	261	341	0	1	80	0.0125000
NODE_15079_length_730_cov_15.801902	261	341	2	24	80	0.3000000
NODE_15079_length_730_cov_15.801902	261	341	4	1	80	0.0125000
NODE_15079_length_730_cov_15.801902	261	341	5	16	80	0.2000000
NODE_15079_length_730_cov_15.801902	261	341	7	3	80	0.0375000
NODE_15079_length_730_cov_15.801902	261	341	9	21	80	0.2625000
NODE_15079_length_730_cov_15.801902	261	341	13	14	80	0.1750000
NODE_15079_length_730_cov_15.801902	314	394	9	13	80	0.1625000
NODE_15079_length_730_cov_15.801902	314	394	11	37	80	0.4625000
NODE_15079_length_730_cov_15.801902	314	394	13	30	80	0.3750000
NODE_15080_length_730_cov_11.746434	242	322	2	80	80	1.0000000
NODE_15080_length_730_cov_11.746434	295	375	0	47	80	0.5875000
NODE_15080_length_730_cov_11.746434	295	375	2	33	80	0.4125000
NODE_15081_length_730_cov_9.209192	358	438	0	14	80	0.1750000
NODE_15081_length_730_cov_9.209192	358	438	2	13	80	0.1625000
NODE_15081_length_730_cov_9.209192	358	438	4	53	80	0.6625000
NODE_15081_length_730_cov_9.209192	411	483	0	26	72	0.3611111
NODE_15081_length_730_cov_9.209192	411	483	2	18	72	0.2500000
NODE_15081_length_730_cov_9.209192	411	483	4	28	72	0.3888889
NODE_15131_length_729_cov_44.188889	418	498	0	11	80	0.1375000
NODE_15131_length_729_cov_44.188889	418	498	4	53	80	0.6625000
NODE_15131_length_729_cov_44.188889	418	498	5	1	80	0.0125000
NODE_15131_length_729_cov_44.188889	418	498	6	15	80	0.1875000
NODE_15131_length_729_cov_44.188889	471	551	0	13	80	0.1625000
NODE_15131_length_729_cov_44.188889	471	551	5	1	80	0.0125000
NODE_15131_length_729_cov_44.188889	471	551	6	66	80	0.8250000
NODE_15132_length_729_cov_40.390476	330	410	0	18	80	0.2250000
NODE_15132_length_729_cov_40.390476	330	410	5	1	80	0.0125000
NODE_15132_length_729_cov_40.390476	330	410	6	8	80	0.1000000
NODE_15132_length_729_cov_40.390476	330	410	12	53	80	0.6625000
NODE_15132_length_729_cov_40.390476	383	463	11	4	80	0.0500000
NODE_15132_length_729_cov_40.390476	383	463	12	28	80	0.3500000
NODE_15132_length_729_cov_40.390476	383	463	15	48	80	0.6000000
NODE_15133_length_729_cov_35.973016	231	311	10	80	80	1.0000000
NODE_15133_length_729_cov_35.973016	284	363	4	11	79	0.1392405
NODE_15133_length_729_cov_35.973016	284	363	10	66	79	0.8354430
NODE_15133_length_729_cov_35.973016	284	363	14	2	79	0.0253165
NODE_15134_length_729_cov_18.357143	170	250	2	80	80	1.0000000
NODE_15134_length_729_cov_18.357143	223	303	0	7	80	0.0875000
NODE_15134_length_729_cov_18.357143	223	303	1	10	80	0.1250000
NODE_15134_length_729_cov_18.357143	223	303	2	63	80	0.7875000
NODE_15135_length_729_cov_17.928571	194	274	0	33	80	0.4125000
NODE_15135_length_729_cov_17.928571	194	274	2	4	80	0.0500000
NODE_15135_length_729_cov_17.928571	194	274	11	14	80	0.1750000
NODE_15135_length_729_cov_17.928571	194	274	14	6	80	0.0750000
NODE_15135_length_729_cov_17.928571	194	274	15	23	80	0.2875000
NODE_15135_length_729_cov_17.928571	247	327	10	8	80	0.1000000
NODE_15135_length_729_cov_17.928571	247	327	14	27	80	0.3375000
NODE_15135_length_729_cov_17.928571	247	327	15	30	80	0.3750000
NODE_15135_length_729_cov_17.928571	247	327	16	15	80	0.1875000
NODE_15136_length_729_cov_17.373016	369	449	0	80	80	1.0000000
NODE_15136_length_729_cov_17.373016	422	502	0	80	80	1.0000000
NODE_15137_length_729_cov_12.452381	347	427	0	80	80	1.0000000
NODE_15137_length_729_cov_12.452381	400	480	0	80	80	1.0000000
NODE_15138_length_729_cov_10.388889	296	376	0	80	80	1.0000000
NODE_15138_length_729_cov_10.388889	349	429	0	80	80	1.0000000
NODE_15185_length_728_cov_23.503975	338	418	0	80	80	1.0000000
NODE_15185_length_728_cov_23.503975	391	471	0	80	80	1.0000000
NODE_15186_length_728_cov_22.496025	310	390	2	19	80	0.2375000
NODE_15186_length_728_cov_22.496025	310	390	4	61	80	0.7625000
NODE_15186_length_728_cov_22.496025	363	443	0	29	80	0.3625000
NODE_15186_length_728_cov_22.496025	363	443	1	4	80	0.0500000
NODE_15186_length_728_cov_22.496025	363	443	3	3	80	0.0375000
NODE_15186_length_728_cov_22.496025	363	443	4	44	80	0.5500000
NODE_15187_length_728_cov_16.596184	257	337	0	80	80	1.0000000
NODE_15187_length_728_cov_16.596184	310	387	0	77	77	1.0000000
NODE_15188_length_728_cov_16.114467	192	272	0	80	80	1.0000000
NODE_15188_length_728_cov_16.114467	245	325	0	80	80	1.0000000
NODE_15189_length_728_cov_15.128776	298	377	0	52	79	0.6582279
NODE_15189_length_728_cov_15.128776	298	377	4	27	79	0.3417721
NODE_15189_length_728_cov_15.128776	350	430	4	80	80	1.0000000
NODE_15190_length_728_cov_10.613672	269	349	0	80	80	1.0000000
NODE_15190_length_728_cov_10.613672	322	402	0	80	80	1.0000000
NODE_15191_length_728_cov_7.613672	408	488	0	80	80	1.0000000
NODE_15191_length_728_cov_7.613672	461	541	0	80	80	1.0000000
NODE_15196_length_728_cov_3.405405	335	415	0	4	80	0.0500000
NODE_15196_length_728_cov_3.405405	335	415	2	65	80	0.8125000
NODE_15196_length_728_cov_3.405405	335	415	4	11	80	0.1375000
NODE_15244_length_727_cov_34.883758	57	137	0	45	80	0.5625000
NODE_15244_length_727_cov_34.883758	57	137	1	6	80	0.0750000
NODE_15244_length_727_cov_34.883758	57	137	2	3	80	0.0375000
NODE_15244_length_727_cov_34.883758	57	137	4	26	80	0.3250000
NODE_15244_length_727_cov_34.883758	57	137	0	45	80	0.5625000
NODE_15244_length_727_cov_34.883758	57	137	1	6	80	0.0750000
NODE_15244_length_727_cov_34.883758	57	137	2	3	80	0.0375000
NODE_15244_length_727_cov_34.883758	57	137	4	26	80	0.3250000
NODE_15244_length_727_cov_34.883758	57	137	0	45	80	0.5625000
NODE_15244_length_727_cov_34.883758	57	137	1	6	80	0.0750000
NODE_15244_length_727_cov_34.883758	57	137	2	3	80	0.0375000
NODE_15244_length_727_cov_34.883758	57	137	4	26	80	0.3250000
NODE_15244_length_727_cov_34.883758	110	190	2	1	80	0.0125000
NODE_15244_length_727_cov_34.883758	110	190	4	79	80	0.9875000
NODE_15244_length_727_cov_34.883758	110	190	2	1	80	0.0125000
NODE_15244_length_727_cov_34.883758	110	190	4	79	80	0.9875000
NODE_15245_length_727_cov_32.025478	275	355	0	80	80	1.0000000
NODE_15245_length_727_cov_32.025478	328	408	0	80	80	1.0000000
NODE_15246_length_727_cov_28.523885	307	381	0	71	74	0.9594595
NODE_15246_length_727_cov_28.523885	307	381	5	3	74	0.0405405
NODE_15246_length_727_cov_28.523885	360	381	0	18	21	0.8571429
NODE_15246_length_727_cov_28.523885	360	381	5	3	21	0.1428571
NODE_15246_length_727_cov_28.523885	378	415	5	37	37	1.0000000
NODE_15247_length_727_cov_25.826433	325	405	0	80	80	1.0000000
NODE_15247_length_727_cov_25.826433	378	458	0	80	80	1.0000000
NODE_15248_length_727_cov_22.253185	150	230	0	39	80	0.4875000
NODE_15248_length_727_cov_22.253185	150	230	2	41	80	0.5125000
NODE_15248_length_727_cov_22.253185	203	283	0	10	80	0.1250000
NODE_15248_length_727_cov_22.253185	203	283	2	70	80	0.8750000
NODE_15249_length_727_cov_18.972930	263	343	2	19	80	0.2375000
NODE_15249_length_727_cov_18.972930	263	343	4	1	80	0.0125000
NODE_15249_length_727_cov_18.972930	263	343	6	60	80	0.7500000
NODE_15249_length_727_cov_18.972930	316	396	0	10	80	0.1250000
NODE_15249_length_727_cov_18.972930	316	396	2	14	80	0.1750000
NODE_15249_length_727_cov_18.972930	316	396	4	8	80	0.1000000
NODE_15249_length_727_cov_18.972930	316	396	6	48	80	0.6000000
NODE_15250_length_727_cov_15.531847	269	349	0	6	80	0.0750000
NODE_15250_length_727_cov_15.531847	269	349	4	74	80	0.9250000
NODE_15250_length_727_cov_15.531847	322	402	0	59	80	0.7375000
NODE_15250_length_727_cov_15.531847	322	402	4	21	80	0.2625000
NODE_15252_length_727_cov_10.178344	280	360	0	58	80	0.7250000
NODE_15252_length_727_cov_10.178344	280	360	2	22	80	0.2750000
NODE_15252_length_727_cov_10.178344	333	413	0	5	80	0.0625000
NODE_15252_length_727_cov_10.178344	333	413	2	75	80	0.9375000
NODE_15258_length_727_cov_4.955414	360	440	0	80	80	1.0000000
NODE_15258_length_727_cov_4.955414	413	493	0	80	80	1.0000000
NODE_15287_length_726_cov_52.923445	415	495	9	58	80	0.7250000
NODE_15287_length_726_cov_52.923445	415	495	11	15	80	0.1875000
NODE_15287_length_726_cov_52.923445	415	495	12	5	80	0.0625000
NODE_15287_length_726_cov_52.923445	415	495	14	2	80	0.0250000
NODE_15287_length_726_cov_52.923445	468	548	4	17	80	0.2125000
NODE_15287_length_726_cov_52.923445	468	548	9	5	80	0.0625000
NODE_15287_length_726_cov_52.923445	468	548	11	15	80	0.1875000
NODE_15287_length_726_cov_52.923445	468	548	12	5	80	0.0625000
NODE_15287_length_726_cov_52.923445	468	548	13	2	80	0.0250000
NODE_15287_length_726_cov_52.923445	468	548	14	36	80	0.4500000
NODE_15288_length_726_cov_35.896332	108	188	2	80	80	1.0000000
NODE_15288_length_726_cov_35.896332	161	241	0	38	80	0.4750000
NODE_15288_length_726_cov_35.896332	161	241	2	42	80	0.5250000
NODE_15288_length_726_cov_35.896332	237	317	2	7	80	0.0875000
NODE_15288_length_726_cov_35.896332	237	317	3	13	80	0.1625000
NODE_15288_length_726_cov_35.896332	237	317	4	60	80	0.7500000
NODE_15288_length_726_cov_35.896332	290	370	4	80	80	1.0000000
NODE_15291_length_726_cov_8.534290	355	435	0	80	80	1.0000000
NODE_15291_length_726_cov_8.534290	408	488	0	80	80	1.0000000
NODE_15330_length_725_cov_40.856230	203	283	0	80	80	1.0000000
NODE_15330_length_725_cov_40.856230	256	336	0	80	80	1.0000000
NODE_15330_length_725_cov_40.856230	332	412	0	61	80	0.7625000
NODE_15330_length_725_cov_40.856230	332	412	8	19	80	0.2375000
NODE_15330_length_725_cov_40.856230	385	465	0	8	80	0.1000000
NODE_15330_length_725_cov_40.856230	385	465	8	40	80	0.5000000
NODE_15330_length_725_cov_40.856230	385	465	10	12	80	0.1500000
NODE_15330_length_725_cov_40.856230	385	465	12	20	80	0.2500000
NODE_15331_length_725_cov_25.036741	366	446	0	80	80	1.0000000
NODE_15331_length_725_cov_25.036741	419	499	0	80	80	1.0000000
NODE_15332_length_725_cov_23.009585	455	536	4	81	81	1.0000000
NODE_15333_length_725_cov_20.474441	112	192	0	39	80	0.4875000
NODE_15333_length_725_cov_20.474441	112	192	2	41	80	0.5125000
NODE_15333_length_725_cov_20.474441	165	245	2	80	80	1.0000000
NODE_15334_length_725_cov_15.455272	106	186	0	80	80	1.0000000
NODE_15334_length_725_cov_15.455272	159	239	0	80	80	1.0000000
NODE_15334_length_725_cov_15.455272	235	315	0	80	80	1.0000000
NODE_15334_length_725_cov_15.455272	288	368	0	80	80	1.0000000
NODE_15335_length_725_cov_10.426518	289	369	0	39	80	0.4875000
NODE_15335_length_725_cov_10.426518	289	369	2	41	80	0.5125000
NODE_15335_length_725_cov_10.426518	342	422	2	80	80	1.0000000
NODE_15337_length_725_cov_7.781150	189	269	0	80	80	1.0000000
NODE_15337_length_725_cov_7.781150	242	322	0	80	80	1.0000000
NODE_15388_length_724_cov_28.132800	354	434	0	47	80	0.5875000
NODE_15388_length_724_cov_28.132800	354	434	2	33	80	0.4125000
NODE_15388_length_724_cov_28.132800	407	473	2	66	66	1.0000000
NODE_15389_length_724_cov_24.710400	376	461	15	25	85	0.2941177
NODE_15389_length_724_cov_24.710400	376	461	16	1	85	0.0117647
NODE_15389_length_724_cov_24.710400	376	461	17	42	85	0.4941176
NODE_15389_length_724_cov_24.710400	376	461	18	17	85	0.2000000
NODE_15389_length_724_cov_24.710400	434	514	0	21	80	0.2625000
NODE_15389_length_724_cov_24.710400	434	514	8	19	80	0.2375000
NODE_15389_length_724_cov_24.710400	434	514	9	1	80	0.0125000
NODE_15389_length_724_cov_24.710400	434	514	13	1	80	0.0125000
NODE_15389_length_724_cov_24.710400	434	514	14	2	80	0.0250000
NODE_15389_length_724_cov_24.710400	434	514	15	34	80	0.4250000
NODE_15389_length_724_cov_24.710400	434	514	16	1	80	0.0125000
NODE_15389_length_724_cov_24.710400	434	514	17	1	80	0.0125000
NODE_15390_length_724_cov_13.960000	152	232	4	50	80	0.6250000
NODE_15390_length_724_cov_13.960000	152	232	6	29	80	0.3625000
NODE_15390_length_724_cov_13.960000	152	232	8	1	80	0.0125000
NODE_15390_length_724_cov_13.960000	205	248	4	43	43	1.0000000
NODE_15390_length_724_cov_13.960000	237	286	0	32	49	0.6530612
NODE_15390_length_724_cov_13.960000	237	286	4	17	49	0.3469388
NODE_15390_length_724_cov_13.960000	259	302	0	43	43	1.0000000
NODE_15390_length_724_cov_13.960000	288	340	0	52	52	1.0000000
NODE_15390_length_724_cov_13.960000	313	393	0	80	80	1.0000000
NODE_15391_length_724_cov_13.065600	215	295	0	80	80	1.0000000
NODE_15391_length_724_cov_13.065600	268	347	0	79	79	1.0000000
NODE_15393_length_724_cov_10.358400	257	337	0	80	80	1.0000000
NODE_15393_length_724_cov_10.358400	310	385	0	75	75	1.0000000
NODE_15396_length_724_cov_6.451200	151	231	0	80	80	1.0000000
NODE_15396_length_724_cov_6.451200	202	282	0	80	80	1.0000000
NODE_15397_length_724_cov_5.921600	165	213	0	48	48	1.0000000
NODE_15399_length_724_cov_5.028800	416	469	0	46	53	0.8679245
NODE_15399_length_724_cov_5.028800	416	469	2	7	53	0.1320755
NODE_15399_length_724_cov_5.028800	488	526	2	38	38	1.0000000
NODE_15403_length_724_cov_3.315200	166	246	0	34	80	0.4250000
NODE_15403_length_724_cov_3.315200	166	246	2	46	80	0.5750000
NODE_15403_length_724_cov_3.315200	219	299	2	70	80	0.8750000
NODE_15403_length_724_cov_3.315200	219	299	4	10	80	0.1250000
NODE_15442_length_723_cov_81.453526	205	285	0	65	80	0.8125000
NODE_15442_length_723_cov_81.453526	205	285	2	1	80	0.0125000
NODE_15442_length_723_cov_81.453526	205	285	4	12	80	0.1500000
NODE_15442_length_723_cov_81.453526	205	285	18	2	80	0.0250000
NODE_15442_length_723_cov_81.453526	258	338	0	12	80	0.1500000
NODE_15442_length_723_cov_81.453526	258	338	2	1	80	0.0125000
NODE_15442_length_723_cov_81.453526	258	338	4	12	80	0.1500000
NODE_15442_length_723_cov_81.453526	258	338	17	28	80	0.3500000
NODE_15442_length_723_cov_81.453526	258	338	18	27	80	0.3375000
NODE_15443_length_723_cov_33.075321	254	329	0	75	75	1.0000000
NODE_15443_length_723_cov_33.075321	307	387	0	80	80	1.0000000
NODE_15444_length_723_cov_25.410256	291	371	0	80	80	1.0000000
NODE_15444_length_723_cov_25.410256	344	424	0	80	80	1.0000000
NODE_15445_length_723_cov_18.097756	233	313	0	80	80	1.0000000
NODE_15445_length_723_cov_18.097756	286	351	0	65	65	1.0000000
NODE_15446_length_723_cov_14.113782	311	391	0	64	80	0.8000000
NODE_15446_length_723_cov_14.113782	311	391	4	16	80	0.2000000
NODE_15446_length_723_cov_14.113782	364	444	0	11	80	0.1375000
NODE_15446_length_723_cov_14.113782	364	444	4	69	80	0.8625000
NODE_15447_length_723_cov_11.634615	299	379	0	80	80	1.0000000
NODE_15447_length_723_cov_11.634615	352	432	0	80	80	1.0000000
NODE_15448_length_723_cov_8.342949	357	437	0	80	80	1.0000000
NODE_15448_length_723_cov_8.342949	410	490	0	80	80	1.0000000
NODE_15455_length_723_cov_2.711538	379	422	0	43	43	1.0000000
NODE_15459_length_723_cov_2.573718	383	413	8	30	30	1.0000000
NODE_15495_length_722_cov_19.182986	180	260	0	8	80	0.1000000
NODE_15495_length_722_cov_19.182986	180	260	4	19	80	0.2375000
NODE_15495_length_722_cov_19.182986	180	260	6	53	80	0.6625000
NODE_15495_length_722_cov_19.182986	233	313	4	9	80	0.1125000
NODE_15495_length_722_cov_19.182986	233	313	6	56	80	0.7000000
NODE_15495_length_722_cov_19.182986	233	313	10	15	80	0.1875000
NODE_15496_length_722_cov_13.582665	192	272	0	80	80	1.0000000
NODE_15496_length_722_cov_13.582665	245	326	0	81	81	1.0000000
NODE_15497_length_722_cov_9.202247	347	427	0	80	80	1.0000000
NODE_15497_length_722_cov_9.202247	400	480	0	80	80	1.0000000
NODE_15500_length_722_cov_6.707865	343	423	2	41	80	0.5125000
NODE_15500_length_722_cov_6.707865	343	423	4	39	80	0.4875000
NODE_15500_length_722_cov_6.707865	396	476	0	5	80	0.0625000
NODE_15500_length_722_cov_6.707865	396	476	2	47	80	0.5875000
NODE_15500_length_722_cov_6.707865	396	476	4	28	80	0.3500000
NODE_15504_length_722_cov_4.985554	332	393	0	61	61	1.0000000
NODE_15508_length_722_cov_3.977528	217	297	0	80	80	1.0000000
NODE_15508_length_722_cov_3.977528	270	350	0	80	80	1.0000000
NODE_15553_length_721_cov_105.927653	425	505	0	80	80	1.0000000
NODE_15553_length_721_cov_105.927653	478	558	0	70	80	0.8750000
NODE_15553_length_721_cov_105.927653	478	558	2	10	80	0.1250000
NODE_15554_length_721_cov_49.660772	304	384	0	80	80	1.0000000
NODE_15554_length_721_cov_49.660772	357	437	0	80	80	1.0000000
NODE_15555_length_721_cov_46.991961	341	421	0	64	80	0.8000000
NODE_15555_length_721_cov_46.991961	341	421	4	16	80	0.2000000
NODE_15555_length_721_cov_46.991961	394	474	0	15	80	0.1875000
NODE_15555_length_721_cov_46.991961	394	474	4	65	80	0.8125000
NODE_15556_length_721_cov_38.864952	208	288	0	80	80	1.0000000
NODE_15556_length_721_cov_38.864952	269	341	0	72	72	1.0000000
NODE_15556_length_721_cov_38.864952	337	417	0	80	80	1.0000000
NODE_15556_length_721_cov_38.864952	390	467	0	77	77	1.0000000
NODE_15557_length_721_cov_29.016077	192	272	0	80	80	1.0000000
NODE_15557_length_721_cov_29.016077	251	325	0	74	74	1.0000000
NODE_15558_length_721_cov_26.196141	398	478	0	32	80	0.4000000
NODE_15558_length_721_cov_26.196141	398	478	2	48	80	0.6000000
NODE_15558_length_721_cov_26.196141	451	531	0	18	80	0.2250000
NODE_15558_length_721_cov_26.196141	451	531	2	62	80	0.7750000
NODE_15560_length_721_cov_20.054662	178	258	0	58	80	0.7250000
NODE_15560_length_721_cov_20.054662	178	258	2	22	80	0.2750000
NODE_15560_length_721_cov_20.054662	231	311	0	11	80	0.1375000
NODE_15560_length_721_cov_20.054662	231	311	2	69	80	0.8625000
NODE_15561_length_721_cov_13.670418	263	343	0	5	80	0.0625000
NODE_15561_length_721_cov_13.670418	263	343	4	75	80	0.9375000
NODE_15561_length_721_cov_13.670418	316	396	0	58	80	0.7250000
NODE_15561_length_721_cov_13.670418	316	396	4	22	80	0.2750000
NODE_15562_length_721_cov_13.652733	268	350	2	64	82	0.7804878
NODE_15562_length_721_cov_13.652733	268	350	4	18	82	0.2195122
NODE_15562_length_721_cov_13.652733	321	403	2	75	82	0.9146342
NODE_15562_length_721_cov_13.652733	321	403	4	7	82	0.0853659
NODE_15563_length_721_cov_13.120579	312	392	0	40	80	0.5000000
NODE_15563_length_721_cov_13.120579	312	392	2	5	80	0.0625000
NODE_15563_length_721_cov_13.120579	312	392	6	15	80	0.1875000
NODE_15563_length_721_cov_13.120579	312	392	8	20	80	0.2500000
NODE_15563_length_721_cov_13.120579	365	445	6	7	80	0.0875000
NODE_15563_length_721_cov_13.120579	365	445	8	73	80	0.9125000
NODE_15572_length_721_cov_4.491961	210	280	0	40	70	0.5714286
NODE_15572_length_721_cov_4.491961	210	280	5	1	70	0.0142857
NODE_15572_length_721_cov_4.491961	210	280	6	29	70	0.4142857
NODE_15572_length_721_cov_4.491961	253	333	6	69	80	0.8625000
NODE_15572_length_721_cov_4.491961	253	333	8	11	80	0.1375000
NODE_15572_length_721_cov_4.491961	470	521	0	51	51	1.0000000
NODE_15608_length_720_cov_17.449275	267	347	0	60	80	0.7500000
NODE_15608_length_720_cov_17.449275	267	347	2	20	80	0.2500000
NODE_15608_length_720_cov_17.449275	320	400	0	80	80	1.0000000
NODE_15609_length_720_cov_14.814815	261	341	0	22	80	0.2750000
NODE_15609_length_720_cov_14.814815	261	341	2	23	80	0.2875000
NODE_15609_length_720_cov_14.814815	261	341	4	35	80	0.4375000
NODE_15609_length_720_cov_14.814815	314	394	0	75	80	0.9375000
NODE_15609_length_720_cov_14.814815	314	394	2	5	80	0.0625000
NODE_15610_length_720_cov_14.107890	290	370	0	80	80	1.0000000
NODE_15610_length_720_cov_14.107890	343	423	0	80	80	1.0000000
NODE_15612_length_720_cov_12.924316	314	394	0	13	80	0.1625000
NODE_15612_length_720_cov_12.924316	314	394	2	40	80	0.5000000
NODE_15612_length_720_cov_12.924316	314	394	4	27	80	0.3375000
NODE_15612_length_720_cov_12.924316	367	447	2	17	80	0.2125000
NODE_15612_length_720_cov_12.924316	367	447	4	63	80	0.7875000
NODE_15614_length_720_cov_10.389694	435	515	0	80	80	1.0000000
NODE_15614_length_720_cov_10.389694	488	568	0	80	80	1.0000000
NODE_15620_length_720_cov_5.278583	309	389	0	2	80	0.0250000
NODE_15620_length_720_cov_5.278583	309	389	6	78	80	0.9750000
NODE_15620_length_720_cov_5.278583	362	442	0	7	80	0.0875000
NODE_15620_length_720_cov_5.278583	362	442	6	73	80	0.9125000
NODE_15624_length_720_cov_3.792271	157	235	0	5	78	0.0641026
NODE_15624_length_720_cov_3.792271	157	235	2	73	78	0.9358974
NODE_15624_length_720_cov_3.792271	215	265	0	16	50	0.3200000
NODE_15624_length_720_cov_3.792271	215	265	2	34	50	0.6800000
NODE_15658_length_719_cov_30.256452	279	359	0	38	80	0.4750000
NODE_15658_length_719_cov_30.256452	279	359	2	42	80	0.5250000
NODE_15658_length_719_cov_30.256452	332	412	0	71	80	0.8875000
NODE_15658_length_719_cov_30.256452	332	412	2	9	80	0.1125000
NODE_15659_length_719_cov_29.093548	310	390	0	25	80	0.3125000
NODE_15659_length_719_cov_29.093548	310	390	2	55	80	0.6875000
NODE_15659_length_719_cov_29.093548	363	443	0	31	80	0.3875000
NODE_15659_length_719_cov_29.093548	363	443	2	49	80	0.6125000
NODE_15660_length_719_cov_10.988710	195	275	0	46	80	0.5750000
NODE_15660_length_719_cov_10.988710	195	275	2	14	80	0.1750000
NODE_15660_length_719_cov_10.988710	195	275	4	20	80	0.2500000
NODE_15660_length_719_cov_10.988710	248	328	0	6	80	0.0750000
NODE_15660_length_719_cov_10.988710	248	328	2	1	80	0.0125000
NODE_15660_length_719_cov_10.988710	248	328	4	73	80	0.9125000
NODE_15661_length_719_cov_10.837097	259	339	0	80	80	1.0000000
NODE_15661_length_719_cov_10.837097	312	392	0	80	80	1.0000000
NODE_15662_length_719_cov_7.622581	288	368	0	80	80	1.0000000
NODE_15662_length_719_cov_7.622581	341	421	0	80	80	1.0000000
NODE_15663_length_719_cov_7.570968	351	431	0	80	80	1.0000000
NODE_15663_length_719_cov_7.570968	404	484	0	80	80	1.0000000
NODE_15672_length_719_cov_4.264516	251	281	0	10	30	0.3333333
NODE_15672_length_719_cov_4.264516	251	281	2	20	30	0.6666667
NODE_15684_length_719_cov_1.629032	88	163	6	3	75	0.0400000
NODE_15684_length_719_cov_1.629032	88	163	8	3	75	0.0400000
NODE_15684_length_719_cov_1.629032	88	163	9	20	75	0.2666667
NODE_15684_length_719_cov_1.629032	88	163	10	40	75	0.5333334
NODE_15684_length_719_cov_1.629032	88	163	11	9	75	0.1200000
NODE_15706_length_718_cov_35.382876	296	376	0	80	80	1.0000000
NODE_15706_length_718_cov_35.382876	296	376	0	80	80	1.0000000
NODE_15706_length_718_cov_35.382876	349	429	0	80	80	1.0000000
NODE_15706_length_718_cov_35.382876	349	429	0	80	80	1.0000000
NODE_15707_length_718_cov_24.211632	313	393	0	80	80	1.0000000
NODE_15707_length_718_cov_24.211632	366	446	0	80	80	1.0000000
NODE_15708_length_718_cov_18.300485	217	297	0	30	80	0.3750000
NODE_15708_length_718_cov_18.300485	217	297	2	50	80	0.6250000
NODE_15708_length_718_cov_18.300485	270	350	0	27	80	0.3375000
NODE_15708_length_718_cov_18.300485	270	350	2	53	80	0.6625000
NODE_15709_length_718_cov_14.757674	383	463	0	80	80	1.0000000
NODE_15709_length_718_cov_14.757674	436	516	0	80	80	1.0000000
NODE_15710_length_718_cov_14.355412	254	334	1	15	80	0.1875000
NODE_15710_length_718_cov_14.355412	254	334	2	53	80	0.6625000
NODE_15710_length_718_cov_14.355412	254	334	3	12	80	0.1500000
NODE_15710_length_718_cov_14.355412	307	387	1	15	80	0.1875000
NODE_15710_length_718_cov_14.355412	307	387	2	13	80	0.1625000
NODE_15710_length_718_cov_14.355412	307	387	3	19	80	0.2375000
NODE_15710_length_718_cov_14.355412	307	387	4	33	80	0.4125000
NODE_15715_length_718_cov_4.804523	263	343	0	80	80	1.0000000
NODE_15715_length_718_cov_4.804523	316	396	0	80	80	1.0000000
NODE_15750_length_717_cov_28.377023	335	415	0	3	80	0.0375000
NODE_15750_length_717_cov_28.377023	335	415	4	77	80	0.9625000
NODE_15750_length_717_cov_28.377023	388	468	0	56	80	0.7000000
NODE_15750_length_717_cov_28.377023	388	468	4	24	80	0.3000000
NODE_15751_length_717_cov_23.275081	162	242	0	13	80	0.1625000
NODE_15751_length_717_cov_23.275081	162	242	2	67	80	0.8375000
NODE_15751_length_717_cov_23.275081	215	295	0	30	80	0.3750000
NODE_15751_length_717_cov_23.275081	215	295	2	50	80	0.6250000
NODE_15752_length_717_cov_18.564725	319	399	0	80	80	1.0000000
NODE_15752_length_717_cov_18.564725	372	452	0	80	80	1.0000000
NODE_15753_length_717_cov_18.389968	358	438	0	80	80	1.0000000
NODE_15753_length_717_cov_18.389968	411	491	0	80	80	1.0000000
NODE_15754_length_717_cov_17.932039	241	321	0	3	80	0.0375000
NODE_15754_length_717_cov_17.932039	241	321	2	34	80	0.4250000
NODE_15754_length_717_cov_17.932039	241	321	4	35	80	0.4375000
NODE_15754_length_717_cov_17.932039	241	321	6	3	80	0.0375000
NODE_15754_length_717_cov_17.932039	241	321	8	5	80	0.0625000
NODE_15754_length_717_cov_17.932039	294	374	0	56	80	0.7000000
NODE_15754_length_717_cov_17.932039	294	374	2	24	80	0.3000000
NODE_15755_length_717_cov_14.637540	298	378	0	80	80	1.0000000
NODE_15755_length_717_cov_14.637540	351	431	0	80	80	1.0000000
NODE_15756_length_717_cov_12.279935	113	196	0	83	83	1.0000000
NODE_15756_length_717_cov_12.279935	169	249	0	80	80	1.0000000
NODE_15757_length_717_cov_10.711974	353	431	0	3	78	0.0384615
NODE_15757_length_717_cov_10.711974	353	431	4	26	78	0.3333333
NODE_15757_length_717_cov_10.711974	353	431	6	49	78	0.6282051
NODE_15758_length_717_cov_9.399676	331	411	0	80	80	1.0000000
NODE_15758_length_717_cov_9.399676	384	464	0	80	80	1.0000000
NODE_15762_length_717_cov_5.341424	475	555	0	80	80	1.0000000
NODE_15762_length_717_cov_5.341424	528	608	0	80	80	1.0000000
NODE_15770_length_717_cov_3.187702	285	322	0	37	37	1.0000000
NODE_15805_length_716_cov_16.800648	430	510	0	80	80	1.0000000
NODE_15805_length_716_cov_16.800648	483	563	0	80	80	1.0000000
NODE_15806_length_716_cov_12.565640	356	436	0	80	80	1.0000000
NODE_15806_length_716_cov_12.565640	409	489	0	80	80	1.0000000
NODE_15807_length_716_cov_9.277147	385	465	0	80	80	1.0000000
NODE_15807_length_716_cov_9.277147	438	518	0	80	80	1.0000000
NODE_15808_length_716_cov_9.257699	302	382	0	80	80	1.0000000
NODE_15808_length_716_cov_9.257699	355	435	0	80	80	1.0000000
NODE_15809_length_716_cov_6.761750	263	343	0	80	80	1.0000000
NODE_15809_length_716_cov_6.761750	316	396	0	80	80	1.0000000
NODE_15812_length_716_cov_4.909238	236	316	0	80	80	1.0000000
NODE_15812_length_716_cov_4.909238	289	369	0	80	80	1.0000000
NODE_15824_length_716_cov_2.068071	453	481	0	28	28	1.0000000
NODE_15853_length_715_cov_38.795455	260	340	2	11	80	0.1375000
NODE_15853_length_715_cov_38.795455	260	340	6	25	80	0.3125000
NODE_15853_length_715_cov_38.795455	260	340	8	44	80	0.5500000
NODE_15853_length_715_cov_38.795455	313	393	2	6	80	0.0750000
NODE_15853_length_715_cov_38.795455	313	393	4	46	80	0.5750000
NODE_15853_length_715_cov_38.795455	313	393	6	3	80	0.0375000
NODE_15853_length_715_cov_38.795455	313	393	8	25	80	0.3125000
NODE_15854_length_715_cov_30.344156	316	396	0	80	80	1.0000000
NODE_15854_length_715_cov_30.344156	369	449	0	80	80	1.0000000
NODE_15857_length_715_cov_11.209416	484	564	0	80	80	1.0000000
NODE_15857_length_715_cov_11.209416	537	617	0	80	80	1.0000000
NODE_15858_length_715_cov_10.894481	189	242	4	53	53	1.0000000
NODE_15859_length_715_cov_10.628247	502	582	0	80	80	1.0000000
NODE_15859_length_715_cov_10.628247	555	635	0	80	80	1.0000000
NODE_15860_length_715_cov_8.647727	138	218	0	41	80	0.5125000
NODE_15860_length_715_cov_8.647727	138	218	2	23	80	0.2875000
NODE_15860_length_715_cov_8.647727	138	218	6	16	80	0.2000000
NODE_15860_length_715_cov_8.647727	191	271	0	80	80	1.0000000
NODE_15861_length_715_cov_8.412338	364	444	0	80	80	1.0000000
NODE_15861_length_715_cov_8.412338	417	497	0	80	80	1.0000000
NODE_15864_length_715_cov_5.373377	318	398	0	32	80	0.4000000
NODE_15864_length_715_cov_5.373377	318	398	2	13	80	0.1625000
NODE_15864_length_715_cov_5.373377	318	398	4	35	80	0.4375000
NODE_15864_length_715_cov_5.373377	371	451	2	14	80	0.1750000
NODE_15864_length_715_cov_5.373377	371	451	4	66	80	0.8250000
NODE_15898_length_715_cov_1.271104	331	397	0	8	66	0.1212121
NODE_15898_length_715_cov_1.271104	331	397	2	13	66	0.1969697
NODE_15898_length_715_cov_1.271104	331	397	3	4	66	0.0606061
NODE_15898_length_715_cov_1.271104	331	397	4	41	66	0.6212121
NODE_15910_length_714_cov_18.621138	297	377	2	5	80	0.0625000
NODE_15910_length_714_cov_18.621138	297	377	4	51	80	0.6375000
NODE_15910_length_714_cov_18.621138	297	377	6	24	80	0.3000000
NODE_15910_length_714_cov_18.621138	350	430	0	11	80	0.1375000
NODE_15910_length_714_cov_18.621138	350	430	2	5	80	0.0625000
NODE_15910_length_714_cov_18.621138	350	430	4	26	80	0.3250000
NODE_15910_length_714_cov_18.621138	350	430	6	38	80	0.4750000
NODE_15911_length_714_cov_15.468293	268	348	0	80	80	1.0000000
NODE_15911_length_714_cov_15.468293	321	401	0	80	80	1.0000000
NODE_15913_length_714_cov_10.530081	218	298	0	4	80	0.0500000
NODE_15913_length_714_cov_10.530081	218	298	2	70	80	0.8750000
NODE_15913_length_714_cov_10.530081	218	298	4	6	80	0.0750000
NODE_15913_length_714_cov_10.530081	271	351	0	57	80	0.7125000
NODE_15913_length_714_cov_10.530081	271	351	2	23	80	0.2875000
NODE_15913_length_714_cov_10.530081	354	434	0	80	80	1.0000000
NODE_15913_length_714_cov_10.530081	407	487	0	80	80	1.0000000
NODE_15914_length_714_cov_8.365854	285	365	0	80	80	1.0000000
NODE_15914_length_714_cov_8.365854	338	418	0	80	80	1.0000000
NODE_15919_length_714_cov_6.993496	263	343	8	1	80	0.0125000
NODE_15919_length_714_cov_6.993496	263	343	10	63	80	0.7875000
NODE_15919_length_714_cov_6.993496	263	343	12	16	80	0.2000000
NODE_15919_length_714_cov_6.993496	316	384	0	4	68	0.0588235
NODE_15919_length_714_cov_6.993496	316	384	4	15	68	0.2205882
NODE_15919_length_714_cov_6.993496	316	384	6	21	68	0.3088235
NODE_15919_length_714_cov_6.993496	316	384	8	2	68	0.0294118
NODE_15919_length_714_cov_6.993496	316	384	10	26	68	0.3823529
NODE_15921_length_714_cov_4.224390	218	288	0	70	70	1.0000000
NODE_15921_length_714_cov_4.224390	271	351	0	80	80	1.0000000
NODE_15969_length_713_cov_19.304560	271	351	4	8	80	0.1000000
NODE_15969_length_713_cov_19.304560	271	351	9	30	80	0.3750000
NODE_15969_length_713_cov_19.304560	271	351	11	32	80	0.4000000
NODE_15969_length_713_cov_19.304560	271	351	12	10	80	0.1250000
NODE_15969_length_713_cov_19.304560	324	404	0	48	80	0.6000000
NODE_15969_length_713_cov_19.304560	324	404	2	3	80	0.0375000
NODE_15969_length_713_cov_19.304560	324	404	4	10	80	0.1250000
NODE_15969_length_713_cov_19.304560	324	404	9	19	80	0.2375000
NODE_15970_length_713_cov_16.926710	262	342	0	26	80	0.3250000
NODE_15970_length_713_cov_16.926710	262	342	2	27	80	0.3375000
NODE_15970_length_713_cov_16.926710	262	342	4	6	80	0.0750000
NODE_15970_length_713_cov_16.926710	262	342	6	21	80	0.2625000
NODE_15970_length_713_cov_16.926710	315	395	2	3	80	0.0375000
NODE_15970_length_713_cov_16.926710	315	395	4	17	80	0.2125000
NODE_15970_length_713_cov_16.926710	315	395	6	60	80	0.7500000
NODE_15973_length_713_cov_7.159609	351	431	0	80	80	1.0000000
NODE_15973_length_713_cov_7.159609	404	484	0	80	80	1.0000000
NODE_15974_length_713_cov_6.723127	379	427	8	21	48	0.4375000
NODE_15974_length_713_cov_6.723127	379	427	9	18	48	0.3750000
NODE_15974_length_713_cov_6.723127	379	427	10	9	48	0.1875000
NODE_15975_length_713_cov_4.954397	90	171	0	81	81	1.0000000
NODE_15975_length_713_cov_4.954397	144	224	0	80	80	1.0000000
NODE_15980_length_713_cov_4.302932	402	482	2	80	80	1.0000000
NODE_15980_length_713_cov_4.302932	455	535	0	52	80	0.6500000
NODE_15980_length_713_cov_4.302932	455	535	2	28	80	0.3500000
NODE_16004_length_713_cov_1.939739	15	75	2	60	60	1.0000000
NODE_16010_length_713_cov_1.605863	81	161	0	80	80	1.0000000
NODE_16010_length_713_cov_1.605863	134	214	0	80	80	1.0000000
NODE_16052_length_712_cov_32.931485	289	369	0	80	80	1.0000000
NODE_16052_length_712_cov_32.931485	342	422	0	80	80	1.0000000
NODE_16053_length_712_cov_31.752039	185	251	0	66	66	1.0000000
NODE_16053_length_712_cov_31.752039	228	307	0	79	79	1.0000000
NODE_16054_length_712_cov_22.567700	228	308	0	80	80	1.0000000
NODE_16054_length_712_cov_22.567700	281	361	0	80	80	1.0000000
NODE_16055_length_712_cov_19.306688	238	318	0	80	80	1.0000000
NODE_16055_length_712_cov_19.306688	291	371	0	80	80	1.0000000
NODE_16056_length_712_cov_14.929853	332	412	0	63	80	0.7875000
NODE_16056_length_712_cov_14.929853	332	412	2	17	80	0.2125000
NODE_16056_length_712_cov_14.929853	385	465	0	80	80	1.0000000
NODE_16057_length_712_cov_14.228385	250	330	0	80	80	1.0000000
NODE_16057_length_712_cov_14.228385	303	383	0	80	80	1.0000000
NODE_16059_length_712_cov_9.221860	326	406	0	7	80	0.0875000
NODE_16059_length_712_cov_9.221860	326	406	4	56	80	0.7000000
NODE_16059_length_712_cov_9.221860	326	406	5	15	80	0.1875000
NODE_16059_length_712_cov_9.221860	326	406	6	2	80	0.0250000
NODE_16059_length_712_cov_9.221860	379	463	2	40	84	0.4761905
NODE_16059_length_712_cov_9.221860	379	463	4	10	84	0.1190476
NODE_16059_length_712_cov_9.221860	379	463	5	15	84	0.1785714
NODE_16059_length_712_cov_9.221860	379	463	6	19	84	0.2261905
NODE_16060_length_712_cov_8.368679	331	411	0	80	80	1.0000000
NODE_16060_length_712_cov_8.368679	384	464	0	80	80	1.0000000
NODE_16079_length_712_cov_2.350734	466	510	0	44	44	1.0000000
NODE_16118_length_711_cov_36.459150	146	223	0	77	77	1.0000000
NODE_16118_length_711_cov_36.459150	199	280	0	81	81	1.0000000
NODE_16119_length_711_cov_26.702614	460	540	4	37	80	0.4625000
NODE_16119_length_711_cov_26.702614	460	540	6	9	80	0.1125000
NODE_16119_length_711_cov_26.702614	460	540	8	34	80	0.4250000
NODE_16119_length_711_cov_26.702614	513	593	2	21	80	0.2625000
NODE_16119_length_711_cov_26.702614	513	593	4	32	80	0.4000000
NODE_16119_length_711_cov_26.702614	513	593	8	27	80	0.3375000
NODE_16120_length_711_cov_19.632353	329	409	0	80	80	1.0000000
NODE_16120_length_711_cov_19.632353	382	462	0	80	80	1.0000000
NODE_16121_length_711_cov_19.267974	283	363	0	36	80	0.4500000
NODE_16121_length_711_cov_19.267974	283	363	2	44	80	0.5500000
NODE_16121_length_711_cov_19.267974	336	416	0	31	80	0.3875000
NODE_16121_length_711_cov_19.267974	336	416	2	49	80	0.6125000
NODE_16122_length_711_cov_12.813725	255	334	0	79	79	1.0000000
NODE_16123_length_711_cov_12.147059	314	394	0	2	80	0.0250000
NODE_16123_length_711_cov_12.147059	314	394	2	78	80	0.9750000
NODE_16123_length_711_cov_12.147059	367	447	0	15	80	0.1875000
NODE_16123_length_711_cov_12.147059	367	447	2	65	80	0.8125000
NODE_16124_length_711_cov_10.009804	336	415	2	33	79	0.4177215
NODE_16124_length_711_cov_10.009804	336	415	4	46	79	0.5822785
NODE_16127_length_711_cov_5.619281	276	356	0	80	80	1.0000000
NODE_16127_length_711_cov_5.619281	329	409	0	80	80	1.0000000
NODE_16130_length_711_cov_4.040850	165	245	0	80	80	1.0000000
NODE_16130_length_711_cov_4.040850	218	298	0	80	80	1.0000000
NODE_16167_length_710_cov_73.721768	626	706	0	80	80	1.0000000
NODE_16168_length_710_cov_21.772504	292	372	0	80	80	1.0000000
NODE_16168_length_710_cov_21.772504	345	425	0	80	80	1.0000000
NODE_16169_length_710_cov_21.597381	18	54	0	33	36	0.9166667
NODE_16169_length_710_cov_21.597381	18	54	2	3	36	0.0833333
NODE_16170_length_710_cov_13.155483	306	386	2	9	80	0.1125000
NODE_16170_length_710_cov_13.155483	306	386	7	2	80	0.0250000
NODE_16170_length_710_cov_13.155483	306	386	11	63	80	0.7875000
NODE_16170_length_710_cov_13.155483	306	386	12	6	80	0.0750000
NODE_16170_length_710_cov_13.155483	359	439	2	17	80	0.2125000
NODE_16170_length_710_cov_13.155483	359	439	3	8	80	0.1000000
NODE_16170_length_710_cov_13.155483	359	439	4	12	80	0.1500000
NODE_16170_length_710_cov_13.155483	359	439	6	25	80	0.3125000
NODE_16170_length_710_cov_13.155483	359	439	7	2	80	0.0250000
NODE_16170_length_710_cov_13.155483	359	439	11	16	80	0.2000000
NODE_16173_length_710_cov_8.031097	316	396	0	80	80	1.0000000
NODE_16173_length_710_cov_8.031097	369	449	0	80	80	1.0000000
NODE_16175_length_710_cov_6.664484	264	344	2	80	80	1.0000000
NODE_16178_length_710_cov_5.590835	352	421	0	27	69	0.3913043
NODE_16178_length_710_cov_5.590835	352	421	2	38	69	0.5507246
NODE_16178_length_710_cov_5.590835	352	421	6	4	69	0.0579710
NODE_16178_length_710_cov_5.590835	394	474	2	23	80	0.2875000
NODE_16178_length_710_cov_5.590835	394	474	4	2	80	0.0250000
NODE_16178_length_710_cov_5.590835	394	474	6	55	80	0.6875000
NODE_16180_length_710_cov_5.356792	248	328	0	3	80	0.0375000
NODE_16180_length_710_cov_5.356792	248	328	2	77	80	0.9625000
NODE_16180_length_710_cov_5.356792	301	381	2	80	80	1.0000000
NODE_16233_length_709_cov_12.227869	347	427	0	80	80	1.0000000
NODE_16233_length_709_cov_12.227869	400	480	0	80	80	1.0000000
NODE_16234_length_709_cov_10.531148	279	359	0	80	80	1.0000000
NODE_16234_length_709_cov_10.531148	332	412	0	80	80	1.0000000
NODE_16238_length_709_cov_7.181967	225	305	0	39	80	0.4875000
NODE_16238_length_709_cov_7.181967	225	305	2	41	80	0.5125000
NODE_16238_length_709_cov_7.181967	279	312	2	33	33	1.0000000
NODE_16241_length_709_cov_5.888525	239	319	0	80	80	1.0000000
NODE_16241_length_709_cov_5.888525	292	372	0	80	80	1.0000000
NODE_16294_length_708_cov_42.435140	307	387	0	76	80	0.9500000
NODE_16294_length_708_cov_42.435140	307	387	2	4	80	0.0500000
NODE_16294_length_708_cov_42.435140	360	440	0	23	80	0.2875000
NODE_16294_length_708_cov_42.435140	360	440	2	57	80	0.7125000
NODE_16296_length_708_cov_33.412151	235	315	0	80	80	1.0000000
NODE_16296_length_708_cov_33.412151	288	368	0	80	80	1.0000000
NODE_16297_length_708_cov_23.034483	316	396	2	43	80	0.5375000
NODE_16297_length_708_cov_23.034483	316	396	4	37	80	0.4625000
NODE_16297_length_708_cov_23.034483	369	449	0	19	80	0.2375000
NODE_16297_length_708_cov_23.034483	369	449	2	39	80	0.4875000
NODE_16297_length_708_cov_23.034483	369	449	4	22	80	0.2750000
NODE_16298_length_708_cov_20.449918	254	334	0	8	80	0.1000000
NODE_16298_length_708_cov_20.449918	254	334	2	72	80	0.9000000
NODE_16298_length_708_cov_20.449918	307	387	0	33	80	0.4125000
NODE_16298_length_708_cov_20.449918	307	387	2	47	80	0.5875000
NODE_16299_length_708_cov_19.998358	238	318	0	14	80	0.1750000
NODE_16299_length_708_cov_19.998358	238	318	2	39	80	0.4875000
NODE_16299_length_708_cov_19.998358	238	318	4	27	80	0.3375000
NODE_16299_length_708_cov_19.998358	291	371	2	38	80	0.4750000
NODE_16299_length_708_cov_19.998358	291	371	4	42	80	0.5250000
NODE_16300_length_708_cov_19.021346	366	446	2	27	80	0.3375000
NODE_16300_length_708_cov_19.021346	366	446	4	53	80	0.6625000
NODE_16300_length_708_cov_19.021346	419	499	0	35	80	0.4375000
NODE_16300_length_708_cov_19.021346	419	499	2	45	80	0.5625000
NODE_16302_length_708_cov_12.228243	181	263	0	8	82	0.0975610
NODE_16302_length_708_cov_12.228243	181	263	2	6	82	0.0731707
NODE_16302_length_708_cov_12.228243	181	263	4	68	82	0.8292683
NODE_16302_length_708_cov_12.228243	188	268	0	13	80	0.1625000
NODE_16302_length_708_cov_12.228243	188	268	2	6	80	0.0750000
NODE_16302_length_708_cov_12.228243	188	268	4	61	80	0.7625000
NODE_16302_length_708_cov_12.228243	236	316	0	61	80	0.7625000
NODE_16302_length_708_cov_12.228243	236	316	2	6	80	0.0750000
NODE_16302_length_708_cov_12.228243	236	316	4	13	80	0.1625000
NODE_16302_length_708_cov_12.228243	312	392	0	14	80	0.1750000
NODE_16302_length_708_cov_12.228243	312	392	2	32	80	0.4000000
NODE_16302_length_708_cov_12.228243	312	392	4	34	80	0.4250000
NODE_16302_length_708_cov_12.228243	312	392	0	14	80	0.1750000
NODE_16302_length_708_cov_12.228243	312	392	2	32	80	0.4000000
NODE_16302_length_708_cov_12.228243	312	392	4	34	80	0.4250000
NODE_16302_length_708_cov_12.228243	365	445	2	59	80	0.7375000
NODE_16302_length_708_cov_12.228243	365	445	4	21	80	0.2625000
NODE_16303_length_708_cov_11.338259	255	335	0	25	80	0.3125000
NODE_16303_length_708_cov_11.338259	255	335	2	55	80	0.6875000
NODE_16303_length_708_cov_11.338259	308	388	0	78	80	0.9750000
NODE_16303_length_708_cov_11.338259	308	388	2	2	80	0.0250000
NODE_16305_length_708_cov_9.676519	219	299	0	80	80	1.0000000
NODE_16305_length_708_cov_9.676519	272	352	0	80	80	1.0000000
NODE_16306_length_708_cov_8.638752	324	399	0	75	75	1.0000000
NODE_16330_length_708_cov_2.699507	358	398	0	40	40	1.0000000
NODE_16370_length_707_cov_30.067434	325	405	0	32	80	0.4000000
NODE_16370_length_707_cov_30.067434	325	405	2	48	80	0.6000000
NODE_16370_length_707_cov_30.067434	378	458	0	27	80	0.3375000
NODE_16370_length_707_cov_30.067434	378	458	2	53	80	0.6625000
NODE_16371_length_707_cov_26.555921	241	321	0	3	80	0.0375000
NODE_16371_length_707_cov_26.555921	241	321	4	77	80	0.9625000
NODE_16371_length_707_cov_26.555921	294	374	0	17	80	0.2125000
NODE_16371_length_707_cov_26.555921	294	374	4	63	80	0.7875000
NODE_16372_length_707_cov_23.972039	322	402	2	6	80	0.0750000
NODE_16372_length_707_cov_23.972039	322	402	4	46	80	0.5750000
NODE_16372_length_707_cov_23.972039	322	402	5	15	80	0.1875000
NODE_16372_length_707_cov_23.972039	322	402	6	13	80	0.1625000
NODE_16372_length_707_cov_23.972039	375	455	0	25	80	0.3125000
NODE_16372_length_707_cov_23.972039	375	455	2	34	80	0.4250000
NODE_16372_length_707_cov_23.972039	375	455	4	10	80	0.1250000
NODE_16372_length_707_cov_23.972039	375	455	5	11	80	0.1375000
NODE_16373_length_707_cov_20.348684	157	237	0	80	80	1.0000000
NODE_16373_length_707_cov_20.348684	210	281	0	71	71	1.0000000
NODE_16374_length_707_cov_18.970395	253	333	0	80	80	1.0000000
NODE_16374_length_707_cov_18.970395	306	386	0	80	80	1.0000000
NODE_16375_length_707_cov_14.324013	302	382	4	80	80	1.0000000
NODE_16375_length_707_cov_14.324013	355	435	0	29	80	0.3625000
NODE_16375_length_707_cov_14.324013	355	435	4	51	80	0.6375000
NODE_16378_length_707_cov_5.062500	313	393	0	80	80	1.0000000
NODE_16441_length_706_cov_34.116969	272	352	0	9	80	0.1125000
NODE_16441_length_706_cov_34.116969	272	352	3	3	80	0.0375000
NODE_16441_length_706_cov_34.116969	272	352	6	68	80	0.8500000
NODE_16441_length_706_cov_34.116969	325	405	0	16	80	0.2000000
NODE_16441_length_706_cov_34.116969	325	405	4	34	80	0.4250000
NODE_16441_length_706_cov_34.116969	325	405	6	30	80	0.3750000
NODE_16442_length_706_cov_27.220758	229	309	0	80	80	1.0000000
NODE_16442_length_706_cov_27.220758	282	362	0	80	80	1.0000000
NODE_16443_length_706_cov_20.380560	264	344	0	28	80	0.3500000
NODE_16443_length_706_cov_20.380560	264	344	1	1	80	0.0125000
NODE_16443_length_706_cov_20.380560	264	344	2	51	80	0.6375000
NODE_16443_length_706_cov_20.380560	317	397	0	38	80	0.4750000
NODE_16443_length_706_cov_20.380560	317	397	2	42	80	0.5250000
NODE_16444_length_706_cov_19.525535	289	369	0	80	80	1.0000000
NODE_16444_length_706_cov_19.525535	342	422	0	80	80	1.0000000
NODE_16454_length_706_cov_3.344316	465	545	7	80	80	1.0000000
NODE_16454_length_706_cov_3.344316	518	598	0	33	80	0.4125000
NODE_16454_length_706_cov_3.344316	518	598	4	7	80	0.0875000
NODE_16454_length_706_cov_3.344316	518	598	5	1	80	0.0125000
NODE_16454_length_706_cov_3.344316	518	598	6	1	80	0.0125000
NODE_16454_length_706_cov_3.344316	518	598	7	38	80	0.4750000
NODE_16494_length_705_cov_19.211221	118	198	0	6	80	0.0750000
NODE_16494_length_705_cov_19.211221	118	198	2	15	80	0.1875000
NODE_16494_length_705_cov_19.211221	118	198	4	59	80	0.7375000
NODE_16494_length_705_cov_19.211221	171	250	2	22	79	0.2784810
NODE_16494_length_705_cov_19.211221	171	250	4	57	79	0.7215190
NODE_16495_length_705_cov_16.338284	291	339	0	45	48	0.9375000
NODE_16495_length_705_cov_16.338284	291	339	6	3	48	0.0625000
NODE_16495_length_705_cov_16.338284	336	406	4	19	70	0.2714286
NODE_16495_length_705_cov_16.338284	336	406	6	51	70	0.7285714
NODE_16496_length_705_cov_14.354785	209	289	0	18	80	0.2250000
NODE_16496_length_705_cov_14.354785	209	289	2	62	80	0.7750000
NODE_16496_length_705_cov_14.354785	262	342	0	71	80	0.8875000
NODE_16496_length_705_cov_14.354785	262	342	2	9	80	0.1125000
NODE_16497_length_705_cov_12.231023	293	373	0	80	80	1.0000000
NODE_16497_length_705_cov_12.231023	346	426	0	80	80	1.0000000
NODE_16498_length_705_cov_11.836634	390	470	0	80	80	1.0000000
NODE_16498_length_705_cov_11.836634	443	523	0	80	80	1.0000000
NODE_16499_length_705_cov_10.049505	382	479	0	97	97	1.0000000
NODE_16499_length_705_cov_10.049505	452	532	0	80	80	1.0000000
NODE_16507_length_705_cov_4.275578	358	438	0	80	80	1.0000000
NODE_16507_length_705_cov_4.275578	411	491	0	80	80	1.0000000
NODE_16509_length_705_cov_4.018152	306	364	0	58	58	1.0000000
NODE_16509_length_705_cov_4.018152	337	410	0	73	73	1.0000000
NODE_16511_length_705_cov_3.620462	253	315	4	4	62	0.0645161
NODE_16511_length_705_cov_3.620462	253	315	6	58	62	0.9354839
NODE_16511_length_705_cov_3.620462	308	368	4	31	60	0.5166667
NODE_16511_length_705_cov_3.620462	308	368	6	23	60	0.3833333
NODE_16511_length_705_cov_3.620462	308	368	8	6	60	0.1000000
NODE_16527_length_705_cov_1.607261	462	531	3	46	69	0.6666667
NODE_16527_length_705_cov_1.607261	462	531	5	9	69	0.1304348
NODE_16527_length_705_cov_1.607261	462	531	6	14	69	0.2028985
NODE_16549_length_705_cov_0.529703	33	97	4	22	64	0.3437500
NODE_16549_length_705_cov_0.529703	33	97	6	42	64	0.6562500
NODE_16549_length_705_cov_0.529703	86	150	0	3	64	0.0468750
NODE_16549_length_705_cov_0.529703	86	150	2	26	64	0.4062500
NODE_16549_length_705_cov_0.529703	86	150	4	7	64	0.1093750
NODE_16549_length_705_cov_0.529703	86	150	6	28	64	0.4375000
NODE_16550_length_704_cov_18.256198	295	375	0	48	80	0.6000000
NODE_16550_length_704_cov_18.256198	295	375	2	32	80	0.4000000
NODE_16550_length_704_cov_18.256198	348	428	0	80	80	1.0000000
NODE_16552_length_704_cov_16.662810	264	344	0	21	80	0.2625000
NODE_16552_length_704_cov_16.662810	264	344	2	59	80	0.7375000
NODE_16552_length_704_cov_16.662810	317	397	0	74	80	0.9250000
NODE_16552_length_704_cov_16.662810	317	397	2	6	80	0.0750000
NODE_16553_length_704_cov_12.641322	294	374	0	65	80	0.8125000
NODE_16553_length_704_cov_12.641322	294	374	2	1	80	0.0125000
NODE_16553_length_704_cov_12.641322	294	374	4	14	80	0.1750000
NODE_16553_length_704_cov_12.641322	347	427	0	12	80	0.1500000
NODE_16553_length_704_cov_12.641322	347	427	2	1	80	0.0125000
NODE_16553_length_704_cov_12.641322	347	427	4	67	80	0.8375000
NODE_16557_length_704_cov_5.603306	440	498	0	58	58	1.0000000
NODE_16564_length_704_cov_3.535537	303	383	0	4	80	0.0500000
NODE_16564_length_704_cov_3.535537	303	383	2	4	80	0.0500000
NODE_16564_length_704_cov_3.535537	303	383	4	23	80	0.2875000
NODE_16564_length_704_cov_3.535537	303	383	6	49	80	0.6125000
NODE_16564_length_704_cov_3.535537	369	436	2	8	67	0.1194030
NODE_16564_length_704_cov_3.535537	369	436	4	4	67	0.0597015
NODE_16564_length_704_cov_3.535537	369	436	6	55	67	0.8208955
NODE_16578_length_704_cov_1.963636	345	425	8	21	80	0.2625000
NODE_16578_length_704_cov_1.963636	345	425	10	59	80	0.7375000
NODE_16578_length_704_cov_1.963636	398	478	0	39	80	0.4875000
NODE_16578_length_704_cov_1.963636	398	478	2	1	80	0.0125000
NODE_16578_length_704_cov_1.963636	398	478	4	8	80	0.1000000
NODE_16578_length_704_cov_1.963636	398	478	6	2	80	0.0250000
NODE_16578_length_704_cov_1.963636	398	478	8	24	80	0.3000000
NODE_16578_length_704_cov_1.963636	398	478	10	6	80	0.0750000
NODE_16598_length_703_cov_44.102649	514	594	2	2	80	0.0250000
NODE_16598_length_703_cov_44.102649	514	594	4	48	80	0.6000000
NODE_16598_length_703_cov_44.102649	514	594	6	30	80	0.3750000
NODE_16598_length_703_cov_44.102649	567	647	0	6	80	0.0750000
NODE_16598_length_703_cov_44.102649	567	647	2	9	80	0.1125000
NODE_16598_length_703_cov_44.102649	567	647	4	65	80	0.8125000
NODE_16599_length_703_cov_33.067881	521	594	68	2	73	0.0273973
NODE_16599_length_703_cov_33.067881	521	594	69	3	73	0.0410959
NODE_16599_length_703_cov_33.067881	521	594	71	15	73	0.2054795
NODE_16599_length_703_cov_33.067881	521	594	72	1	73	0.0136986
NODE_16599_length_703_cov_33.067881	521	594	73	2	73	0.0273973
NODE_16599_length_703_cov_33.067881	521	594	74	3	73	0.0410959
NODE_16599_length_703_cov_33.067881	521	594	75	2	73	0.0273973
NODE_16599_length_703_cov_33.067881	521	594	77	2	73	0.0273973
NODE_16599_length_703_cov_33.067881	521	594	79	4	73	0.0547945
NODE_16599_length_703_cov_33.067881	521	594	83	3	73	0.0410959
NODE_16599_length_703_cov_33.067881	521	594	85	2	73	0.0273973
NODE_16599_length_703_cov_33.067881	521	594	89	5	73	0.0684932
NODE_16599_length_703_cov_33.067881	521	594	91	2	73	0.0273973
NODE_16599_length_703_cov_33.067881	521	594	93	5	73	0.0684932
NODE_16599_length_703_cov_33.067881	521	594	95	8	73	0.1095890
NODE_16599_length_703_cov_33.067881	521	594	97	14	73	0.1917808
NODE_16599_length_703_cov_33.067881	561	602	64	3	41	0.0731707
NODE_16599_length_703_cov_33.067881	561	602	66	5	41	0.1219512
NODE_16599_length_703_cov_33.067881	561	602	68	2	41	0.0487805
NODE_16599_length_703_cov_33.067881	561	602	69	3	41	0.0731707
NODE_16599_length_703_cov_33.067881	561	602	71	15	41	0.3658537
NODE_16599_length_703_cov_33.067881	561	602	72	1	41	0.0243902
NODE_16599_length_703_cov_33.067881	561	602	73	2	41	0.0487805
NODE_16599_length_703_cov_33.067881	561	602	74	3	41	0.0731707
NODE_16599_length_703_cov_33.067881	561	602	75	2	41	0.0487805
NODE_16599_length_703_cov_33.067881	561	602	77	2	41	0.0487805
NODE_16599_length_703_cov_33.067881	561	602	79	3	41	0.0731707
NODE_16600_length_703_cov_30.266556	312	392	0	80	80	1.0000000
NODE_16600_length_703_cov_30.266556	365	445	0	80	80	1.0000000
NODE_16601_length_703_cov_17.006623	449	529	0	80	80	1.0000000
NODE_16601_length_703_cov_17.006623	502	582	0	80	80	1.0000000
NODE_16602_length_703_cov_14.801325	383	463	0	80	80	1.0000000
NODE_16602_length_703_cov_14.801325	436	516	0	80	80	1.0000000
NODE_16603_length_703_cov_11.766556	308	388	2	52	80	0.6500000
NODE_16603_length_703_cov_11.766556	308	388	4	28	80	0.3500000
NODE_16603_length_703_cov_11.766556	361	441	0	5	80	0.0625000
NODE_16603_length_703_cov_11.766556	361	441	2	75	80	0.9375000
NODE_16604_length_703_cov_10.405629	213	293	10	23	80	0.2875000
NODE_16604_length_703_cov_10.405629	213	293	14	7	80	0.0875000
NODE_16604_length_703_cov_10.405629	213	293	16	47	80	0.5875000
NODE_16604_length_703_cov_10.405629	213	293	18	3	80	0.0375000
NODE_16604_length_703_cov_10.405629	266	301	10	31	35	0.8857143
NODE_16604_length_703_cov_10.405629	266	301	16	4	35	0.1142857
NODE_16605_length_703_cov_6.966887	381	440	4	59	59	1.0000000
NODE_16616_length_703_cov_3.491722	256	309	0	53	53	1.0000000
NODE_16616_length_703_cov_3.491722	257	337	0	79	80	0.9875000
NODE_16616_length_703_cov_3.491722	257	337	2	1	80	0.0125000
NODE_16616_length_703_cov_3.491722	305	362	0	31	57	0.5438597
NODE_16616_length_703_cov_3.491722	305	362	2	26	57	0.4561403
NODE_16624_length_703_cov_2.687086	216	296	0	80	80	1.0000000
NODE_16624_length_703_cov_2.687086	269	349	0	80	80	1.0000000
NODE_16663_length_702_cov_49.784411	221	299	0	78	78	1.0000000
NODE_16663_length_702_cov_49.784411	277	352	0	75	75	1.0000000
NODE_16664_length_702_cov_26.570481	201	281	0	80	80	1.0000000
NODE_16664_length_702_cov_26.570481	254	334	0	80	80	1.0000000
NODE_16665_length_702_cov_23.971808	139	219	2	18	80	0.2250000
NODE_16665_length_702_cov_23.971808	139	219	6	18	80	0.2250000
NODE_16665_length_702_cov_23.971808	139	219	8	10	80	0.1250000
NODE_16665_length_702_cov_23.971808	139	219	9	1	80	0.0125000
NODE_16665_length_702_cov_23.971808	139	219	10	33	80	0.4125000
NODE_16665_length_702_cov_23.971808	192	272	0	50	80	0.6250000
NODE_16665_length_702_cov_23.971808	192	272	2	21	80	0.2625000
NODE_16665_length_702_cov_23.971808	192	272	6	9	80	0.1125000
NODE_16665_length_702_cov_23.971808	268	348	0	80	80	1.0000000
NODE_16665_length_702_cov_23.971808	321	401	0	80	80	1.0000000
NODE_16666_length_702_cov_23.827529	448	528	0	80	80	1.0000000
NODE_16666_length_702_cov_23.827529	501	581	0	80	80	1.0000000
NODE_16667_length_702_cov_14.661692	424	504	2	20	80	0.2500000
NODE_16667_length_702_cov_14.661692	424	504	4	60	80	0.7500000
NODE_16667_length_702_cov_14.661692	477	557	0	22	80	0.2750000
NODE_16667_length_702_cov_14.661692	477	557	2	30	80	0.3750000
NODE_16667_length_702_cov_14.661692	477	557	4	28	80	0.3500000
NODE_16668_length_702_cov_13.908789	259	304	10	35	45	0.7777778
NODE_16668_length_702_cov_13.908789	259	304	14	10	45	0.2222222
NODE_16668_length_702_cov_13.908789	277	357	8	28	80	0.3500000
NODE_16668_length_702_cov_13.908789	277	357	10	17	80	0.2125000
NODE_16668_length_702_cov_13.908789	277	357	14	35	80	0.4375000
NODE_16668_length_702_cov_13.908789	289	357	8	28	68	0.4117647
NODE_16668_length_702_cov_13.908789	289	357	10	5	68	0.0735294
NODE_16668_length_702_cov_13.908789	289	357	14	35	68	0.5147059
NODE_16669_length_702_cov_8.502488	337	417	0	80	80	1.0000000
NODE_16669_length_702_cov_8.502488	390	470	0	80	80	1.0000000
NODE_16671_length_702_cov_6.470978	209	289	0	80	80	1.0000000
NODE_16671_length_702_cov_6.470978	262	342	0	80	80	1.0000000
NODE_16729_length_701_cov_38.715947	178	258	2	2	80	0.0250000
NODE_16729_length_701_cov_38.715947	178	258	4	31	80	0.3875000
NODE_16729_length_701_cov_38.715947	178	258	10	2	80	0.0250000
NODE_16729_length_701_cov_38.715947	178	258	12	18	80	0.2250000
NODE_16729_length_701_cov_38.715947	178	258	14	27	80	0.3375000
NODE_16729_length_701_cov_38.715947	231	311	12	46	80	0.5750000
NODE_16729_length_701_cov_38.715947	231	311	14	34	80	0.4250000
NODE_16729_length_701_cov_38.715947	307	387	0	29	80	0.3625000
NODE_16729_length_701_cov_38.715947	307	387	7	12	80	0.1500000
NODE_16729_length_701_cov_38.715947	307	387	8	21	80	0.2625000
NODE_16729_length_701_cov_38.715947	307	387	10	13	80	0.1625000
NODE_16729_length_701_cov_38.715947	307	387	12	5	80	0.0625000
NODE_16729_length_701_cov_38.715947	360	440	0	80	80	1.0000000
NODE_16730_length_701_cov_28.059801	432	513	0	28	81	0.3456790
NODE_16730_length_701_cov_28.059801	432	513	2	53	81	0.6543210
NODE_16730_length_701_cov_28.059801	486	566	0	80	80	1.0000000
NODE_16731_length_701_cov_18.387043	258	338	0	22	80	0.2750000
NODE_16731_length_701_cov_18.387043	258	338	2	58	80	0.7250000
NODE_16731_length_701_cov_18.387043	311	391	0	45	80	0.5625000
NODE_16731_length_701_cov_18.387043	311	391	2	35	80	0.4375000
NODE_16732_length_701_cov_17.122924	295	367	8	24	72	0.3333333
NODE_16732_length_701_cov_17.122924	295	367	10	6	72	0.0833333
NODE_16732_length_701_cov_17.122924	295	367	12	42	72	0.5833333
NODE_16733_length_701_cov_16.114618	242	322	0	80	80	1.0000000
NODE_16733_length_701_cov_16.114618	295	375	0	80	80	1.0000000
NODE_16734_length_701_cov_15.588040	399	479	0	28	80	0.3500000
NODE_16734_length_701_cov_15.588040	399	479	2	27	80	0.3375000
NODE_16734_length_701_cov_15.588040	399	479	4	25	80	0.3125000
NODE_16734_length_701_cov_15.588040	452	532	2	2	80	0.0250000
NODE_16734_length_701_cov_15.588040	452	532	4	78	80	0.9750000
NODE_16736_length_701_cov_11.420266	229	309	0	80	80	1.0000000
NODE_16736_length_701_cov_11.420266	282	362	0	80	80	1.0000000
NODE_16737_length_701_cov_10.411960	202	283	0	81	81	1.0000000
NODE_16737_length_701_cov_10.411960	256	336	0	80	80	1.0000000
NODE_16738_length_701_cov_9.107973	400	480	0	79	80	0.9875000
NODE_16738_length_701_cov_9.107973	400	480	2	1	80	0.0125000
NODE_16738_length_701_cov_9.107973	453	533	0	26	80	0.3250000
NODE_16738_length_701_cov_9.107973	453	533	2	54	80	0.6750000
NODE_16739_length_701_cov_8.877076	283	363	0	80	80	1.0000000
NODE_16739_length_701_cov_8.877076	336	416	0	80	80	1.0000000
NODE_16740_length_701_cov_8.543189	341	421	0	80	80	1.0000000
NODE_16740_length_701_cov_8.543189	394	474	0	80	80	1.0000000
NODE_16742_length_701_cov_6.317276	273	353	0	80	80	1.0000000
NODE_16742_length_701_cov_6.317276	326	382	0	56	56	1.0000000
NODE_16747_length_701_cov_5.081395	318	374	8	7	56	0.1250000
NODE_16747_length_701_cov_5.081395	318	374	10	49	56	0.8750000
NODE_16752_length_701_cov_3.320598	207	287	0	38	80	0.4750000
NODE_16752_length_701_cov_3.320598	207	287	2	42	80	0.5250000
NODE_16752_length_701_cov_3.320598	260	340	2	44	80	0.5500000
NODE_16752_length_701_cov_3.320598	260	340	4	7	80	0.0875000
NODE_16752_length_701_cov_3.320598	260	340	6	29	80	0.3625000
NODE_16794_length_700_cov_22.241265	326	406	34	8	80	0.1000000
NODE_16794_length_700_cov_22.241265	326	406	36	4	80	0.0500000
NODE_16794_length_700_cov_22.241265	326	406	41	1	80	0.0125000
NODE_16794_length_700_cov_22.241265	326	406	42	4	80	0.0500000
NODE_16794_length_700_cov_22.241265	326	406	43	4	80	0.0500000
NODE_16794_length_700_cov_22.241265	326	406	46	5	80	0.0625000
NODE_16794_length_700_cov_22.241265	326	406	48	3	80	0.0375000
NODE_16794_length_700_cov_22.241265	326	406	49	3	80	0.0375000
NODE_16794_length_700_cov_22.241265	326	406	50	15	80	0.1875000
NODE_16794_length_700_cov_22.241265	326	406	51	6	80	0.0750000
NODE_16794_length_700_cov_22.241265	326	406	52	18	80	0.2250000
NODE_16794_length_700_cov_22.241265	326	406	53	7	80	0.0875000
NODE_16794_length_700_cov_22.241265	326	406	55	2	80	0.0250000
NODE_16796_length_700_cov_11.730449	294	374	0	80	80	1.0000000
NODE_16796_length_700_cov_11.730449	347	427	0	80	80	1.0000000
NODE_16800_length_700_cov_7.291181	317	397	0	80	80	1.0000000
NODE_16800_length_700_cov_7.291181	370	450	0	80	80	1.0000000
NODE_16801_length_700_cov_6.557404	353	404	0	51	51	1.0000000
NODE_16802_length_700_cov_5.475874	301	381	0	80	80	1.0000000
NODE_16802_length_700_cov_5.475874	354	434	0	80	80	1.0000000
NODE_16803_length_700_cov_3.960067	158	234	0	76	76	1.0000000
NODE_16803_length_700_cov_3.960067	209	291	0	82	82	1.0000000
NODE_16822_length_700_cov_1.517471	324	404	0	80	80	1.0000000
NODE_16822_length_700_cov_1.517471	377	457	0	80	80	1.0000000
NODE_16844_length_699_cov_18.446667	185	265	0	80	80	1.0000000
NODE_16844_length_699_cov_18.446667	238	318	0	80	80	1.0000000
NODE_16845_length_699_cov_18.383333	258	338	0	66	80	0.8250000
NODE_16845_length_699_cov_18.383333	258	338	2	14	80	0.1750000
NODE_16845_length_699_cov_18.383333	311	391	0	80	80	1.0000000
NODE_16846_length_699_cov_18.103333	218	298	0	14	80	0.1750000
NODE_16846_length_699_cov_18.103333	218	298	1	1	80	0.0125000
NODE_16846_length_699_cov_18.103333	218	298	2	65	80	0.8125000
NODE_16846_length_699_cov_18.103333	271	351	0	53	80	0.6625000
NODE_16846_length_699_cov_18.103333	271	351	1	1	80	0.0125000
NODE_16846_length_699_cov_18.103333	271	351	2	26	80	0.3250000
NODE_16847_length_699_cov_15.636667	279	359	0	80	80	1.0000000
NODE_16847_length_699_cov_15.636667	332	412	0	80	80	1.0000000
NODE_16848_length_699_cov_15.113333	313	393	0	80	80	1.0000000
NODE_16848_length_699_cov_15.113333	366	446	0	80	80	1.0000000
NODE_16849_length_699_cov_10.070000	233	313	0	80	80	1.0000000
NODE_16849_length_699_cov_10.070000	286	366	0	80	80	1.0000000
NODE_16849_length_699_cov_10.070000	362	442	0	80	80	1.0000000
NODE_16849_length_699_cov_10.070000	415	495	0	80	80	1.0000000
NODE_16850_length_699_cov_8.083333	347	427	0	80	80	1.0000000
NODE_16850_length_699_cov_8.083333	400	480	0	79	80	0.9875000
NODE_16850_length_699_cov_8.083333	400	480	2	1	80	0.0125000
NODE_16851_length_699_cov_7.758333	307	387	0	80	80	1.0000000
NODE_16851_length_699_cov_7.758333	360	440	0	80	80	1.0000000
NODE_16852_length_699_cov_7.713333	252	332	0	57	80	0.7125000
NODE_16852_length_699_cov_7.713333	252	332	1	2	80	0.0250000
NODE_16852_length_699_cov_7.713333	252	332	2	21	80	0.2625000
NODE_16852_length_699_cov_7.713333	305	385	0	4	80	0.0500000
NODE_16852_length_699_cov_7.713333	305	385	1	2	80	0.0250000
NODE_16852_length_699_cov_7.713333	305	385	2	31	80	0.3875000
NODE_16852_length_699_cov_7.713333	305	385	4	43	80	0.5375000
NODE_16853_length_699_cov_7.186667	271	332	0	61	61	1.0000000
NODE_16853_length_699_cov_7.186667	348	428	0	80	80	1.0000000
NODE_16857_length_699_cov_5.815000	243	316	0	73	73	1.0000000
NODE_16857_length_699_cov_5.815000	293	374	0	45	81	0.5555556
NODE_16857_length_699_cov_5.815000	293	374	2	36	81	0.4444444
NODE_16858_length_699_cov_5.520000	302	382	0	80	80	1.0000000
NODE_16858_length_699_cov_5.520000	355	435	0	80	80	1.0000000
NODE_16860_length_699_cov_4.051667	289	369	0	80	80	1.0000000
NODE_16860_length_699_cov_4.051667	342	422	0	80	80	1.0000000
NODE_16868_length_699_cov_2.498333	204	284	0	25	80	0.3125000
NODE_16868_length_699_cov_2.498333	204	284	2	55	80	0.6875000
NODE_16868_length_699_cov_2.498333	257	337	0	78	80	0.9750000
NODE_16868_length_699_cov_2.498333	257	337	2	2	80	0.0250000
NODE_16908_length_698_cov_47.350584	321	401	0	27	80	0.3375000
NODE_16908_length_698_cov_47.350584	321	401	2	53	80	0.6625000
NODE_16908_length_698_cov_47.350584	374	454	0	80	80	1.0000000
NODE_16909_length_698_cov_42.848080	255	335	0	80	80	1.0000000
NODE_16909_length_698_cov_42.848080	308	388	0	80	80	1.0000000
NODE_16910_length_698_cov_36.697830	366	446	0	18	80	0.2250000
NODE_16910_length_698_cov_36.697830	366	446	7	2	80	0.0250000
NODE_16910_length_698_cov_36.697830	366	446	8	16	80	0.2000000
NODE_16910_length_698_cov_36.697830	366	446	10	44	80	0.5500000
NODE_16910_length_698_cov_36.697830	419	484	0	56	65	0.8615385
NODE_16910_length_698_cov_36.697830	419	484	7	2	65	0.0307692
NODE_16910_length_698_cov_36.697830	419	484	8	7	65	0.1076923
NODE_16911_length_698_cov_23.874791	222	302	0	23	80	0.2875000
NODE_16911_length_698_cov_23.874791	222	302	2	57	80	0.7125000
NODE_16911_length_698_cov_23.874791	275	355	0	17	80	0.2125000
NODE_16911_length_698_cov_23.874791	275	355	2	63	80	0.7875000
NODE_16912_length_698_cov_7.133556	360	440	0	74	80	0.9250000
NODE_16912_length_698_cov_7.133556	360	440	2	6	80	0.0750000
NODE_16912_length_698_cov_7.133556	413	493	0	21	80	0.2625000
NODE_16912_length_698_cov_7.133556	413	493	2	59	80	0.7375000
NODE_16913_length_698_cov_6.520868	267	347	0	80	80	1.0000000
NODE_16913_length_698_cov_6.520868	320	400	0	80	80	1.0000000
NODE_16917_length_698_cov_4.762938	329	359	0	30	30	1.0000000
NODE_16926_length_698_cov_2.577629	309	389	0	32	80	0.4000000
NODE_16926_length_698_cov_2.577629	309	389	2	48	80	0.6000000
NODE_16926_length_698_cov_2.577629	362	442	0	80	80	1.0000000
NODE_16962_length_697_cov_16.013378	305	385	0	80	80	1.0000000
NODE_16962_length_697_cov_16.013378	358	438	0	80	80	1.0000000
NODE_16963_length_697_cov_14.411371	440	520	0	17	80	0.2125000
NODE_16963_length_697_cov_14.411371	440	520	2	63	80	0.7875000
NODE_16963_length_697_cov_14.411371	493	573	0	23	80	0.2875000
NODE_16963_length_697_cov_14.411371	493	573	2	57	80	0.7125000
NODE_16964_length_697_cov_14.282609	257	354	0	16	97	0.1649484
NODE_16964_length_697_cov_14.282609	257	354	5	1	97	0.0103093
NODE_16964_length_697_cov_14.282609	257	354	6	80	97	0.8247423
NODE_16964_length_697_cov_14.282609	327	385	0	47	58	0.8103448
NODE_16964_length_697_cov_14.282609	327	385	5	1	58	0.0172414
NODE_16964_length_697_cov_14.282609	327	385	6	10	58	0.1724138
NODE_16965_length_697_cov_9.969900	360	440	0	23	80	0.2875000
NODE_16965_length_697_cov_9.969900	360	440	2	57	80	0.7125000
NODE_16965_length_697_cov_9.969900	413	493	2	80	80	1.0000000
NODE_16968_length_697_cov_6.117057	236	316	0	80	80	1.0000000
NODE_16968_length_697_cov_6.117057	289	369	0	80	80	1.0000000
NODE_17025_length_696_cov_28.360134	319	399	0	11	80	0.1375000
NODE_17025_length_696_cov_28.360134	319	399	2	69	80	0.8625000
NODE_17025_length_696_cov_28.360134	372	452	0	64	80	0.8000000
NODE_17025_length_696_cov_28.360134	372	452	2	16	80	0.2000000
NODE_17026_length_696_cov_18.708543	367	447	0	80	80	1.0000000
NODE_17026_length_696_cov_18.708543	420	500	0	80	80	1.0000000
NODE_17027_length_696_cov_18.170854	390	470	0	80	80	1.0000000
NODE_17027_length_696_cov_18.170854	443	523	0	80	80	1.0000000
NODE_17028_length_696_cov_13.738693	266	346	2	80	80	1.0000000
NODE_17028_length_696_cov_13.738693	319	399	0	43	80	0.5375000
NODE_17028_length_696_cov_13.738693	319	399	2	37	80	0.4625000
NODE_17030_length_696_cov_10.693467	239	266	0	27	27	1.0000000
NODE_17031_length_696_cov_9.949749	248	328	0	80	80	1.0000000
NODE_17031_length_696_cov_9.949749	301	381	0	80	80	1.0000000
NODE_17032_length_696_cov_8.658291	247	327	0	80	80	1.0000000
NODE_17032_length_696_cov_8.658291	300	380	0	80	80	1.0000000
NODE_17032_length_696_cov_8.658291	376	456	0	80	80	1.0000000
NODE_17032_length_696_cov_8.658291	429	509	0	80	80	1.0000000
NODE_17068_length_696_cov_1.675042	498	543	0	5	45	0.1111111
NODE_17068_length_696_cov_1.675042	498	543	4	40	45	0.8888889
NODE_17100_length_695_cov_24.112416	388	468	0	80	80	1.0000000
NODE_17100_length_695_cov_24.112416	441	521	0	80	80	1.0000000
NODE_17101_length_695_cov_12.152685	349	429	0	16	80	0.2000000
NODE_17101_length_695_cov_12.152685	349	429	2	64	80	0.8000000
NODE_17101_length_695_cov_12.152685	402	482	0	30	80	0.3750000
NODE_17101_length_695_cov_12.152685	402	482	2	50	80	0.6250000
NODE_17103_length_695_cov_8.466443	345	425	0	80	80	1.0000000
NODE_17103_length_695_cov_8.466443	398	478	0	80	80	1.0000000
NODE_17106_length_695_cov_5.661074	283	363	2	20	80	0.2500000
NODE_17106_length_695_cov_5.661074	283	363	4	1	80	0.0125000
NODE_17106_length_695_cov_5.661074	283	363	5	41	80	0.5125000
NODE_17106_length_695_cov_5.661074	283	363	6	18	80	0.2250000
NODE_17106_length_695_cov_5.661074	346	416	0	16	70	0.2285714
NODE_17106_length_695_cov_5.661074	346	416	2	17	70	0.2428571
NODE_17106_length_695_cov_5.661074	346	416	4	8	70	0.1142857
NODE_17106_length_695_cov_5.661074	346	416	6	29	70	0.4142857
NODE_17124_length_695_cov_2.050336	36	112	0	76	76	1.0000000
NODE_17161_length_694_cov_46.675630	30	110	0	80	80	1.0000000
NODE_17161_length_694_cov_46.675630	83	163	0	80	80	1.0000000
NODE_17161_length_694_cov_46.675630	159	239	0	80	80	1.0000000
NODE_17161_length_694_cov_46.675630	212	292	0	80	80	1.0000000
NODE_17162_length_694_cov_12.850420	326	406	0	80	80	1.0000000
NODE_17162_length_694_cov_12.850420	379	459	0	80	80	1.0000000
NODE_17163_length_694_cov_7.236975	318	396	0	78	78	1.0000000
NODE_17163_length_694_cov_7.236975	371	450	0	40	79	0.5063291
NODE_17163_length_694_cov_7.236975	371	450	2	39	79	0.4936709
NODE_17166_length_694_cov_5.554622	404	484	0	13	80	0.1625000
NODE_17166_length_694_cov_5.554622	404	484	2	67	80	0.8375000
NODE_17166_length_694_cov_5.554622	457	537	2	73	80	0.9125000
NODE_17166_length_694_cov_5.554622	457	537	4	7	80	0.0875000
NODE_17168_length_694_cov_5.373109	152	232	0	80	80	1.0000000
NODE_17168_length_694_cov_5.373109	205	285	0	80	80	1.0000000
NODE_17227_length_693_cov_26.616162	435	515	15	80	80	1.0000000
NODE_17227_length_693_cov_26.616162	488	568	0	45	80	0.5625000
NODE_17227_length_693_cov_26.616162	488	568	15	35	80	0.4375000
NODE_17228_length_693_cov_23.552189	193	273	2	7	80	0.0875000
NODE_17228_length_693_cov_23.552189	193	273	4	43	80	0.5375000
NODE_17228_length_693_cov_23.552189	193	273	6	30	80	0.3750000
NODE_17228_length_693_cov_23.552189	246	326	2	48	80	0.6000000
NODE_17228_length_693_cov_23.552189	246	326	3	4	80	0.0500000
NODE_17228_length_693_cov_23.552189	246	326	4	1	80	0.0125000
NODE_17228_length_693_cov_23.552189	246	326	5	7	80	0.0875000
NODE_17228_length_693_cov_23.552189	246	326	6	20	80	0.2500000
NODE_17229_length_693_cov_22.848485	231	311	0	8	80	0.1000000
NODE_17229_length_693_cov_22.848485	231	311	6	36	80	0.4500000
NODE_17229_length_693_cov_22.848485	231	311	14	36	80	0.4500000
NODE_17229_length_693_cov_22.848485	284	364	8	18	80	0.2250000
NODE_17229_length_693_cov_22.848485	284	364	14	62	80	0.7750000
NODE_17230_length_693_cov_13.616162	219	299	0	80	80	1.0000000
NODE_17230_length_693_cov_13.616162	272	352	0	80	80	1.0000000
NODE_17231_length_693_cov_12.382155	305	385	0	6	80	0.0750000
NODE_17231_length_693_cov_12.382155	305	385	2	3	80	0.0375000
NODE_17231_length_693_cov_12.382155	305	385	4	25	80	0.3125000
NODE_17231_length_693_cov_12.382155	305	385	5	2	80	0.0250000
NODE_17231_length_693_cov_12.382155	305	385	6	44	80	0.5500000
NODE_17231_length_693_cov_12.382155	358	424	2	42	66	0.6363636
NODE_17231_length_693_cov_12.382155	358	424	4	24	66	0.3636364
NODE_17232_length_693_cov_10.053872	279	359	0	9	80	0.1125000
NODE_17232_length_693_cov_10.053872	279	359	6	71	80	0.8875000
NODE_17232_length_693_cov_10.053872	332	412	0	19	80	0.2375000
NODE_17232_length_693_cov_10.053872	332	412	6	61	80	0.7625000
NODE_17233_length_693_cov_9.659933	247	327	0	39	80	0.4875000
NODE_17233_length_693_cov_9.659933	247	327	2	41	80	0.5125000
NODE_17233_length_693_cov_9.659933	300	380	0	80	80	1.0000000
NODE_17235_length_693_cov_8.077441	343	423	0	80	80	1.0000000
NODE_17235_length_693_cov_8.077441	396	476	0	80	80	1.0000000
NODE_17243_length_693_cov_3.680135	250	321	0	71	71	1.0000000
NODE_17280_length_692_cov_33.416526	462	542	0	50	80	0.6250000
NODE_17280_length_692_cov_33.416526	462	542	2	30	80	0.3750000
NODE_17280_length_692_cov_33.416526	515	595	0	12	80	0.1500000
NODE_17280_length_692_cov_33.416526	515	595	2	68	80	0.8500000
NODE_17281_length_692_cov_17.559865	291	371	0	80	80	1.0000000
NODE_17282_length_692_cov_15.070826	304	375	0	71	71	1.0000000
NODE_17283_length_692_cov_13.279933	308	388	0	80	80	1.0000000
NODE_17283_length_692_cov_13.279933	361	441	0	80	80	1.0000000
NODE_17285_length_692_cov_10.750422	317	397	0	80	80	1.0000000
NODE_17287_length_692_cov_7.497470	175	255	0	80	80	1.0000000
NODE_17287_length_692_cov_7.497470	228	312	0	84	84	1.0000000
NODE_17289_length_692_cov_7.370995	235	315	4	18	80	0.2250000
NODE_17289_length_692_cov_7.370995	235	315	7	2	80	0.0250000
NODE_17289_length_692_cov_7.370995	235	315	8	11	80	0.1375000
NODE_17289_length_692_cov_7.370995	235	315	10	45	80	0.5625000
NODE_17289_length_692_cov_7.370995	235	315	12	4	80	0.0500000
NODE_17289_length_692_cov_7.370995	288	369	8	23	81	0.2839506
NODE_17289_length_692_cov_7.370995	288	369	10	54	81	0.6666667
NODE_17289_length_692_cov_7.370995	288	369	12	4	81	0.0493827
NODE_17328_length_692_cov_1.514334	404	484	3	6	80	0.0750000
NODE_17328_length_692_cov_1.514334	404	484	5	17	80	0.2125000
NODE_17328_length_692_cov_1.514334	404	484	7	12	80	0.1500000
NODE_17328_length_692_cov_1.514334	404	484	8	9	80	0.1125000
NODE_17328_length_692_cov_1.514334	404	484	9	36	80	0.4500000
NODE_17350_length_691_cov_115.233108	276	356	0	37	80	0.4625000
NODE_17350_length_691_cov_115.233108	276	356	2	6	80	0.0750000
NODE_17350_length_691_cov_115.233108	276	356	16	37	80	0.4625000
NODE_17350_length_691_cov_115.233108	329	409	14	31	80	0.3875000
NODE_17350_length_691_cov_115.233108	329	409	16	46	80	0.5750000
NODE_17350_length_691_cov_115.233108	329	409	17	3	80	0.0375000
NODE_17350_length_691_cov_115.233108	405	485	14	1	80	0.0125000
NODE_17350_length_691_cov_115.233108	405	485	17	4	80	0.0500000
NODE_17350_length_691_cov_115.233108	405	485	18	17	80	0.2125000
NODE_17350_length_691_cov_115.233108	405	485	22	1	80	0.0125000
NODE_17350_length_691_cov_115.233108	405	485	24	6	80	0.0750000
NODE_17350_length_691_cov_115.233108	405	485	26	1	80	0.0125000
NODE_17350_length_691_cov_115.233108	405	485	28	2	80	0.0250000
NODE_17350_length_691_cov_115.233108	405	485	30	10	80	0.1250000
NODE_17350_length_691_cov_115.233108	405	485	32	3	80	0.0375000
NODE_17350_length_691_cov_115.233108	405	485	34	2	80	0.0250000
NODE_17350_length_691_cov_115.233108	405	485	35	1	80	0.0125000
NODE_17350_length_691_cov_115.233108	405	485	40	3	80	0.0375000
NODE_17350_length_691_cov_115.233108	405	485	42	2	80	0.0250000
NODE_17350_length_691_cov_115.233108	405	485	46	1	80	0.0125000
NODE_17350_length_691_cov_115.233108	405	485	48	1	80	0.0125000
NODE_17350_length_691_cov_115.233108	405	485	51	1	80	0.0125000
NODE_17350_length_691_cov_115.233108	405	485	52	2	80	0.0250000
NODE_17350_length_691_cov_115.233108	405	485	57	1	80	0.0125000
NODE_17350_length_691_cov_115.233108	405	485	58	4	80	0.0500000
NODE_17350_length_691_cov_115.233108	405	485	68	2	80	0.0250000
NODE_17350_length_691_cov_115.233108	405	485	74	3	80	0.0375000
NODE_17350_length_691_cov_115.233108	405	485	76	4	80	0.0500000
NODE_17350_length_691_cov_115.233108	405	485	77	1	80	0.0125000
NODE_17350_length_691_cov_115.233108	405	485	85	1	80	0.0125000
NODE_17350_length_691_cov_115.233108	405	485	87	6	80	0.0750000
NODE_17350_length_691_cov_115.233108	458	538	40	1	80	0.0125000
NODE_17350_length_691_cov_115.233108	458	538	48	1	80	0.0125000
NODE_17350_length_691_cov_115.233108	458	538	51	1	80	0.0125000
NODE_17350_length_691_cov_115.233108	458	538	52	2	80	0.0250000
NODE_17350_length_691_cov_115.233108	458	538	57	1	80	0.0125000
NODE_17350_length_691_cov_115.233108	458	538	58	4	80	0.0500000
NODE_17350_length_691_cov_115.233108	458	538	68	2	80	0.0250000
NODE_17350_length_691_cov_115.233108	458	538	74	3	80	0.0375000
NODE_17350_length_691_cov_115.233108	458	538	76	4	80	0.0500000
NODE_17350_length_691_cov_115.233108	458	538	77	1	80	0.0125000
NODE_17350_length_691_cov_115.233108	458	538	85	1	80	0.0125000
NODE_17350_length_691_cov_115.233108	458	538	87	22	80	0.2750000
NODE_17350_length_691_cov_115.233108	458	538	92	5	80	0.0625000
NODE_17350_length_691_cov_115.233108	458	538	93	11	80	0.1375000
NODE_17350_length_691_cov_115.233108	458	538	95	15	80	0.1875000
NODE_17350_length_691_cov_115.233108	458	538	96	1	80	0.0125000
NODE_17350_length_691_cov_115.233108	458	538	97	2	80	0.0250000
NODE_17350_length_691_cov_115.233108	458	538	98	2	80	0.0250000
NODE_17350_length_691_cov_115.233108	458	538	100	1	80	0.0125000
NODE_17351_length_691_cov_26.076014	188	268	0	80	80	1.0000000
NODE_17351_length_691_cov_26.076014	241	321	0	80	80	1.0000000
NODE_17352_length_691_cov_21.991554	288	368	0	80	80	1.0000000
NODE_17352_length_691_cov_21.991554	341	419	0	78	78	1.0000000
NODE_17353_length_691_cov_14.908784	226	306	0	80	80	1.0000000
NODE_17353_length_691_cov_14.908784	279	359	0	80	80	1.0000000
NODE_17358_length_691_cov_5.670608	325	402	0	55	77	0.7142857
NODE_17358_length_691_cov_5.670608	325	402	2	22	77	0.2857143
NODE_17358_length_691_cov_5.670608	375	455	0	5	80	0.0625000
NODE_17358_length_691_cov_5.670608	375	455	2	75	80	0.9375000
NODE_17361_length_691_cov_4.866554	103	183	0	26	80	0.3250000
NODE_17361_length_691_cov_4.866554	103	183	4	54	80	0.6750000
NODE_17361_length_691_cov_4.866554	156	236	0	10	80	0.1250000
NODE_17361_length_691_cov_4.866554	156	236	4	70	80	0.8750000
NODE_17367_length_691_cov_3.388514	304	384	0	72	80	0.9000000
NODE_17367_length_691_cov_3.388514	304	384	2	8	80	0.1000000
NODE_17367_length_691_cov_3.388514	357	437	0	19	80	0.2375000
NODE_17367_length_691_cov_3.388514	357	437	2	61	80	0.7625000
NODE_17415_length_690_cov_39.538071	563	612	0	49	49	1.0000000
NODE_17415_length_690_cov_39.538071	598	678	0	80	80	1.0000000
NODE_17415_length_690_cov_39.538071	651	690	0	39	39	1.0000000
NODE_17417_length_690_cov_30.336717	319	394	0	57	75	0.7600000
NODE_17417_length_690_cov_30.336717	319	394	2	18	75	0.2400000
NODE_17417_length_690_cov_30.336717	372	453	0	4	81	0.0493827
NODE_17417_length_690_cov_30.336717	372	453	2	77	81	0.9506173
NODE_17417_length_690_cov_30.336717	449	529	2	5	80	0.0625000
NODE_17417_length_690_cov_30.336717	449	529	4	68	80	0.8500000
NODE_17417_length_690_cov_30.336717	449	529	6	7	80	0.0875000
NODE_17417_length_690_cov_30.336717	502	582	0	37	80	0.4625000
NODE_17417_length_690_cov_30.336717	502	582	4	43	80	0.5375000
NODE_17418_length_690_cov_26.888325	270	350	0	80	80	1.0000000
NODE_17418_length_690_cov_26.888325	323	403	0	80	80	1.0000000
NODE_17419_length_690_cov_23.360406	131	211	0	80	80	1.0000000
NODE_17419_length_690_cov_23.360406	188	264	0	76	76	1.0000000
NODE_17420_length_690_cov_18.737733	316	396	0	48	80	0.6000000
NODE_17420_length_690_cov_18.737733	316	396	6	32	80	0.4000000
NODE_17420_length_690_cov_18.737733	369	449	6	80	80	1.0000000
NODE_17421_length_690_cov_16.593909	364	444	0	15	80	0.1875000
NODE_17421_length_690_cov_16.593909	364	444	1	36	80	0.4500000
NODE_17421_length_690_cov_16.593909	364	444	2	29	80	0.3625000
NODE_17421_length_690_cov_16.593909	417	497	1	14	80	0.1750000
NODE_17421_length_690_cov_16.593909	417	497	2	66	80	0.8250000
NODE_17422_length_690_cov_12.896785	320	400	0	80	80	1.0000000
NODE_17422_length_690_cov_12.896785	373	453	0	40	80	0.5000000
NODE_17422_length_690_cov_12.896785	373	453	2	40	80	0.5000000
NODE_17423_length_690_cov_10.818951	349	429	1	80	80	1.0000000
NODE_17424_length_690_cov_7.015228	273	353	0	3	80	0.0375000
NODE_17424_length_690_cov_7.015228	273	353	2	18	80	0.2250000
NODE_17424_length_690_cov_7.015228	273	353	4	59	80	0.7375000
NODE_17424_length_690_cov_7.015228	326	406	0	27	80	0.3375000
NODE_17424_length_690_cov_7.015228	326	406	2	47	80	0.5875000
NODE_17424_length_690_cov_7.015228	326	406	4	6	80	0.0750000
NODE_17429_length_690_cov_4.793570	316	365	169	1	49	0.0204082
NODE_17429_length_690_cov_4.793570	316	365	171	1	49	0.0204082
NODE_17429_length_690_cov_4.793570	316	365	173	3	49	0.0612245
NODE_17429_length_690_cov_4.793570	316	365	175	2	49	0.0408163
NODE_17429_length_690_cov_4.793570	316	365	177	3	49	0.0612245
NODE_17429_length_690_cov_4.793570	316	365	178	2	49	0.0408163
NODE_17429_length_690_cov_4.793570	316	365	179	1	49	0.0204082
NODE_17429_length_690_cov_4.793570	316	365	180	4	49	0.0816327
NODE_17429_length_690_cov_4.793570	316	365	182	1	49	0.0204082
NODE_17429_length_690_cov_4.793570	316	365	186	1	49	0.0204082
NODE_17429_length_690_cov_4.793570	316	365	194	1	49	0.0204082
NODE_17429_length_690_cov_4.793570	316	365	198	2	49	0.0408163
NODE_17429_length_690_cov_4.793570	316	365	201	1	49	0.0204082
NODE_17429_length_690_cov_4.793570	316	365	202	1	49	0.0204082
NODE_17429_length_690_cov_4.793570	316	365	203	1	49	0.0204082
NODE_17429_length_690_cov_4.793570	316	365	204	1	49	0.0204082
NODE_17429_length_690_cov_4.793570	316	365	207	1	49	0.0204082
NODE_17429_length_690_cov_4.793570	316	365	208	1	49	0.0204082
NODE_17429_length_690_cov_4.793570	316	365	209	1	49	0.0204082
NODE_17429_length_690_cov_4.793570	316	365	213	1	49	0.0204082
NODE_17429_length_690_cov_4.793570	316	365	214	5	49	0.1020408
NODE_17429_length_690_cov_4.793570	316	365	218	2	49	0.0408163
NODE_17429_length_690_cov_4.793570	316	365	220	1	49	0.0204082
NODE_17429_length_690_cov_4.793570	316	365	222	2	49	0.0408163
NODE_17429_length_690_cov_4.793570	316	365	223	5	49	0.1020408
NODE_17429_length_690_cov_4.793570	316	365	224	3	49	0.0612245
NODE_17429_length_690_cov_4.793570	316	365	225	1	49	0.0204082
NODE_17430_length_690_cov_4.717428	316	396	0	80	80	1.0000000
NODE_17430_length_690_cov_4.717428	369	449	0	80	80	1.0000000
NODE_17484_length_689_cov_45.984746	244	322	0	78	78	1.0000000
NODE_17484_length_689_cov_45.984746	297	377	0	80	80	1.0000000
NODE_17485_length_689_cov_35.705085	436	516	2	51	80	0.6375000
NODE_17485_length_689_cov_35.705085	436	516	4	29	80	0.3625000
NODE_17485_length_689_cov_35.705085	489	569	0	22	80	0.2750000
NODE_17485_length_689_cov_35.705085	489	569	2	29	80	0.3625000
NODE_17485_length_689_cov_35.705085	489	569	4	29	80	0.3625000
NODE_17486_length_689_cov_25.372881	211	291	0	45	80	0.5625000
NODE_17486_length_689_cov_25.372881	211	291	4	35	80	0.4375000
NODE_17486_length_689_cov_25.372881	264	344	2	8	80	0.1000000
NODE_17486_length_689_cov_25.372881	264	344	4	44	80	0.5500000
NODE_17486_length_689_cov_25.372881	264	344	6	28	80	0.3500000
NODE_17487_length_689_cov_20.138983	319	399	0	80	80	1.0000000
NODE_17487_length_689_cov_20.138983	372	452	0	80	80	1.0000000
NODE_17488_length_689_cov_14.377966	351	431	0	80	80	1.0000000
NODE_17488_length_689_cov_14.377966	404	484	0	80	80	1.0000000
NODE_17489_length_689_cov_9.477966	201	281	0	77	80	0.9625000
NODE_17489_length_689_cov_9.477966	201	281	2	3	80	0.0375000
NODE_17489_length_689_cov_9.477966	254	334	0	24	80	0.3000000
NODE_17489_length_689_cov_9.477966	254	334	2	56	80	0.7000000
NODE_17491_length_689_cov_7.367797	122	207	14	2	85	0.0235294
NODE_17491_length_689_cov_7.367797	122	207	16	2	85	0.0235294
NODE_17491_length_689_cov_7.367797	122	207	18	6	85	0.0705882
NODE_17491_length_689_cov_7.367797	122	207	20	65	85	0.7647059
NODE_17491_length_689_cov_7.367797	122	207	22	10	85	0.1176471
NODE_17492_length_689_cov_6.649153	242	322	0	17	80	0.2125000
NODE_17492_length_689_cov_6.649153	242	322	2	63	80	0.7875000
NODE_17492_length_689_cov_6.649153	295	375	0	5	80	0.0625000
NODE_17492_length_689_cov_6.649153	295	375	2	75	80	0.9375000
NODE_17504_length_689_cov_2.788136	128	208	0	80	80	1.0000000
NODE_17504_length_689_cov_2.788136	181	261	0	80	80	1.0000000
NODE_17548_length_688_cov_52.256367	198	278	0	52	80	0.6500000
NODE_17548_length_688_cov_52.256367	198	278	1	20	80	0.2500000
NODE_17548_length_688_cov_52.256367	198	278	2	8	80	0.1000000
NODE_17548_length_688_cov_52.256367	251	331	0	80	80	1.0000000
NODE_17549_length_688_cov_37.563667	373	453	0	80	80	1.0000000
NODE_17549_length_688_cov_37.563667	426	506	0	80	80	1.0000000
NODE_17549_length_688_cov_37.563667	514	594	2	1	80	0.0125000
NODE_17549_length_688_cov_37.563667	514	594	4	21	80	0.2625000
NODE_17549_length_688_cov_37.563667	514	594	6	13	80	0.1625000
NODE_17549_length_688_cov_37.563667	514	594	8	45	80	0.5625000
NODE_17549_length_688_cov_37.563667	514	594	2	1	80	0.0125000
NODE_17549_length_688_cov_37.563667	514	594	4	21	80	0.2625000
NODE_17549_length_688_cov_37.563667	514	594	6	13	80	0.1625000
NODE_17549_length_688_cov_37.563667	514	594	8	45	80	0.5625000
NODE_17549_length_688_cov_37.563667	514	584	2	1	70	0.0142857
NODE_17549_length_688_cov_37.563667	514	584	4	21	70	0.3000000
NODE_17549_length_688_cov_37.563667	514	584	6	13	70	0.1857143
NODE_17549_length_688_cov_37.563667	514	584	8	35	70	0.5000000
NODE_17549_length_688_cov_37.563667	567	647	6	45	80	0.5625000
NODE_17549_length_688_cov_37.563667	567	647	8	35	80	0.4375000
NODE_17549_length_688_cov_37.563667	567	646	6	44	79	0.5569620
NODE_17549_length_688_cov_37.563667	567	646	8	35	79	0.4430380
NODE_17550_length_688_cov_33.898132	373	453	0	80	80	1.0000000
NODE_17550_length_688_cov_33.898132	426	506	0	80	80	1.0000000
NODE_17551_length_688_cov_26.769100	457	537	0	80	80	1.0000000
NODE_17551_length_688_cov_26.769100	510	590	0	80	80	1.0000000
NODE_17552_length_688_cov_22.517827	332	412	0	70	80	0.8750000
NODE_17552_length_688_cov_22.517827	332	412	2	10	80	0.1250000
NODE_17552_length_688_cov_22.517827	385	465	0	17	80	0.2125000
NODE_17552_length_688_cov_22.517827	385	465	2	30	80	0.3750000
NODE_17552_length_688_cov_22.517827	385	465	4	33	80	0.4125000
NODE_17553_length_688_cov_16.796265	225	305	0	17	80	0.2125000
NODE_17553_length_688_cov_16.796265	225	305	2	28	80	0.3500000
NODE_17553_length_688_cov_16.796265	225	305	4	35	80	0.4375000
NODE_17553_length_688_cov_16.796265	278	358	2	59	80	0.7375000
NODE_17553_length_688_cov_16.796265	278	358	4	21	80	0.2625000
NODE_17555_length_688_cov_13.758913	378	458	0	47	80	0.5875000
NODE_17555_length_688_cov_13.758913	378	458	4	33	80	0.4125000
NODE_17555_length_688_cov_13.758913	431	511	0	80	80	1.0000000
NODE_17556_length_688_cov_12.511036	330	410	0	80	80	1.0000000
NODE_17556_length_688_cov_12.511036	383	463	0	80	80	1.0000000
NODE_17561_length_688_cov_5.446520	366	414	4	48	48	1.0000000
NODE_17567_length_688_cov_3.692699	265	345	0	80	80	1.0000000
NODE_17567_length_688_cov_3.692699	322	380	0	58	58	1.0000000
NODE_17621_length_687_cov_50.214286	430	510	0	80	80	1.0000000
NODE_17621_length_687_cov_50.214286	483	563	0	80	80	1.0000000
NODE_17622_length_687_cov_32.564626	204	284	0	13	80	0.1625000
NODE_17622_length_687_cov_32.564626	204	284	2	67	80	0.8375000
NODE_17622_length_687_cov_32.564626	257	337	0	35	80	0.4375000
NODE_17622_length_687_cov_32.564626	257	337	2	45	80	0.5625000
NODE_17623_length_687_cov_22.365646	231	311	0	14	80	0.1750000
NODE_17623_length_687_cov_22.365646	231	311	2	50	80	0.6250000
NODE_17623_length_687_cov_22.365646	231	311	4	16	80	0.2000000
NODE_17623_length_687_cov_22.365646	284	364	2	63	80	0.7875000
NODE_17623_length_687_cov_22.365646	284	364	4	17	80	0.2125000
NODE_17626_length_687_cov_11.943878	233	313	0	80	80	1.0000000
NODE_17626_length_687_cov_11.943878	286	366	0	80	80	1.0000000
NODE_17627_length_687_cov_7.865646	311	391	0	80	80	1.0000000
NODE_17627_length_687_cov_7.865646	364	444	0	80	80	1.0000000
NODE_17628_length_687_cov_7.353741	286	366	0	58	80	0.7250000
NODE_17628_length_687_cov_7.353741	286	366	2	22	80	0.2750000
NODE_17628_length_687_cov_7.353741	339	419	0	5	80	0.0625000
NODE_17628_length_687_cov_7.353741	339	419	2	75	80	0.9375000
NODE_17631_length_687_cov_5.903061	369	449	0	80	80	1.0000000
NODE_17631_length_687_cov_5.903061	422	502	0	80	80	1.0000000
NODE_17695_length_686_cov_34.642249	355	440	0	2	85	0.0235294
NODE_17695_length_686_cov_34.642249	355	440	4	83	85	0.9764706
NODE_17695_length_686_cov_34.642249	413	493	0	29	80	0.3625000
NODE_17695_length_686_cov_34.642249	413	493	4	51	80	0.6375000
NODE_17697_length_686_cov_26.357751	413	493	0	80	80	1.0000000
NODE_17697_length_686_cov_26.357751	466	546	0	80	80	1.0000000
NODE_17698_length_686_cov_16.715503	400	480	0	80	80	1.0000000
NODE_17698_length_686_cov_16.715503	453	533	0	80	80	1.0000000
NODE_17757_length_685_cov_8.769625	178	258	0	80	80	1.0000000
NODE_17757_length_685_cov_8.769625	222	250	0	28	28	1.0000000
NODE_17757_length_685_cov_8.769625	231	311	0	80	80	1.0000000
NODE_17764_length_685_cov_4.447099	249	329	0	12	80	0.1500000
NODE_17764_length_685_cov_4.447099	249	329	1	1	80	0.0125000
NODE_17764_length_685_cov_4.447099	249	329	2	67	80	0.8375000
NODE_17764_length_685_cov_4.447099	302	382	2	80	80	1.0000000
NODE_17768_length_685_cov_3.556314	338	418	0	80	80	1.0000000
NODE_17768_length_685_cov_3.556314	391	471	0	72	80	0.9000000
NODE_17768_length_685_cov_3.556314	391	471	1	8	80	0.1000000
NODE_17821_length_684_cov_7.521368	189	269	0	59	80	0.7375000
NODE_17821_length_684_cov_7.521368	189	269	2	21	80	0.2625000
NODE_17821_length_684_cov_7.521368	242	322	0	6	80	0.0750000
NODE_17821_length_684_cov_7.521368	242	322	2	74	80	0.9250000
NODE_17832_length_684_cov_3.639316	306	386	0	80	80	1.0000000
NODE_17832_length_684_cov_3.639316	359	439	0	80	80	1.0000000
NODE_17866_length_683_cov_27.493151	346	426	2	21	80	0.2625000
NODE_17866_length_683_cov_27.493151	346	426	4	18	80	0.2250000
NODE_17866_length_683_cov_27.493151	346	426	6	41	80	0.5125000
NODE_17866_length_683_cov_27.493151	399	479	0	11	80	0.1375000
NODE_17866_length_683_cov_27.493151	399	479	2	63	80	0.7875000
NODE_17866_length_683_cov_27.493151	399	479	6	6	80	0.0750000
NODE_17867_length_683_cov_12.880137	242	321	0	39	79	0.4936709
NODE_17867_length_683_cov_12.880137	242	321	2	40	79	0.5063291
NODE_17868_length_683_cov_11.772260	218	274	0	56	56	1.0000000
NODE_17868_length_683_cov_11.772260	247	333	0	86	86	1.0000000
NODE_17869_length_683_cov_9.936644	435	515	0	80	80	1.0000000
NODE_17869_length_683_cov_9.936644	488	568	0	80	80	1.0000000
NODE_17871_length_683_cov_9.017123	296	364	0	29	68	0.4264706
NODE_17871_length_683_cov_9.017123	296	364	2	39	68	0.5735294
NODE_17871_length_683_cov_9.017123	337	417	2	80	80	1.0000000
NODE_17873_length_683_cov_6.797945	359	415	2	7	56	0.1250000
NODE_17873_length_683_cov_6.797945	359	415	4	47	56	0.8392857
NODE_17873_length_683_cov_6.797945	359	415	6	2	56	0.0357143
NODE_17884_length_683_cov_3.176370	113	186	0	73	73	1.0000000
NODE_17947_length_682_cov_33.516295	423	503	0	80	80	1.0000000
NODE_17947_length_682_cov_33.516295	476	556	0	80	80	1.0000000
NODE_17948_length_682_cov_27.022298	479	559	0	14	80	0.1750000
NODE_17948_length_682_cov_27.022298	479	559	2	6	80	0.0750000
NODE_17948_length_682_cov_27.022298	479	559	4	4	80	0.0500000
NODE_17948_length_682_cov_27.022298	479	559	10	1	80	0.0125000
NODE_17948_length_682_cov_27.022298	479	559	12	29	80	0.3625000
NODE_17948_length_682_cov_27.022298	479	559	14	4	80	0.0500000
NODE_17948_length_682_cov_27.022298	479	559	16	8	80	0.1000000
NODE_17948_length_682_cov_27.022298	479	559	18	1	80	0.0125000
NODE_17948_length_682_cov_27.022298	479	559	20	1	80	0.0125000
NODE_17948_length_682_cov_27.022298	479	559	22	2	80	0.0250000
NODE_17948_length_682_cov_27.022298	479	559	24	6	80	0.0750000
NODE_17948_length_682_cov_27.022298	479	559	26	4	80	0.0500000
NODE_17948_length_682_cov_27.022298	532	612	12	1	80	0.0125000
NODE_17948_length_682_cov_27.022298	532	612	14	4	80	0.0500000
NODE_17948_length_682_cov_27.022298	532	612	16	8	80	0.1000000
NODE_17948_length_682_cov_27.022298	532	612	18	1	80	0.0125000
NODE_17948_length_682_cov_27.022298	532	612	20	1	80	0.0125000
NODE_17948_length_682_cov_27.022298	532	612	22	2	80	0.0250000
NODE_17948_length_682_cov_27.022298	532	612	24	6	80	0.0750000
NODE_17948_length_682_cov_27.022298	532	612	26	13	80	0.1625000
NODE_17948_length_682_cov_27.022298	532	612	28	2	80	0.0250000
NODE_17948_length_682_cov_27.022298	532	612	30	2	80	0.0250000
NODE_17948_length_682_cov_27.022298	532	612	32	4	80	0.0500000
NODE_17948_length_682_cov_27.022298	532	612	34	36	80	0.4500000
NODE_17949_length_682_cov_19.612350	434	514	0	2	80	0.0250000
NODE_17949_length_682_cov_19.612350	434	514	4	17	80	0.2125000
NODE_17949_length_682_cov_19.612350	434	514	8	15	80	0.1875000
NODE_17949_length_682_cov_19.612350	434	514	10	46	80	0.5750000
NODE_17949_length_682_cov_19.612350	487	567	0	16	80	0.2000000
NODE_17949_length_682_cov_19.612350	487	567	10	64	80	0.8000000
NODE_17950_length_682_cov_16.620926	261	341	0	80	80	1.0000000
NODE_17950_length_682_cov_16.620926	314	394	0	80	80	1.0000000
NODE_17951_length_682_cov_13.735849	251	331	0	80	80	1.0000000
NODE_17951_length_682_cov_13.735849	304	384	0	80	80	1.0000000
NODE_17952_length_682_cov_12.835334	228	308	0	39	80	0.4875000
NODE_17952_length_682_cov_12.835334	228	308	2	41	80	0.5125000
NODE_17952_length_682_cov_12.835334	281	361	0	33	80	0.4125000
NODE_17952_length_682_cov_12.835334	281	361	2	47	80	0.5875000
NODE_17956_length_682_cov_7.504288	224	304	0	80	80	1.0000000
NODE_17956_length_682_cov_7.504288	277	357	0	80	80	1.0000000
NODE_17960_length_682_cov_5.102916	314	351	0	37	37	1.0000000
NODE_17963_length_682_cov_4.579760	152	232	0	80	80	1.0000000
NODE_17963_length_682_cov_4.579760	205	285	0	80	80	1.0000000
NODE_17967_length_682_cov_4.006861	317	397	0	80	80	1.0000000
NODE_17967_length_682_cov_4.006861	370	450	0	80	80	1.0000000
NODE_17968_length_682_cov_3.859348	160	240	2	29	80	0.3625000
NODE_17968_length_682_cov_3.859348	160	240	6	51	80	0.6375000
NODE_17968_length_682_cov_3.859348	213	293	0	40	80	0.5000000
NODE_17968_length_682_cov_3.859348	213	293	1	11	80	0.1375000
NODE_17968_length_682_cov_3.859348	213	293	2	29	80	0.3625000
NODE_18010_length_681_cov_51.810997	181	261	2	80	80	1.0000000
NODE_18010_length_681_cov_51.810997	234	316	0	51	82	0.6219512
NODE_18010_length_681_cov_51.810997	234	316	2	31	82	0.3780488
NODE_18011_length_681_cov_32.128866	347	427	0	80	80	1.0000000
NODE_18011_length_681_cov_32.128866	400	475	0	75	75	1.0000000
NODE_18012_length_681_cov_19.079038	282	362	0	39	80	0.4875000
NODE_18012_length_681_cov_19.079038	282	362	2	41	80	0.5125000
NODE_18012_length_681_cov_19.079038	335	415	0	24	80	0.3000000
NODE_18012_length_681_cov_19.079038	335	415	2	56	80	0.7000000
NODE_18013_length_681_cov_17.053265	294	374	0	80	80	1.0000000
NODE_18013_length_681_cov_17.053265	347	427	0	80	80	1.0000000
NODE_18014_length_681_cov_11.183849	306	386	0	6	80	0.0750000
NODE_18014_length_681_cov_11.183849	306	386	2	74	80	0.9250000
NODE_18014_length_681_cov_11.183849	359	439	0	59	80	0.7375000
NODE_18014_length_681_cov_11.183849	359	439	2	21	80	0.2625000
NODE_18015_length_681_cov_8.065292	236	316	0	80	80	1.0000000
NODE_18015_length_681_cov_8.065292	289	369	0	80	80	1.0000000
NODE_18017_length_681_cov_6.888316	344	424	0	80	80	1.0000000
NODE_18017_length_681_cov_6.888316	397	477	0	80	80	1.0000000
NODE_18080_length_680_cov_35.695353	348	428	0	80	80	1.0000000
NODE_18080_length_680_cov_35.695353	401	481	0	80	80	1.0000000
NODE_18081_length_680_cov_17.500861	296	376	0	80	80	1.0000000
NODE_18081_length_680_cov_17.500861	349	429	0	80	80	1.0000000
NODE_18082_length_680_cov_16.685026	260	340	0	80	80	1.0000000
NODE_18082_length_680_cov_16.685026	313	393	0	80	80	1.0000000
NODE_18083_length_680_cov_15.345955	332	412	0	28	80	0.3500000
NODE_18083_length_680_cov_15.345955	332	412	2	52	80	0.6500000
NODE_18083_length_680_cov_15.345955	385	465	0	80	80	1.0000000
NODE_18089_length_680_cov_3.858864	458	538	0	80	80	1.0000000
NODE_18107_length_680_cov_1.879518	236	256	0	20	20	1.0000000
NODE_18146_length_679_cov_52.046552	367	447	0	80	80	1.0000000
NODE_18146_length_679_cov_52.046552	420	500	0	80	80	1.0000000
NODE_18147_length_679_cov_40.353448	179	259	0	80	80	1.0000000
NODE_18147_length_679_cov_40.353448	232	312	0	80	80	1.0000000
NODE_18148_length_679_cov_38.144828	364	428	0	8	64	0.1250000
NODE_18148_length_679_cov_38.144828	364	428	4	56	64	0.8750000
NODE_18148_length_679_cov_38.144828	401	481	0	38	80	0.4750000
NODE_18148_length_679_cov_38.144828	401	481	4	42	80	0.5250000
NODE_18149_length_679_cov_17.134483	277	357	0	37	80	0.4625000
NODE_18149_length_679_cov_17.134483	277	357	2	43	80	0.5375000
NODE_18149_length_679_cov_17.134483	330	410	0	80	80	1.0000000
NODE_18150_length_679_cov_15.046552	310	375	0	65	65	1.0000000
NODE_18151_length_679_cov_12.586207	247	327	0	15	80	0.1875000
NODE_18151_length_679_cov_12.586207	247	327	4	65	80	0.8125000
NODE_18151_length_679_cov_12.586207	303	381	0	17	78	0.2179487
NODE_18151_length_679_cov_12.586207	303	381	4	61	78	0.7820513
NODE_18152_length_679_cov_12.282759	337	417	0	80	80	1.0000000
NODE_18152_length_679_cov_12.282759	390	470	0	80	80	1.0000000
NODE_18153_length_679_cov_11.532759	205	285	0	30	80	0.3750000
NODE_18153_length_679_cov_11.532759	205	285	2	22	80	0.2750000
NODE_18153_length_679_cov_11.532759	205	285	3	1	80	0.0125000
NODE_18153_length_679_cov_11.532759	205	285	4	27	80	0.3375000
NODE_18153_length_679_cov_11.532759	258	338	2	21	80	0.2625000
NODE_18153_length_679_cov_11.532759	258	338	4	59	80	0.7375000
NODE_18155_length_679_cov_8.043103	269	341	0	72	72	1.0000000
NODE_18155_length_679_cov_8.043103	314	394	0	80	80	1.0000000
NODE_18156_length_679_cov_7.267241	191	271	0	24	80	0.3000000
NODE_18156_length_679_cov_7.267241	191	271	2	56	80	0.7000000
NODE_18156_length_679_cov_7.267241	244	324	0	31	80	0.3875000
NODE_18156_length_679_cov_7.267241	244	324	2	49	80	0.6125000
NODE_18162_length_679_cov_5.391379	279	331	4	25	52	0.4807692
NODE_18162_length_679_cov_5.391379	279	331	6	27	52	0.5192308
NODE_18164_length_679_cov_3.813793	10	69	3	3	59	0.0508475
NODE_18164_length_679_cov_3.813793	10	69	10	13	59	0.2203390
NODE_18164_length_679_cov_3.813793	10	69	11	1	59	0.0169492
NODE_18164_length_679_cov_3.813793	10	69	13	1	59	0.0169492
NODE_18164_length_679_cov_3.813793	10	69	14	4	59	0.0677966
NODE_18164_length_679_cov_3.813793	10	69	16	37	59	0.6271186
NODE_18164_length_679_cov_3.813793	48	122	2	12	74	0.1621622
NODE_18164_length_679_cov_3.813793	48	122	10	7	74	0.0945946
NODE_18164_length_679_cov_3.813793	48	122	12	12	74	0.1621622
NODE_18164_length_679_cov_3.813793	48	122	16	43	74	0.5810811
NODE_18217_length_678_cov_38.910190	252	332	0	31	80	0.3875000
NODE_18217_length_678_cov_38.910190	252	332	2	49	80	0.6125000
NODE_18217_length_678_cov_38.910190	305	385	2	39	80	0.4875000
NODE_18217_length_678_cov_38.910190	305	385	4	1	80	0.0125000
NODE_18217_length_678_cov_38.910190	305	385	6	40	80	0.5000000
NODE_18217_length_678_cov_38.910190	381	461	2	28	80	0.3500000
NODE_18217_length_678_cov_38.910190	381	461	4	15	80	0.1875000
NODE_18217_length_678_cov_38.910190	381	461	6	37	80	0.4625000
NODE_18217_length_678_cov_38.910190	434	514	0	20	80	0.2500000
NODE_18217_length_678_cov_38.910190	434	514	2	60	80	0.7500000
NODE_18218_length_678_cov_20.663212	243	323	0	58	80	0.7250000
NODE_18218_length_678_cov_20.663212	243	323	2	22	80	0.2750000
NODE_18218_length_678_cov_20.663212	296	376	0	5	80	0.0625000
NODE_18218_length_678_cov_20.663212	296	376	2	75	80	0.9375000
NODE_18219_length_678_cov_12.081174	243	323	0	80	80	1.0000000
NODE_18219_length_678_cov_12.081174	296	376	0	80	80	1.0000000
NODE_18224_length_678_cov_6.559585	195	264	0	41	69	0.5942029
NODE_18224_length_678_cov_6.559585	195	264	2	28	69	0.4057971
NODE_18224_length_678_cov_6.559585	237	317	0	6	80	0.0750000
NODE_18224_length_678_cov_6.559585	237	317	2	74	80	0.9250000
NODE_18228_length_678_cov_4.462867	133	213	0	80	80	1.0000000
NODE_18228_length_678_cov_4.462867	186	266	0	80	80	1.0000000
NODE_18239_length_678_cov_2.716753	351	431	0	80	80	1.0000000
NODE_18239_length_678_cov_2.716753	404	484	0	80	80	1.0000000
NODE_18289_length_677_cov_22.235294	274	354	0	80	80	1.0000000
NODE_18289_length_677_cov_22.235294	327	407	0	80	80	1.0000000
NODE_18290_length_677_cov_16.410035	124	206	0	16	82	0.1951219
NODE_18290_length_677_cov_16.410035	124	206	2	18	82	0.2195122
NODE_18290_length_677_cov_16.410035	124	206	4	48	82	0.5853658
NODE_18290_length_677_cov_16.410035	177	261	0	24	84	0.2857143
NODE_18290_length_677_cov_16.410035	177	261	2	24	84	0.2857143
NODE_18290_length_677_cov_16.410035	177	261	4	36	84	0.4285714
NODE_18291_length_677_cov_11.031142	393	473	0	80	80	1.0000000
NODE_18291_length_677_cov_11.031142	446	526	0	80	80	1.0000000
NODE_18292_length_677_cov_10.129758	258	338	2	15	80	0.1875000
NODE_18292_length_677_cov_10.129758	258	338	3	1	80	0.0125000
NODE_18292_length_677_cov_10.129758	258	338	4	64	80	0.8000000
NODE_18292_length_677_cov_10.129758	311	391	2	1	80	0.0125000
NODE_18292_length_677_cov_10.129758	311	391	3	53	80	0.6625000
NODE_18292_length_677_cov_10.129758	311	391	4	26	80	0.3250000
NODE_18295_length_677_cov_6.660900	217	297	30	2	80	0.0250000
NODE_18295_length_677_cov_6.660900	217	297	34	3	80	0.0375000
NODE_18295_length_677_cov_6.660900	217	297	38	1	80	0.0125000
NODE_18295_length_677_cov_6.660900	217	297	41	1	80	0.0125000
NODE_18295_length_677_cov_6.660900	217	297	42	14	80	0.1750000
NODE_18295_length_677_cov_6.660900	217	297	44	9	80	0.1125000
NODE_18295_length_677_cov_6.660900	217	297	46	50	80	0.6250000
NODE_18297_length_677_cov_5.228374	366	446	0	80	80	1.0000000
NODE_18312_length_677_cov_2.306228	230	278	0	48	48	1.0000000
NODE_18329_length_677_cov_1.709343	369	449	0	39	80	0.4875000
NODE_18329_length_677_cov_1.709343	369	449	2	6	80	0.0750000
NODE_18329_length_677_cov_1.709343	369	449	4	35	80	0.4375000
NODE_18329_length_677_cov_1.709343	422	502	2	5	80	0.0625000
NODE_18329_length_677_cov_1.709343	422	502	4	75	80	0.9375000
NODE_18368_length_676_cov_66.473137	286	366	0	80	80	1.0000000
NODE_18368_length_676_cov_66.473137	339	419	0	44	80	0.5500000
NODE_18368_length_676_cov_66.473137	339	419	8	2	80	0.0250000
NODE_18368_length_676_cov_66.473137	339	419	14	2	80	0.0250000
NODE_18368_length_676_cov_66.473137	339	419	15	2	80	0.0250000
NODE_18368_length_676_cov_66.473137	339	419	17	1	80	0.0125000
NODE_18368_length_676_cov_66.473137	339	419	20	1	80	0.0125000
NODE_18368_length_676_cov_66.473137	339	419	22	1	80	0.0125000
NODE_18368_length_676_cov_66.473137	339	419	23	1	80	0.0125000
NODE_18368_length_676_cov_66.473137	339	419	26	1	80	0.0125000
NODE_18368_length_676_cov_66.473137	339	419	28	1	80	0.0125000
NODE_18368_length_676_cov_66.473137	339	419	30	2	80	0.0250000
NODE_18368_length_676_cov_66.473137	339	419	32	1	80	0.0125000
NODE_18368_length_676_cov_66.473137	339	419	34	9	80	0.1125000
NODE_18368_length_676_cov_66.473137	339	419	35	6	80	0.0750000
NODE_18368_length_676_cov_66.473137	339	419	39	6	80	0.0750000
NODE_18368_length_676_cov_66.473137	383	419	8	2	36	0.0555556
NODE_18368_length_676_cov_66.473137	383	419	14	2	36	0.0555556
NODE_18368_length_676_cov_66.473137	383	419	15	2	36	0.0555556
NODE_18368_length_676_cov_66.473137	383	419	17	1	36	0.0277778
NODE_18368_length_676_cov_66.473137	383	419	20	1	36	0.0277778
NODE_18368_length_676_cov_66.473137	383	419	22	1	36	0.0277778
NODE_18368_length_676_cov_66.473137	383	419	23	1	36	0.0277778
NODE_18368_length_676_cov_66.473137	383	419	26	1	36	0.0277778
NODE_18368_length_676_cov_66.473137	383	419	28	1	36	0.0277778
NODE_18368_length_676_cov_66.473137	383	419	30	2	36	0.0555556
NODE_18368_length_676_cov_66.473137	383	419	32	1	36	0.0277778
NODE_18368_length_676_cov_66.473137	383	419	34	9	36	0.2500000
NODE_18368_length_676_cov_66.473137	383	419	35	6	36	0.1666667
NODE_18368_length_676_cov_66.473137	383	419	39	6	36	0.1666667
NODE_18368_length_676_cov_66.473137	383	419	8	2	36	0.0555556
NODE_18368_length_676_cov_66.473137	383	419	14	2	36	0.0555556
NODE_18368_length_676_cov_66.473137	383	419	15	2	36	0.0555556
NODE_18368_length_676_cov_66.473137	383	419	17	1	36	0.0277778
NODE_18368_length_676_cov_66.473137	383	419	20	1	36	0.0277778
NODE_18368_length_676_cov_66.473137	383	419	22	1	36	0.0277778
NODE_18368_length_676_cov_66.473137	383	419	23	1	36	0.0277778
NODE_18368_length_676_cov_66.473137	383	419	26	1	36	0.0277778
NODE_18368_length_676_cov_66.473137	383	419	28	1	36	0.0277778
NODE_18368_length_676_cov_66.473137	383	419	30	2	36	0.0555556
NODE_18368_length_676_cov_66.473137	383	419	32	1	36	0.0277778
NODE_18368_length_676_cov_66.473137	383	419	34	9	36	0.2500000
NODE_18368_length_676_cov_66.473137	383	419	35	6	36	0.1666667
NODE_18368_length_676_cov_66.473137	383	419	39	6	36	0.1666667
NODE_18368_length_676_cov_66.473137	398	419	34	9	21	0.4285714
NODE_18368_length_676_cov_66.473137	398	419	35	6	21	0.2857143
NODE_18368_length_676_cov_66.473137	398	419	39	6	21	0.2857143
NODE_18369_length_676_cov_14.429809	259	330	0	71	71	1.0000000
NODE_18370_length_676_cov_13.882149	292	372	0	80	80	1.0000000
NODE_18370_length_676_cov_13.882149	345	425	0	80	80	1.0000000
NODE_18374_length_676_cov_7.225303	363	443	0	80	80	1.0000000
NODE_18374_length_676_cov_7.225303	416	496	0	80	80	1.0000000
NODE_18375_length_676_cov_6.740035	373	433	0	60	60	1.0000000
NODE_18375_length_676_cov_6.740035	406	486	0	80	80	1.0000000
NODE_18378_length_676_cov_4.658579	167	240	0	73	73	1.0000000
NODE_18397_length_676_cov_2.292894	146	226	2	80	80	1.0000000
NODE_18401_length_676_cov_2.157712	175	226	0	51	51	1.0000000
NODE_18417_length_676_cov_1.547660	133	164	2	31	31	1.0000000
NODE_18447_length_675_cov_27.574653	190	270	0	80	80	1.0000000
NODE_18447_length_675_cov_27.574653	243	323	0	80	80	1.0000000
NODE_18448_length_675_cov_11.895833	336	416	0	13	80	0.1625000
NODE_18448_length_675_cov_11.895833	336	416	2	67	80	0.8375000
NODE_18448_length_675_cov_11.895833	389	469	0	41	80	0.5125000
NODE_18448_length_675_cov_11.895833	389	469	2	39	80	0.4875000
NODE_18449_length_675_cov_8.157986	414	494	0	31	80	0.3875000
NODE_18449_length_675_cov_8.157986	414	494	2	49	80	0.6125000
NODE_18449_length_675_cov_8.157986	467	547	2	80	80	1.0000000
NODE_18450_length_675_cov_8.026042	320	400	2	25	80	0.3125000
NODE_18450_length_675_cov_8.026042	320	400	4	29	80	0.3625000
NODE_18450_length_675_cov_8.026042	320	400	6	26	80	0.3250000
NODE_18450_length_675_cov_8.026042	373	453	2	78	80	0.9750000
NODE_18450_length_675_cov_8.026042	373	453	6	2	80	0.0250000
NODE_18451_length_675_cov_7.277778	317	397	0	80	80	1.0000000
NODE_18455_length_675_cov_5.666667	142	222	0	80	80	1.0000000
NODE_18455_length_675_cov_5.666667	195	275	0	80	80	1.0000000
NODE_18464_length_675_cov_2.751736	67	122	0	33	55	0.6000000
NODE_18464_length_675_cov_2.751736	67	122	2	22	55	0.4000000
NODE_18467_length_675_cov_2.623264	251	289	0	38	38	1.0000000
NODE_18467_length_675_cov_2.623264	279	343	0	64	64	1.0000000
NODE_18467_length_675_cov_2.623264	432	494	0	62	62	1.0000000
NODE_18515_length_674_cov_38.401739	225	305	0	80	80	1.0000000
NODE_18515_length_674_cov_38.401739	278	358	0	80	80	1.0000000
NODE_18516_length_674_cov_30.215652	519	599	36	1	80	0.0125000
NODE_18516_length_674_cov_30.215652	519	599	38	9	80	0.1125000
NODE_18516_length_674_cov_30.215652	519	599	42	2	80	0.0250000
NODE_18516_length_674_cov_30.215652	519	599	43	1	80	0.0125000
NODE_18516_length_674_cov_30.215652	519	599	44	8	80	0.1000000
NODE_18516_length_674_cov_30.215652	519	599	46	10	80	0.1250000
NODE_18516_length_674_cov_30.215652	519	599	48	12	80	0.1500000
NODE_18516_length_674_cov_30.215652	519	599	50	5	80	0.0625000
NODE_18516_length_674_cov_30.215652	519	599	52	1	80	0.0125000
NODE_18516_length_674_cov_30.215652	519	599	54	7	80	0.0875000
NODE_18516_length_674_cov_30.215652	519	599	56	24	80	0.3000000
NODE_18516_length_674_cov_30.215652	572	602	32	3	30	0.1000000
NODE_18516_length_674_cov_30.215652	572	602	38	4	30	0.1333333
NODE_18516_length_674_cov_30.215652	572	602	43	1	30	0.0333333
NODE_18516_length_674_cov_30.215652	572	602	44	8	30	0.2666667
NODE_18516_length_674_cov_30.215652	572	602	46	2	30	0.0666667
NODE_18516_length_674_cov_30.215652	572	602	48	2	30	0.0666667
NODE_18516_length_674_cov_30.215652	572	602	54	6	30	0.2000000
NODE_18516_length_674_cov_30.215652	572	602	56	4	30	0.1333333
NODE_18517_length_674_cov_19.636522	283	363	0	10	80	0.1250000
NODE_18517_length_674_cov_19.636522	283	363	4	26	80	0.3250000
NODE_18517_length_674_cov_19.636522	283	363	6	44	80	0.5500000
NODE_18517_length_674_cov_19.636522	336	416	0	10	80	0.1250000
NODE_18517_length_674_cov_19.636522	336	416	2	28	80	0.3500000
NODE_18517_length_674_cov_19.636522	336	416	6	42	80	0.5250000
NODE_18518_length_674_cov_19.436522	81	161	0	80	80	1.0000000
NODE_18518_length_674_cov_19.436522	134	214	0	80	80	1.0000000
NODE_18519_length_674_cov_16.819130	185	265	6	22	80	0.2750000
NODE_18519_length_674_cov_16.819130	185	265	8	5	80	0.0625000
NODE_18519_length_674_cov_16.819130	185	265	10	2	80	0.0250000
NODE_18519_length_674_cov_16.819130	185	265	12	20	80	0.2500000
NODE_18519_length_674_cov_16.819130	185	265	16	2	80	0.0250000
NODE_18519_length_674_cov_16.819130	185	265	18	29	80	0.3625000
NODE_18519_length_674_cov_16.819130	238	318	8	12	80	0.1500000
NODE_18519_length_674_cov_16.819130	238	318	10	7	80	0.0875000
NODE_18519_length_674_cov_16.819130	238	318	16	36	80	0.4500000
NODE_18519_length_674_cov_16.819130	238	318	18	25	80	0.3125000
NODE_18520_length_674_cov_14.733913	169	249	0	17	80	0.2125000
NODE_18520_length_674_cov_14.733913	169	249	2	21	80	0.2625000
NODE_18520_length_674_cov_14.733913	169	249	4	16	80	0.2000000
NODE_18520_length_674_cov_14.733913	169	249	8	26	80	0.3250000
NODE_18520_length_674_cov_14.733913	222	302	4	1	80	0.0125000
NODE_18520_length_674_cov_14.733913	222	302	8	79	80	0.9875000
NODE_18524_length_674_cov_7.086957	357	437	0	80	80	1.0000000
NODE_18524_length_674_cov_7.086957	410	490	0	80	80	1.0000000
NODE_18528_length_674_cov_4.808696	262	342	2	9	80	0.1125000
NODE_18528_length_674_cov_4.808696	262	342	4	45	80	0.5625000
NODE_18528_length_674_cov_4.808696	262	342	6	26	80	0.3250000
NODE_18528_length_674_cov_4.808696	315	395	0	13	80	0.1625000
NODE_18528_length_674_cov_4.808696	315	395	2	14	80	0.1750000
NODE_18528_length_674_cov_4.808696	315	395	4	35	80	0.4375000
NODE_18528_length_674_cov_4.808696	315	395	6	18	80	0.2250000
NODE_18592_length_673_cov_47.109756	405	485	2	80	80	1.0000000
NODE_18592_length_673_cov_47.109756	458	538	0	21	80	0.2625000
NODE_18592_length_673_cov_47.109756	458	538	2	59	80	0.7375000
NODE_18593_length_673_cov_20.548780	214	294	0	80	80	1.0000000
NODE_18593_length_673_cov_20.548780	267	347	0	80	80	1.0000000
NODE_18596_length_673_cov_8.306620	337	426	0	48	89	0.5393258
NODE_18596_length_673_cov_8.306620	337	426	2	41	89	0.4606742
NODE_18607_length_673_cov_3.041812	196	276	2	25	80	0.3125000
NODE_18607_length_673_cov_3.041812	196	276	6	55	80	0.6875000
NODE_18607_length_673_cov_3.041812	249	329	0	33	80	0.4125000
NODE_18607_length_673_cov_3.041812	249	329	4	17	80	0.2125000
NODE_18607_length_673_cov_3.041812	249	329	6	30	80	0.3750000
NODE_18660_length_672_cov_15.380454	282	362	0	80	80	1.0000000
NODE_18660_length_672_cov_15.380454	335	415	0	80	80	1.0000000
NODE_18661_length_672_cov_9.902269	328	408	0	18	80	0.2250000
NODE_18661_length_672_cov_9.902269	328	408	2	62	80	0.7750000
NODE_18661_length_672_cov_9.902269	381	461	0	71	80	0.8875000
NODE_18661_length_672_cov_9.902269	381	461	2	9	80	0.1125000
NODE_18662_length_672_cov_9.462478	309	389	0	16	80	0.2000000
NODE_18662_length_672_cov_9.462478	309	389	4	64	80	0.8000000
NODE_18662_length_672_cov_9.462478	362	442	0	69	80	0.8625000
NODE_18662_length_672_cov_9.462478	362	442	4	11	80	0.1375000
NODE_18666_length_672_cov_6.516579	354	434	0	80	80	1.0000000
NODE_18666_length_672_cov_6.516579	407	487	0	80	80	1.0000000
NODE_18668_length_672_cov_6.108202	135	215	0	80	80	1.0000000
NODE_18668_length_672_cov_6.108202	188	268	0	80	80	1.0000000
NODE_18670_length_672_cov_4.949389	115	152	0	37	37	1.0000000
NODE_18670_length_672_cov_4.949389	125	205	0	80	80	1.0000000
NODE_18670_length_672_cov_4.949389	278	326	4	48	48	1.0000000
NODE_18672_length_672_cov_4.753927	378	450	0	5	72	0.0694444
NODE_18672_length_672_cov_4.753927	378	450	2	67	72	0.9305556
NODE_18704_length_672_cov_1.713787	340	401	0	61	61	1.0000000
NODE_18742_length_671_cov_28.874126	306	387	0	7	81	0.0864198
NODE_18742_length_671_cov_28.874126	306	387	2	16	81	0.1975309
NODE_18742_length_671_cov_28.874126	306	387	4	58	81	0.7160494
NODE_18742_length_671_cov_28.874126	360	440	0	19	80	0.2375000
NODE_18742_length_671_cov_28.874126	360	440	2	2	80	0.0250000
NODE_18742_length_671_cov_28.874126	360	440	4	59	80	0.7375000
NODE_18744_length_671_cov_18.526224	294	333	0	39	39	1.0000000
NODE_18744_length_671_cov_18.526224	331	404	0	20	73	0.2739726
NODE_18744_length_671_cov_18.526224	331	404	2	53	73	0.7260274
NODE_18744_length_671_cov_18.526224	331	351	0	20	20	1.0000000
NODE_18745_length_671_cov_16.094406	417	497	0	56	80	0.7000000
NODE_18745_length_671_cov_16.094406	417	497	2	24	80	0.3000000
NODE_18745_length_671_cov_16.094406	470	550	0	3	80	0.0375000
NODE_18745_length_671_cov_16.094406	470	550	2	77	80	0.9625000
NODE_18746_length_671_cov_11.756993	337	417	0	80	80	1.0000000
NODE_18746_length_671_cov_11.756993	390	470	0	80	80	1.0000000
NODE_18747_length_671_cov_9.237762	305	382	0	77	77	1.0000000
NODE_18748_length_671_cov_8.491259	298	379	2	70	81	0.8641976
NODE_18748_length_671_cov_8.491259	298	379	6	11	81	0.1358025
NODE_18748_length_671_cov_8.491259	352	430	2	16	78	0.2051282
NODE_18748_length_671_cov_8.491259	352	430	4	29	78	0.3717949
NODE_18748_length_671_cov_8.491259	352	430	6	33	78	0.4230769
NODE_18749_length_671_cov_8.241259	97	128	0	31	31	1.0000000
NODE_18752_length_671_cov_7.201049	368	448	0	80	80	1.0000000
NODE_18752_length_671_cov_7.201049	421	501	0	80	80	1.0000000
NODE_18753_length_671_cov_5.680070	370	450	1	15	80	0.1875000
NODE_18753_length_671_cov_5.680070	370	450	2	65	80	0.8125000
NODE_18753_length_671_cov_5.680070	423	503	1	68	80	0.8500000
NODE_18753_length_671_cov_5.680070	423	503	2	12	80	0.1500000
NODE_18754_length_671_cov_4.769231	362	414	0	52	52	1.0000000
NODE_18760_length_671_cov_3.804196	360	440	2	18	80	0.2250000
NODE_18760_length_671_cov_3.804196	360	440	6	7	80	0.0875000
NODE_18760_length_671_cov_3.804196	360	440	10	16	80	0.2000000
NODE_18760_length_671_cov_3.804196	360	440	12	39	80	0.4875000
NODE_18812_length_670_cov_21.017513	443	523	0	10	80	0.1250000
NODE_18812_length_670_cov_21.017513	443	523	2	70	80	0.8750000
NODE_18812_length_670_cov_21.017513	496	576	0	63	80	0.7875000
NODE_18812_length_670_cov_21.017513	496	576	2	17	80	0.2125000
NODE_18813_length_670_cov_20.346760	372	452	0	8	80	0.1000000
NODE_18813_length_670_cov_20.346760	372	452	2	9	80	0.1125000
NODE_18813_length_670_cov_20.346760	372	452	5	63	80	0.7875000
NODE_18813_length_670_cov_20.346760	425	505	3	41	80	0.5125000
NODE_18813_length_670_cov_20.346760	425	505	5	39	80	0.4875000
NODE_18814_length_670_cov_15.728546	157	237	0	80	80	1.0000000
NODE_18814_length_670_cov_15.728546	210	290	0	80	80	1.0000000
NODE_18814_length_670_cov_15.728546	286	366	0	80	80	1.0000000
NODE_18814_length_670_cov_15.728546	339	419	0	80	80	1.0000000
NODE_18818_length_670_cov_6.499124	390	470	0	80	80	1.0000000
NODE_18834_length_670_cov_3.099825	159	217	0	58	58	1.0000000
NODE_18838_length_670_cov_2.700525	252	332	0	80	80	1.0000000
NODE_18838_length_670_cov_2.700525	305	385	0	78	80	0.9750000
NODE_18838_length_670_cov_2.700525	305	385	2	2	80	0.0250000
NODE_18883_length_669_cov_13.307018	432	512	0	80	80	1.0000000
NODE_18883_length_669_cov_13.307018	485	565	0	80	80	1.0000000
NODE_18886_length_669_cov_6.921053	245	325	2	11	80	0.1375000
NODE_18886_length_669_cov_6.921053	245	325	3	34	80	0.4250000
NODE_18886_length_669_cov_6.921053	245	325	5	35	80	0.4375000
NODE_18886_length_669_cov_6.921053	298	370	0	19	72	0.2638889
NODE_18886_length_669_cov_6.921053	298	370	2	37	72	0.5138889
NODE_18886_length_669_cov_6.921053	298	370	3	16	72	0.2222222
NODE_18901_length_669_cov_3.633333	277	347	0	32	70	0.4571429
NODE_18901_length_669_cov_3.633333	277	347	2	38	70	0.5428572
NODE_18909_length_669_cov_2.361404	434	490	0	56	56	1.0000000
NODE_18958_length_668_cov_23.131810	275	355	0	33	80	0.4125000
NODE_18958_length_668_cov_23.131810	275	355	3	47	80	0.5875000
NODE_18958_length_668_cov_23.131810	328	408	0	2	80	0.0250000
NODE_18958_length_668_cov_23.131810	328	408	3	78	80	0.9750000
NODE_18959_length_668_cov_14.978910	324	404	0	80	80	1.0000000
NODE_18959_length_668_cov_14.978910	377	457	0	80	80	1.0000000
NODE_18962_length_668_cov_11.184534	187	267	0	15	80	0.1875000
NODE_18962_length_668_cov_11.184534	187	267	2	65	80	0.8125000
NODE_18962_length_668_cov_11.184534	240	320	0	68	80	0.8500000
NODE_18962_length_668_cov_11.184534	240	320	2	12	80	0.1500000
NODE_18963_length_668_cov_10.548330	211	291	0	80	80	1.0000000
NODE_18963_length_668_cov_10.548330	264	344	0	80	80	1.0000000
NODE_18964_length_668_cov_10.370826	226	308	0	43	82	0.5243902
NODE_18964_length_668_cov_10.370826	226	308	2	4	82	0.0487805
NODE_18964_length_668_cov_10.370826	226	308	9	1	82	0.0121951
NODE_18964_length_668_cov_10.370826	226	308	10	33	82	0.4024390
NODE_18964_length_668_cov_10.370826	226	308	12	1	82	0.0121951
NODE_18964_length_668_cov_10.370826	279	361	10	28	82	0.3414634
NODE_18964_length_668_cov_10.370826	279	361	11	12	82	0.1463415
NODE_18964_length_668_cov_10.370826	279	361	12	42	82	0.5121951
NODE_18965_length_668_cov_10.223199	238	318	0	80	80	1.0000000
NODE_18965_length_668_cov_10.223199	291	371	0	80	80	1.0000000
NODE_18967_length_668_cov_9.340949	310	390	0	80	80	1.0000000
NODE_18967_length_668_cov_9.340949	363	443	0	80	80	1.0000000
NODE_18975_length_668_cov_4.077329	304	384	2	21	80	0.2625000
NODE_18975_length_668_cov_4.077329	304	384	4	59	80	0.7375000
NODE_18975_length_668_cov_4.077329	338	367	2	4	29	0.1379310
NODE_18975_length_668_cov_4.077329	338	367	4	25	29	0.8620690
NODE_18975_length_668_cov_4.077329	358	427	0	2	69	0.0289855
NODE_18975_length_668_cov_4.077329	358	427	2	62	69	0.8985507
NODE_18975_length_668_cov_4.077329	358	427	4	5	69	0.0724638
NODE_19032_length_667_cov_33.848592	168	248	0	69	80	0.8625000
NODE_19032_length_667_cov_33.848592	168	248	2	11	80	0.1375000
NODE_19032_length_667_cov_33.848592	221	301	0	80	80	1.0000000
NODE_19033_length_667_cov_21.218310	270	350	0	41	80	0.5125000
NODE_19033_length_667_cov_21.218310	270	350	4	39	80	0.4875000
NODE_19033_length_667_cov_21.218310	323	403	0	9	80	0.1125000
NODE_19033_length_667_cov_21.218310	323	403	4	71	80	0.8875000
NODE_19034_length_667_cov_19.204225	258	338	0	4	80	0.0500000
NODE_19034_length_667_cov_19.204225	258	338	2	76	80	0.9500000
NODE_19034_length_667_cov_19.204225	311	391	2	80	80	1.0000000
NODE_19036_length_667_cov_8.264085	299	379	0	80	80	1.0000000
NODE_19036_length_667_cov_8.264085	352	432	0	80	80	1.0000000
NODE_19037_length_667_cov_8.248239	76	156	0	80	80	1.0000000
NODE_19037_length_667_cov_8.248239	129	209	0	80	80	1.0000000
NODE_19038_length_667_cov_8.207746	257	323	0	66	66	1.0000000
NODE_19038_length_667_cov_8.207746	296	376	0	80	80	1.0000000
NODE_19039_length_667_cov_7.232394	357	437	0	80	80	1.0000000
NODE_19039_length_667_cov_7.232394	410	490	0	40	80	0.5000000
NODE_19039_length_667_cov_7.232394	410	490	2	40	80	0.5000000
NODE_19042_length_667_cov_4.941901	199	279	0	34	80	0.4250000
NODE_19042_length_667_cov_4.941901	199	279	4	46	80	0.5750000
NODE_19042_length_667_cov_4.941901	252	332	0	11	80	0.1375000
NODE_19042_length_667_cov_4.941901	252	332	4	69	80	0.8625000
NODE_19053_length_667_cov_3.404930	501	536	0	18	35	0.5142857
NODE_19053_length_667_cov_3.404930	501	536	2	17	35	0.4857143
NODE_19053_length_667_cov_3.404930	503	533	0	16	30	0.5333334
NODE_19053_length_667_cov_3.404930	503	533	2	14	30	0.4666667
NODE_19100_length_666_cov_24.811287	179	254	5	1	75	0.0133333
NODE_19100_length_666_cov_24.811287	179	254	6	74	75	0.9866667
NODE_19100_length_666_cov_24.811287	182	254	5	1	72	0.0138889
NODE_19100_length_666_cov_24.811287	182	254	6	71	72	0.9861111
NODE_19100_length_666_cov_24.811287	227	307	0	35	80	0.4375000
NODE_19100_length_666_cov_24.811287	227	307	1	14	80	0.1750000
NODE_19100_length_666_cov_24.811287	227	307	5	5	80	0.0625000
NODE_19100_length_666_cov_24.811287	227	307	6	26	80	0.3250000
NODE_19100_length_666_cov_24.811287	227	307	0	35	80	0.4375000
NODE_19100_length_666_cov_24.811287	227	307	1	14	80	0.1750000
NODE_19100_length_666_cov_24.811287	227	307	5	5	80	0.0625000
NODE_19100_length_666_cov_24.811287	227	307	6	26	80	0.3250000
NODE_19100_length_666_cov_24.811287	303	383	0	12	80	0.1500000
NODE_19100_length_666_cov_24.811287	303	383	33	1	80	0.0125000
NODE_19100_length_666_cov_24.811287	303	383	36	2	80	0.0250000
NODE_19100_length_666_cov_24.811287	303	383	37	2	80	0.0250000
NODE_19100_length_666_cov_24.811287	303	383	38	2	80	0.0250000
NODE_19100_length_666_cov_24.811287	303	383	61	5	80	0.0625000
NODE_19100_length_666_cov_24.811287	303	383	71	12	80	0.1500000
NODE_19100_length_666_cov_24.811287	303	383	72	1	80	0.0125000
NODE_19100_length_666_cov_24.811287	303	383	83	2	80	0.0250000
NODE_19100_length_666_cov_24.811287	303	383	84	5	80	0.0625000
NODE_19100_length_666_cov_24.811287	303	383	87	2	80	0.0250000
NODE_19100_length_666_cov_24.811287	303	383	91	8	80	0.1000000
NODE_19100_length_666_cov_24.811287	303	383	93	2	80	0.0250000
NODE_19100_length_666_cov_24.811287	303	383	94	24	80	0.3000000
NODE_19100_length_666_cov_24.811287	356	436	26	8	80	0.1000000
NODE_19100_length_666_cov_24.811287	356	436	28	1	80	0.0125000
NODE_19100_length_666_cov_24.811287	356	436	48	3	80	0.0375000
NODE_19100_length_666_cov_24.811287	356	436	50	1	80	0.0125000
NODE_19100_length_666_cov_24.811287	356	436	56	4	80	0.0500000
NODE_19100_length_666_cov_24.811287	356	436	60	2	80	0.0250000
NODE_19100_length_666_cov_24.811287	356	436	62	2	80	0.0250000
NODE_19100_length_666_cov_24.811287	356	436	91	1	80	0.0125000
NODE_19100_length_666_cov_24.811287	356	436	92	12	80	0.1500000
NODE_19100_length_666_cov_24.811287	356	436	93	2	80	0.0250000
NODE_19100_length_666_cov_24.811287	356	436	94	39	80	0.4875000
NODE_19100_length_666_cov_24.811287	356	436	96	5	80	0.0625000
NODE_19102_length_666_cov_20.114638	172	252	0	80	80	1.0000000
NODE_19102_length_666_cov_20.114638	225	305	0	80	80	1.0000000
NODE_19103_length_666_cov_16.813051	220	286	0	66	66	1.0000000
NODE_19103_length_666_cov_16.813051	259	344	0	85	85	1.0000000
NODE_19104_length_666_cov_15.384480	306	386	4	25	80	0.3125000
NODE_19104_length_666_cov_15.384480	306	386	6	32	80	0.4000000
NODE_19104_length_666_cov_15.384480	306	386	8	23	80	0.2875000
NODE_19104_length_666_cov_15.384480	359	439	2	11	80	0.1375000
NODE_19104_length_666_cov_15.384480	359	439	4	8	80	0.1000000
NODE_19104_length_666_cov_15.384480	359	439	6	4	80	0.0500000
NODE_19104_length_666_cov_15.384480	359	439	8	57	80	0.7125000
NODE_19105_length_666_cov_14.195767	485	565	0	80	80	1.0000000
NODE_19105_length_666_cov_14.195767	538	618	0	80	80	1.0000000
NODE_19108_length_666_cov_7.770723	226	306	0	80	80	1.0000000
NODE_19108_length_666_cov_7.770723	279	359	0	80	80	1.0000000
NODE_19163_length_665_cov_28.786219	391	471	0	56	80	0.7000000
NODE_19163_length_665_cov_28.786219	391	471	14	1	80	0.0125000
NODE_19163_length_665_cov_28.786219	391	471	16	23	80	0.2875000
NODE_19163_length_665_cov_28.786219	444	524	0	3	80	0.0375000
NODE_19163_length_665_cov_28.786219	444	524	14	1	80	0.0125000
NODE_19163_length_665_cov_28.786219	444	524	16	76	80	0.9500000
NODE_19164_length_665_cov_21.740283	311	391	0	80	80	1.0000000
NODE_19164_length_665_cov_21.740283	364	444	0	80	80	1.0000000
NODE_19165_length_665_cov_15.904594	390	470	0	80	80	1.0000000
NODE_19165_length_665_cov_15.904594	443	523	0	80	80	1.0000000
NODE_19224_length_664_cov_27.208850	259	339	0	80	80	1.0000000
NODE_19224_length_664_cov_27.208850	345	404	0	59	59	1.0000000
NODE_19225_length_664_cov_16.116814	241	321	0	30	80	0.3750000
NODE_19225_length_664_cov_16.116814	241	321	3	1	80	0.0125000
NODE_19225_length_664_cov_16.116814	241	321	4	49	80	0.6125000
NODE_19225_length_664_cov_16.116814	294	374	4	80	80	1.0000000
NODE_19227_length_664_cov_14.185841	332	412	0	80	80	1.0000000
NODE_19227_length_664_cov_14.185841	385	465	0	80	80	1.0000000
NODE_19228_length_664_cov_12.256637	325	405	0	80	80	1.0000000
NODE_19228_length_664_cov_12.256637	378	454	0	76	76	1.0000000
NODE_19229_length_664_cov_8.378761	252	332	3	2	80	0.0250000
NODE_19229_length_664_cov_8.378761	252	332	5	15	80	0.1875000
NODE_19229_length_664_cov_8.378761	252	332	11	40	80	0.5000000
NODE_19229_length_664_cov_8.378761	252	332	12	23	80	0.2875000
NODE_19229_length_664_cov_8.378761	305	385	0	38	80	0.4750000
NODE_19229_length_664_cov_8.378761	305	385	1	5	80	0.0625000
NODE_19229_length_664_cov_8.378761	305	385	3	12	80	0.1500000
NODE_19229_length_664_cov_8.378761	305	385	5	15	80	0.1875000
NODE_19229_length_664_cov_8.378761	305	385	11	10	80	0.1250000
NODE_19229_length_664_cov_8.378761	381	461	0	80	80	1.0000000
NODE_19229_length_664_cov_8.378761	434	514	0	80	80	1.0000000
NODE_19254_length_664_cov_1.922124	393	434	0	41	41	1.0000000
NODE_19298_length_663_cov_26.601064	398	478	0	4	80	0.0500000
NODE_19298_length_663_cov_26.601064	398	478	4	76	80	0.9500000
NODE_19298_length_663_cov_26.601064	451	531	0	13	80	0.1625000
NODE_19298_length_663_cov_26.601064	451	531	2	34	80	0.4250000
NODE_19298_length_663_cov_26.601064	451	531	4	33	80	0.4125000
NODE_19299_length_663_cov_16.948582	368	448	0	80	80	1.0000000
NODE_19299_length_663_cov_16.948582	421	501	0	80	80	1.0000000
NODE_19300_length_663_cov_16.225177	118	198	0	8	80	0.1000000
NODE_19300_length_663_cov_16.225177	118	198	4	72	80	0.9000000
NODE_19300_length_663_cov_16.225177	171	251	0	58	80	0.7250000
NODE_19300_length_663_cov_16.225177	171	251	4	22	80	0.2750000
NODE_19302_length_663_cov_13.748227	277	357	0	40	80	0.5000000
NODE_19302_length_663_cov_13.748227	277	357	2	18	80	0.2250000
NODE_19302_length_663_cov_13.748227	277	357	4	22	80	0.2750000
NODE_19302_length_663_cov_13.748227	330	410	2	34	80	0.4250000
NODE_19302_length_663_cov_13.748227	330	410	4	46	80	0.5750000
NODE_19303_length_663_cov_10.377660	300	380	8	4	80	0.0500000
NODE_19303_length_663_cov_10.377660	300	380	14	4	80	0.0500000
NODE_19303_length_663_cov_10.377660	300	380	16	17	80	0.2125000
NODE_19303_length_663_cov_10.377660	300	380	18	12	80	0.1500000
NODE_19303_length_663_cov_10.377660	300	380	20	4	80	0.0500000
NODE_19303_length_663_cov_10.377660	300	380	22	39	80	0.4875000
NODE_19304_length_663_cov_9.549645	199	279	0	73	80	0.9125000
NODE_19304_length_663_cov_9.549645	199	279	2	7	80	0.0875000
NODE_19304_length_663_cov_9.549645	252	332	0	20	80	0.2500000
NODE_19304_length_663_cov_9.549645	252	332	2	60	80	0.7500000
NODE_19305_length_663_cov_7.397163	151	231	0	80	80	1.0000000
NODE_19305_length_663_cov_7.397163	204	284	0	80	80	1.0000000
NODE_19307_length_663_cov_5.081560	317	397	0	80	80	1.0000000
NODE_19368_length_662_cov_29.218472	233	313	0	29	80	0.3625000
NODE_19368_length_662_cov_29.218472	233	313	2	18	80	0.2250000
NODE_19368_length_662_cov_29.218472	233	313	4	25	80	0.3125000
NODE_19368_length_662_cov_29.218472	233	313	10	8	80	0.1000000
NODE_19368_length_662_cov_29.218472	286	366	4	19	80	0.2375000
NODE_19368_length_662_cov_29.218472	286	366	10	61	80	0.7625000
NODE_19369_length_662_cov_18.717584	193	273	0	66	80	0.8250000
NODE_19369_length_662_cov_18.717584	193	273	2	14	80	0.1750000
NODE_19369_length_662_cov_18.717584	246	326	0	13	80	0.1625000
NODE_19369_length_662_cov_18.717584	246	326	2	28	80	0.3500000
NODE_19369_length_662_cov_18.717584	246	326	4	39	80	0.4875000
NODE_19370_length_662_cov_16.358792	258	338	0	30	80	0.3750000
NODE_19370_length_662_cov_16.358792	258	338	2	2	80	0.0250000
NODE_19370_length_662_cov_16.358792	258	338	3	28	80	0.3500000
NODE_19370_length_662_cov_16.358792	258	338	6	20	80	0.2500000
NODE_19370_length_662_cov_16.358792	311	391	3	7	80	0.0875000
NODE_19370_length_662_cov_16.358792	311	391	6	73	80	0.9125000
NODE_19371_length_662_cov_12.845471	259	339	0	80	80	1.0000000
NODE_19371_length_662_cov_12.845471	312	392	0	80	80	1.0000000
NODE_19372_length_662_cov_12.476021	299	379	2	56	80	0.7000000
NODE_19372_length_662_cov_12.476021	299	379	4	24	80	0.3000000
NODE_19372_length_662_cov_12.476021	352	432	2	46	80	0.5750000
NODE_19372_length_662_cov_12.476021	352	432	4	34	80	0.4250000
NODE_19373_length_662_cov_10.252220	239	319	0	60	80	0.7500000
NODE_19373_length_662_cov_10.252220	239	319	2	20	80	0.2500000
NODE_19373_length_662_cov_10.252220	292	372	0	80	80	1.0000000
NODE_19376_length_662_cov_6.335702	267	347	0	52	80	0.6500000
NODE_19376_length_662_cov_6.335702	267	347	2	28	80	0.3500000
NODE_19376_length_662_cov_6.335702	320	400	0	14	80	0.1750000
NODE_19376_length_662_cov_6.335702	320	400	2	66	80	0.8250000
NODE_19378_length_662_cov_5.738899	295	331	0	36	36	1.0000000
NODE_19378_length_662_cov_5.738899	301	322	0	21	21	1.0000000
NODE_19402_length_662_cov_1.905861	150	230	0	80	80	1.0000000
NODE_19402_length_662_cov_1.905861	203	277	0	74	74	1.0000000
NODE_19441_length_661_cov_55.176157	236	316	0	14	80	0.1750000
NODE_19441_length_661_cov_55.176157	236	316	2	66	80	0.8250000
NODE_19441_length_661_cov_55.176157	289	369	0	67	80	0.8375000
NODE_19441_length_661_cov_55.176157	289	369	2	13	80	0.1625000
NODE_19442_length_661_cov_38.501779	231	311	2	24	80	0.3000000
NODE_19442_length_661_cov_38.501779	231	311	4	10	80	0.1250000
NODE_19442_length_661_cov_38.501779	231	311	6	46	80	0.5750000
NODE_19442_length_661_cov_38.501779	284	364	2	77	80	0.9625000
NODE_19442_length_661_cov_38.501779	284	364	4	3	80	0.0375000
NODE_19442_length_661_cov_38.501779	360	440	0	55	80	0.6875000
NODE_19442_length_661_cov_38.501779	360	440	2	25	80	0.3125000
NODE_19442_length_661_cov_38.501779	413	493	0	80	80	1.0000000
NODE_19443_length_661_cov_31.460854	128	208	0	80	80	1.0000000
NODE_19443_length_661_cov_31.460854	181	261	0	80	80	1.0000000
NODE_19444_length_661_cov_18.960854	216	296	0	80	80	1.0000000
NODE_19444_length_661_cov_18.960854	269	349	0	80	80	1.0000000
NODE_19445_length_661_cov_16.035587	201	281	0	80	80	1.0000000
NODE_19445_length_661_cov_16.035587	254	334	0	80	80	1.0000000
NODE_19447_length_661_cov_13.005338	281	343	0	62	62	1.0000000
NODE_19447_length_661_cov_13.005338	353	433	0	80	80	1.0000000
NODE_19447_length_661_cov_13.005338	406	486	0	80	80	1.0000000
NODE_19452_length_661_cov_5.670819	374	454	0	80	80	1.0000000
NODE_19452_length_661_cov_5.670819	427	507	0	80	80	1.0000000
NODE_19457_length_661_cov_4.601423	319	395	0	16	76	0.2105263
NODE_19457_length_661_cov_4.601423	319	395	2	60	76	0.7894737
NODE_19459_length_661_cov_3.532028	282	362	0	80	80	1.0000000
NODE_19459_length_661_cov_3.532028	335	415	0	80	80	1.0000000
NODE_19515_length_660_cov_20.741533	343	423	6	41	80	0.5125000
NODE_19515_length_660_cov_20.741533	343	423	8	9	80	0.1125000
NODE_19515_length_660_cov_20.741533	343	423	10	19	80	0.2375000
NODE_19515_length_660_cov_20.741533	343	423	12	11	80	0.1375000
NODE_19515_length_660_cov_20.741533	396	476	0	14	80	0.1750000
NODE_19515_length_660_cov_20.741533	396	476	2	9	80	0.1125000
NODE_19515_length_660_cov_20.741533	396	476	4	18	80	0.2250000
NODE_19515_length_660_cov_20.741533	396	476	6	38	80	0.4750000
NODE_19515_length_660_cov_20.741533	396	476	8	1	80	0.0125000
NODE_19516_length_660_cov_15.089127	148	228	0	8	80	0.1000000
NODE_19516_length_660_cov_15.089127	148	228	2	51	80	0.6375000
NODE_19516_length_660_cov_15.089127	148	228	4	21	80	0.2625000
NODE_19516_length_660_cov_15.089127	201	281	2	34	80	0.4250000
NODE_19516_length_660_cov_15.089127	201	281	4	46	80	0.5750000
NODE_19518_length_660_cov_13.301248	276	356	0	80	80	1.0000000
NODE_19518_length_660_cov_13.301248	329	409	0	80	80	1.0000000
NODE_19519_length_660_cov_12.393939	234	314	0	23	80	0.2875000
NODE_19519_length_660_cov_12.393939	234	314	1	1	80	0.0125000
NODE_19519_length_660_cov_12.393939	234	314	2	56	80	0.7000000
NODE_19519_length_660_cov_12.393939	287	367	0	34	80	0.4250000
NODE_19519_length_660_cov_12.393939	287	367	2	46	80	0.5750000
NODE_19521_length_660_cov_11.495544	399	479	0	80	80	1.0000000
NODE_19521_length_660_cov_11.495544	452	532	0	80	80	1.0000000
NODE_19522_length_660_cov_10.522282	177	257	0	66	80	0.8250000
NODE_19522_length_660_cov_10.522282	177	257	2	14	80	0.1750000
NODE_19522_length_660_cov_10.522282	230	311	0	13	81	0.1604938
NODE_19522_length_660_cov_10.522282	230	311	2	68	81	0.8395061
NODE_19524_length_660_cov_8.887701	254	325	0	14	71	0.1971831
NODE_19524_length_660_cov_8.887701	254	325	2	1	71	0.0140845
NODE_19524_length_660_cov_8.887701	254	325	4	56	71	0.7887324
NODE_19527_length_660_cov_7.278075	225	305	0	80	80	1.0000000
NODE_19527_length_660_cov_7.278075	278	358	0	80	80	1.0000000
NODE_19529_length_660_cov_6.577540	350	430	0	21	80	0.2625000
NODE_19529_length_660_cov_6.577540	350	430	2	59	80	0.7375000
NODE_19529_length_660_cov_6.577540	403	483	0	47	80	0.5875000
NODE_19529_length_660_cov_6.577540	403	483	2	33	80	0.4125000
NODE_19549_length_660_cov_2.354724	421	470	0	37	49	0.7551020
NODE_19549_length_660_cov_2.354724	421	470	2	12	49	0.2448980
NODE_19594_length_659_cov_43.587500	2	82	0	80	80	1.0000000
NODE_19594_length_659_cov_43.587500	55	135	0	62	80	0.7750000
NODE_19594_length_659_cov_43.587500	55	135	4	18	80	0.2250000
NODE_19594_length_659_cov_43.587500	131	211	4	80	80	1.0000000
NODE_19594_length_659_cov_43.587500	184	264	2	15	80	0.1875000
NODE_19594_length_659_cov_43.587500	184	264	3	17	80	0.2125000
NODE_19594_length_659_cov_43.587500	184	264	4	28	80	0.3500000
NODE_19594_length_659_cov_43.587500	184	264	6	20	80	0.2500000
NODE_19595_length_659_cov_23.330357	236	316	0	73	80	0.9125000
NODE_19595_length_659_cov_23.330357	236	316	2	7	80	0.0875000
NODE_19595_length_659_cov_23.330357	289	369	0	20	80	0.2500000
NODE_19595_length_659_cov_23.330357	289	369	2	60	80	0.7500000
NODE_19596_length_659_cov_12.775000	255	335	0	80	80	1.0000000
NODE_19596_length_659_cov_12.775000	308	388	0	80	80	1.0000000
NODE_19598_length_659_cov_9.683929	220	298	0	78	78	1.0000000
NODE_19598_length_659_cov_9.683929	271	351	0	80	80	1.0000000
NODE_19613_length_659_cov_3.658929	305	385	0	80	80	1.0000000
NODE_19613_length_659_cov_3.658929	358	438	0	80	80	1.0000000
NODE_19678_length_658_cov_38.479428	289	369	0	14	80	0.1750000
NODE_19678_length_658_cov_38.479428	289	369	5	17	80	0.2125000
NODE_19678_length_658_cov_38.479428	289	369	6	49	80	0.6125000
NODE_19678_length_658_cov_38.479428	342	422	4	1	80	0.0125000
NODE_19678_length_658_cov_38.479428	342	422	5	68	80	0.8500000
NODE_19678_length_658_cov_38.479428	342	422	6	11	80	0.1375000
NODE_19679_length_658_cov_35.409660	242	322	0	3	80	0.0375000
NODE_19679_length_658_cov_35.409660	242	322	2	77	80	0.9625000
NODE_19679_length_658_cov_35.409660	295	375	0	42	80	0.5250000
NODE_19679_length_658_cov_35.409660	295	375	2	38	80	0.4750000
NODE_19680_length_658_cov_20.322004	191	271	0	41	80	0.5125000
NODE_19680_length_658_cov_20.322004	191	271	2	39	80	0.4875000
NODE_19680_length_658_cov_20.322004	244	321	0	77	77	1.0000000
NODE_19680_length_658_cov_20.322004	317	397	0	80	80	1.0000000
NODE_19680_length_658_cov_20.322004	370	449	0	79	79	1.0000000
NODE_19681_length_658_cov_11.352415	324	404	0	80	80	1.0000000
NODE_19681_length_658_cov_11.352415	377	457	0	80	80	1.0000000
NODE_19685_length_658_cov_8.241503	227	307	0	80	80	1.0000000
NODE_19685_length_658_cov_8.241503	280	360	0	80	80	1.0000000
NODE_19689_length_658_cov_5.477639	450	530	0	80	80	1.0000000
NODE_19705_length_658_cov_2.277281	286	366	0	17	80	0.2125000
NODE_19705_length_658_cov_2.277281	286	366	2	63	80	0.7875000
NODE_19705_length_658_cov_2.277281	339	419	0	52	80	0.6500000
NODE_19705_length_658_cov_2.277281	339	419	2	21	80	0.2625000
NODE_19705_length_658_cov_2.277281	339	419	3	7	80	0.0875000
NODE_19750_length_657_cov_71.087814	306	372	0	7	66	0.1060606
NODE_19750_length_657_cov_71.087814	306	372	2	12	66	0.1818182
NODE_19750_length_657_cov_71.087814	306	372	4	30	66	0.4545455
NODE_19750_length_657_cov_71.087814	306	372	23	1	66	0.0151515
NODE_19750_length_657_cov_71.087814	306	372	24	7	66	0.1060606
NODE_19750_length_657_cov_71.087814	306	372	32	9	66	0.1363636
NODE_19750_length_657_cov_71.087814	382	462	38	2	80	0.0250000
NODE_19750_length_657_cov_71.087814	382	462	39	1	80	0.0125000
NODE_19750_length_657_cov_71.087814	382	462	40	10	80	0.1250000
NODE_19750_length_657_cov_71.087814	382	462	41	4	80	0.0500000
NODE_19750_length_657_cov_71.087814	382	462	43	3	80	0.0375000
NODE_19750_length_657_cov_71.087814	382	462	50	5	80	0.0625000
NODE_19750_length_657_cov_71.087814	382	462	51	14	80	0.1750000
NODE_19750_length_657_cov_71.087814	382	462	53	28	80	0.3500000
NODE_19750_length_657_cov_71.087814	382	462	54	8	80	0.1000000
NODE_19750_length_657_cov_71.087814	382	462	55	5	80	0.0625000
NODE_19750_length_657_cov_71.087814	382	462	38	2	80	0.0250000
NODE_19750_length_657_cov_71.087814	382	462	39	1	80	0.0125000
NODE_19750_length_657_cov_71.087814	382	462	40	10	80	0.1250000
NODE_19750_length_657_cov_71.087814	382	462	41	4	80	0.0500000
NODE_19750_length_657_cov_71.087814	382	462	43	3	80	0.0375000
NODE_19750_length_657_cov_71.087814	382	462	50	5	80	0.0625000
NODE_19750_length_657_cov_71.087814	382	462	51	14	80	0.1750000
NODE_19750_length_657_cov_71.087814	382	462	53	28	80	0.3500000
NODE_19750_length_657_cov_71.087814	382	462	54	8	80	0.1000000
NODE_19750_length_657_cov_71.087814	382	462	55	5	80	0.0625000
NODE_19750_length_657_cov_71.087814	435	515	10	7	80	0.0875000
NODE_19750_length_657_cov_71.087814	435	515	12	3	80	0.0375000
NODE_19750_length_657_cov_71.087814	435	515	18	12	80	0.1500000
NODE_19750_length_657_cov_71.087814	435	515	20	4	80	0.0500000
NODE_19750_length_657_cov_71.087814	435	515	22	3	80	0.0375000
NODE_19750_length_657_cov_71.087814	435	515	24	2	80	0.0250000
NODE_19750_length_657_cov_71.087814	435	515	28	2	80	0.0250000
NODE_19750_length_657_cov_71.087814	435	515	30	7	80	0.0875000
NODE_19750_length_657_cov_71.087814	435	515	40	1	80	0.0125000
NODE_19750_length_657_cov_71.087814	435	515	41	16	80	0.2000000
NODE_19750_length_657_cov_71.087814	435	515	43	3	80	0.0375000
NODE_19750_length_657_cov_71.087814	435	515	51	12	80	0.1500000
NODE_19750_length_657_cov_71.087814	435	515	53	3	80	0.0375000
NODE_19750_length_657_cov_71.087814	435	515	55	5	80	0.0625000
NODE_19750_length_657_cov_71.087814	440	515	10	7	75	0.0933333
NODE_19750_length_657_cov_71.087814	440	515	12	3	75	0.0400000
NODE_19750_length_657_cov_71.087814	440	515	18	12	75	0.1600000
NODE_19750_length_657_cov_71.087814	440	515	20	4	75	0.0533333
NODE_19750_length_657_cov_71.087814	440	515	22	3	75	0.0400000
NODE_19750_length_657_cov_71.087814	440	515	24	2	75	0.0266667
NODE_19750_length_657_cov_71.087814	440	515	28	2	75	0.0266667
NODE_19750_length_657_cov_71.087814	440	515	30	7	75	0.0933333
NODE_19750_length_657_cov_71.087814	440	515	40	1	75	0.0133333
NODE_19750_length_657_cov_71.087814	440	515	41	16	75	0.2133333
NODE_19750_length_657_cov_71.087814	440	515	43	3	75	0.0400000
NODE_19750_length_657_cov_71.087814	440	515	51	12	75	0.1600000
NODE_19750_length_657_cov_71.087814	440	515	55	3	75	0.0400000
NODE_19751_length_657_cov_67.408602	98	178	0	80	80	1.0000000
NODE_19751_length_657_cov_67.408602	151	231	0	80	80	1.0000000
NODE_19752_length_657_cov_15.568100	265	345	0	80	80	1.0000000
NODE_19752_length_657_cov_15.568100	341	421	0	80	80	1.0000000
NODE_19759_length_657_cov_5.161290	185	256	0	71	71	1.0000000
NODE_19759_length_657_cov_5.161290	229	309	0	80	80	1.0000000
NODE_19824_length_656_cov_37.023339	470	550	0	42	80	0.5250000
NODE_19824_length_656_cov_37.023339	470	550	2	15	80	0.1875000
NODE_19824_length_656_cov_37.023339	470	550	4	6	80	0.0750000
NODE_19824_length_656_cov_37.023339	470	550	6	17	80	0.2125000
NODE_19824_length_656_cov_37.023339	523	603	2	12	80	0.1500000
NODE_19824_length_656_cov_37.023339	523	603	4	16	80	0.2000000
NODE_19824_length_656_cov_37.023339	523	603	6	52	80	0.6500000
NODE_19825_length_656_cov_22.804309	173	253	0	80	80	1.0000000
NODE_19825_length_656_cov_22.804309	226	306	0	80	80	1.0000000
NODE_19826_length_656_cov_19.280072	345	425	0	80	80	1.0000000
NODE_19826_length_656_cov_19.280072	398	478	0	80	80	1.0000000
NODE_19827_length_656_cov_18.267504	272	352	2	75	80	0.9375000
NODE_19827_length_656_cov_18.267504	272	352	4	3	80	0.0375000
NODE_19827_length_656_cov_18.267504	272	352	6	2	80	0.0250000
NODE_19827_length_656_cov_18.267504	325	405	2	22	80	0.2750000
NODE_19827_length_656_cov_18.267504	325	405	4	56	80	0.7000000
NODE_19827_length_656_cov_18.267504	325	405	6	2	80	0.0250000
NODE_19828_length_656_cov_15.928187	223	303	0	80	80	1.0000000
NODE_19829_length_656_cov_15.091562	297	377	0	80	80	1.0000000
NODE_19829_length_656_cov_15.091562	350	430	0	80	80	1.0000000
NODE_19830_length_656_cov_12.773788	269	349	0	12	80	0.1500000
NODE_19830_length_656_cov_12.773788	269	349	4	8	80	0.1000000
NODE_19830_length_656_cov_12.773788	269	349	5	3	80	0.0375000
NODE_19830_length_656_cov_12.773788	269	349	8	57	80	0.7125000
NODE_19830_length_656_cov_12.773788	322	399	0	31	77	0.4025974
NODE_19830_length_656_cov_12.773788	322	399	2	1	77	0.0129870
NODE_19830_length_656_cov_12.773788	322	399	8	45	77	0.5844156
NODE_19831_length_656_cov_12.493716	212	292	0	80	80	1.0000000
NODE_19831_length_656_cov_12.493716	265	345	0	80	80	1.0000000
NODE_19832_length_656_cov_10.946140	197	277	0	80	80	1.0000000
NODE_19832_length_656_cov_10.946140	250	330	0	80	80	1.0000000
NODE_19833_length_656_cov_9.412926	295	375	0	80	80	1.0000000
NODE_19833_length_656_cov_9.412926	348	428	0	80	80	1.0000000
NODE_19904_length_655_cov_31.019784	212	292	0	29	80	0.3625000
NODE_19904_length_655_cov_31.019784	212	292	2	7	80	0.0875000
NODE_19904_length_655_cov_31.019784	212	292	4	44	80	0.5500000
NODE_19904_length_655_cov_31.019784	265	345	0	7	80	0.0875000
NODE_19904_length_655_cov_31.019784	265	345	2	19	80	0.2375000
NODE_19904_length_655_cov_31.019784	265	345	4	54	80	0.6750000
NODE_19907_length_655_cov_8.672662	216	296	0	80	80	1.0000000
NODE_19907_length_655_cov_8.672662	269	349	0	80	80	1.0000000
NODE_19908_length_655_cov_8.250000	204	234	0	30	30	1.0000000
NODE_19909_length_655_cov_7.910072	366	446	0	80	80	1.0000000
NODE_19909_length_655_cov_7.910072	419	499	0	80	80	1.0000000
NODE_19916_length_655_cov_5.478417	178	255	0	62	77	0.8051948
NODE_19916_length_655_cov_5.478417	178	255	2	15	77	0.1948052
NODE_19916_length_655_cov_5.478417	178	221	0	43	43	1.0000000
NODE_19919_length_655_cov_5.174460	347	428	4	81	81	1.0000000
NODE_19919_length_655_cov_5.174460	401	481	0	48	80	0.6000000
NODE_19919_length_655_cov_5.174460	401	481	2	2	80	0.0250000
NODE_19919_length_655_cov_5.174460	401	481	4	30	80	0.3750000
NODE_19979_length_654_cov_17.086486	323	403	0	80	80	1.0000000
NODE_19979_length_654_cov_17.086486	376	456	0	80	80	1.0000000
NODE_19980_length_654_cov_16.194595	318	398	0	80	80	1.0000000
NODE_19980_length_654_cov_16.194595	371	451	0	80	80	1.0000000
NODE_19983_length_654_cov_5.556757	341	412	0	71	71	1.0000000
NODE_19990_length_654_cov_3.236036	105	181	0	76	76	1.0000000
NODE_19990_length_654_cov_3.236036	158	236	0	78	78	1.0000000
NODE_19998_length_654_cov_2.549550	279	366	0	87	87	1.0000000
NODE_20013_length_654_cov_1.790991	480	560	0	4	80	0.0500000
NODE_20013_length_654_cov_1.790991	480	560	2	1	80	0.0125000
NODE_20013_length_654_cov_1.790991	480	560	4	75	80	0.9375000
NODE_20044_length_653_cov_70.296029	277	357	0	80	80	1.0000000
NODE_20044_length_653_cov_70.296029	330	410	0	80	80	1.0000000
NODE_20045_length_653_cov_28.072202	302	382	0	45	80	0.5625000
NODE_20045_length_653_cov_28.072202	302	382	4	14	80	0.1750000
NODE_20045_length_653_cov_28.072202	302	382	8	11	80	0.1375000
NODE_20045_length_653_cov_28.072202	302	382	12	10	80	0.1250000
NODE_20045_length_653_cov_28.072202	355	435	4	6	80	0.0750000
NODE_20045_length_653_cov_28.072202	355	435	8	11	80	0.1375000
NODE_20045_length_653_cov_28.072202	355	435	12	63	80	0.7875000
NODE_20046_length_653_cov_18.382671	214	294	0	80	80	1.0000000
NODE_20046_length_653_cov_18.382671	267	347	0	80	80	1.0000000
NODE_20047_length_653_cov_8.821300	292	372	0	80	80	1.0000000
NODE_20047_length_653_cov_8.821300	345	425	0	80	80	1.0000000
NODE_20048_length_653_cov_8.660650	200	280	0	60	80	0.7500000
NODE_20048_length_653_cov_8.660650	200	280	2	20	80	0.2500000
NODE_20048_length_653_cov_8.660650	253	333	0	7	80	0.0875000
NODE_20048_length_653_cov_8.660650	253	333	2	73	80	0.9125000
NODE_20052_length_653_cov_5.777978	308	383	0	75	75	1.0000000
NODE_20052_length_653_cov_5.777978	361	435	0	74	74	1.0000000
NODE_20054_length_653_cov_5.193141	304	356	0	37	52	0.7115384
NODE_20054_length_653_cov_5.193141	304	356	2	15	52	0.2884615
NODE_20058_length_653_cov_4.823105	178	251	11	3	73	0.0410959
NODE_20058_length_653_cov_4.823105	178	251	12	15	73	0.2054795
NODE_20058_length_653_cov_4.823105	178	251	15	32	73	0.4383562
NODE_20058_length_653_cov_4.823105	178	251	16	23	73	0.3150685
NODE_20058_length_653_cov_4.823105	178	256	8	1	78	0.0128205
NODE_20058_length_653_cov_4.823105	178	256	10	2	78	0.0256410
NODE_20058_length_653_cov_4.823105	178	256	11	5	78	0.0641026
NODE_20058_length_653_cov_4.823105	178	256	12	15	78	0.1923077
NODE_20058_length_653_cov_4.823105	178	256	15	32	78	0.4102564
NODE_20058_length_653_cov_4.823105	178	256	16	23	78	0.2948718
NODE_20058_length_653_cov_4.823105	229	309	2	20	80	0.2500000
NODE_20058_length_653_cov_4.823105	229	309	3	10	80	0.1250000
NODE_20058_length_653_cov_4.823105	229	309	5	3	80	0.0375000
NODE_20058_length_653_cov_4.823105	229	309	6	13	80	0.1625000
NODE_20058_length_653_cov_4.823105	229	309	8	8	80	0.1000000
NODE_20058_length_653_cov_4.823105	229	309	10	2	80	0.0250000
NODE_20058_length_653_cov_4.823105	229	309	11	5	80	0.0625000
NODE_20058_length_653_cov_4.823105	229	309	15	1	80	0.0125000
NODE_20058_length_653_cov_4.823105	229	309	16	18	80	0.2250000
NODE_20058_length_653_cov_4.823105	229	309	2	20	80	0.2500000
NODE_20058_length_653_cov_4.823105	229	309	3	10	80	0.1250000
NODE_20058_length_653_cov_4.823105	229	309	5	3	80	0.0375000
NODE_20058_length_653_cov_4.823105	229	309	6	13	80	0.1625000
NODE_20058_length_653_cov_4.823105	229	309	8	8	80	0.1000000
NODE_20058_length_653_cov_4.823105	229	309	10	2	80	0.0250000
NODE_20058_length_653_cov_4.823105	229	309	11	5	80	0.0625000
NODE_20058_length_653_cov_4.823105	229	309	15	1	80	0.0125000
NODE_20058_length_653_cov_4.823105	229	309	16	18	80	0.2250000
NODE_20058_length_653_cov_4.823105	239	309	2	20	70	0.2857143
NODE_20058_length_653_cov_4.823105	239	309	3	10	70	0.1428571
NODE_20058_length_653_cov_4.823105	239	309	5	3	70	0.0428571
NODE_20058_length_653_cov_4.823105	239	309	6	13	70	0.1857143
NODE_20058_length_653_cov_4.823105	239	309	8	8	70	0.1142857
NODE_20058_length_653_cov_4.823105	239	309	10	2	70	0.0285714
NODE_20058_length_653_cov_4.823105	239	309	11	5	70	0.0714286
NODE_20058_length_653_cov_4.823105	239	309	15	1	70	0.0142857
NODE_20058_length_653_cov_4.823105	239	309	16	8	70	0.1142857
NODE_20127_length_652_cov_215.211573	185	248	5	14	63	0.2222222
NODE_20127_length_652_cov_215.211573	185	248	8	6	63	0.0952381
NODE_20127_length_652_cov_215.211573	185	248	16	10	63	0.1587302
NODE_20127_length_652_cov_215.211573	185	248	18	1	63	0.0158730
NODE_20127_length_652_cov_215.211573	185	248	20	7	63	0.1111111
NODE_20127_length_652_cov_215.211573	185	248	22	8	63	0.1269841
NODE_20127_length_652_cov_215.211573	185	248	26	5	63	0.0793651
NODE_20127_length_652_cov_215.211573	185	248	28	1	63	0.0158730
NODE_20127_length_652_cov_215.211573	185	248	31	1	63	0.0158730
NODE_20127_length_652_cov_215.211573	185	248	33	1	63	0.0158730
NODE_20127_length_652_cov_215.211573	185	248	34	9	63	0.1428571
NODE_20127_length_652_cov_215.211573	221	301	20	2	80	0.0250000
NODE_20127_length_652_cov_215.211573	221	301	22	8	80	0.1000000
NODE_20127_length_652_cov_215.211573	221	301	26	5	80	0.0625000
NODE_20127_length_652_cov_215.211573	221	301	28	1	80	0.0125000
NODE_20127_length_652_cov_215.211573	221	301	31	1	80	0.0125000
NODE_20127_length_652_cov_215.211573	221	301	33	1	80	0.0125000
NODE_20127_length_652_cov_215.211573	221	301	34	32	80	0.4000000
NODE_20127_length_652_cov_215.211573	221	301	36	4	80	0.0500000
NODE_20127_length_652_cov_215.211573	221	301	37	6	80	0.0750000
NODE_20127_length_652_cov_215.211573	221	301	39	6	80	0.0750000
NODE_20127_length_652_cov_215.211573	221	301	40	2	80	0.0250000
NODE_20127_length_652_cov_215.211573	221	301	41	11	80	0.1375000
NODE_20127_length_652_cov_215.211573	221	301	42	1	80	0.0125000
NODE_20128_length_652_cov_21.267631	299	379	0	32	80	0.4000000
NODE_20128_length_652_cov_21.267631	299	379	2	48	80	0.6000000
NODE_20128_length_652_cov_21.267631	352	432	0	28	80	0.3500000
NODE_20128_length_652_cov_21.267631	352	432	2	52	80	0.6500000
NODE_20138_length_652_cov_4.622061	266	315	2	11	49	0.2244898
NODE_20138_length_652_cov_4.622061	266	315	4	38	49	0.7755102
NODE_20138_length_652_cov_4.622061	288	368	2	24	80	0.3000000
NODE_20138_length_652_cov_4.622061	288	368	4	56	80	0.7000000
NODE_20210_length_651_cov_49.981884	425	505	4	1	80	0.0125000
NODE_20210_length_651_cov_49.981884	425	505	6	3	80	0.0375000
NODE_20210_length_651_cov_49.981884	425	505	8	24	80	0.3000000
NODE_20210_length_651_cov_49.981884	425	505	10	14	80	0.1750000
NODE_20210_length_651_cov_49.981884	425	505	12	5	80	0.0625000
NODE_20210_length_651_cov_49.981884	425	505	14	2	80	0.0250000
NODE_20210_length_651_cov_49.981884	425	505	20	31	80	0.3875000
NODE_20210_length_651_cov_49.981884	425	505	4	1	80	0.0125000
NODE_20210_length_651_cov_49.981884	425	505	6	3	80	0.0375000
NODE_20210_length_651_cov_49.981884	425	505	8	24	80	0.3000000
NODE_20210_length_651_cov_49.981884	425	505	10	14	80	0.1750000
NODE_20210_length_651_cov_49.981884	425	505	12	5	80	0.0625000
NODE_20210_length_651_cov_49.981884	425	505	14	2	80	0.0250000
NODE_20210_length_651_cov_49.981884	425	505	20	31	80	0.3875000
NODE_20210_length_651_cov_49.981884	425	505	4	1	80	0.0125000
NODE_20210_length_651_cov_49.981884	425	505	6	3	80	0.0375000
NODE_20210_length_651_cov_49.981884	425	505	8	24	80	0.3000000
NODE_20210_length_651_cov_49.981884	425	505	10	14	80	0.1750000
NODE_20210_length_651_cov_49.981884	425	505	12	5	80	0.0625000
NODE_20210_length_651_cov_49.981884	425	505	14	2	80	0.0250000
NODE_20210_length_651_cov_49.981884	425	505	20	31	80	0.3875000
NODE_20210_length_651_cov_49.981884	425	505	4	1	80	0.0125000
NODE_20210_length_651_cov_49.981884	425	505	6	3	80	0.0375000
NODE_20210_length_651_cov_49.981884	425	505	8	24	80	0.3000000
NODE_20210_length_651_cov_49.981884	425	505	10	14	80	0.1750000
NODE_20210_length_651_cov_49.981884	425	505	12	5	80	0.0625000
NODE_20210_length_651_cov_49.981884	425	505	14	2	80	0.0250000
NODE_20210_length_651_cov_49.981884	425	505	20	31	80	0.3875000
NODE_20210_length_651_cov_49.981884	478	540	0	16	62	0.2580645
NODE_20210_length_651_cov_49.981884	478	540	4	20	62	0.3225806
NODE_20210_length_651_cov_49.981884	478	540	6	3	62	0.0483871
NODE_20210_length_651_cov_49.981884	478	540	8	23	62	0.3709677
NODE_20210_length_651_cov_49.981884	478	540	0	16	62	0.2580645
NODE_20210_length_651_cov_49.981884	478	540	4	20	62	0.3225806
NODE_20210_length_651_cov_49.981884	478	540	6	3	62	0.0483871
NODE_20210_length_651_cov_49.981884	478	540	8	23	62	0.3709677
NODE_20210_length_651_cov_49.981884	478	540	0	16	62	0.2580645
NODE_20210_length_651_cov_49.981884	478	540	4	20	62	0.3225806
NODE_20210_length_651_cov_49.981884	478	540	6	3	62	0.0483871
NODE_20210_length_651_cov_49.981884	478	540	8	23	62	0.3709677
NODE_20210_length_651_cov_49.981884	478	542	0	18	64	0.2812500
NODE_20210_length_651_cov_49.981884	478	542	4	20	64	0.3125000
NODE_20210_length_651_cov_49.981884	478	542	6	3	64	0.0468750
NODE_20210_length_651_cov_49.981884	478	542	8	23	64	0.3593750
NODE_20211_length_651_cov_36.121377	422	502	4	80	80	1.0000000
NODE_20211_length_651_cov_36.121377	475	555	0	42	80	0.5250000
NODE_20211_length_651_cov_36.121377	475	555	2	11	80	0.1375000
NODE_20211_length_651_cov_36.121377	475	555	4	27	80	0.3375000
NODE_20212_length_651_cov_20.045290	252	332	0	14	80	0.1750000
NODE_20212_length_651_cov_20.045290	252	332	2	13	80	0.1625000
NODE_20212_length_651_cov_20.045290	252	332	4	53	80	0.6625000
NODE_20212_length_651_cov_20.045290	305	385	4	80	80	1.0000000
NODE_20213_length_651_cov_12.704710	264	344	0	80	80	1.0000000
NODE_20213_length_651_cov_12.704710	317	397	0	80	80	1.0000000
NODE_20214_length_651_cov_11.632246	205	285	0	80	80	1.0000000
NODE_20214_length_651_cov_11.632246	258	338	0	80	80	1.0000000
NODE_20215_length_651_cov_10.074275	369	449	0	80	80	1.0000000
NODE_20215_length_651_cov_10.074275	422	502	0	80	80	1.0000000
NODE_20216_length_651_cov_9.699275	199	279	4	80	80	1.0000000
NODE_20216_length_651_cov_9.699275	252	332	0	45	80	0.5625000
NODE_20216_length_651_cov_9.699275	252	332	4	35	80	0.4375000
NODE_20219_length_651_cov_8.309783	217	296	2	10	79	0.1265823
NODE_20219_length_651_cov_8.309783	217	296	4	15	79	0.1898734
NODE_20219_length_651_cov_8.309783	217	296	6	4	79	0.0506329
NODE_20219_length_651_cov_8.309783	217	296	10	4	79	0.0506329
NODE_20219_length_651_cov_8.309783	217	296	16	46	79	0.5822785
NODE_20219_length_651_cov_8.309783	269	349	0	1	80	0.0125000
NODE_20219_length_651_cov_8.309783	269	349	4	24	80	0.3000000
NODE_20219_length_651_cov_8.309783	269	349	10	10	80	0.1250000
NODE_20219_length_651_cov_8.309783	269	349	12	1	80	0.0125000
NODE_20219_length_651_cov_8.309783	269	349	14	12	80	0.1500000
NODE_20219_length_651_cov_8.309783	269	349	16	32	80	0.4000000
NODE_20220_length_651_cov_5.621377	148	228	0	80	80	1.0000000
NODE_20220_length_651_cov_5.621377	201	281	0	80	80	1.0000000
NODE_20221_length_651_cov_5.610507	342	422	2	80	80	1.0000000
NODE_20221_length_651_cov_5.610507	395	475	0	8	80	0.1000000
NODE_20221_length_651_cov_5.610507	395	475	2	72	80	0.9000000
NODE_20225_length_651_cov_4.246377	299	359	0	60	60	1.0000000
NODE_20238_length_651_cov_2.744565	340	421	0	81	81	1.0000000
NODE_20252_length_651_cov_2.016304	280	311	0	31	31	1.0000000
NODE_20292_length_650_cov_22.644283	233	313	4	54	80	0.6750000
NODE_20292_length_650_cov_22.644283	233	313	6	1	80	0.0125000
NODE_20292_length_650_cov_22.644283	233	313	7	16	80	0.2000000
NODE_20292_length_650_cov_22.644283	233	313	8	9	80	0.1125000
NODE_20292_length_650_cov_22.644283	286	366	0	19	80	0.2375000
NODE_20292_length_650_cov_22.644283	286	366	4	61	80	0.7625000
NODE_20293_length_650_cov_22.156080	269	349	0	80	80	1.0000000
NODE_20293_length_650_cov_22.156080	322	402	0	80	80	1.0000000
NODE_20294_length_650_cov_20.012704	186	266	2	80	80	1.0000000
NODE_20294_length_650_cov_20.012704	239	319	2	57	80	0.7125000
NODE_20294_length_650_cov_20.012704	239	319	3	14	80	0.1750000
NODE_20294_length_650_cov_20.012704	239	319	4	9	80	0.1125000
NODE_20295_length_650_cov_17.626134	52	132	0	80	80	1.0000000
NODE_20295_length_650_cov_17.626134	105	185	0	80	80	1.0000000
NODE_20297_length_650_cov_10.687840	289	369	0	10	80	0.1250000
NODE_20297_length_650_cov_10.687840	289	369	2	58	80	0.7250000
NODE_20297_length_650_cov_10.687840	289	369	4	12	80	0.1500000
NODE_20297_length_650_cov_10.687840	342	422	2	48	80	0.6000000
NODE_20297_length_650_cov_10.687840	342	422	4	32	80	0.4000000
NODE_20301_length_650_cov_6.519056	312	365	47	1	53	0.0188679
NODE_20301_length_650_cov_6.519056	312	365	53	4	53	0.0754717
NODE_20301_length_650_cov_6.519056	312	365	57	3	53	0.0566038
NODE_20301_length_650_cov_6.519056	312	365	62	1	53	0.0188679
NODE_20301_length_650_cov_6.519056	312	365	63	6	53	0.1132075
NODE_20301_length_650_cov_6.519056	312	365	65	5	53	0.0943396
NODE_20301_length_650_cov_6.519056	312	365	71	2	53	0.0377358
NODE_20301_length_650_cov_6.519056	312	365	75	2	53	0.0377358
NODE_20301_length_650_cov_6.519056	312	365	77	15	53	0.2830189
NODE_20301_length_650_cov_6.519056	312	365	81	1	53	0.0188679
NODE_20301_length_650_cov_6.519056	312	365	87	1	53	0.0188679
NODE_20301_length_650_cov_6.519056	312	365	88	4	53	0.0754717
NODE_20301_length_650_cov_6.519056	312	365	90	8	53	0.1509434
NODE_20301_length_650_cov_6.519056	338	417	77	13	79	0.1645570
NODE_20301_length_650_cov_6.519056	338	417	81	1	79	0.0126582
NODE_20301_length_650_cov_6.519056	338	417	87	1	79	0.0126582
NODE_20301_length_650_cov_6.519056	338	417	88	15	79	0.1898734
NODE_20301_length_650_cov_6.519056	338	417	89	31	79	0.3924051
NODE_20301_length_650_cov_6.519056	338	417	90	18	79	0.2278481
NODE_20302_length_650_cov_6.159710	243	323	0	80	80	1.0000000
NODE_20302_length_650_cov_6.159710	296	376	0	80	80	1.0000000
NODE_20318_length_650_cov_2.488203	213	266	0	27	53	0.5094340
NODE_20318_length_650_cov_2.488203	213	266	2	26	53	0.4905660
NODE_20370_length_649_cov_20.780000	111	140	0	29	29	1.0000000
NODE_20370_length_649_cov_20.780000	111	191	0	56	80	0.7000000
NODE_20370_length_649_cov_20.780000	111	191	4	12	80	0.1500000
NODE_20370_length_649_cov_20.780000	111	191	6	12	80	0.1500000
NODE_20370_length_649_cov_20.780000	138	161	0	23	23	1.0000000
NODE_20370_length_649_cov_20.780000	138	214	0	29	76	0.3815790
NODE_20370_length_649_cov_20.780000	138	214	4	12	76	0.1578947
NODE_20370_length_649_cov_20.780000	138	214	6	35	76	0.4605263
NODE_20370_length_649_cov_20.780000	164	244	0	3	80	0.0375000
NODE_20370_length_649_cov_20.780000	164	244	4	12	80	0.1500000
NODE_20370_length_649_cov_20.780000	164	244	6	65	80	0.8125000
NODE_20371_length_649_cov_17.938182	162	242	0	80	80	1.0000000
NODE_20371_length_649_cov_17.938182	215	295	0	80	80	1.0000000
NODE_20372_length_649_cov_16.761818	395	475	0	39	80	0.4875000
NODE_20372_length_649_cov_16.761818	395	475	2	41	80	0.5125000
NODE_20372_length_649_cov_16.761818	448	528	2	80	80	1.0000000
NODE_20373_length_649_cov_15.632727	226	306	0	80	80	1.0000000
NODE_20373_length_649_cov_15.632727	279	359	0	80	80	1.0000000
NODE_20374_length_649_cov_15.516364	329	409	0	80	80	1.0000000
NODE_20374_length_649_cov_15.516364	382	462	0	80	80	1.0000000
NODE_20375_length_649_cov_10.374545	453	533	0	26	80	0.3250000
NODE_20375_length_649_cov_10.374545	453	533	2	54	80	0.6750000
NODE_20375_length_649_cov_10.374545	506	586	0	34	80	0.4250000
NODE_20375_length_649_cov_10.374545	506	586	2	46	80	0.5750000
NODE_20382_length_649_cov_4.403636	213	293	0	80	80	1.0000000
NODE_20382_length_649_cov_4.403636	266	346	0	80	80	1.0000000
NODE_20454_length_648_cov_34.287796	343	423	0	80	80	1.0000000
NODE_20454_length_648_cov_34.287796	396	476	0	80	80	1.0000000
NODE_20454_length_648_cov_34.287796	472	552	0	80	80	1.0000000
NODE_20454_length_648_cov_34.287796	525	605	0	80	80	1.0000000
NODE_20455_length_648_cov_19.433515	259	339	8	80	80	1.0000000
NODE_20455_length_648_cov_19.433515	312	392	0	9	80	0.1125000
NODE_20455_length_648_cov_19.433515	312	392	4	23	80	0.2875000
NODE_20455_length_648_cov_19.433515	312	392	8	48	80	0.6000000
NODE_20457_length_648_cov_8.391621	206	286	0	80	80	1.0000000
NODE_20457_length_648_cov_8.391621	259	339	0	80	80	1.0000000
NODE_20459_length_648_cov_6.573770	293	373	0	80	80	1.0000000
NODE_20459_length_648_cov_6.573770	346	426	0	80	80	1.0000000
NODE_20460_length_648_cov_6.431694	285	328	0	43	43	1.0000000
NODE_20463_length_648_cov_6.085610	257	337	0	80	80	1.0000000
NODE_20463_length_648_cov_6.085610	310	390	0	80	80	1.0000000
NODE_20483_length_648_cov_2.333333	19	86	0	64	67	0.9552239
NODE_20483_length_648_cov_2.333333	19	86	2	2	67	0.0298507
NODE_20483_length_648_cov_2.333333	19	86	4	1	67	0.0149254
NODE_20531_length_647_cov_18.489051	295	375	0	37	80	0.4625000
NODE_20531_length_647_cov_18.489051	295	375	4	11	80	0.1375000
NODE_20531_length_647_cov_18.489051	295	375	6	32	80	0.4000000
NODE_20531_length_647_cov_18.489051	348	428	2	2	80	0.0250000
NODE_20531_length_647_cov_18.489051	348	428	5	1	80	0.0125000
NODE_20531_length_647_cov_18.489051	348	428	6	77	80	0.9625000
NODE_20532_length_647_cov_14.677007	286	366	0	80	80	1.0000000
NODE_20532_length_647_cov_14.677007	339	419	0	80	80	1.0000000
NODE_20533_length_647_cov_10.895985	231	311	0	80	80	1.0000000
NODE_20533_length_647_cov_10.895985	284	364	0	80	80	1.0000000
NODE_20534_length_647_cov_9.116788	372	452	0	80	80	1.0000000
NODE_20534_length_647_cov_9.116788	425	505	0	80	80	1.0000000
NODE_20536_length_647_cov_6.410584	150	221	0	71	71	1.0000000
NODE_20536_length_647_cov_6.410584	194	274	0	80	80	1.0000000
NODE_20539_length_647_cov_5.567518	239	319	0	5	80	0.0625000
NODE_20539_length_647_cov_5.567518	239	319	6	3	80	0.0375000
NODE_20539_length_647_cov_5.567518	239	319	8	17	80	0.2125000
NODE_20539_length_647_cov_5.567518	239	319	12	13	80	0.1625000
NODE_20539_length_647_cov_5.567518	239	319	14	42	80	0.5250000
NODE_20539_length_647_cov_5.567518	292	355	6	7	63	0.1111111
NODE_20539_length_647_cov_5.567518	292	355	7	1	63	0.0158730
NODE_20539_length_647_cov_5.567518	292	355	8	2	63	0.0317460
NODE_20539_length_647_cov_5.567518	292	355	10	1	63	0.0158730
NODE_20539_length_647_cov_5.567518	292	355	12	15	63	0.2380952
NODE_20539_length_647_cov_5.567518	292	355	14	37	63	0.5873016
NODE_20539_length_647_cov_5.567518	348	416	6	43	68	0.6323529
NODE_20539_length_647_cov_5.567518	348	416	7	1	68	0.0147059
NODE_20539_length_647_cov_5.567518	348	416	8	2	68	0.0294118
NODE_20539_length_647_cov_5.567518	348	416	10	11	68	0.1617647
NODE_20539_length_647_cov_5.567518	348	416	11	3	68	0.0441176
NODE_20539_length_647_cov_5.567518	348	416	12	8	68	0.1176471
NODE_20539_length_647_cov_5.567518	401	469	6	50	68	0.7352941
NODE_20539_length_647_cov_5.567518	401	469	7	18	68	0.2647059
NODE_20544_length_647_cov_3.775547	356	399	0	43	43	1.0000000
NODE_20550_length_647_cov_2.678832	239	319	0	80	80	1.0000000
NODE_20550_length_647_cov_2.678832	292	372	0	80	80	1.0000000
NODE_20561_length_647_cov_1.937956	254	304	0	50	50	1.0000000
NODE_20607_length_646_cov_56.226691	267	347	0	80	80	1.0000000
NODE_20607_length_646_cov_56.226691	320	400	0	80	80	1.0000000
NODE_20608_length_646_cov_23.747715	76	153	0	77	77	1.0000000
NODE_20608_length_646_cov_23.747715	129	209	0	80	80	1.0000000
NODE_20609_length_646_cov_22.740402	326	406	0	38	80	0.4750000
NODE_20609_length_646_cov_22.740402	326	406	1	12	80	0.1500000
NODE_20609_length_646_cov_22.740402	326	406	2	30	80	0.3750000
NODE_20609_length_646_cov_22.740402	379	459	0	80	80	1.0000000
NODE_20610_length_646_cov_15.160878	363	443	0	80	80	1.0000000
NODE_20610_length_646_cov_15.160878	416	496	0	80	80	1.0000000
NODE_20611_length_646_cov_9.429616	309	389	0	2	80	0.0250000
NODE_20611_length_646_cov_9.429616	309	389	4	42	80	0.5250000
NODE_20611_length_646_cov_9.429616	309	389	6	36	80	0.4500000
NODE_20611_length_646_cov_9.429616	362	442	2	36	80	0.4500000
NODE_20611_length_646_cov_9.429616	362	442	6	44	80	0.5500000
NODE_20612_length_646_cov_9.246801	149	221	0	72	72	1.0000000
NODE_20613_length_646_cov_7.539305	227	307	0	80	80	1.0000000
NODE_20613_length_646_cov_7.539305	280	360	0	80	80	1.0000000
NODE_20614_length_646_cov_6.756856	236	316	0	29	80	0.3625000
NODE_20614_length_646_cov_6.756856	236	316	4	51	80	0.6375000
NODE_20614_length_646_cov_6.756856	289	369	4	80	80	1.0000000
NODE_20615_length_646_cov_6.480804	373	437	0	64	64	1.0000000
NODE_20615_length_646_cov_6.480804	410	490	0	80	80	1.0000000
NODE_20616_length_646_cov_6.396709	194	274	0	80	80	1.0000000
NODE_20616_length_646_cov_6.396709	254	327	0	73	73	1.0000000
NODE_20619_length_646_cov_4.652651	265	345	0	76	80	0.9500000
NODE_20619_length_646_cov_4.652651	265	345	2	4	80	0.0500000
NODE_20623_length_646_cov_4.122486	401	452	0	51	51	1.0000000
NODE_20688_length_645_cov_95.882784	179	259	0	53	80	0.6625000
NODE_20688_length_645_cov_95.882784	179	259	1	26	80	0.3250000
NODE_20688_length_645_cov_95.882784	179	259	2	1	80	0.0125000
NODE_20688_length_645_cov_95.882784	232	312	0	80	80	1.0000000
NODE_20689_length_645_cov_12.985348	343	423	0	80	80	1.0000000
NODE_20689_length_645_cov_12.985348	396	476	0	80	80	1.0000000
NODE_20691_length_645_cov_9.228938	254	334	0	56	80	0.7000000
NODE_20691_length_645_cov_9.228938	254	334	2	24	80	0.3000000
NODE_20691_length_645_cov_9.228938	307	387	0	11	80	0.1375000
NODE_20691_length_645_cov_9.228938	307	387	2	69	80	0.8625000
NODE_20692_length_645_cov_9.172161	293	373	0	80	80	1.0000000
NODE_20692_length_645_cov_9.172161	346	426	0	80	80	1.0000000
NODE_20697_length_645_cov_5.609890	461	541	0	80	80	1.0000000
NODE_20697_length_645_cov_5.609890	514	594	0	80	80	1.0000000
NODE_20698_length_645_cov_4.743590	237	317	0	80	80	1.0000000
NODE_20698_length_645_cov_4.743590	290	370	0	80	80	1.0000000
NODE_20716_length_645_cov_2.177656	373	416	0	2	43	0.0465116
NODE_20716_length_645_cov_2.177656	373	416	2	41	43	0.9534883
NODE_20762_length_644_cov_59.286239	323	401	138	1	78	0.0128205
NODE_20762_length_644_cov_59.286239	323	401	140	3	78	0.0384615
NODE_20762_length_644_cov_59.286239	323	401	148	1	78	0.0128205
NODE_20762_length_644_cov_59.286239	323	401	150	2	78	0.0256410
NODE_20762_length_644_cov_59.286239	323	401	151	1	78	0.0128205
NODE_20762_length_644_cov_59.286239	323	401	152	2	78	0.0256410
NODE_20762_length_644_cov_59.286239	323	401	155	1	78	0.0128205
NODE_20762_length_644_cov_59.286239	323	401	159	2	78	0.0256410
NODE_20762_length_644_cov_59.286239	323	401	161	4	78	0.0512821
NODE_20762_length_644_cov_59.286239	323	401	162	2	78	0.0256410
NODE_20762_length_644_cov_59.286239	323	401	165	1	78	0.0128205
NODE_20762_length_644_cov_59.286239	323	401	167	2	78	0.0256410
NODE_20762_length_644_cov_59.286239	323	401	174	1	78	0.0128205
NODE_20762_length_644_cov_59.286239	323	401	180	1	78	0.0128205
NODE_20762_length_644_cov_59.286239	323	401	181	1	78	0.0128205
NODE_20762_length_644_cov_59.286239	323	401	186	1	78	0.0128205
NODE_20762_length_644_cov_59.286239	323	401	189	1	78	0.0128205
NODE_20762_length_644_cov_59.286239	323	401	191	1	78	0.0128205
NODE_20762_length_644_cov_59.286239	323	401	197	1	78	0.0128205
NODE_20762_length_644_cov_59.286239	323	401	200	1	78	0.0128205
NODE_20762_length_644_cov_59.286239	323	401	208	1	78	0.0128205
NODE_20762_length_644_cov_59.286239	323	401	210	1	78	0.0128205
NODE_20762_length_644_cov_59.286239	323	401	215	1	78	0.0128205
NODE_20762_length_644_cov_59.286239	323	401	219	2	78	0.0256410
NODE_20762_length_644_cov_59.286239	323	401	222	2	78	0.0256410
NODE_20762_length_644_cov_59.286239	323	401	233	1	78	0.0128205
NODE_20762_length_644_cov_59.286239	323	401	238	1	78	0.0128205
NODE_20762_length_644_cov_59.286239	323	401	244	1	78	0.0128205
NODE_20762_length_644_cov_59.286239	323	401	247	1	78	0.0128205
NODE_20762_length_644_cov_59.286239	323	401	249	2	78	0.0256410
NODE_20762_length_644_cov_59.286239	323	401	253	1	78	0.0128205
NODE_20762_length_644_cov_59.286239	323	401	257	1	78	0.0128205
NODE_20762_length_644_cov_59.286239	323	401	259	1	78	0.0128205
NODE_20762_length_644_cov_59.286239	323	401	265	1	78	0.0128205
NODE_20762_length_644_cov_59.286239	323	401	266	2	78	0.0256410
NODE_20762_length_644_cov_59.286239	323	401	270	1	78	0.0128205
NODE_20762_length_644_cov_59.286239	323	401	277	1	78	0.0128205
NODE_20762_length_644_cov_59.286239	323	401	278	1	78	0.0128205
NODE_20762_length_644_cov_59.286239	323	401	280	2	78	0.0256410
NODE_20762_length_644_cov_59.286239	323	401	283	1	78	0.0128205
NODE_20762_length_644_cov_59.286239	323	401	293	1	78	0.0128205
NODE_20762_length_644_cov_59.286239	323	401	295	1	78	0.0128205
NODE_20762_length_644_cov_59.286239	323	401	297	1	78	0.0128205
NODE_20762_length_644_cov_59.286239	323	401	300	2	78	0.0256410
NODE_20762_length_644_cov_59.286239	323	401	301	2	78	0.0256410
NODE_20762_length_644_cov_59.286239	323	401	303	3	78	0.0384615
NODE_20762_length_644_cov_59.286239	323	401	304	1	78	0.0128205
NODE_20762_length_644_cov_59.286239	323	401	305	3	78	0.0384615
NODE_20762_length_644_cov_59.286239	323	401	307	1	78	0.0128205
NODE_20762_length_644_cov_59.286239	323	401	308	1	78	0.0128205
NODE_20762_length_644_cov_59.286239	323	401	314	1	78	0.0128205
NODE_20762_length_644_cov_59.286239	323	401	318	2	78	0.0256410
NODE_20762_length_644_cov_59.286239	323	401	319	1	78	0.0128205
NODE_20762_length_644_cov_59.286239	323	401	320	1	78	0.0128205
NODE_20762_length_644_cov_59.286239	323	401	323	1	78	0.0128205
NODE_20762_length_644_cov_59.286239	323	401	324	1	78	0.0128205
NODE_20763_length_644_cov_27.577982	63	143	0	80	80	1.0000000
NODE_20763_length_644_cov_27.577982	116	196	0	80	80	1.0000000
NODE_20765_length_644_cov_10.073394	284	364	0	80	80	1.0000000
NODE_20765_length_644_cov_10.073394	337	417	0	80	80	1.0000000
NODE_20845_length_643_cov_27.562500	201	281	0	80	80	1.0000000
NODE_20845_length_643_cov_27.562500	254	334	0	80	80	1.0000000
NODE_20845_length_643_cov_27.562500	330	410	0	14	80	0.1750000
NODE_20845_length_643_cov_27.562500	330	410	2	6	80	0.0750000
NODE_20845_length_643_cov_27.562500	330	410	4	3	80	0.0375000
NODE_20845_length_643_cov_27.562500	330	410	6	57	80	0.7125000
NODE_20845_length_643_cov_27.562500	383	463	2	33	80	0.4125000
NODE_20845_length_643_cov_27.562500	383	463	4	21	80	0.2625000
NODE_20845_length_643_cov_27.562500	383	463	6	26	80	0.3250000
NODE_20846_length_643_cov_12.895221	203	283	0	17	80	0.2125000
NODE_20846_length_643_cov_12.895221	203	283	2	63	80	0.7875000
NODE_20846_length_643_cov_12.895221	256	336	0	70	80	0.8750000
NODE_20846_length_643_cov_12.895221	256	336	2	10	80	0.1250000
NODE_20847_length_643_cov_10.501838	280	360	2	80	80	1.0000000
NODE_20847_length_643_cov_10.501838	333	413	0	42	80	0.5250000
NODE_20847_length_643_cov_10.501838	333	413	2	38	80	0.4750000
NODE_20848_length_643_cov_9.136029	307	385	6	17	78	0.2179487
NODE_20848_length_643_cov_9.136029	307	385	7	24	78	0.3076923
NODE_20848_length_643_cov_9.136029	307	385	8	26	78	0.3333333
NODE_20848_length_643_cov_9.136029	307	385	9	5	78	0.0641026
NODE_20848_length_643_cov_9.136029	307	385	10	6	78	0.0769231
NODE_20848_length_643_cov_9.136029	358	438	4	27	80	0.3375000
NODE_20848_length_643_cov_9.136029	358	438	6	34	80	0.4250000
NODE_20848_length_643_cov_9.136029	358	438	7	8	80	0.1000000
NODE_20848_length_643_cov_9.136029	358	438	9	5	80	0.0625000
NODE_20848_length_643_cov_9.136029	358	438	10	6	80	0.0750000
NODE_20849_length_643_cov_8.264706	202	282	0	80	80	1.0000000
NODE_20849_length_643_cov_8.264706	255	335	0	80	80	1.0000000
NODE_20851_length_643_cov_7.137868	173	253	0	80	80	1.0000000
NODE_20851_length_643_cov_7.137868	226	306	0	80	80	1.0000000
NODE_20855_length_643_cov_5.851103	255	335	12	10	80	0.1250000
NODE_20855_length_643_cov_5.851103	255	335	14	7	80	0.0875000
NODE_20855_length_643_cov_5.851103	255	335	16	11	80	0.1375000
NODE_20855_length_643_cov_5.851103	255	335	20	1	80	0.0125000
NODE_20855_length_643_cov_5.851103	255	335	22	8	80	0.1000000
NODE_20855_length_643_cov_5.851103	255	335	24	5	80	0.0625000
NODE_20855_length_643_cov_5.851103	255	335	28	5	80	0.0625000
NODE_20855_length_643_cov_5.851103	255	335	30	6	80	0.0750000
NODE_20855_length_643_cov_5.851103	255	335	32	27	80	0.3375000
NODE_20855_length_643_cov_5.851103	308	388	4	3	80	0.0375000
NODE_20855_length_643_cov_5.851103	308	388	5	7	80	0.0875000
NODE_20855_length_643_cov_5.851103	308	388	6	16	80	0.2000000
NODE_20855_length_643_cov_5.851103	308	388	8	3	80	0.0375000
NODE_20855_length_643_cov_5.851103	308	388	10	14	80	0.1750000
NODE_20855_length_643_cov_5.851103	308	388	12	20	80	0.2500000
NODE_20855_length_643_cov_5.851103	308	388	14	7	80	0.0875000
NODE_20855_length_643_cov_5.851103	308	388	16	10	80	0.1250000
NODE_20869_length_643_cov_3.121324	283	348	0	65	65	1.0000000
NODE_20872_length_643_cov_2.806985	387	451	0	5	64	0.0781250
NODE_20872_length_643_cov_2.806985	387	451	2	59	64	0.9218750
NODE_20942_length_642_cov_36.309392	156	236	0	80	80	1.0000000
NODE_20942_length_642_cov_36.309392	209	289	0	80	80	1.0000000
NODE_20943_length_642_cov_27.046041	154	234	0	80	80	1.0000000
NODE_20943_length_642_cov_27.046041	207	287	0	80	80	1.0000000
NODE_20944_length_642_cov_26.290976	209	289	0	80	80	1.0000000
NODE_20944_length_642_cov_26.290976	262	342	0	80	80	1.0000000
NODE_20945_length_642_cov_11.651934	309	389	0	80	80	1.0000000
NODE_20945_length_642_cov_11.651934	362	442	0	80	80	1.0000000
NODE_20947_length_642_cov_6.692449	453	533	2	12	80	0.1500000
NODE_20947_length_642_cov_6.692449	453	533	4	46	80	0.5750000
NODE_20947_length_642_cov_6.692449	453	533	6	22	80	0.2750000
NODE_20947_length_642_cov_6.692449	506	586	0	21	80	0.2625000
NODE_20947_length_642_cov_6.692449	506	586	2	26	80	0.3250000
NODE_20947_length_642_cov_6.692449	506	586	4	33	80	0.4125000
NODE_20951_length_642_cov_5.933702	260	340	0	80	80	1.0000000
NODE_20951_length_642_cov_5.933702	313	391	0	78	78	1.0000000
NODE_20967_length_642_cov_2.823204	115	158	10	6	43	0.1395349
NODE_20967_length_642_cov_2.823204	115	158	12	9	43	0.2093023
NODE_20967_length_642_cov_2.823204	115	158	14	3	43	0.0697674
NODE_20967_length_642_cov_2.823204	115	158	16	11	43	0.2558140
NODE_20967_length_642_cov_2.823204	115	158	18	1	43	0.0232558
NODE_20967_length_642_cov_2.823204	115	158	19	2	43	0.0465116
NODE_20967_length_642_cov_2.823204	115	158	20	11	43	0.2558140
NODE_20967_length_642_cov_2.823204	245	300	19	1	55	0.0181818
NODE_20967_length_642_cov_2.823204	245	300	20	3	55	0.0545455
NODE_20967_length_642_cov_2.823204	245	300	21	4	55	0.0727273
NODE_20967_length_642_cov_2.823204	245	300	23	2	55	0.0363636
NODE_20967_length_642_cov_2.823204	245	300	24	7	55	0.1272727
NODE_20967_length_642_cov_2.823204	245	300	26	6	55	0.1090909
NODE_20967_length_642_cov_2.823204	245	300	30	4	55	0.0727273
NODE_20967_length_642_cov_2.823204	245	300	32	4	55	0.0727273
NODE_20967_length_642_cov_2.823204	245	300	34	1	55	0.0181818
NODE_20967_length_642_cov_2.823204	245	300	35	2	55	0.0363636
NODE_20967_length_642_cov_2.823204	245	300	36	3	55	0.0545455
NODE_20967_length_642_cov_2.823204	245	300	37	12	55	0.2181818
NODE_20967_length_642_cov_2.823204	245	300	38	6	55	0.1090909
NODE_20967_length_642_cov_2.823204	329	410	16	13	81	0.1604938
NODE_20967_length_642_cov_2.823204	329	410	18	21	81	0.2592593
NODE_20967_length_642_cov_2.823204	329	410	24	11	81	0.1358025
NODE_20967_length_642_cov_2.823204	329	410	26	11	81	0.1358025
NODE_20967_length_642_cov_2.823204	329	410	29	6	81	0.0740741
NODE_20967_length_642_cov_2.823204	329	410	30	17	81	0.2098765
NODE_20967_length_642_cov_2.823204	329	410	31	2	81	0.0246914
NODE_20991_length_642_cov_1.357274	0	75	0	75	75	1.0000000
NODE_21018_length_641_cov_38.675277	284	345	4	5	61	0.0819672
NODE_21018_length_641_cov_38.675277	284	345	6	7	61	0.1147541
NODE_21018_length_641_cov_38.675277	284	345	10	7	61	0.1147541
NODE_21018_length_641_cov_38.675277	284	345	11	4	61	0.0655738
NODE_21018_length_641_cov_38.675277	284	345	15	1	61	0.0163934
NODE_21018_length_641_cov_38.675277	284	345	17	1	61	0.0163934
NODE_21018_length_641_cov_38.675277	284	345	19	7	61	0.1147541
NODE_21018_length_641_cov_38.675277	284	345	21	7	61	0.1147541
NODE_21018_length_641_cov_38.675277	284	345	23	1	61	0.0163934
NODE_21018_length_641_cov_38.675277	284	345	25	2	61	0.0327869
NODE_21018_length_641_cov_38.675277	284	345	29	1	61	0.0163934
NODE_21018_length_641_cov_38.675277	284	345	31	3	61	0.0491803
NODE_21018_length_641_cov_38.675277	284	345	33	1	61	0.0163934
NODE_21018_length_641_cov_38.675277	284	345	35	1	61	0.0163934
NODE_21018_length_641_cov_38.675277	284	345	39	3	61	0.0491803
NODE_21018_length_641_cov_38.675277	284	345	40	1	61	0.0163934
NODE_21018_length_641_cov_38.675277	284	345	41	1	61	0.0163934
NODE_21018_length_641_cov_38.675277	284	345	45	1	61	0.0163934
NODE_21018_length_641_cov_38.675277	284	345	47	3	61	0.0491803
NODE_21018_length_641_cov_38.675277	284	345	49	4	61	0.0655738
NODE_21018_length_641_cov_38.675277	318	369	21	5	51	0.0980392
NODE_21018_length_641_cov_38.675277	318	369	23	1	51	0.0196078
NODE_21018_length_641_cov_38.675277	318	369	25	2	51	0.0392157
NODE_21018_length_641_cov_38.675277	318	369	29	1	51	0.0196078
NODE_21018_length_641_cov_38.675277	318	369	31	3	51	0.0588235
NODE_21018_length_641_cov_38.675277	318	369	33	1	51	0.0196078
NODE_21018_length_641_cov_38.675277	318	369	35	1	51	0.0196078
NODE_21018_length_641_cov_38.675277	318	369	39	3	51	0.0588235
NODE_21018_length_641_cov_38.675277	318	369	40	1	51	0.0196078
NODE_21018_length_641_cov_38.675277	318	369	41	1	51	0.0196078
NODE_21018_length_641_cov_38.675277	318	369	45	1	51	0.0196078
NODE_21018_length_641_cov_38.675277	318	369	47	3	51	0.0588235
NODE_21018_length_641_cov_38.675277	318	369	49	6	51	0.1176471
NODE_21018_length_641_cov_38.675277	318	369	50	10	51	0.1960784
NODE_21018_length_641_cov_38.675277	318	369	51	1	51	0.0196078
NODE_21018_length_641_cov_38.675277	318	369	52	11	51	0.2156863
NODE_21019_length_641_cov_15.271218	260	340	0	80	80	1.0000000
NODE_21019_length_641_cov_15.271218	313	393	0	80	80	1.0000000
NODE_21021_length_641_cov_12.584871	363	443	0	80	80	1.0000000
NODE_21021_length_641_cov_12.584871	416	496	0	80	80	1.0000000
NODE_21022_length_641_cov_11.125461	38	118	0	80	80	1.0000000
NODE_21022_length_641_cov_11.125461	91	171	0	80	80	1.0000000
NODE_21025_length_641_cov_7.719557	84	138	2	54	54	1.0000000
NODE_21025_length_641_cov_7.719557	113	193	0	20	80	0.2500000
NODE_21025_length_641_cov_7.719557	113	193	2	60	80	0.7500000
NODE_21026_length_641_cov_7.675277	232	312	0	80	80	1.0000000
NODE_21026_length_641_cov_7.675277	285	365	0	80	80	1.0000000
NODE_21027_length_641_cov_7.675277	255	335	0	43	80	0.5375000
NODE_21027_length_641_cov_7.675277	255	335	2	37	80	0.4625000
NODE_21027_length_641_cov_7.675277	308	388	2	80	80	1.0000000
NODE_21028_length_641_cov_7.627306	262	342	0	80	80	1.0000000
NODE_21028_length_641_cov_7.627306	315	395	0	80	80	1.0000000
NODE_21029_length_641_cov_7.282288	247	300	0	53	53	1.0000000
NODE_21031_length_641_cov_5.029520	138	218	0	80	80	1.0000000
NODE_21031_length_641_cov_5.029520	191	271	0	74	80	0.9250000
NODE_21031_length_641_cov_5.029520	191	271	2	6	80	0.0750000
NODE_21034_length_641_cov_4.701107	238	282	2	34	44	0.7727273
NODE_21034_length_641_cov_4.701107	238	282	4	10	44	0.2272727
NODE_21109_length_640_cov_39.676525	524	597	19	1	73	0.0136986
NODE_21109_length_640_cov_39.676525	524	597	21	1	73	0.0136986
NODE_21109_length_640_cov_39.676525	524	597	23	2	73	0.0273973
NODE_21109_length_640_cov_39.676525	524	597	25	1	73	0.0136986
NODE_21109_length_640_cov_39.676525	524	597	27	9	73	0.1232877
NODE_21109_length_640_cov_39.676525	524	597	30	11	73	0.1506849
NODE_21109_length_640_cov_39.676525	524	597	32	1	73	0.0136986
NODE_21109_length_640_cov_39.676525	524	597	35	1	73	0.0136986
NODE_21109_length_640_cov_39.676525	524	597	36	1	73	0.0136986
NODE_21109_length_640_cov_39.676525	524	597	37	4	73	0.0547945
NODE_21109_length_640_cov_39.676525	524	597	39	3	73	0.0410959
NODE_21109_length_640_cov_39.676525	524	597	40	1	73	0.0136986
NODE_21109_length_640_cov_39.676525	524	597	41	4	73	0.0547945
NODE_21109_length_640_cov_39.676525	524	597	42	2	73	0.0273973
NODE_21109_length_640_cov_39.676525	524	597	43	4	73	0.0547945
NODE_21109_length_640_cov_39.676525	524	597	46	6	73	0.0821918
NODE_21109_length_640_cov_39.676525	524	597	48	3	73	0.0410959
NODE_21109_length_640_cov_39.676525	524	597	50	4	73	0.0547945
NODE_21109_length_640_cov_39.676525	524	597	52	14	73	0.1917808
NODE_21109_length_640_cov_39.676525	564	605	19	9	41	0.2195122
NODE_21109_length_640_cov_39.676525	564	605	21	1	41	0.0243902
NODE_21109_length_640_cov_39.676525	564	605	23	2	41	0.0487805
NODE_21109_length_640_cov_39.676525	564	605	25	1	41	0.0243902
NODE_21109_length_640_cov_39.676525	564	605	27	9	41	0.2195122
NODE_21109_length_640_cov_39.676525	564	605	30	11	41	0.2682927
NODE_21109_length_640_cov_39.676525	564	605	32	1	41	0.0243902
NODE_21109_length_640_cov_39.676525	564	605	35	1	41	0.0243902
NODE_21109_length_640_cov_39.676525	564	605	36	1	41	0.0243902
NODE_21109_length_640_cov_39.676525	564	605	37	4	41	0.0975610
NODE_21109_length_640_cov_39.676525	564	605	39	1	41	0.0243902
NODE_21110_length_640_cov_19.578558	273	353	0	80	80	1.0000000
NODE_21110_length_640_cov_19.578558	326	406	0	80	80	1.0000000
NODE_21111_length_640_cov_15.717190	178	258	0	80	80	1.0000000
NODE_21111_length_640_cov_15.717190	231	311	0	80	80	1.0000000
NODE_21112_length_640_cov_15.338262	319	399	0	80	80	1.0000000
NODE_21112_length_640_cov_15.338262	372	452	0	80	80	1.0000000
NODE_21113_length_640_cov_9.523105	20	43	0	23	23	1.0000000
NODE_21118_length_640_cov_5.123845	272	335	0	63	63	1.0000000
NODE_21121_length_640_cov_4.410351	254	334	0	80	80	1.0000000
NODE_21121_length_640_cov_4.410351	307	387	0	80	80	1.0000000
NODE_21129_length_640_cov_3.406654	244	324	4	40	80	0.5000000
NODE_21129_length_640_cov_3.406654	244	324	6	40	80	0.5000000
NODE_21140_length_640_cov_2.316081	21	57	0	36	36	1.0000000
NODE_21190_length_639_cov_58.092593	302	377	0	75	75	1.0000000
NODE_21190_length_639_cov_58.092593	350	430	0	80	80	1.0000000
NODE_21191_length_639_cov_32.951852	213	293	0	80	80	1.0000000
NODE_21191_length_639_cov_32.951852	266	346	0	80	80	1.0000000
NODE_21192_length_639_cov_24.564815	290	370	0	57	80	0.7125000
NODE_21192_length_639_cov_24.564815	290	370	2	22	80	0.2750000
NODE_21192_length_639_cov_24.564815	290	370	3	1	80	0.0125000
NODE_21192_length_639_cov_24.564815	343	423	0	4	80	0.0500000
NODE_21192_length_639_cov_24.564815	343	423	2	22	80	0.2750000
NODE_21192_length_639_cov_24.564815	343	423	3	25	80	0.3125000
NODE_21192_length_639_cov_24.564815	343	423	5	7	80	0.0875000
NODE_21192_length_639_cov_24.564815	343	423	6	22	80	0.2750000
NODE_21193_length_639_cov_14.448148	288	368	0	80	80	1.0000000
NODE_21193_length_639_cov_14.448148	341	421	0	80	80	1.0000000
NODE_21195_length_639_cov_9.001852	265	345	2	19	80	0.2375000
NODE_21195_length_639_cov_9.001852	265	345	4	32	80	0.4000000
NODE_21195_length_639_cov_9.001852	265	345	6	29	80	0.3625000
NODE_21195_length_639_cov_9.001852	318	398	0	16	80	0.2000000
NODE_21195_length_639_cov_9.001852	318	398	2	27	80	0.3375000
NODE_21195_length_639_cov_9.001852	318	398	4	7	80	0.0875000
NODE_21195_length_639_cov_9.001852	318	398	6	30	80	0.3750000
NODE_21197_length_639_cov_8.444444	161	241	6	22	80	0.2750000
NODE_21197_length_639_cov_8.444444	161	241	8	29	80	0.3625000
NODE_21197_length_639_cov_8.444444	161	241	10	29	80	0.3625000
NODE_21197_length_639_cov_8.444444	214	294	2	4	80	0.0500000
NODE_21197_length_639_cov_8.444444	214	294	6	47	80	0.5875000
NODE_21197_length_639_cov_8.444444	214	294	8	29	80	0.3625000
NODE_21202_length_639_cov_6.283333	157	176	0	19	19	1.0000000
NODE_21207_length_639_cov_4.188889	258	335	0	64	77	0.8311688
NODE_21207_length_639_cov_4.188889	258	335	4	13	77	0.1688312
NODE_21207_length_639_cov_4.188889	308	354	0	14	46	0.3043478
NODE_21207_length_639_cov_4.188889	308	354	4	32	46	0.6956522
NODE_21213_length_639_cov_3.448148	126	206	0	80	80	1.0000000
NODE_21213_length_639_cov_3.448148	179	259	0	80	80	1.0000000
NODE_21223_length_639_cov_2.683333	256	288	0	32	32	1.0000000
NODE_21224_length_639_cov_2.555556	189	240	6	1	51	0.0196078
NODE_21224_length_639_cov_2.555556	189	240	10	1	51	0.0196078
NODE_21224_length_639_cov_2.555556	189	240	12	5	51	0.0980392
NODE_21224_length_639_cov_2.555556	189	240	14	1	51	0.0196078
NODE_21224_length_639_cov_2.555556	189	240	16	43	51	0.8431373
NODE_21225_length_639_cov_2.477778	562	635	0	73	73	1.0000000
NODE_21265_length_639_cov_1.179630	542	564	0	22	22	1.0000000
NODE_21269_length_639_cov_1.051852	404	455	4	51	51	1.0000000
NODE_21278_length_638_cov_13.018553	273	353	0	72	80	0.9000000
NODE_21278_length_638_cov_13.018553	273	353	2	8	80	0.1000000
NODE_21278_length_638_cov_13.018553	326	406	0	80	80	1.0000000
NODE_21279_length_638_cov_12.656772	343	423	2	23	80	0.2875000
NODE_21279_length_638_cov_12.656772	343	423	4	22	80	0.2750000
NODE_21279_length_638_cov_12.656772	343	423	6	35	80	0.4375000
NODE_21279_length_638_cov_12.656772	396	476	2	32	80	0.4000000
NODE_21279_length_638_cov_12.656772	396	476	4	27	80	0.3375000
NODE_21279_length_638_cov_12.656772	396	476	6	21	80	0.2625000
NODE_21280_length_638_cov_11.877551	298	378	0	30	80	0.3750000
NODE_21280_length_638_cov_11.877551	298	378	2	50	80	0.6250000
NODE_21280_length_638_cov_11.877551	351	431	0	15	80	0.1875000
NODE_21280_length_638_cov_11.877551	351	431	2	65	80	0.8125000
NODE_21281_length_638_cov_8.779221	330	408	0	39	78	0.5000000
NODE_21281_length_638_cov_8.779221	330	408	2	39	78	0.5000000
NODE_21281_length_638_cov_8.779221	383	461	0	4	78	0.0512821
NODE_21281_length_638_cov_8.779221	383	461	2	74	78	0.9487180
NODE_21284_length_638_cov_5.543599	315	395	0	80	80	1.0000000
NODE_21290_length_638_cov_3.966605	307	387	0	26	80	0.3250000
NODE_21290_length_638_cov_3.966605	307	387	2	54	80	0.6750000
NODE_21301_length_638_cov_2.786642	157	208	0	51	51	1.0000000
NODE_21301_length_638_cov_2.786642	181	261	0	80	80	1.0000000
NODE_21364_length_637_cov_67.157993	285	365	0	80	80	1.0000000
NODE_21364_length_637_cov_67.157993	338	418	0	80	80	1.0000000
NODE_21364_length_637_cov_67.157993	414	494	0	80	80	1.0000000
NODE_21364_length_637_cov_67.157993	467	547	0	80	80	1.0000000
NODE_21365_length_637_cov_63.029740	195	275	0	52	80	0.6500000
NODE_21365_length_637_cov_63.029740	195	275	2	28	80	0.3500000
NODE_21365_length_637_cov_63.029740	248	328	0	10	80	0.1250000
NODE_21365_length_637_cov_63.029740	248	328	2	70	80	0.8750000
NODE_21366_length_637_cov_44.923792	53	133	0	3	80	0.0375000
NODE_21366_length_637_cov_44.923792	53	133	2	37	80	0.4625000
NODE_21366_length_637_cov_44.923792	53	133	3	6	80	0.0750000
NODE_21366_length_637_cov_44.923792	53	133	4	34	80	0.4250000
NODE_21366_length_637_cov_44.923792	54	133	0	3	79	0.0379747
NODE_21366_length_637_cov_44.923792	54	133	2	36	79	0.4556962
NODE_21366_length_637_cov_44.923792	54	133	3	6	79	0.0759494
NODE_21366_length_637_cov_44.923792	54	133	4	34	79	0.4303797
NODE_21366_length_637_cov_44.923792	106	186	0	56	80	0.7000000
NODE_21366_length_637_cov_44.923792	106	186	2	24	80	0.3000000
NODE_21366_length_637_cov_44.923792	106	186	0	56	80	0.7000000
NODE_21366_length_637_cov_44.923792	106	186	2	24	80	0.3000000
NODE_21366_length_637_cov_44.923792	182	262	0	50	80	0.6250000
NODE_21366_length_637_cov_44.923792	182	262	6	30	80	0.3750000
NODE_21366_length_637_cov_44.923792	235	315	1	8	80	0.1000000
NODE_21366_length_637_cov_44.923792	235	315	2	1	80	0.0125000
NODE_21366_length_637_cov_44.923792	235	315	4	3	80	0.0375000
NODE_21366_length_637_cov_44.923792	235	315	6	68	80	0.8500000
NODE_21367_length_637_cov_44.193309	193	273	0	80	80	1.0000000
NODE_21367_length_637_cov_44.193309	246	326	0	80	80	1.0000000
NODE_21368_length_637_cov_37.855019	215	295	0	26	80	0.3250000
NODE_21368_length_637_cov_37.855019	215	295	4	54	80	0.6750000
NODE_21368_length_637_cov_37.855019	268	347	0	70	79	0.8860760
NODE_21368_length_637_cov_37.855019	268	347	2	8	79	0.1012658
NODE_21368_length_637_cov_37.855019	268	347	4	1	79	0.0126582
NODE_21369_length_637_cov_33.957249	332	412	0	9	80	0.1125000
NODE_21369_length_637_cov_33.957249	332	412	2	71	80	0.8875000
NODE_21369_length_637_cov_33.957249	385	465	0	61	80	0.7625000
NODE_21369_length_637_cov_33.957249	385	465	2	19	80	0.2375000
NODE_21370_length_637_cov_23.682156	275	355	0	18	80	0.2250000
NODE_21370_length_637_cov_23.682156	275	355	2	62	80	0.7750000
NODE_21370_length_637_cov_23.682156	328	408	0	43	80	0.5375000
NODE_21370_length_637_cov_23.682156	328	408	2	37	80	0.4625000
NODE_21371_length_637_cov_19.676580	267	347	0	5	80	0.0625000
NODE_21371_length_637_cov_19.676580	267	347	2	8	80	0.1000000
NODE_21371_length_637_cov_19.676580	267	347	4	24	80	0.3000000
NODE_21371_length_637_cov_19.676580	267	347	6	43	80	0.5375000
NODE_21371_length_637_cov_19.676580	320	400	2	31	80	0.3875000
NODE_21371_length_637_cov_19.676580	320	400	4	26	80	0.3250000
NODE_21371_length_637_cov_19.676580	320	400	6	23	80	0.2875000
NODE_21373_length_637_cov_9.182156	226	276	0	50	50	1.0000000
NODE_21373_length_637_cov_9.182156	312	357	0	45	45	1.0000000
NODE_21374_length_637_cov_9.078067	276	357	4	64	81	0.7901235
NODE_21374_length_637_cov_9.078067	276	357	6	13	81	0.1604938
NODE_21374_length_637_cov_9.078067	276	357	8	4	81	0.0493827
NODE_21374_length_637_cov_9.078067	330	410	0	12	80	0.1500000
NODE_21374_length_637_cov_9.078067	330	410	2	3	80	0.0375000
NODE_21374_length_637_cov_9.078067	330	410	4	65	80	0.8125000
NODE_21375_length_637_cov_8.566914	235	315	0	80	80	1.0000000
NODE_21375_length_637_cov_8.566914	288	368	0	80	80	1.0000000
NODE_21378_length_637_cov_6.652416	337	415	2	78	78	1.0000000
NODE_21378_length_637_cov_6.652416	390	472	0	33	82	0.4024390
NODE_21378_length_637_cov_6.652416	390	472	2	49	82	0.5975610
NODE_21385_length_637_cov_4.522305	284	364	0	80	80	1.0000000
NODE_21385_length_637_cov_4.522305	337	417	0	80	80	1.0000000
NODE_21389_length_637_cov_4.131970	292	370	0	78	78	1.0000000
NODE_21389_length_637_cov_4.131970	343	423	0	80	80	1.0000000
NODE_21457_length_636_cov_19.938547	214	294	0	80	80	1.0000000
NODE_21457_length_636_cov_19.938547	267	347	0	80	80	1.0000000
NODE_21458_length_636_cov_12.283054	295	375	0	80	80	1.0000000
NODE_21458_length_636_cov_12.283054	348	428	0	80	80	1.0000000
NODE_21460_length_636_cov_8.312849	346	413	2	67	67	1.0000000
NODE_21460_length_636_cov_8.312849	399	479	0	35	80	0.4375000
NODE_21460_length_636_cov_8.312849	399	479	2	45	80	0.5625000
NODE_21467_length_636_cov_4.324022	185	251	0	66	66	1.0000000
NODE_21467_length_636_cov_4.324022	224	266	0	42	42	1.0000000
NODE_21467_length_636_cov_4.324022	224	264	0	40	40	1.0000000
NODE_21539_length_635_cov_45.483209	195	239	258	1	44	0.0227273
NODE_21539_length_635_cov_45.483209	195	239	262	1	44	0.0227273
NODE_21539_length_635_cov_45.483209	195	239	266	3	44	0.0681818
NODE_21539_length_635_cov_45.483209	195	239	267	1	44	0.0227273
NODE_21539_length_635_cov_45.483209	195	239	268	2	44	0.0454545
NODE_21539_length_635_cov_45.483209	195	239	269	1	44	0.0227273
NODE_21539_length_635_cov_45.483209	195	239	270	6	44	0.1363636
NODE_21539_length_635_cov_45.483209	195	239	271	2	44	0.0454545
NODE_21539_length_635_cov_45.483209	195	239	272	3	44	0.0681818
NODE_21539_length_635_cov_45.483209	195	239	274	10	44	0.2272727
NODE_21539_length_635_cov_45.483209	195	239	276	3	44	0.0681818
NODE_21539_length_635_cov_45.483209	195	239	277	4	44	0.0909091
NODE_21539_length_635_cov_45.483209	195	239	280	3	44	0.0681818
NODE_21539_length_635_cov_45.483209	195	239	281	3	44	0.0681818
NODE_21539_length_635_cov_45.483209	195	239	283	1	44	0.0227273
NODE_21539_length_635_cov_45.483209	225	268	202	1	43	0.0232558
NODE_21539_length_635_cov_45.483209	225	268	204	1	43	0.0232558
NODE_21539_length_635_cov_45.483209	225	268	212	1	43	0.0232558
NODE_21539_length_635_cov_45.483209	225	268	216	1	43	0.0232558
NODE_21539_length_635_cov_45.483209	225	268	220	2	43	0.0465116
NODE_21539_length_635_cov_45.483209	225	268	224	2	43	0.0465116
NODE_21539_length_635_cov_45.483209	225	268	234	1	43	0.0232558
NODE_21539_length_635_cov_45.483209	225	268	244	1	43	0.0232558
NODE_21539_length_635_cov_45.483209	225	268	250	2	43	0.0465116
NODE_21539_length_635_cov_45.483209	225	268	251	1	43	0.0232558
NODE_21539_length_635_cov_45.483209	225	268	253	1	43	0.0232558
NODE_21539_length_635_cov_45.483209	225	268	256	1	43	0.0232558
NODE_21539_length_635_cov_45.483209	225	268	257	1	43	0.0232558
NODE_21539_length_635_cov_45.483209	225	268	258	5	43	0.1162791
NODE_21539_length_635_cov_45.483209	225	268	260	6	43	0.1395349
NODE_21539_length_635_cov_45.483209	225	268	261	1	43	0.0232558
NODE_21539_length_635_cov_45.483209	225	268	262	1	43	0.0232558
NODE_21539_length_635_cov_45.483209	225	268	266	2	43	0.0465116
NODE_21539_length_635_cov_45.483209	225	268	268	2	43	0.0465116
NODE_21539_length_635_cov_45.483209	225	268	274	3	43	0.0697674
NODE_21539_length_635_cov_45.483209	225	268	276	2	43	0.0465116
NODE_21539_length_635_cov_45.483209	225	268	277	4	43	0.0930233
NODE_21539_length_635_cov_45.483209	225	268	280	1	43	0.0232558
NODE_21539_length_635_cov_45.483209	248	298	120	1	50	0.0200000
NODE_21539_length_635_cov_45.483209	248	298	124	1	50	0.0200000
NODE_21539_length_635_cov_45.483209	248	298	125	2	50	0.0400000
NODE_21539_length_635_cov_45.483209	248	298	126	3	50	0.0600000
NODE_21539_length_635_cov_45.483209	248	298	128	1	50	0.0200000
NODE_21539_length_635_cov_45.483209	248	298	136	3	50	0.0600000
NODE_21539_length_635_cov_45.483209	248	298	141	1	50	0.0200000
NODE_21539_length_635_cov_45.483209	248	298	143	1	50	0.0200000
NODE_21539_length_635_cov_45.483209	248	298	147	2	50	0.0400000
NODE_21539_length_635_cov_45.483209	248	298	149	1	50	0.0200000
NODE_21539_length_635_cov_45.483209	248	298	156	2	50	0.0400000
NODE_21539_length_635_cov_45.483209	248	298	160	2	50	0.0400000
NODE_21539_length_635_cov_45.483209	248	298	166	1	50	0.0200000
NODE_21539_length_635_cov_45.483209	248	298	170	1	50	0.0200000
NODE_21539_length_635_cov_45.483209	248	298	171	2	50	0.0400000
NODE_21539_length_635_cov_45.483209	248	298	174	1	50	0.0200000
NODE_21539_length_635_cov_45.483209	248	298	199	2	50	0.0400000
NODE_21539_length_635_cov_45.483209	248	298	200	1	50	0.0200000
NODE_21539_length_635_cov_45.483209	248	298	201	2	50	0.0400000
NODE_21539_length_635_cov_45.483209	248	298	202	1	50	0.0200000
NODE_21539_length_635_cov_45.483209	248	298	204	1	50	0.0200000
NODE_21539_length_635_cov_45.483209	248	298	212	1	50	0.0200000
NODE_21539_length_635_cov_45.483209	248	298	216	1	50	0.0200000
NODE_21539_length_635_cov_45.483209	248	298	220	2	50	0.0400000
NODE_21539_length_635_cov_45.483209	248	298	224	2	50	0.0400000
NODE_21539_length_635_cov_45.483209	248	298	234	1	50	0.0200000
NODE_21539_length_635_cov_45.483209	248	298	244	1	50	0.0200000
NODE_21539_length_635_cov_45.483209	248	298	250	2	50	0.0400000
NODE_21539_length_635_cov_45.483209	248	298	251	1	50	0.0200000
NODE_21539_length_635_cov_45.483209	248	298	253	1	50	0.0200000
NODE_21539_length_635_cov_45.483209	248	298	257	1	50	0.0200000
NODE_21539_length_635_cov_45.483209	248	298	258	2	50	0.0400000
NODE_21539_length_635_cov_45.483209	248	298	260	2	50	0.0400000
NODE_21539_length_635_cov_45.483209	248	298	262	1	50	0.0200000
NODE_21541_length_635_cov_23.895522	179	259	0	80	80	1.0000000
NODE_21541_length_635_cov_23.895522	232	312	0	80	80	1.0000000
NODE_21543_length_635_cov_14.772388	48	128	0	80	80	1.0000000
NODE_21543_length_635_cov_14.772388	101	181	0	80	80	1.0000000
NODE_21549_length_635_cov_6.180970	276	356	0	80	80	1.0000000
NODE_21549_length_635_cov_6.180970	329	409	0	80	80	1.0000000
NODE_21554_length_635_cov_4.421642	442	522	0	80	80	1.0000000
NODE_21560_length_635_cov_2.985075	296	376	10	6	80	0.0750000
NODE_21560_length_635_cov_2.985075	296	376	12	2	80	0.0250000
NODE_21560_length_635_cov_2.985075	296	376	14	3	80	0.0375000
NODE_21560_length_635_cov_2.985075	296	376	16	12	80	0.1500000
NODE_21560_length_635_cov_2.985075	296	376	18	9	80	0.1125000
NODE_21560_length_635_cov_2.985075	296	376	21	1	80	0.0125000
NODE_21560_length_635_cov_2.985075	296	376	22	1	80	0.0125000
NODE_21560_length_635_cov_2.985075	296	376	23	1	80	0.0125000
NODE_21560_length_635_cov_2.985075	296	376	24	23	80	0.2875000
NODE_21560_length_635_cov_2.985075	296	376	25	2	80	0.0250000
NODE_21560_length_635_cov_2.985075	296	376	26	20	80	0.2500000
NODE_21625_length_634_cov_53.315888	349	429	0	38	80	0.4750000
NODE_21625_length_634_cov_53.315888	349	429	2	42	80	0.5250000
NODE_21625_length_634_cov_53.315888	402	482	0	41	80	0.5125000
NODE_21625_length_634_cov_53.315888	402	482	2	39	80	0.4875000
NODE_21626_length_634_cov_28.530841	156	236	4	80	80	1.0000000
NODE_21626_length_634_cov_28.530841	209	289	0	31	80	0.3875000
NODE_21626_length_634_cov_28.530841	209	289	4	49	80	0.6125000
NODE_21627_length_634_cov_19.117757	151	229	0	6	78	0.0769231
NODE_21627_length_634_cov_19.117757	151	229	2	72	78	0.9230769
NODE_21627_length_634_cov_19.117757	204	268	0	45	64	0.7031250
NODE_21627_length_634_cov_19.117757	204	268	2	19	64	0.2968750
NODE_21628_length_634_cov_18.762617	84	164	0	80	80	1.0000000
NODE_21628_length_634_cov_18.762617	137	217	0	80	80	1.0000000
NODE_21629_length_634_cov_18.136449	162	242	0	80	80	1.0000000
NODE_21629_length_634_cov_18.136449	215	295	0	80	80	1.0000000
NODE_21635_length_634_cov_9.988785	508	553	2	36	45	0.8000000
NODE_21635_length_634_cov_9.988785	508	553	4	9	45	0.2000000
NODE_21636_length_634_cov_9.381308	267	353	0	86	86	1.0000000
NODE_21636_length_634_cov_9.381308	324	404	0	80	80	1.0000000
NODE_21651_length_634_cov_3.702804	460	532	0	39	72	0.5416667
NODE_21651_length_634_cov_3.702804	460	532	2	18	72	0.2500000
NODE_21651_length_634_cov_3.702804	460	532	4	15	72	0.2083333
NODE_21720_length_633_cov_30.076779	180	214	0	34	34	1.0000000
NODE_21720_length_633_cov_30.076779	187	267	0	80	80	1.0000000
NODE_21720_length_633_cov_30.076779	263	343	0	80	80	1.0000000
NODE_21720_length_633_cov_30.076779	316	396	0	80	80	1.0000000
NODE_21721_length_633_cov_17.595506	282	362	0	80	80	1.0000000
NODE_21721_length_633_cov_17.595506	335	415	0	80	80	1.0000000
NODE_21722_length_633_cov_17.327715	228	308	0	64	80	0.8000000
NODE_21722_length_633_cov_17.327715	228	308	2	16	80	0.2000000
NODE_21722_length_633_cov_17.327715	281	361	0	80	80	1.0000000
NODE_21723_length_633_cov_9.689139	79	147	0	10	68	0.1470588
NODE_21723_length_633_cov_9.689139	79	147	2	1	68	0.0147059
NODE_21723_length_633_cov_9.689139	79	147	4	10	68	0.1470588
NODE_21723_length_633_cov_9.689139	79	147	9	3	68	0.0441176
NODE_21723_length_633_cov_9.689139	79	147	11	1	68	0.0147059
NODE_21723_length_633_cov_9.689139	79	147	13	13	68	0.1911765
NODE_21723_length_633_cov_9.689139	79	147	15	30	68	0.4411765
NODE_21729_length_633_cov_7.018727	309	389	0	80	80	1.0000000
NODE_21729_length_633_cov_7.018727	362	442	0	80	80	1.0000000
NODE_21755_length_633_cov_2.644195	166	240	0	28	74	0.3783784
NODE_21755_length_633_cov_2.644195	166	240	2	46	74	0.6216216
NODE_21816_length_632_cov_25.425891	332	412	0	25	80	0.3125000
NODE_21816_length_632_cov_25.425891	332	412	2	55	80	0.6875000
NODE_21816_length_632_cov_25.425891	385	465	0	72	80	0.9000000
NODE_21816_length_632_cov_25.425891	385	465	2	8	80	0.1000000
NODE_21817_length_632_cov_21.613508	243	323	0	80	80	1.0000000
NODE_21817_length_632_cov_21.613508	296	376	0	80	80	1.0000000
NODE_21818_length_632_cov_16.465291	293	373	0	80	80	1.0000000
NODE_21818_length_632_cov_16.465291	346	426	0	80	80	1.0000000
NODE_21819_length_632_cov_13.260788	232	312	0	4	80	0.0500000
NODE_21819_length_632_cov_13.260788	232	312	2	76	80	0.9500000
NODE_21819_length_632_cov_13.260788	285	365	0	49	80	0.6125000
NODE_21819_length_632_cov_13.260788	285	365	2	31	80	0.3875000
NODE_21821_length_632_cov_9.106942	188	268	0	80	80	1.0000000
NODE_21821_length_632_cov_9.106942	241	321	0	80	80	1.0000000
NODE_21834_length_632_cov_4.135084	229	309	0	80	80	1.0000000
NODE_21834_length_632_cov_4.135084	282	359	0	77	77	1.0000000
NODE_21841_length_632_cov_2.939962	216	274	0	14	58	0.2413793
NODE_21841_length_632_cov_2.939962	216	274	2	9	58	0.1551724
NODE_21841_length_632_cov_2.939962	216	274	4	17	58	0.2931035
NODE_21841_length_632_cov_2.939962	216	274	6	18	58	0.3103448
NODE_21841_length_632_cov_2.939962	247	327	4	9	80	0.1125000
NODE_21841_length_632_cov_2.939962	247	327	6	71	80	0.8875000
NODE_21848_length_632_cov_2.330206	57	76	0	19	19	1.0000000
NODE_21912_length_631_cov_31.469925	321	396	0	75	75	1.0000000
NODE_21912_length_631_cov_31.469925	369	449	0	80	80	1.0000000
NODE_21913_length_631_cov_26.453008	383	463	0	80	80	1.0000000
NODE_21913_length_631_cov_26.453008	436	516	0	80	80	1.0000000
NODE_21917_length_631_cov_8.374060	318	398	0	80	80	1.0000000
NODE_21917_length_631_cov_8.374060	371	451	0	80	80	1.0000000
NODE_21924_length_631_cov_5.507519	335	386	10	2	51	0.0392157
NODE_21924_length_631_cov_5.507519	335	386	12	3	51	0.0588235
NODE_21924_length_631_cov_5.507519	335	386	14	1	51	0.0196078
NODE_21924_length_631_cov_5.507519	335	386	15	7	51	0.1372549
NODE_21924_length_631_cov_5.507519	335	386	17	9	51	0.1764706
NODE_21924_length_631_cov_5.507519	335	386	18	19	51	0.3725490
NODE_21924_length_631_cov_5.507519	335	386	20	10	51	0.1960784
NODE_21927_length_631_cov_5.227444	443	523	0	80	80	1.0000000
NODE_21927_length_631_cov_5.227444	496	576	0	80	80	1.0000000
NODE_21942_length_631_cov_2.926692	307	354	0	47	47	1.0000000
NODE_21983_length_631_cov_1.383459	248	267	1	19	19	1.0000000
NODE_22011_length_630_cov_41.728814	6	86	0	80	80	1.0000000
NODE_22011_length_630_cov_41.728814	59	139	0	80	80	1.0000000
NODE_22012_length_630_cov_24.856874	421	501	0	80	80	1.0000000
NODE_22012_length_630_cov_24.856874	474	554	0	80	80	1.0000000
NODE_22013_length_630_cov_14.323917	196	276	0	47	80	0.5875000
NODE_22013_length_630_cov_14.323917	196	276	2	33	80	0.4125000
NODE_22013_length_630_cov_14.323917	249	329	0	80	80	1.0000000
NODE_22014_length_630_cov_9.964218	284	364	0	80	80	1.0000000
NODE_22014_length_630_cov_9.964218	337	417	0	80	80	1.0000000
NODE_22086_length_629_cov_38.271698	288	368	0	80	80	1.0000000
NODE_22086_length_629_cov_38.271698	341	421	0	80	80	1.0000000
NODE_22087_length_629_cov_27.556604	212	292	0	80	80	1.0000000
NODE_22087_length_629_cov_27.556604	265	345	0	80	80	1.0000000
NODE_22088_length_629_cov_24.150943	356	436	0	48	80	0.6000000
NODE_22088_length_629_cov_24.150943	356	436	5	1	80	0.0125000
NODE_22088_length_629_cov_24.150943	356	436	6	31	80	0.3875000
NODE_22088_length_629_cov_24.150943	409	489	0	17	80	0.2125000
NODE_22088_length_629_cov_24.150943	409	489	6	63	80	0.7875000
NODE_22091_length_629_cov_13.641509	176	256	0	56	80	0.7000000
NODE_22091_length_629_cov_13.641509	176	256	4	24	80	0.3000000
NODE_22091_length_629_cov_13.641509	229	309	0	3	80	0.0375000
NODE_22091_length_629_cov_13.641509	229	309	4	77	80	0.9625000
NODE_22101_length_629_cov_4.264151	362	442	0	46	80	0.5750000
NODE_22101_length_629_cov_4.264151	362	442	1	29	80	0.3625000
NODE_22101_length_629_cov_4.264151	362	442	2	5	80	0.0625000
NODE_22188_length_628_cov_5.015123	210	274	2	22	64	0.3437500
NODE_22188_length_628_cov_5.015123	210	274	4	42	64	0.6562500
NODE_22257_length_627_cov_24.500000	217	297	0	22	80	0.2750000
NODE_22257_length_627_cov_24.500000	217	297	2	58	80	0.7250000
NODE_22257_length_627_cov_24.500000	270	350	0	75	80	0.9375000
NODE_22257_length_627_cov_24.500000	270	350	2	5	80	0.0625000
NODE_22258_length_627_cov_20.395833	84	164	0	9	80	0.1125000
NODE_22258_length_627_cov_20.395833	84	164	2	71	80	0.8875000
NODE_22258_length_627_cov_20.395833	137	217	0	25	80	0.3125000
NODE_22258_length_627_cov_20.395833	137	217	2	55	80	0.6875000
NODE_22259_length_627_cov_19.676136	308	388	0	10	80	0.1250000
NODE_22259_length_627_cov_19.676136	308	388	2	17	80	0.2125000
NODE_22259_length_627_cov_19.676136	308	388	4	53	80	0.6625000
NODE_22259_length_627_cov_19.676136	361	441	0	16	80	0.2000000
NODE_22259_length_627_cov_19.676136	361	441	2	45	80	0.5625000
NODE_22259_length_627_cov_19.676136	361	441	4	19	80	0.2375000
NODE_22260_length_627_cov_17.634470	264	296	2	32	32	1.0000000
NODE_22260_length_627_cov_17.634470	360	385	0	25	25	1.0000000
NODE_22260_length_627_cov_17.634470	365	385	0	20	20	1.0000000
NODE_22260_length_627_cov_17.634470	385	424	0	39	39	1.0000000
NODE_22267_length_627_cov_5.634470	298	346	4	48	48	1.0000000
NODE_22274_length_627_cov_4.517045	323	403	0	80	80	1.0000000
NODE_22274_length_627_cov_4.517045	376	456	0	80	80	1.0000000
NODE_22357_length_626_cov_24.184061	140	220	0	80	80	1.0000000
NODE_22357_length_626_cov_24.184061	193	273	0	80	80	1.0000000
NODE_22358_length_626_cov_21.189753	342	419	34	3	77	0.0389610
NODE_22358_length_626_cov_21.189753	342	419	36	4	77	0.0519481
NODE_22358_length_626_cov_21.189753	342	419	38	22	77	0.2857143
NODE_22358_length_626_cov_21.189753	342	419	41	42	77	0.5454546
NODE_22358_length_626_cov_21.189753	342	419	42	6	77	0.0779221
NODE_22358_length_626_cov_21.189753	342	419	34	3	77	0.0389610
NODE_22358_length_626_cov_21.189753	342	419	36	4	77	0.0519481
NODE_22358_length_626_cov_21.189753	342	419	38	22	77	0.2857143
NODE_22358_length_626_cov_21.189753	342	419	41	42	77	0.5454546
NODE_22358_length_626_cov_21.189753	342	419	42	6	77	0.0779221
NODE_22358_length_626_cov_21.189753	392	453	4	10	61	0.1639344
NODE_22358_length_626_cov_21.189753	392	453	6	14	61	0.2295082
NODE_22358_length_626_cov_21.189753	392	453	19	1	61	0.0163934
NODE_22358_length_626_cov_21.189753	392	453	20	4	61	0.0655738
NODE_22358_length_626_cov_21.189753	392	453	30	4	61	0.0655738
NODE_22358_length_626_cov_21.189753	392	453	34	4	61	0.0655738
NODE_22358_length_626_cov_21.189753	392	453	38	9	61	0.1475410
NODE_22358_length_626_cov_21.189753	392	453	41	15	61	0.2459016
NODE_22364_length_626_cov_7.100569	236	311	0	75	75	1.0000000
NODE_22364_length_626_cov_7.100569	284	364	0	80	80	1.0000000
NODE_22366_length_626_cov_6.296015	193	273	0	80	80	1.0000000
NODE_22366_length_626_cov_6.296015	246	326	0	80	80	1.0000000
NODE_22367_length_626_cov_6.163188	257	337	0	80	80	1.0000000
NODE_22367_length_626_cov_6.163188	310	390	0	80	80	1.0000000
NODE_22438_length_625_cov_33.100760	239	319	0	80	80	1.0000000
NODE_22438_length_625_cov_33.100760	292	372	0	80	80	1.0000000
NODE_22438_length_625_cov_33.100760	368	448	0	80	80	1.0000000
NODE_22438_length_625_cov_33.100760	421	501	0	80	80	1.0000000
NODE_22439_length_625_cov_21.062738	267	347	0	80	80	1.0000000
NODE_22439_length_625_cov_21.062738	320	400	0	80	80	1.0000000
NODE_22440_length_625_cov_14.237643	28	108	0	80	80	1.0000000
NODE_22440_length_625_cov_14.237643	81	161	0	42	80	0.5250000
NODE_22440_length_625_cov_14.237643	81	161	1	7	80	0.0875000
NODE_22440_length_625_cov_14.237643	81	161	2	31	80	0.3875000
NODE_22441_length_625_cov_14.207224	358	438	0	80	80	1.0000000
NODE_22441_length_625_cov_14.207224	411	491	0	56	80	0.7000000
NODE_22441_length_625_cov_14.207224	411	491	2	24	80	0.3000000
NODE_22455_length_625_cov_4.157795	548	600	4	52	52	1.0000000
NODE_22466_length_625_cov_2.929658	118	198	0	80	80	1.0000000
NODE_22466_length_625_cov_2.929658	171	251	0	80	80	1.0000000
NODE_22491_length_625_cov_1.570342	471	502	0	31	31	1.0000000
NODE_22542_length_624_cov_9.598095	77	126	0	49	49	1.0000000
NODE_22542_length_624_cov_9.598095	103	183	0	80	80	1.0000000
NODE_22544_length_624_cov_8.485714	271	351	0	48	80	0.6000000
NODE_22544_length_624_cov_8.485714	271	351	2	32	80	0.4000000
NODE_22544_length_624_cov_8.485714	324	404	2	80	80	1.0000000
NODE_22546_length_624_cov_6.691429	386	466	2	80	80	1.0000000
NODE_22546_length_624_cov_6.691429	439	519	0	48	80	0.6000000
NODE_22546_length_624_cov_6.691429	439	519	2	32	80	0.4000000
NODE_22547_length_624_cov_5.592381	312	387	0	11	75	0.1466667
NODE_22547_length_624_cov_5.592381	312	387	2	11	75	0.1466667
NODE_22547_length_624_cov_5.592381	312	387	6	53	75	0.7066666
NODE_22551_length_624_cov_4.638095	328	388	0	14	60	0.2333333
NODE_22551_length_624_cov_4.638095	328	388	2	46	60	0.7666667
NODE_22642_length_623_cov_41.877863	419	499	4	16	80	0.2000000
NODE_22642_length_623_cov_41.877863	419	499	6	25	80	0.3125000
NODE_22642_length_623_cov_41.877863	419	499	9	1	80	0.0125000
NODE_22642_length_623_cov_41.877863	419	499	10	38	80	0.4750000
NODE_22642_length_623_cov_41.877863	472	552	0	32	80	0.4000000
NODE_22642_length_623_cov_41.877863	472	552	6	46	80	0.5750000
NODE_22642_length_623_cov_41.877863	472	552	10	2	80	0.0250000
NODE_22643_length_623_cov_31.875954	148	228	6	30	80	0.3750000
NODE_22643_length_623_cov_31.875954	148	228	8	33	80	0.4125000
NODE_22643_length_623_cov_31.875954	148	228	10	17	80	0.2125000
NODE_22643_length_623_cov_31.875954	201	281	2	16	80	0.2000000
NODE_22643_length_623_cov_31.875954	201	281	4	11	80	0.1375000
NODE_22643_length_623_cov_31.875954	201	281	6	25	80	0.3125000
NODE_22643_length_623_cov_31.875954	201	281	8	10	80	0.1250000
NODE_22643_length_623_cov_31.875954	201	281	10	18	80	0.2250000
NODE_22644_length_623_cov_31.192748	313	393	0	61	80	0.7625000
NODE_22644_length_623_cov_31.192748	313	393	2	19	80	0.2375000
NODE_22644_length_623_cov_31.192748	366	446	0	10	80	0.1250000
NODE_22644_length_623_cov_31.192748	366	446	2	70	80	0.8750000
NODE_22645_length_623_cov_20.187023	287	367	0	80	80	1.0000000
NODE_22645_length_623_cov_20.187023	340	420	0	80	80	1.0000000
NODE_22646_length_623_cov_12.045802	377	457	0	68	80	0.8500000
NODE_22646_length_623_cov_12.045802	377	457	1	12	80	0.1500000
NODE_22646_length_623_cov_12.045802	430	510	0	15	80	0.1875000
NODE_22646_length_623_cov_12.045802	430	510	1	25	80	0.3125000
NODE_22646_length_623_cov_12.045802	430	510	2	40	80	0.5000000
NODE_22668_length_623_cov_2.891221	457	535	2	10	78	0.1282051
NODE_22668_length_623_cov_2.891221	457	535	6	68	78	0.8717949
NODE_22725_length_622_cov_19.042065	368	448	0	59	80	0.7375000
NODE_22725_length_622_cov_19.042065	368	448	2	21	80	0.2625000
NODE_22725_length_622_cov_19.042065	421	501	0	6	80	0.0750000
NODE_22725_length_622_cov_19.042065	421	501	2	74	80	0.9250000
NODE_22726_length_622_cov_13.470363	109	189	0	9	80	0.1125000
NODE_22726_length_622_cov_13.470363	109	189	2	5	80	0.0625000
NODE_22726_length_622_cov_13.470363	109	189	4	66	80	0.8250000
NODE_22726_length_622_cov_13.470363	162	242	0	6	80	0.0750000
NODE_22726_length_622_cov_13.470363	162	242	2	24	80	0.3000000
NODE_22726_length_622_cov_13.470363	162	242	4	50	80	0.6250000
NODE_22752_length_622_cov_2.407266	94	170	4	70	76	0.9210526
NODE_22752_length_622_cov_2.407266	94	170	6	6	76	0.0789474
NODE_22796_length_622_cov_1.353728	346	376	0	30	30	1.0000000
NODE_22819_length_621_cov_46.247126	0	52	0	52	52	1.0000000
NODE_22819_length_621_cov_46.247126	25	105	0	80	80	1.0000000
NODE_22819_length_621_cov_46.247126	101	181	0	47	80	0.5875000
NODE_22819_length_621_cov_46.247126	101	181	2	33	80	0.4125000
NODE_22819_length_621_cov_46.247126	154	234	2	80	80	1.0000000
NODE_22820_length_621_cov_45.764368	344	424	0	80	80	1.0000000
NODE_22820_length_621_cov_45.764368	397	477	0	80	80	1.0000000
NODE_22821_length_621_cov_35.147510	393	473	0	41	80	0.5125000
NODE_22821_length_621_cov_35.147510	393	473	2	39	80	0.4875000
NODE_22821_length_621_cov_35.147510	446	526	0	80	80	1.0000000
NODE_22822_length_621_cov_13.842912	231	311	0	80	80	1.0000000
NODE_22822_length_621_cov_13.842912	284	364	0	80	80	1.0000000
NODE_22825_length_621_cov_6.279693	376	406	2	16	30	0.5333334
NODE_22825_length_621_cov_6.279693	376	406	4	14	30	0.4666667
NODE_22845_length_621_cov_2.645594	367	426	0	59	59	1.0000000
NODE_22914_length_620_cov_23.913628	433	513	2	21	80	0.2625000
NODE_22914_length_620_cov_23.913628	433	513	4	30	80	0.3750000
NODE_22914_length_620_cov_23.913628	433	513	6	29	80	0.3625000
NODE_22914_length_620_cov_23.913628	486	566	0	36	80	0.4500000
NODE_22914_length_620_cov_23.913628	486	566	2	38	80	0.4750000
NODE_22914_length_620_cov_23.913628	486	566	6	6	80	0.0750000
NODE_22915_length_620_cov_9.222649	186	266	0	80	80	1.0000000
NODE_22915_length_620_cov_9.222649	239	319	0	80	80	1.0000000
NODE_22919_length_620_cov_7.804223	57	137	0	60	80	0.7500000
NODE_22919_length_620_cov_7.804223	57	137	2	20	80	0.2500000
NODE_22919_length_620_cov_7.804223	110	190	0	7	80	0.0875000
NODE_22919_length_620_cov_7.804223	110	190	2	73	80	0.9125000
NODE_22920_length_620_cov_6.909789	199	279	0	55	80	0.6875000
NODE_22920_length_620_cov_6.909789	199	279	8	25	80	0.3125000
NODE_22920_length_620_cov_6.909789	252	332	0	2	80	0.0250000
NODE_22920_length_620_cov_6.909789	252	332	8	78	80	0.9750000
NODE_22930_length_620_cov_4.560461	309	347	13	31	38	0.8157895
NODE_22930_length_620_cov_4.560461	309	347	14	7	38	0.1842105
NODE_22930_length_620_cov_4.560461	395	421	0	26	26	1.0000000
NODE_22930_length_620_cov_4.560461	395	451	0	42	56	0.7500000
NODE_22930_length_620_cov_4.560461	395	451	4	11	56	0.1964286
NODE_22930_length_620_cov_4.560461	395	451	6	3	56	0.0535714
NODE_23031_length_619_cov_26.309615	118	198	6	37	80	0.4625000
NODE_23031_length_619_cov_26.309615	118	198	7	2	80	0.0250000
NODE_23031_length_619_cov_26.309615	118	198	8	1	80	0.0125000
NODE_23031_length_619_cov_26.309615	118	198	9	1	80	0.0125000
NODE_23031_length_619_cov_26.309615	118	198	12	39	80	0.4875000
NODE_23031_length_619_cov_26.309615	171	251	0	30	80	0.3750000
NODE_23031_length_619_cov_26.309615	171	251	6	50	80	0.6250000
NODE_23033_length_619_cov_10.417308	427	487	10	30	60	0.5000000
NODE_23033_length_619_cov_10.417308	427	487	12	30	60	0.5000000
NODE_23034_length_619_cov_7.944231	213	293	0	54	80	0.6750000
NODE_23034_length_619_cov_7.944231	213	293	2	26	80	0.3250000
NODE_23034_length_619_cov_7.944231	266	346	0	80	80	1.0000000
NODE_23135_length_618_cov_14.477842	223	299	0	46	76	0.6052632
NODE_23135_length_618_cov_14.477842	223	299	2	7	76	0.0921053
NODE_23135_length_618_cov_14.477842	223	299	4	23	76	0.3026316
NODE_23135_length_618_cov_14.477842	223	299	0	46	76	0.6052632
NODE_23135_length_618_cov_14.477842	223	299	2	7	76	0.0921053
NODE_23135_length_618_cov_14.477842	223	299	4	23	76	0.3026316
NODE_23135_length_618_cov_14.477842	276	337	4	61	61	1.0000000
NODE_23136_length_618_cov_13.840077	377	457	0	80	80	1.0000000
NODE_23136_length_618_cov_13.840077	430	510	0	80	80	1.0000000
NODE_23137_length_618_cov_12.048170	348	428	0	80	80	1.0000000
NODE_23137_length_618_cov_12.048170	401	481	0	80	80	1.0000000
NODE_23138_length_618_cov_8.799615	353	433	0	80	80	1.0000000
NODE_23138_length_618_cov_8.799615	406	486	0	80	80	1.0000000
NODE_23147_length_618_cov_3.793834	412	478	0	1	66	0.0151515
NODE_23147_length_618_cov_3.793834	412	478	2	65	66	0.9848485
NODE_23148_length_618_cov_3.761079	305	385	0	80	80	1.0000000
NODE_23252_length_617_cov_29.565637	378	458	2	7	80	0.0875000
NODE_23252_length_617_cov_29.565637	378	458	4	73	80	0.9125000
NODE_23252_length_617_cov_29.565637	431	511	0	34	80	0.4250000
NODE_23252_length_617_cov_29.565637	431	511	2	26	80	0.3250000
NODE_23252_length_617_cov_29.565637	431	511	4	20	80	0.2500000
NODE_23253_length_617_cov_16.781853	253	333	0	34	80	0.4250000
NODE_23253_length_617_cov_16.781853	253	333	6	46	80	0.5750000
NODE_23253_length_617_cov_16.781853	306	386	0	80	80	1.0000000
NODE_23254_length_617_cov_9.175676	373	453	0	80	80	1.0000000
NODE_23254_length_617_cov_9.175676	426	506	0	80	80	1.0000000
NODE_23255_length_617_cov_8.774131	320	406	0	38	86	0.4418605
NODE_23255_length_617_cov_8.774131	320	406	3	1	86	0.0116279
NODE_23255_length_617_cov_8.774131	320	406	4	12	86	0.1395349
NODE_23255_length_617_cov_8.774131	320	406	6	35	86	0.4069767
NODE_23255_length_617_cov_8.774131	379	458	2	2	79	0.0253165
NODE_23255_length_617_cov_8.774131	379	458	6	77	79	0.9746835
NODE_23257_length_617_cov_8.416988	359	439	0	80	80	1.0000000
NODE_23257_length_617_cov_8.416988	412	492	0	80	80	1.0000000
NODE_23259_length_617_cov_7.683398	197	275	0	78	78	1.0000000
NODE_23259_length_617_cov_7.683398	250	330	0	30	80	0.3750000
NODE_23259_length_617_cov_7.683398	250	330	2	50	80	0.6250000
NODE_23263_length_617_cov_5.330116	288	360	0	72	72	1.0000000
NODE_23263_length_617_cov_5.330116	333	413	0	80	80	1.0000000
NODE_23302_length_617_cov_1.967181	384	430	0	46	46	1.0000000
NODE_23311_length_617_cov_1.847490	273	344	1	23	71	0.3239437
NODE_23311_length_617_cov_1.847490	273	344	2	42	71	0.5915493
NODE_23311_length_617_cov_1.847490	273	344	4	6	71	0.0845070
NODE_23331_length_617_cov_1.322394	269	318	28	6	49	0.1224490
NODE_23331_length_617_cov_1.322394	269	318	30	18	49	0.3673469
NODE_23331_length_617_cov_1.322394	269	318	32	22	49	0.4489796
NODE_23331_length_617_cov_1.322394	269	318	34	3	49	0.0612245
NODE_23365_length_616_cov_15.914894	292	370	7	3	78	0.0384615
NODE_23365_length_616_cov_15.914894	292	370	9	75	78	0.9615384
NODE_23365_length_616_cov_15.914894	343	423	0	38	80	0.4750000
NODE_23365_length_616_cov_15.914894	343	423	3	2	80	0.0250000
NODE_23365_length_616_cov_15.914894	343	423	7	16	80	0.2000000
NODE_23365_length_616_cov_15.914894	343	423	9	24	80	0.3000000
NODE_23366_length_616_cov_14.276596	191	271	0	80	80	1.0000000
NODE_23366_length_616_cov_14.276596	244	319	0	75	75	1.0000000
NODE_23366_length_616_cov_14.276596	368	448	0	80	80	1.0000000
NODE_23367_length_616_cov_12.119923	273	353	0	80	80	1.0000000
NODE_23367_length_616_cov_12.119923	326	406	0	80	80	1.0000000
NODE_23373_length_616_cov_6.379110	305	385	0	80	80	1.0000000
NODE_23373_length_616_cov_6.379110	358	438	0	80	80	1.0000000
NODE_23381_length_616_cov_4.441006	286	350	0	27	64	0.4218750
NODE_23381_length_616_cov_4.441006	286	350	2	37	64	0.5781250
NODE_23381_length_616_cov_4.441006	286	306	0	20	20	1.0000000
NODE_23400_length_616_cov_2.541586	375	415	0	40	40	1.0000000
NODE_23430_length_616_cov_1.491296	105	183	4	52	78	0.6666667
NODE_23430_length_616_cov_1.491296	105	183	6	26	78	0.3333333
NODE_23474_length_615_cov_27.519380	302	382	0	80	80	1.0000000
NODE_23474_length_615_cov_27.519380	355	435	0	80	80	1.0000000
NODE_23475_length_615_cov_17.792636	239	319	0	7	80	0.0875000
NODE_23475_length_615_cov_17.792636	239	319	4	21	80	0.2625000
NODE_23475_length_615_cov_17.792636	239	319	6	16	80	0.2000000
NODE_23475_length_615_cov_17.792636	239	319	8	31	80	0.3875000
NODE_23475_length_615_cov_17.792636	239	319	10	5	80	0.0625000
NODE_23475_length_615_cov_17.792636	292	372	2	3	80	0.0375000
NODE_23475_length_615_cov_17.792636	292	372	4	26	80	0.3250000
NODE_23475_length_615_cov_17.792636	292	372	8	22	80	0.2750000
NODE_23475_length_615_cov_17.792636	292	372	10	29	80	0.3625000
NODE_23477_length_615_cov_11.835271	240	320	0	80	80	1.0000000
NODE_23477_length_615_cov_11.835271	293	373	0	80	80	1.0000000
NODE_23478_length_615_cov_8.591085	287	367	0	30	80	0.3750000
NODE_23478_length_615_cov_8.591085	287	367	2	50	80	0.6250000
NODE_23478_length_615_cov_8.591085	340	420	2	27	80	0.3375000
NODE_23478_length_615_cov_8.591085	340	420	3	3	80	0.0375000
NODE_23478_length_615_cov_8.591085	340	420	4	50	80	0.6250000
NODE_23513_length_615_cov_2.461240	429	509	0	80	80	1.0000000
NODE_23513_length_615_cov_2.461240	482	562	0	80	80	1.0000000
NODE_23516_length_615_cov_2.379845	405	467	6	2	62	0.0322581
NODE_23516_length_615_cov_2.379845	405	467	8	1	62	0.0161290
NODE_23516_length_615_cov_2.379845	405	467	18	2	62	0.0322581
NODE_23516_length_615_cov_2.379845	405	467	20	1	62	0.0161290
NODE_23516_length_615_cov_2.379845	405	467	24	6	62	0.0967742
NODE_23516_length_615_cov_2.379845	405	467	26	4	62	0.0645161
NODE_23516_length_615_cov_2.379845	405	467	28	44	62	0.7096774
NODE_23516_length_615_cov_2.379845	405	467	30	2	62	0.0322581
NODE_23516_length_615_cov_2.379845	440	520	18	11	80	0.1375000
NODE_23516_length_615_cov_2.379845	440	520	20	15	80	0.1875000
NODE_23516_length_615_cov_2.379845	440	520	24	4	80	0.0500000
NODE_23516_length_615_cov_2.379845	440	520	28	25	80	0.3125000
NODE_23516_length_615_cov_2.379845	440	520	30	25	80	0.3125000
NODE_23517_length_615_cov_2.294574	205	268	0	63	63	1.0000000
NODE_23554_length_615_cov_1.122093	255	335	0	36	80	0.4500000
NODE_23554_length_615_cov_1.122093	255	335	2	44	80	0.5500000
NODE_23566_length_615_cov_0.887597	561	582	0	21	21	1.0000000
NODE_23575_length_614_cov_17.772816	257	337	0	60	80	0.7500000
NODE_23575_length_614_cov_17.772816	257	337	2	20	80	0.2500000
NODE_23575_length_614_cov_17.772816	310	390	0	80	80	1.0000000
NODE_23576_length_614_cov_10.706796	425	505	4	29	80	0.3625000
NODE_23576_length_614_cov_10.706796	425	505	6	13	80	0.1625000
NODE_23576_length_614_cov_10.706796	425	505	8	38	80	0.4750000
NODE_23576_length_614_cov_10.706796	478	558	0	28	80	0.3500000
NODE_23576_length_614_cov_10.706796	478	558	4	52	80	0.6500000
NODE_23578_length_614_cov_8.545631	193	273	0	7	80	0.0875000
NODE_23578_length_614_cov_8.545631	193	273	2	29	80	0.3625000
NODE_23578_length_614_cov_8.545631	193	273	4	2	80	0.0250000
NODE_23578_length_614_cov_8.545631	193	273	6	3	80	0.0375000
NODE_23578_length_614_cov_8.545631	193	273	8	11	80	0.1375000
NODE_23578_length_614_cov_8.545631	193	273	15	1	80	0.0125000
NODE_23578_length_614_cov_8.545631	193	273	16	2	80	0.0250000
NODE_23578_length_614_cov_8.545631	193	273	18	2	80	0.0250000
NODE_23578_length_614_cov_8.545631	193	273	24	1	80	0.0125000
NODE_23578_length_614_cov_8.545631	193	273	28	4	80	0.0500000
NODE_23578_length_614_cov_8.545631	193	273	34	3	80	0.0375000
NODE_23578_length_614_cov_8.545631	193	273	38	2	80	0.0250000
NODE_23578_length_614_cov_8.545631	193	273	40	1	80	0.0125000
NODE_23578_length_614_cov_8.545631	193	273	46	2	80	0.0250000
NODE_23578_length_614_cov_8.545631	193	273	48	6	80	0.0750000
NODE_23578_length_614_cov_8.545631	193	273	50	3	80	0.0375000
NODE_23578_length_614_cov_8.545631	193	273	54	1	80	0.0125000
NODE_23578_length_614_cov_8.545631	246	326	2	12	80	0.1500000
NODE_23578_length_614_cov_8.545631	246	326	4	2	80	0.0250000
NODE_23578_length_614_cov_8.545631	246	326	6	3	80	0.0375000
NODE_23578_length_614_cov_8.545631	246	326	8	36	80	0.4500000
NODE_23578_length_614_cov_8.545631	246	326	9	3	80	0.0375000
NODE_23578_length_614_cov_8.545631	246	326	11	7	80	0.0875000
NODE_23578_length_614_cov_8.545631	246	326	13	13	80	0.1625000
NODE_23578_length_614_cov_8.545631	246	326	16	4	80	0.0500000
NODE_23604_length_614_cov_2.450485	315	393	2	78	78	1.0000000
NODE_23604_length_614_cov_2.450485	355	383	2	28	28	1.0000000
NODE_23604_length_614_cov_2.450485	368	448	2	27	80	0.3375000
NODE_23604_length_614_cov_2.450485	368	448	4	9	80	0.1125000
NODE_23604_length_614_cov_2.450485	368	448	6	14	80	0.1750000
NODE_23604_length_614_cov_2.450485	368	448	8	30	80	0.3750000
NODE_23604_length_614_cov_2.450485	379	448	2	16	69	0.2318841
NODE_23604_length_614_cov_2.450485	379	448	4	9	69	0.1304348
NODE_23604_length_614_cov_2.450485	379	448	6	14	69	0.2028985
NODE_23604_length_614_cov_2.450485	379	448	8	30	69	0.4347826
NODE_23662_length_613_cov_18.075875	211	291	0	72	80	0.9000000
NODE_23662_length_613_cov_18.075875	211	291	2	8	80	0.1000000
NODE_23662_length_613_cov_18.075875	264	344	0	19	80	0.2375000
NODE_23662_length_613_cov_18.075875	264	344	2	61	80	0.7625000
NODE_23663_length_613_cov_16.118677	283	363	2	80	80	1.0000000
NODE_23663_length_613_cov_16.118677	336	416	0	28	80	0.3500000
NODE_23663_length_613_cov_16.118677	336	416	2	52	80	0.6500000
NODE_23665_length_613_cov_12.883268	155	235	4	80	80	1.0000000
NODE_23665_length_613_cov_12.883268	208	288	0	26	80	0.3250000
NODE_23665_length_613_cov_12.883268	208	288	4	54	80	0.6750000
NODE_23674_length_613_cov_3.857977	167	247	0	80	80	1.0000000
NODE_23674_length_613_cov_3.857977	220	300	0	50	80	0.6250000
NODE_23674_length_613_cov_3.857977	220	300	2	30	80	0.3750000
NODE_23771_length_612_cov_24.023392	173	253	0	28	80	0.3500000
NODE_23771_length_612_cov_24.023392	173	253	2	52	80	0.6500000
NODE_23771_length_612_cov_24.023392	226	306	2	77	80	0.9625000
NODE_23771_length_612_cov_24.023392	226	306	4	3	80	0.0375000
NODE_23772_length_612_cov_23.846004	141	221	4	34	80	0.4250000
NODE_23772_length_612_cov_23.846004	141	221	8	46	80	0.5750000
NODE_23772_length_612_cov_23.846004	194	274	0	39	80	0.4875000
NODE_23772_length_612_cov_23.846004	194	274	4	41	80	0.5125000
NODE_23773_length_612_cov_12.448343	244	324	0	80	80	1.0000000
NODE_23773_length_612_cov_12.448343	297	377	0	80	80	1.0000000
NODE_23774_length_612_cov_12.068226	267	347	0	80	80	1.0000000
NODE_23774_length_612_cov_12.068226	320	400	0	80	80	1.0000000
NODE_23779_length_612_cov_6.393762	242	322	0	71	80	0.8875000
NODE_23779_length_612_cov_6.393762	242	322	2	9	80	0.1125000
NODE_23779_length_612_cov_6.393762	295	375	0	18	80	0.2250000
NODE_23779_length_612_cov_6.393762	295	375	2	62	80	0.7750000
NODE_23814_length_612_cov_1.904483	288	354	0	66	66	1.0000000
NODE_23869_length_611_cov_38.705078	132	212	0	80	80	1.0000000
NODE_23869_length_611_cov_38.705078	185	262	0	77	77	1.0000000
NODE_23869_length_611_cov_38.705078	185	262	0	77	77	1.0000000
NODE_23871_length_611_cov_12.669922	264	344	0	15	80	0.1875000
NODE_23871_length_611_cov_12.669922	264	344	2	54	80	0.6750000
NODE_23871_length_611_cov_12.669922	264	344	4	11	80	0.1375000
NODE_23871_length_611_cov_12.669922	317	397	2	47	80	0.5875000
NODE_23871_length_611_cov_12.669922	317	397	4	33	80	0.4125000
NODE_23880_length_611_cov_4.943359	27	107	2	34	80	0.4250000
NODE_23880_length_611_cov_4.943359	27	107	4	46	80	0.5750000
NODE_23880_length_611_cov_4.943359	80	137	0	9	57	0.1578947
NODE_23880_length_611_cov_4.943359	80	137	2	37	57	0.6491228
NODE_23880_length_611_cov_4.943359	80	137	4	11	57	0.1929825
NODE_23880_length_611_cov_4.943359	143	209	0	60	66	0.9090909
NODE_23880_length_611_cov_4.943359	143	209	2	6	66	0.0909091
NODE_23880_length_611_cov_4.943359	182	262	0	21	80	0.2625000
NODE_23880_length_611_cov_4.943359	182	262	2	59	80	0.7375000
NODE_23894_length_611_cov_3.294922	271	300	2	29	29	1.0000000
NODE_23894_length_611_cov_3.294922	434	469	6	35	35	1.0000000
NODE_23897_length_611_cov_3.162109	313	342	0	29	29	1.0000000
NODE_23973_length_610_cov_20.673190	87	167	0	80	80	1.0000000
NODE_23973_length_610_cov_20.673190	140	220	0	80	80	1.0000000
NODE_23974_length_610_cov_10.191781	250	330	0	80	80	1.0000000
NODE_23974_length_610_cov_10.191781	303	383	0	80	80	1.0000000
NODE_23980_length_610_cov_4.998043	129	181	0	9	52	0.1730769
NODE_23980_length_610_cov_4.998043	129	181	2	43	52	0.8269231
NODE_23980_length_610_cov_4.998043	182	234	0	3	52	0.0576923
NODE_23980_length_610_cov_4.998043	182	234	2	49	52	0.9423077
NODE_23989_length_610_cov_3.479452	215	267	0	52	52	1.0000000
NODE_24059_length_609_cov_21.117647	80	160	0	2	80	0.0250000
NODE_24059_length_609_cov_21.117647	80	160	6	78	80	0.9750000
NODE_24059_length_609_cov_21.117647	133	213	6	80	80	1.0000000
NODE_24060_length_609_cov_11.300000	218	298	0	24	80	0.3000000
NODE_24060_length_609_cov_11.300000	218	298	4	56	80	0.7000000
NODE_24060_length_609_cov_11.300000	271	351	0	25	80	0.3125000
NODE_24060_length_609_cov_11.300000	271	351	2	8	80	0.1000000
NODE_24060_length_609_cov_11.300000	271	351	3	1	80	0.0125000
NODE_24060_length_609_cov_11.300000	271	351	4	46	80	0.5750000
NODE_24061_length_609_cov_10.778431	239	319	0	40	80	0.5000000
NODE_24061_length_609_cov_10.778431	239	319	2	40	80	0.5000000
NODE_24061_length_609_cov_10.778431	292	372	0	4	80	0.0500000
NODE_24061_length_609_cov_10.778431	292	372	2	76	80	0.9500000
NODE_24062_length_609_cov_10.298039	340	420	0	80	80	1.0000000
NODE_24062_length_609_cov_10.298039	393	473	0	42	80	0.5250000
NODE_24062_length_609_cov_10.298039	393	473	2	38	80	0.4750000
NODE_24062_length_609_cov_10.298039	469	537	0	31	68	0.4558823
NODE_24062_length_609_cov_10.298039	469	537	2	37	68	0.5441176
NODE_24063_length_609_cov_10.270588	217	297	2	80	80	1.0000000
NODE_24063_length_609_cov_10.270588	270	353	0	44	83	0.5301205
NODE_24063_length_609_cov_10.270588	270	353	2	39	83	0.4698795
NODE_24064_length_609_cov_8.345098	408	488	0	80	80	1.0000000
NODE_24064_length_609_cov_8.345098	461	515	0	54	54	1.0000000
NODE_24064_length_609_cov_8.345098	537	566	0	29	29	1.0000000
NODE_24066_length_609_cov_6.054902	219	299	0	80	80	1.0000000
NODE_24066_length_609_cov_6.054902	272	352	0	70	80	0.8750000
NODE_24066_length_609_cov_6.054902	272	352	2	10	80	0.1250000
NODE_24067_length_609_cov_5.986275	219	299	0	80	80	1.0000000
NODE_24067_length_609_cov_5.986275	272	352	0	80	80	1.0000000
NODE_24160_length_608_cov_76.257367	300	380	8	13	80	0.1625000
NODE_24160_length_608_cov_76.257367	300	380	10	28	80	0.3500000
NODE_24160_length_608_cov_76.257367	300	380	12	39	80	0.4875000
NODE_24160_length_608_cov_76.257367	353	433	8	20	80	0.2500000
NODE_24160_length_608_cov_76.257367	353	433	9	1	80	0.0125000
NODE_24160_length_608_cov_76.257367	353	433	10	38	80	0.4750000
NODE_24160_length_608_cov_76.257367	353	433	12	21	80	0.2625000
NODE_24161_length_608_cov_13.271120	252	332	2	73	80	0.9125000
NODE_24161_length_608_cov_13.271120	252	332	4	7	80	0.0875000
NODE_24161_length_608_cov_13.271120	305	385	0	48	80	0.6000000
NODE_24161_length_608_cov_13.271120	305	385	2	32	80	0.4000000
NODE_24162_length_608_cov_11.583497	63	139	0	76	76	1.0000000
NODE_24162_length_608_cov_11.583497	112	192	0	80	80	1.0000000
NODE_24164_length_608_cov_8.076621	53	133	53	2	80	0.0250000
NODE_24164_length_608_cov_8.076621	53	133	54	1	80	0.0125000
NODE_24164_length_608_cov_8.076621	53	133	60	1	80	0.0125000
NODE_24164_length_608_cov_8.076621	53	133	64	1	80	0.0125000
NODE_24164_length_608_cov_8.076621	53	133	66	3	80	0.0375000
NODE_24164_length_608_cov_8.076621	53	133	74	1	80	0.0125000
NODE_24164_length_608_cov_8.076621	53	133	82	2	80	0.0250000
NODE_24164_length_608_cov_8.076621	53	133	86	1	80	0.0125000
NODE_24164_length_608_cov_8.076621	53	133	90	1	80	0.0125000
NODE_24164_length_608_cov_8.076621	53	133	94	1	80	0.0125000
NODE_24164_length_608_cov_8.076621	53	133	98	1	80	0.0125000
NODE_24164_length_608_cov_8.076621	53	133	100	9	80	0.1125000
NODE_24164_length_608_cov_8.076621	53	133	102	2	80	0.0250000
NODE_24164_length_608_cov_8.076621	53	133	104	7	80	0.0875000
NODE_24164_length_608_cov_8.076621	53	133	106	1	80	0.0125000
NODE_24164_length_608_cov_8.076621	53	133	108	4	80	0.0500000
NODE_24164_length_608_cov_8.076621	53	133	112	12	80	0.1500000
NODE_24164_length_608_cov_8.076621	53	133	114	4	80	0.0500000
NODE_24164_length_608_cov_8.076621	53	133	116	11	80	0.1375000
NODE_24164_length_608_cov_8.076621	53	133	120	15	80	0.1875000
NODE_24164_length_608_cov_8.076621	106	186	0	5	80	0.0625000
NODE_24164_length_608_cov_8.076621	106	186	6	3	80	0.0375000
NODE_24164_length_608_cov_8.076621	106	186	7	16	80	0.2000000
NODE_24164_length_608_cov_8.076621	106	186	13	1	80	0.0125000
NODE_24164_length_608_cov_8.076621	106	186	17	1	80	0.0125000
NODE_24164_length_608_cov_8.076621	106	186	21	1	80	0.0125000
NODE_24164_length_608_cov_8.076621	106	186	25	9	80	0.1125000
NODE_24164_length_608_cov_8.076621	106	186	31	2	80	0.0250000
NODE_24164_length_608_cov_8.076621	106	186	32	3	80	0.0375000
NODE_24164_length_608_cov_8.076621	106	186	34	1	80	0.0125000
NODE_24164_length_608_cov_8.076621	106	186	36	1	80	0.0125000
NODE_24164_length_608_cov_8.076621	106	186	42	1	80	0.0125000
NODE_24164_length_608_cov_8.076621	106	186	43	2	80	0.0250000
NODE_24164_length_608_cov_8.076621	106	186	47	1	80	0.0125000
NODE_24164_length_608_cov_8.076621	106	186	49	1	80	0.0125000
NODE_24164_length_608_cov_8.076621	106	186	51	2	80	0.0250000
NODE_24164_length_608_cov_8.076621	106	186	53	5	80	0.0625000
NODE_24164_length_608_cov_8.076621	106	186	54	1	80	0.0125000
NODE_24164_length_608_cov_8.076621	106	186	60	1	80	0.0125000
NODE_24164_length_608_cov_8.076621	106	186	64	1	80	0.0125000
NODE_24164_length_608_cov_8.076621	106	186	66	3	80	0.0375000
NODE_24164_length_608_cov_8.076621	106	186	74	1	80	0.0125000
NODE_24164_length_608_cov_8.076621	106	186	82	2	80	0.0250000
NODE_24164_length_608_cov_8.076621	106	186	86	1	80	0.0125000
NODE_24164_length_608_cov_8.076621	106	186	90	1	80	0.0125000
NODE_24164_length_608_cov_8.076621	106	186	94	1	80	0.0125000
NODE_24164_length_608_cov_8.076621	106	186	98	1	80	0.0125000
NODE_24164_length_608_cov_8.076621	106	186	100	9	80	0.1125000
NODE_24164_length_608_cov_8.076621	106	186	102	2	80	0.0250000
NODE_24164_length_608_cov_8.076621	106	186	104	1	80	0.0125000
NODE_24165_length_608_cov_7.994106	279	326	0	47	47	1.0000000
NODE_24165_length_608_cov_7.994106	348	373	0	25	25	1.0000000
NODE_24166_length_608_cov_7.939096	247	277	9	30	30	1.0000000
NODE_24177_length_608_cov_3.829077	313	393	0	80	80	1.0000000
NODE_24177_length_608_cov_3.829077	366	446	0	80	80	1.0000000
NODE_24251_length_608_cov_1.064833	472	512	0	40	40	1.0000000
NODE_24281_length_607_cov_61.316929	347	427	0	54	80	0.6750000
NODE_24281_length_607_cov_61.316929	347	427	2	26	80	0.3250000
NODE_24281_length_607_cov_61.316929	347	427	0	54	80	0.6750000
NODE_24281_length_607_cov_61.316929	347	427	2	26	80	0.3250000
NODE_24281_length_607_cov_61.316929	347	427	0	54	80	0.6750000
NODE_24281_length_607_cov_61.316929	347	427	2	26	80	0.3250000
NODE_24281_length_607_cov_61.316929	364	427	0	37	63	0.5873016
NODE_24281_length_607_cov_61.316929	364	427	2	26	63	0.4126984
NODE_24281_length_607_cov_61.316929	400	480	0	1	80	0.0125000
NODE_24281_length_607_cov_61.316929	400	480	2	79	80	0.9875000
NODE_24281_length_607_cov_61.316929	400	480	0	1	80	0.0125000
NODE_24281_length_607_cov_61.316929	400	480	2	79	80	0.9875000
NODE_24281_length_607_cov_61.316929	400	480	0	1	80	0.0125000
NODE_24281_length_607_cov_61.316929	400	480	2	79	80	0.9875000
NODE_24281_length_607_cov_61.316929	400	480	0	1	80	0.0125000
NODE_24281_length_607_cov_61.316929	400	480	2	79	80	0.9875000
NODE_24281_length_607_cov_61.316929	476	556	0	56	80	0.7000000
NODE_24281_length_607_cov_61.316929	476	556	2	24	80	0.3000000
NODE_24281_length_607_cov_61.316929	476	556	0	56	80	0.7000000
NODE_24281_length_607_cov_61.316929	476	556	2	24	80	0.3000000
NODE_24281_length_607_cov_61.316929	476	556	0	56	80	0.7000000
NODE_24281_length_607_cov_61.316929	476	556	2	24	80	0.3000000
NODE_24281_length_607_cov_61.316929	529	595	0	66	66	1.0000000
NODE_24281_length_607_cov_61.316929	529	607	0	78	78	1.0000000
NODE_24281_length_607_cov_61.316929	529	600	0	71	71	1.0000000
NODE_24281_length_607_cov_61.316929	534	607	0	73	73	1.0000000
NODE_24282_length_607_cov_16.852362	383	463	0	80	80	1.0000000
NODE_24282_length_607_cov_16.852362	436	516	0	80	80	1.0000000
NODE_24283_length_607_cov_12.889764	67	147	0	80	80	1.0000000
NODE_24283_length_607_cov_12.889764	120	200	0	80	80	1.0000000
NODE_24284_length_607_cov_11.023622	122	202	0	80	80	1.0000000
NODE_24284_length_607_cov_11.023622	175	255	0	80	80	1.0000000
NODE_24285_length_607_cov_10.690945	199	279	0	31	80	0.3875000
NODE_24285_length_607_cov_10.690945	199	279	2	15	80	0.1875000
NODE_24285_length_607_cov_10.690945	199	279	4	34	80	0.4250000
NODE_24285_length_607_cov_10.690945	252	332	0	14	80	0.1750000
NODE_24285_length_607_cov_10.690945	252	332	2	26	80	0.3250000
NODE_24285_length_607_cov_10.690945	252	332	4	40	80	0.5000000
NODE_24290_length_607_cov_5.818898	301	386	0	85	85	1.0000000
NODE_24291_length_607_cov_5.771654	278	358	0	80	80	1.0000000
NODE_24291_length_607_cov_5.771654	331	411	0	80	80	1.0000000
NODE_24295_length_607_cov_4.816929	282	362	0	80	80	1.0000000
NODE_24295_length_607_cov_4.816929	335	415	0	80	80	1.0000000
NODE_24300_length_607_cov_4.015748	295	354	2	43	59	0.7288136
NODE_24300_length_607_cov_4.015748	295	354	4	16	59	0.2711864
NODE_24310_length_607_cov_3.088583	107	158	0	51	51	1.0000000
NODE_24331_length_607_cov_1.791339	204	247	4	43	43	1.0000000
NODE_24400_length_606_cov_42.264300	182	262	0	61	80	0.7625000
NODE_24400_length_606_cov_42.264300	182	262	2	19	80	0.2375000
NODE_24400_length_606_cov_42.264300	235	315	0	8	80	0.1000000
NODE_24400_length_606_cov_42.264300	235	315	2	34	80	0.4250000
NODE_24400_length_606_cov_42.264300	235	315	4	7	80	0.0875000
NODE_24400_length_606_cov_42.264300	235	315	6	31	80	0.3875000
NODE_24402_length_606_cov_26.341223	371	451	0	80	80	1.0000000
NODE_24402_length_606_cov_26.341223	424	504	0	80	80	1.0000000
NODE_24403_length_606_cov_14.895464	308	388	0	39	80	0.4875000
NODE_24403_length_606_cov_14.895464	308	388	2	41	80	0.5125000
NODE_24403_length_606_cov_14.895464	361	441	0	80	80	1.0000000
NODE_24406_length_606_cov_7.934911	412	492	0	80	80	1.0000000
NODE_24406_length_606_cov_7.934911	465	545	0	80	80	1.0000000
NODE_24407_length_606_cov_7.481262	250	330	0	6	80	0.0750000
NODE_24407_length_606_cov_7.481262	250	330	2	49	80	0.6125000
NODE_24407_length_606_cov_7.481262	250	330	3	3	80	0.0375000
NODE_24407_length_606_cov_7.481262	250	330	4	22	80	0.2750000
NODE_24407_length_606_cov_7.481262	303	383	2	22	80	0.2750000
NODE_24407_length_606_cov_7.481262	303	383	3	3	80	0.0375000
NODE_24407_length_606_cov_7.481262	303	383	4	43	80	0.5375000
NODE_24407_length_606_cov_7.481262	303	383	6	3	80	0.0375000
NODE_24407_length_606_cov_7.481262	303	383	8	9	80	0.1125000
NODE_24409_length_606_cov_6.842209	139	219	0	80	80	1.0000000
NODE_24409_length_606_cov_6.842209	192	272	0	80	80	1.0000000
NODE_24428_length_606_cov_3.384615	156	206	0	1	50	0.0200000
NODE_24428_length_606_cov_3.384615	156	206	2	45	50	0.9000000
NODE_24428_length_606_cov_3.384615	156	206	4	4	50	0.0800000
NODE_24433_length_606_cov_2.670611	113	193	0	41	80	0.5125000
NODE_24433_length_606_cov_2.670611	113	193	2	39	80	0.4875000
NODE_24525_length_605_cov_63.343874	7	83	0	76	76	1.0000000
NODE_24525_length_605_cov_63.343874	12	83	0	71	71	1.0000000
NODE_24525_length_605_cov_63.343874	17	83	0	66	66	1.0000000
NODE_24525_length_605_cov_63.343874	56	136	0	73	80	0.9125000
NODE_24525_length_605_cov_63.343874	56	136	4	7	80	0.0875000
NODE_24525_length_605_cov_63.343874	56	136	0	73	80	0.9125000
NODE_24525_length_605_cov_63.343874	56	136	4	7	80	0.0875000
NODE_24525_length_605_cov_63.343874	56	136	0	73	80	0.9125000
NODE_24525_length_605_cov_63.343874	56	136	4	7	80	0.0875000
NODE_24525_length_605_cov_63.343874	132	212	4	18	80	0.2250000
NODE_24525_length_605_cov_63.343874	132	212	10	62	80	0.7750000
NODE_24525_length_605_cov_63.343874	132	212	4	18	80	0.2250000
NODE_24525_length_605_cov_63.343874	132	212	10	62	80	0.7750000
NODE_24525_length_605_cov_63.343874	132	210	4	18	78	0.2307692
NODE_24525_length_605_cov_63.343874	132	210	10	60	78	0.7692308
NODE_24525_length_605_cov_63.343874	132	212	4	18	80	0.2250000
NODE_24525_length_605_cov_63.343874	132	212	10	62	80	0.7750000
NODE_24525_length_605_cov_63.343874	132	212	4	18	80	0.2250000
NODE_24525_length_605_cov_63.343874	132	212	10	62	80	0.7750000
NODE_24525_length_605_cov_63.343874	185	265	0	22	80	0.2750000
NODE_24525_length_605_cov_63.343874	185	265	4	1	80	0.0125000
NODE_24525_length_605_cov_63.343874	185	265	10	57	80	0.7125000
NODE_24526_length_605_cov_48.191700	298	374	0	76	76	1.0000000
NODE_24526_length_605_cov_48.191700	347	427	0	80	80	1.0000000
NODE_24528_length_605_cov_33.328063	57	137	112	1	80	0.0125000
NODE_24528_length_605_cov_33.328063	57	137	114	3	80	0.0375000
NODE_24528_length_605_cov_33.328063	57	137	116	1	80	0.0125000
NODE_24528_length_605_cov_33.328063	57	137	119	1	80	0.0125000
NODE_24528_length_605_cov_33.328063	57	137	121	2	80	0.0250000
NODE_24528_length_605_cov_33.328063	57	137	125	2	80	0.0250000
NODE_24528_length_605_cov_33.328063	57	137	131	1	80	0.0125000
NODE_24528_length_605_cov_33.328063	57	137	133	1	80	0.0125000
NODE_24528_length_605_cov_33.328063	57	137	135	2	80	0.0250000
NODE_24528_length_605_cov_33.328063	57	137	136	1	80	0.0125000
NODE_24528_length_605_cov_33.328063	57	137	141	1	80	0.0125000
NODE_24528_length_605_cov_33.328063	57	137	151	1	80	0.0125000
NODE_24528_length_605_cov_33.328063	57	137	155	1	80	0.0125000
NODE_24528_length_605_cov_33.328063	57	137	156	1	80	0.0125000
NODE_24528_length_605_cov_33.328063	57	137	160	1	80	0.0125000
NODE_24528_length_605_cov_33.328063	57	137	162	2	80	0.0250000
NODE_24528_length_605_cov_33.328063	57	137	166	1	80	0.0125000
NODE_24528_length_605_cov_33.328063	57	137	170	1	80	0.0125000
NODE_24528_length_605_cov_33.328063	57	137	175	1	80	0.0125000
NODE_24528_length_605_cov_33.328063	57	137	177	2	80	0.0250000
NODE_24528_length_605_cov_33.328063	57	137	182	1	80	0.0125000
NODE_24528_length_605_cov_33.328063	57	137	190	2	80	0.0250000
NODE_24528_length_605_cov_33.328063	57	137	198	3	80	0.0375000
NODE_24528_length_605_cov_33.328063	57	137	203	1	80	0.0125000
NODE_24528_length_605_cov_33.328063	57	137	206	2	80	0.0250000
NODE_24528_length_605_cov_33.328063	57	137	209	1	80	0.0125000
NODE_24528_length_605_cov_33.328063	57	137	212	1	80	0.0125000
NODE_24528_length_605_cov_33.328063	57	137	214	5	80	0.0625000
NODE_24528_length_605_cov_33.328063	57	137	215	1	80	0.0125000
NODE_24528_length_605_cov_33.328063	57	137	219	2	80	0.0250000
NODE_24528_length_605_cov_33.328063	57	137	221	1	80	0.0125000
NODE_24528_length_605_cov_33.328063	57	137	222	1	80	0.0125000
NODE_24528_length_605_cov_33.328063	57	137	225	1	80	0.0125000
NODE_24528_length_605_cov_33.328063	57	137	226	1	80	0.0125000
NODE_24528_length_605_cov_33.328063	57	137	227	2	80	0.0250000
NODE_24528_length_605_cov_33.328063	57	137	228	1	80	0.0125000
NODE_24528_length_605_cov_33.328063	57	137	229	2	80	0.0250000
NODE_24528_length_605_cov_33.328063	57	137	230	1	80	0.0125000
NODE_24528_length_605_cov_33.328063	57	137	231	1	80	0.0125000
NODE_24528_length_605_cov_33.328063	57	137	232	2	80	0.0250000
NODE_24528_length_605_cov_33.328063	57	137	233	1	80	0.0125000
NODE_24528_length_605_cov_33.328063	57	137	236	3	80	0.0375000
NODE_24528_length_605_cov_33.328063	57	137	237	2	80	0.0250000
NODE_24528_length_605_cov_33.328063	57	137	238	2	80	0.0250000
NODE_24528_length_605_cov_33.328063	57	137	239	2	80	0.0250000
NODE_24528_length_605_cov_33.328063	57	137	240	2	80	0.0250000
NODE_24528_length_605_cov_33.328063	57	137	241	3	80	0.0375000
NODE_24528_length_605_cov_33.328063	57	137	243	2	80	0.0250000
NODE_24528_length_605_cov_33.328063	57	137	245	1	80	0.0125000
NODE_24528_length_605_cov_33.328063	57	137	247	1	80	0.0125000
NODE_24528_length_605_cov_33.328063	57	137	249	2	80	0.0250000
NODE_24528_length_605_cov_33.328063	140	175	311	1	35	0.0285714
NODE_24528_length_605_cov_33.328063	140	175	314	1	35	0.0285714
NODE_24528_length_605_cov_33.328063	140	175	315	1	35	0.0285714
NODE_24528_length_605_cov_33.328063	140	175	317	2	35	0.0571429
NODE_24528_length_605_cov_33.328063	140	175	318	1	35	0.0285714
NODE_24528_length_605_cov_33.328063	140	175	319	1	35	0.0285714
NODE_24528_length_605_cov_33.328063	140	175	321	1	35	0.0285714
NODE_24528_length_605_cov_33.328063	140	175	322	1	35	0.0285714
NODE_24528_length_605_cov_33.328063	140	175	327	1	35	0.0285714
NODE_24528_length_605_cov_33.328063	140	175	328	1	35	0.0285714
NODE_24528_length_605_cov_33.328063	140	175	334	1	35	0.0285714
NODE_24528_length_605_cov_33.328063	140	175	342	1	35	0.0285714
NODE_24528_length_605_cov_33.328063	140	175	363	1	35	0.0285714
NODE_24528_length_605_cov_33.328063	140	175	373	1	35	0.0285714
NODE_24528_length_605_cov_33.328063	140	175	380	2	35	0.0571429
NODE_24528_length_605_cov_33.328063	140	175	383	1	35	0.0285714
NODE_24528_length_605_cov_33.328063	140	175	406	1	35	0.0285714
NODE_24528_length_605_cov_33.328063	140	175	408	1	35	0.0285714
NODE_24528_length_605_cov_33.328063	140	175	409	1	35	0.0285714
NODE_24528_length_605_cov_33.328063	140	175	413	1	35	0.0285714
NODE_24528_length_605_cov_33.328063	140	175	414	1	35	0.0285714
NODE_24528_length_605_cov_33.328063	140	175	415	1	35	0.0285714
NODE_24528_length_605_cov_33.328063	140	175	421	1	35	0.0285714
NODE_24528_length_605_cov_33.328063	140	175	423	1	35	0.0285714
NODE_24528_length_605_cov_33.328063	140	175	428	1	35	0.0285714
NODE_24528_length_605_cov_33.328063	140	175	430	1	35	0.0285714
NODE_24528_length_605_cov_33.328063	140	175	431	1	35	0.0285714
NODE_24528_length_605_cov_33.328063	140	175	434	1	35	0.0285714
NODE_24528_length_605_cov_33.328063	140	175	441	1	35	0.0285714
NODE_24528_length_605_cov_33.328063	140	175	443	1	35	0.0285714
NODE_24528_length_605_cov_33.328063	140	175	445	1	35	0.0285714
NODE_24528_length_605_cov_33.328063	140	175	447	1	35	0.0285714
NODE_24528_length_605_cov_33.328063	140	175	452	1	35	0.0285714
NODE_24529_length_605_cov_26.717391	353	433	0	80	80	1.0000000
NODE_24529_length_605_cov_26.717391	406	486	0	80	80	1.0000000
NODE_24530_length_605_cov_17.677866	215	295	0	80	80	1.0000000
NODE_24530_length_605_cov_17.677866	268	348	0	80	80	1.0000000
NODE_24531_length_605_cov_15.225296	144	224	4	80	80	1.0000000
NODE_24531_length_605_cov_15.225296	197	277	0	36	80	0.4500000
NODE_24531_length_605_cov_15.225296	197	277	4	44	80	0.5500000
NODE_24532_length_605_cov_14.990119	136	216	0	80	80	1.0000000
NODE_24532_length_605_cov_14.990119	189	269	0	80	80	1.0000000
NODE_24533_length_605_cov_10.835968	103	183	0	80	80	1.0000000
NODE_24533_length_605_cov_10.835968	156	236	0	80	80	1.0000000
NODE_24534_length_605_cov_9.169960	306	377	0	71	71	1.0000000
NODE_24534_length_605_cov_9.169960	359	432	0	73	73	1.0000000
NODE_24546_length_605_cov_4.308300	159	239	0	80	80	1.0000000
NODE_24546_length_605_cov_4.308300	271	338	12	3	67	0.0447761
NODE_24546_length_605_cov_4.308300	271	338	16	6	67	0.0895522
NODE_24546_length_605_cov_4.308300	271	338	18	1	67	0.0149254
NODE_24546_length_605_cov_4.308300	271	338	20	8	67	0.1194030
NODE_24546_length_605_cov_4.308300	271	338	22	21	67	0.3134328
NODE_24546_length_605_cov_4.308300	271	338	24	28	67	0.4179105
NODE_24546_length_605_cov_4.308300	275	350	16	5	75	0.0666667
NODE_24546_length_605_cov_4.308300	275	350	18	1	75	0.0133333
NODE_24546_length_605_cov_4.308300	275	350	20	14	75	0.1866667
NODE_24546_length_605_cov_4.308300	275	350	22	27	75	0.3600000
NODE_24546_length_605_cov_4.308300	275	350	24	28	75	0.3733333
NODE_24546_length_605_cov_4.308300	315	372	12	1	57	0.0175439
NODE_24546_length_605_cov_4.308300	315	372	15	8	57	0.1403509
NODE_24546_length_605_cov_4.308300	315	372	16	2	57	0.0350877
NODE_24546_length_605_cov_4.308300	315	372	18	7	57	0.1228070
NODE_24546_length_605_cov_4.308300	315	372	20	10	57	0.1754386
NODE_24546_length_605_cov_4.308300	315	372	22	23	57	0.4035088
NODE_24546_length_605_cov_4.308300	315	372	24	6	57	0.1052632
NODE_24546_length_605_cov_4.308300	328	373	12	2	45	0.0444444
NODE_24546_length_605_cov_4.308300	328	373	15	8	45	0.1777778
NODE_24546_length_605_cov_4.308300	328	373	16	2	45	0.0444444
NODE_24546_length_605_cov_4.308300	328	373	18	7	45	0.1555556
NODE_24546_length_605_cov_4.308300	328	373	20	10	45	0.2222222
NODE_24546_length_605_cov_4.308300	328	373	22	16	45	0.3555556
NODE_24558_length_605_cov_3.120553	216	287	2	13	71	0.1830986
NODE_24558_length_605_cov_3.120553	216	287	3	19	71	0.2676056
NODE_24558_length_605_cov_3.120553	216	287	4	39	71	0.5492958
NODE_24561_length_605_cov_2.909091	408	487	0	9	79	0.1139240
NODE_24561_length_605_cov_2.909091	408	487	2	7	79	0.0886076
NODE_24561_length_605_cov_2.909091	408	487	4	36	79	0.4556962
NODE_24561_length_605_cov_2.909091	408	487	5	2	79	0.0253165
NODE_24561_length_605_cov_2.909091	408	487	6	25	79	0.3164557
NODE_24577_length_605_cov_1.897233	230	273	4	43	43	1.0000000
NODE_24603_length_605_cov_1.339921	168	210	0	42	42	1.0000000
NODE_24636_length_604_cov_30.411881	93	173	0	80	80	1.0000000
NODE_24636_length_604_cov_30.411881	146	226	0	80	80	1.0000000
NODE_24637_length_604_cov_20.099010	414	494	0	80	80	1.0000000
NODE_24637_length_604_cov_20.099010	467	547	0	80	80	1.0000000
NODE_24639_length_604_cov_10.291089	184	264	0	80	80	1.0000000
NODE_24639_length_604_cov_10.291089	237	317	0	80	80	1.0000000
NODE_24646_length_604_cov_6.033663	265	345	0	38	80	0.4750000
NODE_24646_length_604_cov_6.033663	265	345	2	41	80	0.5125000
NODE_24646_length_604_cov_6.033663	265	345	4	1	80	0.0125000
NODE_24646_length_604_cov_6.033663	318	397	2	26	79	0.3291139
NODE_24646_length_604_cov_6.033663	318	397	4	2	79	0.0253165
NODE_24646_length_604_cov_6.033663	318	397	8	5	79	0.0632911
NODE_24646_length_604_cov_6.033663	318	397	10	17	79	0.2151899
NODE_24646_length_604_cov_6.033663	318	397	12	1	79	0.0126582
NODE_24646_length_604_cov_6.033663	318	397	14	23	79	0.2911392
NODE_24646_length_604_cov_6.033663	318	397	16	5	79	0.0632911
NODE_24654_length_604_cov_4.316832	40	106	0	66	66	1.0000000
NODE_24654_length_604_cov_4.316832	377	435	0	38	58	0.6551724
NODE_24654_length_604_cov_4.316832	377	435	2	20	58	0.3448276
NODE_24692_length_604_cov_1.805941	299	380	0	81	81	1.0000000
NODE_24692_length_604_cov_1.805941	353	433	0	80	80	1.0000000
NODE_24732_length_603_cov_18.761905	108	188	0	80	80	1.0000000
NODE_24732_length_603_cov_18.761905	161	241	0	80	80	1.0000000
NODE_24734_length_603_cov_8.996032	163	243	0	4	80	0.0500000
NODE_24734_length_603_cov_8.996032	163	243	4	64	80	0.8000000
NODE_24734_length_603_cov_8.996032	163	243	6	12	80	0.1500000
NODE_24734_length_603_cov_8.996032	216	296	2	30	80	0.3750000
NODE_24734_length_603_cov_8.996032	216	296	4	15	80	0.1875000
NODE_24734_length_603_cov_8.996032	216	296	6	35	80	0.4375000
NODE_24735_length_603_cov_8.970238	413	493	0	24	80	0.3000000
NODE_24735_length_603_cov_8.970238	413	493	2	56	80	0.7000000
NODE_24736_length_603_cov_7.212302	324	404	0	80	80	1.0000000
NODE_24736_length_603_cov_7.212302	377	457	0	80	80	1.0000000
NODE_24739_length_603_cov_5.831349	351	385	0	34	34	1.0000000
NODE_24744_length_603_cov_4.744048	103	183	0	80	80	1.0000000
NODE_24744_length_603_cov_4.744048	156	236	0	80	80	1.0000000
NODE_24748_length_603_cov_4.115079	219	259	0	40	40	1.0000000
NODE_24755_length_603_cov_3.269841	186	223	0	37	37	1.0000000
NODE_24755_length_603_cov_3.269841	196	276	0	80	80	1.0000000
NODE_24755_length_603_cov_3.269841	367	441	0	74	74	1.0000000
NODE_24843_length_602_cov_33.208748	106	186	0	32	80	0.4000000
NODE_24843_length_602_cov_33.208748	106	186	4	48	80	0.6000000
NODE_24843_length_602_cov_33.208748	159	239	0	12	80	0.1500000
NODE_24843_length_602_cov_33.208748	159	239	4	68	80	0.8500000
NODE_24844_length_602_cov_28.922465	319	399	0	80	80	1.0000000
NODE_24844_length_602_cov_28.922465	372	452	0	80	80	1.0000000
NODE_24846_length_602_cov_10.930417	248	328	0	80	80	1.0000000
NODE_24846_length_602_cov_10.930417	301	381	0	80	80	1.0000000
NODE_24847_length_602_cov_10.447316	148	207	12	8	59	0.1355932
NODE_24847_length_602_cov_10.447316	148	207	16	8	59	0.1355932
NODE_24847_length_602_cov_10.447316	148	207	17	1	59	0.0169492
NODE_24847_length_602_cov_10.447316	148	207	18	39	59	0.6610169
NODE_24847_length_602_cov_10.447316	148	207	20	3	59	0.0508475
NODE_24847_length_602_cov_10.447316	181	207	12	8	26	0.3076923
NODE_24847_length_602_cov_10.447316	181	207	16	8	26	0.3076923
NODE_24847_length_602_cov_10.447316	181	207	17	1	26	0.0384615
NODE_24847_length_602_cov_10.447316	181	207	18	6	26	0.2307692
NODE_24847_length_602_cov_10.447316	181	207	20	3	26	0.1153846
NODE_24847_length_602_cov_10.447316	259	291	10	32	32	1.0000000
NODE_24851_length_602_cov_7.787276	544	565	0	21	21	1.0000000
NODE_24875_length_602_cov_3.332008	157	239	6	7	82	0.0853659
NODE_24875_length_602_cov_3.332008	157	239	8	75	82	0.9146342
NODE_24957_length_601_cov_14.952191	183	263	0	80	80	1.0000000
NODE_24957_length_601_cov_14.952191	236	316	0	80	80	1.0000000
NODE_24958_length_601_cov_14.747012	324	404	2	80	80	1.0000000
NODE_24958_length_601_cov_14.747012	377	457	0	47	80	0.5875000
NODE_24958_length_601_cov_14.747012	377	457	2	33	80	0.4125000
NODE_24959_length_601_cov_11.561753	226	306	0	80	80	1.0000000
NODE_24959_length_601_cov_11.561753	279	359	0	80	80	1.0000000
NODE_24960_length_601_cov_10.826693	320	388	0	68	68	1.0000000
NODE_24961_length_601_cov_10.392430	243	323	0	80	80	1.0000000
NODE_24961_length_601_cov_10.392430	296	375	0	79	79	1.0000000
NODE_24965_length_601_cov_7.037849	236	316	0	80	80	1.0000000
NODE_24965_length_601_cov_7.037849	289	369	0	80	80	1.0000000
NODE_24969_length_601_cov_5.798805	290	361	0	71	71	1.0000000
NODE_24970_length_601_cov_5.657371	228	308	4	39	80	0.4875000
NODE_24970_length_601_cov_5.657371	228	308	6	41	80	0.5125000
NODE_24973_length_601_cov_5.039841	395	462	0	67	67	1.0000000
NODE_24975_length_601_cov_4.735060	184	247	0	63	63	1.0000000
NODE_24995_length_601_cov_2.599602	371	430	0	59	59	1.0000000
NODE_24995_length_601_cov_2.599602	441	494	0	53	53	1.0000000
NODE_25090_length_600_cov_6.341317	125	147	0	22	22	1.0000000
NODE_25103_length_600_cov_3.754491	142	222	4	15	80	0.1875000
NODE_25103_length_600_cov_3.754491	142	222	6	65	80	0.8125000
NODE_25126_length_600_cov_2.081836	282	328	0	46	46	1.0000000
NODE_25141_length_600_cov_1.728543	381	423	0	42	42	1.0000000
NODE_25190_length_599_cov_36.488000	25	105	18	8	80	0.1000000
NODE_25190_length_599_cov_36.488000	25	105	20	3	80	0.0375000
NODE_25190_length_599_cov_36.488000	25	105	22	4	80	0.0500000
NODE_25190_length_599_cov_36.488000	25	105	24	8	80	0.1000000
NODE_25190_length_599_cov_36.488000	25	105	26	57	80	0.7125000
NODE_25191_length_599_cov_27.870000	255	335	0	12	80	0.1500000
NODE_25191_length_599_cov_27.870000	255	335	2	68	80	0.8500000
NODE_25191_length_599_cov_27.870000	308	388	2	57	80	0.7125000
NODE_25191_length_599_cov_27.870000	308	388	4	23	80	0.2875000
NODE_25192_length_599_cov_22.640000	229	309	0	8	80	0.1000000
NODE_25192_length_599_cov_22.640000	229	309	2	15	80	0.1875000
NODE_25192_length_599_cov_22.640000	229	309	4	57	80	0.7125000
NODE_25192_length_599_cov_22.640000	229	309	0	8	80	0.1000000
NODE_25192_length_599_cov_22.640000	229	309	2	15	80	0.1875000
NODE_25192_length_599_cov_22.640000	229	309	4	57	80	0.7125000
NODE_25192_length_599_cov_22.640000	229	309	0	8	80	0.1000000
NODE_25192_length_599_cov_22.640000	229	309	2	15	80	0.1875000
NODE_25192_length_599_cov_22.640000	229	309	4	57	80	0.7125000
NODE_25192_length_599_cov_22.640000	229	309	0	8	80	0.1000000
NODE_25192_length_599_cov_22.640000	229	309	2	15	80	0.1875000
NODE_25192_length_599_cov_22.640000	229	309	4	57	80	0.7125000
NODE_25192_length_599_cov_22.640000	229	309	0	8	80	0.1000000
NODE_25192_length_599_cov_22.640000	229	309	2	15	80	0.1875000
NODE_25192_length_599_cov_22.640000	229	309	4	57	80	0.7125000
NODE_25192_length_599_cov_22.640000	282	362	0	39	80	0.4875000
NODE_25192_length_599_cov_22.640000	282	362	2	15	80	0.1875000
NODE_25192_length_599_cov_22.640000	282	362	3	22	80	0.2750000
NODE_25192_length_599_cov_22.640000	282	362	4	4	80	0.0500000
NODE_25192_length_599_cov_22.640000	282	362	0	39	80	0.4875000
NODE_25192_length_599_cov_22.640000	282	362	2	15	80	0.1875000
NODE_25192_length_599_cov_22.640000	282	362	3	22	80	0.2750000
NODE_25192_length_599_cov_22.640000	282	362	4	4	80	0.0500000
NODE_25192_length_599_cov_22.640000	282	353	0	39	71	0.5492958
NODE_25192_length_599_cov_22.640000	282	353	2	15	71	0.2112676
NODE_25192_length_599_cov_22.640000	282	353	3	13	71	0.1830986
NODE_25192_length_599_cov_22.640000	282	353	4	4	71	0.0563380
NODE_25192_length_599_cov_22.640000	285	355	0	39	70	0.5571429
NODE_25192_length_599_cov_22.640000	285	355	2	15	70	0.2142857
NODE_25192_length_599_cov_22.640000	285	355	3	15	70	0.2142857
NODE_25192_length_599_cov_22.640000	285	355	4	1	70	0.0142857
NODE_25192_length_599_cov_22.640000	287	362	0	39	75	0.5200000
NODE_25192_length_599_cov_22.640000	287	362	2	14	75	0.1866667
NODE_25192_length_599_cov_22.640000	287	362	3	22	75	0.2933333
NODE_25193_length_599_cov_14.618000	279	359	0	29	80	0.3625000
NODE_25193_length_599_cov_14.618000	279	359	2	51	80	0.6375000
NODE_25193_length_599_cov_14.618000	332	412	0	80	80	1.0000000
NODE_25195_length_599_cov_10.308000	245	325	0	80	80	1.0000000
NODE_25195_length_599_cov_10.308000	298	378	0	80	80	1.0000000
NODE_25196_length_599_cov_9.224000	160	240	0	80	80	1.0000000
NODE_25196_length_599_cov_9.224000	213	297	0	84	84	1.0000000
NODE_25201_length_599_cov_5.536000	58	112	0	54	54	1.0000000
NODE_25208_length_599_cov_3.810000	271	334	0	63	63	1.0000000
NODE_25208_length_599_cov_3.810000	324	390	0	66	66	1.0000000
NODE_25211_length_599_cov_3.598000	238	318	0	80	80	1.0000000
NODE_25211_length_599_cov_3.598000	291	371	0	80	80	1.0000000
NODE_25308_length_598_cov_54.450902	264	344	0	80	80	1.0000000
NODE_25308_length_598_cov_54.450902	317	397	0	80	80	1.0000000
NODE_25309_length_598_cov_8.326653	204	284	0	80	80	1.0000000
NODE_25309_length_598_cov_8.326653	257	337	0	80	80	1.0000000
NODE_25316_length_598_cov_5.623246	169	240	2	25	71	0.3521127
NODE_25316_length_598_cov_5.623246	169	240	4	1	71	0.0140845
NODE_25316_length_598_cov_5.623246	169	240	6	45	71	0.6338028
NODE_25320_length_598_cov_4.929860	73	153	0	80	80	1.0000000
NODE_25320_length_598_cov_4.929860	126	206	0	80	80	1.0000000
NODE_25421_length_597_cov_15.142570	197	277	0	65	80	0.8125000
NODE_25421_length_597_cov_15.142570	197	277	2	15	80	0.1875000
NODE_25421_length_597_cov_15.142570	250	330	0	80	80	1.0000000
NODE_25422_length_597_cov_12.387550	118	198	0	80	80	1.0000000
NODE_25422_length_597_cov_12.387550	171	251	0	80	80	1.0000000
NODE_25423_length_597_cov_7.016064	213	293	0	80	80	1.0000000
NODE_25423_length_597_cov_7.016064	266	346	0	80	80	1.0000000
NODE_25426_length_597_cov_6.212851	374	449	0	1	75	0.0133333
NODE_25426_length_597_cov_6.212851	374	449	2	74	75	0.9866667
NODE_25434_length_597_cov_4.273092	368	448	0	80	80	1.0000000
NODE_25434_length_597_cov_4.273092	421	507	0	86	86	1.0000000
NODE_25464_length_597_cov_2.162651	92	172	0	80	80	1.0000000
NODE_25464_length_597_cov_2.162651	145	225	0	80	80	1.0000000
NODE_25467_length_597_cov_2.096386	440	509	0	33	69	0.4782609
NODE_25467_length_597_cov_2.096386	440	509	2	36	69	0.5217391
NODE_25469_length_597_cov_1.977912	392	472	8	33	80	0.4125000
NODE_25469_length_597_cov_1.977912	392	472	10	42	80	0.5250000
NODE_25469_length_597_cov_1.977912	392	472	11	1	80	0.0125000
NODE_25469_length_597_cov_1.977912	392	472	12	4	80	0.0500000
NODE_25469_length_597_cov_1.977912	437	494	4	19	57	0.3333333
NODE_25469_length_597_cov_1.977912	437	494	6	3	57	0.0526316
NODE_25469_length_597_cov_1.977912	437	494	8	25	57	0.4385965
NODE_25469_length_597_cov_1.977912	437	494	10	5	57	0.0877193
NODE_25469_length_597_cov_1.977912	437	494	11	1	57	0.0175439
NODE_25469_length_597_cov_1.977912	437	494	12	4	57	0.0701754
NODE_25469_length_597_cov_1.977912	445	525	4	50	80	0.6250000
NODE_25469_length_597_cov_1.977912	445	525	6	3	80	0.0375000
NODE_25469_length_597_cov_1.977912	445	525	8	17	80	0.2125000
NODE_25469_length_597_cov_1.977912	445	525	10	5	80	0.0625000
NODE_25469_length_597_cov_1.977912	445	525	11	1	80	0.0125000
NODE_25469_length_597_cov_1.977912	445	525	12	4	80	0.0500000
NODE_25552_length_596_cov_32.293763	221	301	0	80	80	1.0000000
NODE_25552_length_596_cov_32.293763	274	354	0	80	80	1.0000000
NODE_25552_length_596_cov_32.293763	351	406	0	55	55	1.0000000
NODE_25552_length_596_cov_32.293763	381	459	0	31	78	0.3974359
NODE_25552_length_596_cov_32.293763	381	459	4	47	78	0.6025641
NODE_25553_length_596_cov_26.891348	199	279	0	80	80	1.0000000
NODE_25553_length_596_cov_26.891348	252	332	0	80	80	1.0000000
NODE_25554_length_596_cov_17.082495	179	259	0	80	80	1.0000000
NODE_25554_length_596_cov_17.082495	232	312	0	80	80	1.0000000
NODE_25555_length_596_cov_10.372233	354	434	0	80	80	1.0000000
NODE_25555_length_596_cov_10.372233	407	487	0	80	80	1.0000000
NODE_25557_length_596_cov_6.955734	142	222	4	80	80	1.0000000
NODE_25558_length_596_cov_6.225352	242	322	0	78	80	0.9750000
NODE_25558_length_596_cov_6.225352	242	322	2	2	80	0.0250000
NODE_25558_length_596_cov_6.225352	308	375	0	12	67	0.1791045
NODE_25558_length_596_cov_6.225352	308	375	2	55	67	0.8208955
NODE_25567_length_596_cov_4.197183	369	444	0	52	75	0.6933333
NODE_25567_length_596_cov_4.197183	369	444	2	6	75	0.0800000
NODE_25567_length_596_cov_4.197183	369	444	4	1	75	0.0133333
NODE_25567_length_596_cov_4.197183	369	444	6	1	75	0.0133333
NODE_25567_length_596_cov_4.197183	369	444	8	15	75	0.2000000
NODE_25593_length_596_cov_2.066398	534	583	0	49	49	1.0000000
NODE_25666_length_595_cov_52.532258	248	328	0	29	80	0.3625000
NODE_25666_length_595_cov_52.532258	248	328	2	51	80	0.6375000
NODE_25666_length_595_cov_52.532258	301	381	0	80	80	1.0000000
NODE_25667_length_595_cov_38.584677	122	202	0	60	80	0.7500000
NODE_25667_length_595_cov_38.584677	122	202	2	20	80	0.2500000
NODE_25667_length_595_cov_38.584677	175	255	0	11	80	0.1375000
NODE_25667_length_595_cov_38.584677	175	255	2	69	80	0.8625000
NODE_25669_length_595_cov_10.576613	323	403	0	80	80	1.0000000
NODE_25669_length_595_cov_10.576613	376	456	0	80	80	1.0000000
NODE_25672_length_595_cov_7.917339	342	415	7	28	73	0.3835616
NODE_25672_length_595_cov_7.917339	342	415	8	45	73	0.6164383
NODE_25672_length_595_cov_7.917339	388	438	0	12	50	0.2400000
NODE_25672_length_595_cov_7.917339	388	438	7	38	50	0.7600000
NODE_25702_length_595_cov_2.792339	178	258	0	75	80	0.9375000
NODE_25702_length_595_cov_2.792339	178	258	2	5	80	0.0625000
NODE_25702_length_595_cov_2.792339	231	311	0	22	80	0.2750000
NODE_25702_length_595_cov_2.792339	231	311	2	53	80	0.6625000
NODE_25702_length_595_cov_2.792339	231	311	4	5	80	0.0625000
NODE_25807_length_594_cov_34.157576	283	363	0	17	80	0.2125000
NODE_25807_length_594_cov_34.157576	283	363	2	20	80	0.2500000
NODE_25807_length_594_cov_34.157576	283	363	4	43	80	0.5375000
NODE_25807_length_594_cov_34.157576	336	416	0	28	80	0.3500000
NODE_25807_length_594_cov_34.157576	336	416	2	20	80	0.2500000
NODE_25807_length_594_cov_34.157576	336	416	4	32	80	0.4000000
NODE_25811_length_594_cov_8.933333	258	338	0	80	80	1.0000000
NODE_25811_length_594_cov_8.933333	311	389	0	78	78	1.0000000
NODE_25815_length_594_cov_5.759596	82	118	0	36	36	1.0000000
NODE_25815_length_594_cov_5.759596	114	194	0	53	80	0.6625000
NODE_25815_length_594_cov_5.759596	114	194	1	1	80	0.0125000
NODE_25815_length_594_cov_5.759596	114	194	4	1	80	0.0125000
NODE_25815_length_594_cov_5.759596	114	194	5	8	80	0.1000000
NODE_25815_length_594_cov_5.759596	114	194	7	17	80	0.2125000
NODE_25815_length_594_cov_5.759596	167	242	1	1	75	0.0133333
NODE_25815_length_594_cov_5.759596	167	242	4	1	75	0.0133333
NODE_25815_length_594_cov_5.759596	167	242	5	8	75	0.1066667
NODE_25815_length_594_cov_5.759596	167	242	7	26	75	0.3466667
NODE_25815_length_594_cov_5.759596	167	242	9	39	75	0.5200000
NODE_25825_length_594_cov_3.913131	275	355	0	60	80	0.7500000
NODE_25825_length_594_cov_3.913131	275	355	2	9	80	0.1125000
NODE_25825_length_594_cov_3.913131	275	355	4	11	80	0.1375000
NODE_25844_length_594_cov_2.470707	209	247	0	38	38	1.0000000
NODE_25919_length_594_cov_0.698990	33	73	0	40	40	1.0000000
NODE_25928_length_593_cov_124.985830	247	285	32	6	38	0.1578947
NODE_25928_length_593_cov_124.985830	247	285	33	3	38	0.0789474
NODE_25928_length_593_cov_124.985830	247	285	35	3	38	0.0789474
NODE_25928_length_593_cov_124.985830	247	285	39	2	38	0.0526316
NODE_25928_length_593_cov_124.985830	247	285	40	2	38	0.0526316
NODE_25928_length_593_cov_124.985830	247	285	42	2	38	0.0526316
NODE_25928_length_593_cov_124.985830	247	285	43	2	38	0.0526316
NODE_25928_length_593_cov_124.985830	247	285	44	1	38	0.0263158
NODE_25928_length_593_cov_124.985830	247	285	46	3	38	0.0789474
NODE_25928_length_593_cov_124.985830	247	285	48	2	38	0.0526316
NODE_25928_length_593_cov_124.985830	247	285	50	5	38	0.1315790
NODE_25928_length_593_cov_124.985830	247	285	52	1	38	0.0263158
NODE_25928_length_593_cov_124.985830	247	285	54	1	38	0.0263158
NODE_25928_length_593_cov_124.985830	247	285	57	3	38	0.0789474
NODE_25928_length_593_cov_124.985830	247	285	58	1	38	0.0263158
NODE_25928_length_593_cov_124.985830	247	285	60	1	38	0.0263158
NODE_25929_length_593_cov_36.161943	150	230	0	80	80	1.0000000
NODE_25929_length_593_cov_36.161943	203	283	0	80	80	1.0000000
NODE_25930_length_593_cov_14.979757	219	299	0	80	80	1.0000000
NODE_25930_length_593_cov_14.979757	272	352	0	80	80	1.0000000
NODE_25931_length_593_cov_11.018219	324	404	0	52	80	0.6500000
NODE_25931_length_593_cov_11.018219	324	404	2	28	80	0.3500000
NODE_25931_length_593_cov_11.018219	377	457	0	5	80	0.0625000
NODE_25931_length_593_cov_11.018219	377	457	2	75	80	0.9375000
NODE_25946_length_593_cov_3.232794	210	273	0	63	63	1.0000000
NODE_25946_length_593_cov_3.232794	263	326	0	63	63	1.0000000
NODE_25996_length_593_cov_1.261134	227	249	0	22	22	1.0000000
NODE_26033_length_592_cov_18.908722	163	243	3	5	80	0.0625000
NODE_26033_length_592_cov_18.908722	163	243	4	66	80	0.8250000
NODE_26033_length_592_cov_18.908722	163	243	7	9	80	0.1125000
NODE_26033_length_592_cov_18.908722	230	296	4	4	66	0.0606061
NODE_26033_length_592_cov_18.908722	230	296	5	22	66	0.3333333
NODE_26033_length_592_cov_18.908722	230	296	6	12	66	0.1818182
NODE_26033_length_592_cov_18.908722	230	296	7	28	66	0.4242424
NODE_26034_length_592_cov_7.531440	232	312	0	7	80	0.0875000
NODE_26034_length_592_cov_7.531440	232	312	2	21	80	0.2625000
NODE_26034_length_592_cov_7.531440	232	312	4	14	80	0.1750000
NODE_26034_length_592_cov_7.531440	232	312	6	6	80	0.0750000
NODE_26034_length_592_cov_7.531440	232	312	8	32	80	0.4000000
NODE_26034_length_592_cov_7.531440	285	361	4	19	76	0.2500000
NODE_26034_length_592_cov_7.531440	285	361	6	8	76	0.1052632
NODE_26034_length_592_cov_7.531440	285	361	8	49	76	0.6447368
NODE_26035_length_592_cov_7.000000	77	157	0	80	80	1.0000000
NODE_26035_length_592_cov_7.000000	130	210	0	80	80	1.0000000
NODE_26040_length_592_cov_5.036511	270	349	0	79	79	1.0000000
NODE_26041_length_592_cov_5.024341	205	285	0	12	80	0.1500000
NODE_26041_length_592_cov_5.024341	205	285	4	17	80	0.2125000
NODE_26041_length_592_cov_5.024341	205	285	6	51	80	0.6375000
NODE_26041_length_592_cov_5.024341	258	309	6	51	51	1.0000000
NODE_26062_length_592_cov_2.866126	61	127	0	66	66	1.0000000
NODE_26069_length_592_cov_2.361055	476	526	0	17	50	0.3400000
NODE_26069_length_592_cov_2.361055	476	526	2	33	50	0.6600000
NODE_26142_length_591_cov_11.286585	245	325	0	42	80	0.5250000
NODE_26142_length_591_cov_11.286585	245	325	2	38	80	0.4750000
NODE_26142_length_591_cov_11.286585	298	378	0	13	80	0.1625000
NODE_26142_length_591_cov_11.286585	298	378	2	67	80	0.8375000
NODE_26143_length_591_cov_9.432927	241	321	0	25	80	0.3125000
NODE_26143_length_591_cov_9.432927	241	321	4	55	80	0.6875000
NODE_26143_length_591_cov_9.432927	294	374	4	80	80	1.0000000
NODE_26184_length_591_cov_2.365854	396	476	0	80	80	1.0000000
NODE_26184_length_591_cov_2.365854	449	529	0	80	80	1.0000000
NODE_26272_length_590_cov_29.661914	26	106	0	80	80	1.0000000
NODE_26272_length_590_cov_29.661914	79	159	0	80	80	1.0000000
NODE_26272_length_590_cov_29.661914	155	235	0	80	80	1.0000000
NODE_26272_length_590_cov_29.661914	208	288	0	80	80	1.0000000
NODE_26273_length_590_cov_21.360489	178	258	0	80	80	1.0000000
NODE_26273_length_590_cov_21.360489	231	311	0	80	80	1.0000000
NODE_26274_length_590_cov_18.395112	161	241	0	80	80	1.0000000
NODE_26274_length_590_cov_18.395112	214	294	0	80	80	1.0000000
NODE_26275_length_590_cov_17.376782	238	318	7	21	80	0.2625000
NODE_26275_length_590_cov_17.376782	238	318	10	9	80	0.1125000
NODE_26275_length_590_cov_17.376782	238	318	13	21	80	0.2625000
NODE_26275_length_590_cov_17.376782	238	318	14	29	80	0.3625000
NODE_26275_length_590_cov_17.376782	291	371	0	40	80	0.5000000
NODE_26275_length_590_cov_17.376782	291	371	6	1	80	0.0125000
NODE_26275_length_590_cov_17.376782	291	371	7	33	80	0.4125000
NODE_26275_length_590_cov_17.376782	291	371	10	6	80	0.0750000
NODE_26279_length_590_cov_6.205703	262	333	6	55	71	0.7746479
NODE_26279_length_590_cov_6.205703	262	333	8	2	71	0.0281690
NODE_26279_length_590_cov_6.205703	262	333	10	14	71	0.1971831
NODE_26283_length_590_cov_5.319756	224	304	0	4	80	0.0500000
NODE_26283_length_590_cov_5.319756	224	304	2	76	80	0.9500000
NODE_26283_length_590_cov_5.319756	277	357	0	35	80	0.4375000
NODE_26283_length_590_cov_5.319756	277	357	2	45	80	0.5625000
NODE_26366_length_590_cov_0.971487	0	32	0	32	32	1.0000000
NODE_26390_length_589_cov_15.810204	384	464	0	76	80	0.9500000
NODE_26390_length_589_cov_15.810204	384	464	2	4	80	0.0500000
NODE_26390_length_589_cov_15.810204	437	517	0	80	80	1.0000000
NODE_26391_length_589_cov_13.855102	320	400	2	1	80	0.0125000
NODE_26391_length_589_cov_13.855102	320	400	4	79	80	0.9875000
NODE_26391_length_589_cov_13.855102	373	453	0	45	80	0.5625000
NODE_26391_length_589_cov_13.855102	373	453	2	9	80	0.1125000
NODE_26391_length_589_cov_13.855102	373	453	4	26	80	0.3250000
NODE_26395_length_589_cov_6.297959	186	266	0	80	80	1.0000000
NODE_26395_length_589_cov_6.297959	239	319	0	80	80	1.0000000
NODE_26430_length_589_cov_2.320408	431	511	2	57	80	0.7125000
NODE_26430_length_589_cov_2.320408	431	511	4	23	80	0.2875000
NODE_26515_length_588_cov_49.936605	264	341	0	77	77	1.0000000
NODE_26515_length_588_cov_49.936605	314	394	0	80	80	1.0000000
NODE_26516_length_588_cov_33.691207	273	353	0	80	80	1.0000000
NODE_26516_length_588_cov_33.691207	326	406	0	80	80	1.0000000
NODE_26517_length_588_cov_16.564417	245	325	0	80	80	1.0000000
NODE_26517_length_588_cov_16.564417	298	378	0	80	80	1.0000000
NODE_26518_length_588_cov_14.595092	266	346	0	7	80	0.0875000
NODE_26518_length_588_cov_14.595092	266	346	2	73	80	0.9125000
NODE_26518_length_588_cov_14.595092	319	399	0	60	80	0.7500000
NODE_26518_length_588_cov_14.595092	319	399	2	20	80	0.2500000
NODE_26522_length_588_cov_7.439673	155	235	0	80	80	1.0000000
NODE_26522_length_588_cov_7.439673	208	288	0	80	80	1.0000000
NODE_26523_length_588_cov_7.094070	191	263	0	23	72	0.3194444
NODE_26523_length_588_cov_7.094070	191	263	2	34	72	0.4722222
NODE_26523_length_588_cov_7.094070	191	263	4	15	72	0.2083333
NODE_26523_length_588_cov_7.094070	244	310	0	66	66	1.0000000
NODE_26523_length_588_cov_7.094070	439	519	0	80	80	1.0000000
NODE_26523_length_588_cov_7.094070	492	572	0	80	80	1.0000000
NODE_26534_length_588_cov_4.167689	65	122	0	2	57	0.0350877
NODE_26534_length_588_cov_4.167689	65	122	4	55	57	0.9649123
NODE_26634_length_587_cov_39.782787	123	203	0	10	80	0.1250000
NODE_26634_length_587_cov_39.782787	123	203	2	70	80	0.8750000
NODE_26634_length_587_cov_39.782787	176	256	0	61	80	0.7625000
NODE_26634_length_587_cov_39.782787	176	256	2	19	80	0.2375000
NODE_26634_length_587_cov_39.782787	252	332	0	63	80	0.7875000
NODE_26634_length_587_cov_39.782787	252	332	4	17	80	0.2125000
NODE_26634_length_587_cov_39.782787	305	385	0	13	80	0.1625000
NODE_26634_length_587_cov_39.782787	305	385	4	67	80	0.8375000
NODE_26635_length_587_cov_31.807377	141	221	0	80	80	1.0000000
NODE_26635_length_587_cov_31.807377	194	274	0	80	80	1.0000000
NODE_26636_length_587_cov_12.629098	219	299	2	29	80	0.3625000
NODE_26636_length_587_cov_12.629098	219	299	4	51	80	0.6375000
NODE_26636_length_587_cov_12.629098	272	352	2	44	80	0.5500000
NODE_26636_length_587_cov_12.629098	272	352	4	36	80	0.4500000
NODE_26639_length_587_cov_9.067623	203	283	2	80	80	1.0000000
NODE_26639_length_587_cov_9.067623	256	336	2	77	80	0.9625000
NODE_26639_length_587_cov_9.067623	256	336	4	3	80	0.0375000
NODE_26640_length_587_cov_8.411885	253	311	2	2	58	0.0344828
NODE_26640_length_587_cov_8.411885	253	311	6	26	58	0.4482759
NODE_26640_length_587_cov_8.411885	253	311	8	3	58	0.0517241
NODE_26640_length_587_cov_8.411885	253	311	12	16	58	0.2758621
NODE_26640_length_587_cov_8.411885	253	311	13	1	58	0.0172414
NODE_26640_length_587_cov_8.411885	253	311	14	5	58	0.0862069
NODE_26640_length_587_cov_8.411885	253	311	16	5	58	0.0862069
NODE_26656_length_587_cov_3.231557	201	256	4	30	55	0.5454546
NODE_26656_length_587_cov_3.231557	201	256	5	21	55	0.3818182
NODE_26656_length_587_cov_3.231557	201	256	6	4	55	0.0727273
NODE_26665_length_587_cov_2.850410	255	288	2	15	33	0.4545455
NODE_26665_length_587_cov_2.850410	255	288	4	9	33	0.2727273
NODE_26665_length_587_cov_2.850410	255	288	5	1	33	0.0303030
NODE_26665_length_587_cov_2.850410	255	288	6	8	33	0.2424242
NODE_26749_length_586_cov_37.843943	268	348	0	80	80	1.0000000
NODE_26749_length_586_cov_37.843943	321	401	0	80	80	1.0000000
NODE_26749_length_586_cov_37.843943	397	477	0	80	80	1.0000000
NODE_26749_length_586_cov_37.843943	450	531	0	81	81	1.0000000
NODE_26750_length_586_cov_12.831622	186	266	0	80	80	1.0000000
NODE_26750_length_586_cov_12.831622	239	319	0	80	80	1.0000000
NODE_26752_length_586_cov_11.264887	108	188	0	80	80	1.0000000
NODE_26752_length_586_cov_11.264887	161	241	0	80	80	1.0000000
NODE_26754_length_586_cov_9.624230	299	360	0	61	61	1.0000000
NODE_26754_length_586_cov_9.624230	299	360	0	61	61	1.0000000
NODE_26754_length_586_cov_9.624230	299	360	0	61	61	1.0000000
NODE_26754_length_586_cov_9.624230	301	360	0	59	59	1.0000000
NODE_26756_length_586_cov_8.591376	273	353	0	80	80	1.0000000
NODE_26756_length_586_cov_8.591376	326	406	0	80	80	1.0000000
NODE_26758_length_586_cov_6.135524	334	375	0	41	41	1.0000000
NODE_26758_length_586_cov_6.135524	334	375	0	41	41	1.0000000
NODE_26760_length_586_cov_5.634497	150	230	0	80	80	1.0000000
NODE_26760_length_586_cov_5.634497	203	283	0	80	80	1.0000000
NODE_26765_length_586_cov_4.626283	296	362	0	66	66	1.0000000
NODE_26765_length_586_cov_4.626283	453	533	2	14	80	0.1750000
NODE_26765_length_586_cov_4.626283	453	533	4	1	80	0.0125000
NODE_26765_length_586_cov_4.626283	453	533	6	65	80	0.8125000
NODE_26885_length_585_cov_112.094650	456	536	72	3	80	0.0375000
NODE_26885_length_585_cov_112.094650	456	536	76	4	80	0.0500000
NODE_26885_length_585_cov_112.094650	456	536	84	1	80	0.0125000
NODE_26885_length_585_cov_112.094650	456	536	87	1	80	0.0125000
NODE_26885_length_585_cov_112.094650	456	536	90	2	80	0.0250000
NODE_26885_length_585_cov_112.094650	456	536	93	1	80	0.0125000
NODE_26885_length_585_cov_112.094650	456	536	95	2	80	0.0250000
NODE_26885_length_585_cov_112.094650	456	536	98	1	80	0.0125000
NODE_26885_length_585_cov_112.094650	456	536	100	1	80	0.0125000
NODE_26885_length_585_cov_112.094650	456	536	102	1	80	0.0125000
NODE_26885_length_585_cov_112.094650	456	536	105	5	80	0.0625000
NODE_26885_length_585_cov_112.094650	456	536	107	1	80	0.0125000
NODE_26885_length_585_cov_112.094650	456	536	108	7	80	0.0875000
NODE_26885_length_585_cov_112.094650	456	536	110	3	80	0.0375000
NODE_26885_length_585_cov_112.094650	456	536	112	3	80	0.0375000
NODE_26885_length_585_cov_112.094650	456	536	114	2	80	0.0250000
NODE_26885_length_585_cov_112.094650	456	536	116	3	80	0.0375000
NODE_26885_length_585_cov_112.094650	456	536	117	2	80	0.0250000
NODE_26885_length_585_cov_112.094650	456	536	119	2	80	0.0250000
NODE_26885_length_585_cov_112.094650	456	536	120	3	80	0.0375000
NODE_26885_length_585_cov_112.094650	456	536	121	4	80	0.0500000
NODE_26885_length_585_cov_112.094650	456	536	122	13	80	0.1625000
NODE_26885_length_585_cov_112.094650	456	536	123	6	80	0.0750000
NODE_26885_length_585_cov_112.094650	456	536	125	8	80	0.1000000
NODE_26885_length_585_cov_112.094650	456	536	127	1	80	0.0125000
NODE_26885_length_585_cov_112.094650	509	585	0	3	76	0.0394737
NODE_26885_length_585_cov_112.094650	509	585	2	7	76	0.0921053
NODE_26885_length_585_cov_112.094650	509	585	8	5	76	0.0657895
NODE_26885_length_585_cov_112.094650	509	585	12	2	76	0.0263158
NODE_26885_length_585_cov_112.094650	509	585	22	3	76	0.0394737
NODE_26885_length_585_cov_112.094650	509	585	24	2	76	0.0263158
NODE_26885_length_585_cov_112.094650	509	585	25	1	76	0.0131579
NODE_26885_length_585_cov_112.094650	509	585	26	3	76	0.0394737
NODE_26885_length_585_cov_112.094650	509	585	34	2	76	0.0263158
NODE_26885_length_585_cov_112.094650	509	585	36	1	76	0.0131579
NODE_26885_length_585_cov_112.094650	509	585	38	1	76	0.0131579
NODE_26885_length_585_cov_112.094650	509	585	40	1	76	0.0131579
NODE_26885_length_585_cov_112.094650	509	585	50	1	76	0.0131579
NODE_26885_length_585_cov_112.094650	509	585	54	1	76	0.0131579
NODE_26885_length_585_cov_112.094650	509	585	76	2	76	0.0263158
NODE_26885_length_585_cov_112.094650	509	585	78	1	76	0.0131579
NODE_26885_length_585_cov_112.094650	509	585	80	3	76	0.0394737
NODE_26885_length_585_cov_112.094650	509	585	82	1	76	0.0131579
NODE_26885_length_585_cov_112.094650	509	585	86	3	76	0.0394737
NODE_26885_length_585_cov_112.094650	509	585	92	3	76	0.0394737
NODE_26885_length_585_cov_112.094650	509	585	94	1	76	0.0131579
NODE_26885_length_585_cov_112.094650	509	585	98	3	76	0.0394737
NODE_26885_length_585_cov_112.094650	509	585	100	1	76	0.0131579
NODE_26885_length_585_cov_112.094650	509	585	102	1	76	0.0131579
NODE_26885_length_585_cov_112.094650	509	585	108	4	76	0.0526316
NODE_26885_length_585_cov_112.094650	509	585	110	1	76	0.0131579
NODE_26885_length_585_cov_112.094650	509	585	112	2	76	0.0263158
NODE_26885_length_585_cov_112.094650	509	585	114	1	76	0.0131579
NODE_26885_length_585_cov_112.094650	509	585	116	3	76	0.0394737
NODE_26885_length_585_cov_112.094650	509	585	121	4	76	0.0526316
NODE_26885_length_585_cov_112.094650	509	585	122	8	76	0.1052632
NODE_26885_length_585_cov_112.094650	509	585	123	1	76	0.0131579
NODE_26886_length_585_cov_23.872428	168	248	0	30	80	0.3750000
NODE_26886_length_585_cov_23.872428	168	248	2	50	80	0.6250000
NODE_26886_length_585_cov_23.872428	222	301	0	17	79	0.2151899
NODE_26886_length_585_cov_23.872428	222	301	2	62	79	0.7848101
NODE_26887_length_585_cov_18.981481	360	440	0	6	80	0.0750000
NODE_26887_length_585_cov_18.981481	360	440	4	74	80	0.9250000
NODE_26887_length_585_cov_18.981481	413	493	0	39	80	0.4875000
NODE_26887_length_585_cov_18.981481	413	493	4	41	80	0.5125000
NODE_26888_length_585_cov_13.967078	323	387	0	64	64	1.0000000
NODE_26889_length_585_cov_10.555556	229	309	0	80	80	1.0000000
NODE_26889_length_585_cov_10.555556	282	362	0	80	80	1.0000000
NODE_26891_length_585_cov_9.216049	233	313	0	80	80	1.0000000
NODE_26891_length_585_cov_9.216049	286	366	0	80	80	1.0000000
NODE_26894_length_585_cov_8.090535	292	372	0	80	80	1.0000000
NODE_26894_length_585_cov_8.090535	345	425	0	80	80	1.0000000
NODE_26895_length_585_cov_8.018519	339	381	0	42	42	1.0000000
NODE_26895_length_585_cov_8.018519	354	419	0	65	65	1.0000000
NODE_26900_length_585_cov_4.954733	147	227	0	80	80	1.0000000
NODE_26912_length_585_cov_3.751029	288	368	0	80	80	1.0000000
NODE_26912_length_585_cov_3.751029	341	421	0	80	80	1.0000000
NODE_27019_length_584_cov_21.657732	57	137	0	80	80	1.0000000
NODE_27019_length_584_cov_21.657732	110	190	0	80	80	1.0000000
NODE_27020_length_584_cov_11.915464	280	360	0	80	80	1.0000000
NODE_27020_length_584_cov_11.915464	333	413	0	80	80	1.0000000
NODE_27021_length_584_cov_11.197938	217	297	0	14	80	0.1750000
NODE_27021_length_584_cov_11.197938	217	297	4	47	80	0.5875000
NODE_27021_length_584_cov_11.197938	217	297	8	19	80	0.2375000
NODE_27021_length_584_cov_11.197938	270	350	4	17	80	0.2125000
NODE_27021_length_584_cov_11.197938	270	350	8	63	80	0.7875000
NODE_27022_length_584_cov_9.824742	375	441	0	41	66	0.6212121
NODE_27022_length_584_cov_9.824742	375	441	2	25	66	0.3787879
NODE_27022_length_584_cov_9.824742	375	441	0	41	66	0.6212121
NODE_27022_length_584_cov_9.824742	375	441	2	25	66	0.3787879
NODE_27023_length_584_cov_9.160825	369	449	0	80	80	1.0000000
NODE_27023_length_584_cov_9.160825	422	502	0	80	80	1.0000000
NODE_27023_length_584_cov_9.160825	422	502	0	80	80	1.0000000
NODE_27026_length_584_cov_7.736082	51	131	0	80	80	1.0000000
NODE_27026_length_584_cov_7.736082	104	184	0	80	80	1.0000000
NODE_27031_length_584_cov_7.113402	213	293	2	29	80	0.3625000
NODE_27031_length_584_cov_7.113402	213	293	4	51	80	0.6375000
NODE_27031_length_584_cov_7.113402	266	346	0	39	80	0.4875000
NODE_27031_length_584_cov_7.113402	266	346	2	41	80	0.5125000
NODE_27035_length_584_cov_5.843299	281	341	0	20	60	0.3333333
NODE_27035_length_584_cov_5.843299	281	341	10	6	60	0.1000000
NODE_27035_length_584_cov_5.843299	281	341	12	34	60	0.5666667
NODE_27039_length_584_cov_5.032990	240	320	0	35	80	0.4375000
NODE_27039_length_584_cov_5.032990	240	320	2	45	80	0.5625000
NODE_27039_length_584_cov_5.032990	293	373	0	12	80	0.1500000
NODE_27039_length_584_cov_5.032990	293	373	2	68	80	0.8500000
NODE_27061_length_584_cov_2.707216	186	257	0	71	71	1.0000000
NODE_27147_length_583_cov_7.973140	232	312	0	25	80	0.3125000
NODE_27147_length_583_cov_7.973140	232	312	2	55	80	0.6875000
NODE_27147_length_583_cov_7.973140	285	365	0	78	80	0.9750000
NODE_27147_length_583_cov_7.973140	285	365	2	2	80	0.0250000
NODE_27148_length_583_cov_6.731405	328	408	0	80	80	1.0000000
NODE_27148_length_583_cov_6.731405	381	461	0	80	80	1.0000000
NODE_27149_length_583_cov_6.363636	161	231	0	70	70	1.0000000
NODE_27152_length_583_cov_5.766529	132	186	0	54	54	1.0000000
NODE_27263_length_583_cov_0.762397	9	50	0	41	41	1.0000000
NODE_27278_length_582_cov_74.269151	295	375	0	60	80	0.7500000
NODE_27278_length_582_cov_74.269151	295	375	2	20	80	0.2500000
NODE_27278_length_582_cov_74.269151	348	428	0	7	80	0.0875000
NODE_27278_length_582_cov_74.269151	348	428	2	73	80	0.9125000
NODE_27279_length_582_cov_53.093168	11	91	0	80	80	1.0000000
NODE_27279_length_582_cov_53.093168	64	144	0	80	80	1.0000000
NODE_27279_length_582_cov_53.093168	140	220	0	80	80	1.0000000
NODE_27279_length_582_cov_53.093168	193	273	0	80	80	1.0000000
NODE_27280_length_582_cov_47.393375	345	425	0	7	80	0.0875000
NODE_27280_length_582_cov_47.393375	345	425	2	73	80	0.9125000
NODE_27280_length_582_cov_47.393375	398	478	0	16	80	0.2000000
NODE_27280_length_582_cov_47.393375	398	478	2	64	80	0.8000000
NODE_27281_length_582_cov_16.358178	297	377	0	51	80	0.6375000
NODE_27281_length_582_cov_16.358178	297	377	4	29	80	0.3625000
NODE_27281_length_582_cov_16.358178	350	431	4	81	81	1.0000000
NODE_27282_length_582_cov_14.107660	128	208	0	47	80	0.5875000
NODE_27282_length_582_cov_14.107660	128	208	2	33	80	0.4125000
NODE_27282_length_582_cov_14.107660	181	261	0	10	80	0.1250000
NODE_27282_length_582_cov_14.107660	181	261	2	70	80	0.8750000
NODE_27283_length_582_cov_7.923395	208	287	4	79	79	1.0000000
NODE_27283_length_582_cov_7.923395	262	340	0	34	78	0.4358974
NODE_27283_length_582_cov_7.923395	262	340	4	44	78	0.5641026
NODE_27284_length_582_cov_7.722567	216	296	0	80	80	1.0000000
NODE_27284_length_582_cov_7.722567	269	349	0	80	80	1.0000000
NODE_27289_length_582_cov_4.956522	294	325	0	31	31	1.0000000
NODE_27295_length_582_cov_4.308489	151	192	8	2	41	0.0487805
NODE_27295_length_582_cov_4.308489	151	192	10	39	41	0.9512195
NODE_27297_length_582_cov_3.838509	223	299	8	76	76	1.0000000
NODE_27297_length_582_cov_3.838509	272	354	0	28	82	0.3414634
NODE_27297_length_582_cov_3.838509	272	354	1	7	82	0.0853659
NODE_27297_length_582_cov_3.838509	272	354	2	1	82	0.0121951
NODE_27297_length_582_cov_3.838509	272	354	6	10	82	0.1219512
NODE_27297_length_582_cov_3.838509	272	354	8	36	82	0.4390244
NODE_27350_length_582_cov_1.650104	375	450	2	75	75	1.0000000
NODE_27405_length_581_cov_16.890041	244	316	0	72	72	1.0000000
NODE_27413_length_581_cov_6.340249	262	342	0	80	80	1.0000000
NODE_27413_length_581_cov_6.340249	315	395	0	80	80	1.0000000
NODE_27416_length_581_cov_5.827801	122	192	0	45	70	0.6428571
NODE_27416_length_581_cov_5.827801	122	192	2	25	70	0.3571429
NODE_27420_length_581_cov_5.072614	392	466	0	74	74	1.0000000
NODE_27420_length_581_cov_5.072614	424	444	0	20	20	1.0000000
NODE_27464_length_581_cov_1.881743	474	538	0	64	64	1.0000000
NODE_27541_length_580_cov_39.353430	358	438	0	44	80	0.5500000
NODE_27541_length_580_cov_39.353430	358	438	11	36	80	0.4500000
NODE_27541_length_580_cov_39.353430	411	491	11	29	80	0.3625000
NODE_27541_length_580_cov_39.353430	411	491	12	51	80	0.6375000
NODE_27541_length_580_cov_39.353430	487	567	0	17	80	0.2125000
NODE_27541_length_580_cov_39.353430	487	567	12	63	80	0.7875000
NODE_27541_length_580_cov_39.353430	487	567	0	17	80	0.2125000
NODE_27541_length_580_cov_39.353430	487	567	12	63	80	0.7875000
NODE_27541_length_580_cov_39.353430	487	567	0	17	80	0.2125000
NODE_27541_length_580_cov_39.353430	487	567	12	63	80	0.7875000
NODE_27541_length_580_cov_39.353430	487	567	0	17	80	0.2125000
NODE_27541_length_580_cov_39.353430	487	567	12	63	80	0.7875000
NODE_27541_length_580_cov_39.353430	487	567	0	17	80	0.2125000
NODE_27541_length_580_cov_39.353430	487	567	12	63	80	0.7875000
NODE_27541_length_580_cov_39.353430	487	567	0	17	80	0.2125000
NODE_27541_length_580_cov_39.353430	487	567	12	63	80	0.7875000
NODE_27544_length_580_cov_8.925156	198	238	0	40	40	1.0000000
NODE_27544_length_580_cov_8.925156	258	338	0	80	80	1.0000000
NODE_27545_length_580_cov_8.634096	197	277	0	30	80	0.3750000
NODE_27545_length_580_cov_8.634096	197	277	2	50	80	0.6250000
NODE_27545_length_580_cov_8.634096	250	330	0	75	80	0.9375000
NODE_27545_length_580_cov_8.634096	250	330	2	5	80	0.0625000
NODE_27551_length_580_cov_6.291060	356	398	0	42	42	1.0000000
NODE_27554_length_580_cov_5.494802	110	190	0	80	80	1.0000000
NODE_27554_length_580_cov_5.494802	163	243	0	80	80	1.0000000
NODE_27559_length_580_cov_4.563410	231	292	0	13	61	0.2131148
NODE_27559_length_580_cov_4.563410	231	292	4	1	61	0.0163934
NODE_27559_length_580_cov_4.563410	231	292	5	23	61	0.3770492
NODE_27559_length_580_cov_4.563410	231	292	6	24	61	0.3934426
NODE_27559_length_580_cov_4.563410	322	357	0	35	35	1.0000000
NODE_27590_length_580_cov_2.264033	215	277	0	62	62	1.0000000
NODE_27597_length_580_cov_2.116424	265	345	0	80	80	1.0000000
NODE_27659_length_579_cov_24.231250	159	239	2	9	80	0.1125000
NODE_27659_length_579_cov_24.231250	159	239	4	71	80	0.8875000
NODE_27659_length_579_cov_24.231250	212	287	0	38	75	0.5066667
NODE_27659_length_579_cov_24.231250	212	287	2	1	75	0.0133333
NODE_27659_length_579_cov_24.231250	212	287	4	36	75	0.4800000
NODE_27660_length_579_cov_12.602083	246	326	0	80	80	1.0000000
NODE_27660_length_579_cov_12.602083	299	377	0	78	78	1.0000000
NODE_27663_length_579_cov_9.195833	254	334	0	32	80	0.4000000
NODE_27663_length_579_cov_9.195833	254	334	2	4	80	0.0500000
NODE_27663_length_579_cov_9.195833	254	334	4	44	80	0.5500000
NODE_27663_length_579_cov_9.195833	307	387	0	6	80	0.0750000
NODE_27663_length_579_cov_9.195833	307	387	2	21	80	0.2625000
NODE_27663_length_579_cov_9.195833	307	387	4	53	80	0.6625000
NODE_27663_length_579_cov_9.195833	383	463	0	80	80	1.0000000
NODE_27664_length_579_cov_6.600000	169	249	0	80	80	1.0000000
NODE_27664_length_579_cov_6.600000	222	302	0	80	80	1.0000000
NODE_27667_length_579_cov_5.956250	225	295	2	6	70	0.0857143
NODE_27667_length_579_cov_5.956250	225	295	8	54	70	0.7714286
NODE_27667_length_579_cov_5.956250	225	295	10	10	70	0.1428571
NODE_27667_length_579_cov_5.956250	279	316	2	27	37	0.7297297
NODE_27667_length_579_cov_5.956250	279	316	8	10	37	0.2702703
NODE_27674_length_579_cov_4.850000	105	185	0	39	80	0.4875000
NODE_27674_length_579_cov_4.850000	105	185	2	41	80	0.5125000
NODE_27674_length_579_cov_4.850000	158	238	0	3	80	0.0375000
NODE_27674_length_579_cov_4.850000	158	238	2	77	80	0.9625000
NODE_27688_length_579_cov_3.291667	290	343	2	53	53	1.0000000
NODE_27695_length_579_cov_2.420833	251	331	0	80	80	1.0000000
NODE_27695_length_579_cov_2.420833	304	384	0	80	80	1.0000000
NODE_27724_length_579_cov_1.435417	463	497	0	34	34	1.0000000
NODE_27781_length_578_cov_70.192067	100	180	0	80	80	1.0000000
NODE_27781_length_578_cov_70.192067	153	233	0	80	80	1.0000000
NODE_27782_length_578_cov_51.676409	129	209	4	65	80	0.8125000
NODE_27782_length_578_cov_51.676409	129	209	7	1	80	0.0125000
NODE_27782_length_578_cov_51.676409	129	209	8	14	80	0.1750000
NODE_27782_length_578_cov_51.676409	182	262	0	31	80	0.3875000
NODE_27782_length_578_cov_51.676409	182	262	4	49	80	0.6125000
NODE_27783_length_578_cov_32.152401	310	390	4	80	80	1.0000000
NODE_27783_length_578_cov_32.152401	363	443	0	21	80	0.2625000
NODE_27783_length_578_cov_32.152401	363	443	3	3	80	0.0375000
NODE_27783_length_578_cov_32.152401	363	443	4	56	80	0.7000000
NODE_27784_length_578_cov_30.484342	215	295	0	80	80	1.0000000
NODE_27784_length_578_cov_30.484342	268	348	0	80	80	1.0000000
NODE_27785_length_578_cov_15.983299	213	265	0	52	52	1.0000000
NODE_27786_length_578_cov_14.968685	147	227	0	40	80	0.5000000
NODE_27786_length_578_cov_14.968685	147	227	2	40	80	0.5000000
NODE_27786_length_578_cov_14.968685	200	280	0	4	80	0.0500000
NODE_27786_length_578_cov_14.968685	200	280	2	76	80	0.9500000
NODE_27787_length_578_cov_9.567850	273	328	0	55	55	1.0000000
NODE_27792_length_578_cov_6.670146	273	353	0	80	80	1.0000000
NODE_27792_length_578_cov_6.670146	326	406	0	80	80	1.0000000
NODE_27793_length_578_cov_6.465553	320	400	0	80	80	1.0000000
NODE_27793_length_578_cov_6.465553	373	453	0	80	80	1.0000000
NODE_27863_length_578_cov_1.480167	185	265	0	57	80	0.7125000
NODE_27863_length_578_cov_1.480167	185	265	1	23	80	0.2875000
NODE_27863_length_578_cov_1.480167	238	318	0	4	80	0.0500000
NODE_27863_length_578_cov_1.480167	238	318	1	32	80	0.4000000
NODE_27863_length_578_cov_1.480167	238	318	3	9	80	0.1125000
NODE_27863_length_578_cov_1.480167	238	318	4	35	80	0.4375000
NODE_27935_length_577_cov_11.638075	312	392	0	80	80	1.0000000
NODE_27942_length_577_cov_4.912134	218	249	8	31	31	1.0000000
NODE_27942_length_577_cov_4.912134	301	330	0	17	29	0.5862069
NODE_27942_length_577_cov_4.912134	301	330	1	1	29	0.0344828
NODE_27942_length_577_cov_4.912134	301	330	2	11	29	0.3793103
NODE_27961_length_577_cov_2.970711	78	126	10	48	48	1.0000000
NODE_27968_length_577_cov_2.631799	169	253	22	13	84	0.1547619
NODE_27968_length_577_cov_2.631799	169	253	23	1	84	0.0119048
NODE_27968_length_577_cov_2.631799	169	253	24	17	84	0.2023810
NODE_27968_length_577_cov_2.631799	169	253	25	2	84	0.0238095
NODE_27968_length_577_cov_2.631799	169	253	26	11	84	0.1309524
NODE_27968_length_577_cov_2.631799	169	253	27	10	84	0.1190476
NODE_27968_length_577_cov_2.631799	169	253	28	4	84	0.0476190
NODE_27968_length_577_cov_2.631799	169	253	29	13	84	0.1547619
NODE_27968_length_577_cov_2.631799	169	253	30	3	84	0.0357143
NODE_27968_length_577_cov_2.631799	169	253	31	9	84	0.1071429
NODE_27968_length_577_cov_2.631799	169	253	33	1	84	0.0119048
NODE_27968_length_577_cov_2.631799	226	269	22	29	43	0.6744186
NODE_27968_length_577_cov_2.631799	226	269	26	3	43	0.0697674
NODE_27968_length_577_cov_2.631799	226	269	27	8	43	0.1860465
NODE_27968_length_577_cov_2.631799	226	269	29	3	43	0.0697674
NODE_28003_length_577_cov_1.468619	71	146	0	75	75	1.0000000
NODE_28003_length_577_cov_1.468619	119	199	0	80	80	1.0000000
NODE_28058_length_576_cov_10.903564	194	274	2	2	80	0.0250000
NODE_28058_length_576_cov_10.903564	194	274	4	49	80	0.6125000
NODE_28058_length_576_cov_10.903564	194	274	6	29	80	0.3625000
NODE_28059_length_576_cov_9.039832	271	351	0	80	80	1.0000000
NODE_28059_length_576_cov_9.039832	324	404	0	80	80	1.0000000
NODE_28060_length_576_cov_8.490566	338	418	0	80	80	1.0000000
NODE_28060_length_576_cov_8.490566	391	471	0	80	80	1.0000000
NODE_28061_length_576_cov_7.002096	157	237	0	80	80	1.0000000
NODE_28061_length_576_cov_7.002096	210	290	0	80	80	1.0000000
NODE_28076_length_576_cov_3.322851	118	183	0	1	65	0.0153846
NODE_28076_length_576_cov_3.322851	118	183	2	64	65	0.9846154
NODE_28102_length_576_cov_1.964361	148	228	0	80	80	1.0000000
NODE_28102_length_576_cov_1.964361	201	281	0	80	80	1.0000000
NODE_28104_length_576_cov_1.951782	159	239	0	80	80	1.0000000
NODE_28104_length_576_cov_1.951782	212	292	0	65	80	0.8125000
NODE_28104_length_576_cov_1.951782	212	292	1	6	80	0.0750000
NODE_28104_length_576_cov_1.951782	212	292	2	9	80	0.1125000
NODE_28116_length_576_cov_1.584906	381	455	0	74	74	1.0000000
NODE_28179_length_575_cov_15.319328	319	399	0	19	80	0.2375000
NODE_28179_length_575_cov_15.319328	319	399	2	61	80	0.7625000
NODE_28179_length_575_cov_15.319328	372	452	0	40	80	0.5000000
NODE_28179_length_575_cov_15.319328	372	452	2	40	80	0.5000000
NODE_28181_length_575_cov_8.254202	286	366	0	27	80	0.3375000
NODE_28181_length_575_cov_8.254202	286	366	2	53	80	0.6625000
NODE_28181_length_575_cov_8.254202	339	419	0	80	80	1.0000000
NODE_28182_length_575_cov_7.558824	300	380	0	51	80	0.6375000
NODE_28182_length_575_cov_7.558824	300	380	2	29	80	0.3625000
NODE_28313_length_574_cov_6.282105	185	265	0	17	80	0.2125000
NODE_28313_length_574_cov_6.282105	185	265	2	63	80	0.7875000
NODE_28313_length_574_cov_6.282105	238	318	0	70	80	0.8750000
NODE_28313_length_574_cov_6.282105	238	318	2	10	80	0.1250000
NODE_28330_length_574_cov_2.993684	215	234	0	19	19	1.0000000
NODE_28438_length_573_cov_53.668776	393	473	0	80	80	1.0000000
NODE_28438_length_573_cov_53.668776	446	526	0	80	80	1.0000000
NODE_28439_length_573_cov_30.658228	451	531	4	7	80	0.0875000
NODE_28439_length_573_cov_30.658228	451	531	6	8	80	0.1000000
NODE_28439_length_573_cov_30.658228	451	531	7	12	80	0.1500000
NODE_28439_length_573_cov_30.658228	451	531	8	27	80	0.3375000
NODE_28439_length_573_cov_30.658228	451	531	10	23	80	0.2875000
NODE_28439_length_573_cov_30.658228	451	531	12	3	80	0.0375000
NODE_28440_length_573_cov_30.116034	435	515	18	3	80	0.0375000
NODE_28440_length_573_cov_30.116034	435	515	20	5	80	0.0625000
NODE_28440_length_573_cov_30.116034	435	515	22	2	80	0.0250000
NODE_28440_length_573_cov_30.116034	435	515	24	6	80	0.0750000
NODE_28440_length_573_cov_30.116034	435	515	26	6	80	0.0750000
NODE_28440_length_573_cov_30.116034	435	515	28	2	80	0.0250000
NODE_28440_length_573_cov_30.116034	435	515	30	2	80	0.0250000
NODE_28440_length_573_cov_30.116034	435	515	31	1	80	0.0125000
NODE_28440_length_573_cov_30.116034	435	515	32	14	80	0.1750000
NODE_28440_length_573_cov_30.116034	435	515	34	12	80	0.1500000
NODE_28440_length_573_cov_30.116034	435	515	35	12	80	0.1500000
NODE_28440_length_573_cov_30.116034	435	515	36	5	80	0.0625000
NODE_28440_length_573_cov_30.116034	435	515	37	5	80	0.0625000
NODE_28440_length_573_cov_30.116034	435	515	38	5	80	0.0625000
NODE_28440_length_573_cov_30.116034	488	568	8	2	80	0.0250000
NODE_28440_length_573_cov_30.116034	488	568	10	6	80	0.0750000
NODE_28440_length_573_cov_30.116034	488	568	12	3	80	0.0375000
NODE_28440_length_573_cov_30.116034	488	568	16	5	80	0.0625000
NODE_28440_length_573_cov_30.116034	488	568	18	4	80	0.0500000
NODE_28440_length_573_cov_30.116034	488	568	24	5	80	0.0625000
NODE_28440_length_573_cov_30.116034	488	568	26	1	80	0.0125000
NODE_28440_length_573_cov_30.116034	488	568	28	11	80	0.1375000
NODE_28440_length_573_cov_30.116034	488	568	30	12	80	0.1500000
NODE_28440_length_573_cov_30.116034	488	568	32	18	80	0.2250000
NODE_28440_length_573_cov_30.116034	488	568	34	11	80	0.1375000
NODE_28440_length_573_cov_30.116034	488	568	35	2	80	0.0250000
NODE_28441_length_573_cov_24.234177	210	290	0	71	80	0.8875000
NODE_28441_length_573_cov_24.234177	210	290	2	9	80	0.1125000
NODE_28441_length_573_cov_24.234177	263	343	0	18	80	0.2250000
NODE_28441_length_573_cov_24.234177	263	343	2	62	80	0.7750000
NODE_28442_length_573_cov_13.464135	278	358	0	80	80	1.0000000
NODE_28442_length_573_cov_13.464135	331	411	0	80	80	1.0000000
NODE_28443_length_573_cov_8.761603	124	204	2	14	80	0.1750000
NODE_28443_length_573_cov_8.761603	124	204	4	1	80	0.0125000
NODE_28443_length_573_cov_8.761603	124	204	6	16	80	0.2000000
NODE_28443_length_573_cov_8.761603	124	204	8	49	80	0.6125000
NODE_28443_length_573_cov_8.761603	177	257	0	30	80	0.3750000
NODE_28443_length_573_cov_8.761603	177	257	2	37	80	0.4625000
NODE_28443_length_573_cov_8.761603	177	257	4	1	80	0.0125000
NODE_28443_length_573_cov_8.761603	177	257	6	10	80	0.1250000
NODE_28443_length_573_cov_8.761603	177	257	8	2	80	0.0250000
NODE_28456_length_573_cov_3.364979	365	398	17	33	33	1.0000000
NODE_28565_length_572_cov_17.530655	312	392	0	80	80	1.0000000
NODE_28565_length_572_cov_17.530655	365	445	0	80	80	1.0000000
NODE_28567_length_572_cov_8.059197	250	321	0	71	71	1.0000000
NODE_28568_length_572_cov_7.873150	134	214	0	80	80	1.0000000
NODE_28568_length_572_cov_7.873150	187	267	0	80	80	1.0000000
NODE_28570_length_572_cov_6.706131	365	445	0	80	80	1.0000000
NODE_28570_length_572_cov_6.706131	418	498	0	80	80	1.0000000
NODE_28573_length_572_cov_5.625793	137	217	0	1	80	0.0125000
NODE_28573_length_572_cov_5.625793	137	217	2	79	80	0.9875000
NODE_28573_length_572_cov_5.625793	190	270	0	54	80	0.6750000
NODE_28573_length_572_cov_5.625793	190	270	2	26	80	0.3250000
NODE_28574_length_572_cov_5.617336	331	401	0	27	70	0.3857143
NODE_28574_length_572_cov_5.617336	331	401	4	19	70	0.2714286
NODE_28574_length_572_cov_5.617336	331	401	6	12	70	0.1714286
NODE_28574_length_572_cov_5.617336	331	401	8	2	70	0.0285714
NODE_28574_length_572_cov_5.617336	331	401	10	10	70	0.1428571
NODE_28578_length_572_cov_4.596195	212	288	2	76	76	1.0000000
NODE_28578_length_572_cov_4.596195	261	341	0	6	80	0.0750000
NODE_28578_length_572_cov_4.596195	261	341	2	74	80	0.9250000
NODE_28585_length_572_cov_3.843552	210	290	6	28	80	0.3500000
NODE_28585_length_572_cov_3.843552	210	290	8	4	80	0.0500000
NODE_28585_length_572_cov_3.843552	210	290	9	2	80	0.0250000
NODE_28585_length_572_cov_3.843552	210	290	10	14	80	0.1750000
NODE_28585_length_572_cov_3.843552	210	290	11	16	80	0.2000000
NODE_28585_length_572_cov_3.843552	210	290	13	16	80	0.2000000
NODE_28585_length_572_cov_3.843552	263	343	8	4	80	0.0500000
NODE_28585_length_572_cov_3.843552	263	343	10	3	80	0.0375000
NODE_28585_length_572_cov_3.843552	263	343	11	11	80	0.1375000
NODE_28585_length_572_cov_3.843552	263	343	12	17	80	0.2125000
NODE_28585_length_572_cov_3.843552	263	343	13	36	80	0.4500000
NODE_28585_length_572_cov_3.843552	263	343	14	9	80	0.1125000
NODE_28621_length_572_cov_2.319239	357	431	0	31	74	0.4189189
NODE_28621_length_572_cov_2.319239	357	431	5	1	74	0.0135135
NODE_28621_length_572_cov_2.319239	357	431	6	42	74	0.5675676
NODE_28621_length_572_cov_2.319239	410	478	0	1	68	0.0147059
NODE_28621_length_572_cov_2.319239	410	478	5	1	68	0.0147059
NODE_28621_length_572_cov_2.319239	410	478	6	66	68	0.9705882
NODE_28625_length_572_cov_2.107822	184	254	0	70	70	1.0000000
NODE_28625_length_572_cov_2.107822	415	493	0	78	78	1.0000000
NODE_28631_length_572_cov_1.947146	327	363	0	36	36	1.0000000
NODE_28631_length_572_cov_1.947146	328	354	0	26	26	1.0000000
NODE_28700_length_571_cov_14.262712	237	317	0	80	80	1.0000000
NODE_28700_length_571_cov_14.262712	290	370	0	80	80	1.0000000
NODE_28717_length_571_cov_4.033898	154	234	0	30	80	0.3750000
NODE_28717_length_571_cov_4.033898	154	234	1	15	80	0.1875000
NODE_28717_length_571_cov_4.033898	154	234	2	35	80	0.4375000
NODE_28717_length_571_cov_4.033898	207	273	2	66	66	1.0000000
NODE_28809_length_570_cov_28.269639	487	559	13	12	72	0.1666667
NODE_28809_length_570_cov_28.269639	487	559	15	6	72	0.0833333
NODE_28809_length_570_cov_28.269639	487	559	17	7	72	0.0972222
NODE_28809_length_570_cov_28.269639	487	559	21	1	72	0.0138889
NODE_28809_length_570_cov_28.269639	487	559	23	7	72	0.0972222
NODE_28809_length_570_cov_28.269639	487	559	27	33	72	0.4583333
NODE_28809_length_570_cov_28.269639	487	559	28	3	72	0.0416667
NODE_28809_length_570_cov_28.269639	487	559	30	3	72	0.0416667
NODE_28812_length_570_cov_10.161359	167	247	2	76	80	0.9500000
NODE_28812_length_570_cov_10.161359	167	247	4	4	80	0.0500000
NODE_28812_length_570_cov_10.161359	220	256	2	33	36	0.9166667
NODE_28812_length_570_cov_10.161359	220	256	4	3	36	0.0833333
NODE_28819_length_570_cov_5.010616	179	216	4	37	37	1.0000000
NODE_28819_length_570_cov_5.010616	189	269	4	80	80	1.0000000
NODE_28828_length_570_cov_3.898089	236	316	0	80	80	1.0000000
NODE_28828_length_570_cov_3.898089	289	369	0	80	80	1.0000000
NODE_28840_length_570_cov_2.938429	202	280	0	16	78	0.2051282
NODE_28840_length_570_cov_2.938429	202	280	2	39	78	0.5000000
NODE_28840_length_570_cov_2.938429	202	280	4	1	78	0.0128205
NODE_28840_length_570_cov_2.938429	202	280	5	14	78	0.1794872
NODE_28840_length_570_cov_2.938429	202	280	6	8	78	0.1025641
NODE_28840_length_570_cov_2.938429	262	333	0	69	71	0.9718310
NODE_28840_length_570_cov_2.938429	262	333	2	2	71	0.0281690
NODE_28842_length_570_cov_2.891720	204	260	0	56	56	1.0000000
NODE_28950_length_569_cov_20.559574	275	355	0	80	80	1.0000000
NODE_28950_length_569_cov_20.559574	328	408	0	80	80	1.0000000
NODE_28951_length_569_cov_15.282979	272	352	0	15	80	0.1875000
NODE_28951_length_569_cov_15.282979	272	352	2	65	80	0.8125000
NODE_28951_length_569_cov_15.282979	325	405	0	68	80	0.8500000
NODE_28951_length_569_cov_15.282979	325	405	2	12	80	0.1500000
NODE_28952_length_569_cov_11.023404	280	360	0	6	80	0.0750000
NODE_28952_length_569_cov_11.023404	280	360	4	74	80	0.9250000
NODE_28952_length_569_cov_11.023404	333	413	0	59	80	0.7375000
NODE_28952_length_569_cov_11.023404	333	413	4	21	80	0.2625000
NODE_28953_length_569_cov_9.310638	231	277	8	5	46	0.1086956
NODE_28953_length_569_cov_9.310638	231	277	10	41	46	0.8913044
NODE_28956_length_569_cov_6.989362	258	338	5	5	80	0.0625000
NODE_28956_length_569_cov_6.989362	258	338	8	3	80	0.0375000
NODE_28956_length_569_cov_6.989362	258	338	10	5	80	0.0625000
NODE_28956_length_569_cov_6.989362	258	338	12	3	80	0.0375000
NODE_28956_length_569_cov_6.989362	258	338	14	1	80	0.0125000
NODE_28956_length_569_cov_6.989362	258	338	15	46	80	0.5750000
NODE_28956_length_569_cov_6.989362	258	338	16	17	80	0.2125000
NODE_28956_length_569_cov_6.989362	294	329	10	4	35	0.1142857
NODE_28956_length_569_cov_6.989362	294	329	12	3	35	0.0857143
NODE_28956_length_569_cov_6.989362	294	329	14	1	35	0.0285714
NODE_28956_length_569_cov_6.989362	294	329	15	27	35	0.7714286
NODE_28956_length_569_cov_6.989362	296	338	5	5	42	0.1190476
NODE_28956_length_569_cov_6.989362	296	338	8	3	42	0.0714286
NODE_28956_length_569_cov_6.989362	296	338	10	5	42	0.1190476
NODE_28956_length_569_cov_6.989362	296	338	12	3	42	0.0714286
NODE_28956_length_569_cov_6.989362	296	338	14	1	42	0.0238095
NODE_28956_length_569_cov_6.989362	296	338	15	25	42	0.5952381
NODE_28957_length_569_cov_6.978723	264	344	0	59	80	0.7375000
NODE_28957_length_569_cov_6.978723	264	344	1	21	80	0.2625000
NODE_28957_length_569_cov_6.978723	317	397	0	6	80	0.0750000
NODE_28957_length_569_cov_6.978723	317	397	1	58	80	0.7250000
NODE_28957_length_569_cov_6.978723	317	397	2	16	80	0.2000000
NODE_28960_length_569_cov_6.434043	228	308	0	80	80	1.0000000
NODE_28973_length_569_cov_3.353191	340	419	0	79	79	1.0000000
NODE_28981_length_569_cov_3.027660	277	348	0	5	71	0.0704225
NODE_28981_length_569_cov_3.027660	277	348	2	66	71	0.9295775
NODE_29072_length_568_cov_59.729211	124	204	10	80	80	1.0000000
NODE_29072_length_568_cov_59.729211	177	257	0	30	80	0.3750000
NODE_29072_length_568_cov_59.729211	177	257	10	50	80	0.6250000
NODE_29075_length_568_cov_7.763326	215	294	0	79	79	1.0000000
NODE_29075_length_568_cov_7.763326	267	347	0	80	80	1.0000000
NODE_29078_length_568_cov_6.257996	397	471	0	74	74	1.0000000
NODE_29091_length_568_cov_3.748401	170	236	0	66	66	1.0000000
NODE_29091_length_568_cov_3.748401	262	311	0	49	49	1.0000000
NODE_29133_length_568_cov_1.769723	192	233	0	41	41	1.0000000
NODE_29160_length_568_cov_1.358209	355	432	0	7	77	0.0909091
NODE_29160_length_568_cov_1.358209	355	432	2	5	77	0.0649351
NODE_29160_length_568_cov_1.358209	355	432	4	54	77	0.7012987
NODE_29160_length_568_cov_1.358209	355	432	6	11	77	0.1428571
NODE_29182_length_568_cov_1.038380	195	275	0	80	80	1.0000000
NODE_29216_length_567_cov_21.155983	347	427	0	80	80	1.0000000
NODE_29216_length_567_cov_21.155983	400	480	0	80	80	1.0000000
NODE_29217_length_567_cov_18.292735	367	447	0	80	80	1.0000000
NODE_29217_length_567_cov_18.292735	420	500	0	80	80	1.0000000
NODE_29218_length_567_cov_17.579060	259	339	0	80	80	1.0000000
NODE_29218_length_567_cov_17.579060	312	392	0	80	80	1.0000000
NODE_29220_length_567_cov_15.457265	276	356	1	7	80	0.0875000
NODE_29220_length_567_cov_15.457265	276	356	3	13	80	0.1625000
NODE_29220_length_567_cov_15.457265	276	356	10	60	80	0.7500000
NODE_29220_length_567_cov_15.457265	329	409	0	10	80	0.1250000
NODE_29220_length_567_cov_15.457265	329	409	1	50	80	0.6250000
NODE_29220_length_567_cov_15.457265	329	409	3	13	80	0.1625000
NODE_29220_length_567_cov_15.457265	329	409	10	7	80	0.0875000
NODE_29221_length_567_cov_14.393162	270	350	0	80	80	1.0000000
NODE_29221_length_567_cov_14.393162	323	403	0	80	80	1.0000000
NODE_29225_length_567_cov_6.611111	356	436	2	57	80	0.7125000
NODE_29225_length_567_cov_6.611111	356	436	4	23	80	0.2875000
NODE_29225_length_567_cov_6.611111	409	489	0	22	80	0.2750000
NODE_29225_length_567_cov_6.611111	409	489	2	58	80	0.7250000
NODE_29245_length_567_cov_2.884615	204	284	0	49	80	0.6125000
NODE_29245_length_567_cov_2.884615	204	284	2	31	80	0.3875000
NODE_29245_length_567_cov_2.884615	204	254	0	49	50	0.9800000
NODE_29245_length_567_cov_2.884615	204	254	2	1	50	0.0200000
NODE_29245_length_567_cov_2.884615	266	297	2	31	31	1.0000000
NODE_29363_length_566_cov_47.747323	157	237	0	33	80	0.4125000
NODE_29363_length_566_cov_47.747323	157	237	2	47	80	0.5875000
NODE_29363_length_566_cov_47.747323	210	290	0	28	80	0.3500000
NODE_29363_length_566_cov_47.747323	210	290	2	52	80	0.6500000
NODE_29364_length_566_cov_44.824411	14	94	8	1	80	0.0125000
NODE_29364_length_566_cov_44.824411	14	94	14	2	80	0.0250000
NODE_29364_length_566_cov_44.824411	14	94	15	2	80	0.0250000
NODE_29364_length_566_cov_44.824411	14	94	16	1	80	0.0125000
NODE_29364_length_566_cov_44.824411	14	94	18	5	80	0.0625000
NODE_29364_length_566_cov_44.824411	14	94	20	1	80	0.0125000
NODE_29364_length_566_cov_44.824411	14	94	22	2	80	0.0250000
NODE_29364_length_566_cov_44.824411	14	94	26	1	80	0.0125000
NODE_29364_length_566_cov_44.824411	14	94	30	1	80	0.0125000
NODE_29364_length_566_cov_44.824411	14	94	32	3	80	0.0375000
NODE_29364_length_566_cov_44.824411	14	94	34	3	80	0.0375000
NODE_29364_length_566_cov_44.824411	14	94	36	1	80	0.0125000
NODE_29364_length_566_cov_44.824411	14	94	39	1	80	0.0125000
NODE_29364_length_566_cov_44.824411	14	94	40	5	80	0.0625000
NODE_29364_length_566_cov_44.824411	14	94	42	4	80	0.0500000
NODE_29364_length_566_cov_44.824411	14	94	46	1	80	0.0125000
NODE_29364_length_566_cov_44.824411	14	94	48	4	80	0.0500000
NODE_29364_length_566_cov_44.824411	14	94	50	1	80	0.0125000
NODE_29364_length_566_cov_44.824411	14	94	52	41	80	0.5125000
NODE_29364_length_566_cov_44.824411	15	94	14	2	79	0.0253165
NODE_29364_length_566_cov_44.824411	15	94	15	2	79	0.0253165
NODE_29364_length_566_cov_44.824411	15	94	16	1	79	0.0126582
NODE_29364_length_566_cov_44.824411	15	94	18	5	79	0.0632911
NODE_29364_length_566_cov_44.824411	15	94	20	1	79	0.0126582
NODE_29364_length_566_cov_44.824411	15	94	22	2	79	0.0253165
NODE_29364_length_566_cov_44.824411	15	94	26	1	79	0.0126582
NODE_29364_length_566_cov_44.824411	15	94	30	1	79	0.0126582
NODE_29364_length_566_cov_44.824411	15	94	32	3	79	0.0379747
NODE_29364_length_566_cov_44.824411	15	94	34	3	79	0.0379747
NODE_29364_length_566_cov_44.824411	15	94	36	1	79	0.0126582
NODE_29364_length_566_cov_44.824411	15	94	39	1	79	0.0126582
NODE_29364_length_566_cov_44.824411	15	94	40	5	79	0.0632911
NODE_29364_length_566_cov_44.824411	15	94	42	4	79	0.0506329
NODE_29364_length_566_cov_44.824411	15	94	46	1	79	0.0126582
NODE_29364_length_566_cov_44.824411	15	94	48	4	79	0.0506329
NODE_29364_length_566_cov_44.824411	15	94	50	1	79	0.0126582
NODE_29364_length_566_cov_44.824411	15	94	52	41	79	0.5189874
NODE_29364_length_566_cov_44.824411	67	147	9	3	80	0.0375000
NODE_29364_length_566_cov_44.824411	67	147	10	2	80	0.0250000
NODE_29364_length_566_cov_44.824411	67	147	11	2	80	0.0250000
NODE_29364_length_566_cov_44.824411	67	147	16	1	80	0.0125000
NODE_29364_length_566_cov_44.824411	67	147	18	2	80	0.0250000
NODE_29364_length_566_cov_44.824411	67	147	20	1	80	0.0125000
NODE_29364_length_566_cov_44.824411	67	147	24	1	80	0.0125000
NODE_29364_length_566_cov_44.824411	67	147	26	1	80	0.0125000
NODE_29364_length_566_cov_44.824411	67	147	30	1	80	0.0125000
NODE_29364_length_566_cov_44.824411	67	147	32	6	80	0.0750000
NODE_29364_length_566_cov_44.824411	67	147	34	1	80	0.0125000
NODE_29364_length_566_cov_44.824411	67	147	36	1	80	0.0125000
NODE_29364_length_566_cov_44.824411	67	147	40	4	80	0.0500000
NODE_29364_length_566_cov_44.824411	67	147	42	2	80	0.0250000
NODE_29364_length_566_cov_44.824411	67	147	44	2	80	0.0250000
NODE_29364_length_566_cov_44.824411	67	147	51	1	80	0.0125000
NODE_29364_length_566_cov_44.824411	67	147	52	49	80	0.6125000
NODE_29364_length_566_cov_44.824411	67	147	9	3	80	0.0375000
NODE_29364_length_566_cov_44.824411	67	147	10	2	80	0.0250000
NODE_29364_length_566_cov_44.824411	67	147	11	2	80	0.0250000
NODE_29364_length_566_cov_44.824411	67	147	16	1	80	0.0125000
NODE_29364_length_566_cov_44.824411	67	147	18	2	80	0.0250000
NODE_29364_length_566_cov_44.824411	67	147	20	1	80	0.0125000
NODE_29364_length_566_cov_44.824411	67	147	24	1	80	0.0125000
NODE_29364_length_566_cov_44.824411	67	147	26	1	80	0.0125000
NODE_29364_length_566_cov_44.824411	67	147	30	1	80	0.0125000
NODE_29364_length_566_cov_44.824411	67	147	32	6	80	0.0750000
NODE_29364_length_566_cov_44.824411	67	147	34	1	80	0.0125000
NODE_29364_length_566_cov_44.824411	67	147	36	1	80	0.0125000
NODE_29364_length_566_cov_44.824411	67	147	40	4	80	0.0500000
NODE_29364_length_566_cov_44.824411	67	147	42	2	80	0.0250000
NODE_29364_length_566_cov_44.824411	67	147	44	2	80	0.0250000
NODE_29364_length_566_cov_44.824411	67	147	51	1	80	0.0125000
NODE_29364_length_566_cov_44.824411	67	147	52	49	80	0.6125000
NODE_29364_length_566_cov_44.824411	77	147	9	3	70	0.0428571
NODE_29364_length_566_cov_44.824411	77	147	10	2	70	0.0285714
NODE_29364_length_566_cov_44.824411	77	147	11	2	70	0.0285714
NODE_29364_length_566_cov_44.824411	77	147	16	1	70	0.0142857
NODE_29364_length_566_cov_44.824411	77	147	18	2	70	0.0285714
NODE_29364_length_566_cov_44.824411	77	147	20	1	70	0.0142857
NODE_29364_length_566_cov_44.824411	77	147	24	1	70	0.0142857
NODE_29364_length_566_cov_44.824411	77	147	26	1	70	0.0142857
NODE_29364_length_566_cov_44.824411	77	147	30	1	70	0.0142857
NODE_29364_length_566_cov_44.824411	77	147	32	6	70	0.0857143
NODE_29364_length_566_cov_44.824411	77	147	34	1	70	0.0142857
NODE_29364_length_566_cov_44.824411	77	147	36	1	70	0.0142857
NODE_29364_length_566_cov_44.824411	77	147	40	4	70	0.0571429
NODE_29364_length_566_cov_44.824411	77	147	42	2	70	0.0285714
NODE_29364_length_566_cov_44.824411	77	147	44	2	70	0.0285714
NODE_29364_length_566_cov_44.824411	77	147	51	1	70	0.0142857
NODE_29364_length_566_cov_44.824411	77	147	52	39	70	0.5571429
NODE_29364_length_566_cov_44.824411	143	223	0	65	80	0.8125000
NODE_29364_length_566_cov_44.824411	143	223	4	6	80	0.0750000
NODE_29364_length_566_cov_44.824411	143	223	6	3	80	0.0375000
NODE_29364_length_566_cov_44.824411	143	223	9	5	80	0.0625000
NODE_29364_length_566_cov_44.824411	143	223	10	1	80	0.0125000
NODE_29364_length_566_cov_44.824411	196	276	0	80	80	1.0000000
NODE_29367_length_566_cov_18.494647	344	424	0	40	80	0.5000000
NODE_29367_length_566_cov_18.494647	344	424	2	40	80	0.5000000
NODE_29367_length_566_cov_18.494647	397	477	0	80	80	1.0000000
NODE_29368_length_566_cov_17.537473	324	404	0	22	80	0.2750000
NODE_29368_length_566_cov_17.537473	324	404	2	34	80	0.4250000
NODE_29368_length_566_cov_17.537473	324	404	4	24	80	0.3000000
NODE_29368_length_566_cov_17.537473	377	457	2	9	80	0.1125000
NODE_29368_length_566_cov_17.537473	377	457	4	71	80	0.8875000
NODE_29369_length_566_cov_13.019272	157	237	0	80	80	1.0000000
NODE_29369_length_566_cov_13.019272	210	290	0	80	80	1.0000000
NODE_29371_length_566_cov_9.513919	191	279	1	88	88	1.0000000
NODE_29371_length_566_cov_9.513919	252	332	0	47	80	0.5875000
NODE_29371_length_566_cov_9.513919	252	332	1	33	80	0.4125000
NODE_29397_length_566_cov_3.239829	292	334	0	42	42	1.0000000
NODE_29397_length_566_cov_3.239829	351	375	0	24	24	1.0000000
NODE_29437_length_566_cov_1.698073	432	481	0	49	49	1.0000000
NODE_29472_length_566_cov_0.957173	378	405	0	27	27	1.0000000
NODE_29503_length_565_cov_10.508584	202	280	0	78	78	1.0000000
NODE_29503_length_565_cov_10.508584	253	334	0	81	81	1.0000000
NODE_29509_length_565_cov_7.560086	170	246	2	23	76	0.3026316
NODE_29509_length_565_cov_7.560086	170	246	4	14	76	0.1842105
NODE_29509_length_565_cov_7.560086	170	246	6	39	76	0.5131579
NODE_29520_length_565_cov_4.045064	231	311	0	4	80	0.0500000
NODE_29520_length_565_cov_4.045064	231	311	2	76	80	0.9500000
NODE_29520_length_565_cov_4.045064	284	364	0	47	80	0.5875000
NODE_29520_length_565_cov_4.045064	284	364	2	33	80	0.4125000
NODE_29528_length_565_cov_3.399142	161	241	7	61	80	0.7625000
NODE_29528_length_565_cov_3.399142	161	241	8	19	80	0.2375000
NODE_29528_length_565_cov_3.399142	214	294	7	80	80	1.0000000
NODE_29542_length_565_cov_2.542918	302	382	0	80	80	1.0000000
NODE_29542_length_565_cov_2.542918	355	435	0	80	80	1.0000000
NODE_29650_length_564_cov_46.901075	129	209	0	80	80	1.0000000
NODE_29650_length_564_cov_46.901075	182	262	0	80	80	1.0000000
NODE_29651_length_564_cov_13.520430	300	380	0	80	80	1.0000000
NODE_29651_length_564_cov_13.520430	353	433	0	80	80	1.0000000
NODE_29653_length_564_cov_7.965591	291	332	0	41	41	1.0000000
NODE_29796_length_563_cov_24.487069	97	177	0	80	80	1.0000000
NODE_29796_length_563_cov_24.487069	150	230	0	80	80	1.0000000
NODE_29800_length_563_cov_6.758621	301	367	4	13	66	0.1969697
NODE_29800_length_563_cov_6.758621	301	367	6	13	66	0.1969697
NODE_29800_length_563_cov_6.758621	301	367	7	1	66	0.0151515
NODE_29800_length_563_cov_6.758621	301	367	11	6	66	0.0909091
NODE_29800_length_563_cov_6.758621	301	367	12	7	66	0.1060606
NODE_29800_length_563_cov_6.758621	301	367	14	5	66	0.0757576
NODE_29800_length_563_cov_6.758621	301	367	16	2	66	0.0303030
NODE_29800_length_563_cov_6.758621	301	367	18	19	66	0.2878788
NODE_29800_length_563_cov_6.758621	378	422	4	39	44	0.8863636
NODE_29800_length_563_cov_6.758621	378	422	6	5	44	0.1136364
NODE_29802_length_563_cov_5.762931	48	135	0	87	87	1.0000000
NODE_29802_length_563_cov_5.762931	108	188	0	80	80	1.0000000
NODE_29808_length_563_cov_4.176724	197	277	0	80	80	1.0000000
NODE_29808_length_563_cov_4.176724	250	330	0	80	80	1.0000000
NODE_29809_length_563_cov_4.155172	273	315	3	5	42	0.1190476
NODE_29809_length_563_cov_4.155172	273	315	4	37	42	0.8809524
NODE_29809_length_563_cov_4.155172	288	358	0	22	70	0.3142857
NODE_29809_length_563_cov_4.155172	288	358	2	21	70	0.3000000
NODE_29809_length_563_cov_4.155172	288	358	3	5	70	0.0714286
NODE_29809_length_563_cov_4.155172	288	358	4	22	70	0.3142857
NODE_29925_length_562_cov_31.194384	47	127	0	34	80	0.4250000
NODE_29925_length_562_cov_31.194384	47	127	4	39	80	0.4875000
NODE_29925_length_562_cov_31.194384	47	127	6	7	80	0.0875000
NODE_29925_length_562_cov_31.194384	100	180	4	41	80	0.5125000
NODE_29925_length_562_cov_31.194384	100	180	6	11	80	0.1375000
NODE_29925_length_562_cov_31.194384	100	180	8	28	80	0.3500000
NODE_29926_length_562_cov_29.857451	33	113	0	20	80	0.2500000
NODE_29926_length_562_cov_29.857451	33	113	2	60	80	0.7500000
NODE_29926_length_562_cov_29.857451	86	166	0	73	80	0.9125000
NODE_29926_length_562_cov_29.857451	86	166	2	7	80	0.0875000
NODE_29927_length_562_cov_23.194384	245	325	0	80	80	1.0000000
NODE_29927_length_562_cov_23.194384	298	378	0	80	80	1.0000000
NODE_29930_length_562_cov_10.304536	271	321	0	50	50	1.0000000
NODE_29931_length_562_cov_9.131749	265	346	0	24	81	0.2962963
NODE_29931_length_562_cov_9.131749	265	346	4	57	81	0.7037037
NODE_29931_length_562_cov_9.131749	319	399	0	39	80	0.4875000
NODE_29931_length_562_cov_9.131749	319	399	4	41	80	0.5125000
NODE_29960_length_562_cov_2.961123	350	398	0	48	48	1.0000000
NODE_30083_length_561_cov_18.049784	54	134	0	4	80	0.0500000
NODE_30083_length_561_cov_18.049784	54	134	2	1	80	0.0125000
NODE_30083_length_561_cov_18.049784	54	134	6	16	80	0.2000000
NODE_30083_length_561_cov_18.049784	54	134	8	11	80	0.1375000
NODE_30083_length_561_cov_18.049784	54	134	10	48	80	0.6000000
NODE_30083_length_561_cov_18.049784	107	187	0	17	80	0.2125000
NODE_30083_length_561_cov_18.049784	107	187	2	10	80	0.1250000
NODE_30083_length_561_cov_18.049784	107	187	4	14	80	0.1750000
NODE_30083_length_561_cov_18.049784	107	187	8	8	80	0.1000000
NODE_30083_length_561_cov_18.049784	107	187	10	31	80	0.3875000
NODE_30087_length_561_cov_5.348485	208	274	4	22	66	0.3333333
NODE_30087_length_561_cov_5.348485	208	274	6	44	66	0.6666667
NODE_30105_length_561_cov_2.787879	216	285	2	69	69	1.0000000
NODE_30120_length_561_cov_2.233766	339	419	0	80	80	1.0000000
NODE_30120_length_561_cov_2.233766	391	445	0	54	54	1.0000000
NODE_30120_length_561_cov_2.233766	392	438	0	46	46	1.0000000
NODE_30133_length_561_cov_1.803030	258	334	6	76	76	1.0000000
NODE_30224_length_560_cov_41.433839	67	147	4	32	80	0.4000000
NODE_30224_length_560_cov_41.433839	67	147	6	48	80	0.6000000
NODE_30224_length_560_cov_41.433839	120	200	0	38	80	0.4750000
NODE_30224_length_560_cov_41.433839	120	200	2	9	80	0.1125000
NODE_30224_length_560_cov_41.433839	120	200	6	33	80	0.4125000
NODE_30225_length_560_cov_35.993492	366	446	0	7	80	0.0875000
NODE_30225_length_560_cov_35.993492	366	446	2	73	80	0.9125000
NODE_30225_length_560_cov_35.993492	419	499	0	60	80	0.7500000
NODE_30225_length_560_cov_35.993492	419	499	2	20	80	0.2500000
NODE_30226_length_560_cov_20.433839	342	422	0	80	80	1.0000000
NODE_30226_length_560_cov_20.433839	395	475	0	80	80	1.0000000
NODE_30227_length_560_cov_13.850325	274	327	0	30	53	0.5660377
NODE_30227_length_560_cov_13.850325	274	327	2	23	53	0.4339623
NODE_30228_length_560_cov_12.075922	233	314	0	40	81	0.4938272
NODE_30228_length_560_cov_12.075922	233	314	2	41	81	0.5061728
NODE_30229_length_560_cov_8.594360	263	343	0	80	80	1.0000000
NODE_30229_length_560_cov_8.594360	316	396	0	80	80	1.0000000
NODE_30237_length_560_cov_5.227766	264	328	11	1	64	0.0156250
NODE_30237_length_560_cov_5.227766	264	328	12	5	64	0.0781250
NODE_30237_length_560_cov_5.227766	264	328	14	5	64	0.0781250
NODE_30237_length_560_cov_5.227766	264	328	16	2	64	0.0312500
NODE_30237_length_560_cov_5.227766	264	328	18	4	64	0.0625000
NODE_30237_length_560_cov_5.227766	264	328	20	5	64	0.0781250
NODE_30237_length_560_cov_5.227766	264	328	22	3	64	0.0468750
NODE_30237_length_560_cov_5.227766	264	328	24	39	64	0.6093750
NODE_30238_length_560_cov_5.056399	299	379	3	24	80	0.3000000
NODE_30238_length_560_cov_5.056399	299	379	4	56	80	0.7000000
NODE_30238_length_560_cov_5.056399	352	432	0	14	80	0.1750000
NODE_30238_length_560_cov_5.056399	352	432	3	63	80	0.7875000
NODE_30238_length_560_cov_5.056399	352	432	4	3	80	0.0375000
NODE_30244_length_560_cov_4.518438	156	236	8	42	80	0.5250000
NODE_30244_length_560_cov_4.518438	156	236	10	32	80	0.4000000
NODE_30244_length_560_cov_4.518438	156	236	12	6	80	0.0750000
NODE_30281_length_560_cov_2.154013	204	275	0	71	71	1.0000000
NODE_30281_length_560_cov_2.154013	255	335	0	80	80	1.0000000
NODE_30288_length_560_cov_2.017354	52	114	0	62	62	1.0000000
NODE_30363_length_559_cov_37.526087	289	370	0	81	81	1.0000000
NODE_30363_length_559_cov_37.526087	343	423	0	80	80	1.0000000
NODE_30363_length_559_cov_37.526087	419	500	0	81	81	1.0000000
NODE_30363_length_559_cov_37.526087	473	553	0	80	80	1.0000000
NODE_30365_length_559_cov_19.126087	388	468	4	50	80	0.6250000
NODE_30365_length_559_cov_19.126087	388	468	6	30	80	0.3750000
NODE_30365_length_559_cov_19.126087	441	521	2	35	80	0.4375000
NODE_30365_length_559_cov_19.126087	441	521	4	3	80	0.0375000
NODE_30365_length_559_cov_19.126087	441	521	6	42	80	0.5250000
NODE_30366_length_559_cov_12.489130	262	341	0	79	79	1.0000000
NODE_30366_length_559_cov_12.489130	316	394	0	78	78	1.0000000
NODE_30370_length_559_cov_6.530435	283	363	0	80	80	1.0000000
NODE_30377_length_559_cov_4.930435	112	192	0	58	80	0.7250000
NODE_30377_length_559_cov_4.930435	112	192	2	22	80	0.2750000
NODE_30377_length_559_cov_4.930435	165	244	0	79	79	1.0000000
NODE_30419_length_559_cov_1.776087	395	433	51	7	38	0.1842105
NODE_30419_length_559_cov_1.776087	395	433	55	8	38	0.2105263
NODE_30419_length_559_cov_1.776087	395	433	57	15	38	0.3947369
NODE_30419_length_559_cov_1.776087	395	433	59	5	38	0.1315790
NODE_30419_length_559_cov_1.776087	395	433	61	3	38	0.0789474
NODE_30480_length_558_cov_13.102397	297	364	0	35	67	0.5223880
NODE_30480_length_558_cov_13.102397	297	364	2	32	67	0.4776119
NODE_30482_length_558_cov_9.309368	369	449	0	80	80	1.0000000
NODE_30482_length_558_cov_9.309368	422	502	0	80	80	1.0000000
NODE_30489_length_558_cov_5.921569	304	361	2	57	57	1.0000000
NODE_30493_length_558_cov_4.801743	197	266	0	69	69	1.0000000
NODE_30493_length_558_cov_4.801743	197	277	0	80	80	1.0000000
NODE_30493_length_558_cov_4.801743	250	330	0	80	80	1.0000000
NODE_30493_length_558_cov_4.801743	250	330	0	80	80	1.0000000
NODE_30495_length_558_cov_4.570806	188	244	2	28	56	0.5000000
NODE_30495_length_558_cov_4.570806	188	244	4	28	56	0.5000000
NODE_30536_length_558_cov_2.259259	236	294	2	27	58	0.4655173
NODE_30536_length_558_cov_2.259259	236	294	4	31	58	0.5344828
NODE_30536_length_558_cov_2.259259	267	347	4	45	80	0.5625000
NODE_30536_length_558_cov_2.259259	267	347	6	35	80	0.4375000
NODE_30568_length_558_cov_1.544662	403	483	0	80	80	1.0000000
NODE_30568_length_558_cov_1.544662	456	536	0	80	80	1.0000000
NODE_30623_length_557_cov_9.141921	255	335	0	80	80	1.0000000
NODE_30623_length_557_cov_9.141921	308	388	0	80	80	1.0000000
NODE_30626_length_557_cov_7.316594	210	290	0	57	80	0.7125000
NODE_30626_length_557_cov_7.316594	210	290	2	23	80	0.2875000
NODE_30626_length_557_cov_7.316594	263	341	0	78	78	1.0000000
NODE_30636_length_557_cov_4.259825	185	267	2	18	82	0.2195122
NODE_30636_length_557_cov_4.259825	185	267	4	64	82	0.7804878
NODE_30646_length_557_cov_3.794760	131	188	0	27	57	0.4736842
NODE_30646_length_557_cov_3.794760	131	188	2	30	57	0.5263158
NODE_30646_length_557_cov_3.794760	139	219	0	19	80	0.2375000
NODE_30646_length_557_cov_3.794760	139	219	2	61	80	0.7625000
NODE_30650_length_557_cov_3.517467	246	325	0	79	79	1.0000000
NODE_30650_length_557_cov_3.517467	298	378	0	80	80	1.0000000
NODE_30652_length_557_cov_3.390830	366	395	48	8	29	0.2758621
NODE_30652_length_557_cov_3.390830	366	395	49	5	29	0.1724138
NODE_30652_length_557_cov_3.390830	366	395	50	8	29	0.2758621
NODE_30652_length_557_cov_3.390830	366	395	52	8	29	0.2758621
NODE_30792_length_556_cov_37.258206	122	202	0	80	80	1.0000000
NODE_30792_length_556_cov_37.258206	175	255	0	80	80	1.0000000
NODE_30793_length_556_cov_15.266958	360	440	0	80	80	1.0000000
NODE_30793_length_556_cov_15.266958	413	493	0	80	80	1.0000000
NODE_30794_length_556_cov_12.781182	341	421	2	43	80	0.5375000
NODE_30794_length_556_cov_12.781182	341	421	4	37	80	0.4625000
NODE_30794_length_556_cov_12.781182	394	474	0	22	80	0.2750000
NODE_30794_length_556_cov_12.781182	394	474	2	48	80	0.6000000
NODE_30794_length_556_cov_12.781182	394	474	4	10	80	0.1250000
NODE_30795_length_556_cov_11.131291	304	384	0	80	80	1.0000000
NODE_30795_length_556_cov_11.131291	357	437	0	80	80	1.0000000
NODE_30797_length_556_cov_7.168490	163	243	0	80	80	1.0000000
NODE_30797_length_556_cov_7.168490	216	296	0	80	80	1.0000000
NODE_30798_length_556_cov_7.089716	325	379	0	31	54	0.5740741
NODE_30798_length_556_cov_7.089716	325	379	4	23	54	0.4259259
NODE_30801_length_556_cov_6.505470	232	312	2	27	80	0.3375000
NODE_30801_length_556_cov_6.505470	232	312	4	7	80	0.0875000
NODE_30801_length_556_cov_6.505470	232	312	6	46	80	0.5750000
NODE_30801_length_556_cov_6.505470	285	365	4	49	80	0.6125000
NODE_30801_length_556_cov_6.505470	285	365	6	31	80	0.3875000
NODE_30802_length_556_cov_6.496718	140	179	0	39	39	1.0000000
NODE_30802_length_556_cov_6.496718	226	255	0	29	29	1.0000000
NODE_30809_length_556_cov_4.457330	197	277	10	23	80	0.2875000
NODE_30809_length_556_cov_4.457330	197	277	12	8	80	0.1000000
NODE_30809_length_556_cov_4.457330	197	277	14	17	80	0.2125000
NODE_30809_length_556_cov_4.457330	197	277	16	11	80	0.1375000
NODE_30809_length_556_cov_4.457330	197	277	18	21	80	0.2625000
NODE_30818_length_556_cov_3.761488	234	307	0	29	73	0.3972603
NODE_30818_length_556_cov_3.761488	234	307	2	10	73	0.1369863
NODE_30818_length_556_cov_3.761488	234	307	4	34	73	0.4657534
NODE_30930_length_555_cov_20.949561	322	402	0	80	80	1.0000000
NODE_30930_length_555_cov_20.949561	375	455	0	80	80	1.0000000
NODE_30931_length_555_cov_16.822368	268	348	6	80	80	1.0000000
NODE_30931_length_555_cov_16.822368	321	401	0	15	80	0.1875000
NODE_30931_length_555_cov_16.822368	321	401	3	19	80	0.2375000
NODE_30931_length_555_cov_16.822368	321	401	6	46	80	0.5750000
NODE_30933_length_555_cov_9.912281	313	393	0	80	80	1.0000000
NODE_30935_length_555_cov_8.057018	277	357	0	80	80	1.0000000
NODE_30935_length_555_cov_8.057018	330	410	0	80	80	1.0000000
NODE_30938_length_555_cov_6.778509	62	92	0	30	30	1.0000000
NODE_30986_length_555_cov_2.177632	208	288	0	80	80	1.0000000
NODE_30986_length_555_cov_2.177632	261	329	0	68	68	1.0000000
NODE_31092_length_554_cov_11.942857	118	198	0	80	80	1.0000000
NODE_31092_length_554_cov_11.942857	171	251	0	80	80	1.0000000
NODE_31096_length_554_cov_8.426374	242	322	2	70	80	0.8750000
NODE_31096_length_554_cov_8.426374	242	322	3	10	80	0.1250000
NODE_31096_length_554_cov_8.426374	295	375	2	35	80	0.4375000
NODE_31096_length_554_cov_8.426374	295	375	3	17	80	0.2125000
NODE_31096_length_554_cov_8.426374	295	375	4	28	80	0.3500000
NODE_31101_length_554_cov_6.116484	264	344	0	51	80	0.6375000
NODE_31101_length_554_cov_6.116484	264	344	3	1	80	0.0125000
NODE_31101_length_554_cov_6.116484	264	344	4	28	80	0.3500000
NODE_31101_length_554_cov_6.116484	317	393	0	76	76	1.0000000
NODE_31115_length_554_cov_3.586813	207	286	0	79	79	1.0000000
NODE_31240_length_553_cov_42.017621	197	277	0	80	80	1.0000000
NODE_31240_length_553_cov_42.017621	250	330	0	80	80	1.0000000
NODE_31241_length_553_cov_28.944934	333	413	0	80	80	1.0000000
NODE_31241_length_553_cov_28.944934	386	466	0	80	80	1.0000000
NODE_31242_length_553_cov_12.176211	242	322	0	57	80	0.7125000
NODE_31242_length_553_cov_12.176211	242	322	2	21	80	0.2625000
NODE_31242_length_553_cov_12.176211	242	322	4	2	80	0.0250000
NODE_31242_length_553_cov_12.176211	295	375	0	4	80	0.0500000
NODE_31242_length_553_cov_12.176211	295	375	2	21	80	0.2625000
NODE_31242_length_553_cov_12.176211	295	375	4	55	80	0.6875000
NODE_31244_length_553_cov_9.876652	232	312	0	80	80	1.0000000
NODE_31244_length_553_cov_9.876652	285	365	0	59	80	0.7375000
NODE_31244_length_553_cov_9.876652	285	365	2	21	80	0.2625000
NODE_31246_length_553_cov_9.306167	207	287	0	80	80	1.0000000
NODE_31246_length_553_cov_9.306167	207	287	0	80	80	1.0000000
NODE_31246_length_553_cov_9.306167	260	340	0	80	80	1.0000000
NODE_31259_length_553_cov_3.729075	36	93	12	3	57	0.0526316
NODE_31259_length_553_cov_3.729075	36	93	14	11	57	0.1929825
NODE_31259_length_553_cov_3.729075	36	93	16	43	57	0.7543859
NODE_31259_length_553_cov_3.729075	89	146	0	2	57	0.0350877
NODE_31259_length_553_cov_3.729075	89	146	2	2	57	0.0350877
NODE_31259_length_553_cov_3.729075	89	146	4	6	57	0.1052632
NODE_31259_length_553_cov_3.729075	89	146	6	10	57	0.1754386
NODE_31259_length_553_cov_3.729075	89	146	8	14	57	0.2456140
NODE_31259_length_553_cov_3.729075	89	146	10	1	57	0.0175439
NODE_31259_length_553_cov_3.729075	89	146	12	12	57	0.2105263
NODE_31259_length_553_cov_3.729075	89	146	14	5	57	0.0877193
NODE_31259_length_553_cov_3.729075	89	146	16	5	57	0.0877193
NODE_31266_length_553_cov_3.310573	226	293	0	67	67	1.0000000
NODE_31279_length_553_cov_2.678414	102	180	0	65	78	0.8333333
NODE_31279_length_553_cov_2.678414	102	180	2	13	78	0.1666667
NODE_31279_length_553_cov_2.678414	248	275	0	27	27	1.0000000
NODE_31295_length_553_cov_1.958150	416	462	2	1	46	0.0217391
NODE_31295_length_553_cov_1.958150	416	462	4	2	46	0.0434783
NODE_31295_length_553_cov_1.958150	416	462	6	11	46	0.2391304
NODE_31295_length_553_cov_1.958150	416	462	8	2	46	0.0434783
NODE_31295_length_553_cov_1.958150	416	462	10	7	46	0.1521739
NODE_31295_length_553_cov_1.958150	416	462	16	6	46	0.1304348
NODE_31295_length_553_cov_1.958150	416	462	18	3	46	0.0652174
NODE_31295_length_553_cov_1.958150	416	462	20	5	46	0.1086956
NODE_31295_length_553_cov_1.958150	416	462	24	9	46	0.1956522
NODE_31295_length_553_cov_1.958150	469	515	12	5	46	0.1086956
NODE_31295_length_553_cov_1.958150	469	515	14	2	46	0.0434783
NODE_31295_length_553_cov_1.958150	469	515	16	3	46	0.0652174
NODE_31295_length_553_cov_1.958150	469	515	18	8	46	0.1739130
NODE_31295_length_553_cov_1.958150	469	515	20	11	46	0.2391304
NODE_31295_length_553_cov_1.958150	469	515	22	12	46	0.2608696
NODE_31295_length_553_cov_1.958150	469	515	24	5	46	0.1086956
NODE_31377_length_552_cov_92.070640	298	378	0	80	80	1.0000000
NODE_31377_length_552_cov_92.070640	298	378	0	80	80	1.0000000
NODE_31377_length_552_cov_92.070640	374	454	0	28	80	0.3500000
NODE_31377_length_552_cov_92.070640	374	454	3	1	80	0.0125000
NODE_31377_length_552_cov_92.070640	374	454	4	51	80	0.6375000
NODE_31377_length_552_cov_92.070640	374	454	0	28	80	0.3500000
NODE_31377_length_552_cov_92.070640	374	454	3	1	80	0.0125000
NODE_31377_length_552_cov_92.070640	374	454	4	51	80	0.6375000
NODE_31377_length_552_cov_92.070640	374	454	0	28	80	0.3500000
NODE_31377_length_552_cov_92.070640	374	454	3	1	80	0.0125000
NODE_31377_length_552_cov_92.070640	374	454	4	51	80	0.6375000
NODE_31377_length_552_cov_92.070640	374	454	0	28	80	0.3500000
NODE_31377_length_552_cov_92.070640	374	454	3	1	80	0.0125000
NODE_31377_length_552_cov_92.070640	374	454	4	51	80	0.6375000
NODE_31377_length_552_cov_92.070640	374	450	0	28	76	0.3684210
NODE_31377_length_552_cov_92.070640	374	450	3	1	76	0.0131579
NODE_31377_length_552_cov_92.070640	374	450	4	47	76	0.6184211
NODE_31377_length_552_cov_92.070640	427	507	4	80	80	1.0000000
NODE_31377_length_552_cov_92.070640	427	507	4	80	80	1.0000000
NODE_31377_length_552_cov_92.070640	427	498	4	71	71	1.0000000
NODE_31377_length_552_cov_92.070640	430	500	4	70	70	1.0000000
NODE_31377_length_552_cov_92.070640	432	507	4	75	75	1.0000000
NODE_31378_length_552_cov_20.432671	151	231	0	64	80	0.8000000
NODE_31378_length_552_cov_20.432671	151	231	2	16	80	0.2000000
NODE_31378_length_552_cov_20.432671	204	284	0	80	80	1.0000000
NODE_31379_length_552_cov_18.075055	257	333	0	8	76	0.1052632
NODE_31379_length_552_cov_18.075055	257	333	4	6	76	0.0789474
NODE_31379_length_552_cov_18.075055	257	333	6	62	76	0.8157895
NODE_31380_length_552_cov_13.331126	214	294	0	62	80	0.7750000
NODE_31380_length_552_cov_13.331126	214	294	2	1	80	0.0125000
NODE_31380_length_552_cov_13.331126	214	294	4	3	80	0.0375000
NODE_31380_length_552_cov_13.331126	214	294	8	5	80	0.0625000
NODE_31380_length_552_cov_13.331126	214	294	12	9	80	0.1125000
NODE_31380_length_552_cov_13.331126	267	347	0	80	80	1.0000000
NODE_31381_length_552_cov_12.774834	360	440	0	80	80	1.0000000
NODE_31381_length_552_cov_12.774834	413	493	0	80	80	1.0000000
NODE_31384_length_552_cov_8.883002	310	390	0	80	80	1.0000000
NODE_31384_length_552_cov_8.883002	363	443	0	80	80	1.0000000
NODE_31385_length_552_cov_6.916115	206	281	0	75	75	1.0000000
NODE_31538_length_551_cov_34.070796	324	406	0	82	82	1.0000000
NODE_31538_length_551_cov_34.070796	379	444	0	65	65	1.0000000
NODE_31541_length_551_cov_10.252212	164	244	0	80	80	1.0000000
NODE_31541_length_551_cov_10.252212	217	297	0	80	80	1.0000000
NODE_31543_length_551_cov_8.075221	363	406	0	43	43	1.0000000
NODE_31547_length_551_cov_5.668142	213	293	4	7	80	0.0875000
NODE_31547_length_551_cov_5.668142	213	293	6	24	80	0.3000000
NODE_31547_length_551_cov_5.668142	213	293	8	21	80	0.2625000
NODE_31547_length_551_cov_5.668142	213	293	10	28	80	0.3500000
NODE_31547_length_551_cov_5.668142	266	346	2	29	80	0.3625000
NODE_31547_length_551_cov_5.668142	266	346	4	6	80	0.0750000
NODE_31547_length_551_cov_5.668142	266	346	6	38	80	0.4750000
NODE_31547_length_551_cov_5.668142	266	346	8	4	80	0.0500000
NODE_31547_length_551_cov_5.668142	266	346	10	3	80	0.0375000
NODE_31552_length_551_cov_4.212389	171	242	8	24	71	0.3380282
NODE_31552_length_551_cov_4.212389	171	242	10	41	71	0.5774648
NODE_31552_length_551_cov_4.212389	171	242	12	6	71	0.0845070
NODE_31552_length_551_cov_4.212389	215	263	4	1	48	0.0208333
NODE_31552_length_551_cov_4.212389	215	263	6	20	48	0.4166667
NODE_31552_length_551_cov_4.212389	215	263	8	21	48	0.4375000
NODE_31552_length_551_cov_4.212389	215	263	10	6	48	0.1250000
NODE_31563_length_551_cov_3.307522	227	307	4	25	80	0.3125000
NODE_31563_length_551_cov_3.307522	227	307	6	1	80	0.0125000
NODE_31563_length_551_cov_3.307522	227	307	8	13	80	0.1625000
NODE_31563_length_551_cov_3.307522	227	307	11	41	80	0.5125000
NODE_31563_length_551_cov_3.307522	280	360	8	30	80	0.3750000
NODE_31563_length_551_cov_3.307522	280	360	11	32	80	0.4000000
NODE_31563_length_551_cov_3.307522	280	360	12	18	80	0.2250000
NODE_31693_length_550_cov_17.308204	101	181	6	16	80	0.2000000
NODE_31693_length_550_cov_17.308204	101	181	8	64	80	0.8000000
NODE_31693_length_550_cov_17.308204	154	234	0	29	80	0.3625000
NODE_31693_length_550_cov_17.308204	154	234	5	1	80	0.0125000
NODE_31693_length_550_cov_17.308204	154	234	6	39	80	0.4875000
NODE_31693_length_550_cov_17.308204	154	234	8	11	80	0.1375000
NODE_31700_length_550_cov_5.580931	286	329	0	43	43	1.0000000
NODE_31701_length_550_cov_5.490022	458	500	0	42	42	1.0000000
NODE_31701_length_550_cov_5.490022	459	523	0	64	64	1.0000000
NODE_31703_length_550_cov_5.243902	194	274	0	80	80	1.0000000
NODE_31703_length_550_cov_5.243902	247	327	0	80	80	1.0000000
NODE_31706_length_550_cov_4.815965	184	264	0	80	80	1.0000000
NODE_31726_length_550_cov_3.252772	308	388	6	2	80	0.0250000
NODE_31726_length_550_cov_3.252772	308	388	8	32	80	0.4000000
NODE_31726_length_550_cov_3.252772	308	388	10	46	80	0.5750000
NODE_31756_length_550_cov_1.864745	189	259	0	70	70	1.0000000
NODE_31756_length_550_cov_1.864745	189	258	0	69	69	1.0000000
NODE_31847_length_549_cov_31.826667	216	292	45	4	76	0.0526316
NODE_31847_length_549_cov_31.826667	216	292	46	4	76	0.0526316
NODE_31847_length_549_cov_31.826667	216	292	47	1	76	0.0131579
NODE_31847_length_549_cov_31.826667	216	292	48	3	76	0.0394737
NODE_31847_length_549_cov_31.826667	216	292	50	3	76	0.0394737
NODE_31847_length_549_cov_31.826667	216	292	52	1	76	0.0131579
NODE_31847_length_549_cov_31.826667	216	292	58	5	76	0.0657895
NODE_31847_length_549_cov_31.826667	216	292	60	2	76	0.0263158
NODE_31847_length_549_cov_31.826667	216	292	66	7	76	0.0921053
NODE_31847_length_549_cov_31.826667	216	292	68	8	76	0.1052632
NODE_31847_length_549_cov_31.826667	216	292	70	2	76	0.0263158
NODE_31847_length_549_cov_31.826667	216	292	72	5	76	0.0657895
NODE_31847_length_549_cov_31.826667	216	292	74	23	76	0.3026316
NODE_31847_length_549_cov_31.826667	216	292	76	8	76	0.1052632
NODE_31847_length_549_cov_31.826667	267	331	21	3	64	0.0468750
NODE_31847_length_549_cov_31.826667	267	331	31	1	64	0.0156250
NODE_31847_length_549_cov_31.826667	267	331	35	2	64	0.0312500
NODE_31847_length_549_cov_31.826667	267	331	37	1	64	0.0156250
NODE_31847_length_549_cov_31.826667	267	331	41	4	64	0.0625000
NODE_31847_length_549_cov_31.826667	267	331	43	2	64	0.0312500
NODE_31847_length_549_cov_31.826667	267	331	49	1	64	0.0156250
NODE_31847_length_549_cov_31.826667	267	331	50	1	64	0.0156250
NODE_31847_length_549_cov_31.826667	267	331	51	2	64	0.0312500
NODE_31847_length_549_cov_31.826667	267	331	52	2	64	0.0312500
NODE_31847_length_549_cov_31.826667	267	331	54	1	64	0.0156250
NODE_31847_length_549_cov_31.826667	267	331	56	13	64	0.2031250
NODE_31847_length_549_cov_31.826667	267	331	62	5	64	0.0781250
NODE_31847_length_549_cov_31.826667	267	331	66	7	64	0.1093750
NODE_31847_length_549_cov_31.826667	267	331	68	4	64	0.0625000
NODE_31847_length_549_cov_31.826667	267	331	70	1	64	0.0156250
NODE_31847_length_549_cov_31.826667	267	331	72	3	64	0.0468750
NODE_31847_length_549_cov_31.826667	267	331	74	11	64	0.1718750
NODE_31848_length_549_cov_14.124444	174	263	0	34	89	0.3820225
NODE_31848_length_549_cov_14.124444	174	263	2	55	89	0.6179775
NODE_31848_length_549_cov_14.124444	242	315	0	73	73	1.0000000
NODE_31857_length_549_cov_5.375556	181	257	89	1	76	0.0131579
NODE_31857_length_549_cov_5.375556	181	257	90	1	76	0.0131579
NODE_31857_length_549_cov_5.375556	181	257	92	2	76	0.0263158
NODE_31857_length_549_cov_5.375556	181	257	94	2	76	0.0263158
NODE_31857_length_549_cov_5.375556	181	257	98	1	76	0.0131579
NODE_31857_length_549_cov_5.375556	181	257	99	1	76	0.0131579
NODE_31857_length_549_cov_5.375556	181	257	100	4	76	0.0526316
NODE_31857_length_549_cov_5.375556	181	257	102	4	76	0.0526316
NODE_31857_length_549_cov_5.375556	181	257	104	2	76	0.0263158
NODE_31857_length_549_cov_5.375556	181	257	106	13	76	0.1710526
NODE_31857_length_549_cov_5.375556	181	257	108	7	76	0.0921053
NODE_31857_length_549_cov_5.375556	181	257	109	9	76	0.1184211
NODE_31857_length_549_cov_5.375556	181	257	110	5	76	0.0657895
NODE_31857_length_549_cov_5.375556	181	257	111	1	76	0.0131579
NODE_31857_length_549_cov_5.375556	181	257	112	5	76	0.0657895
NODE_31857_length_549_cov_5.375556	181	257	114	1	76	0.0131579
NODE_31857_length_549_cov_5.375556	181	257	117	1	76	0.0131579
NODE_31857_length_549_cov_5.375556	181	257	118	4	76	0.0526316
NODE_31857_length_549_cov_5.375556	181	257	119	7	76	0.0921053
NODE_31857_length_549_cov_5.375556	181	257	120	3	76	0.0394737
NODE_31857_length_549_cov_5.375556	181	257	121	1	76	0.0131579
NODE_31857_length_549_cov_5.375556	181	257	122	1	76	0.0131579
NODE_31859_length_549_cov_4.933333	260	340	0	80	80	1.0000000
NODE_31864_length_549_cov_4.537778	345	430	0	85	85	1.0000000
NODE_31864_length_549_cov_4.537778	403	483	0	80	80	1.0000000
NODE_31865_length_549_cov_4.124444	406	486	10	5	80	0.0625000
NODE_31865_length_549_cov_4.124444	406	486	11	9	80	0.1125000
NODE_31865_length_549_cov_4.124444	406	486	12	7	80	0.0875000
NODE_31865_length_549_cov_4.124444	406	486	13	3	80	0.0375000
NODE_31865_length_549_cov_4.124444	406	486	14	17	80	0.2125000
NODE_31865_length_549_cov_4.124444	406	486	15	27	80	0.3375000
NODE_31865_length_549_cov_4.124444	406	486	16	12	80	0.1500000
NODE_31866_length_549_cov_3.931111	182	219	2	4	37	0.1081081
NODE_31866_length_549_cov_3.931111	182	219	6	1	37	0.0270270
NODE_31866_length_549_cov_3.931111	182	219	8	18	37	0.4864865
NODE_31866_length_549_cov_3.931111	182	219	10	14	37	0.3783784
NODE_31868_length_549_cov_3.893333	287	367	0	80	80	1.0000000
NODE_31868_length_549_cov_3.893333	340	420	0	80	80	1.0000000
NODE_31887_length_549_cov_2.673333	282	343	2	61	61	1.0000000
NODE_31890_length_549_cov_2.622222	144	220	4	3	76	0.0394737
NODE_31890_length_549_cov_2.622222	144	220	6	73	76	0.9605263
NODE_32013_length_548_cov_13.962138	285	371	0	86	86	1.0000000
NODE_32013_length_548_cov_13.962138	344	424	0	80	80	1.0000000
NODE_32022_length_548_cov_4.683742	261	336	0	75	75	1.0000000
NODE_32023_length_548_cov_4.670379	140	182	0	42	42	1.0000000
NODE_32023_length_548_cov_4.670379	282	311	4	17	29	0.5862069
NODE_32023_length_548_cov_4.670379	282	311	8	12	29	0.4137931
NODE_32023_length_548_cov_4.670379	410	455	4	15	45	0.3333333
NODE_32023_length_548_cov_4.670379	410	455	8	19	45	0.4222222
NODE_32023_length_548_cov_4.670379	410	455	10	11	45	0.2444444
NODE_32029_length_548_cov_3.630290	111	177	0	66	66	1.0000000
NODE_32039_length_548_cov_3.080178	142	191	0	49	49	1.0000000
NODE_32180_length_547_cov_23.982143	243	323	2	23	80	0.2875000
NODE_32180_length_547_cov_23.982143	243	323	4	5	80	0.0625000
NODE_32180_length_547_cov_23.982143	243	323	6	52	80	0.6500000
NODE_32180_length_547_cov_23.982143	243	323	2	23	80	0.2875000
NODE_32180_length_547_cov_23.982143	243	323	4	5	80	0.0625000
NODE_32180_length_547_cov_23.982143	243	323	6	52	80	0.6500000
NODE_32180_length_547_cov_23.982143	252	323	2	14	71	0.1971831
NODE_32180_length_547_cov_23.982143	252	323	4	5	71	0.0704225
NODE_32180_length_547_cov_23.982143	252	323	6	52	71	0.7323943
NODE_32181_length_547_cov_23.555804	42	122	0	68	80	0.8500000
NODE_32181_length_547_cov_23.555804	42	122	6	12	80	0.1500000
NODE_32181_length_547_cov_23.555804	95	175	0	15	80	0.1875000
NODE_32181_length_547_cov_23.555804	95	175	6	65	80	0.8125000
NODE_32183_length_547_cov_12.819196	190	270	2	5	80	0.0625000
NODE_32183_length_547_cov_12.819196	190	270	4	1	80	0.0125000
NODE_32183_length_547_cov_12.819196	190	270	8	74	80	0.9250000
NODE_32195_length_547_cov_5.207589	290	370	4	41	80	0.5125000
NODE_32195_length_547_cov_5.207589	290	370	6	5	80	0.0625000
NODE_32195_length_547_cov_5.207589	290	370	7	34	80	0.4250000
NODE_32195_length_547_cov_5.207589	343	423	7	37	80	0.4625000
NODE_32195_length_547_cov_5.207589	343	423	8	43	80	0.5375000
NODE_32197_length_547_cov_4.975446	411	488	2	71	77	0.9220779
NODE_32197_length_547_cov_4.975446	411	488	4	6	77	0.0779221
NODE_32197_length_547_cov_4.975446	461	542	2	75	81	0.9259259
NODE_32197_length_547_cov_4.975446	461	542	4	6	81	0.0740741
NODE_32199_length_547_cov_4.683036	451	492	0	41	41	1.0000000
NODE_32204_length_547_cov_4.138393	97	175	0	41	78	0.5256410
NODE_32204_length_547_cov_4.138393	97	175	2	37	78	0.4743590
NODE_32204_length_547_cov_4.138393	151	228	0	77	77	1.0000000
NODE_32206_length_547_cov_4.026786	136	216	0	80	80	1.0000000
NODE_32206_length_547_cov_4.026786	189	269	0	80	80	1.0000000
NODE_32215_length_547_cov_3.468750	219	299	0	80	80	1.0000000
NODE_32222_length_547_cov_2.901786	304	384	0	80	80	1.0000000
NODE_32347_length_546_cov_17.733781	159	239	0	80	80	1.0000000
NODE_32347_length_546_cov_17.733781	212	293	0	81	81	1.0000000
NODE_32348_length_546_cov_16.275168	272	352	0	80	80	1.0000000
NODE_32348_length_546_cov_16.275168	325	405	0	80	80	1.0000000
NODE_32349_length_546_cov_8.201342	179	259	6	2	80	0.0250000
NODE_32349_length_546_cov_8.201342	179	259	12	2	80	0.0250000
NODE_32349_length_546_cov_8.201342	179	259	16	22	80	0.2750000
NODE_32349_length_546_cov_8.201342	179	259	18	18	80	0.2250000
NODE_32349_length_546_cov_8.201342	179	259	19	1	80	0.0125000
NODE_32349_length_546_cov_8.201342	179	259	20	35	80	0.4375000
NODE_32351_length_546_cov_7.454139	241	321	0	80	80	1.0000000
NODE_32351_length_546_cov_7.454139	294	374	0	80	80	1.0000000
NODE_32380_length_546_cov_3.192394	171	251	0	22	80	0.2750000
NODE_32380_length_546_cov_3.192394	171	251	2	58	80	0.7250000
NODE_32510_length_545_cov_31.524664	38	118	0	6	80	0.0750000
NODE_32510_length_545_cov_31.524664	38	118	4	56	80	0.7000000
NODE_32510_length_545_cov_31.524664	38	118	5	1	80	0.0125000
NODE_32510_length_545_cov_31.524664	38	118	6	17	80	0.2125000
NODE_32510_length_545_cov_31.524664	91	171	2	42	80	0.5250000
NODE_32510_length_545_cov_31.524664	91	171	4	9	80	0.1125000
NODE_32510_length_545_cov_31.524664	91	171	5	1	80	0.0125000
NODE_32510_length_545_cov_31.524664	91	171	6	28	80	0.3500000
NODE_32517_length_545_cov_5.524664	268	348	0	20	80	0.2500000
NODE_32517_length_545_cov_5.524664	268	348	1	23	80	0.2875000
NODE_32517_length_545_cov_5.524664	268	348	2	37	80	0.4625000
NODE_32525_length_545_cov_3.885650	137	217	2	19	80	0.2375000
NODE_32525_length_545_cov_3.885650	137	217	4	61	80	0.7625000
NODE_32571_length_545_cov_2.013453	246	318	2	1	72	0.0138889
NODE_32571_length_545_cov_2.013453	246	318	4	5	72	0.0694444
NODE_32571_length_545_cov_2.013453	246	318	6	66	72	0.9166667
NODE_32599_length_545_cov_1.450673	130	179	0	41	49	0.8367347
NODE_32599_length_545_cov_1.450673	130	179	2	6	49	0.1224490
NODE_32599_length_545_cov_1.450673	130	179	4	2	49	0.0408163
NODE_32616_length_545_cov_1.179372	431	469	0	38	38	1.0000000
NODE_32673_length_544_cov_37.705618	258	338	0	80	80	1.0000000
NODE_32673_length_544_cov_37.705618	311	391	0	80	80	1.0000000
NODE_32674_length_544_cov_33.847191	189	269	0	22	80	0.2750000
NODE_32674_length_544_cov_33.847191	189	269	2	58	80	0.7250000
NODE_32674_length_544_cov_33.847191	242	327	0	80	85	0.9411765
NODE_32674_length_544_cov_33.847191	242	327	2	5	85	0.0588235
NODE_32675_length_544_cov_19.467416	251	331	0	80	80	1.0000000
NODE_32675_length_544_cov_19.467416	304	384	0	80	80	1.0000000
NODE_32676_length_544_cov_16.775281	163	243	0	80	80	1.0000000
NODE_32676_length_544_cov_16.775281	216	296	0	80	80	1.0000000
NODE_32677_length_544_cov_8.943820	81	161	0	80	80	1.0000000
NODE_32677_length_544_cov_8.943820	134	214	0	80	80	1.0000000
NODE_32678_length_544_cov_8.537079	283	363	0	80	80	1.0000000
NODE_32678_length_544_cov_8.537079	336	416	0	80	80	1.0000000
NODE_32680_length_544_cov_8.440449	209	289	0	19	80	0.2375000
NODE_32680_length_544_cov_8.440449	209	289	3	1	80	0.0125000
NODE_32680_length_544_cov_8.440449	209	289	4	60	80	0.7500000
NODE_32680_length_544_cov_8.440449	262	342	0	72	80	0.9000000
NODE_32680_length_544_cov_8.440449	262	342	3	1	80	0.0125000
NODE_32680_length_544_cov_8.440449	262	342	4	7	80	0.0875000
NODE_32681_length_544_cov_7.604494	332	412	0	80	80	1.0000000
NODE_32681_length_544_cov_7.604494	385	465	0	80	80	1.0000000
NODE_32684_length_544_cov_6.000000	461	513	2	18	52	0.3461539
NODE_32684_length_544_cov_6.000000	461	513	4	2	52	0.0384615
NODE_32684_length_544_cov_6.000000	461	513	6	29	52	0.5576923
NODE_32684_length_544_cov_6.000000	461	513	8	3	52	0.0576923
NODE_32830_length_543_cov_38.790541	116	196	0	15	80	0.1875000
NODE_32830_length_543_cov_38.790541	116	196	4	30	80	0.3750000
NODE_32830_length_543_cov_38.790541	116	196	6	35	80	0.4375000
NODE_32830_length_543_cov_38.790541	169	249	0	10	80	0.1250000
NODE_32830_length_543_cov_38.790541	169	249	2	9	80	0.1125000
NODE_32830_length_543_cov_38.790541	169	249	6	61	80	0.7625000
NODE_32831_length_543_cov_31.713964	193	273	0	80	80	1.0000000
NODE_32831_length_543_cov_31.713964	246	326	0	80	80	1.0000000
NODE_32832_length_543_cov_13.689189	118	198	0	43	80	0.5375000
NODE_32832_length_543_cov_13.689189	118	198	4	37	80	0.4625000
NODE_32832_length_543_cov_13.689189	171	251	2	3	80	0.0375000
NODE_32832_length_543_cov_13.689189	171	251	4	77	80	0.9625000
NODE_32833_length_543_cov_10.601351	271	351	0	80	80	1.0000000
NODE_32833_length_543_cov_10.601351	324	404	0	80	80	1.0000000
NODE_32833_length_543_cov_10.601351	400	480	0	80	80	1.0000000
NODE_32833_length_543_cov_10.601351	453	533	0	80	80	1.0000000
NODE_32834_length_543_cov_9.202703	291	341	4	10	50	0.2000000
NODE_32834_length_543_cov_9.202703	291	341	6	23	50	0.4600000
NODE_32834_length_543_cov_9.202703	291	341	8	17	50	0.3400000
NODE_32834_length_543_cov_9.202703	347	384	2	26	37	0.7027027
NODE_32834_length_543_cov_9.202703	347	384	6	11	37	0.2972973
NODE_32835_length_543_cov_7.722973	300	378	0	34	78	0.4358974
NODE_32835_length_543_cov_7.722973	300	378	2	34	78	0.4358974
NODE_32835_length_543_cov_7.722973	300	378	4	10	78	0.1282051
NODE_32835_length_543_cov_7.722973	351	431	0	80	80	1.0000000
NODE_32836_length_543_cov_6.815315	181	260	0	51	79	0.6455696
NODE_32836_length_543_cov_6.815315	181	260	2	28	79	0.3544304
NODE_32845_length_543_cov_4.704955	145	225	0	80	80	1.0000000
NODE_32845_length_543_cov_4.704955	198	275	0	77	77	1.0000000
NODE_32864_length_543_cov_3.301802	247	312	0	65	65	1.0000000
NODE_32875_length_543_cov_2.635135	253	316	0	44	63	0.6984127
NODE_32875_length_543_cov_2.635135	253	316	2	19	63	0.3015873
NODE_32875_length_543_cov_2.635135	293	373	0	4	80	0.0500000
NODE_32875_length_543_cov_2.635135	293	373	2	29	80	0.3625000
NODE_32875_length_543_cov_2.635135	293	373	6	1	80	0.0125000
NODE_32875_length_543_cov_2.635135	293	373	8	2	80	0.0250000
NODE_32875_length_543_cov_2.635135	293	373	10	5	80	0.0625000
NODE_32875_length_543_cov_2.635135	293	373	12	39	80	0.4875000
NODE_33002_length_543_cov_0.682432	98	178	0	10	80	0.1250000
NODE_33002_length_543_cov_0.682432	98	178	2	36	80	0.4500000
NODE_33002_length_543_cov_0.682432	98	178	4	34	80	0.4250000
NODE_33012_length_542_cov_57.370203	287	367	0	80	80	1.0000000
NODE_33012_length_542_cov_57.370203	340	378	0	38	38	1.0000000
NODE_33014_length_542_cov_11.616253	277	357	0	80	80	1.0000000
NODE_33014_length_542_cov_11.616253	330	410	0	80	80	1.0000000
NODE_33015_length_542_cov_9.988713	253	333	0	64	80	0.8000000
NODE_33015_length_542_cov_9.988713	253	333	2	16	80	0.2000000
NODE_33015_length_542_cov_9.988713	306	386	0	73	80	0.9125000
NODE_33015_length_542_cov_9.988713	306	386	2	7	80	0.0875000
NODE_33018_length_542_cov_7.934537	215	295	0	80	80	1.0000000
NODE_33018_length_542_cov_7.934537	268	348	0	80	80	1.0000000
NODE_33020_length_542_cov_7.266366	159	239	0	11	80	0.1375000
NODE_33020_length_542_cov_7.266366	159	239	1	4	80	0.0500000
NODE_33020_length_542_cov_7.266366	159	239	2	14	80	0.1750000
NODE_33020_length_542_cov_7.266366	159	239	4	51	80	0.6375000
NODE_33021_length_542_cov_7.069977	230	304	0	27	74	0.3648649
NODE_33021_length_542_cov_7.069977	230	304	2	47	74	0.6351351
NODE_33021_length_542_cov_7.069977	284	362	0	78	78	1.0000000
NODE_33025_length_542_cov_4.783296	237	267	0	30	30	1.0000000
NODE_33035_length_542_cov_3.882619	275	303	0	28	28	1.0000000
NODE_33040_length_542_cov_3.600451	82	131	2	4	49	0.0816327
NODE_33040_length_542_cov_3.600451	82	131	3	3	49	0.0612245
NODE_33040_length_542_cov_3.600451	82	131	4	36	49	0.7346939
NODE_33040_length_542_cov_3.600451	82	131	7	3	49	0.0612245
NODE_33040_length_542_cov_3.600451	82	131	8	3	49	0.0612245
NODE_33188_length_541_cov_22.463801	247	327	0	15	80	0.1875000
NODE_33188_length_541_cov_22.463801	247	327	2	65	80	0.8125000
NODE_33188_length_541_cov_22.463801	300	380	0	9	80	0.1125000
NODE_33188_length_541_cov_22.463801	300	380	2	71	80	0.8875000
NODE_33190_length_541_cov_11.070136	60	140	2	60	80	0.7500000
NODE_33190_length_541_cov_11.070136	60	140	4	20	80	0.2500000
NODE_33190_length_541_cov_11.070136	113	193	0	4	80	0.0500000
NODE_33190_length_541_cov_11.070136	113	193	2	68	80	0.8500000
NODE_33190_length_541_cov_11.070136	113	193	4	8	80	0.1000000
NODE_33204_length_541_cov_3.690045	179	250	2	36	71	0.5070422
NODE_33204_length_541_cov_3.690045	179	250	4	35	71	0.4929577
NODE_33300_length_541_cov_1.187783	352	400	6	27	48	0.5625000
NODE_33300_length_541_cov_1.187783	352	400	7	21	48	0.4375000
NODE_33359_length_540_cov_78.353741	219	299	0	6	80	0.0750000
NODE_33359_length_540_cov_78.353741	219	299	2	74	80	0.9250000
NODE_33359_length_540_cov_78.353741	272	352	0	47	80	0.5875000
NODE_33359_length_540_cov_78.353741	272	352	2	33	80	0.4125000
NODE_33360_length_540_cov_33.473923	59	139	0	80	80	1.0000000
NODE_33360_length_540_cov_33.473923	112	192	0	80	80	1.0000000
NODE_33361_length_540_cov_20.380952	97	177	0	38	80	0.4750000
NODE_33361_length_540_cov_20.380952	97	177	4	42	80	0.5250000
NODE_33361_length_540_cov_20.380952	150	230	2	16	80	0.2000000
NODE_33361_length_540_cov_20.380952	150	230	4	40	80	0.5000000
NODE_33361_length_540_cov_20.380952	150	230	6	24	80	0.3000000
NODE_33362_length_540_cov_12.657596	248	328	0	80	80	1.0000000
NODE_33362_length_540_cov_12.657596	301	381	0	80	80	1.0000000
NODE_33363_length_540_cov_11.111111	180	260	0	80	80	1.0000000
NODE_33363_length_540_cov_11.111111	233	313	0	80	80	1.0000000
NODE_33365_length_540_cov_6.328798	260	340	0	11	80	0.1375000
NODE_33365_length_540_cov_6.328798	260	340	2	69	80	0.8625000
NODE_33365_length_540_cov_6.328798	313	393	0	64	80	0.8000000
NODE_33365_length_540_cov_6.328798	313	393	2	16	80	0.2000000
NODE_33382_length_540_cov_3.587302	351	411	0	60	60	1.0000000
NODE_33503_length_539_cov_1023.604545	264	344	345	1	80	0.0125000
NODE_33503_length_539_cov_1023.604545	264	344	350	1	80	0.0125000
NODE_33503_length_539_cov_1023.604545	264	344	367	1	80	0.0125000
NODE_33503_length_539_cov_1023.604545	264	344	380	1	80	0.0125000
NODE_33503_length_539_cov_1023.604545	264	344	413	1	80	0.0125000
NODE_33503_length_539_cov_1023.604545	264	344	419	1	80	0.0125000
NODE_33503_length_539_cov_1023.604545	264	344	426	1	80	0.0125000
NODE_33503_length_539_cov_1023.604545	264	344	451	1	80	0.0125000
NODE_33503_length_539_cov_1023.604545	264	344	453	1	80	0.0125000
NODE_33503_length_539_cov_1023.604545	264	344	459	1	80	0.0125000
NODE_33503_length_539_cov_1023.604545	264	344	466	1	80	0.0125000
NODE_33503_length_539_cov_1023.604545	264	344	496	1	80	0.0125000
NODE_33503_length_539_cov_1023.604545	264	344	500	1	80	0.0125000
NODE_33503_length_539_cov_1023.604545	264	344	508	1	80	0.0125000
NODE_33503_length_539_cov_1023.604545	264	344	513	1	80	0.0125000
NODE_33503_length_539_cov_1023.604545	264	344	524	1	80	0.0125000
NODE_33503_length_539_cov_1023.604545	264	344	546	1	80	0.0125000
NODE_33503_length_539_cov_1023.604545	264	344	557	1	80	0.0125000
NODE_33503_length_539_cov_1023.604545	264	344	578	1	80	0.0125000
NODE_33503_length_539_cov_1023.604545	264	344	591	1	80	0.0125000
NODE_33503_length_539_cov_1023.604545	264	344	601	1	80	0.0125000
NODE_33503_length_539_cov_1023.604545	264	344	614	1	80	0.0125000
NODE_33503_length_539_cov_1023.604545	264	344	621	1	80	0.0125000
NODE_33503_length_539_cov_1023.604545	264	344	654	1	80	0.0125000
NODE_33503_length_539_cov_1023.604545	264	344	684	1	80	0.0125000
NODE_33503_length_539_cov_1023.604545	264	344	717	1	80	0.0125000
NODE_33503_length_539_cov_1023.604545	264	344	735	1	80	0.0125000
NODE_33503_length_539_cov_1023.604545	264	344	769	1	80	0.0125000
NODE_33503_length_539_cov_1023.604545	264	344	811	1	80	0.0125000
NODE_33503_length_539_cov_1023.604545	264	344	851	1	80	0.0125000
NODE_33503_length_539_cov_1023.604545	264	344	868	1	80	0.0125000
NODE_33503_length_539_cov_1023.604545	264	344	876	1	80	0.0125000
NODE_33503_length_539_cov_1023.604545	264	344	915	1	80	0.0125000
NODE_33503_length_539_cov_1023.604545	264	344	938	1	80	0.0125000
NODE_33503_length_539_cov_1023.604545	264	344	942	1	80	0.0125000
NODE_33503_length_539_cov_1023.604545	264	344	957	1	80	0.0125000
NODE_33503_length_539_cov_1023.604545	264	344	992	1	80	0.0125000
NODE_33503_length_539_cov_1023.604545	264	344	1011	1	80	0.0125000
NODE_33503_length_539_cov_1023.604545	264	344	1048	1	80	0.0125000
NODE_33503_length_539_cov_1023.604545	264	344	1057	1	80	0.0125000
NODE_33503_length_539_cov_1023.604545	264	344	1079	1	80	0.0125000
NODE_33503_length_539_cov_1023.604545	264	344	1089	1	80	0.0125000
NODE_33503_length_539_cov_1023.604545	264	344	1103	1	80	0.0125000
NODE_33503_length_539_cov_1023.604545	264	344	1126	2	80	0.0250000
NODE_33503_length_539_cov_1023.604545	264	344	1127	1	80	0.0125000
NODE_33503_length_539_cov_1023.604545	264	344	1131	1	80	0.0125000
NODE_33503_length_539_cov_1023.604545	264	344	1144	1	80	0.0125000
NODE_33503_length_539_cov_1023.604545	264	344	1167	1	80	0.0125000
NODE_33503_length_539_cov_1023.604545	264	344	1169	1	80	0.0125000
NODE_33503_length_539_cov_1023.604545	264	344	1193	1	80	0.0125000
NODE_33503_length_539_cov_1023.604545	264	344	1211	1	80	0.0125000
NODE_33503_length_539_cov_1023.604545	264	344	1243	1	80	0.0125000
NODE_33503_length_539_cov_1023.604545	264	344	1247	1	80	0.0125000
NODE_33503_length_539_cov_1023.604545	264	344	1256	1	80	0.0125000
NODE_33503_length_539_cov_1023.604545	264	344	1280	1	80	0.0125000
NODE_33503_length_539_cov_1023.604545	264	344	1282	1	80	0.0125000
NODE_33503_length_539_cov_1023.604545	264	344	1295	1	80	0.0125000
NODE_33503_length_539_cov_1023.604545	264	344	1334	1	80	0.0125000
NODE_33503_length_539_cov_1023.604545	264	344	1339	1	80	0.0125000
NODE_33503_length_539_cov_1023.604545	264	344	1353	1	80	0.0125000
NODE_33503_length_539_cov_1023.604545	264	344	1369	1	80	0.0125000
NODE_33503_length_539_cov_1023.604545	264	344	1377	1	80	0.0125000
NODE_33503_length_539_cov_1023.604545	264	344	1399	2	80	0.0250000
NODE_33503_length_539_cov_1023.604545	264	344	1410	1	80	0.0125000
NODE_33503_length_539_cov_1023.604545	264	344	1432	1	80	0.0125000
NODE_33503_length_539_cov_1023.604545	264	344	1456	1	80	0.0125000
NODE_33503_length_539_cov_1023.604545	264	344	1459	1	80	0.0125000
NODE_33503_length_539_cov_1023.604545	264	344	1471	1	80	0.0125000
NODE_33503_length_539_cov_1023.604545	264	344	1490	1	80	0.0125000
NODE_33503_length_539_cov_1023.604545	264	344	1505	1	80	0.0125000
NODE_33503_length_539_cov_1023.604545	264	344	1507	1	80	0.0125000
NODE_33503_length_539_cov_1023.604545	264	344	1511	1	80	0.0125000
NODE_33503_length_539_cov_1023.604545	264	344	1518	1	80	0.0125000
NODE_33503_length_539_cov_1023.604545	264	344	1525	1	80	0.0125000
NODE_33503_length_539_cov_1023.604545	264	344	1532	1	80	0.0125000
NODE_33503_length_539_cov_1023.604545	264	344	1537	1	80	0.0125000
NODE_33503_length_539_cov_1023.604545	264	344	1548	1	80	0.0125000
NODE_33503_length_539_cov_1023.604545	264	344	1550	1	80	0.0125000
NODE_33503_length_539_cov_1023.604545	317	397	1247	1	80	0.0125000
NODE_33503_length_539_cov_1023.604545	317	397	1256	1	80	0.0125000
NODE_33503_length_539_cov_1023.604545	317	397	1280	1	80	0.0125000
NODE_33503_length_539_cov_1023.604545	317	397	1282	1	80	0.0125000
NODE_33503_length_539_cov_1023.604545	317	397	1295	1	80	0.0125000
NODE_33503_length_539_cov_1023.604545	317	397	1334	1	80	0.0125000
NODE_33503_length_539_cov_1023.604545	317	397	1339	1	80	0.0125000
NODE_33503_length_539_cov_1023.604545	317	397	1353	1	80	0.0125000
NODE_33503_length_539_cov_1023.604545	317	397	1369	1	80	0.0125000
NODE_33503_length_539_cov_1023.604545	317	397	1377	1	80	0.0125000
NODE_33503_length_539_cov_1023.604545	317	397	1399	2	80	0.0250000
NODE_33503_length_539_cov_1023.604545	317	397	1410	1	80	0.0125000
NODE_33503_length_539_cov_1023.604545	317	397	1432	1	80	0.0125000
NODE_33503_length_539_cov_1023.604545	317	397	1456	1	80	0.0125000
NODE_33503_length_539_cov_1023.604545	317	397	1459	1	80	0.0125000
NODE_33503_length_539_cov_1023.604545	317	397	1470	1	80	0.0125000
NODE_33503_length_539_cov_1023.604545	317	397	1471	1	80	0.0125000
NODE_33503_length_539_cov_1023.604545	317	397	1474	1	80	0.0125000
NODE_33503_length_539_cov_1023.604545	317	397	1478	1	80	0.0125000
NODE_33503_length_539_cov_1023.604545	317	397	1482	1	80	0.0125000
NODE_33503_length_539_cov_1023.604545	317	397	1485	1	80	0.0125000
NODE_33503_length_539_cov_1023.604545	317	397	1490	1	80	0.0125000
NODE_33503_length_539_cov_1023.604545	317	397	1491	1	80	0.0125000
NODE_33503_length_539_cov_1023.604545	317	397	1505	1	80	0.0125000
NODE_33503_length_539_cov_1023.604545	317	397	1507	1	80	0.0125000
NODE_33503_length_539_cov_1023.604545	317	397	1509	1	80	0.0125000
NODE_33503_length_539_cov_1023.604545	317	397	1511	1	80	0.0125000
NODE_33503_length_539_cov_1023.604545	317	397	1513	1	80	0.0125000
NODE_33503_length_539_cov_1023.604545	317	397	1516	1	80	0.0125000
NODE_33503_length_539_cov_1023.604545	317	397	1518	1	80	0.0125000
NODE_33503_length_539_cov_1023.604545	317	397	1523	1	80	0.0125000
NODE_33503_length_539_cov_1023.604545	317	397	1525	1	80	0.0125000
NODE_33503_length_539_cov_1023.604545	317	397	1528	1	80	0.0125000
NODE_33503_length_539_cov_1023.604545	317	397	1532	1	80	0.0125000
NODE_33503_length_539_cov_1023.604545	317	397	1534	1	80	0.0125000
NODE_33503_length_539_cov_1023.604545	317	397	1537	1	80	0.0125000
NODE_33503_length_539_cov_1023.604545	317	397	1538	1	80	0.0125000
NODE_33503_length_539_cov_1023.604545	317	397	1543	1	80	0.0125000
NODE_33503_length_539_cov_1023.604545	317	397	1544	1	80	0.0125000
NODE_33503_length_539_cov_1023.604545	317	397	1546	2	80	0.0250000
NODE_33503_length_539_cov_1023.604545	317	397	1548	2	80	0.0250000
NODE_33503_length_539_cov_1023.604545	317	397	1549	1	80	0.0125000
NODE_33503_length_539_cov_1023.604545	317	397	1550	4	80	0.0500000
NODE_33503_length_539_cov_1023.604545	317	397	1553	1	80	0.0125000
NODE_33503_length_539_cov_1023.604545	317	397	1554	1	80	0.0125000
NODE_33503_length_539_cov_1023.604545	317	397	1555	1	80	0.0125000
NODE_33503_length_539_cov_1023.604545	317	397	1556	1	80	0.0125000
NODE_33503_length_539_cov_1023.604545	317	397	1557	2	80	0.0250000
NODE_33503_length_539_cov_1023.604545	317	397	1564	2	80	0.0250000
NODE_33503_length_539_cov_1023.604545	317	397	1573	1	80	0.0125000
NODE_33503_length_539_cov_1023.604545	317	397	1574	1	80	0.0125000
NODE_33503_length_539_cov_1023.604545	317	397	1575	1	80	0.0125000
NODE_33503_length_539_cov_1023.604545	317	397	1578	1	80	0.0125000
NODE_33503_length_539_cov_1023.604545	317	397	1579	1	80	0.0125000
NODE_33503_length_539_cov_1023.604545	317	397	1586	1	80	0.0125000
NODE_33503_length_539_cov_1023.604545	317	397	1594	1	80	0.0125000
NODE_33503_length_539_cov_1023.604545	317	397	1606	1	80	0.0125000
NODE_33503_length_539_cov_1023.604545	317	397	1615	1	80	0.0125000
NODE_33503_length_539_cov_1023.604545	317	397	1617	1	80	0.0125000
NODE_33503_length_539_cov_1023.604545	317	397	1620	1	80	0.0125000
NODE_33503_length_539_cov_1023.604545	317	397	1638	2	80	0.0250000
NODE_33503_length_539_cov_1023.604545	317	397	1641	1	80	0.0125000
NODE_33503_length_539_cov_1023.604545	317	397	1644	1	80	0.0125000
NODE_33503_length_539_cov_1023.604545	317	397	1652	1	80	0.0125000
NODE_33503_length_539_cov_1023.604545	317	397	1653	1	80	0.0125000
NODE_33503_length_539_cov_1023.604545	317	397	1654	1	80	0.0125000
NODE_33503_length_539_cov_1023.604545	317	397	1656	1	80	0.0125000
NODE_33503_length_539_cov_1023.604545	317	397	1657	1	80	0.0125000
NODE_33503_length_539_cov_1023.604545	317	397	1661	1	80	0.0125000
NODE_33503_length_539_cov_1023.604545	317	397	1664	2	80	0.0250000
NODE_33504_length_539_cov_99.579545	478	539	0	61	61	1.0000000
NODE_33505_length_539_cov_15.247727	217	297	0	80	80	1.0000000
NODE_33505_length_539_cov_15.247727	270	350	0	80	80	1.0000000
NODE_33506_length_539_cov_14.172727	278	350	0	72	72	1.0000000
NODE_33507_length_539_cov_13.154545	118	198	0	80	80	1.0000000
NODE_33507_length_539_cov_13.154545	171	251	0	80	80	1.0000000
NODE_33508_length_539_cov_10.811364	48	128	0	32	80	0.4000000
NODE_33508_length_539_cov_10.811364	48	128	4	48	80	0.6000000
NODE_33508_length_539_cov_10.811364	101	181	4	80	80	1.0000000
NODE_33509_length_539_cov_9.563636	201	277	2	55	76	0.7236842
NODE_33509_length_539_cov_9.563636	201	277	4	21	76	0.2763158
NODE_33510_length_539_cov_7.934091	311	369	0	58	58	1.0000000
NODE_33510_length_539_cov_7.934091	342	422	0	46	80	0.5750000
NODE_33510_length_539_cov_7.934091	342	422	3	1	80	0.0125000
NODE_33510_length_539_cov_7.934091	342	422	4	33	80	0.4125000
NODE_33517_length_539_cov_5.740909	251	319	0	47	68	0.6911765
NODE_33517_length_539_cov_5.740909	251	319	2	21	68	0.3088235
NODE_33517_length_539_cov_5.740909	301	372	0	71	71	1.0000000
NODE_33533_length_539_cov_3.627273	80	157	0	77	77	1.0000000
NODE_33533_length_539_cov_3.627273	130	175	0	45	45	1.0000000
NODE_33569_length_539_cov_2.143182	325	371	2	46	46	1.0000000
NODE_33595_length_539_cov_1.618182	408	456	2	1	48	0.0208333
NODE_33595_length_539_cov_1.618182	408	456	4	47	48	0.9791667
NODE_33623_length_539_cov_1.129545	97	134	0	37	37	1.0000000
NODE_33669_length_538_cov_23.193622	171	256	0	85	85	1.0000000
NODE_33669_length_538_cov_23.193622	225	305	0	80	80	1.0000000
NODE_33672_length_538_cov_7.378132	145	225	0	80	80	1.0000000
NODE_33672_length_538_cov_7.378132	198	278	0	66	80	0.8250000
NODE_33672_length_538_cov_7.378132	198	278	3	14	80	0.1750000
NODE_33683_length_538_cov_4.496583	277	357	0	80	80	1.0000000
NODE_33683_length_538_cov_4.496583	330	410	0	80	80	1.0000000
NODE_33687_length_538_cov_3.753986	251	309	4	44	58	0.7586207
NODE_33687_length_538_cov_3.753986	251	309	6	14	58	0.2413793
NODE_33713_length_538_cov_2.239180	256	338	0	82	82	1.0000000
NODE_33814_length_538_cov_0.822323	397	477	0	80	80	1.0000000
NODE_33852_length_537_cov_13.031963	258	309	0	51	51	1.0000000
NODE_33854_length_537_cov_9.552511	198	278	0	80	80	1.0000000
NODE_33854_length_537_cov_9.552511	251	332	0	81	81	1.0000000
NODE_33960_length_537_cov_1.244292	107	187	6	11	80	0.1375000
NODE_33960_length_537_cov_1.244292	107	187	12	8	80	0.1000000
NODE_33960_length_537_cov_1.244292	107	187	14	2	80	0.0250000
NODE_33960_length_537_cov_1.244292	107	187	18	1	80	0.0125000
NODE_33960_length_537_cov_1.244292	107	187	22	1	80	0.0125000
NODE_33960_length_537_cov_1.244292	107	187	26	1	80	0.0125000
NODE_33960_length_537_cov_1.244292	107	187	30	4	80	0.0500000
NODE_33960_length_537_cov_1.244292	107	187	34	2	80	0.0250000
NODE_33960_length_537_cov_1.244292	107	187	36	6	80	0.0750000
NODE_33960_length_537_cov_1.244292	107	187	38	5	80	0.0625000
NODE_33960_length_537_cov_1.244292	107	187	40	1	80	0.0125000
NODE_33960_length_537_cov_1.244292	107	187	44	1	80	0.0125000
NODE_33960_length_537_cov_1.244292	107	187	50	1	80	0.0125000
NODE_33960_length_537_cov_1.244292	107	187	55	7	80	0.0875000
NODE_33960_length_537_cov_1.244292	107	187	57	1	80	0.0125000
NODE_33960_length_537_cov_1.244292	107	187	63	1	80	0.0125000
NODE_33960_length_537_cov_1.244292	107	187	65	5	80	0.0625000
NODE_33960_length_537_cov_1.244292	107	187	69	1	80	0.0125000
NODE_33960_length_537_cov_1.244292	107	187	71	3	80	0.0375000
NODE_33960_length_537_cov_1.244292	107	187	75	2	80	0.0250000
NODE_33960_length_537_cov_1.244292	107	187	77	1	80	0.0125000
NODE_33960_length_537_cov_1.244292	107	187	79	10	80	0.1250000
NODE_33960_length_537_cov_1.244292	107	187	81	4	80	0.0500000
NODE_33960_length_537_cov_1.244292	107	187	85	1	80	0.0125000
NODE_34029_length_536_cov_87.622426	430	462	87	1	32	0.0312500
NODE_34029_length_536_cov_87.622426	430	462	89	1	32	0.0312500
NODE_34029_length_536_cov_87.622426	430	462	91	1	32	0.0312500
NODE_34029_length_536_cov_87.622426	430	462	93	4	32	0.1250000
NODE_34029_length_536_cov_87.622426	430	462	95	7	32	0.2187500
NODE_34029_length_536_cov_87.622426	430	462	97	1	32	0.0312500
NODE_34029_length_536_cov_87.622426	430	462	99	1	32	0.0312500
NODE_34029_length_536_cov_87.622426	430	462	101	5	32	0.1562500
NODE_34029_length_536_cov_87.622426	430	462	102	5	32	0.1562500
NODE_34029_length_536_cov_87.622426	430	462	103	2	32	0.0625000
NODE_34029_length_536_cov_87.622426	430	462	105	4	32	0.1250000
NODE_34030_length_536_cov_11.629291	119	199	0	80	80	1.0000000
NODE_34030_length_536_cov_11.629291	172	252	0	80	80	1.0000000
NODE_34032_length_536_cov_6.613272	286	372	0	86	86	1.0000000
NODE_34035_length_536_cov_5.810069	191	271	0	80	80	1.0000000
NODE_34035_length_536_cov_5.810069	244	324	0	80	80	1.0000000
NODE_34035_length_536_cov_5.810069	374	404	0	30	30	1.0000000
NODE_34039_length_536_cov_4.729977	202	245	0	43	43	1.0000000
NODE_34057_length_536_cov_3.297483	86	126	2	40	40	1.0000000
NODE_34068_length_536_cov_2.796339	223	280	0	57	57	1.0000000
NODE_34094_length_536_cov_1.956522	181	230	14	1	49	0.0204082
NODE_34094_length_536_cov_1.956522	181	230	16	3	49	0.0612245
NODE_34094_length_536_cov_1.956522	181	230	18	6	49	0.1224490
NODE_34094_length_536_cov_1.956522	181	230	20	39	49	0.7959183
NODE_34095_length_536_cov_1.951945	203	284	13	2	81	0.0246914
NODE_34095_length_536_cov_1.951945	203	284	14	12	81	0.1481481
NODE_34095_length_536_cov_1.951945	203	284	15	31	81	0.3827161
NODE_34095_length_536_cov_1.951945	203	284	16	36	81	0.4444444
NODE_34095_length_536_cov_1.951945	306	368	1	7	62	0.1129032
NODE_34095_length_536_cov_1.951945	306	368	2	6	62	0.0967742
NODE_34095_length_536_cov_1.951945	306	368	3	1	62	0.0161290
NODE_34095_length_536_cov_1.951945	306	368	6	5	62	0.0806452
NODE_34095_length_536_cov_1.951945	306	368	8	6	62	0.0967742
NODE_34095_length_536_cov_1.951945	306	368	10	1	62	0.0161290
NODE_34095_length_536_cov_1.951945	306	368	11	1	62	0.0161290
NODE_34095_length_536_cov_1.951945	306	368	13	1	62	0.0161290
NODE_34095_length_536_cov_1.951945	306	368	14	34	62	0.5483871
NODE_34209_length_535_cov_32.277523	158	238	0	59	80	0.7375000
NODE_34209_length_535_cov_32.277523	158	238	6	21	80	0.2625000
NODE_34209_length_535_cov_32.277523	211	291	0	6	80	0.0750000
NODE_34209_length_535_cov_32.277523	211	291	6	23	80	0.2875000
NODE_34209_length_535_cov_32.277523	211	291	8	51	80	0.6375000
NODE_34215_length_535_cov_5.910550	110	162	2	52	52	1.0000000
NODE_34229_length_535_cov_3.795872	217	297	10	36	80	0.4500000
NODE_34229_length_535_cov_3.795872	217	297	11	44	80	0.5500000
NODE_34375_length_534_cov_54.331034	435	498	0	57	63	0.9047619
NODE_34375_length_534_cov_54.331034	435	498	6	1	63	0.0158730
NODE_34375_length_534_cov_54.331034	435	498	12	1	63	0.0158730
NODE_34375_length_534_cov_54.331034	435	498	40	2	63	0.0317460
NODE_34375_length_534_cov_54.331034	435	498	42	2	63	0.0317460
NODE_34375_length_534_cov_54.331034	471	534	0	63	63	1.0000000
NODE_34377_length_534_cov_15.462069	460	534	0	74	74	1.0000000
NODE_34377_length_534_cov_15.462069	512	534	0	22	22	1.0000000
NODE_34378_length_534_cov_10.308046	268	348	0	80	80	1.0000000
NODE_34378_length_534_cov_10.308046	321	401	0	80	80	1.0000000
NODE_34380_length_534_cov_9.041379	204	284	0	80	80	1.0000000
NODE_34380_length_534_cov_9.041379	257	332	0	75	75	1.0000000
NODE_34383_length_534_cov_6.958621	273	303	0	30	30	1.0000000
NODE_34392_length_534_cov_5.022989	291	371	0	18	80	0.2250000
NODE_34392_length_534_cov_5.022989	291	371	2	1	80	0.0125000
NODE_34392_length_534_cov_5.022989	291	371	4	41	80	0.5125000
NODE_34392_length_534_cov_5.022989	291	371	6	15	80	0.1875000
NODE_34392_length_534_cov_5.022989	291	371	10	5	80	0.0625000
NODE_34402_length_534_cov_3.873563	110	190	0	46	80	0.5750000
NODE_34402_length_534_cov_3.873563	110	190	2	34	80	0.4250000
NODE_34409_length_534_cov_3.202299	221	301	4	46	80	0.5750000
NODE_34409_length_534_cov_3.202299	221	301	8	5	80	0.0625000
NODE_34409_length_534_cov_3.202299	221	301	10	4	80	0.0500000
NODE_34409_length_534_cov_3.202299	221	301	12	2	80	0.0250000
NODE_34409_length_534_cov_3.202299	221	301	14	2	80	0.0250000
NODE_34409_length_534_cov_3.202299	221	301	16	21	80	0.2625000
NODE_34411_length_534_cov_3.158621	171	200	6	29	29	1.0000000
NODE_34418_length_534_cov_3.002299	175	219	0	44	44	1.0000000
NODE_34489_length_534_cov_1.344828	475	518	0	43	43	1.0000000
NODE_34494_length_534_cov_1.291954	273	336	0	1	63	0.0158730
NODE_34494_length_534_cov_1.291954	273	336	4	2	63	0.0317460
NODE_34494_length_534_cov_1.291954	273	336	8	6	63	0.0952381
NODE_34494_length_534_cov_1.291954	273	336	10	8	63	0.1269841
NODE_34494_length_534_cov_1.291954	273	336	12	46	63	0.7301587
NODE_34511_length_534_cov_1.160920	227	264	2	37	37	1.0000000
NODE_34570_length_533_cov_13.956221	216	296	0	80	80	1.0000000
NODE_34570_length_533_cov_13.956221	269	349	0	80	80	1.0000000
NODE_34575_length_533_cov_8.207373	244	322	0	29	78	0.3717949
NODE_34575_length_533_cov_8.207373	244	322	2	49	78	0.6282051
NODE_34576_length_533_cov_8.023041	230	310	0	51	80	0.6375000
NODE_34576_length_533_cov_8.023041	230	310	2	29	80	0.3625000
NODE_34576_length_533_cov_8.023041	283	364	2	81	81	1.0000000
NODE_34585_length_533_cov_5.170507	308	369	0	29	61	0.4754098
NODE_34585_length_533_cov_5.170507	308	369	2	3	61	0.0491803
NODE_34585_length_533_cov_5.170507	308	369	4	29	61	0.4754098
NODE_34588_length_533_cov_4.988479	229	309	0	80	80	1.0000000
NODE_34588_length_533_cov_4.988479	282	362	0	80	80	1.0000000
NODE_34600_length_533_cov_3.638249	201	265	0	64	64	1.0000000
NODE_34603_length_533_cov_3.511521	138	218	0	29	80	0.3625000
NODE_34603_length_533_cov_3.511521	138	218	2	51	80	0.6375000
NODE_34615_length_533_cov_3.073733	294	340	0	46	46	1.0000000
NODE_34617_length_533_cov_3.052995	256	304	0	48	48	1.0000000
NODE_34631_length_533_cov_2.366359	229	311	0	8	82	0.0975610
NODE_34631_length_533_cov_2.366359	229	311	1	23	82	0.2804878
NODE_34631_length_533_cov_2.366359	229	311	2	9	82	0.1097561
NODE_34631_length_533_cov_2.366359	229	311	4	10	82	0.1219512
NODE_34631_length_533_cov_2.366359	229	311	6	7	82	0.0853659
NODE_34631_length_533_cov_2.366359	229	311	12	25	82	0.3048781
NODE_34635_length_533_cov_2.288018	468	490	0	22	22	1.0000000
NODE_34767_length_532_cov_73.279446	0	64	2	4	64	0.0625000
NODE_34767_length_532_cov_73.279446	0	64	4	1	64	0.0156250
NODE_34767_length_532_cov_73.279446	0	64	8	1	64	0.0156250
NODE_34767_length_532_cov_73.279446	0	64	12	2	64	0.0312500
NODE_34767_length_532_cov_73.279446	0	64	14	2	64	0.0312500
NODE_34767_length_532_cov_73.279446	0	64	16	1	64	0.0156250
NODE_34767_length_532_cov_73.279446	0	64	18	4	64	0.0625000
NODE_34767_length_532_cov_73.279446	0	64	20	3	64	0.0468750
NODE_34767_length_532_cov_73.279446	0	64	28	2	64	0.0312500
NODE_34767_length_532_cov_73.279446	0	64	34	1	64	0.0156250
NODE_34767_length_532_cov_73.279446	0	64	38	5	64	0.0781250
NODE_34767_length_532_cov_73.279446	0	64	40	3	64	0.0468750
NODE_34767_length_532_cov_73.279446	0	64	42	2	64	0.0312500
NODE_34767_length_532_cov_73.279446	0	64	46	33	64	0.5156250
NODE_34768_length_532_cov_23.055427	168	248	0	80	80	1.0000000
NODE_34768_length_532_cov_23.055427	221	301	0	38	80	0.4750000
NODE_34768_length_532_cov_23.055427	221	301	3	2	80	0.0250000
NODE_34768_length_532_cov_23.055427	221	301	4	40	80	0.5000000
NODE_34769_length_532_cov_22.778291	256	336	0	27	80	0.3375000
NODE_34769_length_532_cov_22.778291	256	336	1	26	80	0.3250000
NODE_34769_length_532_cov_22.778291	256	336	2	27	80	0.3375000
NODE_34769_length_532_cov_22.778291	309	389	0	80	80	1.0000000
NODE_34770_length_532_cov_13.279446	85	165	0	43	80	0.5375000
NODE_34770_length_532_cov_13.279446	85	165	2	37	80	0.4625000
NODE_34770_length_532_cov_13.279446	138	218	0	18	80	0.2250000
NODE_34770_length_532_cov_13.279446	138	218	2	62	80	0.7750000
NODE_34774_length_532_cov_7.591224	171	235	0	64	64	1.0000000
NODE_34774_length_532_cov_7.591224	172	235	0	63	63	1.0000000
NODE_34774_length_532_cov_7.591224	173	226	0	53	53	1.0000000
NODE_34774_length_532_cov_7.591224	173	228	0	55	55	1.0000000
NODE_34774_length_532_cov_7.591224	208	282	0	74	74	1.0000000
NODE_34774_length_532_cov_7.591224	208	282	0	74	74	1.0000000
NODE_34774_length_532_cov_7.591224	208	282	0	74	74	1.0000000
NODE_34774_length_532_cov_7.591224	208	282	0	74	74	1.0000000
NODE_34788_length_532_cov_4.524249	84	151	0	67	67	1.0000000
NODE_34788_length_532_cov_4.524249	137	218	0	81	81	1.0000000
NODE_34838_length_532_cov_1.866051	263	309	0	46	46	1.0000000
NODE_34845_length_532_cov_1.757506	126	146	0	20	20	1.0000000
NODE_34948_length_531_cov_35.539352	7	45	0	24	38	0.6315789
NODE_34948_length_531_cov_35.539352	7	45	2	14	38	0.3684210
NODE_34948_length_531_cov_35.539352	18	98	0	13	80	0.1625000
NODE_34948_length_531_cov_35.539352	18	98	2	67	80	0.8375000
NODE_34949_length_531_cov_13.162037	129	209	0	21	80	0.2625000
NODE_34949_length_531_cov_13.162037	129	209	2	59	80	0.7375000
NODE_34949_length_531_cov_13.162037	182	251	2	69	69	1.0000000
NODE_34953_length_531_cov_6.821759	242	322	0	80	80	1.0000000
NODE_34953_length_531_cov_6.821759	295	375	0	80	80	1.0000000
NODE_34958_length_531_cov_5.261574	261	336	14	1	75	0.0133333
NODE_34958_length_531_cov_5.261574	261	336	16	7	75	0.0933333
NODE_34958_length_531_cov_5.261574	261	336	18	12	75	0.1600000
NODE_34958_length_531_cov_5.261574	261	336	20	8	75	0.1066667
NODE_34958_length_531_cov_5.261574	261	336	22	9	75	0.1200000
NODE_34958_length_531_cov_5.261574	261	336	23	1	75	0.0133333
NODE_34958_length_531_cov_5.261574	261	336	24	37	75	0.4933333
NODE_34958_length_531_cov_5.261574	309	362	12	1	53	0.0188679
NODE_34958_length_531_cov_5.261574	309	362	14	7	53	0.1320755
NODE_34958_length_531_cov_5.261574	309	362	16	10	53	0.1886792
NODE_34958_length_531_cov_5.261574	309	362	18	1	53	0.0188679
NODE_34958_length_531_cov_5.261574	309	362	20	8	53	0.1509434
NODE_34958_length_531_cov_5.261574	309	362	22	7	53	0.1320755
NODE_34958_length_531_cov_5.261574	309	362	23	1	53	0.0188679
NODE_34958_length_531_cov_5.261574	309	362	24	18	53	0.3396226
NODE_34963_length_531_cov_4.527778	177	255	0	78	78	1.0000000
NODE_34965_length_531_cov_4.319444	283	363	0	80	80	1.0000000
NODE_34965_length_531_cov_4.319444	336	416	0	80	80	1.0000000
NODE_34979_length_531_cov_3.488426	238	318	0	80	80	1.0000000
NODE_34979_length_531_cov_3.488426	291	371	0	80	80	1.0000000
NODE_34980_length_531_cov_3.375000	153	207	2	5	54	0.0925926
NODE_34980_length_531_cov_3.375000	153	207	4	9	54	0.1666667
NODE_34980_length_531_cov_3.375000	153	207	6	31	54	0.5740741
NODE_34980_length_531_cov_3.375000	153	207	8	9	54	0.1666667
NODE_34980_length_531_cov_3.375000	180	260	6	18	80	0.2250000
NODE_34980_length_531_cov_3.375000	180	260	8	10	80	0.1250000
NODE_34980_length_531_cov_3.375000	180	260	11	9	80	0.1125000
NODE_34980_length_531_cov_3.375000	180	260	13	6	80	0.0750000
NODE_34980_length_531_cov_3.375000	180	260	15	23	80	0.2875000
NODE_34980_length_531_cov_3.375000	180	260	16	8	80	0.1000000
NODE_34980_length_531_cov_3.375000	180	260	17	3	80	0.0375000
NODE_34980_length_531_cov_3.375000	180	260	18	3	80	0.0375000
NODE_34986_length_531_cov_3.111111	243	323	0	80	80	1.0000000
NODE_34986_length_531_cov_3.111111	296	376	0	80	80	1.0000000
NODE_35008_length_531_cov_2.201389	302	373	0	1	71	0.0140845
NODE_35008_length_531_cov_2.201389	302	373	2	70	71	0.9859155
NODE_35008_length_531_cov_2.201389	350	426	0	42	76	0.5526316
NODE_35008_length_531_cov_2.201389	350	426	2	34	76	0.4473684
NODE_35141_length_530_cov_30.605568	250	330	0	80	80	1.0000000
NODE_35141_length_530_cov_30.605568	303	383	0	62	80	0.7750000
NODE_35141_length_530_cov_30.605568	303	383	2	18	80	0.2250000
NODE_35142_length_530_cov_16.937355	404	484	2	1	80	0.0125000
NODE_35142_length_530_cov_16.937355	404	484	4	4	80	0.0500000
NODE_35142_length_530_cov_16.937355	404	484	6	2	80	0.0250000
NODE_35142_length_530_cov_16.937355	404	484	12	1	80	0.0125000
NODE_35142_length_530_cov_16.937355	404	484	14	1	80	0.0125000
NODE_35142_length_530_cov_16.937355	404	484	16	1	80	0.0125000
NODE_35142_length_530_cov_16.937355	404	484	18	2	80	0.0250000
NODE_35142_length_530_cov_16.937355	404	484	22	1	80	0.0125000
NODE_35142_length_530_cov_16.937355	404	484	24	8	80	0.1000000
NODE_35142_length_530_cov_16.937355	404	484	26	59	80	0.7375000
NODE_35142_length_530_cov_16.937355	457	530	2	3	73	0.0410959
NODE_35142_length_530_cov_16.937355	457	530	6	3	73	0.0410959
NODE_35142_length_530_cov_16.937355	457	530	8	4	73	0.0547945
NODE_35142_length_530_cov_16.937355	457	530	10	1	73	0.0136986
NODE_35142_length_530_cov_16.937355	457	530	14	7	73	0.0958904
NODE_35142_length_530_cov_16.937355	457	530	22	1	73	0.0136986
NODE_35142_length_530_cov_16.937355	457	530	24	4	73	0.0547945
NODE_35142_length_530_cov_16.937355	457	530	26	50	73	0.6849315
NODE_35143_length_530_cov_9.902552	273	353	0	80	80	1.0000000
NODE_35143_length_530_cov_9.902552	326	406	0	80	80	1.0000000
NODE_35144_length_530_cov_7.928074	46	126	0	80	80	1.0000000
NODE_35144_length_530_cov_7.928074	99	179	0	80	80	1.0000000
NODE_35150_length_530_cov_4.647332	188	268	0	56	80	0.7000000
NODE_35150_length_530_cov_4.647332	188	268	2	24	80	0.3000000
NODE_35150_length_530_cov_4.647332	241	321	0	80	80	1.0000000
NODE_35154_length_530_cov_4.389791	162	242	0	80	80	1.0000000
NODE_35159_length_530_cov_4.046404	76	111	0	35	35	1.0000000
NODE_35319_length_529_cov_38.983721	140	220	22	25	80	0.3125000
NODE_35319_length_529_cov_38.983721	140	220	24	30	80	0.3750000
NODE_35319_length_529_cov_38.983721	140	220	26	25	80	0.3125000
NODE_35320_length_529_cov_18.223256	189	269	0	14	80	0.1750000
NODE_35320_length_529_cov_18.223256	189	269	2	66	80	0.8250000
NODE_35320_length_529_cov_18.223256	242	322	0	39	80	0.4875000
NODE_35320_length_529_cov_18.223256	242	322	2	41	80	0.5125000
NODE_35321_length_529_cov_17.009302	358	438	0	21	80	0.2625000
NODE_35321_length_529_cov_17.009302	358	438	4	59	80	0.7375000
NODE_35321_length_529_cov_17.009302	411	491	0	74	80	0.9250000
NODE_35321_length_529_cov_17.009302	411	491	4	6	80	0.0750000
NODE_35331_length_529_cov_6.195349	211	291	0	9	80	0.1125000
NODE_35331_length_529_cov_6.195349	211	291	2	71	80	0.8875000
NODE_35331_length_529_cov_6.195349	264	322	0	40	58	0.6896552
NODE_35331_length_529_cov_6.195349	264	322	2	18	58	0.3103448
NODE_35336_length_529_cov_5.176744	139	207	2	58	68	0.8529412
NODE_35336_length_529_cov_5.176744	139	207	4	1	68	0.0147059
NODE_35336_length_529_cov_5.176744	139	207	5	5	68	0.0735294
NODE_35336_length_529_cov_5.176744	139	207	6	4	68	0.0588235
NODE_35336_length_529_cov_5.176744	185	260	2	12	75	0.1600000
NODE_35336_length_529_cov_5.176744	185	260	4	54	75	0.7200000
NODE_35336_length_529_cov_5.176744	185	260	5	5	75	0.0666667
NODE_35336_length_529_cov_5.176744	185	260	6	4	75	0.0533333
NODE_35364_length_529_cov_2.883721	223	281	0	30	58	0.5172414
NODE_35364_length_529_cov_2.883721	223	281	4	28	58	0.4827586
NODE_35374_length_529_cov_2.660465	89	168	0	58	79	0.7341772
NODE_35374_length_529_cov_2.660465	89	168	2	21	79	0.2658228
NODE_35375_length_529_cov_2.595349	278	321	0	43	43	1.0000000
NODE_35384_length_529_cov_2.272093	247	313	0	66	66	1.0000000
NODE_35427_length_529_cov_1.597674	289	332	0	43	43	1.0000000
NODE_35521_length_528_cov_25.808858	233	313	0	5	80	0.0625000
NODE_35521_length_528_cov_25.808858	233	313	4	75	80	0.9375000
NODE_35521_length_528_cov_25.808858	286	366	0	58	80	0.7250000
NODE_35521_length_528_cov_25.808858	286	366	4	22	80	0.2750000
NODE_35522_length_528_cov_17.331002	219	299	0	80	80	1.0000000
NODE_35522_length_528_cov_17.331002	272	352	0	80	80	1.0000000
NODE_35523_length_528_cov_16.165501	262	342	0	80	80	1.0000000
NODE_35523_length_528_cov_16.165501	315	395	0	80	80	1.0000000
NODE_35529_length_528_cov_5.776224	204	284	0	80	80	1.0000000
NODE_35529_length_528_cov_5.776224	257	337	0	60	80	0.7500000
NODE_35529_length_528_cov_5.776224	257	337	2	20	80	0.2500000
NODE_35542_length_528_cov_4.016317	235	315	0	80	80	1.0000000
NODE_35542_length_528_cov_4.016317	288	368	0	80	80	1.0000000
NODE_35545_length_528_cov_3.799534	144	192	0	48	48	1.0000000
NODE_35561_length_528_cov_2.902098	252	305	6	11	53	0.2075472
NODE_35561_length_528_cov_2.902098	252	305	8	42	53	0.7924528
NODE_35575_length_528_cov_2.324009	137	188	0	51	51	1.0000000
NODE_35575_length_528_cov_2.324009	161	241	0	80	80	1.0000000
NODE_35597_length_528_cov_1.755245	268	348	2	41	80	0.5125000
NODE_35597_length_528_cov_1.755245	268	348	4	20	80	0.2500000
NODE_35597_length_528_cov_1.755245	268	348	6	19	80	0.2375000
NODE_35597_length_528_cov_1.755245	321	401	4	61	80	0.7625000
NODE_35597_length_528_cov_1.755245	321	401	6	19	80	0.2375000
NODE_35687_length_527_cov_19.247664	306	386	0	80	80	1.0000000
NODE_35687_length_527_cov_19.247664	359	439	0	80	80	1.0000000
NODE_35688_length_527_cov_15.974299	250	349	0	99	99	1.0000000
NODE_35688_length_527_cov_15.974299	322	402	0	80	80	1.0000000
NODE_35691_length_527_cov_8.221963	235	315	0	13	80	0.1625000
NODE_35691_length_527_cov_8.221963	235	315	2	67	80	0.8375000
NODE_35691_length_527_cov_8.221963	288	368	0	14	80	0.1750000
NODE_35691_length_527_cov_8.221963	288	368	2	66	80	0.8250000
NODE_35693_length_527_cov_7.200935	190	270	0	80	80	1.0000000
NODE_35693_length_527_cov_7.200935	243	346	0	103	103	1.0000000
NODE_35693_length_527_cov_7.200935	342	422	0	80	80	1.0000000
NODE_35693_length_527_cov_7.200935	395	475	0	27	80	0.3375000
NODE_35693_length_527_cov_7.200935	395	475	2	53	80	0.6625000
NODE_35696_length_527_cov_6.862150	279	359	0	80	80	1.0000000
NODE_35697_length_527_cov_6.046729	155	235	0	80	80	1.0000000
NODE_35697_length_527_cov_6.046729	208	288	0	80	80	1.0000000
NODE_35736_length_527_cov_2.238318	226	306	2	37	80	0.4625000
NODE_35736_length_527_cov_2.238318	226	306	4	27	80	0.3375000
NODE_35736_length_527_cov_2.238318	226	306	5	16	80	0.2000000
NODE_35858_length_526_cov_50.866511	169	242	0	13	73	0.1780822
NODE_35858_length_526_cov_50.866511	169	242	2	60	73	0.8219178
NODE_35858_length_526_cov_50.866511	215	295	0	23	80	0.2875000
NODE_35858_length_526_cov_50.866511	215	295	2	57	80	0.7125000
NODE_35858_length_526_cov_50.866511	291	371	0	80	80	1.0000000
NODE_35858_length_526_cov_50.866511	344	424	0	80	80	1.0000000
NODE_35860_length_526_cov_26.395785	315	395	2	80	80	1.0000000
NODE_35860_length_526_cov_26.395785	368	448	0	53	80	0.6625000
NODE_35860_length_526_cov_26.395785	368	448	2	27	80	0.3375000
NODE_35861_length_526_cov_16.611241	305	385	6	80	80	1.0000000
NODE_35861_length_526_cov_16.611241	358	438	0	38	80	0.4750000
NODE_35861_length_526_cov_16.611241	358	438	4	3	80	0.0375000
NODE_35861_length_526_cov_16.611241	358	438	5	2	80	0.0250000
NODE_35861_length_526_cov_16.611241	358	438	6	37	80	0.4625000
NODE_35866_length_526_cov_6.215457	303	351	3	2	48	0.0416667
NODE_35866_length_526_cov_6.215457	303	351	5	1	48	0.0208333
NODE_35866_length_526_cov_6.215457	303	351	9	1	48	0.0208333
NODE_35866_length_526_cov_6.215457	303	351	10	1	48	0.0208333
NODE_35866_length_526_cov_6.215457	303	351	13	1	48	0.0208333
NODE_35866_length_526_cov_6.215457	303	351	16	3	48	0.0625000
NODE_35866_length_526_cov_6.215457	303	351	17	1	48	0.0208333
NODE_35866_length_526_cov_6.215457	303	351	18	1	48	0.0208333
NODE_35866_length_526_cov_6.215457	303	351	22	1	48	0.0208333
NODE_35866_length_526_cov_6.215457	303	351	26	7	48	0.1458333
NODE_35866_length_526_cov_6.215457	303	351	27	5	48	0.1041667
NODE_35866_length_526_cov_6.215457	303	351	28	1	48	0.0208333
NODE_35866_length_526_cov_6.215457	303	351	29	1	48	0.0208333
NODE_35866_length_526_cov_6.215457	303	351	30	2	48	0.0416667
NODE_35866_length_526_cov_6.215457	303	351	32	1	48	0.0208333
NODE_35866_length_526_cov_6.215457	303	351	36	3	48	0.0625000
NODE_35866_length_526_cov_6.215457	303	351	37	1	48	0.0208333
NODE_35866_length_526_cov_6.215457	303	351	38	1	48	0.0208333
NODE_35866_length_526_cov_6.215457	303	351	42	8	48	0.1666667
NODE_35866_length_526_cov_6.215457	303	351	47	1	48	0.0208333
NODE_35866_length_526_cov_6.215457	303	351	51	1	48	0.0208333
NODE_35866_length_526_cov_6.215457	303	351	53	1	48	0.0208333
NODE_35866_length_526_cov_6.215457	303	351	55	1	48	0.0208333
NODE_35866_length_526_cov_6.215457	303	351	57	1	48	0.0208333
NODE_35866_length_526_cov_6.215457	303	351	59	1	48	0.0208333
NODE_35877_length_526_cov_3.936768	118	142	0	2	24	0.0833333
NODE_35877_length_526_cov_3.936768	118	142	2	22	24	0.9166667
NODE_35877_length_526_cov_3.936768	118	163	0	2	45	0.0444444
NODE_35877_length_526_cov_3.936768	118	163	2	43	45	0.9555556
NODE_35901_length_526_cov_2.466042	138	184	0	46	46	1.0000000
NODE_36055_length_525_cov_33.910798	98	178	0	6	80	0.0750000
NODE_36055_length_525_cov_33.910798	98	178	2	19	80	0.2375000
NODE_36055_length_525_cov_33.910798	98	178	4	1	80	0.0125000
NODE_36055_length_525_cov_33.910798	98	178	8	1	80	0.0125000
NODE_36055_length_525_cov_33.910798	98	178	18	1	80	0.0125000
NODE_36055_length_525_cov_33.910798	98	178	20	3	80	0.0375000
NODE_36055_length_525_cov_33.910798	98	178	26	1	80	0.0125000
NODE_36055_length_525_cov_33.910798	98	178	34	1	80	0.0125000
NODE_36055_length_525_cov_33.910798	98	178	36	4	80	0.0500000
NODE_36055_length_525_cov_33.910798	98	178	38	10	80	0.1250000
NODE_36055_length_525_cov_33.910798	98	178	42	7	80	0.0875000
NODE_36055_length_525_cov_33.910798	98	178	44	2	80	0.0250000
NODE_36055_length_525_cov_33.910798	98	178	46	8	80	0.1000000
NODE_36055_length_525_cov_33.910798	98	178	52	16	80	0.2000000
NODE_36055_length_525_cov_33.910798	151	231	0	11	80	0.1375000
NODE_36055_length_525_cov_33.910798	151	231	2	67	80	0.8375000
NODE_36055_length_525_cov_33.910798	151	231	4	1	80	0.0125000
NODE_36055_length_525_cov_33.910798	151	231	8	1	80	0.0125000
NODE_36055_length_525_cov_33.910798	159	231	0	5	72	0.0694444
NODE_36055_length_525_cov_33.910798	159	231	2	67	72	0.9305556
NODE_36058_length_525_cov_8.788732	175	255	0	80	80	1.0000000
NODE_36058_length_525_cov_8.788732	228	308	0	80	80	1.0000000
NODE_36059_length_525_cov_7.880282	242	285	4	43	43	1.0000000
NODE_36098_length_525_cov_2.417840	229	306	0	77	77	1.0000000
NODE_36230_length_524_cov_21.649412	262	342	0	80	80	1.0000000
NODE_36230_length_524_cov_21.649412	315	395	0	80	80	1.0000000
NODE_36231_length_524_cov_14.131765	136	201	0	3	65	0.0461538
NODE_36231_length_524_cov_14.131765	136	201	6	62	65	0.9538462
NODE_36232_length_524_cov_10.392941	237	317	0	44	80	0.5500000
NODE_36232_length_524_cov_10.392941	237	317	2	11	80	0.1375000
NODE_36232_length_524_cov_10.392941	237	317	4	25	80	0.3125000
NODE_36232_length_524_cov_10.392941	290	370	2	2	80	0.0250000
NODE_36232_length_524_cov_10.392941	290	370	4	78	80	0.9750000
NODE_36262_length_524_cov_3.221176	195	272	0	29	77	0.3766234
NODE_36262_length_524_cov_3.221176	195	272	2	48	77	0.6233766
NODE_36262_length_524_cov_3.221176	253	324	0	2	71	0.0281690
NODE_36262_length_524_cov_3.221176	253	324	2	69	71	0.9718310
NODE_36264_length_524_cov_3.148235	317	397	0	80	80	1.0000000
NODE_36410_length_523_cov_113.438679	0	48	0	48	48	1.0000000
NODE_36410_length_523_cov_113.438679	14	69	0	55	55	1.0000000
NODE_36410_length_523_cov_113.438679	25	101	0	68	76	0.8947368
NODE_36410_length_523_cov_113.438679	25	101	4	8	76	0.1052632
NODE_36410_length_523_cov_113.438679	105	181	6	11	76	0.1447368
NODE_36410_length_523_cov_113.438679	105	181	7	3	76	0.0394737
NODE_36410_length_523_cov_113.438679	105	181	8	3	76	0.0394737
NODE_36410_length_523_cov_113.438679	105	181	10	3	76	0.0394737
NODE_36410_length_523_cov_113.438679	105	181	11	3	76	0.0394737
NODE_36410_length_523_cov_113.438679	105	181	12	1	76	0.0131579
NODE_36410_length_523_cov_113.438679	105	181	15	1	76	0.0131579
NODE_36410_length_523_cov_113.438679	105	181	16	1	76	0.0131579
NODE_36410_length_523_cov_113.438679	105	181	23	1	76	0.0131579
NODE_36410_length_523_cov_113.438679	105	181	24	1	76	0.0131579
NODE_36410_length_523_cov_113.438679	105	181	26	2	76	0.0263158
NODE_36410_length_523_cov_113.438679	105	181	28	5	76	0.0657895
NODE_36410_length_523_cov_113.438679	105	181	30	15	76	0.1973684
NODE_36410_length_523_cov_113.438679	105	181	34	1	76	0.0131579
NODE_36410_length_523_cov_113.438679	105	181	35	4	76	0.0526316
NODE_36410_length_523_cov_113.438679	105	181	36	19	76	0.2500000
NODE_36410_length_523_cov_113.438679	105	181	37	2	76	0.0263158
NODE_36410_length_523_cov_113.438679	154	234	30	1	80	0.0125000
NODE_36410_length_523_cov_113.438679	154	234	34	1	80	0.0125000
NODE_36410_length_523_cov_113.438679	154	234	35	4	80	0.0500000
NODE_36410_length_523_cov_113.438679	154	234	36	19	80	0.2375000
NODE_36410_length_523_cov_113.438679	154	234	37	6	80	0.0750000
NODE_36410_length_523_cov_113.438679	154	234	39	3	80	0.0375000
NODE_36410_length_523_cov_113.438679	154	234	42	1	80	0.0125000
NODE_36410_length_523_cov_113.438679	154	234	43	8	80	0.1000000
NODE_36410_length_523_cov_113.438679	154	234	44	13	80	0.1625000
NODE_36410_length_523_cov_113.438679	154	234	46	1	80	0.0125000
NODE_36410_length_523_cov_113.438679	154	234	47	9	80	0.1125000
NODE_36410_length_523_cov_113.438679	154	234	49	8	80	0.1000000
NODE_36410_length_523_cov_113.438679	154	234	50	1	80	0.0125000
NODE_36410_length_523_cov_113.438679	154	234	51	5	80	0.0625000
NODE_36410_length_523_cov_113.438679	312	355	14	6	43	0.1395349
NODE_36410_length_523_cov_113.438679	312	355	15	7	43	0.1627907
NODE_36410_length_523_cov_113.438679	312	355	16	12	43	0.2790698
NODE_36410_length_523_cov_113.438679	312	355	17	17	43	0.3953488
NODE_36410_length_523_cov_113.438679	312	355	18	1	43	0.0232558
NODE_36412_length_523_cov_64.695755	35	115	0	80	80	1.0000000
NODE_36412_length_523_cov_64.695755	88	168	0	80	80	1.0000000
NODE_36414_length_523_cov_20.724057	235	315	2	30	80	0.3750000
NODE_36414_length_523_cov_20.724057	235	315	4	50	80	0.6250000
NODE_36414_length_523_cov_20.724057	288	368	0	7	80	0.0875000
NODE_36414_length_523_cov_20.724057	288	368	2	34	80	0.4250000
NODE_36414_length_523_cov_20.724057	288	368	4	39	80	0.4875000
NODE_36415_length_523_cov_18.500000	164	244	0	23	80	0.2875000
NODE_36415_length_523_cov_18.500000	164	244	2	25	80	0.3125000
NODE_36415_length_523_cov_18.500000	164	244	4	32	80	0.4000000
NODE_36415_length_523_cov_18.500000	217	297	4	80	80	1.0000000
NODE_36416_length_523_cov_15.216981	62	142	0	80	80	1.0000000
NODE_36416_length_523_cov_15.216981	115	195	0	80	80	1.0000000
NODE_36417_length_523_cov_10.575472	157	183	0	26	26	1.0000000
NODE_36418_length_523_cov_9.962264	212	292	0	80	80	1.0000000
NODE_36418_length_523_cov_9.962264	265	345	0	80	80	1.0000000
NODE_36427_length_523_cov_4.943396	108	188	4	16	80	0.2000000
NODE_36427_length_523_cov_4.943396	108	188	7	11	80	0.1375000
NODE_36427_length_523_cov_4.943396	108	188	8	24	80	0.3000000
NODE_36427_length_523_cov_4.943396	108	188	10	22	80	0.2750000
NODE_36427_length_523_cov_4.943396	108	188	12	7	80	0.0875000
NODE_36427_length_523_cov_4.943396	161	241	8	4	80	0.0500000
NODE_36427_length_523_cov_4.943396	161	241	10	21	80	0.2625000
NODE_36427_length_523_cov_4.943396	161	241	11	15	80	0.1875000
NODE_36427_length_523_cov_4.943396	161	241	12	19	80	0.2375000
NODE_36427_length_523_cov_4.943396	161	241	13	19	80	0.2375000
NODE_36427_length_523_cov_4.943396	161	241	15	2	80	0.0250000
NODE_36429_length_523_cov_4.787736	110	141	10	8	31	0.2580645
NODE_36429_length_523_cov_4.787736	110	141	12	21	31	0.6774194
NODE_36429_length_523_cov_4.787736	110	141	14	2	31	0.0645161
NODE_36429_length_523_cov_4.787736	131	194	8	5	63	0.0793651
NODE_36429_length_523_cov_4.787736	131	194	10	17	63	0.2698413
NODE_36429_length_523_cov_4.787736	131	194	12	8	63	0.1269841
NODE_36429_length_523_cov_4.787736	131	194	14	7	63	0.1111111
NODE_36429_length_523_cov_4.787736	131	194	16	26	63	0.4126984
NODE_36439_length_523_cov_3.792453	139	219	0	80	80	1.0000000
NODE_36439_length_523_cov_3.792453	192	272	0	80	80	1.0000000
NODE_36481_length_523_cov_2.259434	337	372	0	35	35	1.0000000
NODE_36490_length_523_cov_2.096698	307	351	2	8	44	0.1818182
NODE_36490_length_523_cov_2.096698	307	351	4	4	44	0.0909091
NODE_36490_length_523_cov_2.096698	307	351	10	8	44	0.1818182
NODE_36490_length_523_cov_2.096698	307	351	14	6	44	0.1363636
NODE_36490_length_523_cov_2.096698	307	351	16	2	44	0.0454545
NODE_36490_length_523_cov_2.096698	307	351	19	12	44	0.2727273
NODE_36490_length_523_cov_2.096698	307	351	20	2	44	0.0454545
NODE_36490_length_523_cov_2.096698	307	351	21	2	44	0.0454545
NODE_36518_length_523_cov_1.700472	176	195	0	19	19	1.0000000
NODE_36632_length_522_cov_33.579196	55	135	0	14	80	0.1750000
NODE_36632_length_522_cov_33.579196	55	135	2	9	80	0.1125000
NODE_36632_length_522_cov_33.579196	55	135	6	57	80	0.7125000
NODE_36632_length_522_cov_33.579196	108	188	0	9	80	0.1125000
NODE_36632_length_522_cov_33.579196	108	188	3	27	80	0.3375000
NODE_36632_length_522_cov_33.579196	108	188	5	6	80	0.0750000
NODE_36632_length_522_cov_33.579196	108	188	6	38	80	0.4750000
NODE_36634_length_522_cov_12.851064	266	342	0	76	76	1.0000000
NODE_36634_length_522_cov_12.851064	319	395	0	76	76	1.0000000
NODE_36637_length_522_cov_7.349882	212	283	2	71	71	1.0000000
NODE_36637_length_522_cov_7.349882	400	469	0	69	69	1.0000000
NODE_36670_length_522_cov_2.933806	178	258	0	80	80	1.0000000
NODE_36670_length_522_cov_2.933806	231	311	0	80	80	1.0000000
NODE_36676_length_522_cov_2.661939	187	241	0	32	54	0.5925926
NODE_36676_length_522_cov_2.661939	187	241	2	22	54	0.4074074
NODE_36820_length_521_cov_9.303318	106	186	0	47	80	0.5875000
NODE_36820_length_521_cov_9.303318	106	186	2	33	80	0.4125000
NODE_36820_length_521_cov_9.303318	159	239	2	80	80	1.0000000
NODE_36832_length_521_cov_4.971564	218	298	0	80	80	1.0000000
NODE_36832_length_521_cov_4.971564	271	351	0	80	80	1.0000000
NODE_36845_length_521_cov_3.504739	113	191	0	78	78	1.0000000
NODE_36845_length_521_cov_3.504739	164	205	0	41	41	1.0000000
NODE_36848_length_521_cov_3.324645	158	244	0	40	86	0.4651163
NODE_36848_length_521_cov_3.324645	158	244	2	46	86	0.5348837
NODE_36848_length_521_cov_3.324645	217	280	0	11	63	0.1746032
NODE_36848_length_521_cov_3.324645	217	280	2	52	63	0.8253968
NODE_36916_length_521_cov_1.613744	165	227	0	62	62	1.0000000
NODE_37036_length_520_cov_50.676960	0	75	0	75	75	1.0000000
NODE_37036_length_520_cov_50.676960	48	128	0	80	80	1.0000000
NODE_37036_length_520_cov_50.676960	124	204	0	55	80	0.6875000
NODE_37036_length_520_cov_50.676960	124	204	2	8	80	0.1000000
NODE_37036_length_520_cov_50.676960	124	204	4	17	80	0.2125000
NODE_37036_length_520_cov_50.676960	177	257	0	2	80	0.0250000
NODE_37036_length_520_cov_50.676960	177	257	2	8	80	0.1000000
NODE_37036_length_520_cov_50.676960	177	257	4	70	80	0.8750000
NODE_37037_length_520_cov_43.294537	10	90	0	24	80	0.3000000
NODE_37037_length_520_cov_43.294537	10	90	2	1	80	0.0125000
NODE_37037_length_520_cov_43.294537	10	90	4	9	80	0.1125000
NODE_37037_length_520_cov_43.294537	10	90	6	46	80	0.5750000
NODE_37037_length_520_cov_43.294537	10	90	0	24	80	0.3000000
NODE_37037_length_520_cov_43.294537	10	90	2	1	80	0.0125000
NODE_37037_length_520_cov_43.294537	10	90	4	9	80	0.1125000
NODE_37037_length_520_cov_43.294537	10	90	6	46	80	0.5750000
NODE_37037_length_520_cov_43.294537	10	90	0	24	80	0.3000000
NODE_37037_length_520_cov_43.294537	10	90	2	1	80	0.0125000
NODE_37037_length_520_cov_43.294537	10	90	4	9	80	0.1125000
NODE_37037_length_520_cov_43.294537	10	90	6	46	80	0.5750000
NODE_37037_length_520_cov_43.294537	10	90	0	24	80	0.3000000
NODE_37037_length_520_cov_43.294537	10	90	2	1	80	0.0125000
NODE_37037_length_520_cov_43.294537	10	90	4	9	80	0.1125000
NODE_37037_length_520_cov_43.294537	10	90	6	46	80	0.5750000
NODE_37037_length_520_cov_43.294537	10	90	0	24	80	0.3000000
NODE_37037_length_520_cov_43.294537	10	90	2	1	80	0.0125000
NODE_37037_length_520_cov_43.294537	10	90	4	9	80	0.1125000
NODE_37037_length_520_cov_43.294537	10	90	6	46	80	0.5750000
NODE_37037_length_520_cov_43.294537	10	90	0	24	80	0.3000000
NODE_37037_length_520_cov_43.294537	10	90	2	1	80	0.0125000
NODE_37037_length_520_cov_43.294537	10	90	4	9	80	0.1125000
NODE_37037_length_520_cov_43.294537	10	90	6	46	80	0.5750000
NODE_37037_length_520_cov_43.294537	63	129	0	1	66	0.0151515
NODE_37037_length_520_cov_43.294537	63	129	2	20	66	0.3030303
NODE_37037_length_520_cov_43.294537	63	129	6	45	66	0.6818182
NODE_37037_length_520_cov_43.294537	63	142	0	14	79	0.1772152
NODE_37037_length_520_cov_43.294537	63	142	2	20	79	0.2531646
NODE_37037_length_520_cov_43.294537	63	142	6	45	79	0.5696203
NODE_37037_length_520_cov_43.294537	63	143	0	15	80	0.1875000
NODE_37037_length_520_cov_43.294537	63	143	2	20	80	0.2500000
NODE_37037_length_520_cov_43.294537	63	143	6	45	80	0.5625000
NODE_37037_length_520_cov_43.294537	63	133	0	5	70	0.0714286
NODE_37037_length_520_cov_43.294537	63	133	2	20	70	0.2857143
NODE_37037_length_520_cov_43.294537	63	133	6	45	70	0.6428571
NODE_37037_length_520_cov_43.294537	66	133	0	5	67	0.0746269
NODE_37037_length_520_cov_43.294537	66	133	2	20	67	0.2985075
NODE_37037_length_520_cov_43.294537	66	133	6	42	67	0.6268657
NODE_37037_length_520_cov_43.294537	68	143	0	15	75	0.2000000
NODE_37037_length_520_cov_43.294537	68	143	2	20	75	0.2666667
NODE_37037_length_520_cov_43.294537	68	143	6	40	75	0.5333334
NODE_37038_length_520_cov_29.427553	224	304	0	18	80	0.2250000
NODE_37038_length_520_cov_29.427553	224	304	4	62	80	0.7750000
NODE_37038_length_520_cov_29.427553	277	357	0	68	80	0.8500000
NODE_37038_length_520_cov_29.427553	277	357	4	12	80	0.1500000
NODE_37038_length_520_cov_29.427553	353	433	0	80	80	1.0000000
NODE_37038_length_520_cov_29.427553	406	486	0	80	80	1.0000000
NODE_37039_length_520_cov_14.365796	103	183	0	49	80	0.6125000
NODE_37039_length_520_cov_14.365796	103	183	4	31	80	0.3875000
NODE_37039_length_520_cov_14.365796	156	237	4	81	81	1.0000000
NODE_37059_length_520_cov_4.121140	79	159	0	80	80	1.0000000
NODE_37059_length_520_cov_4.121140	132	212	0	80	80	1.0000000
NODE_37063_length_520_cov_3.900238	203	233	0	30	30	1.0000000
NODE_37235_length_519_cov_42.842857	8	88	6	18	80	0.2250000
NODE_37235_length_519_cov_42.842857	8	88	8	3	80	0.0375000
NODE_37235_length_519_cov_42.842857	8	88	12	4	80	0.0500000
NODE_37235_length_519_cov_42.842857	8	88	14	13	80	0.1625000
NODE_37235_length_519_cov_42.842857	8	88	18	8	80	0.1000000
NODE_37235_length_519_cov_42.842857	8	88	20	23	80	0.2875000
NODE_37235_length_519_cov_42.842857	8	88	22	11	80	0.1375000
NODE_37235_length_519_cov_42.842857	61	139	12	7	78	0.0897436
NODE_37235_length_519_cov_42.842857	61	139	14	16	78	0.2051282
NODE_37235_length_519_cov_42.842857	61	139	16	1	78	0.0128205
NODE_37235_length_519_cov_42.842857	61	139	18	6	78	0.0769231
NODE_37235_length_519_cov_42.842857	61	139	20	18	78	0.2307692
NODE_37235_length_519_cov_42.842857	61	139	22	17	78	0.2179487
NODE_37235_length_519_cov_42.842857	61	139	24	12	78	0.1538462
NODE_37235_length_519_cov_42.842857	61	139	26	1	78	0.0128205
NODE_37236_length_519_cov_19.269048	284	363	0	71	79	0.8987342
NODE_37236_length_519_cov_19.269048	284	363	2	8	79	0.1012658
NODE_37236_length_519_cov_19.269048	336	416	0	80	80	1.0000000
NODE_37237_length_519_cov_8.500000	195	267	0	65	72	0.9027778
NODE_37237_length_519_cov_8.500000	195	267	2	7	72	0.0972222
NODE_37245_length_519_cov_5.169048	282	346	0	64	64	1.0000000
NODE_37290_length_519_cov_2.783333	174	235	0	61	61	1.0000000
NODE_37349_length_519_cov_1.538095	147	213	0	66	66	1.0000000
NODE_37447_length_518_cov_40.026253	385	465	0	80	80	1.0000000
NODE_37447_length_518_cov_40.026253	438	518	0	80	80	1.0000000
NODE_37449_length_518_cov_12.083532	144	224	0	8	80	0.1000000
NODE_37449_length_518_cov_12.083532	144	224	2	18	80	0.2250000
NODE_37449_length_518_cov_12.083532	144	224	4	11	80	0.1375000
NODE_37449_length_518_cov_12.083532	144	224	8	2	80	0.0250000
NODE_37449_length_518_cov_12.083532	144	224	12	41	80	0.5125000
NODE_37449_length_518_cov_12.083532	197	277	12	80	80	1.0000000
NODE_37449_length_518_cov_12.083532	407	481	0	74	74	1.0000000
NODE_37449_length_518_cov_12.083532	454	518	0	64	64	1.0000000
NODE_37450_length_518_cov_11.467780	171	200	0	18	29	0.6206896
NODE_37450_length_518_cov_11.467780	171	200	2	11	29	0.3793103
NODE_37450_length_518_cov_11.467780	253	320	0	9	67	0.1343284
NODE_37450_length_518_cov_11.467780	253	320	2	58	67	0.8656716
NODE_37450_length_518_cov_11.467780	253	282	2	29	29	1.0000000
NODE_37454_length_518_cov_7.441527	188	273	0	85	85	1.0000000
NODE_37461_length_518_cov_5.563246	315	366	0	51	51	1.0000000
NODE_37461_length_518_cov_5.563246	339	383	0	44	44	1.0000000
NODE_37465_length_518_cov_4.732697	214	276	8	11	62	0.1774193
NODE_37465_length_518_cov_4.732697	214	276	9	1	62	0.0161290
NODE_37465_length_518_cov_4.732697	214	276	10	50	62	0.8064516
NODE_37465_length_518_cov_4.732697	350	430	0	80	80	1.0000000
NODE_37479_length_518_cov_3.503580	291	333	0	8	42	0.1904762
NODE_37479_length_518_cov_3.503580	291	333	2	34	42	0.8095238
NODE_37479_length_518_cov_3.503580	306	363	2	57	57	1.0000000
NODE_37483_length_518_cov_3.136038	269	338	2	7	69	0.1014493
NODE_37483_length_518_cov_3.136038	269	338	4	21	69	0.3043478
NODE_37483_length_518_cov_3.136038	269	338	6	41	69	0.5942029
NODE_37483_length_518_cov_3.136038	269	348	2	7	79	0.0886076
NODE_37483_length_518_cov_3.136038	269	348	4	21	79	0.2658228
NODE_37483_length_518_cov_3.136038	269	348	6	51	79	0.6455696
NODE_37483_length_518_cov_3.136038	269	349	2	7	80	0.0875000
NODE_37483_length_518_cov_3.136038	269	349	4	21	80	0.2625000
NODE_37483_length_518_cov_3.136038	269	349	6	52	80	0.6500000
NODE_37483_length_518_cov_3.136038	322	402	0	28	80	0.3500000
NODE_37483_length_518_cov_3.136038	322	402	2	9	80	0.1125000
NODE_37483_length_518_cov_3.136038	322	402	4	5	80	0.0625000
NODE_37483_length_518_cov_3.136038	322	402	6	38	80	0.4750000
NODE_37483_length_518_cov_3.136038	322	364	4	4	42	0.0952381
NODE_37483_length_518_cov_3.136038	322	364	6	38	42	0.9047619
NODE_37483_length_518_cov_3.136038	322	368	2	3	46	0.0652174
NODE_37483_length_518_cov_3.136038	322	368	4	5	46	0.1086956
NODE_37483_length_518_cov_3.136038	322	368	6	38	46	0.8260869
NODE_37483_length_518_cov_3.136038	331	366	2	1	35	0.0285714
NODE_37483_length_518_cov_3.136038	331	366	4	5	35	0.1428571
NODE_37483_length_518_cov_3.136038	331	366	6	29	35	0.8285714
NODE_37637_length_517_cov_55.267943	177	257	0	80	80	1.0000000
NODE_37637_length_517_cov_55.267943	230	310	0	80	80	1.0000000
NODE_37639_length_517_cov_30.863636	0	72	0	52	72	0.7222222
NODE_37639_length_517_cov_30.863636	0	72	3	20	72	0.2777778
NODE_37639_length_517_cov_30.863636	0	72	0	52	72	0.7222222
NODE_37639_length_517_cov_30.863636	0	72	3	20	72	0.2777778
NODE_37639_length_517_cov_30.863636	45	125	0	7	80	0.0875000
NODE_37639_length_517_cov_30.863636	45	125	2	2	80	0.0250000
NODE_37639_length_517_cov_30.863636	45	125	3	71	80	0.8875000
NODE_37639_length_517_cov_30.863636	45	99	0	7	54	0.1296296
NODE_37639_length_517_cov_30.863636	45	99	2	2	54	0.0370370
NODE_37639_length_517_cov_30.863636	45	99	3	45	54	0.8333333
NODE_37641_length_517_cov_12.258373	305	385	0	5	80	0.0625000
NODE_37641_length_517_cov_12.258373	305	385	2	75	80	0.9375000
NODE_37641_length_517_cov_12.258373	358	438	0	58	80	0.7250000
NODE_37641_length_517_cov_12.258373	358	438	2	22	80	0.2750000
NODE_37643_length_517_cov_7.131579	100	152	0	32	52	0.6153846
NODE_37643_length_517_cov_7.131579	100	152	2	20	52	0.3846154
NODE_37662_length_517_cov_4.492823	140	220	0	80	80	1.0000000
NODE_37662_length_517_cov_4.492823	193	273	0	80	80	1.0000000
NODE_37697_length_517_cov_2.437799	331	388	0	8	57	0.1403509
NODE_37697_length_517_cov_2.437799	331	388	4	25	57	0.4385965
NODE_37697_length_517_cov_2.437799	331	388	6	24	57	0.4210526
NODE_37850_length_516_cov_17.570743	147	227	0	80	80	1.0000000
NODE_37850_length_516_cov_17.570743	200	280	0	80	80	1.0000000
NODE_37861_length_516_cov_5.268585	402	448	0	46	46	1.0000000
NODE_37862_length_516_cov_5.067146	114	194	0	80	80	1.0000000
NODE_37862_length_516_cov_5.067146	167	247	0	80	80	1.0000000
NODE_37864_length_516_cov_4.788969	156	236	0	80	80	1.0000000
NODE_37864_length_516_cov_4.788969	209	277	0	68	68	1.0000000
NODE_37881_length_516_cov_3.167866	48	93	0	45	45	1.0000000
NODE_37881_length_516_cov_3.167866	103	177	0	74	74	1.0000000
NODE_38044_length_515_cov_69.442308	177	257	0	49	80	0.6125000
NODE_38044_length_515_cov_69.442308	177	257	2	31	80	0.3875000
NODE_38044_length_515_cov_69.442308	177	257	0	49	80	0.6125000
NODE_38044_length_515_cov_69.442308	177	257	2	31	80	0.3875000
NODE_38044_length_515_cov_69.442308	177	257	0	49	80	0.6125000
NODE_38044_length_515_cov_69.442308	177	257	2	31	80	0.3875000
NODE_38044_length_515_cov_69.442308	230	291	2	61	61	1.0000000
NODE_38044_length_515_cov_69.442308	230	308	2	78	78	1.0000000
NODE_38044_length_515_cov_69.442308	235	308	2	73	73	1.0000000
NODE_38045_length_515_cov_13.271635	168	248	0	8	80	0.1000000
NODE_38045_length_515_cov_13.271635	168	248	2	72	80	0.9000000
NODE_38045_length_515_cov_13.271635	221	301	0	61	80	0.7625000
NODE_38045_length_515_cov_13.271635	221	301	2	19	80	0.2375000
NODE_38048_length_515_cov_8.314904	213	290	0	77	77	1.0000000
NODE_38054_length_515_cov_5.487981	317	402	2	9	85	0.1058824
NODE_38054_length_515_cov_5.487981	317	402	4	15	85	0.1764706
NODE_38054_length_515_cov_5.487981	317	402	8	12	85	0.1411765
NODE_38054_length_515_cov_5.487981	317	402	9	15	85	0.1764706
NODE_38054_length_515_cov_5.487981	317	402	10	28	85	0.3294118
NODE_38054_length_515_cov_5.487981	317	402	11	6	85	0.0705882
NODE_38242_length_514_cov_26.910843	170	250	0	80	80	1.0000000
NODE_38242_length_514_cov_26.910843	223	303	0	80	80	1.0000000
NODE_38243_length_514_cov_12.775904	85	149	0	64	64	1.0000000
NODE_38243_length_514_cov_12.775904	123	202	0	79	79	1.0000000
NODE_38244_length_514_cov_11.156627	124	204	0	25	80	0.3125000
NODE_38244_length_514_cov_11.156627	124	204	4	55	80	0.6875000
NODE_38244_length_514_cov_11.156627	177	257	0	15	80	0.1875000
NODE_38244_length_514_cov_11.156627	177	257	4	65	80	0.8125000
NODE_38253_length_514_cov_5.802410	165	217	0	10	52	0.1923077
NODE_38253_length_514_cov_5.802410	165	217	2	42	52	0.8076923
NODE_38253_length_514_cov_5.802410	190	270	2	80	80	1.0000000
NODE_38254_length_514_cov_5.554217	192	272	0	80	80	1.0000000
NODE_38254_length_514_cov_5.554217	294	340	0	8	46	0.1739130
NODE_38254_length_514_cov_5.554217	294	340	2	38	46	0.8260869
NODE_38257_length_514_cov_5.322892	230	260	0	30	30	1.0000000
NODE_38262_length_514_cov_4.337349	220	300	0	80	80	1.0000000
NODE_38286_length_514_cov_3.012048	264	328	0	61	64	0.9531250
NODE_38286_length_514_cov_3.012048	264	328	2	3	64	0.0468750
NODE_38432_length_513_cov_14.613527	118	198	0	65	80	0.8125000
NODE_38432_length_513_cov_14.613527	118	198	2	15	80	0.1875000
NODE_38432_length_513_cov_14.613527	171	251	0	12	80	0.1500000
NODE_38432_length_513_cov_14.613527	171	251	2	55	80	0.6875000
NODE_38432_length_513_cov_14.613527	171	251	4	13	80	0.1625000
NODE_38433_length_513_cov_9.898551	253	333	0	80	80	1.0000000
NODE_38433_length_513_cov_9.898551	306	386	0	55	80	0.6875000
NODE_38433_length_513_cov_9.898551	306	386	2	25	80	0.3125000
NODE_38434_length_513_cov_9.164251	185	265	0	80	80	1.0000000
NODE_38434_length_513_cov_9.164251	238	318	0	80	80	1.0000000
NODE_38441_length_513_cov_6.123188	284	364	2	44	80	0.5500000
NODE_38441_length_513_cov_6.123188	284	364	4	36	80	0.4500000
NODE_38441_length_513_cov_6.123188	337	417	2	66	80	0.8250000
NODE_38441_length_513_cov_6.123188	337	417	4	14	80	0.1750000
NODE_38460_length_513_cov_3.456522	283	350	2	2	67	0.0298507
NODE_38460_length_513_cov_3.456522	283	350	4	4	67	0.0597015
NODE_38460_length_513_cov_3.456522	283	350	6	1	67	0.0149254
NODE_38460_length_513_cov_3.456522	283	350	8	60	67	0.8955224
NODE_38460_length_513_cov_3.456522	336	398	4	16	62	0.2580645
NODE_38460_length_513_cov_3.456522	336	398	6	16	62	0.2580645
NODE_38460_length_513_cov_3.456522	336	398	8	30	62	0.4838710
NODE_38482_length_513_cov_2.309179	134	174	0	40	40	1.0000000
NODE_38482_length_513_cov_2.309179	170	223	0	53	53	1.0000000
NODE_38482_length_513_cov_2.309179	238	285	0	47	47	1.0000000
NODE_38515_length_513_cov_1.671498	427	476	0	49	49	1.0000000
NODE_38646_length_512_cov_45.070218	34	114	0	80	80	1.0000000
NODE_38646_length_512_cov_45.070218	87	167	0	80	80	1.0000000
NODE_38647_length_512_cov_39.639225	323	404	0	81	81	1.0000000
NODE_38647_length_512_cov_39.639225	377	457	0	80	80	1.0000000
NODE_38648_length_512_cov_8.581114	192	256	2	1	64	0.0156250
NODE_38648_length_512_cov_8.581114	192	256	6	39	64	0.6093750
NODE_38648_length_512_cov_8.581114	192	256	8	4	64	0.0625000
NODE_38648_length_512_cov_8.581114	192	256	10	20	64	0.3125000
NODE_38661_length_512_cov_4.869249	327	407	0	46	80	0.5750000
NODE_38661_length_512_cov_4.869249	327	407	4	34	80	0.4250000
NODE_38661_length_512_cov_4.869249	380	460	4	80	80	1.0000000
NODE_38668_length_512_cov_4.157385	161	204	0	43	43	1.0000000
NODE_38668_length_512_cov_4.157385	178	257	0	79	79	1.0000000
NODE_38677_length_512_cov_3.435835	138	218	0	80	80	1.0000000
NODE_38677_length_512_cov_3.435835	191	271	0	80	80	1.0000000
NODE_38693_length_512_cov_2.888620	320	400	0	80	80	1.0000000
NODE_38768_length_512_cov_1.341404	198	269	0	1	71	0.0140845
NODE_38768_length_512_cov_1.341404	198	269	2	1	71	0.0140845
NODE_38768_length_512_cov_1.341404	198	269	8	4	71	0.0563380
NODE_38768_length_512_cov_1.341404	198	269	10	7	71	0.0985916
NODE_38768_length_512_cov_1.341404	198	269	12	9	71	0.1267606
NODE_38768_length_512_cov_1.341404	198	269	14	10	71	0.1408451
NODE_38768_length_512_cov_1.341404	198	269	16	1	71	0.0140845
NODE_38768_length_512_cov_1.341404	198	269	17	4	71	0.0563380
NODE_38768_length_512_cov_1.341404	198	269	21	1	71	0.0140845
NODE_38768_length_512_cov_1.341404	198	269	23	7	71	0.0985916
NODE_38768_length_512_cov_1.341404	198	269	25	2	71	0.0281690
NODE_38768_length_512_cov_1.341404	198	269	26	1	71	0.0140845
NODE_38768_length_512_cov_1.341404	198	269	27	10	71	0.1408451
NODE_38768_length_512_cov_1.341404	198	269	28	1	71	0.0140845
NODE_38768_length_512_cov_1.341404	198	269	29	10	71	0.1408451
NODE_38768_length_512_cov_1.341404	198	269	30	2	71	0.0281690
NODE_38866_length_511_cov_9.796117	251	331	4	4	80	0.0500000
NODE_38866_length_511_cov_9.796117	251	331	6	5	80	0.0625000
NODE_38866_length_511_cov_9.796117	251	331	8	71	80	0.8875000
NODE_38866_length_511_cov_9.796117	304	370	0	32	66	0.4848485
NODE_38866_length_511_cov_9.796117	304	370	4	3	66	0.0454545
NODE_38866_length_511_cov_9.796117	304	370	6	3	66	0.0454545
NODE_38866_length_511_cov_9.796117	304	370	8	28	66	0.4242424
NODE_38869_length_511_cov_8.873786	239	319	0	80	80	1.0000000
NODE_38869_length_511_cov_8.873786	292	356	0	64	64	1.0000000
NODE_38870_length_511_cov_8.434466	232	312	0	80	80	1.0000000
NODE_38870_length_511_cov_8.434466	285	366	0	81	81	1.0000000
NODE_38872_length_511_cov_7.519417	157	237	0	80	80	1.0000000
NODE_38872_length_511_cov_7.519417	210	290	0	39	80	0.4875000
NODE_38872_length_511_cov_7.519417	210	290	2	41	80	0.5125000
NODE_38877_length_511_cov_5.762136	102	179	8	12	77	0.1558442
NODE_38877_length_511_cov_5.762136	102	179	10	7	77	0.0909091
NODE_38877_length_511_cov_5.762136	102	179	12	3	77	0.0389610
NODE_38877_length_511_cov_5.762136	102	179	14	55	77	0.7142857
NODE_38877_length_511_cov_5.762136	155	230	6	38	75	0.5066667
NODE_38877_length_511_cov_5.762136	155	230	10	5	75	0.0666667
NODE_38877_length_511_cov_5.762136	155	230	12	11	75	0.1466667
NODE_38877_length_511_cov_5.762136	155	230	14	21	75	0.2800000
NODE_38878_length_511_cov_5.655340	133	213	0	78	80	0.9750000
NODE_38878_length_511_cov_5.655340	133	213	2	2	80	0.0250000
NODE_38878_length_511_cov_5.655340	186	266	0	25	80	0.3125000
NODE_38878_length_511_cov_5.655340	186	266	2	55	80	0.6875000
NODE_38911_length_511_cov_2.978155	219	255	2	24	36	0.6666667
NODE_38911_length_511_cov_2.978155	219	255	3	1	36	0.0277778
NODE_38911_length_511_cov_2.978155	219	255	4	11	36	0.3055556
NODE_39013_length_511_cov_1.225728	99	127	0	28	28	1.0000000
NODE_39092_length_511_cov_0.708738	98	146	0	48	48	1.0000000
NODE_39105_length_510_cov_18.206813	334	414	0	80	80	1.0000000
NODE_39105_length_510_cov_18.206813	387	467	0	80	80	1.0000000
NODE_39110_length_510_cov_8.017032	211	291	0	80	80	1.0000000
NODE_39110_length_510_cov_8.017032	264	344	0	80	80	1.0000000
NODE_39110_length_510_cov_8.017032	391	413	0	22	22	1.0000000
NODE_39112_length_510_cov_6.476886	208	251	2	43	43	1.0000000
NODE_39115_length_510_cov_6.133820	149	200	0	51	51	1.0000000
NODE_39122_length_510_cov_4.313869	32	106	0	8	74	0.1081081
NODE_39122_length_510_cov_4.313869	32	106	2	66	74	0.8918919
NODE_39131_length_510_cov_3.435523	149	213	0	23	64	0.3593750
NODE_39131_length_510_cov_3.435523	149	213	4	41	64	0.6406250
NODE_39131_length_510_cov_3.435523	191	249	4	58	58	1.0000000
NODE_39293_length_509_cov_13.378049	160	240	0	80	80	1.0000000
NODE_39293_length_509_cov_13.378049	213	294	0	81	81	1.0000000
NODE_39302_length_509_cov_5.190244	203	283	10	36	80	0.4500000
NODE_39302_length_509_cov_5.190244	203	283	14	44	80	0.5500000
NODE_39302_length_509_cov_5.190244	256	336	0	2	80	0.0250000
NODE_39302_length_509_cov_5.190244	256	336	4	40	80	0.5000000
NODE_39302_length_509_cov_5.190244	256	336	6	3	80	0.0375000
NODE_39302_length_509_cov_5.190244	256	336	8	1	80	0.0125000
NODE_39302_length_509_cov_5.190244	256	336	14	34	80	0.4250000
NODE_39309_length_509_cov_4.478049	221	301	0	80	80	1.0000000
NODE_39309_length_509_cov_4.478049	274	354	0	80	80	1.0000000
NODE_39311_length_509_cov_4.451220	203	283	0	2	80	0.0250000
NODE_39311_length_509_cov_4.451220	203	283	2	78	80	0.9750000
NODE_39322_length_509_cov_3.443902	133	185	0	52	52	1.0000000
NODE_39326_length_509_cov_3.207317	367	445	2	6	78	0.0769231
NODE_39326_length_509_cov_3.207317	367	445	4	6	78	0.0769231
NODE_39326_length_509_cov_3.207317	367	445	6	66	78	0.8461539
NODE_39337_length_509_cov_2.853659	194	274	0	80	80	1.0000000
NODE_39480_length_509_cov_0.809756	229	272	0	43	43	1.0000000
NODE_39506_length_508_cov_22.009780	440	508	0	68	68	1.0000000
NODE_39512_length_508_cov_5.158924	248	284	0	36	36	1.0000000
NODE_39539_length_508_cov_2.662592	165	244	14	50	79	0.6329114
NODE_39539_length_508_cov_2.662592	165	244	16	20	79	0.2531646
NODE_39539_length_508_cov_2.662592	165	244	18	9	79	0.1139240
NODE_39698_length_507_cov_32.286765	0	61	10	2	61	0.0327869
NODE_39698_length_507_cov_32.286765	0	61	14	1	61	0.0163934
NODE_39698_length_507_cov_32.286765	0	61	22	2	61	0.0327869
NODE_39698_length_507_cov_32.286765	0	61	24	2	61	0.0327869
NODE_39698_length_507_cov_32.286765	0	61	28	1	61	0.0163934
NODE_39698_length_507_cov_32.286765	0	61	30	1	61	0.0163934
NODE_39698_length_507_cov_32.286765	0	61	31	1	61	0.0163934
NODE_39698_length_507_cov_32.286765	0	61	35	1	61	0.0163934
NODE_39698_length_507_cov_32.286765	0	61	39	1	61	0.0163934
NODE_39698_length_507_cov_32.286765	0	61	46	1	61	0.0163934
NODE_39698_length_507_cov_32.286765	0	61	52	2	61	0.0327869
NODE_39698_length_507_cov_32.286765	0	61	58	3	61	0.0491803
NODE_39698_length_507_cov_32.286765	0	61	60	1	61	0.0163934
NODE_39698_length_507_cov_32.286765	0	61	68	1	61	0.0163934
NODE_39698_length_507_cov_32.286765	0	61	70	1	61	0.0163934
NODE_39698_length_507_cov_32.286765	0	61	72	7	61	0.1147541
NODE_39698_length_507_cov_32.286765	0	61	79	1	61	0.0163934
NODE_39698_length_507_cov_32.286765	0	61	83	1	61	0.0163934
NODE_39698_length_507_cov_32.286765	0	61	85	1	61	0.0163934
NODE_39698_length_507_cov_32.286765	0	61	88	1	61	0.0163934
NODE_39698_length_507_cov_32.286765	0	61	92	1	61	0.0163934
NODE_39698_length_507_cov_32.286765	0	61	94	1	61	0.0163934
NODE_39698_length_507_cov_32.286765	0	61	95	1	61	0.0163934
NODE_39698_length_507_cov_32.286765	0	61	100	1	61	0.0163934
NODE_39698_length_507_cov_32.286765	0	61	101	8	61	0.1311475
NODE_39698_length_507_cov_32.286765	0	61	103	1	61	0.0163934
NODE_39698_length_507_cov_32.286765	0	61	105	4	61	0.0655738
NODE_39698_length_507_cov_32.286765	0	61	112	1	61	0.0163934
NODE_39698_length_507_cov_32.286765	0	61	114	1	61	0.0163934
NODE_39698_length_507_cov_32.286765	0	61	116	1	61	0.0163934
NODE_39698_length_507_cov_32.286765	0	61	118	1	61	0.0163934
NODE_39698_length_507_cov_32.286765	0	61	120	1	61	0.0163934
NODE_39698_length_507_cov_32.286765	0	61	126	2	61	0.0327869
NODE_39698_length_507_cov_32.286765	0	61	131	3	61	0.0491803
NODE_39698_length_507_cov_32.286765	0	61	133	2	61	0.0327869
NODE_39698_length_507_cov_32.286765	53	97	120	1	44	0.0227273
NODE_39698_length_507_cov_32.286765	53	97	126	2	44	0.0454545
NODE_39698_length_507_cov_32.286765	53	97	131	3	44	0.0681818
NODE_39698_length_507_cov_32.286765	53	97	133	2	44	0.0454545
NODE_39698_length_507_cov_32.286765	53	97	135	1	44	0.0227273
NODE_39698_length_507_cov_32.286765	53	97	137	1	44	0.0227273
NODE_39698_length_507_cov_32.286765	53	97	139	2	44	0.0454545
NODE_39698_length_507_cov_32.286765	53	97	140	1	44	0.0227273
NODE_39698_length_507_cov_32.286765	53	97	142	1	44	0.0227273
NODE_39698_length_507_cov_32.286765	53	97	144	1	44	0.0227273
NODE_39698_length_507_cov_32.286765	53	97	150	3	44	0.0681818
NODE_39698_length_507_cov_32.286765	53	97	152	1	44	0.0227273
NODE_39698_length_507_cov_32.286765	53	97	158	1	44	0.0227273
NODE_39698_length_507_cov_32.286765	53	97	165	5	44	0.1136364
NODE_39698_length_507_cov_32.286765	53	97	170	3	44	0.0681818
NODE_39698_length_507_cov_32.286765	53	97	172	1	44	0.0227273
NODE_39698_length_507_cov_32.286765	53	97	174	1	44	0.0227273
NODE_39698_length_507_cov_32.286765	53	97	180	2	44	0.0454545
NODE_39698_length_507_cov_32.286765	53	97	186	1	44	0.0227273
NODE_39698_length_507_cov_32.286765	53	97	190	1	44	0.0227273
NODE_39698_length_507_cov_32.286765	53	97	193	1	44	0.0227273
NODE_39698_length_507_cov_32.286765	53	97	199	1	44	0.0227273
NODE_39698_length_507_cov_32.286765	53	97	201	1	44	0.0227273
NODE_39698_length_507_cov_32.286765	53	97	203	1	44	0.0227273
NODE_39698_length_507_cov_32.286765	53	97	205	1	44	0.0227273
NODE_39698_length_507_cov_32.286765	53	97	208	1	44	0.0227273
NODE_39698_length_507_cov_32.286765	53	97	211	2	44	0.0454545
NODE_39698_length_507_cov_32.286765	53	97	213	1	44	0.0227273
NODE_39698_length_507_cov_32.286765	53	97	217	1	44	0.0227273
NODE_39701_length_507_cov_7.553922	203	283	5	1	80	0.0125000
NODE_39701_length_507_cov_7.553922	203	283	7	7	80	0.0875000
NODE_39701_length_507_cov_7.553922	203	283	12	24	80	0.3000000
NODE_39701_length_507_cov_7.553922	203	283	14	48	80	0.6000000
NODE_39709_length_507_cov_5.154412	296	362	0	29	66	0.4393939
NODE_39709_length_507_cov_5.154412	296	362	3	1	66	0.0151515
NODE_39709_length_507_cov_5.154412	296	362	4	31	66	0.4696970
NODE_39709_length_507_cov_5.154412	296	362	6	5	66	0.0757576
NODE_39714_length_507_cov_4.710784	248	328	0	15	80	0.1875000
NODE_39714_length_507_cov_4.710784	248	328	8	65	80	0.8125000
NODE_39714_length_507_cov_4.710784	308	379	0	66	71	0.9295775
NODE_39714_length_507_cov_4.710784	308	379	8	5	71	0.0704225
NODE_39728_length_507_cov_3.649510	80	109	0	1	29	0.0344828
NODE_39728_length_507_cov_3.649510	80	109	2	7	29	0.2413793
NODE_39728_length_507_cov_3.649510	80	109	4	5	29	0.1724138
NODE_39728_length_507_cov_3.649510	80	109	6	3	29	0.1034483
NODE_39728_length_507_cov_3.649510	80	109	8	13	29	0.4482759
NODE_39728_length_507_cov_3.649510	184	266	10	8	82	0.0975610
NODE_39728_length_507_cov_3.649510	184	266	12	7	82	0.0853659
NODE_39728_length_507_cov_3.649510	184	266	14	13	82	0.1585366
NODE_39728_length_507_cov_3.649510	184	266	16	6	82	0.0731707
NODE_39728_length_507_cov_3.649510	184	266	18	13	82	0.1585366
NODE_39728_length_507_cov_3.649510	184	266	19	20	82	0.2439024
NODE_39728_length_507_cov_3.649510	184	266	20	9	82	0.1097561
NODE_39728_length_507_cov_3.649510	184	266	22	3	82	0.0365854
NODE_39728_length_507_cov_3.649510	184	266	23	2	82	0.0243902
NODE_39728_length_507_cov_3.649510	184	266	24	1	82	0.0121951
NODE_39728_length_507_cov_3.649510	189	273	10	15	84	0.1785714
NODE_39728_length_507_cov_3.649510	189	273	12	7	84	0.0833333
NODE_39728_length_507_cov_3.649510	189	273	14	13	84	0.1547619
NODE_39728_length_507_cov_3.649510	189	273	16	6	84	0.0714286
NODE_39728_length_507_cov_3.649510	189	273	18	11	84	0.1309524
NODE_39728_length_507_cov_3.649510	189	273	19	17	84	0.2023810
NODE_39728_length_507_cov_3.649510	189	273	20	9	84	0.1071429
NODE_39728_length_507_cov_3.649510	189	273	22	3	84	0.0357143
NODE_39728_length_507_cov_3.649510	189	273	23	2	84	0.0238095
NODE_39728_length_507_cov_3.649510	189	273	24	1	84	0.0119048
NODE_39728_length_507_cov_3.649510	207	266	10	8	59	0.1355932
NODE_39728_length_507_cov_3.649510	207	266	12	7	59	0.1186441
NODE_39728_length_507_cov_3.649510	207	266	14	13	59	0.2203390
NODE_39728_length_507_cov_3.649510	207	266	16	6	59	0.1016949
NODE_39728_length_507_cov_3.649510	207	266	18	11	59	0.1864407
NODE_39728_length_507_cov_3.649510	207	266	20	9	59	0.1525424
NODE_39728_length_507_cov_3.649510	207	266	22	3	59	0.0508475
NODE_39728_length_507_cov_3.649510	207	266	23	1	59	0.0169492
NODE_39728_length_507_cov_3.649510	207	266	24	1	59	0.0169492
NODE_39747_length_507_cov_2.754902	345	425	0	80	80	1.0000000
NODE_39747_length_507_cov_2.754902	428	463	0	35	35	1.0000000
NODE_39918_length_506_cov_31.987715	71	156	0	10	85	0.1176471
NODE_39918_length_506_cov_31.987715	71	156	4	21	85	0.2470588
NODE_39918_length_506_cov_31.987715	71	156	6	9	85	0.1058824
NODE_39918_length_506_cov_31.987715	71	156	14	45	85	0.5294118
NODE_39918_length_506_cov_31.987715	71	156	0	10	85	0.1176471
NODE_39918_length_506_cov_31.987715	71	156	4	21	85	0.2470588
NODE_39918_length_506_cov_31.987715	71	156	6	9	85	0.1058824
NODE_39918_length_506_cov_31.987715	71	156	14	45	85	0.5294118
NODE_39918_length_506_cov_31.987715	71	156	0	10	85	0.1176471
NODE_39918_length_506_cov_31.987715	71	156	4	21	85	0.2470588
NODE_39918_length_506_cov_31.987715	71	156	6	9	85	0.1058824
NODE_39918_length_506_cov_31.987715	71	156	14	45	85	0.5294118
NODE_39918_length_506_cov_31.987715	129	209	10	18	80	0.2250000
NODE_39918_length_506_cov_31.987715	129	209	12	35	80	0.4375000
NODE_39918_length_506_cov_31.987715	129	209	14	27	80	0.3375000
NODE_39919_length_506_cov_15.877150	210	279	2	4	69	0.0579710
NODE_39919_length_506_cov_15.877150	210	279	13	23	69	0.3333333
NODE_39919_length_506_cov_15.877150	210	279	14	5	69	0.0724638
NODE_39919_length_506_cov_15.877150	210	279	16	37	69	0.5362319
NODE_39920_length_506_cov_15.461916	334	414	0	80	80	1.0000000
NODE_39920_length_506_cov_15.461916	387	467	0	80	80	1.0000000
NODE_39921_length_506_cov_9.749386	197	276	0	79	79	1.0000000
NODE_39921_length_506_cov_9.749386	249	329	0	80	80	1.0000000
NODE_39947_length_506_cov_3.122850	218	298	0	80	80	1.0000000
NODE_39947_length_506_cov_3.122850	271	351	0	80	80	1.0000000
NODE_39951_length_506_cov_2.894349	190	270	0	80	80	1.0000000
NODE_40133_length_505_cov_35.541872	373	453	0	2	80	0.0250000
NODE_40133_length_505_cov_35.541872	373	453	4	78	80	0.9750000
NODE_40135_length_505_cov_10.339901	30	110	0	80	80	1.0000000
NODE_40135_length_505_cov_10.339901	83	163	0	80	80	1.0000000
NODE_40158_length_505_cov_3.554187	225	305	0	80	80	1.0000000
NODE_40158_length_505_cov_3.554187	278	358	0	80	80	1.0000000
NODE_40160_length_505_cov_3.403941	207	287	0	80	80	1.0000000
NODE_40175_length_505_cov_2.975369	162	227	0	65	65	1.0000000
NODE_40222_length_505_cov_1.864532	55	126	0	71	71	1.0000000
NODE_40368_length_504_cov_115.891358	122	202	136	1	80	0.0125000
NODE_40368_length_504_cov_115.891358	122	202	140	4	80	0.0500000
NODE_40368_length_504_cov_115.891358	122	202	147	1	80	0.0125000
NODE_40368_length_504_cov_115.891358	122	202	148	1	80	0.0125000
NODE_40368_length_504_cov_115.891358	122	202	151	3	80	0.0375000
NODE_40368_length_504_cov_115.891358	122	202	152	2	80	0.0250000
NODE_40368_length_504_cov_115.891358	122	202	153	4	80	0.0500000
NODE_40368_length_504_cov_115.891358	122	202	155	3	80	0.0375000
NODE_40368_length_504_cov_115.891358	122	202	158	2	80	0.0250000
NODE_40368_length_504_cov_115.891358	122	202	168	1	80	0.0125000
NODE_40368_length_504_cov_115.891358	122	202	178	3	80	0.0375000
NODE_40368_length_504_cov_115.891358	122	202	180	4	80	0.0500000
NODE_40368_length_504_cov_115.891358	122	202	182	2	80	0.0250000
NODE_40368_length_504_cov_115.891358	122	202	184	3	80	0.0375000
NODE_40368_length_504_cov_115.891358	122	202	185	1	80	0.0125000
NODE_40368_length_504_cov_115.891358	122	202	186	2	80	0.0250000
NODE_40368_length_504_cov_115.891358	122	202	188	3	80	0.0375000
NODE_40368_length_504_cov_115.891358	122	202	190	8	80	0.1000000
NODE_40368_length_504_cov_115.891358	122	202	191	2	80	0.0250000
NODE_40368_length_504_cov_115.891358	122	202	192	3	80	0.0375000
NODE_40368_length_504_cov_115.891358	122	202	193	7	80	0.0875000
NODE_40368_length_504_cov_115.891358	122	202	194	5	80	0.0625000
NODE_40368_length_504_cov_115.891358	122	202	195	4	80	0.0500000
NODE_40368_length_504_cov_115.891358	122	202	196	2	80	0.0250000
NODE_40368_length_504_cov_115.891358	122	202	197	2	80	0.0250000
NODE_40368_length_504_cov_115.891358	122	202	198	2	80	0.0250000
NODE_40368_length_504_cov_115.891358	122	202	199	1	80	0.0125000
NODE_40368_length_504_cov_115.891358	122	202	201	2	80	0.0250000
NODE_40368_length_504_cov_115.891358	122	202	203	2	80	0.0250000
NODE_40368_length_504_cov_115.891358	175	255	149	2	80	0.0250000
NODE_40368_length_504_cov_115.891358	175	255	151	1	80	0.0125000
NODE_40368_length_504_cov_115.891358	175	255	152	1	80	0.0125000
NODE_40368_length_504_cov_115.891358	175	255	154	2	80	0.0250000
NODE_40368_length_504_cov_115.891358	175	255	155	2	80	0.0250000
NODE_40368_length_504_cov_115.891358	175	255	157	1	80	0.0125000
NODE_40368_length_504_cov_115.891358	175	255	161	1	80	0.0125000
NODE_40368_length_504_cov_115.891358	175	255	163	2	80	0.0250000
NODE_40368_length_504_cov_115.891358	175	255	165	1	80	0.0125000
NODE_40368_length_504_cov_115.891358	175	255	168	1	80	0.0125000
NODE_40368_length_504_cov_115.891358	175	255	174	1	80	0.0125000
NODE_40368_length_504_cov_115.891358	175	255	177	1	80	0.0125000
NODE_40368_length_504_cov_115.891358	175	255	180	2	80	0.0250000
NODE_40368_length_504_cov_115.891358	175	255	181	3	80	0.0375000
NODE_40368_length_504_cov_115.891358	175	255	183	4	80	0.0500000
NODE_40368_length_504_cov_115.891358	175	255	184	3	80	0.0375000
NODE_40368_length_504_cov_115.891358	175	255	185	2	80	0.0250000
NODE_40368_length_504_cov_115.891358	175	255	186	2	80	0.0250000
NODE_40368_length_504_cov_115.891358	175	255	188	3	80	0.0375000
NODE_40368_length_504_cov_115.891358	175	255	190	8	80	0.1000000
NODE_40368_length_504_cov_115.891358	175	255	192	1	80	0.0125000
NODE_40368_length_504_cov_115.891358	175	255	193	4	80	0.0500000
NODE_40368_length_504_cov_115.891358	175	255	194	3	80	0.0375000
NODE_40368_length_504_cov_115.891358	175	255	195	2	80	0.0250000
NODE_40368_length_504_cov_115.891358	175	255	196	1	80	0.0125000
NODE_40368_length_504_cov_115.891358	175	255	197	2	80	0.0250000
NODE_40368_length_504_cov_115.891358	175	255	198	2	80	0.0250000
NODE_40368_length_504_cov_115.891358	175	255	199	2	80	0.0250000
NODE_40368_length_504_cov_115.891358	175	255	200	1	80	0.0125000
NODE_40368_length_504_cov_115.891358	175	255	201	3	80	0.0375000
NODE_40368_length_504_cov_115.891358	175	255	203	8	80	0.1000000
NODE_40368_length_504_cov_115.891358	175	255	204	2	80	0.0250000
NODE_40368_length_504_cov_115.891358	175	255	205	6	80	0.0750000
NODE_40369_length_504_cov_33.360494	28	108	0	80	80	1.0000000
NODE_40369_length_504_cov_33.360494	81	161	0	80	80	1.0000000
NODE_40370_length_504_cov_15.669136	176	256	0	80	80	1.0000000
NODE_40370_length_504_cov_15.669136	229	309	0	80	80	1.0000000
NODE_40371_length_504_cov_13.202469	134	215	0	8	81	0.0987654
NODE_40371_length_504_cov_13.202469	134	215	4	73	81	0.9012346
NODE_40371_length_504_cov_13.202469	188	268	0	61	80	0.7625000
NODE_40371_length_504_cov_13.202469	188	268	4	19	80	0.2375000
NODE_40377_length_504_cov_6.770370	55	135	0	80	80	1.0000000
NODE_40377_length_504_cov_6.770370	108	188	0	80	80	1.0000000
NODE_40427_length_504_cov_2.234568	359	407	0	48	48	1.0000000
NODE_40428_length_504_cov_2.227160	307	370	0	63	63	1.0000000
NODE_40434_length_504_cov_2.116049	245	325	0	80	80	1.0000000
NODE_40434_length_504_cov_2.116049	298	378	0	80	80	1.0000000
NODE_40446_length_504_cov_1.925926	196	262	6	22	66	0.3333333
NODE_40446_length_504_cov_1.925926	196	262	7	2	66	0.0303030
NODE_40446_length_504_cov_1.925926	196	262	8	13	66	0.1969697
NODE_40446_length_504_cov_1.925926	196	262	9	27	66	0.4090909
NODE_40446_length_504_cov_1.925926	196	262	11	2	66	0.0303030
NODE_40601_length_503_cov_11.356436	268	348	0	80	80	1.0000000
NODE_40601_length_503_cov_11.356436	321	401	0	80	80	1.0000000
NODE_40615_length_503_cov_5.537129	314	381	2	8	67	0.1194030
NODE_40615_length_503_cov_5.537129	314	381	3	14	67	0.2089552
NODE_40615_length_503_cov_5.537129	314	381	5	45	67	0.6716418
NODE_40645_length_503_cov_3.012376	264	285	0	10	21	0.4761905
NODE_40645_length_503_cov_3.012376	264	285	2	11	21	0.5238096
NODE_40652_length_503_cov_2.757426	266	334	0	3	68	0.0441176
NODE_40652_length_503_cov_2.757426	266	334	2	9	68	0.1323529
NODE_40652_length_503_cov_2.757426	266	334	6	8	68	0.1176471
NODE_40652_length_503_cov_2.757426	266	334	8	8	68	0.1176471
NODE_40652_length_503_cov_2.757426	266	334	12	40	68	0.5882353
NODE_40652_length_503_cov_2.757426	307	387	8	12	80	0.1500000
NODE_40652_length_503_cov_2.757426	307	387	12	60	80	0.7500000
NODE_40652_length_503_cov_2.757426	307	387	14	8	80	0.1000000
NODE_40655_length_503_cov_2.705446	158	237	0	51	79	0.6455696
NODE_40655_length_503_cov_2.705446	158	237	4	11	79	0.1392405
NODE_40655_length_503_cov_2.705446	158	237	6	17	79	0.2151899
NODE_40655_length_503_cov_2.705446	211	291	4	9	80	0.1125000
NODE_40655_length_503_cov_2.705446	211	291	6	71	80	0.8875000
NODE_40656_length_503_cov_2.705446	251	331	4	35	80	0.4375000
NODE_40656_length_503_cov_2.705446	251	331	8	15	80	0.1875000
NODE_40656_length_503_cov_2.705446	251	331	10	2	80	0.0250000
NODE_40656_length_503_cov_2.705446	251	331	12	4	80	0.0500000
NODE_40656_length_503_cov_2.705446	251	331	14	24	80	0.3000000
NODE_40656_length_503_cov_2.705446	251	321	4	25	70	0.3571429
NODE_40656_length_503_cov_2.705446	251	321	8	15	70	0.2142857
NODE_40656_length_503_cov_2.705446	251	321	10	2	70	0.0285714
NODE_40656_length_503_cov_2.705446	251	321	12	4	70	0.0571429
NODE_40656_length_503_cov_2.705446	251	321	14	24	70	0.3428572
NODE_40656_length_503_cov_2.705446	330	384	2	52	54	0.9629630
NODE_40656_length_503_cov_2.705446	330	384	4	2	54	0.0370370
NODE_40656_length_503_cov_2.705446	338	384	2	46	46	1.0000000
NODE_40664_length_503_cov_2.584158	95	163	0	68	68	1.0000000
NODE_40857_length_502_cov_45.292804	353	433	6	4	80	0.0500000
NODE_40857_length_502_cov_45.292804	353	433	7	6	80	0.0750000
NODE_40857_length_502_cov_45.292804	353	433	8	15	80	0.1875000
NODE_40857_length_502_cov_45.292804	353	433	12	1	80	0.0125000
NODE_40857_length_502_cov_45.292804	353	433	13	4	80	0.0500000
NODE_40857_length_502_cov_45.292804	353	433	15	6	80	0.0750000
NODE_40857_length_502_cov_45.292804	353	433	16	40	80	0.5000000
NODE_40857_length_502_cov_45.292804	353	433	17	4	80	0.0500000
NODE_40864_length_502_cov_5.980149	305	381	10	1	76	0.0131579
NODE_40864_length_502_cov_5.980149	305	381	16	7	76	0.0921053
NODE_40864_length_502_cov_5.980149	305	381	18	36	76	0.4736842
NODE_40864_length_502_cov_5.980149	305	381	20	32	76	0.4210526
NODE_41070_length_501_cov_208.708955	288	350	3	3	62	0.0483871
NODE_41070_length_501_cov_208.708955	288	350	5	8	62	0.1290323
NODE_41070_length_501_cov_208.708955	288	350	6	51	62	0.8225806
NODE_41070_length_501_cov_208.708955	327	413	0	59	86	0.6860465
NODE_41070_length_501_cov_208.708955	327	413	3	7	86	0.0813954
NODE_41070_length_501_cov_208.708955	327	413	5	8	86	0.0930233
NODE_41070_length_501_cov_208.708955	327	413	6	12	86	0.1395349
NODE_41071_length_501_cov_29.126866	23	103	0	80	80	1.0000000
NODE_41071_length_501_cov_29.126866	76	156	0	80	80	1.0000000
NODE_41072_length_501_cov_23.736318	85	165	0	80	80	1.0000000
NODE_41072_length_501_cov_23.736318	138	218	0	80	80	1.0000000
NODE_41075_length_501_cov_7.820896	270	350	0	36	80	0.4500000
NODE_41075_length_501_cov_7.820896	270	350	1	3	80	0.0375000
NODE_41075_length_501_cov_7.820896	270	350	2	9	80	0.1125000
NODE_41075_length_501_cov_7.820896	270	350	4	32	80	0.4000000
NODE_41075_length_501_cov_7.820896	323	403	0	80	80	1.0000000
NODE_41080_length_501_cov_6.437811	309	389	0	80	80	1.0000000
NODE_41097_length_501_cov_3.656716	289	312	0	23	23	1.0000000
NODE_41097_length_501_cov_3.656716	355	420	0	65	65	1.0000000
NODE_41103_length_501_cov_3.477612	329	409	2	17	80	0.2125000
NODE_41103_length_501_cov_3.477612	329	409	4	28	80	0.3500000
NODE_41103_length_501_cov_3.477612	329	409	6	35	80	0.4375000
NODE_41109_length_501_cov_3.134328	266	345	0	67	79	0.8481013
NODE_41109_length_501_cov_3.134328	266	345	2	12	79	0.1518987
NODE_41308_length_500_cov_77.895262	456	500	1	20	44	0.4545455
NODE_41308_length_500_cov_77.895262	456	500	3	5	44	0.1136364
NODE_41308_length_500_cov_77.895262	456	500	4	16	44	0.3636364
NODE_41308_length_500_cov_77.895262	456	500	6	2	44	0.0454545
NODE_41308_length_500_cov_77.895262	456	500	7	1	44	0.0227273
NODE_41309_length_500_cov_35.805486	326	406	2	5	80	0.0625000
NODE_41309_length_500_cov_35.805486	326	406	4	7	80	0.0875000
NODE_41309_length_500_cov_35.805486	326	406	6	68	80	0.8500000
NODE_41309_length_500_cov_35.805486	379	459	0	51	80	0.6375000
NODE_41309_length_500_cov_35.805486	379	459	2	7	80	0.0875000
NODE_41309_length_500_cov_35.805486	379	459	4	7	80	0.0875000
NODE_41309_length_500_cov_35.805486	379	459	6	15	80	0.1875000
NODE_41310_length_500_cov_13.084788	160	221	0	59	61	0.9672131
NODE_41310_length_500_cov_13.084788	160	221	4	1	61	0.0163934
NODE_41310_length_500_cov_13.084788	160	221	6	1	61	0.0163934
NODE_41311_length_500_cov_12.650873	215	295	0	80	80	1.0000000
NODE_41311_length_500_cov_12.650873	268	348	0	80	80	1.0000000
NODE_41312_length_500_cov_12.009975	203	268	6	32	65	0.4923077
NODE_41312_length_500_cov_12.009975	203	268	8	31	65	0.4769231
NODE_41312_length_500_cov_12.009975	203	268	9	2	65	0.0307692
NODE_41312_length_500_cov_12.009975	241	321	3	2	80	0.0250000
NODE_41312_length_500_cov_12.009975	241	321	5	41	80	0.5125000
NODE_41312_length_500_cov_12.009975	241	321	8	25	80	0.3125000
NODE_41312_length_500_cov_12.009975	241	321	9	12	80	0.1500000
NODE_41325_length_500_cov_4.653367	224	295	0	71	71	1.0000000
NODE_41415_length_500_cov_1.650873	355	435	0	70	80	0.8750000
NODE_41415_length_500_cov_1.650873	355	435	2	10	80	0.1250000
NODE_41415_length_500_cov_1.650873	408	488	0	80	80	1.0000000
NODE_41462_length_500_cov_1.231920	169	212	0	43	43	1.0000000
NODE_41542_length_499_cov_358.730000	425	492	21	3	67	0.0447761
NODE_41542_length_499_cov_358.730000	425	492	22	2	67	0.0298507
NODE_41542_length_499_cov_358.730000	425	492	26	1	67	0.0149254
NODE_41542_length_499_cov_358.730000	425	492	30	3	67	0.0447761
NODE_41542_length_499_cov_358.730000	425	492	34	2	67	0.0298507
NODE_41542_length_499_cov_358.730000	425	492	38	4	67	0.0597015
NODE_41542_length_499_cov_358.730000	425	492	40	2	67	0.0298507
NODE_41542_length_499_cov_358.730000	425	492	42	2	67	0.0298507
NODE_41542_length_499_cov_358.730000	425	492	44	4	67	0.0597015
NODE_41542_length_499_cov_358.730000	425	492	46	2	67	0.0298507
NODE_41542_length_499_cov_358.730000	425	492	48	7	67	0.1044776
NODE_41542_length_499_cov_358.730000	425	492	52	1	67	0.0149254
NODE_41542_length_499_cov_358.730000	425	492	54	2	67	0.0298507
NODE_41542_length_499_cov_358.730000	425	492	60	5	67	0.0746269
NODE_41542_length_499_cov_358.730000	425	492	64	2	67	0.0298507
NODE_41542_length_499_cov_358.730000	425	492	66	1	67	0.0149254
NODE_41542_length_499_cov_358.730000	425	492	68	1	67	0.0149254
NODE_41542_length_499_cov_358.730000	425	492	70	2	67	0.0298507
NODE_41542_length_499_cov_358.730000	425	492	74	2	67	0.0298507
NODE_41542_length_499_cov_358.730000	425	492	76	1	67	0.0149254
NODE_41542_length_499_cov_358.730000	425	492	82	2	67	0.0298507
NODE_41542_length_499_cov_358.730000	425	492	84	3	67	0.0447761
NODE_41542_length_499_cov_358.730000	425	492	86	3	67	0.0447761
NODE_41542_length_499_cov_358.730000	425	492	90	5	67	0.0746269
NODE_41542_length_499_cov_358.730000	425	492	91	1	67	0.0149254
NODE_41542_length_499_cov_358.730000	425	492	93	4	67	0.0597015
NODE_41543_length_499_cov_21.135000	52	132	0	39	80	0.4875000
NODE_41543_length_499_cov_21.135000	52	132	2	41	80	0.5125000
NODE_41543_length_499_cov_21.135000	105	185	2	80	80	1.0000000
NODE_41544_length_499_cov_11.917500	50	130	0	80	80	1.0000000
NODE_41544_length_499_cov_11.917500	103	183	0	80	80	1.0000000
NODE_41549_length_499_cov_5.007500	0	54	0	54	54	1.0000000
NODE_41563_length_499_cov_3.482500	307	336	9	8	29	0.2758621
NODE_41563_length_499_cov_3.482500	307	336	13	2	29	0.0689655
NODE_41563_length_499_cov_3.482500	307	336	14	8	29	0.2758621
NODE_41563_length_499_cov_3.482500	307	336	15	8	29	0.2758621
NODE_41563_length_499_cov_3.482500	307	336	17	3	29	0.1034483
NODE_41594_length_499_cov_2.420000	198	247	0	49	49	1.0000000
NODE_41662_length_499_cov_1.445000	311	372	0	61	61	1.0000000
NODE_41770_length_498_cov_31.704261	12	92	0	80	80	1.0000000
NODE_41770_length_498_cov_31.704261	65	145	0	80	80	1.0000000
NODE_41775_length_498_cov_7.002506	256	336	0	34	80	0.4250000
NODE_41775_length_498_cov_7.002506	256	336	2	46	80	0.5750000
NODE_41780_length_498_cov_5.759398	217	247	0	30	30	1.0000000
NODE_41814_length_498_cov_3.075188	225	262	6	17	37	0.4594595
NODE_41814_length_498_cov_3.075188	225	262	7	1	37	0.0270270
NODE_41814_length_498_cov_3.075188	225	262	8	9	37	0.2432432
NODE_41814_length_498_cov_3.075188	225	262	10	7	37	0.1891892
NODE_41814_length_498_cov_3.075188	225	262	12	2	37	0.0540541
NODE_41814_length_498_cov_3.075188	225	262	14	1	37	0.0270270
NODE_41814_length_498_cov_3.075188	246	324	8	6	78	0.0769231
NODE_41814_length_498_cov_3.075188	246	324	10	7	78	0.0897436
NODE_41814_length_498_cov_3.075188	246	324	12	2	78	0.0256410
NODE_41814_length_498_cov_3.075188	246	324	14	6	78	0.0769231
NODE_41814_length_498_cov_3.075188	246	324	16	17	78	0.2179487
NODE_41814_length_498_cov_3.075188	246	324	18	5	78	0.0641026
NODE_41814_length_498_cov_3.075188	246	324	20	25	78	0.3205128
NODE_41814_length_498_cov_3.075188	246	324	22	10	78	0.1282051
NODE_42016_length_497_cov_44.105528	169	249	0	27	80	0.3375000
NODE_42016_length_497_cov_44.105528	169	249	2	53	80	0.6625000
NODE_42016_length_497_cov_44.105528	222	302	0	80	80	1.0000000
NODE_42017_length_497_cov_10.145729	85	165	2	14	80	0.1750000
NODE_42017_length_497_cov_10.145729	85	165	4	66	80	0.8250000
NODE_42017_length_497_cov_10.145729	138	226	0	6	88	0.0681818
NODE_42017_length_497_cov_10.145729	138	226	2	40	88	0.4545455
NODE_42017_length_497_cov_10.145729	138	226	4	42	88	0.4772727
NODE_42024_length_497_cov_6.618090	231	304	0	73	73	1.0000000
NODE_42024_length_497_cov_6.618090	284	364	0	80	80	1.0000000
NODE_42065_length_497_cov_2.889447	109	189	6	35	80	0.4375000
NODE_42065_length_497_cov_2.889447	109	189	7	1	80	0.0125000
NODE_42065_length_497_cov_2.889447	109	189	8	44	80	0.5500000
NODE_42065_length_497_cov_2.889447	162	242	0	11	80	0.1375000
NODE_42065_length_497_cov_2.889447	162	242	7	4	80	0.0500000
NODE_42065_length_497_cov_2.889447	162	242	8	65	80	0.8125000
NODE_42071_length_497_cov_2.623116	302	368	0	1	66	0.0151515
NODE_42071_length_497_cov_2.623116	302	368	2	10	66	0.1515152
NODE_42071_length_497_cov_2.623116	302	368	4	26	66	0.3939394
NODE_42071_length_497_cov_2.623116	302	368	6	15	66	0.2272727
NODE_42071_length_497_cov_2.623116	302	368	8	14	66	0.2121212
NODE_42071_length_497_cov_2.623116	355	406	6	6	51	0.1176471
NODE_42071_length_497_cov_2.623116	355	406	8	27	51	0.5294118
NODE_42071_length_497_cov_2.623116	355	406	9	1	51	0.0196078
NODE_42071_length_497_cov_2.623116	355	406	10	17	51	0.3333333
NODE_42100_length_497_cov_1.909548	106	186	6	6	80	0.0750000
NODE_42100_length_497_cov_1.909548	106	186	10	23	80	0.2875000
NODE_42100_length_497_cov_1.909548	106	186	12	2	80	0.0250000
NODE_42100_length_497_cov_1.909548	106	186	14	25	80	0.3125000
NODE_42100_length_497_cov_1.909548	106	186	16	8	80	0.1000000
NODE_42100_length_497_cov_1.909548	106	186	18	16	80	0.2000000
NODE_42100_length_497_cov_1.909548	159	240	12	6	81	0.0740741
NODE_42100_length_497_cov_1.909548	159	240	14	4	81	0.0493827
NODE_42100_length_497_cov_1.909548	159	240	16	9	81	0.1111111
NODE_42100_length_497_cov_1.909548	159	240	18	26	81	0.3209876
NODE_42100_length_497_cov_1.909548	159	240	26	1	81	0.0123457
NODE_42100_length_497_cov_1.909548	159	240	28	1	81	0.0123457
NODE_42100_length_497_cov_1.909548	159	240	34	1	81	0.0123457
NODE_42100_length_497_cov_1.909548	159	240	36	2	81	0.0246914
NODE_42100_length_497_cov_1.909548	159	240	38	1	81	0.0123457
NODE_42100_length_497_cov_1.909548	159	240	40	1	81	0.0123457
NODE_42100_length_497_cov_1.909548	159	240	44	1	81	0.0123457
NODE_42100_length_497_cov_1.909548	159	240	48	1	81	0.0123457
NODE_42100_length_497_cov_1.909548	159	240	50	2	81	0.0246914
NODE_42100_length_497_cov_1.909548	159	240	52	1	81	0.0123457
NODE_42100_length_497_cov_1.909548	159	240	54	1	81	0.0123457
NODE_42100_length_497_cov_1.909548	159	240	56	3	81	0.0370370
NODE_42100_length_497_cov_1.909548	159	240	58	2	81	0.0246914
NODE_42100_length_497_cov_1.909548	159	240	60	18	81	0.2222222
NODE_42100_length_497_cov_1.909548	262	324	6	6	62	0.0967742
NODE_42100_length_497_cov_1.909548	262	324	10	1	62	0.0161290
NODE_42100_length_497_cov_1.909548	262	324	16	3	62	0.0483871
NODE_42100_length_497_cov_1.909548	262	324	20	1	62	0.0161290
NODE_42100_length_497_cov_1.909548	262	324	24	2	62	0.0322581
NODE_42100_length_497_cov_1.909548	262	324	28	1	62	0.0161290
NODE_42100_length_497_cov_1.909548	262	324	36	1	62	0.0161290
NODE_42100_length_497_cov_1.909548	262	324	46	4	62	0.0645161
NODE_42100_length_497_cov_1.909548	262	324	54	16	62	0.2580645
NODE_42100_length_497_cov_1.909548	262	324	56	6	62	0.0967742
NODE_42100_length_497_cov_1.909548	262	324	58	21	62	0.3387097
NODE_42131_length_497_cov_1.500000	259	339	0	80	80	1.0000000
NODE_42136_length_497_cov_1.404523	211	263	0	52	52	1.0000000
NODE_42279_length_496_cov_5.619647	239	269	2	30	30	1.0000000
NODE_42281_length_496_cov_5.392947	103	168	0	65	65	1.0000000
NODE_42281_length_496_cov_5.392947	141	221	0	80	80	1.0000000
NODE_42281_length_496_cov_5.392947	217	295	0	74	78	0.9487180
NODE_42281_length_496_cov_5.392947	217	295	2	4	78	0.0512821
NODE_42281_length_496_cov_5.392947	270	295	0	21	25	0.8400000
NODE_42281_length_496_cov_5.392947	270	295	2	4	25	0.1600000
NODE_42287_length_496_cov_4.397985	388	467	0	20	79	0.2531646
NODE_42287_length_496_cov_4.397985	388	467	2	59	79	0.7468355
NODE_42288_length_496_cov_4.193955	235	315	0	47	80	0.5875000
NODE_42288_length_496_cov_4.193955	235	315	2	12	80	0.1500000
NODE_42288_length_496_cov_4.193955	235	315	4	21	80	0.2625000
NODE_42297_length_496_cov_3.531486	192	273	2	37	81	0.4567901
NODE_42297_length_496_cov_3.531486	192	273	4	44	81	0.5432099
NODE_42297_length_496_cov_3.531486	245	325	0	2	80	0.0250000
NODE_42297_length_496_cov_3.531486	245	325	2	42	80	0.5250000
NODE_42297_length_496_cov_3.531486	245	325	4	36	80	0.4500000
NODE_42298_length_496_cov_3.377834	252	332	0	80	80	1.0000000
NODE_42298_length_496_cov_3.377834	305	383	0	78	78	1.0000000
NODE_42316_length_496_cov_2.659950	203	251	0	46	48	0.9583333
NODE_42316_length_496_cov_2.659950	203	251	2	2	48	0.0416667
NODE_42328_length_496_cov_2.445844	95	165	0	70	70	1.0000000
NODE_42328_length_496_cov_2.445844	148	228	0	80	80	1.0000000
NODE_42333_length_496_cov_2.214106	299	359	4	7	60	0.1166667
NODE_42333_length_496_cov_2.214106	299	359	6	53	60	0.8833333
NODE_42415_length_496_cov_1.395466	273	317	2	35	44	0.7954546
NODE_42415_length_496_cov_1.395466	273	317	4	9	44	0.2045455
NODE_42461_length_496_cov_0.979849	214	294	2	16	80	0.2000000
NODE_42461_length_496_cov_0.979849	214	294	4	64	80	0.8000000
NODE_42525_length_495_cov_34.888889	209	264	0	55	55	1.0000000
NODE_42526_length_495_cov_12.800505	268	348	0	80	80	1.0000000
NODE_42526_length_495_cov_12.800505	321	401	0	50	80	0.6250000
NODE_42526_length_495_cov_12.800505	321	401	2	30	80	0.3750000
NODE_42529_length_495_cov_7.080808	386	416	0	30	30	1.0000000
NODE_42548_length_495_cov_3.868687	218	298	2	6	80	0.0750000
NODE_42548_length_495_cov_3.868687	218	298	4	74	80	0.9250000
NODE_42736_length_495_cov_0.792929	274	309	4	35	35	1.0000000
NODE_42773_length_494_cov_20.096203	182	262	0	39	80	0.4875000
NODE_42773_length_494_cov_20.096203	182	262	4	12	80	0.1500000
NODE_42773_length_494_cov_20.096203	182	262	6	29	80	0.3625000
NODE_42773_length_494_cov_20.096203	235	315	6	58	80	0.7250000
NODE_42773_length_494_cov_20.096203	235	315	8	22	80	0.2750000
NODE_42778_length_494_cov_7.498734	187	240	0	53	53	1.0000000
NODE_42788_length_494_cov_4.283544	255	332	2	77	77	1.0000000
NODE_42804_length_494_cov_3.496203	209	276	0	67	67	1.0000000
NODE_42812_length_494_cov_3.032911	385	432	0	1	47	0.0212766
NODE_42812_length_494_cov_3.032911	385	432	2	3	47	0.0638298
NODE_42812_length_494_cov_3.032911	385	432	4	8	47	0.1702128
NODE_42812_length_494_cov_3.032911	385	432	6	7	47	0.1489362
NODE_42812_length_494_cov_3.032911	385	432	10	1	47	0.0212766
NODE_42812_length_494_cov_3.032911	385	432	12	12	47	0.2553191
NODE_42812_length_494_cov_3.032911	385	432	14	15	47	0.3191489
NODE_42816_length_494_cov_2.908861	189	269	4	9	80	0.1125000
NODE_42816_length_494_cov_2.908861	189	269	6	7	80	0.0875000
NODE_42816_length_494_cov_2.908861	189	269	8	6	80	0.0750000
NODE_42816_length_494_cov_2.908861	189	269	10	3	80	0.0375000
NODE_42816_length_494_cov_2.908861	189	269	12	1	80	0.0125000
NODE_42816_length_494_cov_2.908861	189	269	14	54	80	0.6750000
NODE_42822_length_494_cov_2.777215	145	188	0	43	43	1.0000000
NODE_42834_length_494_cov_2.531646	371	430	0	59	59	1.0000000
NODE_42834_length_494_cov_2.531646	428	494	0	66	66	1.0000000
NODE_43021_length_493_cov_34.946701	140	220	0	80	80	1.0000000
NODE_43021_length_493_cov_34.946701	193	265	0	72	72	1.0000000
NODE_43022_length_493_cov_12.451777	173	253	2	6	80	0.0750000
NODE_43022_length_493_cov_12.451777	173	253	4	72	80	0.9000000
NODE_43022_length_493_cov_12.451777	173	253	6	2	80	0.0250000
NODE_43022_length_493_cov_12.451777	226	306	0	3	80	0.0375000
NODE_43022_length_493_cov_12.451777	226	306	2	15	80	0.1875000
NODE_43022_length_493_cov_12.451777	226	306	4	60	80	0.7500000
NODE_43022_length_493_cov_12.451777	226	306	6	2	80	0.0250000
NODE_43025_length_493_cov_8.540609	116	146	25	1	30	0.0333333
NODE_43025_length_493_cov_8.540609	116	146	29	1	30	0.0333333
NODE_43025_length_493_cov_8.540609	116	146	43	1	30	0.0333333
NODE_43025_length_493_cov_8.540609	116	146	45	1	30	0.0333333
NODE_43025_length_493_cov_8.540609	116	146	47	4	30	0.1333333
NODE_43025_length_493_cov_8.540609	116	146	49	2	30	0.0666667
NODE_43025_length_493_cov_8.540609	116	146	52	1	30	0.0333333
NODE_43025_length_493_cov_8.540609	116	146	58	1	30	0.0333333
NODE_43025_length_493_cov_8.540609	116	146	60	3	30	0.1000000
NODE_43025_length_493_cov_8.540609	116	146	62	2	30	0.0666667
NODE_43025_length_493_cov_8.540609	116	146	64	1	30	0.0333333
NODE_43025_length_493_cov_8.540609	116	146	66	5	30	0.1666667
NODE_43025_length_493_cov_8.540609	116	146	67	7	30	0.2333333
NODE_43025_length_493_cov_8.540609	119	199	45	1	80	0.0125000
NODE_43025_length_493_cov_8.540609	119	199	47	4	80	0.0500000
NODE_43025_length_493_cov_8.540609	119	199	49	2	80	0.0250000
NODE_43025_length_493_cov_8.540609	119	199	52	1	80	0.0125000
NODE_43025_length_493_cov_8.540609	119	199	58	1	80	0.0125000
NODE_43025_length_493_cov_8.540609	119	199	60	3	80	0.0375000
NODE_43025_length_493_cov_8.540609	119	199	62	2	80	0.0250000
NODE_43025_length_493_cov_8.540609	119	199	64	1	80	0.0125000
NODE_43025_length_493_cov_8.540609	119	199	66	5	80	0.0625000
NODE_43025_length_493_cov_8.540609	119	199	67	7	80	0.0875000
NODE_43025_length_493_cov_8.540609	119	199	71	1	80	0.0125000
NODE_43025_length_493_cov_8.540609	119	199	73	5	80	0.0625000
NODE_43025_length_493_cov_8.540609	119	199	77	5	80	0.0625000
NODE_43025_length_493_cov_8.540609	119	199	78	2	80	0.0250000
NODE_43025_length_493_cov_8.540609	119	199	84	1	80	0.0125000
NODE_43025_length_493_cov_8.540609	119	199	85	1	80	0.0125000
NODE_43025_length_493_cov_8.540609	119	199	87	1	80	0.0125000
NODE_43025_length_493_cov_8.540609	119	199	89	1	80	0.0125000
NODE_43025_length_493_cov_8.540609	119	199	94	1	80	0.0125000
NODE_43025_length_493_cov_8.540609	119	199	96	4	80	0.0500000
NODE_43025_length_493_cov_8.540609	119	199	98	4	80	0.0500000
NODE_43025_length_493_cov_8.540609	119	199	100	4	80	0.0500000
NODE_43025_length_493_cov_8.540609	119	199	102	2	80	0.0250000
NODE_43025_length_493_cov_8.540609	119	199	104	3	80	0.0375000
NODE_43025_length_493_cov_8.540609	119	199	106	4	80	0.0500000
NODE_43025_length_493_cov_8.540609	119	199	108	1	80	0.0125000
NODE_43025_length_493_cov_8.540609	119	199	110	6	80	0.0750000
NODE_43025_length_493_cov_8.540609	119	199	114	1	80	0.0125000
NODE_43025_length_493_cov_8.540609	119	199	118	3	80	0.0375000
NODE_43025_length_493_cov_8.540609	119	199	121	3	80	0.0375000
NODE_43031_length_493_cov_6.144670	300	380	4	49	80	0.6125000
NODE_43031_length_493_cov_6.144670	300	380	6	31	80	0.3875000
NODE_43031_length_493_cov_6.144670	353	433	0	10	80	0.1250000
NODE_43031_length_493_cov_6.144670	353	433	2	29	80	0.3625000
NODE_43031_length_493_cov_6.144670	353	433	6	41	80	0.5125000
NODE_43046_length_493_cov_3.840102	178	258	0	80	80	1.0000000
NODE_43046_length_493_cov_3.840102	231	311	0	80	80	1.0000000
NODE_43125_length_493_cov_1.588832	126	206	0	80	80	1.0000000
NODE_43125_length_493_cov_1.588832	179	259	0	80	80	1.0000000
NODE_43261_length_492_cov_5.488550	117	197	0	80	80	1.0000000
NODE_43261_length_492_cov_5.488550	170	250	0	80	80	1.0000000
NODE_43270_length_492_cov_4.445293	158	234	0	7	76	0.0921053
NODE_43270_length_492_cov_4.445293	158	234	4	69	76	0.9078947
NODE_43270_length_492_cov_4.445293	207	285	0	40	78	0.5128205
NODE_43270_length_492_cov_4.445293	207	285	4	38	78	0.4871795
NODE_43273_length_492_cov_4.244275	272	315	0	24	43	0.5581396
NODE_43273_length_492_cov_4.244275	272	315	2	7	43	0.1627907
NODE_43273_length_492_cov_4.244275	272	315	4	12	43	0.2790698
NODE_43293_length_492_cov_3.297710	113	193	0	80	80	1.0000000
NODE_43528_length_491_cov_17.196429	138	218	0	80	80	1.0000000
NODE_43528_length_491_cov_17.196429	191	271	0	80	80	1.0000000
NODE_43529_length_491_cov_17.193878	77	157	0	80	80	1.0000000
NODE_43529_length_491_cov_17.193878	130	210	0	80	80	1.0000000
NODE_43535_length_491_cov_5.505102	215	284	0	69	69	1.0000000
NODE_43535_length_491_cov_5.505102	215	295	0	80	80	1.0000000
NODE_43535_length_491_cov_5.505102	268	348	0	80	80	1.0000000
NODE_43536_length_491_cov_5.477041	169	222	0	53	53	1.0000000
NODE_43546_length_491_cov_4.176020	383	449	6	1	66	0.0151515
NODE_43546_length_491_cov_4.176020	383	449	10	65	66	0.9848485
NODE_43546_length_491_cov_4.176020	422	476	2	2	54	0.0370370
NODE_43546_length_491_cov_4.176020	422	476	4	2	54	0.0370370
NODE_43546_length_491_cov_4.176020	422	476	6	3	54	0.0555556
NODE_43546_length_491_cov_4.176020	422	476	8	4	54	0.0740741
NODE_43546_length_491_cov_4.176020	422	476	10	43	54	0.7962963
NODE_43570_length_491_cov_2.887755	348	428	0	80	80	1.0000000
NODE_43570_length_491_cov_2.887755	401	472	0	71	71	1.0000000
NODE_43575_length_491_cov_2.693878	239	316	0	8	77	0.1038961
NODE_43575_length_491_cov_2.693878	239	316	2	69	77	0.8961039
NODE_43744_length_490_cov_10.058824	192	272	2	26	80	0.3250000
NODE_43744_length_490_cov_10.058824	192	272	4	54	80	0.6750000
NODE_43744_length_490_cov_10.058824	245	325	0	18	80	0.2250000
NODE_43744_length_490_cov_10.058824	245	325	2	39	80	0.4875000
NODE_43744_length_490_cov_10.058824	245	325	4	23	80	0.2875000
NODE_43748_length_490_cov_6.652174	304	363	0	59	59	1.0000000
NODE_43816_length_490_cov_2.212276	241	300	0	47	59	0.7966102
NODE_43816_length_490_cov_2.212276	241	300	2	12	59	0.2033898
NODE_43816_length_490_cov_2.212276	280	358	0	40	78	0.5128205
NODE_43816_length_490_cov_2.212276	280	358	2	38	78	0.4871795
NODE_43886_length_490_cov_1.360614	97	159	4	9	62	0.1451613
NODE_43886_length_490_cov_1.360614	97	159	6	53	62	0.8548387
NODE_43886_length_490_cov_1.360614	132	212	0	6	80	0.0750000
NODE_43886_length_490_cov_1.360614	132	212	2	7	80	0.0875000
NODE_43886_length_490_cov_1.360614	132	212	4	41	80	0.5125000
NODE_43886_length_490_cov_1.360614	132	212	6	26	80	0.3250000
NODE_43993_length_489_cov_55.992308	50	130	0	80	80	1.0000000
NODE_43993_length_489_cov_55.992308	103	183	0	80	80	1.0000000
NODE_43993_length_489_cov_55.992308	179	259	0	80	80	1.0000000
NODE_43993_length_489_cov_55.992308	232	312	0	80	80	1.0000000
NODE_43994_length_489_cov_31.707692	299	384	10	11	85	0.1294118
NODE_43994_length_489_cov_31.707692	299	384	13	11	85	0.1294118
NODE_43994_length_489_cov_31.707692	299	384	14	8	85	0.0941176
NODE_43994_length_489_cov_31.707692	299	384	17	12	85	0.1411765
NODE_43994_length_489_cov_31.707692	299	384	18	27	85	0.3176471
NODE_43994_length_489_cov_31.707692	299	384	19	16	85	0.1882353
NODE_43994_length_489_cov_31.707692	299	384	10	11	85	0.1294118
NODE_43994_length_489_cov_31.707692	299	384	13	11	85	0.1294118
NODE_43994_length_489_cov_31.707692	299	384	14	8	85	0.0941176
NODE_43994_length_489_cov_31.707692	299	384	17	12	85	0.1411765
NODE_43994_length_489_cov_31.707692	299	384	18	27	85	0.3176471
NODE_43994_length_489_cov_31.707692	299	384	19	16	85	0.1882353
NODE_43996_length_489_cov_13.661538	227	307	0	80	80	1.0000000
NODE_43996_length_489_cov_13.661538	280	358	0	78	78	1.0000000
NODE_43997_length_489_cov_12.017949	214	294	0	80	80	1.0000000
NODE_43997_length_489_cov_12.017949	267	347	0	80	80	1.0000000
NODE_43998_length_489_cov_10.774359	262	304	0	42	42	1.0000000
NODE_44001_length_489_cov_8.094872	141	221	0	38	80	0.4750000
NODE_44001_length_489_cov_8.094872	141	221	3	1	80	0.0125000
NODE_44001_length_489_cov_8.094872	141	221	4	14	80	0.1750000
NODE_44001_length_489_cov_8.094872	141	221	6	27	80	0.3375000
NODE_44001_length_489_cov_8.094872	194	247	6	53	53	1.0000000
NODE_44007_length_489_cov_5.284615	176	256	0	45	80	0.5625000
NODE_44007_length_489_cov_5.284615	176	256	2	35	80	0.4375000
NODE_44007_length_489_cov_5.284615	229	309	0	80	80	1.0000000
NODE_44096_length_489_cov_1.646154	234	278	0	44	44	1.0000000
NODE_44105_length_489_cov_1.574359	351	391	0	11	40	0.2750000
NODE_44105_length_489_cov_1.574359	351	391	2	29	40	0.7250000
NODE_44105_length_489_cov_1.574359	351	383	0	3	32	0.0937500
NODE_44105_length_489_cov_1.574359	351	383	2	29	32	0.9062500
NODE_44105_length_489_cov_1.574359	365	445	0	65	80	0.8125000
NODE_44105_length_489_cov_1.574359	365	445	2	15	80	0.1875000
NODE_44105_length_489_cov_1.574359	365	445	0	65	80	0.8125000
NODE_44105_length_489_cov_1.574359	365	445	2	15	80	0.1875000
NODE_44105_length_489_cov_1.574359	366	445	0	65	79	0.8227848
NODE_44105_length_489_cov_1.574359	366	445	2	14	79	0.1772152
NODE_44231_length_488_cov_15.406170	235	313	0	39	78	0.5000000
NODE_44231_length_488_cov_15.406170	235	313	2	39	78	0.5000000
NODE_44231_length_488_cov_15.406170	286	367	0	28	81	0.3456790
NODE_44231_length_488_cov_15.406170	286	367	2	53	81	0.6543210
NODE_44234_length_488_cov_8.416452	210	290	0	80	80	1.0000000
NODE_44234_length_488_cov_8.416452	263	343	0	80	80	1.0000000
NODE_44240_length_488_cov_6.084833	254	302	8	19	48	0.3958333
NODE_44240_length_488_cov_6.084833	254	302	12	3	48	0.0625000
NODE_44240_length_488_cov_6.084833	254	302	16	26	48	0.5416667
NODE_44243_length_488_cov_5.434447	210	279	0	69	69	1.0000000
NODE_44243_length_488_cov_5.434447	265	300	0	35	35	1.0000000
NODE_44263_length_488_cov_3.431877	212	248	0	36	36	1.0000000
NODE_44264_length_488_cov_3.424165	320	367	2	6	47	0.1276596
NODE_44264_length_488_cov_3.424165	320	367	4	41	47	0.8723404
NODE_44264_length_488_cov_3.424165	320	378	2	6	58	0.1034483
NODE_44264_length_488_cov_3.424165	320	378	4	42	58	0.7241379
NODE_44264_length_488_cov_3.424165	320	378	6	10	58	0.1724138
NODE_44264_length_488_cov_3.424165	351	393	4	17	42	0.4047619
NODE_44264_length_488_cov_3.424165	351	393	6	25	42	0.5952381
NODE_44264_length_488_cov_3.424165	360	395	4	8	35	0.2285714
NODE_44264_length_488_cov_3.424165	360	395	6	27	35	0.7714286
NODE_44274_length_488_cov_2.850900	276	356	4	23	80	0.2875000
NODE_44274_length_488_cov_2.850900	276	356	6	31	80	0.3875000
NODE_44274_length_488_cov_2.850900	276	356	8	26	80	0.3250000
NODE_44376_length_488_cov_1.562982	31	67	0	36	36	1.0000000
NODE_44496_length_487_cov_7.028351	278	358	12	12	80	0.1500000
NODE_44496_length_487_cov_7.028351	278	358	14	5	80	0.0625000
NODE_44496_length_487_cov_7.028351	278	358	15	8	80	0.1000000
NODE_44496_length_487_cov_7.028351	278	358	16	55	80	0.6875000
NODE_44498_length_487_cov_6.804124	242	313	4	41	71	0.5774648
NODE_44498_length_487_cov_6.804124	242	313	6	1	71	0.0140845
NODE_44498_length_487_cov_6.804124	242	313	8	21	71	0.2957746
NODE_44498_length_487_cov_6.804124	242	313	10	8	71	0.1126761
NODE_44498_length_487_cov_6.804124	286	366	0	9	80	0.1125000
NODE_44498_length_487_cov_6.804124	286	366	4	71	80	0.8875000
NODE_44500_length_487_cov_5.917526	140	220	2	80	80	1.0000000
NODE_44500_length_487_cov_5.917526	193	273	0	17	80	0.2125000
NODE_44500_length_487_cov_5.917526	193	273	2	63	80	0.7875000
NODE_44520_length_487_cov_3.296392	235	315	0	48	80	0.6000000
NODE_44520_length_487_cov_3.296392	235	315	2	2	80	0.0250000
NODE_44520_length_487_cov_3.296392	235	315	4	23	80	0.2875000
NODE_44520_length_487_cov_3.296392	235	315	6	7	80	0.0875000
NODE_44521_length_487_cov_3.237113	301	363	0	62	62	1.0000000
NODE_44525_length_487_cov_3.074742	214	294	2	58	80	0.7250000
NODE_44525_length_487_cov_3.074742	214	294	4	5	80	0.0625000
NODE_44525_length_487_cov_3.074742	214	294	6	17	80	0.2125000
NODE_44723_length_486_cov_6.609819	206	286	0	55	80	0.6875000
NODE_44723_length_486_cov_6.609819	206	286	2	15	80	0.1875000
NODE_44723_length_486_cov_6.609819	206	286	4	10	80	0.1250000
NODE_44728_length_486_cov_5.428941	147	227	2	80	80	1.0000000
NODE_44754_length_486_cov_3.072351	131	211	0	23	80	0.2875000
NODE_44754_length_486_cov_3.072351	131	211	2	3	80	0.0375000
NODE_44754_length_486_cov_3.072351	131	211	4	54	80	0.6750000
NODE_44754_length_486_cov_3.072351	190	235	0	45	45	1.0000000
NODE_44769_length_486_cov_2.581395	156	236	0	80	80	1.0000000
NODE_44769_length_486_cov_2.581395	209	289	0	80	80	1.0000000
NODE_44781_length_486_cov_2.343669	189	230	2	41	41	1.0000000
NODE_44781_length_486_cov_2.343669	242	306	0	54	64	0.8437500
NODE_44781_length_486_cov_2.343669	242	306	2	10	64	0.1562500
NODE_44959_length_485_cov_29.505181	270	350	0	80	80	1.0000000
NODE_44959_length_485_cov_29.505181	323	403	0	80	80	1.0000000
NODE_44959_length_485_cov_29.505181	399	479	0	80	80	1.0000000
NODE_44960_length_485_cov_10.450777	67	153	0	86	86	1.0000000
NODE_44960_length_485_cov_10.450777	133	206	0	73	73	1.0000000
NODE_44965_length_485_cov_5.922280	196	273	2	77	77	1.0000000
NODE_44965_length_485_cov_5.922280	246	326	0	45	80	0.5625000
NODE_44965_length_485_cov_5.922280	246	326	2	35	80	0.4375000
NODE_44966_length_485_cov_5.818653	279	359	0	10	80	0.1250000
NODE_44966_length_485_cov_5.818653	279	359	2	29	80	0.3625000
NODE_44966_length_485_cov_5.818653	279	359	3	12	80	0.1500000
NODE_44966_length_485_cov_5.818653	279	359	4	29	80	0.3625000
NODE_44966_length_485_cov_5.818653	332	412	2	34	80	0.4250000
NODE_44966_length_485_cov_5.818653	332	412	4	46	80	0.5750000
NODE_44968_length_485_cov_5.670984	321	396	0	45	75	0.6000000
NODE_44968_length_485_cov_5.670984	321	396	2	11	75	0.1466667
NODE_44968_length_485_cov_5.670984	321	396	4	19	75	0.2533333
NODE_44992_length_485_cov_3.518135	162	210	2	8	48	0.1666667
NODE_44992_length_485_cov_3.518135	162	210	4	40	48	0.8333333
NODE_45005_length_485_cov_2.790155	193	253	0	60	60	1.0000000
NODE_45021_length_485_cov_2.427461	170	249	0	64	79	0.8101266
NODE_45021_length_485_cov_2.427461	170	249	2	15	79	0.1898734
NODE_45100_length_485_cov_1.264249	232	251	0	19	19	1.0000000
NODE_45193_length_484_cov_33.384416	92	172	0	27	80	0.3375000
NODE_45193_length_484_cov_33.384416	92	172	4	53	80	0.6625000
NODE_45193_length_484_cov_33.384416	145	225	4	80	80	1.0000000
NODE_45195_length_484_cov_9.111688	136	216	0	80	80	1.0000000
NODE_45195_length_484_cov_9.111688	189	270	0	81	81	1.0000000
NODE_45196_length_484_cov_8.353247	165	244	0	17	79	0.2151899
NODE_45196_length_484_cov_8.353247	165	244	2	62	79	0.7848101
NODE_45196_length_484_cov_8.353247	217	297	2	80	80	1.0000000
NODE_45197_length_484_cov_8.119481	108	188	0	80	80	1.0000000
NODE_45197_length_484_cov_8.119481	161	241	0	80	80	1.0000000
NODE_45200_length_484_cov_7.703896	208	288	4	80	80	1.0000000
NODE_45200_length_484_cov_7.703896	261	341	0	47	80	0.5875000
NODE_45200_length_484_cov_7.703896	261	341	4	33	80	0.4125000
NODE_45202_length_484_cov_7.153247	230	292	0	20	62	0.3225806
NODE_45202_length_484_cov_7.153247	230	292	1	12	62	0.1935484
NODE_45202_length_484_cov_7.153247	230	292	2	30	62	0.4838710
NODE_45204_length_484_cov_6.594805	221	301	0	80	80	1.0000000
NODE_45204_length_484_cov_6.594805	274	354	0	37	80	0.4625000
NODE_45204_length_484_cov_6.594805	274	354	1	43	80	0.5375000
NODE_45218_length_484_cov_4.044156	267	347	2	26	80	0.3250000
NODE_45218_length_484_cov_4.044156	267	347	4	3	80	0.0375000
NODE_45218_length_484_cov_4.044156	267	347	6	43	80	0.5375000
NODE_45218_length_484_cov_4.044156	267	347	8	8	80	0.1000000
NODE_45218_length_484_cov_4.044156	342	396	6	1	54	0.0185185
NODE_45218_length_484_cov_4.044156	342	396	8	18	54	0.3333333
NODE_45218_length_484_cov_4.044156	342	396	10	17	54	0.3148148
NODE_45218_length_484_cov_4.044156	342	396	12	18	54	0.3333333
NODE_45225_length_484_cov_3.787013	287	331	0	44	44	1.0000000
NODE_45225_length_484_cov_3.787013	307	386	0	79	79	1.0000000
NODE_45225_length_484_cov_3.787013	317	386	0	69	69	1.0000000
NODE_45276_length_484_cov_2.254545	79	132	0	53	53	1.0000000
NODE_45352_length_484_cov_1.322078	429	477	0	48	48	1.0000000
NODE_45353_length_484_cov_1.314286	431	472	0	41	41	1.0000000
NODE_45459_length_483_cov_40.815104	396	473	0	77	77	1.0000000
NODE_45459_length_483_cov_40.815104	396	473	0	77	77	1.0000000
NODE_45473_length_483_cov_5.289062	124	185	0	61	61	1.0000000
NODE_45494_length_483_cov_4.114583	226	306	0	80	80	1.0000000
NODE_45494_length_483_cov_4.114583	226	305	0	79	79	1.0000000
NODE_45494_length_483_cov_4.114583	226	306	0	80	80	1.0000000
NODE_45494_length_483_cov_4.114583	226	306	0	80	80	1.0000000
NODE_45494_length_483_cov_4.114583	279	359	0	80	80	1.0000000
NODE_45494_length_483_cov_4.114583	279	325	0	46	46	1.0000000
NODE_45494_length_483_cov_4.114583	297	323	0	26	26	1.0000000
NODE_45495_length_483_cov_4.046875	68	117	0	49	49	1.0000000
NODE_45495_length_483_cov_4.046875	184	250	0	66	66	1.0000000
NODE_45635_length_483_cov_1.205729	249	291	0	42	42	1.0000000
NODE_45725_length_482_cov_37.900783	72	152	14	33	80	0.4125000
NODE_45725_length_482_cov_37.900783	72	152	15	12	80	0.1500000
NODE_45725_length_482_cov_37.900783	72	152	16	35	80	0.4375000
NODE_45725_length_482_cov_37.900783	125	205	0	16	80	0.2000000
NODE_45725_length_482_cov_37.900783	125	205	10	35	80	0.4375000
NODE_45725_length_482_cov_37.900783	125	205	15	1	80	0.0125000
NODE_45725_length_482_cov_37.900783	125	205	16	28	80	0.3500000
NODE_45728_length_482_cov_10.545692	233	297	0	64	64	1.0000000
NODE_45729_length_482_cov_9.342037	281	333	0	21	52	0.4038461
NODE_45729_length_482_cov_9.342037	281	333	2	31	52	0.5961539
NODE_45730_length_482_cov_8.190601	247	311	8	19	64	0.2968750
NODE_45730_length_482_cov_8.190601	247	311	10	3	64	0.0468750
NODE_45730_length_482_cov_8.190601	247	311	11	11	64	0.1718750
NODE_45730_length_482_cov_8.190601	247	311	12	16	64	0.2500000
NODE_45730_length_482_cov_8.190601	247	311	13	2	64	0.0312500
NODE_45730_length_482_cov_8.190601	247	311	14	13	64	0.2031250
NODE_45730_length_482_cov_8.190601	284	355	5	18	71	0.2535211
NODE_45730_length_482_cov_8.190601	284	355	8	45	71	0.6338028
NODE_45730_length_482_cov_8.190601	284	355	10	3	71	0.0422535
NODE_45730_length_482_cov_8.190601	284	355	11	5	71	0.0704225
NODE_45734_length_482_cov_6.002611	112	192	0	80	80	1.0000000
NODE_45734_length_482_cov_6.002611	165	245	0	80	80	1.0000000
NODE_45735_length_482_cov_5.953003	315	395	0	80	80	1.0000000
NODE_45735_length_482_cov_5.953003	368	441	0	73	73	1.0000000
NODE_45748_length_482_cov_4.530026	20	85	0	65	65	1.0000000
NODE_45759_length_482_cov_3.791123	278	358	0	80	80	1.0000000
NODE_45759_length_482_cov_3.791123	331	411	0	80	80	1.0000000
NODE_45842_length_482_cov_1.647520	382	446	0	28	64	0.4375000
NODE_45842_length_482_cov_1.647520	382	446	4	36	64	0.5625000
NODE_45842_length_482_cov_1.647520	435	482	0	1	47	0.0212766
NODE_45842_length_482_cov_1.647520	435	482	4	46	47	0.9787234
NODE_45994_length_481_cov_50.623037	154	234	0	80	80	1.0000000
NODE_45994_length_481_cov_50.623037	207	287	0	80	80	1.0000000
NODE_45995_length_481_cov_30.939791	149	198	0	12	49	0.2448980
NODE_45995_length_481_cov_30.939791	149	198	2	37	49	0.7551020
NODE_45995_length_481_cov_30.939791	171	235	2	64	64	1.0000000
NODE_45995_length_481_cov_30.939791	171	235	2	64	64	1.0000000
NODE_45996_length_481_cov_30.183246	0	41	0	25	41	0.6097561
NODE_45996_length_481_cov_30.183246	0	41	5	1	41	0.0243902
NODE_45996_length_481_cov_30.183246	0	41	6	15	41	0.3658537
NODE_45996_length_481_cov_30.183246	0	39	0	25	39	0.6410257
NODE_45996_length_481_cov_30.183246	0	39	5	1	39	0.0256410
NODE_45996_length_481_cov_30.183246	0	39	6	13	39	0.3333333
NODE_45996_length_481_cov_30.183246	0	44	0	25	44	0.5681818
NODE_45996_length_481_cov_30.183246	0	44	5	1	44	0.0227273
NODE_45996_length_481_cov_30.183246	0	44	6	18	44	0.4090909
NODE_45996_length_481_cov_30.183246	0	44	0	25	44	0.5681818
NODE_45996_length_481_cov_30.183246	0	44	5	1	44	0.0227273
NODE_45996_length_481_cov_30.183246	0	44	6	18	44	0.4090909
NODE_45996_length_481_cov_30.183246	0	44	0	25	44	0.5681818
NODE_45996_length_481_cov_30.183246	0	44	5	1	44	0.0227273
NODE_45996_length_481_cov_30.183246	0	44	6	18	44	0.4090909
NODE_45996_length_481_cov_30.183246	0	44	0	25	44	0.5681818
NODE_45996_length_481_cov_30.183246	0	44	5	1	44	0.0227273
NODE_45996_length_481_cov_30.183246	0	44	6	18	44	0.4090909
NODE_45996_length_481_cov_30.183246	17	97	0	8	80	0.1000000
NODE_45996_length_481_cov_30.183246	17	97	5	1	80	0.0125000
NODE_45996_length_481_cov_30.183246	17	97	6	71	80	0.8875000
NODE_45996_length_481_cov_30.183246	17	97	0	8	80	0.1000000
NODE_45996_length_481_cov_30.183246	17	97	5	1	80	0.0125000
NODE_45996_length_481_cov_30.183246	17	97	6	71	80	0.8875000
NODE_45996_length_481_cov_30.183246	17	97	0	8	80	0.1000000
NODE_45996_length_481_cov_30.183246	17	97	5	1	80	0.0125000
NODE_45996_length_481_cov_30.183246	17	97	6	71	80	0.8875000
NODE_45996_length_481_cov_30.183246	17	97	0	8	80	0.1000000
NODE_45996_length_481_cov_30.183246	17	97	5	1	80	0.0125000
NODE_45996_length_481_cov_30.183246	17	97	6	71	80	0.8875000
NODE_45996_length_481_cov_30.183246	17	97	0	8	80	0.1000000
NODE_45996_length_481_cov_30.183246	17	97	5	1	80	0.0125000
NODE_45996_length_481_cov_30.183246	17	97	6	71	80	0.8875000
NODE_45996_length_481_cov_30.183246	17	97	0	8	80	0.1000000
NODE_45996_length_481_cov_30.183246	17	97	5	1	80	0.0125000
NODE_45996_length_481_cov_30.183246	17	97	6	71	80	0.8875000
NODE_45997_length_481_cov_12.709424	250	330	17	1	80	0.0125000
NODE_45997_length_481_cov_12.709424	250	330	19	2	80	0.0250000
NODE_45997_length_481_cov_12.709424	250	330	21	9	80	0.1125000
NODE_45997_length_481_cov_12.709424	250	330	23	10	80	0.1250000
NODE_45997_length_481_cov_12.709424	250	330	29	19	80	0.2375000
NODE_45997_length_481_cov_12.709424	250	330	31	39	80	0.4875000
NODE_45997_length_481_cov_12.709424	303	383	12	10	80	0.1250000
NODE_45997_length_481_cov_12.709424	303	383	14	8	80	0.1000000
NODE_45997_length_481_cov_12.709424	303	383	16	1	80	0.0125000
NODE_45997_length_481_cov_12.709424	303	383	18	2	80	0.0250000
NODE_45997_length_481_cov_12.709424	303	383	25	2	80	0.0250000
NODE_45997_length_481_cov_12.709424	303	383	28	1	80	0.0125000
NODE_45997_length_481_cov_12.709424	303	383	29	1	80	0.0125000
NODE_45997_length_481_cov_12.709424	303	383	31	35	80	0.4375000
NODE_45997_length_481_cov_12.709424	303	383	32	8	80	0.1000000
NODE_45997_length_481_cov_12.709424	303	383	33	2	80	0.0250000
NODE_45997_length_481_cov_12.709424	303	383	34	5	80	0.0625000
NODE_45997_length_481_cov_12.709424	303	383	35	3	80	0.0375000
NODE_45997_length_481_cov_12.709424	303	383	37	2	80	0.0250000
NODE_46037_length_481_cov_3.002618	197	277	0	80	80	1.0000000
NODE_46064_length_481_cov_2.261780	271	351	4	12	80	0.1500000
NODE_46064_length_481_cov_2.261780	271	351	6	10	80	0.1250000
NODE_46064_length_481_cov_2.261780	271	351	7	4	80	0.0500000
NODE_46064_length_481_cov_2.261780	271	351	8	54	80	0.6750000
NODE_46256_length_480_cov_22.346457	318	398	0	80	80	1.0000000
NODE_46256_length_480_cov_22.346457	371	451	0	80	80	1.0000000
NODE_46257_length_480_cov_16.488189	252	332	0	30	80	0.3750000
NODE_46257_length_480_cov_16.488189	252	332	2	50	80	0.6250000
NODE_46257_length_480_cov_16.488189	305	385	0	23	80	0.2875000
NODE_46257_length_480_cov_16.488189	305	385	2	57	80	0.7125000
NODE_46258_length_480_cov_12.874016	164	234	2	5	70	0.0714286
NODE_46258_length_480_cov_12.874016	164	234	4	65	70	0.9285714
NODE_46258_length_480_cov_12.874016	207	273	2	43	66	0.6515151
NODE_46258_length_480_cov_12.874016	207	273	4	23	66	0.3484848
NODE_46260_length_480_cov_11.879265	170	250	0	80	80	1.0000000
NODE_46260_length_480_cov_11.879265	223	303	0	80	80	1.0000000
NODE_46261_length_480_cov_8.774278	114	143	4	29	29	1.0000000
NODE_46261_length_480_cov_8.774278	165	245	0	2	80	0.0250000
NODE_46261_length_480_cov_8.774278	165	245	2	68	80	0.8500000
NODE_46261_length_480_cov_8.774278	165	245	6	1	80	0.0125000
NODE_46261_length_480_cov_8.774278	165	245	10	9	80	0.1125000
NODE_46261_length_480_cov_8.774278	218	298	2	17	80	0.2125000
NODE_46261_length_480_cov_8.774278	218	298	6	1	80	0.0125000
NODE_46261_length_480_cov_8.774278	218	298	10	47	80	0.5875000
NODE_46261_length_480_cov_8.774278	218	298	12	5	80	0.0625000
NODE_46261_length_480_cov_8.774278	218	298	14	10	80	0.1250000
NODE_46261_length_480_cov_8.774278	385	428	4	19	43	0.4418605
NODE_46261_length_480_cov_8.774278	385	428	6	3	43	0.0697674
NODE_46261_length_480_cov_8.774278	385	428	8	21	43	0.4883721
NODE_46271_length_480_cov_5.671916	231	302	0	71	71	1.0000000
NODE_46283_length_480_cov_4.354331	126	187	0	6	61	0.0983607
NODE_46283_length_480_cov_4.354331	126	187	2	55	61	0.9016393
NODE_46283_length_480_cov_4.354331	218	298	2	32	80	0.4000000
NODE_46283_length_480_cov_4.354331	218	298	4	48	80	0.6000000
NODE_46445_length_480_cov_1.152231	142	216	0	50	74	0.6756757
NODE_46445_length_480_cov_1.152231	142	216	4	2	74	0.0270270
NODE_46445_length_480_cov_1.152231	142	216	8	22	74	0.2972973
NODE_46470_length_480_cov_0.973753	31	71	2	35	40	0.8750000
NODE_46470_length_480_cov_0.973753	31	71	4	5	40	0.1250000
NODE_46533_length_479_cov_28.205263	308	388	12	18	80	0.2250000
NODE_46533_length_479_cov_28.205263	308	388	13	15	80	0.1875000
NODE_46533_length_479_cov_28.205263	308	388	17	20	80	0.2500000
NODE_46533_length_479_cov_28.205263	308	388	19	27	80	0.3375000
NODE_46533_length_479_cov_28.205263	361	441	6	5	80	0.0625000
NODE_46533_length_479_cov_28.205263	361	441	8	3	80	0.0375000
NODE_46533_length_479_cov_28.205263	361	441	15	1	80	0.0125000
NODE_46533_length_479_cov_28.205263	361	441	16	34	80	0.4250000
NODE_46533_length_479_cov_28.205263	361	441	17	4	80	0.0500000
NODE_46533_length_479_cov_28.205263	361	441	19	33	80	0.4125000
NODE_46534_length_479_cov_23.944737	189	269	0	80	80	1.0000000
NODE_46534_length_479_cov_23.944737	242	322	0	80	80	1.0000000
NODE_46554_length_479_cov_4.942105	283	363	0	80	80	1.0000000
NODE_46554_length_479_cov_4.942105	336	416	0	80	80	1.0000000
NODE_46574_length_479_cov_3.494737	217	279	0	62	62	1.0000000
NODE_46574_length_479_cov_3.494737	272	332	0	60	60	1.0000000
NODE_46611_length_479_cov_2.281579	219	265	2	17	46	0.3695652
NODE_46611_length_479_cov_2.281579	219	265	4	1	46	0.0217391
NODE_46611_length_479_cov_2.281579	219	265	6	27	46	0.5869565
NODE_46611_length_479_cov_2.281579	219	265	8	1	46	0.0217391
NODE_46638_length_479_cov_1.839474	376	431	2	45	55	0.8181818
NODE_46638_length_479_cov_1.839474	376	431	4	10	55	0.1818182
NODE_46654_length_479_cov_1.710526	203	265	0	16	62	0.2580645
NODE_46654_length_479_cov_1.710526	203	265	2	14	62	0.2258064
NODE_46654_length_479_cov_1.710526	203	265	4	32	62	0.5161290
NODE_46654_length_479_cov_1.710526	248	318	0	14	70	0.2000000
NODE_46654_length_479_cov_1.710526	248	318	2	56	70	0.8000000
NODE_46828_length_478_cov_336.139842	153	233	209	1	80	0.0125000
NODE_46828_length_478_cov_336.139842	153	233	211	1	80	0.0125000
NODE_46828_length_478_cov_336.139842	153	233	213	1	80	0.0125000
NODE_46828_length_478_cov_336.139842	153	233	221	1	80	0.0125000
NODE_46828_length_478_cov_336.139842	153	233	223	1	80	0.0125000
NODE_46828_length_478_cov_336.139842	153	233	225	1	80	0.0125000
NODE_46828_length_478_cov_336.139842	153	233	233	1	80	0.0125000
NODE_46828_length_478_cov_336.139842	153	233	243	1	80	0.0125000
NODE_46828_length_478_cov_336.139842	153	233	245	1	80	0.0125000
NODE_46828_length_478_cov_336.139842	153	233	247	2	80	0.0250000
NODE_46828_length_478_cov_336.139842	153	233	255	1	80	0.0125000
NODE_46828_length_478_cov_336.139842	153	233	263	2	80	0.0250000
NODE_46828_length_478_cov_336.139842	153	233	265	2	80	0.0250000
NODE_46828_length_478_cov_336.139842	153	233	266	1	80	0.0125000
NODE_46828_length_478_cov_336.139842	153	233	267	4	80	0.0500000
NODE_46828_length_478_cov_336.139842	153	233	268	6	80	0.0750000
NODE_46828_length_478_cov_336.139842	153	233	269	1	80	0.0125000
NODE_46828_length_478_cov_336.139842	153	233	270	1	80	0.0125000
NODE_46828_length_478_cov_336.139842	153	233	273	2	80	0.0250000
NODE_46828_length_478_cov_336.139842	153	233	274	1	80	0.0125000
NODE_46828_length_478_cov_336.139842	153	233	275	2	80	0.0250000
NODE_46828_length_478_cov_336.139842	153	233	277	1	80	0.0125000
NODE_46828_length_478_cov_336.139842	153	233	279	1	80	0.0125000
NODE_46828_length_478_cov_336.139842	153	233	288	2	80	0.0250000
NODE_46828_length_478_cov_336.139842	153	233	292	2	80	0.0250000
NODE_46828_length_478_cov_336.139842	153	233	294	3	80	0.0375000
NODE_46828_length_478_cov_336.139842	153	233	298	1	80	0.0125000
NODE_46828_length_478_cov_336.139842	153	233	303	1	80	0.0125000
NODE_46828_length_478_cov_336.139842	153	233	305	1	80	0.0125000
NODE_46828_length_478_cov_336.139842	153	233	309	2	80	0.0250000
NODE_46828_length_478_cov_336.139842	153	233	313	1	80	0.0125000
NODE_46828_length_478_cov_336.139842	153	233	314	1	80	0.0125000
NODE_46828_length_478_cov_336.139842	153	233	315	1	80	0.0125000
NODE_46828_length_478_cov_336.139842	153	233	316	2	80	0.0250000
NODE_46828_length_478_cov_336.139842	153	233	326	1	80	0.0125000
NODE_46828_length_478_cov_336.139842	153	233	332	1	80	0.0125000
NODE_46828_length_478_cov_336.139842	153	233	334	1	80	0.0125000
NODE_46828_length_478_cov_336.139842	153	233	335	4	80	0.0500000
NODE_46828_length_478_cov_336.139842	153	233	336	1	80	0.0125000
NODE_46828_length_478_cov_336.139842	153	233	337	1	80	0.0125000
NODE_46828_length_478_cov_336.139842	153	233	341	4	80	0.0500000
NODE_46828_length_478_cov_336.139842	153	233	343	3	80	0.0375000
NODE_46828_length_478_cov_336.139842	153	233	344	1	80	0.0125000
NODE_46828_length_478_cov_336.139842	153	233	345	5	80	0.0625000
NODE_46828_length_478_cov_336.139842	153	233	348	1	80	0.0125000
NODE_46828_length_478_cov_336.139842	153	233	349	1	80	0.0125000
NODE_46828_length_478_cov_336.139842	153	233	350	3	80	0.0375000
NODE_46828_length_478_cov_336.139842	206	286	221	1	80	0.0125000
NODE_46828_length_478_cov_336.139842	206	286	223	3	80	0.0375000
NODE_46828_length_478_cov_336.139842	206	286	231	1	80	0.0125000
NODE_46828_length_478_cov_336.139842	206	286	237	1	80	0.0125000
NODE_46828_length_478_cov_336.139842	206	286	247	2	80	0.0250000
NODE_46828_length_478_cov_336.139842	206	286	249	1	80	0.0125000
NODE_46828_length_478_cov_336.139842	206	286	252	1	80	0.0125000
NODE_46828_length_478_cov_336.139842	206	286	258	2	80	0.0250000
NODE_46828_length_478_cov_336.139842	206	286	270	1	80	0.0125000
NODE_46828_length_478_cov_336.139842	206	286	272	1	80	0.0125000
NODE_46828_length_478_cov_336.139842	206	286	275	1	80	0.0125000
NODE_46828_length_478_cov_336.139842	206	286	279	2	80	0.0250000
NODE_46828_length_478_cov_336.139842	206	286	283	1	80	0.0125000
NODE_46828_length_478_cov_336.139842	206	286	284	1	80	0.0125000
NODE_46828_length_478_cov_336.139842	206	286	285	3	80	0.0375000
NODE_46828_length_478_cov_336.139842	206	286	288	1	80	0.0125000
NODE_46828_length_478_cov_336.139842	206	286	294	1	80	0.0125000
NODE_46828_length_478_cov_336.139842	206	286	312	1	80	0.0125000
NODE_46828_length_478_cov_336.139842	206	286	318	1	80	0.0125000
NODE_46828_length_478_cov_336.139842	206	286	322	1	80	0.0125000
NODE_46828_length_478_cov_336.139842	206	286	325	3	80	0.0375000
NODE_46828_length_478_cov_336.139842	206	286	326	2	80	0.0250000
NODE_46828_length_478_cov_336.139842	206	286	327	2	80	0.0250000
NODE_46828_length_478_cov_336.139842	206	286	329	3	80	0.0375000
NODE_46828_length_478_cov_336.139842	206	286	332	2	80	0.0250000
NODE_46828_length_478_cov_336.139842	206	286	333	1	80	0.0125000
NODE_46828_length_478_cov_336.139842	206	286	334	3	80	0.0375000
NODE_46828_length_478_cov_336.139842	206	286	335	5	80	0.0625000
NODE_46828_length_478_cov_336.139842	206	286	336	1	80	0.0125000
NODE_46828_length_478_cov_336.139842	206	286	337	3	80	0.0375000
NODE_46828_length_478_cov_336.139842	206	286	341	7	80	0.0875000
NODE_46828_length_478_cov_336.139842	206	286	343	8	80	0.1000000
NODE_46828_length_478_cov_336.139842	206	286	344	1	80	0.0125000
NODE_46828_length_478_cov_336.139842	206	286	345	6	80	0.0750000
NODE_46828_length_478_cov_336.139842	206	286	347	1	80	0.0125000
NODE_46828_length_478_cov_336.139842	206	286	348	1	80	0.0125000
NODE_46828_length_478_cov_336.139842	206	286	349	1	80	0.0125000
NODE_46828_length_478_cov_336.139842	206	286	350	3	80	0.0375000
NODE_46846_length_478_cov_4.448549	150	230	0	80	80	1.0000000
NODE_46846_length_478_cov_4.448549	203	284	0	81	81	1.0000000
NODE_46874_length_478_cov_2.627968	228	278	0	10	50	0.2000000
NODE_46874_length_478_cov_2.627968	228	278	4	40	50	0.8000000
NODE_47128_length_477_cov_36.230159	225	305	0	80	80	1.0000000
NODE_47128_length_477_cov_36.230159	278	358	0	80	80	1.0000000
NODE_47129_length_477_cov_33.111111	307	387	0	5	80	0.0625000
NODE_47129_length_477_cov_33.111111	307	387	2	36	80	0.4500000
NODE_47129_length_477_cov_33.111111	307	387	4	16	80	0.2000000
NODE_47129_length_477_cov_33.111111	307	387	6	23	80	0.2875000
NODE_47129_length_477_cov_33.111111	360	440	0	14	80	0.1750000
NODE_47129_length_477_cov_33.111111	360	440	2	66	80	0.8250000
NODE_47133_length_477_cov_11.235450	119	199	0	60	80	0.7500000
NODE_47133_length_477_cov_11.235450	119	199	2	20	80	0.2500000
NODE_47133_length_477_cov_11.235450	172	247	0	7	75	0.0933333
NODE_47133_length_477_cov_11.235450	172	247	2	68	75	0.9066667
NODE_47135_length_477_cov_9.359788	221	301	0	80	80	1.0000000
NODE_47135_length_477_cov_9.359788	274	354	0	80	80	1.0000000
NODE_47139_length_477_cov_7.436508	230	304	6	1	74	0.0135135
NODE_47139_length_477_cov_7.436508	230	304	8	6	74	0.0810811
NODE_47139_length_477_cov_7.436508	230	304	10	1	74	0.0135135
NODE_47139_length_477_cov_7.436508	230	304	18	1	74	0.0135135
NODE_47139_length_477_cov_7.436508	230	304	20	11	74	0.1486486
NODE_47139_length_477_cov_7.436508	230	304	22	4	74	0.0540541
NODE_47139_length_477_cov_7.436508	230	304	24	6	74	0.0810811
NODE_47139_length_477_cov_7.436508	230	304	26	2	74	0.0270270
NODE_47139_length_477_cov_7.436508	230	304	28	2	74	0.0270270
NODE_47139_length_477_cov_7.436508	230	304	36	2	74	0.0270270
NODE_47139_length_477_cov_7.436508	230	304	38	3	74	0.0405405
NODE_47139_length_477_cov_7.436508	230	304	42	6	74	0.0810811
NODE_47139_length_477_cov_7.436508	230	304	49	2	74	0.0270270
NODE_47139_length_477_cov_7.436508	230	304	50	27	74	0.3648649
NODE_47140_length_477_cov_7.433862	43	123	0	16	80	0.2000000
NODE_47140_length_477_cov_7.433862	43	123	2	64	80	0.8000000
NODE_47140_length_477_cov_7.433862	96	176	0	25	80	0.3125000
NODE_47140_length_477_cov_7.433862	96	176	2	55	80	0.6875000
NODE_47143_length_477_cov_6.846561	163	243	0	80	80	1.0000000
NODE_47143_length_477_cov_6.846561	216	296	0	80	80	1.0000000
NODE_47147_length_477_cov_5.677249	150	228	0	24	78	0.3076923
NODE_47147_length_477_cov_5.677249	150	228	4	54	78	0.6923077
NODE_47148_length_477_cov_5.084656	227	288	0	61	61	1.0000000
NODE_47253_length_477_cov_1.629630	115	171	6	56	56	1.0000000
NODE_47253_length_477_cov_1.629630	167	224	0	28	57	0.4912281
NODE_47253_length_477_cov_1.629630	167	224	2	19	57	0.3333333
NODE_47253_length_477_cov_1.629630	167	224	6	10	57	0.1754386
NODE_47375_length_477_cov_0.859788	445	477	0	32	32	1.0000000
NODE_47427_length_476_cov_7.533156	221	301	0	80	80	1.0000000
NODE_47427_length_476_cov_7.533156	274	354	0	80	80	1.0000000
NODE_47529_length_476_cov_1.618037	385	444	0	59	59	1.0000000
NODE_47601_length_476_cov_1.129973	15	34	0	11	19	0.5789474
NODE_47601_length_476_cov_1.129973	15	34	1	1	19	0.0526316
NODE_47601_length_476_cov_1.129973	15	34	3	2	19	0.1052632
NODE_47601_length_476_cov_1.129973	15	34	5	4	19	0.2105263
NODE_47601_length_476_cov_1.129973	15	34	7	1	19	0.0526316
NODE_47620_length_476_cov_1.037135	180	243	0	44	63	0.6984127
NODE_47620_length_476_cov_1.037135	180	243	2	19	63	0.3015873
NODE_47620_length_476_cov_1.037135	237	296	0	9	59	0.1525424
NODE_47620_length_476_cov_1.037135	237	296	1	7	59	0.1186441
NODE_47620_length_476_cov_1.037135	237	296	2	43	59	0.7288136
NODE_47693_length_475_cov_34.460106	270	350	0	80	80	1.0000000
NODE_47693_length_475_cov_34.460106	323	403	0	80	80	1.0000000
NODE_47694_length_475_cov_30.087766	273	353	0	80	80	1.0000000
NODE_47694_length_475_cov_30.087766	326	406	0	80	80	1.0000000
NODE_47695_length_475_cov_10.247340	42	122	0	2	80	0.0250000
NODE_47695_length_475_cov_10.247340	42	122	2	78	80	0.9750000
NODE_47701_length_475_cov_8.393617	9	89	0	80	80	1.0000000
NODE_47701_length_475_cov_8.393617	62	142	0	80	80	1.0000000
NODE_47828_length_475_cov_1.531915	272	352	0	20	80	0.2500000
NODE_47828_length_475_cov_1.531915	272	352	2	60	80	0.7500000
NODE_47839_length_475_cov_1.457447	50	93	0	43	43	1.0000000
NODE_47979_length_474_cov_49.453333	392	472	38	1	80	0.0125000
NODE_47979_length_474_cov_49.453333	392	472	42	1	80	0.0125000
NODE_47979_length_474_cov_49.453333	392	472	44	1	80	0.0125000
NODE_47979_length_474_cov_49.453333	392	472	45	1	80	0.0125000
NODE_47979_length_474_cov_49.453333	392	472	52	2	80	0.0250000
NODE_47979_length_474_cov_49.453333	392	472	53	1	80	0.0125000
NODE_47979_length_474_cov_49.453333	392	472	63	2	80	0.0250000
NODE_47979_length_474_cov_49.453333	392	472	67	1	80	0.0125000
NODE_47979_length_474_cov_49.453333	392	472	70	1	80	0.0125000
NODE_47979_length_474_cov_49.453333	392	472	80	2	80	0.0250000
NODE_47979_length_474_cov_49.453333	392	472	83	2	80	0.0250000
NODE_47979_length_474_cov_49.453333	392	472	85	1	80	0.0125000
NODE_47979_length_474_cov_49.453333	392	472	89	1	80	0.0125000
NODE_47979_length_474_cov_49.453333	392	472	96	2	80	0.0250000
NODE_47979_length_474_cov_49.453333	392	472	100	1	80	0.0125000
NODE_47979_length_474_cov_49.453333	392	472	101	1	80	0.0125000
NODE_47979_length_474_cov_49.453333	392	472	103	1	80	0.0125000
NODE_47979_length_474_cov_49.453333	392	472	104	1	80	0.0125000
NODE_47979_length_474_cov_49.453333	392	472	105	1	80	0.0125000
NODE_47979_length_474_cov_49.453333	392	472	107	2	80	0.0250000
NODE_47979_length_474_cov_49.453333	392	472	109	2	80	0.0250000
NODE_47979_length_474_cov_49.453333	392	472	113	1	80	0.0125000
NODE_47979_length_474_cov_49.453333	392	472	115	2	80	0.0250000
NODE_47979_length_474_cov_49.453333	392	472	122	2	80	0.0250000
NODE_47979_length_474_cov_49.453333	392	472	124	2	80	0.0250000
NODE_47979_length_474_cov_49.453333	392	472	125	3	80	0.0375000
NODE_47979_length_474_cov_49.453333	392	472	127	1	80	0.0125000
NODE_47979_length_474_cov_49.453333	392	472	130	2	80	0.0250000
NODE_47979_length_474_cov_49.453333	392	472	137	1	80	0.0125000
NODE_47979_length_474_cov_49.453333	392	472	138	1	80	0.0125000
NODE_47979_length_474_cov_49.453333	392	472	143	1	80	0.0125000
NODE_47979_length_474_cov_49.453333	392	472	148	1	80	0.0125000
NODE_47979_length_474_cov_49.453333	392	472	149	2	80	0.0250000
NODE_47979_length_474_cov_49.453333	392	472	151	1	80	0.0125000
NODE_47979_length_474_cov_49.453333	392	472	153	1	80	0.0125000
NODE_47979_length_474_cov_49.453333	392	472	158	1	80	0.0125000
NODE_47979_length_474_cov_49.453333	392	472	159	1	80	0.0125000
NODE_47979_length_474_cov_49.453333	392	472	164	1	80	0.0125000
NODE_47979_length_474_cov_49.453333	392	472	170	1	80	0.0125000
NODE_47979_length_474_cov_49.453333	392	472	172	1	80	0.0125000
NODE_47979_length_474_cov_49.453333	392	472	173	1	80	0.0125000
NODE_47979_length_474_cov_49.453333	392	472	175	4	80	0.0500000
NODE_47979_length_474_cov_49.453333	392	472	176	1	80	0.0125000
NODE_47979_length_474_cov_49.453333	392	472	178	1	80	0.0125000
NODE_47979_length_474_cov_49.453333	392	472	182	2	80	0.0250000
NODE_47979_length_474_cov_49.453333	392	472	184	2	80	0.0250000
NODE_47979_length_474_cov_49.453333	392	472	188	1	80	0.0125000
NODE_47979_length_474_cov_49.453333	392	472	194	1	80	0.0125000
NODE_47979_length_474_cov_49.453333	392	472	196	3	80	0.0375000
NODE_47979_length_474_cov_49.453333	392	472	205	3	80	0.0375000
NODE_47979_length_474_cov_49.453333	392	472	211	2	80	0.0250000
NODE_47979_length_474_cov_49.453333	392	472	227	3	80	0.0375000
NODE_47979_length_474_cov_49.453333	392	472	229	2	80	0.0250000
NODE_47979_length_474_cov_49.453333	445	474	26	2	29	0.0689655
NODE_47979_length_474_cov_49.453333	445	474	38	1	29	0.0344828
NODE_47979_length_474_cov_49.453333	445	474	42	1	29	0.0344828
NODE_47979_length_474_cov_49.453333	445	474	44	1	29	0.0344828
NODE_47979_length_474_cov_49.453333	445	474	45	1	29	0.0344828
NODE_47979_length_474_cov_49.453333	445	474	52	2	29	0.0689655
NODE_47979_length_474_cov_49.453333	445	474	53	1	29	0.0344828
NODE_47979_length_474_cov_49.453333	445	474	63	2	29	0.0689655
NODE_47979_length_474_cov_49.453333	445	474	67	1	29	0.0344828
NODE_47979_length_474_cov_49.453333	445	474	70	1	29	0.0344828
NODE_47979_length_474_cov_49.453333	445	474	80	2	29	0.0689655
NODE_47979_length_474_cov_49.453333	445	474	83	2	29	0.0689655
NODE_47979_length_474_cov_49.453333	445	474	85	1	29	0.0344828
NODE_47979_length_474_cov_49.453333	445	474	89	1	29	0.0344828
NODE_47979_length_474_cov_49.453333	445	474	96	2	29	0.0689655
NODE_47979_length_474_cov_49.453333	445	474	100	1	29	0.0344828
NODE_47979_length_474_cov_49.453333	445	474	101	1	29	0.0344828
NODE_47979_length_474_cov_49.453333	445	474	103	1	29	0.0344828
NODE_47979_length_474_cov_49.453333	445	474	104	1	29	0.0344828
NODE_47979_length_474_cov_49.453333	445	474	105	1	29	0.0344828
NODE_47979_length_474_cov_49.453333	445	474	107	2	29	0.0689655
NODE_47979_length_474_cov_49.453333	445	474	109	1	29	0.0344828
NODE_47981_length_474_cov_24.930667	287	367	0	80	80	1.0000000
NODE_47981_length_474_cov_24.930667	340	420	0	80	80	1.0000000
NODE_47982_length_474_cov_15.952000	258	338	0	46	80	0.5750000
NODE_47982_length_474_cov_15.952000	258	338	2	34	80	0.4250000
NODE_47982_length_474_cov_15.952000	311	391	0	19	80	0.2375000
NODE_47982_length_474_cov_15.952000	311	391	2	61	80	0.7625000
NODE_48003_length_474_cov_3.986667	172	252	0	1	80	0.0125000
NODE_48003_length_474_cov_3.986667	172	252	8	4	80	0.0500000
NODE_48003_length_474_cov_3.986667	172	252	10	2	80	0.0250000
NODE_48003_length_474_cov_3.986667	172	252	12	1	80	0.0125000
NODE_48003_length_474_cov_3.986667	172	252	16	9	80	0.1125000
NODE_48003_length_474_cov_3.986667	172	252	18	5	80	0.0625000
NODE_48003_length_474_cov_3.986667	172	252	20	1	80	0.0125000
NODE_48003_length_474_cov_3.986667	172	252	22	8	80	0.1000000
NODE_48003_length_474_cov_3.986667	172	252	24	13	80	0.1625000
NODE_48003_length_474_cov_3.986667	172	252	26	13	80	0.1625000
NODE_48003_length_474_cov_3.986667	172	252	28	23	80	0.2875000
NODE_48015_length_474_cov_3.496000	163	243	24	1	80	0.0125000
NODE_48015_length_474_cov_3.496000	163	243	26	6	80	0.0750000
NODE_48015_length_474_cov_3.496000	163	243	28	3	80	0.0375000
NODE_48015_length_474_cov_3.496000	163	243	30	5	80	0.0625000
NODE_48015_length_474_cov_3.496000	163	243	32	7	80	0.0875000
NODE_48015_length_474_cov_3.496000	163	243	34	55	80	0.6875000
NODE_48015_length_474_cov_3.496000	163	243	36	3	80	0.0375000
NODE_48038_length_474_cov_2.784000	259	300	0	41	41	1.0000000
NODE_48116_length_474_cov_1.538667	41	62	0	21	21	1.0000000
NODE_48181_length_474_cov_1.085333	0	50	0	50	50	1.0000000
NODE_48184_length_474_cov_1.056000	95	133	0	38	38	1.0000000
NODE_48266_length_473_cov_82.374332	123	203	0	80	80	1.0000000
NODE_48266_length_473_cov_82.374332	176	256	0	80	80	1.0000000
NODE_48267_length_473_cov_54.882353	199	279	0	80	80	1.0000000
NODE_48267_length_473_cov_54.882353	252	332	0	80	80	1.0000000
NODE_48268_length_473_cov_48.997326	119	194	8	7	75	0.0933333
NODE_48268_length_473_cov_48.997326	119	194	12	12	75	0.1600000
NODE_48268_length_473_cov_48.997326	119	194	14	44	75	0.5866666
NODE_48268_length_473_cov_48.997326	119	194	16	12	75	0.1600000
NODE_48268_length_473_cov_48.997326	119	194	8	7	75	0.0933333
NODE_48268_length_473_cov_48.997326	119	194	12	12	75	0.1600000
NODE_48268_length_473_cov_48.997326	119	194	14	44	75	0.5866666
NODE_48268_length_473_cov_48.997326	119	194	16	12	75	0.1600000
NODE_48268_length_473_cov_48.997326	167	247	0	4	80	0.0500000
NODE_48268_length_473_cov_48.997326	167	247	4	20	80	0.2500000
NODE_48268_length_473_cov_48.997326	167	247	6	17	80	0.2125000
NODE_48268_length_473_cov_48.997326	167	247	10	10	80	0.1250000
NODE_48268_length_473_cov_48.997326	167	247	12	12	80	0.1500000
NODE_48268_length_473_cov_48.997326	167	247	14	17	80	0.2125000
NODE_48269_length_473_cov_30.679144	174	254	0	11	80	0.1375000
NODE_48269_length_473_cov_30.679144	174	254	2	20	80	0.2500000
NODE_48269_length_473_cov_30.679144	174	254	6	3	80	0.0375000
NODE_48269_length_473_cov_30.679144	174	254	8	2	80	0.0250000
NODE_48269_length_473_cov_30.679144	174	254	10	3	80	0.0375000
NODE_48269_length_473_cov_30.679144	174	254	14	2	80	0.0250000
NODE_48269_length_473_cov_30.679144	174	254	16	1	80	0.0125000
NODE_48269_length_473_cov_30.679144	174	254	18	12	80	0.1500000
NODE_48269_length_473_cov_30.679144	174	254	20	1	80	0.0125000
NODE_48269_length_473_cov_30.679144	174	254	22	8	80	0.1000000
NODE_48269_length_473_cov_30.679144	174	254	24	1	80	0.0125000
NODE_48269_length_473_cov_30.679144	174	254	26	5	80	0.0625000
NODE_48269_length_473_cov_30.679144	174	254	28	5	80	0.0625000
NODE_48269_length_473_cov_30.679144	174	254	30	2	80	0.0250000
NODE_48269_length_473_cov_30.679144	174	254	32	1	80	0.0125000
NODE_48269_length_473_cov_30.679144	174	254	33	3	80	0.0375000
NODE_48269_length_473_cov_30.679144	226	307	0	8	81	0.0987654
NODE_48269_length_473_cov_30.679144	226	307	2	27	81	0.3333333
NODE_48269_length_473_cov_30.679144	226	307	4	46	81	0.5679013
NODE_48269_length_473_cov_30.679144	227	307	0	7	80	0.0875000
NODE_48269_length_473_cov_30.679144	227	307	2	27	80	0.3375000
NODE_48269_length_473_cov_30.679144	227	307	4	46	80	0.5750000
NODE_48270_length_473_cov_24.967914	295	370	0	75	75	1.0000000
NODE_48270_length_473_cov_24.967914	343	423	0	80	80	1.0000000
NODE_48271_length_473_cov_18.540107	168	248	0	24	80	0.3000000
NODE_48271_length_473_cov_18.540107	168	248	1	49	80	0.6125000
NODE_48271_length_473_cov_18.540107	168	248	2	7	80	0.0875000
NODE_48271_length_473_cov_18.540107	221	301	0	71	80	0.8875000
NODE_48271_length_473_cov_18.540107	221	301	1	3	80	0.0375000
NODE_48271_length_473_cov_18.540107	221	301	2	6	80	0.0750000
NODE_48272_length_473_cov_15.871658	143	223	0	80	80	1.0000000
NODE_48272_length_473_cov_15.871658	196	276	0	66	80	0.8250000
NODE_48272_length_473_cov_15.871658	196	276	2	14	80	0.1750000
NODE_48291_length_473_cov_4.363636	160	240	0	80	80	1.0000000
NODE_48291_length_473_cov_4.363636	213	293	0	80	80	1.0000000
NODE_48320_length_473_cov_2.959893	199	267	2	68	68	1.0000000
NODE_48325_length_473_cov_2.804813	207	269	0	62	62	1.0000000
NODE_48350_length_473_cov_2.251337	48	128	0	80	80	1.0000000
NODE_48350_length_473_cov_2.251337	101	181	0	32	80	0.4000000
NODE_48350_length_473_cov_2.251337	101	181	2	13	80	0.1625000
NODE_48350_length_473_cov_2.251337	101	181	4	35	80	0.4375000
NODE_48568_length_472_cov_50.077748	1	81	5	2	80	0.0250000
NODE_48568_length_472_cov_50.077748	1	81	8	2	80	0.0250000
NODE_48568_length_472_cov_50.077748	1	81	9	2	80	0.0250000
NODE_48568_length_472_cov_50.077748	1	81	12	25	80	0.3125000
NODE_48568_length_472_cov_50.077748	1	81	13	5	80	0.0625000
NODE_48568_length_472_cov_50.077748	1	81	17	7	80	0.0875000
NODE_48568_length_472_cov_50.077748	1	81	24	24	80	0.3000000
NODE_48568_length_472_cov_50.077748	1	81	26	1	80	0.0125000
NODE_48568_length_472_cov_50.077748	1	81	28	12	80	0.1500000
NODE_48568_length_472_cov_50.077748	1	81	5	2	80	0.0250000
NODE_48568_length_472_cov_50.077748	1	81	8	2	80	0.0250000
NODE_48568_length_472_cov_50.077748	1	81	9	2	80	0.0250000
NODE_48568_length_472_cov_50.077748	1	81	12	25	80	0.3125000
NODE_48568_length_472_cov_50.077748	1	81	13	5	80	0.0625000
NODE_48568_length_472_cov_50.077748	1	81	17	7	80	0.0875000
NODE_48568_length_472_cov_50.077748	1	81	24	24	80	0.3000000
NODE_48568_length_472_cov_50.077748	1	81	26	1	80	0.0125000
NODE_48568_length_472_cov_50.077748	1	81	28	12	80	0.1500000
NODE_48568_length_472_cov_50.077748	1	81	5	2	80	0.0250000
NODE_48568_length_472_cov_50.077748	1	81	8	2	80	0.0250000
NODE_48568_length_472_cov_50.077748	1	81	9	2	80	0.0250000
NODE_48568_length_472_cov_50.077748	1	81	12	25	80	0.3125000
NODE_48568_length_472_cov_50.077748	1	81	13	5	80	0.0625000
NODE_48568_length_472_cov_50.077748	1	81	17	7	80	0.0875000
NODE_48568_length_472_cov_50.077748	1	81	24	24	80	0.3000000
NODE_48568_length_472_cov_50.077748	1	81	26	1	80	0.0125000
NODE_48568_length_472_cov_50.077748	1	81	28	12	80	0.1500000
NODE_48568_length_472_cov_50.077748	1	81	5	2	80	0.0250000
NODE_48568_length_472_cov_50.077748	1	81	8	2	80	0.0250000
NODE_48568_length_472_cov_50.077748	1	81	9	2	80	0.0250000
NODE_48568_length_472_cov_50.077748	1	81	12	25	80	0.3125000
NODE_48568_length_472_cov_50.077748	1	81	13	5	80	0.0625000
NODE_48568_length_472_cov_50.077748	1	81	17	7	80	0.0875000
NODE_48568_length_472_cov_50.077748	1	81	24	24	80	0.3000000
NODE_48568_length_472_cov_50.077748	1	81	26	1	80	0.0125000
NODE_48568_length_472_cov_50.077748	1	81	28	12	80	0.1500000
NODE_48568_length_472_cov_50.077748	1	81	5	2	80	0.0250000
NODE_48568_length_472_cov_50.077748	1	81	8	2	80	0.0250000
NODE_48568_length_472_cov_50.077748	1	81	9	2	80	0.0250000
NODE_48568_length_472_cov_50.077748	1	81	12	25	80	0.3125000
NODE_48568_length_472_cov_50.077748	1	81	13	5	80	0.0625000
NODE_48568_length_472_cov_50.077748	1	81	17	7	80	0.0875000
NODE_48568_length_472_cov_50.077748	1	81	24	24	80	0.3000000
NODE_48568_length_472_cov_50.077748	1	81	26	1	80	0.0125000
NODE_48568_length_472_cov_50.077748	1	81	28	12	80	0.1500000
NODE_48568_length_472_cov_50.077748	10	81	12	22	71	0.3098592
NODE_48568_length_472_cov_50.077748	10	81	13	5	71	0.0704225
NODE_48568_length_472_cov_50.077748	10	81	17	7	71	0.0985916
NODE_48568_length_472_cov_50.077748	10	81	24	24	71	0.3380282
NODE_48568_length_472_cov_50.077748	10	81	26	1	71	0.0140845
NODE_48568_length_472_cov_50.077748	10	81	28	12	71	0.1690141
NODE_48568_length_472_cov_50.077748	54	131	19	8	77	0.1038961
NODE_48568_length_472_cov_50.077748	54	131	24	14	77	0.1818182
NODE_48568_length_472_cov_50.077748	54	131	25	3	77	0.0389610
NODE_48568_length_472_cov_50.077748	54	131	26	1	77	0.0129870
NODE_48568_length_472_cov_50.077748	54	131	28	20	77	0.2597403
NODE_48568_length_472_cov_50.077748	54	131	29	15	77	0.1948052
NODE_48568_length_472_cov_50.077748	54	131	33	16	77	0.2077922
NODE_48568_length_472_cov_50.077748	54	131	19	8	77	0.1038961
NODE_48568_length_472_cov_50.077748	54	131	24	14	77	0.1818182
NODE_48568_length_472_cov_50.077748	54	131	25	3	77	0.0389610
NODE_48568_length_472_cov_50.077748	54	131	26	1	77	0.0129870
NODE_48568_length_472_cov_50.077748	54	131	28	20	77	0.2597403
NODE_48568_length_472_cov_50.077748	54	131	29	15	77	0.1948052
NODE_48568_length_472_cov_50.077748	54	131	33	16	77	0.2077922
NODE_48568_length_472_cov_50.077748	54	131	19	8	77	0.1038961
NODE_48568_length_472_cov_50.077748	54	131	24	14	77	0.1818182
NODE_48568_length_472_cov_50.077748	54	131	25	3	77	0.0389610
NODE_48568_length_472_cov_50.077748	54	131	26	1	77	0.0129870
NODE_48568_length_472_cov_50.077748	54	131	28	20	77	0.2597403
NODE_48568_length_472_cov_50.077748	54	131	29	15	77	0.1948052
NODE_48568_length_472_cov_50.077748	54	131	33	16	77	0.2077922
NODE_48568_length_472_cov_50.077748	130	204	10	14	74	0.1891892
NODE_48568_length_472_cov_50.077748	130	204	11	1	74	0.0135135
NODE_48568_length_472_cov_50.077748	130	204	12	7	74	0.0945946
NODE_48568_length_472_cov_50.077748	130	204	13	7	74	0.0945946
NODE_48568_length_472_cov_50.077748	130	204	14	17	74	0.2297297
NODE_48568_length_472_cov_50.077748	130	204	15	1	74	0.0135135
NODE_48568_length_472_cov_50.077748	130	204	17	2	74	0.0270270
NODE_48568_length_472_cov_50.077748	130	204	18	2	74	0.0270270
NODE_48568_length_472_cov_50.077748	130	204	19	20	74	0.2702703
NODE_48568_length_472_cov_50.077748	130	204	21	2	74	0.0270270
NODE_48568_length_472_cov_50.077748	130	204	22	1	74	0.0135135
NODE_48569_length_472_cov_10.469169	294	374	0	80	80	1.0000000
NODE_48569_length_472_cov_10.469169	347	427	0	80	80	1.0000000
NODE_48570_length_472_cov_10.195710	143	223	0	80	80	1.0000000
NODE_48570_length_472_cov_10.195710	196	276	0	80	80	1.0000000
NODE_48593_length_472_cov_4.375335	165	245	0	53	80	0.6625000
NODE_48593_length_472_cov_4.375335	165	245	2	27	80	0.3375000
NODE_48593_length_472_cov_4.375335	218	251	2	33	33	1.0000000
NODE_48614_length_472_cov_3.495979	305	349	0	44	44	1.0000000
NODE_48620_length_472_cov_3.093834	220	295	0	75	75	1.0000000
NODE_48638_length_472_cov_2.592493	431	471	0	34	40	0.8500000
NODE_48638_length_472_cov_2.592493	431	471	2	6	40	0.1500000
NODE_48745_length_472_cov_1.294906	43	98	0	55	55	1.0000000
NODE_48745_length_472_cov_1.294906	71	151	0	80	80	1.0000000
NODE_48768_length_472_cov_1.211796	106	126	0	20	20	1.0000000
NODE_48873_length_471_cov_39.319892	119	193	0	35	74	0.4729730
NODE_48873_length_471_cov_39.319892	119	193	2	36	74	0.4864865
NODE_48873_length_471_cov_39.319892	119	193	5	2	74	0.0270270
NODE_48873_length_471_cov_39.319892	119	193	40	1	74	0.0135135
NODE_48874_length_471_cov_24.279570	185	265	0	54	80	0.6750000
NODE_48874_length_471_cov_24.279570	185	265	2	26	80	0.3250000
NODE_48874_length_471_cov_24.279570	238	318	0	1	80	0.0125000
NODE_48874_length_471_cov_24.279570	238	318	2	79	80	0.9875000
NODE_48875_length_471_cov_19.669355	83	163	2	14	80	0.1750000
NODE_48875_length_471_cov_19.669355	83	163	7	9	80	0.1125000
NODE_48875_length_471_cov_19.669355	83	163	9	57	80	0.7125000
NODE_48875_length_471_cov_19.669355	136	216	7	40	80	0.5000000
NODE_48875_length_471_cov_19.669355	136	216	8	22	80	0.2750000
NODE_48875_length_471_cov_19.669355	136	216	9	18	80	0.2250000
NODE_48876_length_471_cov_14.387097	198	278	0	80	80	1.0000000
NODE_48876_length_471_cov_14.387097	251	331	0	80	80	1.0000000
NODE_48881_length_471_cov_6.948925	186	213	2	27	27	1.0000000
NODE_48881_length_471_cov_6.948925	204	284	2	80	80	1.0000000
NODE_48881_length_471_cov_6.948925	244	275	2	31	31	1.0000000
NODE_48881_length_471_cov_6.948925	257	337	0	53	80	0.6625000
NODE_48881_length_471_cov_6.948925	257	337	2	27	80	0.3375000
NODE_48881_length_471_cov_6.948925	268	337	0	53	69	0.7681159
NODE_48881_length_471_cov_6.948925	268	337	2	16	69	0.2318841
NODE_48902_length_471_cov_3.803763	83	162	0	79	79	1.0000000
NODE_48902_length_471_cov_3.803763	135	215	0	33	80	0.4125000
NODE_48902_length_471_cov_3.803763	135	215	1	15	80	0.1875000
NODE_48902_length_471_cov_3.803763	135	215	2	32	80	0.4000000
NODE_48924_length_471_cov_2.954301	284	315	12	31	31	1.0000000
NODE_48957_length_471_cov_2.287634	133	200	0	18	67	0.2686567
NODE_48957_length_471_cov_2.287634	133	200	2	6	67	0.0895522
NODE_48957_length_471_cov_2.287634	133	200	4	21	67	0.3134328
NODE_48957_length_471_cov_2.287634	133	200	8	3	67	0.0447761
NODE_48957_length_471_cov_2.287634	133	200	10	1	67	0.0149254
NODE_48957_length_471_cov_2.287634	133	200	12	18	67	0.2686567
NODE_49186_length_470_cov_57.078167	184	264	0	49	80	0.6125000
NODE_49186_length_470_cov_57.078167	184	264	6	31	80	0.3875000
NODE_49186_length_470_cov_57.078167	237	317	6	54	80	0.6750000
NODE_49186_length_470_cov_57.078167	237	317	8	17	80	0.2125000
NODE_49186_length_470_cov_57.078167	237	317	12	9	80	0.1125000
NODE_49186_length_470_cov_57.078167	313	393	4	13	80	0.1625000
NODE_49186_length_470_cov_57.078167	313	393	6	30	80	0.3750000
NODE_49186_length_470_cov_57.078167	313	393	9	17	80	0.2125000
NODE_49186_length_470_cov_57.078167	313	393	12	20	80	0.2500000
NODE_49186_length_470_cov_57.078167	366	446	4	66	80	0.8250000
NODE_49186_length_470_cov_57.078167	366	446	6	14	80	0.1750000
NODE_49187_length_470_cov_34.035040	228	308	0	80	80	1.0000000
NODE_49187_length_470_cov_34.035040	281	361	0	80	80	1.0000000
NODE_49187_length_470_cov_34.035040	357	437	0	80	80	1.0000000
NODE_49187_length_470_cov_34.035040	410	470	0	60	60	1.0000000
NODE_49188_length_470_cov_15.539084	142	222	0	12	80	0.1500000
NODE_49188_length_470_cov_15.539084	142	222	8	68	80	0.8500000
NODE_49188_length_470_cov_15.539084	195	275	0	65	80	0.8125000
NODE_49188_length_470_cov_15.539084	195	275	8	15	80	0.1875000
NODE_49193_length_470_cov_6.070081	272	330	65	3	58	0.0517241
NODE_49193_length_470_cov_6.070081	272	330	67	4	58	0.0689655
NODE_49193_length_470_cov_6.070081	272	330	68	5	58	0.0862069
NODE_49193_length_470_cov_6.070081	272	330	69	3	58	0.0517241
NODE_49193_length_470_cov_6.070081	272	330	70	1	58	0.0172414
NODE_49193_length_470_cov_6.070081	272	330	71	5	58	0.0862069
NODE_49193_length_470_cov_6.070081	272	330	74	8	58	0.1379310
NODE_49193_length_470_cov_6.070081	272	330	76	1	58	0.0172414
NODE_49193_length_470_cov_6.070081	272	330	77	3	58	0.0517241
NODE_49193_length_470_cov_6.070081	272	330	78	13	58	0.2241379
NODE_49193_length_470_cov_6.070081	272	330	79	11	58	0.1896552
NODE_49193_length_470_cov_6.070081	272	330	80	1	58	0.0172414
NODE_49193_length_470_cov_6.070081	325	383	2	1	58	0.0172414
NODE_49193_length_470_cov_6.070081	325	383	4	1	58	0.0172414
NODE_49193_length_470_cov_6.070081	325	383	8	4	58	0.0689655
NODE_49193_length_470_cov_6.070081	325	383	9	7	58	0.1206897
NODE_49193_length_470_cov_6.070081	325	383	10	6	58	0.1034483
NODE_49193_length_470_cov_6.070081	325	383	11	2	58	0.0344828
NODE_49193_length_470_cov_6.070081	325	383	13	4	58	0.0689655
NODE_49193_length_470_cov_6.070081	325	383	24	1	58	0.0172414
NODE_49193_length_470_cov_6.070081	325	383	27	1	58	0.0172414
NODE_49193_length_470_cov_6.070081	325	383	29	3	58	0.0517241
NODE_49193_length_470_cov_6.070081	325	383	31	1	58	0.0172414
NODE_49193_length_470_cov_6.070081	325	383	33	1	58	0.0172414
NODE_49193_length_470_cov_6.070081	325	383	36	4	58	0.0689655
NODE_49193_length_470_cov_6.070081	325	383	39	1	58	0.0172414
NODE_49193_length_470_cov_6.070081	325	383	42	2	58	0.0344828
NODE_49193_length_470_cov_6.070081	325	383	43	5	58	0.0862069
NODE_49193_length_470_cov_6.070081	325	383	45	1	58	0.0172414
NODE_49193_length_470_cov_6.070081	325	383	56	1	58	0.0172414
NODE_49193_length_470_cov_6.070081	325	383	58	1	58	0.0172414
NODE_49193_length_470_cov_6.070081	325	383	61	1	58	0.0172414
NODE_49193_length_470_cov_6.070081	325	383	63	1	58	0.0172414
NODE_49193_length_470_cov_6.070081	325	383	65	2	58	0.0344828
NODE_49193_length_470_cov_6.070081	325	383	67	7	58	0.1206897
NODE_49215_length_470_cov_3.735849	194	251	0	18	57	0.3157895
NODE_49215_length_470_cov_3.735849	194	251	2	39	57	0.6842105
NODE_49260_length_470_cov_2.363881	403	422	2	19	19	1.0000000
NODE_49260_length_470_cov_2.363881	403	422	2	19	19	1.0000000
NODE_49389_length_470_cov_1.142857	414	470	0	56	56	1.0000000
NODE_49502_length_469_cov_221.024324	150	228	252	2	78	0.0256410
NODE_49502_length_469_cov_221.024324	150	228	257	2	78	0.0256410
NODE_49502_length_469_cov_221.024324	150	228	260	1	78	0.0128205
NODE_49502_length_469_cov_221.024324	150	228	264	2	78	0.0256410
NODE_49502_length_469_cov_221.024324	150	228	265	3	78	0.0384615
NODE_49502_length_469_cov_221.024324	150	228	267	1	78	0.0128205
NODE_49502_length_469_cov_221.024324	150	228	270	1	78	0.0128205
NODE_49502_length_469_cov_221.024324	150	228	273	1	78	0.0128205
NODE_49502_length_469_cov_221.024324	150	228	277	1	78	0.0128205
NODE_49502_length_469_cov_221.024324	150	228	279	2	78	0.0256410
NODE_49502_length_469_cov_221.024324	150	228	284	2	78	0.0256410
NODE_49502_length_469_cov_221.024324	150	228	289	1	78	0.0128205
NODE_49502_length_469_cov_221.024324	150	228	291	3	78	0.0384615
NODE_49502_length_469_cov_221.024324	150	228	293	1	78	0.0128205
NODE_49502_length_469_cov_221.024324	150	228	294	2	78	0.0256410
NODE_49502_length_469_cov_221.024324	150	228	295	1	78	0.0128205
NODE_49502_length_469_cov_221.024324	150	228	297	4	78	0.0512821
NODE_49502_length_469_cov_221.024324	150	228	298	5	78	0.0641026
NODE_49502_length_469_cov_221.024324	150	228	299	2	78	0.0256410
NODE_49502_length_469_cov_221.024324	150	228	300	3	78	0.0384615
NODE_49502_length_469_cov_221.024324	150	228	301	3	78	0.0384615
NODE_49502_length_469_cov_221.024324	150	228	302	3	78	0.0384615
NODE_49502_length_469_cov_221.024324	150	228	303	4	78	0.0512821
NODE_49502_length_469_cov_221.024324	150	228	304	1	78	0.0128205
NODE_49502_length_469_cov_221.024324	150	228	305	3	78	0.0384615
NODE_49502_length_469_cov_221.024324	150	228	306	3	78	0.0384615
NODE_49502_length_469_cov_221.024324	150	228	307	2	78	0.0256410
NODE_49502_length_469_cov_221.024324	150	228	308	4	78	0.0512821
NODE_49502_length_469_cov_221.024324	150	228	310	2	78	0.0256410
NODE_49502_length_469_cov_221.024324	150	228	311	1	78	0.0128205
NODE_49502_length_469_cov_221.024324	150	228	312	3	78	0.0384615
NODE_49502_length_469_cov_221.024324	150	228	313	2	78	0.0256410
NODE_49502_length_469_cov_221.024324	150	228	315	2	78	0.0256410
NODE_49502_length_469_cov_221.024324	150	228	317	2	78	0.0256410
NODE_49502_length_469_cov_221.024324	150	228	319	3	78	0.0384615
NODE_49502_length_469_cov_221.024324	150	228	252	2	78	0.0256410
NODE_49502_length_469_cov_221.024324	150	228	257	2	78	0.0256410
NODE_49502_length_469_cov_221.024324	150	228	260	1	78	0.0128205
NODE_49502_length_469_cov_221.024324	150	228	264	2	78	0.0256410
NODE_49502_length_469_cov_221.024324	150	228	265	3	78	0.0384615
NODE_49502_length_469_cov_221.024324	150	228	267	1	78	0.0128205
NODE_49502_length_469_cov_221.024324	150	228	270	1	78	0.0128205
NODE_49502_length_469_cov_221.024324	150	228	273	1	78	0.0128205
NODE_49502_length_469_cov_221.024324	150	228	277	1	78	0.0128205
NODE_49502_length_469_cov_221.024324	150	228	279	2	78	0.0256410
NODE_49502_length_469_cov_221.024324	150	228	284	2	78	0.0256410
NODE_49502_length_469_cov_221.024324	150	228	289	1	78	0.0128205
NODE_49502_length_469_cov_221.024324	150	228	291	3	78	0.0384615
NODE_49502_length_469_cov_221.024324	150	228	293	1	78	0.0128205
NODE_49502_length_469_cov_221.024324	150	228	294	2	78	0.0256410
NODE_49502_length_469_cov_221.024324	150	228	295	1	78	0.0128205
NODE_49502_length_469_cov_221.024324	150	228	297	4	78	0.0512821
NODE_49502_length_469_cov_221.024324	150	228	298	5	78	0.0641026
NODE_49502_length_469_cov_221.024324	150	228	299	2	78	0.0256410
NODE_49502_length_469_cov_221.024324	150	228	300	3	78	0.0384615
NODE_49502_length_469_cov_221.024324	150	228	301	3	78	0.0384615
NODE_49502_length_469_cov_221.024324	150	228	302	3	78	0.0384615
NODE_49502_length_469_cov_221.024324	150	228	303	4	78	0.0512821
NODE_49502_length_469_cov_221.024324	150	228	304	1	78	0.0128205
NODE_49502_length_469_cov_221.024324	150	228	305	3	78	0.0384615
NODE_49502_length_469_cov_221.024324	150	228	306	3	78	0.0384615
NODE_49502_length_469_cov_221.024324	150	228	307	2	78	0.0256410
NODE_49502_length_469_cov_221.024324	150	228	308	4	78	0.0512821
NODE_49502_length_469_cov_221.024324	150	228	310	2	78	0.0256410
NODE_49502_length_469_cov_221.024324	150	228	311	1	78	0.0128205
NODE_49502_length_469_cov_221.024324	150	228	312	3	78	0.0384615
NODE_49502_length_469_cov_221.024324	150	228	313	2	78	0.0256410
NODE_49502_length_469_cov_221.024324	150	228	315	2	78	0.0256410
NODE_49502_length_469_cov_221.024324	150	228	317	2	78	0.0256410
NODE_49502_length_469_cov_221.024324	150	228	319	3	78	0.0384615
NODE_49502_length_469_cov_221.024324	150	219	252	2	69	0.0289855
NODE_49502_length_469_cov_221.024324	150	219	257	2	69	0.0289855
NODE_49502_length_469_cov_221.024324	150	219	260	1	69	0.0144928
NODE_49502_length_469_cov_221.024324	150	219	264	2	69	0.0289855
NODE_49502_length_469_cov_221.024324	150	219	265	3	69	0.0434783
NODE_49502_length_469_cov_221.024324	150	219	267	1	69	0.0144928
NODE_49502_length_469_cov_221.024324	150	219	270	1	69	0.0144928
NODE_49502_length_469_cov_221.024324	150	219	273	1	69	0.0144928
NODE_49502_length_469_cov_221.024324	150	219	277	1	69	0.0144928
NODE_49502_length_469_cov_221.024324	150	219	279	2	69	0.0289855
NODE_49502_length_469_cov_221.024324	150	219	289	1	69	0.0144928
NODE_49502_length_469_cov_221.024324	150	219	291	2	69	0.0289855
NODE_49502_length_469_cov_221.024324	150	219	294	2	69	0.0289855
NODE_49502_length_469_cov_221.024324	150	219	297	4	69	0.0579710
NODE_49502_length_469_cov_221.024324	150	219	298	4	69	0.0579710
NODE_49502_length_469_cov_221.024324	150	219	299	2	69	0.0289855
NODE_49502_length_469_cov_221.024324	150	219	300	3	69	0.0434783
NODE_49502_length_469_cov_221.024324	150	219	301	3	69	0.0434783
NODE_49502_length_469_cov_221.024324	150	219	302	3	69	0.0434783
NODE_49502_length_469_cov_221.024324	150	219	303	2	69	0.0289855
NODE_49502_length_469_cov_221.024324	150	219	304	1	69	0.0144928
NODE_49502_length_469_cov_221.024324	150	219	305	3	69	0.0434783
NODE_49502_length_469_cov_221.024324	150	219	306	3	69	0.0434783
NODE_49502_length_469_cov_221.024324	150	219	307	2	69	0.0289855
NODE_49502_length_469_cov_221.024324	150	219	308	4	69	0.0579710
NODE_49502_length_469_cov_221.024324	150	219	310	2	69	0.0289855
NODE_49502_length_469_cov_221.024324	150	219	311	1	69	0.0144928
NODE_49502_length_469_cov_221.024324	150	219	312	3	69	0.0434783
NODE_49502_length_469_cov_221.024324	150	219	313	2	69	0.0289855
NODE_49502_length_469_cov_221.024324	150	219	315	1	69	0.0144928
NODE_49502_length_469_cov_221.024324	150	219	317	2	69	0.0289855
NODE_49502_length_469_cov_221.024324	150	219	319	3	69	0.0434783
NODE_49557_length_469_cov_2.686486	263	343	0	80	80	1.0000000
NODE_49561_length_469_cov_2.521622	237	289	0	52	52	1.0000000
NODE_49579_length_469_cov_2.224324	279	331	0	52	52	1.0000000
NODE_49796_length_468_cov_8.043360	190	250	0	50	60	0.8333333
NODE_49796_length_468_cov_8.043360	190	250	2	10	60	0.1666667
NODE_49796_length_468_cov_8.043360	223	303	0	17	80	0.2125000
NODE_49796_length_468_cov_8.043360	223	303	2	63	80	0.7875000
NODE_49800_length_468_cov_6.046070	152	232	0	80	80	1.0000000
NODE_49800_length_468_cov_6.046070	205	285	0	80	80	1.0000000
NODE_49801_length_468_cov_5.997290	81	161	0	47	80	0.5875000
NODE_49801_length_468_cov_5.997290	81	161	2	33	80	0.4125000
NODE_49801_length_468_cov_5.997290	134	214	2	42	80	0.5250000
NODE_49801_length_468_cov_5.997290	134	214	4	5	80	0.0625000
NODE_49801_length_468_cov_5.997290	134	214	5	5	80	0.0625000
NODE_49801_length_468_cov_5.997290	134	214	6	5	80	0.0625000
NODE_49801_length_468_cov_5.997290	134	214	8	23	80	0.2875000
NODE_49801_length_468_cov_5.997290	210	270	8	6	60	0.1000000
NODE_49801_length_468_cov_5.997290	210	270	10	45	60	0.7500000
NODE_49801_length_468_cov_5.997290	210	270	12	9	60	0.1500000
NODE_49803_length_468_cov_5.872629	133	201	2	20	68	0.2941177
NODE_49803_length_468_cov_5.872629	133	201	6	4	68	0.0588235
NODE_49803_length_468_cov_5.872629	133	201	8	44	68	0.6470588
NODE_49807_length_468_cov_5.384824	305	356	4	51	51	1.0000000
NODE_49894_length_468_cov_2.067751	45	96	4	50	51	0.9803922
NODE_49894_length_468_cov_2.067751	45	96	6	1	51	0.0196078
NODE_49913_length_468_cov_1.891599	4	63	0	24	59	0.4067796
NODE_49913_length_468_cov_1.891599	4	63	2	35	59	0.5932204
NODE_49928_length_468_cov_1.758808	140	218	0	78	78	1.0000000
NODE_49928_length_468_cov_1.758808	191	257	0	66	66	1.0000000
NODE_49974_length_468_cov_1.390244	291	310	0	19	19	1.0000000
NODE_49974_length_468_cov_1.390244	369	405	0	36	36	1.0000000
NODE_50133_length_467_cov_14.100543	176	256	0	80	80	1.0000000
NODE_50134_length_467_cov_11.902174	193	236	0	43	43	1.0000000
NODE_50135_length_467_cov_10.875000	226	306	2	44	80	0.5500000
NODE_50135_length_467_cov_10.875000	226	306	4	36	80	0.4500000
NODE_50135_length_467_cov_10.875000	279	359	0	40	80	0.5000000
NODE_50135_length_467_cov_10.875000	279	359	2	40	80	0.5000000
NODE_50144_length_467_cov_6.625000	206	275	0	30	69	0.4347826
NODE_50144_length_467_cov_6.625000	206	275	2	7	69	0.1014493
NODE_50144_length_467_cov_6.625000	206	275	4	32	69	0.4637681
NODE_50144_length_467_cov_6.625000	257	328	2	5	71	0.0704225
NODE_50144_length_467_cov_6.625000	257	328	4	66	71	0.9295775
NODE_50197_length_467_cov_2.709239	247	327	2	1	80	0.0125000
NODE_50197_length_467_cov_2.709239	247	327	3	1	80	0.0125000
NODE_50197_length_467_cov_2.709239	247	327	4	39	80	0.4875000
NODE_50197_length_467_cov_2.709239	247	327	5	29	80	0.3625000
NODE_50197_length_467_cov_2.709239	247	327	7	10	80	0.1250000
NODE_50215_length_467_cov_2.296196	284	329	0	45	45	1.0000000
NODE_50238_length_467_cov_2.027174	218	269	1	4	51	0.0784314
NODE_50238_length_467_cov_2.027174	218	269	2	26	51	0.5098040
NODE_50238_length_467_cov_2.027174	218	269	3	21	51	0.4117647
NODE_50252_length_467_cov_1.836957	55	118	0	63	63	1.0000000
NODE_50267_length_467_cov_1.603261	92	141	0	1	49	0.0204082
NODE_50267_length_467_cov_1.603261	92	141	2	1	49	0.0204082
NODE_50267_length_467_cov_1.603261	92	141	4	5	49	0.1020408
NODE_50267_length_467_cov_1.603261	92	141	8	22	49	0.4489796
NODE_50267_length_467_cov_1.603261	92	141	10	20	49	0.4081633
NODE_50283_length_467_cov_1.426630	135	183	0	48	48	1.0000000
NODE_50447_length_466_cov_42.839237	0	47	0	47	47	1.0000000
NODE_50447_length_466_cov_42.839237	20	100	0	80	80	1.0000000
NODE_50447_length_466_cov_42.839237	96	176	0	31	80	0.3875000
NODE_50447_length_466_cov_42.839237	96	176	2	49	80	0.6125000
NODE_50447_length_466_cov_42.839237	149	229	0	13	80	0.1625000
NODE_50447_length_466_cov_42.839237	149	229	2	67	80	0.8375000
NODE_50448_length_466_cov_36.901907	85	165	0	80	80	1.0000000
NODE_50448_length_466_cov_36.901907	138	218	0	65	80	0.8125000
NODE_50448_length_466_cov_36.901907	138	218	2	15	80	0.1875000
NODE_50448_length_466_cov_36.901907	214	294	2	5	80	0.0625000
NODE_50448_length_466_cov_36.901907	214	294	4	55	80	0.6875000
NODE_50448_length_466_cov_36.901907	214	294	10	20	80	0.2500000
NODE_50448_length_466_cov_36.901907	267	347	4	7	80	0.0875000
NODE_50448_length_466_cov_36.901907	267	347	6	4	80	0.0500000
NODE_50448_length_466_cov_36.901907	267	347	7	3	80	0.0375000
NODE_50448_length_466_cov_36.901907	267	347	9	43	80	0.5375000
NODE_50448_length_466_cov_36.901907	267	347	10	23	80	0.2875000
NODE_50457_length_466_cov_5.122616	275	316	0	41	41	1.0000000
NODE_50457_length_466_cov_5.122616	276	316	0	40	40	1.0000000
NODE_50457_length_466_cov_5.122616	289	338	0	49	49	1.0000000
NODE_50515_length_466_cov_2.602180	9	90	4	2	81	0.0246914
NODE_50515_length_466_cov_2.602180	9	90	6	7	81	0.0864198
NODE_50515_length_466_cov_2.602180	9	90	8	5	81	0.0617284
NODE_50515_length_466_cov_2.602180	9	90	12	48	81	0.5925926
NODE_50515_length_466_cov_2.602180	9	90	14	19	81	0.2345679
NODE_50515_length_466_cov_2.602180	312	341	2	29	29	1.0000000
NODE_50549_length_466_cov_2.108992	130	182	0	52	52	1.0000000
NODE_50562_length_466_cov_1.980926	183	265	0	57	82	0.6951219
NODE_50562_length_466_cov_1.980926	183	265	2	25	82	0.3048781
NODE_50787_length_465_cov_13.019126	170	250	0	21	80	0.2625000
NODE_50787_length_465_cov_13.019126	170	250	4	51	80	0.6375000
NODE_50787_length_465_cov_13.019126	170	250	5	6	80	0.0750000
NODE_50787_length_465_cov_13.019126	170	250	6	2	80	0.0250000
NODE_50787_length_465_cov_13.019126	223	301	4	22	78	0.2820513
NODE_50787_length_465_cov_13.019126	223	301	5	6	78	0.0769231
NODE_50787_length_465_cov_13.019126	223	301	6	27	78	0.3461539
NODE_50787_length_465_cov_13.019126	223	301	8	23	78	0.2948718
NODE_50799_length_465_cov_5.363388	316	393	0	77	77	1.0000000
NODE_50800_length_465_cov_4.898907	376	406	0	30	30	1.0000000
NODE_50869_length_465_cov_2.366120	147	227	0	80	80	1.0000000
NODE_50869_length_465_cov_2.366120	200	271	0	71	71	1.0000000
NODE_50911_length_465_cov_1.737705	338	383	0	45	45	1.0000000
NODE_51100_length_464_cov_8.473973	209	289	0	28	80	0.3500000
NODE_51100_length_464_cov_8.473973	209	289	2	52	80	0.6500000
NODE_51100_length_464_cov_8.473973	262	342	0	6	80	0.0750000
NODE_51100_length_464_cov_8.473973	262	342	2	74	80	0.9250000
NODE_51148_length_464_cov_2.528767	136	199	0	24	63	0.3809524
NODE_51148_length_464_cov_2.528767	136	199	2	39	63	0.6190476
NODE_51167_length_464_cov_2.134247	130	203	0	14	73	0.1917808
NODE_51167_length_464_cov_2.134247	130	203	2	44	73	0.6027398
NODE_51167_length_464_cov_2.134247	130	203	4	15	73	0.2054795
NODE_51186_length_464_cov_1.901370	58	138	0	80	80	1.0000000
NODE_51203_length_464_cov_1.706849	186	265	0	79	79	1.0000000
NODE_51377_length_463_cov_64.420330	375	455	0	67	80	0.8375000
NODE_51377_length_463_cov_64.420330	375	455	4	13	80	0.1625000
NODE_51377_length_463_cov_64.420330	375	455	0	67	80	0.8375000
NODE_51377_length_463_cov_64.420330	375	455	4	13	80	0.1625000
NODE_51377_length_463_cov_64.420330	375	455	0	67	80	0.8375000
NODE_51377_length_463_cov_64.420330	375	455	4	13	80	0.1625000
NODE_51377_length_463_cov_64.420330	375	455	0	67	80	0.8375000
NODE_51377_length_463_cov_64.420330	375	455	4	13	80	0.1625000
NODE_51377_length_463_cov_64.420330	375	455	0	67	80	0.8375000
NODE_51377_length_463_cov_64.420330	375	455	4	13	80	0.1625000
NODE_51378_length_463_cov_49.673077	0	71	3	3	71	0.0422535
NODE_51378_length_463_cov_49.673077	0	71	4	25	71	0.3521127
NODE_51378_length_463_cov_49.673077	0	71	6	19	71	0.2676056
NODE_51378_length_463_cov_49.673077	0	71	10	24	71	0.3380282
NODE_51378_length_463_cov_49.673077	44	121	6	3	77	0.0389610
NODE_51378_length_463_cov_49.673077	44	121	10	52	77	0.6753247
NODE_51378_length_463_cov_49.673077	44	121	12	22	77	0.2857143
NODE_51379_length_463_cov_41.005495	8	88	0	80	80	1.0000000
NODE_51379_length_463_cov_41.005495	61	141	0	80	80	1.0000000
NODE_51380_length_463_cov_30.626374	318	398	6	80	80	1.0000000
NODE_51380_length_463_cov_30.626374	371	451	0	20	80	0.2500000
NODE_51380_length_463_cov_30.626374	371	451	6	60	80	0.7500000
NODE_51381_length_463_cov_27.475275	211	291	0	32	80	0.4000000
NODE_51381_length_463_cov_27.475275	211	291	2	48	80	0.6000000
NODE_51381_length_463_cov_27.475275	264	344	0	26	80	0.3250000
NODE_51381_length_463_cov_27.475275	264	344	2	54	80	0.6750000
NODE_51383_length_463_cov_11.211538	304	377	0	73	73	1.0000000
NODE_51383_length_463_cov_11.211538	350	430	0	80	80	1.0000000
NODE_51391_length_463_cov_5.711538	181	261	0	32	80	0.4000000
NODE_51391_length_463_cov_5.711538	181	261	2	1	80	0.0125000
NODE_51391_length_463_cov_5.711538	181	261	4	47	80	0.5875000
NODE_51391_length_463_cov_5.711538	234	314	0	5	80	0.0625000
NODE_51391_length_463_cov_5.711538	234	314	2	11	80	0.1375000
NODE_51391_length_463_cov_5.711538	234	314	4	64	80	0.8000000
NODE_51399_length_463_cov_4.398352	119	169	0	2	50	0.0400000
NODE_51399_length_463_cov_4.398352	119	169	1	48	50	0.9600000
NODE_51402_length_463_cov_4.186813	175	233	14	11	58	0.1896552
NODE_51402_length_463_cov_4.186813	175	233	16	1	58	0.0172414
NODE_51402_length_463_cov_4.186813	175	233	20	46	58	0.7931035
NODE_51402_length_463_cov_4.186813	206	251	20	45	45	1.0000000
NODE_51408_length_463_cov_3.846154	235	268	0	16	33	0.4848485
NODE_51408_length_463_cov_3.846154	235	268	2	17	33	0.5151515
NODE_51421_length_463_cov_3.063187	193	248	0	55	55	1.0000000
NODE_51421_length_463_cov_3.063187	222	301	0	79	79	1.0000000
NODE_51680_length_462_cov_21.876033	93	173	0	80	80	1.0000000
NODE_51680_length_462_cov_21.876033	146	226	0	80	80	1.0000000
NODE_51687_length_462_cov_5.033058	93	154	0	61	61	1.0000000
NODE_51687_length_462_cov_5.033058	159	209	0	50	50	1.0000000
NODE_51699_length_462_cov_4.101928	168	246	0	78	78	1.0000000
NODE_51699_length_462_cov_4.101928	184	208	0	24	24	1.0000000
NODE_51699_length_462_cov_4.101928	219	299	0	80	80	1.0000000
NODE_51708_length_462_cov_3.630854	149	194	0	45	45	1.0000000
NODE_51720_length_462_cov_3.079890	103	147	0	44	44	1.0000000
NODE_51735_length_462_cov_2.677686	78	118	0	40	40	1.0000000
NODE_51763_length_462_cov_2.209366	18	58	0	40	40	1.0000000
NODE_51817_length_462_cov_1.570248	68	113	0	45	45	1.0000000
NODE_51995_length_461_cov_35.116022	0	79	0	79	79	1.0000000
NODE_51995_length_461_cov_35.116022	52	132	0	80	80	1.0000000
NODE_51996_length_461_cov_11.124309	77	157	0	21	80	0.2625000
NODE_51996_length_461_cov_11.124309	77	157	2	59	80	0.7375000
NODE_51996_length_461_cov_11.124309	130	210	0	29	80	0.3625000
NODE_51996_length_461_cov_11.124309	130	210	2	51	80	0.6375000
NODE_52010_length_461_cov_5.361878	246	322	0	38	76	0.5000000
NODE_52010_length_461_cov_5.361878	246	322	2	29	76	0.3815790
NODE_52010_length_461_cov_5.361878	246	322	4	9	76	0.1184211
NODE_52018_length_461_cov_4.472376	268	333	0	65	65	1.0000000
NODE_52021_length_461_cov_4.168508	159	234	0	75	75	1.0000000
NODE_52047_length_461_cov_2.892265	233	312	0	79	79	1.0000000
NODE_52073_length_461_cov_2.392265	186	223	0	10	37	0.2702703
NODE_52073_length_461_cov_2.392265	186	223	3	14	37	0.3783784
NODE_52073_length_461_cov_2.392265	186	223	6	13	37	0.3513514
NODE_52154_length_461_cov_1.389503	283	349	0	66	66	1.0000000
NODE_52292_length_460_cov_172.986150	0	68	19	1	68	0.0147059
NODE_52292_length_460_cov_172.986150	0	68	27	1	68	0.0147059
NODE_52292_length_460_cov_172.986150	0	68	30	1	68	0.0147059
NODE_52292_length_460_cov_172.986150	0	68	37	2	68	0.0294118
NODE_52292_length_460_cov_172.986150	0	68	40	1	68	0.0147059
NODE_52292_length_460_cov_172.986150	0	68	48	1	68	0.0147059
NODE_52292_length_460_cov_172.986150	0	68	50	1	68	0.0147059
NODE_52292_length_460_cov_172.986150	0	68	69	1	68	0.0147059
NODE_52292_length_460_cov_172.986150	0	68	95	1	68	0.0147059
NODE_52292_length_460_cov_172.986150	0	68	98	1	68	0.0147059
NODE_52292_length_460_cov_172.986150	0	68	109	1	68	0.0147059
NODE_52292_length_460_cov_172.986150	0	68	134	1	68	0.0147059
NODE_52292_length_460_cov_172.986150	0	68	152	1	68	0.0147059
NODE_52292_length_460_cov_172.986150	0	68	161	1	68	0.0147059
NODE_52292_length_460_cov_172.986150	0	68	164	1	68	0.0147059
NODE_52292_length_460_cov_172.986150	0	68	187	1	68	0.0147059
NODE_52292_length_460_cov_172.986150	0	68	213	1	68	0.0147059
NODE_52292_length_460_cov_172.986150	0	68	217	1	68	0.0147059
NODE_52292_length_460_cov_172.986150	0	68	226	1	68	0.0147059
NODE_52292_length_460_cov_172.986150	0	68	236	1	68	0.0147059
NODE_52292_length_460_cov_172.986150	0	68	247	1	68	0.0147059
NODE_52292_length_460_cov_172.986150	0	68	249	1	68	0.0147059
NODE_52292_length_460_cov_172.986150	0	68	278	1	68	0.0147059
NODE_52292_length_460_cov_172.986150	0	68	301	1	68	0.0147059
NODE_52292_length_460_cov_172.986150	0	68	304	1	68	0.0147059
NODE_52292_length_460_cov_172.986150	0	68	309	1	68	0.0147059
NODE_52292_length_460_cov_172.986150	0	68	318	1	68	0.0147059
NODE_52292_length_460_cov_172.986150	0	68	322	1	68	0.0147059
NODE_52292_length_460_cov_172.986150	0	68	324	1	68	0.0147059
NODE_52292_length_460_cov_172.986150	0	68	337	1	68	0.0147059
NODE_52292_length_460_cov_172.986150	0	68	349	1	68	0.0147059
NODE_52292_length_460_cov_172.986150	0	68	361	1	68	0.0147059
NODE_52292_length_460_cov_172.986150	0	68	371	1	68	0.0147059
NODE_52292_length_460_cov_172.986150	0	68	379	1	68	0.0147059
NODE_52292_length_460_cov_172.986150	0	68	381	1	68	0.0147059
NODE_52292_length_460_cov_172.986150	0	68	387	1	68	0.0147059
NODE_52292_length_460_cov_172.986150	0	68	392	3	68	0.0441176
NODE_52292_length_460_cov_172.986150	0	68	402	1	68	0.0147059
NODE_52292_length_460_cov_172.986150	0	68	403	1	68	0.0147059
NODE_52292_length_460_cov_172.986150	0	68	405	1	68	0.0147059
NODE_52292_length_460_cov_172.986150	0	68	411	1	68	0.0147059
NODE_52292_length_460_cov_172.986150	0	68	419	1	68	0.0147059
NODE_52292_length_460_cov_172.986150	0	68	429	1	68	0.0147059
NODE_52292_length_460_cov_172.986150	0	68	441	1	68	0.0147059
NODE_52292_length_460_cov_172.986150	0	68	443	1	68	0.0147059
NODE_52292_length_460_cov_172.986150	0	68	457	1	68	0.0147059
NODE_52292_length_460_cov_172.986150	0	68	459	1	68	0.0147059
NODE_52292_length_460_cov_172.986150	0	68	471	1	68	0.0147059
NODE_52292_length_460_cov_172.986150	0	68	473	1	68	0.0147059
NODE_52292_length_460_cov_172.986150	0	68	481	2	68	0.0294118
NODE_52292_length_460_cov_172.986150	0	68	499	1	68	0.0147059
NODE_52292_length_460_cov_172.986150	0	68	503	1	68	0.0147059
NODE_52292_length_460_cov_172.986150	0	68	505	1	68	0.0147059
NODE_52292_length_460_cov_172.986150	0	68	508	1	68	0.0147059
NODE_52292_length_460_cov_172.986150	0	68	512	1	68	0.0147059
NODE_52292_length_460_cov_172.986150	0	68	525	1	68	0.0147059
NODE_52292_length_460_cov_172.986150	0	68	527	2	68	0.0294118
NODE_52292_length_460_cov_172.986150	0	68	528	1	68	0.0147059
NODE_52292_length_460_cov_172.986150	0	68	529	2	68	0.0294118
NODE_52292_length_460_cov_172.986150	0	68	535	1	68	0.0147059
NODE_52292_length_460_cov_172.986150	0	68	537	2	68	0.0294118
NODE_52292_length_460_cov_172.986150	41	121	403	1	80	0.0125000
NODE_52292_length_460_cov_172.986150	41	121	405	1	80	0.0125000
NODE_52292_length_460_cov_172.986150	41	121	411	1	80	0.0125000
NODE_52292_length_460_cov_172.986150	41	121	419	1	80	0.0125000
NODE_52292_length_460_cov_172.986150	41	121	429	1	80	0.0125000
NODE_52292_length_460_cov_172.986150	41	121	441	1	80	0.0125000
NODE_52292_length_460_cov_172.986150	41	121	443	1	80	0.0125000
NODE_52292_length_460_cov_172.986150	41	121	457	1	80	0.0125000
NODE_52292_length_460_cov_172.986150	41	121	459	1	80	0.0125000
NODE_52292_length_460_cov_172.986150	41	121	471	1	80	0.0125000
NODE_52292_length_460_cov_172.986150	41	121	473	1	80	0.0125000
NODE_52292_length_460_cov_172.986150	41	121	481	2	80	0.0250000
NODE_52292_length_460_cov_172.986150	41	121	499	1	80	0.0125000
NODE_52292_length_460_cov_172.986150	41	121	503	1	80	0.0125000
NODE_52292_length_460_cov_172.986150	41	121	505	1	80	0.0125000
NODE_52292_length_460_cov_172.986150	41	121	508	1	80	0.0125000
NODE_52292_length_460_cov_172.986150	41	121	512	1	80	0.0125000
NODE_52292_length_460_cov_172.986150	41	121	525	1	80	0.0125000
NODE_52292_length_460_cov_172.986150	41	121	527	2	80	0.0250000
NODE_52292_length_460_cov_172.986150	41	121	528	1	80	0.0125000
NODE_52292_length_460_cov_172.986150	41	121	529	2	80	0.0250000
NODE_52292_length_460_cov_172.986150	41	121	535	1	80	0.0125000
NODE_52292_length_460_cov_172.986150	41	121	537	2	80	0.0250000
NODE_52292_length_460_cov_172.986150	41	121	545	1	80	0.0125000
NODE_52292_length_460_cov_172.986150	41	121	546	1	80	0.0125000
NODE_52292_length_460_cov_172.986150	41	121	550	1	80	0.0125000
NODE_52292_length_460_cov_172.986150	41	121	552	1	80	0.0125000
NODE_52292_length_460_cov_172.986150	41	121	554	1	80	0.0125000
NODE_52292_length_460_cov_172.986150	41	121	558	2	80	0.0250000
NODE_52292_length_460_cov_172.986150	41	121	563	1	80	0.0125000
NODE_52292_length_460_cov_172.986150	41	121	567	1	80	0.0125000
NODE_52292_length_460_cov_172.986150	41	121	569	1	80	0.0125000
NODE_52292_length_460_cov_172.986150	41	121	575	1	80	0.0125000
NODE_52292_length_460_cov_172.986150	41	121	576	1	80	0.0125000
NODE_52292_length_460_cov_172.986150	41	121	586	1	80	0.0125000
NODE_52292_length_460_cov_172.986150	41	121	593	1	80	0.0125000
NODE_52292_length_460_cov_172.986150	41	121	598	1	80	0.0125000
NODE_52292_length_460_cov_172.986150	41	121	600	1	80	0.0125000
NODE_52292_length_460_cov_172.986150	41	121	603	1	80	0.0125000
NODE_52292_length_460_cov_172.986150	41	121	605	1	80	0.0125000
NODE_52292_length_460_cov_172.986150	41	121	612	3	80	0.0375000
NODE_52292_length_460_cov_172.986150	41	121	616	1	80	0.0125000
NODE_52292_length_460_cov_172.986150	41	121	623	1	80	0.0125000
NODE_52292_length_460_cov_172.986150	41	121	628	1	80	0.0125000
NODE_52292_length_460_cov_172.986150	41	121	631	2	80	0.0250000
NODE_52292_length_460_cov_172.986150	41	121	632	1	80	0.0125000
NODE_52292_length_460_cov_172.986150	41	121	634	1	80	0.0125000
NODE_52292_length_460_cov_172.986150	41	121	648	2	80	0.0250000
NODE_52292_length_460_cov_172.986150	41	121	650	2	80	0.0250000
NODE_52292_length_460_cov_172.986150	41	121	652	2	80	0.0250000
NODE_52292_length_460_cov_172.986150	41	121	653	1	80	0.0125000
NODE_52292_length_460_cov_172.986150	41	121	664	1	80	0.0125000
NODE_52292_length_460_cov_172.986150	41	121	668	2	80	0.0250000
NODE_52292_length_460_cov_172.986150	41	121	669	2	80	0.0250000
NODE_52292_length_460_cov_172.986150	41	121	673	1	80	0.0125000
NODE_52292_length_460_cov_172.986150	41	121	674	1	80	0.0125000
NODE_52292_length_460_cov_172.986150	41	121	677	1	80	0.0125000
NODE_52292_length_460_cov_172.986150	41	121	680	2	80	0.0250000
NODE_52292_length_460_cov_172.986150	41	121	681	1	80	0.0125000
NODE_52292_length_460_cov_172.986150	41	121	683	1	80	0.0125000
NODE_52292_length_460_cov_172.986150	41	121	700	1	80	0.0125000
NODE_52292_length_460_cov_172.986150	41	121	702	1	80	0.0125000
NODE_52292_length_460_cov_172.986150	41	121	704	4	80	0.0500000
NODE_52293_length_460_cov_62.512465	9	48	8	3	39	0.0769231
NODE_52293_length_460_cov_62.512465	9	48	12	2	39	0.0512821
NODE_52293_length_460_cov_62.512465	9	48	13	6	39	0.1538462
NODE_52293_length_460_cov_62.512465	9	48	15	8	39	0.2051282
NODE_52293_length_460_cov_62.512465	9	48	16	4	39	0.1025641
NODE_52293_length_460_cov_62.512465	9	48	17	2	39	0.0512821
NODE_52293_length_460_cov_62.512465	9	48	19	6	39	0.1538462
NODE_52293_length_460_cov_62.512465	9	48	20	3	39	0.0769231
NODE_52293_length_460_cov_62.512465	9	48	22	1	39	0.0256410
NODE_52293_length_460_cov_62.512465	9	48	26	2	39	0.0512821
NODE_52293_length_460_cov_62.512465	9	48	27	2	39	0.0512821
NODE_52294_length_460_cov_33.146814	0	47	0	47	47	1.0000000
NODE_52294_length_460_cov_33.146814	43	115	0	72	72	1.0000000
NODE_52294_length_460_cov_33.146814	96	165	0	69	69	1.0000000
NODE_52295_length_460_cov_26.049861	0	63	0	16	63	0.2539683
NODE_52295_length_460_cov_26.049861	0	63	6	18	63	0.2857143
NODE_52295_length_460_cov_26.049861	0	63	12	13	63	0.2063492
NODE_52295_length_460_cov_26.049861	0	63	15	1	63	0.0158730
NODE_52295_length_460_cov_26.049861	0	63	16	15	63	0.2380952
NODE_52296_length_460_cov_25.709141	246	326	0	80	80	1.0000000
NODE_52296_length_460_cov_25.709141	299	379	0	80	80	1.0000000
NODE_52297_length_460_cov_11.063712	273	353	0	26	80	0.3250000
NODE_52297_length_460_cov_11.063712	273	353	4	54	80	0.6750000
NODE_52297_length_460_cov_11.063712	326	406	4	80	80	1.0000000
NODE_52303_length_460_cov_7.285319	172	250	0	78	78	1.0000000
NODE_52312_length_460_cov_5.163435	120	200	22	7	80	0.0875000
NODE_52312_length_460_cov_5.163435	120	200	26	1	80	0.0125000
NODE_52312_length_460_cov_5.163435	120	200	28	2	80	0.0250000
NODE_52312_length_460_cov_5.163435	120	200	30	4	80	0.0500000
NODE_52312_length_460_cov_5.163435	120	200	33	5	80	0.0625000
NODE_52312_length_460_cov_5.163435	120	200	34	3	80	0.0375000
NODE_52312_length_460_cov_5.163435	120	200	35	8	80	0.1000000
NODE_52312_length_460_cov_5.163435	120	200	36	7	80	0.0875000
NODE_52312_length_460_cov_5.163435	120	200	39	1	80	0.0125000
NODE_52312_length_460_cov_5.163435	120	200	40	2	80	0.0250000
NODE_52312_length_460_cov_5.163435	120	200	42	5	80	0.0625000
NODE_52312_length_460_cov_5.163435	120	200	44	10	80	0.1250000
NODE_52312_length_460_cov_5.163435	120	200	48	25	80	0.3125000
NODE_52312_length_460_cov_5.163435	173	253	19	6	80	0.0750000
NODE_52312_length_460_cov_5.163435	173	253	21	1	80	0.0125000
NODE_52312_length_460_cov_5.163435	173	253	23	8	80	0.1000000
NODE_52312_length_460_cov_5.163435	173	253	29	6	80	0.0750000
NODE_52312_length_460_cov_5.163435	173	253	31	4	80	0.0500000
NODE_52312_length_460_cov_5.163435	173	253	33	1	80	0.0125000
NODE_52312_length_460_cov_5.163435	173	253	34	7	80	0.0875000
NODE_52312_length_460_cov_5.163435	173	253	40	1	80	0.0125000
NODE_52312_length_460_cov_5.163435	173	253	42	11	80	0.1375000
NODE_52312_length_460_cov_5.163435	173	253	44	22	80	0.2750000
NODE_52312_length_460_cov_5.163435	173	253	48	13	80	0.1625000
NODE_52333_length_460_cov_3.457064	150	230	0	44	80	0.5500000
NODE_52333_length_460_cov_3.457064	150	230	1	19	80	0.2375000
NODE_52333_length_460_cov_3.457064	150	230	3	17	80	0.2125000
NODE_52333_length_460_cov_3.457064	203	246	1	10	43	0.2325581
NODE_52333_length_460_cov_3.457064	203	246	3	33	43	0.7674419
NODE_52339_length_460_cov_3.027701	167	230	0	63	63	1.0000000
NODE_52347_length_460_cov_2.819945	195	266	2	11	71	0.1549296
NODE_52347_length_460_cov_2.819945	195	266	4	23	71	0.3239437
NODE_52347_length_460_cov_2.819945	195	266	6	14	71	0.1971831
NODE_52347_length_460_cov_2.819945	195	266	10	23	71	0.3239437
NODE_52358_length_460_cov_2.626039	223	277	0	30	54	0.5555556
NODE_52358_length_460_cov_2.626039	223	277	2	24	54	0.4444444
NODE_52612_length_459_cov_34.927778	165	239	4	74	74	1.0000000
NODE_52612_length_459_cov_34.927778	212	292	0	27	80	0.3375000
NODE_52612_length_459_cov_34.927778	212	292	4	53	80	0.6625000
NODE_52617_length_459_cov_7.261111	143	189	0	7	46	0.1521739
NODE_52617_length_459_cov_7.261111	143	189	8	15	46	0.3260870
NODE_52617_length_459_cov_7.261111	143	189	10	24	46	0.5217391
NODE_52617_length_459_cov_7.261111	162	242	8	3	80	0.0375000
NODE_52617_length_459_cov_7.261111	162	242	10	77	80	0.9625000
NODE_52635_length_459_cov_4.127778	153	233	0	14	80	0.1750000
NODE_52635_length_459_cov_4.127778	153	233	1	7	80	0.0875000
NODE_52635_length_459_cov_4.127778	153	233	2	59	80	0.7375000
NODE_52685_length_459_cov_2.158333	219	285	0	66	66	1.0000000
NODE_52685_length_459_cov_2.158333	283	342	0	59	59	1.0000000
NODE_52704_length_459_cov_1.722222	280	353	0	73	73	1.0000000
NODE_52920_length_458_cov_71.047354	0	51	0	51	51	1.0000000
NODE_52920_length_458_cov_71.047354	24	104	0	80	80	1.0000000
NODE_52920_length_458_cov_71.047354	100	180	0	43	80	0.5375000
NODE_52920_length_458_cov_71.047354	100	180	2	37	80	0.4625000
NODE_52920_length_458_cov_71.047354	153	233	2	54	80	0.6750000
NODE_52920_length_458_cov_71.047354	153	233	4	26	80	0.3250000
NODE_52921_length_458_cov_47.966574	151	231	0	80	80	1.0000000
NODE_52921_length_458_cov_47.966574	204	284	0	80	80	1.0000000
NODE_52921_length_458_cov_47.966574	280	360	0	80	80	1.0000000
NODE_52921_length_458_cov_47.966574	333	413	0	80	80	1.0000000
NODE_52924_length_458_cov_9.935933	267	347	0	11	80	0.1375000
NODE_52924_length_458_cov_9.935933	267	347	2	13	80	0.1625000
NODE_52924_length_458_cov_9.935933	267	347	5	1	80	0.0125000
NODE_52924_length_458_cov_9.935933	267	347	6	55	80	0.6875000
NODE_52924_length_458_cov_9.935933	320	400	0	64	80	0.8000000
NODE_52924_length_458_cov_9.935933	320	400	2	13	80	0.1625000
NODE_52924_length_458_cov_9.935933	320	400	5	1	80	0.0125000
NODE_52924_length_458_cov_9.935933	320	400	6	2	80	0.0250000
NODE_52929_length_458_cov_7.598886	87	167	0	80	80	1.0000000
NODE_52967_length_458_cov_3.061281	62	91	0	29	29	1.0000000
NODE_52967_length_458_cov_3.061281	185	224	0	39	39	1.0000000
NODE_52992_length_458_cov_2.454039	210	251	0	41	41	1.0000000
NODE_53107_length_458_cov_1.139276	242	289	0	47	47	1.0000000
NODE_53107_length_458_cov_1.139276	262	328	0	27	66	0.4090909
NODE_53107_length_458_cov_1.139276	262	328	2	39	66	0.5909091
NODE_53205_length_457_cov_20.754190	123	203	0	11	80	0.1375000
NODE_53205_length_457_cov_20.754190	123	203	2	38	80	0.4750000
NODE_53205_length_457_cov_20.754190	123	203	8	30	80	0.3750000
NODE_53205_length_457_cov_20.754190	123	203	9	1	80	0.0125000
NODE_53205_length_457_cov_20.754190	176	256	2	7	80	0.0875000
NODE_53205_length_457_cov_20.754190	176	256	8	40	80	0.5000000
NODE_53205_length_457_cov_20.754190	176	256	9	1	80	0.0125000
NODE_53205_length_457_cov_20.754190	176	256	10	32	80	0.4000000
NODE_53207_length_457_cov_13.918994	218	298	0	80	80	1.0000000
NODE_53207_length_457_cov_13.918994	218	298	0	80	80	1.0000000
NODE_53207_length_457_cov_13.918994	218	298	0	80	80	1.0000000
NODE_53207_length_457_cov_13.918994	218	298	0	80	80	1.0000000
NODE_53207_length_457_cov_13.918994	271	320	0	49	49	1.0000000
NODE_53207_length_457_cov_13.918994	271	320	0	49	49	1.0000000
NODE_53207_length_457_cov_13.918994	271	320	0	49	49	1.0000000
NODE_53216_length_457_cov_6.050279	264	326	0	25	62	0.4032258
NODE_53216_length_457_cov_6.050279	264	326	2	37	62	0.5967742
NODE_53220_length_457_cov_5.078212	71	149	0	78	78	1.0000000
NODE_53220_length_457_cov_5.078212	122	202	0	80	80	1.0000000
NODE_53225_length_457_cov_4.530726	193	273	4	73	80	0.9125000
NODE_53225_length_457_cov_4.530726	193	273	6	7	80	0.0875000
NODE_53225_length_457_cov_4.530726	246	315	0	20	69	0.2898551
NODE_53225_length_457_cov_4.530726	246	315	2	19	69	0.2753623
NODE_53225_length_457_cov_4.530726	246	315	4	30	69	0.4347826
NODE_53230_length_457_cov_3.986034	192	272	0	80	80	1.0000000
NODE_53267_length_457_cov_2.636872	117	197	0	20	80	0.2500000
NODE_53267_length_457_cov_2.636872	117	197	2	60	80	0.7500000
NODE_53462_length_457_cov_0.916201	108	188	0	80	80	1.0000000
NODE_53462_length_457_cov_0.916201	108	188	0	80	80	1.0000000
NODE_53462_length_457_cov_0.916201	161	241	0	80	80	1.0000000
NODE_53462_length_457_cov_0.916201	161	241	0	80	80	1.0000000
NODE_53512_length_456_cov_34.731092	0	63	0	63	63	1.0000000
NODE_53512_length_456_cov_34.731092	36	116	0	80	80	1.0000000
NODE_53512_length_456_cov_34.731092	112	194	0	82	82	1.0000000
NODE_53532_length_456_cov_4.582633	269	349	0	80	80	1.0000000
NODE_53533_length_456_cov_4.554622	124	206	0	82	82	1.0000000
NODE_53533_length_456_cov_4.554622	179	263	0	42	84	0.5000000
NODE_53533_length_456_cov_4.554622	179	263	2	42	84	0.5000000
NODE_53546_length_456_cov_3.669468	123	186	2	63	63	1.0000000
NODE_53566_length_456_cov_2.921569	302	362	0	60	60	1.0000000
NODE_53859_length_455_cov_113.589888	137	220	6	10	83	0.1204819
NODE_53859_length_455_cov_113.589888	137	220	10	23	83	0.2771084
NODE_53859_length_455_cov_113.589888	137	220	12	50	83	0.6024097
NODE_53859_length_455_cov_113.589888	198	268	0	7	70	0.1000000
NODE_53859_length_455_cov_113.589888	198	268	2	26	70	0.3714286
NODE_53859_length_455_cov_113.589888	198	268	4	13	70	0.1857143
NODE_53859_length_455_cov_113.589888	198	268	6	12	70	0.1714286
NODE_53859_length_455_cov_113.589888	198	268	10	12	70	0.1714286
NODE_53859_length_455_cov_113.589888	269	348	0	69	79	0.8734177
NODE_53859_length_455_cov_113.589888	269	348	2	10	79	0.1265823
NODE_53859_length_455_cov_113.589888	321	401	0	17	80	0.2125000
NODE_53859_length_455_cov_113.589888	321	401	2	63	80	0.7875000
NODE_53860_length_455_cov_52.941011	260	340	0	19	80	0.2375000
NODE_53860_length_455_cov_52.941011	260	340	2	61	80	0.7625000
NODE_53860_length_455_cov_52.941011	313	393	0	61	80	0.7625000
NODE_53860_length_455_cov_52.941011	313	393	2	19	80	0.2375000
NODE_53863_length_455_cov_8.584270	250	302	0	52	52	1.0000000
NODE_53863_length_455_cov_8.584270	275	355	0	80	80	1.0000000
NODE_53864_length_455_cov_8.084270	146	226	0	9	80	0.1125000
NODE_53864_length_455_cov_8.084270	146	226	2	4	80	0.0500000
NODE_53864_length_455_cov_8.084270	146	226	4	7	80	0.0875000
NODE_53864_length_455_cov_8.084270	146	226	8	13	80	0.1625000
NODE_53864_length_455_cov_8.084270	146	226	10	6	80	0.0750000
NODE_53864_length_455_cov_8.084270	146	226	12	41	80	0.5125000
NODE_53864_length_455_cov_8.084270	199	279	0	62	80	0.7750000
NODE_53864_length_455_cov_8.084270	199	279	2	4	80	0.0500000
NODE_53864_length_455_cov_8.084270	199	279	4	7	80	0.0875000
NODE_53864_length_455_cov_8.084270	199	279	8	7	80	0.0875000
NODE_53870_length_455_cov_6.022472	122	203	2	81	81	1.0000000
NODE_53872_length_455_cov_5.140449	181	232	1	32	51	0.6274510
NODE_53872_length_455_cov_5.140449	181	232	2	19	51	0.3725490
NODE_54512_length_453_cov_29.528249	44	124	0	80	80	1.0000000
NODE_54512_length_453_cov_29.528249	97	177	0	80	80	1.0000000
NODE_54512_length_453_cov_29.528249	173	253	0	78	80	0.9750000
NODE_54512_length_453_cov_29.528249	173	253	2	2	80	0.0250000
NODE_54512_length_453_cov_29.528249	226	301	0	25	75	0.3333333
NODE_54512_length_453_cov_29.528249	226	301	2	50	75	0.6666667
NODE_54513_length_453_cov_11.146893	95	140	0	45	45	1.0000000
NODE_54513_length_453_cov_11.146893	146	220	0	74	74	1.0000000
NODE_54517_length_453_cov_7.709040	194	252	4	58	58	1.0000000
NODE_54518_length_453_cov_7.440678	250	319	0	69	69	1.0000000
NODE_54533_length_453_cov_4.282486	190	270	0	80	80	1.0000000
NODE_54533_length_453_cov_4.282486	243	283	0	40	40	1.0000000
NODE_54566_length_453_cov_2.836158	186	266	2	61	80	0.7625000
NODE_54566_length_453_cov_2.836158	186	266	4	19	80	0.2375000
NODE_54566_length_453_cov_2.836158	239	319	2	59	80	0.7375000
NODE_54566_length_453_cov_2.836158	239	319	4	21	80	0.2625000
NODE_54592_length_453_cov_2.048023	139	174	0	35	35	1.0000000
NODE_54600_length_453_cov_2.002825	78	98	0	20	20	1.0000000
NODE_54767_length_453_cov_0.774011	174	195	0	21	21	1.0000000
NODE_54822_length_452_cov_36.028329	0	72	0	14	72	0.1944444
NODE_54822_length_452_cov_36.028329	0	72	5	29	72	0.4027778
NODE_54822_length_452_cov_36.028329	0	72	7	17	72	0.2361111
NODE_54822_length_452_cov_36.028329	0	72	8	12	72	0.1666667
NODE_54822_length_452_cov_36.028329	0	72	0	14	72	0.1944444
NODE_54822_length_452_cov_36.028329	0	72	5	29	72	0.4027778
NODE_54822_length_452_cov_36.028329	0	72	7	17	72	0.2361111
NODE_54822_length_452_cov_36.028329	0	72	8	12	72	0.1666667
NODE_54822_length_452_cov_36.028329	45	99	7	42	54	0.7777778
NODE_54822_length_452_cov_36.028329	45	99	8	12	54	0.2222222
NODE_54822_length_452_cov_36.028329	45	125	2	9	80	0.1125000
NODE_54822_length_452_cov_36.028329	45	125	6	3	80	0.0375000
NODE_54822_length_452_cov_36.028329	45	125	7	56	80	0.7000000
NODE_54822_length_452_cov_36.028329	45	125	8	12	80	0.1500000
NODE_54823_length_452_cov_17.424929	29	109	0	74	80	0.9250000
NODE_54823_length_452_cov_17.424929	29	109	4	6	80	0.0750000
NODE_54823_length_452_cov_17.424929	82	162	0	21	80	0.2625000
NODE_54823_length_452_cov_17.424929	82	162	4	59	80	0.7375000
NODE_54844_length_452_cov_4.317280	141	200	0	59	59	1.0000000
NODE_54886_length_452_cov_2.634561	262	338	0	76	76	1.0000000
NODE_55146_length_451_cov_37.090909	230	310	0	9	80	0.1125000
NODE_55146_length_451_cov_37.090909	230	310	2	9	80	0.1125000
NODE_55146_length_451_cov_37.090909	230	310	6	62	80	0.7750000
NODE_55146_length_451_cov_37.090909	283	363	0	62	80	0.7750000
NODE_55146_length_451_cov_37.090909	283	363	2	9	80	0.1125000
NODE_55146_length_451_cov_37.090909	283	363	6	9	80	0.1125000
NODE_55147_length_451_cov_16.517045	205	286	0	10	81	0.1234568
NODE_55147_length_451_cov_16.517045	205	286	2	71	81	0.8765432
NODE_55147_length_451_cov_16.517045	259	339	0	54	80	0.6750000
NODE_55147_length_451_cov_16.517045	259	339	2	26	80	0.3250000
NODE_55148_length_451_cov_13.153409	182	262	0	9	80	0.1125000
NODE_55148_length_451_cov_13.153409	182	262	2	71	80	0.8875000
NODE_55148_length_451_cov_13.153409	235	315	2	80	80	1.0000000
NODE_55149_length_451_cov_11.926136	141	221	3	4	80	0.0500000
NODE_55149_length_451_cov_11.926136	141	221	4	4	80	0.0500000
NODE_55149_length_451_cov_11.926136	141	221	7	1	80	0.0125000
NODE_55149_length_451_cov_11.926136	141	221	8	4	80	0.0500000
NODE_55149_length_451_cov_11.926136	141	221	10	7	80	0.0875000
NODE_55149_length_451_cov_11.926136	141	221	14	14	80	0.1750000
NODE_55149_length_451_cov_11.926136	141	221	16	46	80	0.5750000
NODE_55149_length_451_cov_11.926136	331	411	2	80	80	1.0000000
NODE_55154_length_451_cov_7.102273	81	143	0	62	62	1.0000000
NODE_55161_length_451_cov_5.610795	1	31	0	30	30	1.0000000
NODE_55161_length_451_cov_5.610795	60	90	0	30	30	1.0000000
NODE_55166_length_451_cov_5.065341	219	285	2	3	66	0.0454545
NODE_55166_length_451_cov_5.065341	219	285	4	2	66	0.0303030
NODE_55166_length_451_cov_5.065341	219	285	6	23	66	0.3484848
NODE_55166_length_451_cov_5.065341	219	285	8	7	66	0.1060606
NODE_55166_length_451_cov_5.065341	219	285	10	31	66	0.4696970
NODE_55166_length_451_cov_5.065341	272	322	2	40	50	0.8000000
NODE_55166_length_451_cov_5.065341	272	322	4	2	50	0.0400000
NODE_55166_length_451_cov_5.065341	272	322	6	8	50	0.1600000
NODE_55184_length_451_cov_3.696023	253	332	2	19	79	0.2405063
NODE_55184_length_451_cov_3.696023	253	332	4	7	79	0.0886076
NODE_55184_length_451_cov_3.696023	253	332	6	1	79	0.0126582
NODE_55184_length_451_cov_3.696023	253	332	8	15	79	0.1898734
NODE_55184_length_451_cov_3.696023	253	332	10	2	79	0.0253165
NODE_55184_length_451_cov_3.696023	253	332	12	19	79	0.2405063
NODE_55184_length_451_cov_3.696023	253	332	14	16	79	0.2025317
NODE_55188_length_451_cov_3.406250	176	247	6	13	71	0.1830986
NODE_55188_length_451_cov_3.406250	176	247	8	19	71	0.2676056
NODE_55188_length_451_cov_3.406250	176	247	10	39	71	0.5492958
NODE_55188_length_451_cov_3.406250	220	300	2	22	80	0.2750000
NODE_55188_length_451_cov_3.406250	220	300	4	7	80	0.0875000
NODE_55188_length_451_cov_3.406250	220	300	6	1	80	0.0125000
NODE_55188_length_451_cov_3.406250	220	300	8	18	80	0.2250000
NODE_55188_length_451_cov_3.406250	220	300	10	32	80	0.4000000
NODE_55198_length_451_cov_3.025568	72	148	2	1	76	0.0131579
NODE_55198_length_451_cov_3.025568	72	148	4	7	76	0.0921053
NODE_55198_length_451_cov_3.025568	72	148	8	16	76	0.2105263
NODE_55198_length_451_cov_3.025568	72	148	9	3	76	0.0394737
NODE_55198_length_451_cov_3.025568	72	148	10	16	76	0.2105263
NODE_55198_length_451_cov_3.025568	72	148	12	33	76	0.4342105
NODE_55213_length_451_cov_2.607955	84	143	0	18	59	0.3050847
NODE_55213_length_451_cov_2.607955	84	143	2	41	59	0.6949152
NODE_55213_length_451_cov_2.607955	257	326	0	69	69	1.0000000
NODE_55234_length_451_cov_2.125000	156	224	0	68	68	1.0000000
NODE_55436_length_450_cov_105.723647	317	386	0	69	69	1.0000000
NODE_55438_length_450_cov_27.982906	98	120	0	22	22	1.0000000
NODE_55438_length_450_cov_27.982906	225	305	0	80	80	1.0000000
NODE_55438_length_450_cov_27.982906	278	358	0	80	80	1.0000000
NODE_55459_length_450_cov_3.991453	220	290	0	70	70	1.0000000
NODE_55459_length_450_cov_3.991453	223	290	0	67	67	1.0000000
NODE_55459_length_450_cov_3.991453	268	348	0	80	80	1.0000000
NODE_55459_length_450_cov_3.991453	268	348	0	80	80	1.0000000
NODE_55459_length_450_cov_3.991453	278	348	0	70	70	1.0000000
NODE_55459_length_450_cov_3.991453	344	363	0	19	19	1.0000000
NODE_55466_length_450_cov_3.717949	107	177	0	70	70	1.0000000
NODE_55483_length_450_cov_3.162393	99	157	0	58	58	1.0000000
NODE_55550_length_450_cov_1.857550	114	172	4	15	58	0.2586207
NODE_55550_length_450_cov_1.857550	114	172	8	11	58	0.1896552
NODE_55550_length_450_cov_1.857550	114	172	10	10	58	0.1724138
NODE_55550_length_450_cov_1.857550	114	172	12	16	58	0.2758621
NODE_55550_length_450_cov_1.857550	114	172	14	6	58	0.1034483
NODE_55560_length_450_cov_1.749288	321	376	0	55	55	1.0000000
NODE_55565_length_450_cov_1.723647	101	161	14	10	60	0.1666667
NODE_55565_length_450_cov_1.723647	101	161	16	6	60	0.1000000
NODE_55565_length_450_cov_1.723647	101	161	18	9	60	0.1500000
NODE_55565_length_450_cov_1.723647	101	161	20	2	60	0.0333333
NODE_55565_length_450_cov_1.723647	101	161	22	14	60	0.2333333
NODE_55565_length_450_cov_1.723647	101	161	24	19	60	0.3166667
NODE_55685_length_450_cov_1.017094	116	196	0	17	80	0.2125000
NODE_55685_length_450_cov_1.017094	116	196	2	63	80	0.7875000
NODE_55761_length_449_cov_46.882857	237	317	0	80	80	1.0000000
NODE_55761_length_449_cov_46.882857	290	370	0	80	80	1.0000000
NODE_55762_length_449_cov_36.031429	238	318	0	40	80	0.5000000
NODE_55762_length_449_cov_36.031429	238	318	2	40	80	0.5000000
NODE_55762_length_449_cov_36.031429	291	371	2	80	80	1.0000000
NODE_55783_length_449_cov_4.594286	137	184	5	12	47	0.2553191
NODE_55783_length_449_cov_4.594286	137	184	6	13	47	0.2765957
NODE_55783_length_449_cov_4.594286	137	184	7	5	47	0.1063830
NODE_55783_length_449_cov_4.594286	137	184	9	1	47	0.0212766
NODE_55783_length_449_cov_4.594286	137	184	10	16	47	0.3404255
NODE_55794_length_449_cov_3.797143	204	284	2	6	80	0.0750000
NODE_55794_length_449_cov_3.797143	204	284	4	74	80	0.9250000
NODE_55844_length_449_cov_2.445714	346	376	0	30	30	1.0000000
NODE_56144_length_448_cov_44.664756	126	206	0	80	80	1.0000000
NODE_56144_length_448_cov_44.664756	179	259	0	80	80	1.0000000
NODE_56145_length_448_cov_36.148997	195	275	0	80	80	1.0000000
NODE_56145_length_448_cov_36.148997	248	328	0	80	80	1.0000000
NODE_56145_length_448_cov_36.148997	324	404	0	11	80	0.1375000
NODE_56145_length_448_cov_36.148997	324	404	4	69	80	0.8625000
NODE_56145_length_448_cov_36.148997	377	448	0	32	71	0.4507042
NODE_56145_length_448_cov_36.148997	377	448	4	39	71	0.5492958
NODE_56146_length_448_cov_31.816619	43	123	0	80	80	1.0000000
NODE_56151_length_448_cov_6.779370	197	277	0	80	80	1.0000000
NODE_56151_length_448_cov_6.779370	250	313	0	63	63	1.0000000
NODE_56180_length_448_cov_3.664756	148	189	0	41	41	1.0000000
NODE_56189_length_448_cov_3.108883	242	324	6	19	82	0.2317073
NODE_56189_length_448_cov_3.108883	242	324	8	10	82	0.1219512
NODE_56189_length_448_cov_3.108883	242	324	10	53	82	0.6463414
NODE_56233_length_448_cov_2.263610	292	360	0	68	68	1.0000000
NODE_56518_length_447_cov_10.505747	205	234	0	29	29	1.0000000
NODE_56518_length_447_cov_10.505747	267	326	0	59	59	1.0000000
NODE_56518_length_447_cov_10.505747	299	379	0	80	80	1.0000000
NODE_56527_length_447_cov_5.767241	176	256	0	80	80	1.0000000
NODE_56527_length_447_cov_5.767241	229	309	0	80	80	1.0000000
NODE_56539_length_447_cov_4.583333	265	289	0	24	24	1.0000000
NODE_56545_length_447_cov_4.037356	58	138	0	24	80	0.3000000
NODE_56545_length_447_cov_4.037356	58	138	4	56	80	0.7000000
NODE_56545_length_447_cov_4.037356	111	191	0	1	80	0.0125000
NODE_56545_length_447_cov_4.037356	111	191	4	79	80	0.9875000
NODE_56890_length_446_cov_42.527378	239	310	2	63	71	0.8873239
NODE_56890_length_446_cov_42.527378	239	310	4	2	71	0.0281690
NODE_56890_length_446_cov_42.527378	239	310	6	1	71	0.0140845
NODE_56890_length_446_cov_42.527378	239	310	9	1	71	0.0140845
NODE_56890_length_446_cov_42.527378	239	310	11	4	71	0.0563380
NODE_56890_length_446_cov_42.527378	359	433	9	7	74	0.0945946
NODE_56890_length_446_cov_42.527378	359	433	11	3	74	0.0405405
NODE_56890_length_446_cov_42.527378	359	433	13	17	74	0.2297297
NODE_56890_length_446_cov_42.527378	359	433	14	4	74	0.0540541
NODE_56890_length_446_cov_42.527378	359	433	15	8	74	0.1081081
NODE_56890_length_446_cov_42.527378	359	433	17	9	74	0.1216216
NODE_56890_length_446_cov_42.527378	359	433	19	26	74	0.3513514
NODE_56891_length_446_cov_12.749280	92	172	2	80	80	1.0000000
NODE_56891_length_446_cov_12.749280	145	225	0	30	80	0.3750000
NODE_56891_length_446_cov_12.749280	145	225	2	50	80	0.6250000
NODE_56896_length_446_cov_6.902017	175	217	2	42	42	1.0000000
NODE_56902_length_446_cov_5.930836	165	245	0	80	80	1.0000000
NODE_56902_length_446_cov_5.930836	165	245	0	80	80	1.0000000
NODE_56902_length_446_cov_5.930836	165	235	0	70	70	1.0000000
NODE_56902_length_446_cov_5.930836	218	298	0	80	80	1.0000000
NODE_56902_length_446_cov_5.930836	218	297	0	79	79	1.0000000
NODE_56919_length_446_cov_3.896254	215	274	4	1	59	0.0169492
NODE_56919_length_446_cov_3.896254	215	274	6	10	59	0.1694915
NODE_56919_length_446_cov_3.896254	215	274	8	5	59	0.0847458
NODE_56919_length_446_cov_3.896254	215	274	10	42	59	0.7118644
NODE_56919_length_446_cov_3.896254	215	274	12	1	59	0.0169492
NODE_56934_length_446_cov_3.282421	130	168	0	38	38	1.0000000
NODE_56952_length_446_cov_2.775216	337	417	0	80	80	1.0000000
NODE_56995_length_446_cov_2.161383	17	97	0	80	80	1.0000000
NODE_57022_length_446_cov_1.907781	196	225	6	18	29	0.6206896
NODE_57022_length_446_cov_1.907781	196	225	8	1	29	0.0344828
NODE_57022_length_446_cov_1.907781	196	225	10	10	29	0.3448276
NODE_57277_length_445_cov_75.572254	108	188	0	50	80	0.6250000
NODE_57277_length_445_cov_75.572254	108	188	2	30	80	0.3750000
NODE_57277_length_445_cov_75.572254	161	241	0	6	80	0.0750000
NODE_57277_length_445_cov_75.572254	161	241	2	74	80	0.9250000
NODE_57277_length_445_cov_75.572254	237	317	0	80	80	1.0000000
NODE_57277_length_445_cov_75.572254	290	370	0	80	80	1.0000000
NODE_57278_length_445_cov_33.973988	83	163	0	41	80	0.5125000
NODE_57278_length_445_cov_33.973988	83	163	2	5	80	0.0625000
NODE_57278_length_445_cov_33.973988	83	163	4	32	80	0.4000000
NODE_57278_length_445_cov_33.973988	83	163	6	2	80	0.0250000
NODE_57278_length_445_cov_33.973988	136	216	4	37	80	0.4625000
NODE_57278_length_445_cov_33.973988	136	216	6	43	80	0.5375000
NODE_57280_length_445_cov_9.323699	78	148	0	70	70	1.0000000
NODE_57280_length_445_cov_9.323699	121	201	0	80	80	1.0000000
NODE_57284_length_445_cov_6.439306	210	282	1	31	72	0.4305556
NODE_57284_length_445_cov_6.439306	210	282	2	27	72	0.3750000
NODE_57284_length_445_cov_6.439306	210	282	4	14	72	0.1944444
NODE_57286_length_445_cov_5.479769	115	184	2	69	69	1.0000000
NODE_57286_length_445_cov_5.479769	157	237	0	44	80	0.5500000
NODE_57286_length_445_cov_5.479769	157	237	2	36	80	0.4500000
NODE_57286_length_445_cov_5.479769	233	309	0	28	76	0.3684210
NODE_57286_length_445_cov_5.479769	233	309	2	48	76	0.6315789
NODE_57286_length_445_cov_5.479769	286	309	2	23	23	1.0000000
NODE_57345_length_445_cov_2.843931	124	199	2	75	75	1.0000000
NODE_57352_length_445_cov_2.682081	202	248	0	1	46	0.0217391
NODE_57352_length_445_cov_2.682081	202	248	1	2	46	0.0434783
NODE_57352_length_445_cov_2.682081	202	248	2	43	46	0.9347826
NODE_57400_length_445_cov_1.884393	252	332	0	7	80	0.0875000
NODE_57400_length_445_cov_1.884393	252	332	4	8	80	0.1000000
NODE_57400_length_445_cov_1.884393	252	332	6	65	80	0.8125000
NODE_57409_length_445_cov_1.783237	132	203	0	28	71	0.3943662
NODE_57409_length_445_cov_1.783237	132	203	2	43	71	0.6056338
NODE_57409_length_445_cov_1.783237	256	331	0	75	75	1.0000000
NODE_57409_length_445_cov_1.783237	256	278	0	22	22	1.0000000
NODE_57644_length_444_cov_34.075362	243	323	0	48	80	0.6000000
NODE_57644_length_444_cov_34.075362	243	323	2	32	80	0.4000000
NODE_57644_length_444_cov_34.075362	296	376	0	16	80	0.2000000
NODE_57644_length_444_cov_34.075362	296	376	2	64	80	0.8000000
NODE_57645_length_444_cov_22.524638	98	178	2	16	80	0.2000000
NODE_57645_length_444_cov_22.524638	98	178	3	3	80	0.0375000
NODE_57645_length_444_cov_22.524638	98	178	4	61	80	0.7625000
NODE_57645_length_444_cov_22.524638	151	231	0	37	80	0.4625000
NODE_57645_length_444_cov_22.524638	151	231	2	32	80	0.4000000
NODE_57645_length_444_cov_22.524638	151	231	4	11	80	0.1375000
NODE_57646_length_444_cov_16.544928	263	343	0	80	80	1.0000000
NODE_57646_length_444_cov_16.544928	316	396	0	80	80	1.0000000
NODE_57647_length_444_cov_12.684058	293	373	2	80	80	1.0000000
NODE_57647_length_444_cov_12.684058	346	426	0	30	80	0.3750000
NODE_57647_length_444_cov_12.684058	346	426	2	50	80	0.6250000
NODE_57649_length_444_cov_9.284058	176	256	0	80	80	1.0000000
NODE_57649_length_444_cov_9.284058	229	309	0	80	80	1.0000000
NODE_57666_length_444_cov_5.159420	170	241	0	71	71	1.0000000
NODE_57668_length_444_cov_5.060870	201	245	8	15	44	0.3409091
NODE_57668_length_444_cov_5.060870	201	245	10	29	44	0.6590909
NODE_57668_length_444_cov_5.060870	218	298	2	13	80	0.1625000
NODE_57668_length_444_cov_5.060870	218	298	4	1	80	0.0125000
NODE_57668_length_444_cov_5.060870	218	298	6	4	80	0.0500000
NODE_57668_length_444_cov_5.060870	218	298	8	8	80	0.1000000
NODE_57668_length_444_cov_5.060870	218	298	10	54	80	0.6750000
NODE_57717_length_444_cov_2.744928	73	136	0	24	63	0.3809524
NODE_57717_length_444_cov_2.744928	73	136	2	39	63	0.6190476
NODE_57770_length_444_cov_2.028986	46	113	27	1	67	0.0149254
NODE_57770_length_444_cov_2.028986	46	113	29	2	67	0.0298507
NODE_57770_length_444_cov_2.028986	46	113	30	1	67	0.0149254
NODE_57770_length_444_cov_2.028986	46	113	35	1	67	0.0149254
NODE_57770_length_444_cov_2.028986	46	113	37	1	67	0.0149254
NODE_57770_length_444_cov_2.028986	46	113	39	2	67	0.0298507
NODE_57770_length_444_cov_2.028986	46	113	41	6	67	0.0895522
NODE_57770_length_444_cov_2.028986	46	113	43	2	67	0.0298507
NODE_57770_length_444_cov_2.028986	46	113	45	1	67	0.0149254
NODE_57770_length_444_cov_2.028986	46	113	47	3	67	0.0447761
NODE_57770_length_444_cov_2.028986	46	113	59	1	67	0.0149254
NODE_57770_length_444_cov_2.028986	46	113	61	1	67	0.0149254
NODE_57770_length_444_cov_2.028986	46	113	67	1	67	0.0149254
NODE_57770_length_444_cov_2.028986	46	113	71	1	67	0.0149254
NODE_57770_length_444_cov_2.028986	46	113	74	3	67	0.0447761
NODE_57770_length_444_cov_2.028986	46	113	76	1	67	0.0149254
NODE_57770_length_444_cov_2.028986	46	113	78	1	67	0.0149254
NODE_57770_length_444_cov_2.028986	46	113	84	1	67	0.0149254
NODE_57770_length_444_cov_2.028986	46	113	86	1	67	0.0149254
NODE_57770_length_444_cov_2.028986	46	113	88	1	67	0.0149254
NODE_57770_length_444_cov_2.028986	46	113	92	2	67	0.0298507
NODE_57770_length_444_cov_2.028986	46	113	96	1	67	0.0149254
NODE_57770_length_444_cov_2.028986	46	113	98	2	67	0.0298507
NODE_57770_length_444_cov_2.028986	46	113	102	1	67	0.0149254
NODE_57770_length_444_cov_2.028986	46	113	103	1	67	0.0149254
NODE_57770_length_444_cov_2.028986	46	113	105	1	67	0.0149254
NODE_57770_length_444_cov_2.028986	46	113	107	1	67	0.0149254
NODE_57770_length_444_cov_2.028986	46	113	111	2	67	0.0298507
NODE_57770_length_444_cov_2.028986	46	113	115	2	67	0.0298507
NODE_57770_length_444_cov_2.028986	46	113	120	1	67	0.0149254
NODE_57770_length_444_cov_2.028986	46	113	124	2	67	0.0298507
NODE_57770_length_444_cov_2.028986	46	113	128	6	67	0.0895522
NODE_57770_length_444_cov_2.028986	46	113	130	1	67	0.0149254
NODE_57770_length_444_cov_2.028986	46	113	131	1	67	0.0149254
NODE_57770_length_444_cov_2.028986	46	113	135	7	67	0.1044776
NODE_57770_length_444_cov_2.028986	46	113	137	4	67	0.0597015
NODE_57770_length_444_cov_2.028986	86	166	82	1	80	0.0125000
NODE_57770_length_444_cov_2.028986	86	166	86	1	80	0.0125000
NODE_57770_length_444_cov_2.028986	86	166	88	1	80	0.0125000
NODE_57770_length_444_cov_2.028986	86	166	94	1	80	0.0125000
NODE_57770_length_444_cov_2.028986	86	166	98	3	80	0.0375000
NODE_57770_length_444_cov_2.028986	86	166	99	1	80	0.0125000
NODE_57770_length_444_cov_2.028986	86	166	104	2	80	0.0250000
NODE_57770_length_444_cov_2.028986	86	166	106	1	80	0.0125000
NODE_57770_length_444_cov_2.028986	86	166	107	1	80	0.0125000
NODE_57770_length_444_cov_2.028986	86	166	108	1	80	0.0125000
NODE_57770_length_444_cov_2.028986	86	166	110	1	80	0.0125000
NODE_57770_length_444_cov_2.028986	86	166	111	2	80	0.0250000
NODE_57770_length_444_cov_2.028986	86	166	115	2	80	0.0250000
NODE_57770_length_444_cov_2.028986	86	166	116	1	80	0.0125000
NODE_57770_length_444_cov_2.028986	86	166	117	1	80	0.0125000
NODE_57770_length_444_cov_2.028986	86	166	120	1	80	0.0125000
NODE_57770_length_444_cov_2.028986	86	166	124	2	80	0.0250000
NODE_57770_length_444_cov_2.028986	86	166	125	1	80	0.0125000
NODE_57770_length_444_cov_2.028986	86	166	127	3	80	0.0375000
NODE_57770_length_444_cov_2.028986	86	166	128	7	80	0.0875000
NODE_57770_length_444_cov_2.028986	86	166	130	3	80	0.0375000
NODE_57770_length_444_cov_2.028986	86	166	131	3	80	0.0375000
NODE_57770_length_444_cov_2.028986	86	166	134	2	80	0.0250000
NODE_57770_length_444_cov_2.028986	86	166	135	7	80	0.0875000
NODE_57770_length_444_cov_2.028986	86	166	136	6	80	0.0750000
NODE_57770_length_444_cov_2.028986	86	166	137	5	80	0.0625000
NODE_57770_length_444_cov_2.028986	86	166	138	3	80	0.0375000
NODE_57770_length_444_cov_2.028986	86	166	139	2	80	0.0250000
NODE_57770_length_444_cov_2.028986	86	166	141	7	80	0.0875000
NODE_57770_length_444_cov_2.028986	86	166	143	4	80	0.0500000
NODE_57770_length_444_cov_2.028986	86	166	145	2	80	0.0250000
NODE_57770_length_444_cov_2.028986	86	166	147	2	80	0.0250000
NODE_57873_length_444_cov_1.234783	335	407	0	72	72	1.0000000
NODE_57892_length_444_cov_1.173913	7	87	2	80	80	1.0000000
NODE_58026_length_443_cov_71.284884	209	289	2	20	80	0.2500000
NODE_58026_length_443_cov_71.284884	209	289	14	13	80	0.1625000
NODE_58026_length_443_cov_71.284884	209	289	16	22	80	0.2750000
NODE_58026_length_443_cov_71.284884	209	289	18	15	80	0.1875000
NODE_58026_length_443_cov_71.284884	209	289	20	10	80	0.1250000
NODE_58026_length_443_cov_71.284884	262	342	12	2	80	0.0250000
NODE_58026_length_443_cov_71.284884	262	342	16	2	80	0.0250000
NODE_58026_length_443_cov_71.284884	262	342	18	66	80	0.8250000
NODE_58026_length_443_cov_71.284884	262	342	20	10	80	0.1250000
NODE_58026_length_443_cov_71.284884	338	418	6	27	80	0.3375000
NODE_58026_length_443_cov_71.284884	338	418	8	23	80	0.2875000
NODE_58026_length_443_cov_71.284884	338	418	10	4	80	0.0500000
NODE_58026_length_443_cov_71.284884	338	418	12	24	80	0.3000000
NODE_58026_length_443_cov_71.284884	338	418	18	2	80	0.0250000
NODE_58026_length_443_cov_71.284884	391	443	0	8	52	0.1538462
NODE_58026_length_443_cov_71.284884	391	443	6	44	52	0.8461539
NODE_58027_length_443_cov_68.973837	314	394	4	6	80	0.0750000
NODE_58027_length_443_cov_68.973837	314	394	6	1	80	0.0125000
NODE_58027_length_443_cov_68.973837	314	394	8	9	80	0.1125000
NODE_58027_length_443_cov_68.973837	314	394	10	48	80	0.6000000
NODE_58027_length_443_cov_68.973837	314	394	12	16	80	0.2000000
NODE_58027_length_443_cov_68.973837	367	443	0	1	76	0.0131579
NODE_58027_length_443_cov_68.973837	367	443	2	7	76	0.0921053
NODE_58027_length_443_cov_68.973837	367	443	4	24	76	0.3157895
NODE_58027_length_443_cov_68.973837	367	443	6	16	76	0.2105263
NODE_58027_length_443_cov_68.973837	367	443	8	1	76	0.0131579
NODE_58027_length_443_cov_68.973837	367	443	10	27	76	0.3552631
NODE_58028_length_443_cov_61.116279	34	114	0	80	80	1.0000000
NODE_58028_length_443_cov_61.116279	87	167	0	80	80	1.0000000
NODE_58041_length_443_cov_4.895349	127	207	2	80	80	1.0000000
NODE_58086_length_443_cov_2.581395	121	195	0	29	74	0.3918919
NODE_58086_length_443_cov_2.581395	121	195	2	41	74	0.5540541
NODE_58086_length_443_cov_2.581395	121	195	6	4	74	0.0540541
NODE_58088_length_443_cov_2.508721	297	347	0	50	50	1.0000000
NODE_58088_length_443_cov_2.508721	320	395	0	75	75	1.0000000
NODE_58091_length_443_cov_2.456395	114	192	0	78	78	1.0000000
NODE_58091_length_443_cov_2.456395	118	141	0	23	23	1.0000000
NODE_58237_length_443_cov_1.151163	144	224	0	1	80	0.0125000
NODE_58237_length_443_cov_1.151163	144	224	2	30	80	0.3750000
NODE_58237_length_443_cov_1.151163	144	224	4	49	80	0.6125000
NODE_58321_length_443_cov_0.715116	52	104	0	52	52	1.0000000
NODE_58321_length_443_cov_0.715116	105	146	0	41	41	1.0000000
NODE_58346_length_442_cov_42.956268	290	375	0	5	85	0.0588235
NODE_58346_length_442_cov_42.956268	290	375	8	2	85	0.0235294
NODE_58346_length_442_cov_42.956268	290	375	10	26	85	0.3058824
NODE_58346_length_442_cov_42.956268	290	375	12	8	85	0.0941176
NODE_58346_length_442_cov_42.956268	290	375	14	44	85	0.5176471
NODE_58346_length_442_cov_42.956268	290	375	0	5	85	0.0588235
NODE_58346_length_442_cov_42.956268	290	375	8	2	85	0.0235294
NODE_58346_length_442_cov_42.956268	290	375	10	26	85	0.3058824
NODE_58346_length_442_cov_42.956268	290	375	12	8	85	0.0941176
NODE_58346_length_442_cov_42.956268	290	375	14	44	85	0.5176471
NODE_58347_length_442_cov_24.093294	225	305	2	80	80	1.0000000
NODE_58347_length_442_cov_24.093294	278	358	0	27	80	0.3375000
NODE_58347_length_442_cov_24.093294	278	358	2	53	80	0.6625000
NODE_58348_length_442_cov_8.956268	173	192	0	19	19	1.0000000
NODE_58361_length_442_cov_5.052478	213	293	0	80	80	1.0000000
NODE_58361_length_442_cov_5.052478	266	346	0	80	80	1.0000000
NODE_58376_length_442_cov_3.871720	297	372	8	5	75	0.0666667
NODE_58376_length_442_cov_3.871720	297	372	10	1	75	0.0133333
NODE_58376_length_442_cov_3.871720	297	372	12	2	75	0.0266667
NODE_58376_length_442_cov_3.871720	297	372	14	3	75	0.0400000
NODE_58376_length_442_cov_3.871720	297	372	16	7	75	0.0933333
NODE_58376_length_442_cov_3.871720	297	372	18	57	75	0.7600000
NODE_58376_length_442_cov_3.871720	360	413	2	13	53	0.2452830
NODE_58376_length_442_cov_3.871720	360	413	4	8	53	0.1509434
NODE_58376_length_442_cov_3.871720	360	413	6	3	53	0.0566038
NODE_58376_length_442_cov_3.871720	360	413	8	1	53	0.0188679
NODE_58376_length_442_cov_3.871720	360	413	10	2	53	0.0377358
NODE_58376_length_442_cov_3.871720	360	413	12	1	53	0.0188679
NODE_58376_length_442_cov_3.871720	360	413	14	9	53	0.1698113
NODE_58376_length_442_cov_3.871720	360	413	16	10	53	0.1886792
NODE_58376_length_442_cov_3.871720	360	413	18	6	53	0.1132075
NODE_58378_length_442_cov_3.804665	211	244	0	30	33	0.9090909
NODE_58378_length_442_cov_3.804665	211	244	9	2	33	0.0606061
NODE_58378_length_442_cov_3.804665	211	244	16	1	33	0.0303030
NODE_58405_length_442_cov_3.206997	149	217	2	3	68	0.0441176
NODE_58405_length_442_cov_3.206997	149	217	4	32	68	0.4705882
NODE_58405_length_442_cov_3.206997	149	217	6	33	68	0.4852941
NODE_58438_length_442_cov_2.434402	203	274	0	68	71	0.9577465
NODE_58438_length_442_cov_2.434402	203	274	2	1	71	0.0140845
NODE_58438_length_442_cov_2.434402	203	274	4	2	71	0.0281690
NODE_58438_length_442_cov_2.434402	247	327	0	24	80	0.3000000
NODE_58438_length_442_cov_2.434402	247	327	2	1	80	0.0125000
NODE_58438_length_442_cov_2.434402	247	327	4	12	80	0.1500000
NODE_58438_length_442_cov_2.434402	247	327	6	31	80	0.3875000
NODE_58438_length_442_cov_2.434402	247	327	8	12	80	0.1500000
NODE_58503_length_442_cov_1.746356	95	161	0	31	66	0.4696970
NODE_58503_length_442_cov_1.746356	95	161	2	35	66	0.5303030
NODE_58503_length_442_cov_1.746356	95	122	0	27	27	1.0000000
NODE_58759_length_441_cov_21.877193	28	108	0	80	80	1.0000000
NODE_58759_length_441_cov_21.877193	81	161	0	80	80	1.0000000
NODE_58760_length_441_cov_13.546784	152	232	0	51	80	0.6375000
NODE_58760_length_441_cov_13.546784	152	232	2	29	80	0.3625000
NODE_58760_length_441_cov_13.546784	205	285	2	42	80	0.5250000
NODE_58760_length_441_cov_13.546784	205	285	4	38	80	0.4750000
NODE_58771_length_441_cov_5.710526	200	280	0	80	80	1.0000000
NODE_58771_length_441_cov_5.710526	253	333	0	80	80	1.0000000
NODE_58817_length_441_cov_3.096491	240	324	0	60	84	0.7142857
NODE_58817_length_441_cov_3.096491	240	324	2	24	84	0.2857143
NODE_58820_length_441_cov_3.023392	105	163	0	40	58	0.6896552
NODE_58820_length_441_cov_3.023392	105	163	2	18	58	0.3103448
NODE_58852_length_441_cov_2.438596	19	99	0	16	80	0.2000000
NODE_58852_length_441_cov_2.438596	19	99	2	7	80	0.0875000
NODE_58852_length_441_cov_2.438596	19	99	6	57	80	0.7125000
NODE_58852_length_441_cov_2.438596	72	126	6	53	54	0.9814815
NODE_58852_length_441_cov_2.438596	72	126	8	1	54	0.0185185
NODE_58970_length_441_cov_1.435673	105	156	0	51	51	1.0000000
NODE_59142_length_440_cov_43.131965	122	202	0	6	80	0.0750000
NODE_59142_length_440_cov_43.131965	122	202	4	29	80	0.3625000
NODE_59142_length_440_cov_43.131965	122	202	11	2	80	0.0250000
NODE_59142_length_440_cov_43.131965	122	202	12	43	80	0.5375000
NODE_59142_length_440_cov_43.131965	175	255	0	12	80	0.1500000
NODE_59142_length_440_cov_43.131965	175	255	8	19	80	0.2375000
NODE_59142_length_440_cov_43.131965	175	255	12	49	80	0.6125000
NODE_59142_length_440_cov_43.131965	251	331	0	65	80	0.8125000
NODE_59142_length_440_cov_43.131965	251	331	4	15	80	0.1875000
NODE_59142_length_440_cov_43.131965	304	384	0	12	80	0.1500000
NODE_59142_length_440_cov_43.131965	304	384	4	68	80	0.8500000
NODE_59143_length_440_cov_42.929619	116	196	6	3	80	0.0375000
NODE_59143_length_440_cov_42.929619	116	196	8	77	80	0.9625000
NODE_59143_length_440_cov_42.929619	169	249	6	51	80	0.6375000
NODE_59143_length_440_cov_42.929619	169	249	8	29	80	0.3625000
NODE_59147_length_440_cov_8.164223	45	125	0	80	80	1.0000000
NODE_59147_length_440_cov_8.164223	98	178	0	80	80	1.0000000
NODE_59157_length_440_cov_5.193548	146	210	7	22	64	0.3437500
NODE_59157_length_440_cov_5.193548	146	210	9	8	64	0.1250000
NODE_59157_length_440_cov_5.193548	146	210	11	34	64	0.5312500
NODE_59157_length_440_cov_5.193548	146	210	7	22	64	0.3437500
NODE_59157_length_440_cov_5.193548	146	210	9	8	64	0.1250000
NODE_59157_length_440_cov_5.193548	146	210	11	34	64	0.5312500
NODE_59157_length_440_cov_5.193548	146	210	7	22	64	0.3437500
NODE_59157_length_440_cov_5.193548	146	210	9	8	64	0.1250000
NODE_59157_length_440_cov_5.193548	146	210	11	34	64	0.5312500
NODE_59164_length_440_cov_4.595308	153	233	0	8	80	0.1000000
NODE_59164_length_440_cov_4.595308	153	233	2	7	80	0.0875000
NODE_59164_length_440_cov_4.595308	153	233	4	65	80	0.8125000
NODE_59164_length_440_cov_4.595308	153	180	4	27	27	1.0000000
NODE_59188_length_440_cov_3.431085	84	150	0	66	66	1.0000000
NODE_59191_length_440_cov_3.331378	139	195	0	56	56	1.0000000
NODE_59517_length_439_cov_76.552941	0	68	0	68	68	1.0000000
NODE_59517_length_439_cov_76.552941	0	68	0	68	68	1.0000000
NODE_59517_length_439_cov_76.552941	0	68	0	68	68	1.0000000
NODE_59517_length_439_cov_76.552941	1	68	0	67	67	1.0000000
NODE_59517_length_439_cov_76.552941	64	144	0	80	80	1.0000000
NODE_59517_length_439_cov_76.552941	64	144	0	80	80	1.0000000
NODE_59517_length_439_cov_76.552941	117	197	0	80	80	1.0000000
NODE_59517_length_439_cov_76.552941	117	195	0	78	78	1.0000000
NODE_59533_length_439_cov_4.408824	174	238	0	64	64	1.0000000
NODE_59536_length_439_cov_4.255882	258	318	0	7	60	0.1166667
NODE_59536_length_439_cov_4.255882	258	318	4	53	60	0.8833333
NODE_59560_length_439_cov_3.011765	57	128	32	4	71	0.0563380
NODE_59560_length_439_cov_3.011765	57	128	33	1	71	0.0140845
NODE_59560_length_439_cov_3.011765	57	128	34	15	71	0.2112676
NODE_59560_length_439_cov_3.011765	57	128	35	4	71	0.0563380
NODE_59560_length_439_cov_3.011765	57	128	36	3	71	0.0422535
NODE_59560_length_439_cov_3.011765	57	128	37	28	71	0.3943662
NODE_59560_length_439_cov_3.011765	57	128	38	6	71	0.0845070
NODE_59560_length_439_cov_3.011765	57	128	39	10	71	0.1408451
NODE_59560_length_439_cov_3.011765	101	140	29	1	39	0.0256410
NODE_59560_length_439_cov_3.011765	101	140	31	2	39	0.0512821
NODE_59560_length_439_cov_3.011765	101	140	33	1	39	0.0256410
NODE_59560_length_439_cov_3.011765	101	140	34	7	39	0.1794872
NODE_59560_length_439_cov_3.011765	101	140	35	1	39	0.0256410
NODE_59560_length_439_cov_3.011765	101	140	37	17	39	0.4358974
NODE_59560_length_439_cov_3.011765	101	140	39	10	39	0.2564103
NODE_59592_length_439_cov_2.252941	227	269	0	42	42	1.0000000
NODE_59599_length_439_cov_2.135294	116	179	0	63	63	1.0000000
NODE_59617_length_439_cov_1.929412	388	439	0	51	51	1.0000000
NODE_59897_length_438_cov_29.952802	196	276	0	80	80	1.0000000
NODE_59897_length_438_cov_29.952802	249	329	0	80	80	1.0000000
NODE_59898_length_438_cov_16.330383	225	305	0	50	80	0.6250000
NODE_59898_length_438_cov_16.330383	225	305	2	30	80	0.3750000
NODE_59898_length_438_cov_16.330383	278	358	2	80	80	1.0000000
NODE_59899_length_438_cov_15.436578	74	154	0	80	80	1.0000000
NODE_59899_length_438_cov_15.436578	127	207	0	80	80	1.0000000
NODE_59901_length_438_cov_9.306785	256	309	0	53	53	1.0000000
NODE_59901_length_438_cov_9.306785	282	327	0	45	45	1.0000000
NODE_59916_length_438_cov_4.808260	46	133	2	21	87	0.2413793
NODE_59916_length_438_cov_4.808260	46	133	6	5	87	0.0574713
NODE_59916_length_438_cov_4.808260	46	133	8	3	87	0.0344828
NODE_59916_length_438_cov_4.808260	46	133	10	15	87	0.1724138
NODE_59916_length_438_cov_4.808260	46	133	12	5	87	0.0574713
NODE_59916_length_438_cov_4.808260	46	133	14	21	87	0.2413793
NODE_59916_length_438_cov_4.808260	46	133	16	10	87	0.1149425
NODE_59916_length_438_cov_4.808260	46	133	20	7	87	0.0804598
NODE_59916_length_438_cov_4.808260	106	186	12	25	80	0.3125000
NODE_59916_length_438_cov_4.808260	106	186	14	22	80	0.2750000
NODE_59916_length_438_cov_4.808260	106	186	16	22	80	0.2750000
NODE_59916_length_438_cov_4.808260	106	186	20	11	80	0.1375000
NODE_59920_length_438_cov_4.622419	135	184	4	49	49	1.0000000
NODE_59936_length_438_cov_3.651917	86	166	0	77	80	0.9625000
NODE_59936_length_438_cov_3.651917	86	166	2	3	80	0.0375000
NODE_59936_length_438_cov_3.651917	139	219	0	24	80	0.3000000
NODE_59936_length_438_cov_3.651917	139	219	2	56	80	0.7000000
NODE_59952_length_438_cov_3.109145	215	273	0	58	58	1.0000000
NODE_59957_length_438_cov_3.005900	175	258	0	83	83	1.0000000
NODE_60317_length_437_cov_57.260355	272	352	2	80	80	1.0000000
NODE_60317_length_437_cov_57.260355	325	405	0	52	80	0.6500000
NODE_60317_length_437_cov_57.260355	325	405	2	28	80	0.3500000
NODE_60318_length_437_cov_40.964497	0	73	0	73	73	1.0000000
NODE_60318_length_437_cov_40.964497	46	126	0	76	80	0.9500000
NODE_60318_length_437_cov_40.964497	46	126	2	4	80	0.0500000
NODE_60319_length_437_cov_30.843195	140	220	0	80	80	1.0000000
NODE_60319_length_437_cov_30.843195	193	273	0	80	80	1.0000000
NODE_60320_length_437_cov_14.736686	164	244	0	6	80	0.0750000
NODE_60320_length_437_cov_14.736686	164	244	2	4	80	0.0500000
NODE_60320_length_437_cov_14.736686	164	244	3	70	80	0.8750000
NODE_60320_length_437_cov_14.736686	217	297	0	48	80	0.6000000
NODE_60320_length_437_cov_14.736686	217	297	2	9	80	0.1125000
NODE_60320_length_437_cov_14.736686	217	297	3	23	80	0.2875000
NODE_60331_length_437_cov_6.032544	249	320	0	71	71	1.0000000
NODE_60332_length_437_cov_6.020710	272	352	16	27	80	0.3375000
NODE_60332_length_437_cov_6.020710	272	352	17	4	80	0.0500000
NODE_60332_length_437_cov_6.020710	272	352	18	49	80	0.6125000
NODE_60332_length_437_cov_6.020710	325	405	0	28	80	0.3500000
NODE_60332_length_437_cov_6.020710	325	405	2	2	80	0.0250000
NODE_60332_length_437_cov_6.020710	325	405	12	6	80	0.0750000
NODE_60332_length_437_cov_6.020710	325	405	14	11	80	0.1375000
NODE_60332_length_437_cov_6.020710	325	405	16	18	80	0.2250000
NODE_60332_length_437_cov_6.020710	325	405	17	4	80	0.0500000
NODE_60332_length_437_cov_6.020710	325	405	18	11	80	0.1375000
NODE_60336_length_437_cov_5.526627	129	209	0	80	80	1.0000000
NODE_60336_length_437_cov_5.526627	182	262	0	80	80	1.0000000
NODE_60348_length_437_cov_4.505917	247	327	0	36	80	0.4500000
NODE_60348_length_437_cov_4.505917	247	327	17	2	80	0.0250000
NODE_60348_length_437_cov_4.505917	247	327	18	42	80	0.5250000
NODE_60361_length_437_cov_3.470414	204	259	0	55	55	1.0000000
NODE_60369_length_437_cov_3.301775	95	149	4	54	54	1.0000000
NODE_60381_length_437_cov_2.911243	91	171	0	29	80	0.3625000
NODE_60381_length_437_cov_2.911243	91	171	2	3	80	0.0375000
NODE_60381_length_437_cov_2.911243	91	171	4	2	80	0.0250000
NODE_60381_length_437_cov_2.911243	91	171	6	1	80	0.0125000
NODE_60381_length_437_cov_2.911243	91	171	9	4	80	0.0500000
NODE_60381_length_437_cov_2.911243	91	171	11	1	80	0.0125000
NODE_60381_length_437_cov_2.911243	91	171	13	6	80	0.0750000
NODE_60381_length_437_cov_2.911243	91	171	14	11	80	0.1375000
NODE_60381_length_437_cov_2.911243	91	171	16	23	80	0.2875000
NODE_60400_length_437_cov_2.650888	190	239	0	4	49	0.0816327
NODE_60400_length_437_cov_2.650888	190	239	2	12	49	0.2448980
NODE_60400_length_437_cov_2.650888	190	239	4	33	49	0.6734694
NODE_60400_length_437_cov_2.650888	212	292	0	7	80	0.0875000
NODE_60400_length_437_cov_2.650888	212	292	2	8	80	0.1000000
NODE_60400_length_437_cov_2.650888	212	292	4	65	80	0.8125000
NODE_60411_length_437_cov_2.514793	292	333	2	41	41	1.0000000
NODE_60509_length_437_cov_1.473373	252	324	2	18	72	0.2500000
NODE_60509_length_437_cov_1.473373	252	324	4	16	72	0.2222222
NODE_60509_length_437_cov_1.473373	252	324	6	38	72	0.5277778
NODE_60709_length_436_cov_125.940653	204	284	2	39	80	0.4875000
NODE_60709_length_436_cov_125.940653	204	284	6	14	80	0.1750000
NODE_60709_length_436_cov_125.940653	204	284	8	11	80	0.1375000
NODE_60709_length_436_cov_125.940653	204	284	10	10	80	0.1250000
NODE_60709_length_436_cov_125.940653	204	284	11	3	80	0.0375000
NODE_60709_length_436_cov_125.940653	204	284	13	1	80	0.0125000
NODE_60709_length_436_cov_125.940653	204	284	16	2	80	0.0250000
NODE_60709_length_436_cov_125.940653	255	301	0	10	46	0.2173913
NODE_60709_length_436_cov_125.940653	255	301	2	36	46	0.7826087
NODE_60709_length_436_cov_125.940653	257	337	0	42	80	0.5250000
NODE_60709_length_436_cov_125.940653	257	337	2	38	80	0.4750000
NODE_60709_length_436_cov_125.940653	333	413	2	80	80	1.0000000
NODE_60709_length_436_cov_125.940653	386	436	0	4	50	0.0800000
NODE_60709_length_436_cov_125.940653	386	436	2	46	50	0.9200000
NODE_60712_length_436_cov_45.459941	166	246	0	80	80	1.0000000
NODE_60712_length_436_cov_45.459941	219	299	0	59	80	0.7375000
NODE_60712_length_436_cov_45.459941	219	299	10	21	80	0.2625000
NODE_60712_length_436_cov_45.459941	295	375	10	80	80	1.0000000
NODE_60712_length_436_cov_45.459941	348	428	0	20	80	0.2500000
NODE_60712_length_436_cov_45.459941	348	428	10	60	80	0.7500000
NODE_60713_length_436_cov_10.560831	74	154	0	20	80	0.2500000
NODE_60713_length_436_cov_10.560831	74	154	2	60	80	0.7500000
NODE_60713_length_436_cov_10.560831	127	207	0	34	80	0.4250000
NODE_60713_length_436_cov_10.560831	127	207	2	46	80	0.5750000
NODE_60716_length_436_cov_8.317507	51	127	0	76	76	1.0000000
NODE_60716_length_436_cov_8.317507	104	182	0	78	78	1.0000000
NODE_60760_length_436_cov_3.109792	153	205	0	52	52	1.0000000
NODE_60786_length_436_cov_2.551929	182	258	2	76	76	1.0000000
NODE_60786_length_436_cov_2.551929	235	315	0	53	80	0.6625000
NODE_60786_length_436_cov_2.551929	235	315	2	27	80	0.3375000
NODE_60934_length_436_cov_1.207715	105	181	0	76	76	1.0000000
NODE_61088_length_435_cov_17.401786	55	135	0	80	80	1.0000000
NODE_61088_length_435_cov_17.401786	108	188	0	80	80	1.0000000
NODE_61094_length_435_cov_6.910714	113	193	2	16	80	0.2000000
NODE_61094_length_435_cov_6.910714	113	193	3	7	80	0.0875000
NODE_61094_length_435_cov_6.910714	113	193	4	57	80	0.7125000
NODE_61094_length_435_cov_6.910714	147	194	0	1	47	0.0212766
NODE_61094_length_435_cov_6.910714	147	194	2	16	47	0.3404255
NODE_61094_length_435_cov_6.910714	147	194	3	7	47	0.1489362
NODE_61094_length_435_cov_6.910714	147	194	4	23	47	0.4893617
NODE_61094_length_435_cov_6.910714	149	184	2	7	35	0.2000000
NODE_61094_length_435_cov_6.910714	149	184	3	7	35	0.2000000
NODE_61094_length_435_cov_6.910714	149	184	4	21	35	0.6000000
NODE_61094_length_435_cov_6.910714	151	193	2	16	42	0.3809524
NODE_61094_length_435_cov_6.910714	151	193	3	7	42	0.1666667
NODE_61094_length_435_cov_6.910714	151	193	4	19	42	0.4523810
NODE_61094_length_435_cov_6.910714	166	251	0	58	85	0.6823530
NODE_61094_length_435_cov_6.910714	166	251	2	16	85	0.1882353
NODE_61094_length_435_cov_6.910714	166	251	3	7	85	0.0823529
NODE_61094_length_435_cov_6.910714	166	251	4	4	85	0.0470588
NODE_61094_length_435_cov_6.910714	167	251	0	58	84	0.6904762
NODE_61094_length_435_cov_6.910714	167	251	2	16	84	0.1904762
NODE_61094_length_435_cov_6.910714	167	251	3	7	84	0.0833333
NODE_61094_length_435_cov_6.910714	167	251	4	3	84	0.0357143
NODE_61102_length_435_cov_5.630952	159	217	0	58	58	1.0000000
NODE_61102_length_435_cov_5.630952	190	270	0	80	80	1.0000000
NODE_61112_length_435_cov_4.601190	271	309	0	35	38	0.9210526
NODE_61112_length_435_cov_4.601190	271	309	2	3	38	0.0789474
NODE_61112_length_435_cov_4.601190	282	344	0	24	62	0.3870968
NODE_61112_length_435_cov_4.601190	282	344	2	38	62	0.6129032
NODE_61122_length_435_cov_3.770833	209	240	0	31	31	1.0000000
NODE_61137_length_435_cov_2.836310	113	194	2	5	81	0.0617284
NODE_61137_length_435_cov_2.836310	113	194	4	11	81	0.1358025
NODE_61137_length_435_cov_2.836310	113	194	5	6	81	0.0740741
NODE_61137_length_435_cov_2.836310	113	194	6	59	81	0.7283950
NODE_61357_length_435_cov_0.988095	286	322	0	36	36	1.0000000
NODE_61451_length_434_cov_136.483582	0	58	18	1	58	0.0172414
NODE_61451_length_434_cov_136.483582	0	58	24	1	58	0.0172414
NODE_61451_length_434_cov_136.483582	0	58	30	1	58	0.0172414
NODE_61451_length_434_cov_136.483582	0	58	49	2	58	0.0344828
NODE_61451_length_434_cov_136.483582	0	58	61	1	58	0.0172414
NODE_61451_length_434_cov_136.483582	0	58	79	1	58	0.0172414
NODE_61451_length_434_cov_136.483582	0	58	83	1	58	0.0172414
NODE_61451_length_434_cov_136.483582	0	58	95	1	58	0.0172414
NODE_61451_length_434_cov_136.483582	0	58	97	1	58	0.0172414
NODE_61451_length_434_cov_136.483582	0	58	101	1	58	0.0172414
NODE_61451_length_434_cov_136.483582	0	58	117	1	58	0.0172414
NODE_61451_length_434_cov_136.483582	0	58	123	1	58	0.0172414
NODE_61451_length_434_cov_136.483582	0	58	129	1	58	0.0172414
NODE_61451_length_434_cov_136.483582	0	58	135	2	58	0.0344828
NODE_61451_length_434_cov_136.483582	0	58	139	1	58	0.0172414
NODE_61451_length_434_cov_136.483582	0	58	144	1	58	0.0172414
NODE_61451_length_434_cov_136.483582	0	58	153	1	58	0.0172414
NODE_61451_length_434_cov_136.483582	0	58	154	1	58	0.0172414
NODE_61451_length_434_cov_136.483582	0	58	155	1	58	0.0172414
NODE_61451_length_434_cov_136.483582	0	58	161	1	58	0.0172414
NODE_61451_length_434_cov_136.483582	0	58	167	1	58	0.0172414
NODE_61451_length_434_cov_136.483582	0	58	174	3	58	0.0517241
NODE_61451_length_434_cov_136.483582	0	58	176	1	58	0.0172414
NODE_61451_length_434_cov_136.483582	0	58	178	1	58	0.0172414
NODE_61451_length_434_cov_136.483582	0	58	180	1	58	0.0172414
NODE_61451_length_434_cov_136.483582	0	58	184	1	58	0.0172414
NODE_61451_length_434_cov_136.483582	0	58	188	1	58	0.0172414
NODE_61451_length_434_cov_136.483582	0	58	192	1	58	0.0172414
NODE_61451_length_434_cov_136.483582	0	58	194	1	58	0.0172414
NODE_61451_length_434_cov_136.483582	0	58	196	1	58	0.0172414
NODE_61451_length_434_cov_136.483582	0	58	200	3	58	0.0517241
NODE_61451_length_434_cov_136.483582	0	58	202	1	58	0.0172414
NODE_61451_length_434_cov_136.483582	0	58	204	1	58	0.0172414
NODE_61451_length_434_cov_136.483582	0	58	206	1	58	0.0172414
NODE_61451_length_434_cov_136.483582	0	58	209	6	58	0.1034483
NODE_61451_length_434_cov_136.483582	0	58	210	1	58	0.0172414
NODE_61451_length_434_cov_136.483582	0	58	211	6	58	0.1034483
NODE_61451_length_434_cov_136.483582	0	58	212	4	58	0.0689655
NODE_61451_length_434_cov_136.483582	0	58	213	1	58	0.0172414
NODE_61451_length_434_cov_136.483582	31	111	192	1	80	0.0125000
NODE_61451_length_434_cov_136.483582	31	111	194	1	80	0.0125000
NODE_61451_length_434_cov_136.483582	31	111	196	1	80	0.0125000
NODE_61451_length_434_cov_136.483582	31	111	200	3	80	0.0375000
NODE_61451_length_434_cov_136.483582	31	111	202	1	80	0.0125000
NODE_61451_length_434_cov_136.483582	31	111	204	1	80	0.0125000
NODE_61451_length_434_cov_136.483582	31	111	206	1	80	0.0125000
NODE_61451_length_434_cov_136.483582	31	111	209	6	80	0.0750000
NODE_61451_length_434_cov_136.483582	31	111	210	1	80	0.0125000
NODE_61451_length_434_cov_136.483582	31	111	211	6	80	0.0750000
NODE_61451_length_434_cov_136.483582	31	111	212	4	80	0.0500000
NODE_61451_length_434_cov_136.483582	31	111	213	1	80	0.0125000
NODE_61451_length_434_cov_136.483582	31	111	215	5	80	0.0625000
NODE_61451_length_434_cov_136.483582	31	111	216	1	80	0.0125000
NODE_61451_length_434_cov_136.483582	31	111	217	3	80	0.0375000
NODE_61451_length_434_cov_136.483582	31	111	218	6	80	0.0750000
NODE_61451_length_434_cov_136.483582	31	111	222	2	80	0.0250000
NODE_61451_length_434_cov_136.483582	31	111	227	1	80	0.0125000
NODE_61451_length_434_cov_136.483582	31	111	233	2	80	0.0250000
NODE_61451_length_434_cov_136.483582	31	111	235	1	80	0.0125000
NODE_61451_length_434_cov_136.483582	31	111	239	1	80	0.0125000
NODE_61451_length_434_cov_136.483582	31	111	241	5	80	0.0625000
NODE_61451_length_434_cov_136.483582	31	111	243	2	80	0.0250000
NODE_61451_length_434_cov_136.483582	31	111	245	3	80	0.0375000
NODE_61451_length_434_cov_136.483582	31	111	247	2	80	0.0250000
NODE_61451_length_434_cov_136.483582	31	111	249	1	80	0.0125000
NODE_61451_length_434_cov_136.483582	31	111	250	1	80	0.0125000
NODE_61451_length_434_cov_136.483582	31	111	251	1	80	0.0125000
NODE_61451_length_434_cov_136.483582	31	111	253	4	80	0.0500000
NODE_61451_length_434_cov_136.483582	31	111	255	1	80	0.0125000
NODE_61451_length_434_cov_136.483582	31	111	259	8	80	0.1000000
NODE_61451_length_434_cov_136.483582	31	111	260	1	80	0.0125000
NODE_61451_length_434_cov_136.483582	31	111	261	1	80	0.0125000
NODE_61451_length_434_cov_136.483582	31	111	263	1	80	0.0125000
NODE_61452_length_434_cov_43.214925	291	366	0	47	75	0.6266667
NODE_61452_length_434_cov_43.214925	291	366	2	28	75	0.3733333
NODE_61452_length_434_cov_43.214925	344	424	0	80	80	1.0000000
NODE_61452_length_434_cov_43.214925	344	424	0	80	80	1.0000000
NODE_61453_length_434_cov_22.373134	80	160	0	80	80	1.0000000
NODE_61453_length_434_cov_22.373134	133	213	0	80	80	1.0000000
NODE_61455_length_434_cov_11.549254	74	145	0	71	71	1.0000000
NODE_61455_length_434_cov_11.549254	118	198	0	80	80	1.0000000
NODE_61477_length_434_cov_4.125373	191	233	2	42	42	1.0000000
NODE_61477_length_434_cov_4.125373	200	235	2	35	35	1.0000000
NODE_61497_length_434_cov_3.104478	191	263	0	72	72	1.0000000
NODE_61528_length_434_cov_2.197015	129	168	0	7	39	0.1794872
NODE_61528_length_434_cov_2.197015	129	168	2	32	39	0.8205128
NODE_61563_length_434_cov_1.883582	88	133	0	45	45	1.0000000
NODE_61563_length_434_cov_1.883582	141	182	0	26	41	0.6341463
NODE_61563_length_434_cov_1.883582	141	182	2	15	41	0.3658537
NODE_61603_length_434_cov_1.626866	163	243	2	55	80	0.6875000
NODE_61603_length_434_cov_1.626866	163	243	4	25	80	0.3125000
NODE_61676_length_434_cov_1.220896	118	198	72	2	80	0.0250000
NODE_61676_length_434_cov_1.220896	118	198	74	2	80	0.0250000
NODE_61676_length_434_cov_1.220896	118	198	75	1	80	0.0125000
NODE_61676_length_434_cov_1.220896	118	198	83	2	80	0.0250000
NODE_61676_length_434_cov_1.220896	118	198	85	1	80	0.0125000
NODE_61676_length_434_cov_1.220896	118	198	102	1	80	0.0125000
NODE_61676_length_434_cov_1.220896	118	198	108	2	80	0.0250000
NODE_61676_length_434_cov_1.220896	118	198	110	1	80	0.0125000
NODE_61676_length_434_cov_1.220896	118	198	114	1	80	0.0125000
NODE_61676_length_434_cov_1.220896	118	198	120	1	80	0.0125000
NODE_61676_length_434_cov_1.220896	118	198	125	4	80	0.0500000
NODE_61676_length_434_cov_1.220896	118	198	129	3	80	0.0375000
NODE_61676_length_434_cov_1.220896	118	198	131	1	80	0.0125000
NODE_61676_length_434_cov_1.220896	118	198	139	4	80	0.0500000
NODE_61676_length_434_cov_1.220896	118	198	140	3	80	0.0375000
NODE_61676_length_434_cov_1.220896	118	198	141	2	80	0.0250000
NODE_61676_length_434_cov_1.220896	118	198	142	3	80	0.0375000
NODE_61676_length_434_cov_1.220896	118	198	143	1	80	0.0125000
NODE_61676_length_434_cov_1.220896	118	198	144	6	80	0.0750000
NODE_61676_length_434_cov_1.220896	118	198	145	6	80	0.0750000
NODE_61676_length_434_cov_1.220896	118	198	149	3	80	0.0375000
NODE_61676_length_434_cov_1.220896	118	198	150	1	80	0.0125000
NODE_61676_length_434_cov_1.220896	118	198	151	4	80	0.0500000
NODE_61676_length_434_cov_1.220896	118	198	152	6	80	0.0750000
NODE_61676_length_434_cov_1.220896	118	198	153	2	80	0.0250000
NODE_61676_length_434_cov_1.220896	118	198	161	5	80	0.0625000
NODE_61676_length_434_cov_1.220896	118	198	162	2	80	0.0250000
NODE_61676_length_434_cov_1.220896	118	198	163	5	80	0.0625000
NODE_61676_length_434_cov_1.220896	118	198	164	1	80	0.0125000
NODE_61676_length_434_cov_1.220896	118	198	166	3	80	0.0375000
NODE_61676_length_434_cov_1.220896	118	198	168	1	80	0.0125000
NODE_61727_length_434_cov_1.002985	245	286	4	23	41	0.5609756
NODE_61727_length_434_cov_1.002985	245	286	6	18	41	0.4390244
NODE_61727_length_434_cov_1.002985	258	339	0	12	81	0.1481481
NODE_61727_length_434_cov_1.002985	258	339	2	2	81	0.0246914
NODE_61727_length_434_cov_1.002985	258	339	4	21	81	0.2592593
NODE_61727_length_434_cov_1.002985	258	339	6	46	81	0.5679013
NODE_61826_length_433_cov_51.392216	2	82	0	80	80	1.0000000
NODE_61826_length_433_cov_51.392216	55	135	0	28	80	0.3500000
NODE_61826_length_433_cov_51.392216	55	135	1	11	80	0.1375000
NODE_61826_length_433_cov_51.392216	55	135	2	41	80	0.5125000
NODE_61826_length_433_cov_51.392216	131	213	2	82	82	1.0000000
NODE_61826_length_433_cov_51.392216	189	266	0	22	77	0.2857143
NODE_61826_length_433_cov_51.392216	189	266	1	11	77	0.1428571
NODE_61826_length_433_cov_51.392216	189	266	2	44	77	0.5714286
NODE_61827_length_433_cov_46.344311	248	328	0	80	80	1.0000000
NODE_61827_length_433_cov_46.344311	301	381	0	80	80	1.0000000
NODE_61828_length_433_cov_41.808383	92	172	0	80	80	1.0000000
NODE_61828_length_433_cov_41.808383	145	225	0	80	80	1.0000000
NODE_61835_length_433_cov_6.227545	157	237	0	80	80	1.0000000
NODE_61836_length_433_cov_6.080838	164	244	0	80	80	1.0000000
NODE_61838_length_433_cov_5.547904	10	80	4	14	70	0.2000000
NODE_61838_length_433_cov_5.547904	10	80	6	19	70	0.2714286
NODE_61838_length_433_cov_5.547904	10	80	8	37	70	0.5285714
NODE_61838_length_433_cov_5.547904	51	133	4	6	82	0.0731707
NODE_61838_length_433_cov_5.547904	51	133	6	2	82	0.0243902
NODE_61838_length_433_cov_5.547904	51	133	8	66	82	0.8048781
NODE_61838_length_433_cov_5.547904	51	133	10	1	82	0.0121951
NODE_61838_length_433_cov_5.547904	51	133	12	7	82	0.0853659
NODE_61839_length_433_cov_5.476048	81	141	8	60	60	1.0000000
NODE_61855_length_433_cov_3.907186	77	107	0	30	30	1.0000000
NODE_61862_length_433_cov_3.595808	231	316	0	30	85	0.3529412
NODE_61862_length_433_cov_3.595808	231	316	2	55	85	0.6470588
NODE_61864_length_433_cov_3.526946	107	178	0	5	71	0.0704225
NODE_61864_length_433_cov_3.526946	107	178	4	66	71	0.9295775
NODE_61931_length_433_cov_2.137725	123	203	0	23	80	0.2875000
NODE_61931_length_433_cov_2.137725	123	203	5	25	80	0.3125000
NODE_61931_length_433_cov_2.137725	123	203	6	32	80	0.4000000
NODE_62258_length_432_cov_17.540541	150	230	0	80	80	1.0000000
NODE_62258_length_432_cov_17.540541	203	288	0	85	85	1.0000000
NODE_62264_length_432_cov_6.555556	52	82	0	30	30	1.0000000
NODE_62268_length_432_cov_5.720721	77	157	0	80	80	1.0000000
NODE_62268_length_432_cov_5.720721	130	202	0	72	72	1.0000000
NODE_62269_length_432_cov_5.387387	65	95	0	30	30	1.0000000
NODE_62270_length_432_cov_5.345345	271	324	0	9	53	0.1698113
NODE_62270_length_432_cov_5.345345	271	324	2	40	53	0.7547170
NODE_62270_length_432_cov_5.345345	271	324	4	4	53	0.0754717
NODE_62293_length_432_cov_3.678679	78	121	0	43	43	1.0000000
NODE_62304_length_432_cov_3.246246	87	128	14	8	41	0.1951219
NODE_62304_length_432_cov_3.246246	87	128	16	7	41	0.1707317
NODE_62304_length_432_cov_3.246246	87	128	18	14	41	0.3414634
NODE_62304_length_432_cov_3.246246	87	128	20	9	41	0.2195122
NODE_62304_length_432_cov_3.246246	87	128	23	1	41	0.0243902
NODE_62304_length_432_cov_3.246246	87	128	25	2	41	0.0487805
NODE_62304_length_432_cov_3.246246	101	167	16	1	66	0.0151515
NODE_62304_length_432_cov_3.246246	101	167	18	14	66	0.2121212
NODE_62304_length_432_cov_3.246246	101	167	20	9	66	0.1363636
NODE_62304_length_432_cov_3.246246	101	167	23	1	66	0.0151515
NODE_62304_length_432_cov_3.246246	101	167	25	8	66	0.1212121
NODE_62304_length_432_cov_3.246246	101	167	27	1	66	0.0151515
NODE_62304_length_432_cov_3.246246	101	167	28	1	66	0.0151515
NODE_62304_length_432_cov_3.246246	101	167	36	11	66	0.1666667
NODE_62304_length_432_cov_3.246246	101	167	38	11	66	0.1666667
NODE_62304_length_432_cov_3.246246	101	167	39	2	66	0.0303030
NODE_62304_length_432_cov_3.246246	101	167	40	5	66	0.0757576
NODE_62304_length_432_cov_3.246246	101	167	42	2	66	0.0303030
NODE_62396_length_432_cov_1.762763	4	71	0	67	67	1.0000000
NODE_62544_length_432_cov_1.027027	44	68	0	24	24	1.0000000
NODE_62650_length_431_cov_35.355422	202	284	0	82	82	1.0000000
NODE_62650_length_431_cov_35.355422	257	333	0	76	76	1.0000000
NODE_62652_length_431_cov_11.207831	185	265	0	80	80	1.0000000
NODE_62652_length_431_cov_11.207831	238	318	0	80	80	1.0000000
NODE_62657_length_431_cov_7.018072	110	190	0	80	80	1.0000000
NODE_62657_length_431_cov_7.018072	163	243	0	80	80	1.0000000
NODE_62661_length_431_cov_6.292169	123	203	0	80	80	1.0000000
NODE_62668_length_431_cov_5.608434	170	241	0	71	71	1.0000000
NODE_62681_length_431_cov_4.250000	146	216	0	58	70	0.8285714
NODE_62681_length_431_cov_4.250000	146	216	2	12	70	0.1714286
NODE_62684_length_431_cov_3.993976	210	290	2	2	80	0.0250000
NODE_62684_length_431_cov_3.993976	210	290	4	55	80	0.6875000
NODE_62684_length_431_cov_3.993976	210	290	6	23	80	0.2875000
NODE_62794_length_431_cov_1.695783	76	156	8	5	80	0.0625000
NODE_62794_length_431_cov_1.695783	76	156	12	3	80	0.0375000
NODE_62794_length_431_cov_1.695783	76	156	14	72	80	0.9000000
NODE_62794_length_431_cov_1.695783	129	199	2	10	70	0.1428571
NODE_62794_length_431_cov_1.695783	129	199	4	2	70	0.0285714
NODE_62794_length_431_cov_1.695783	129	199	6	25	70	0.3571429
NODE_62794_length_431_cov_1.695783	129	199	8	2	70	0.0285714
NODE_62794_length_431_cov_1.695783	129	199	12	4	70	0.0571429
NODE_62794_length_431_cov_1.695783	129	199	14	27	70	0.3857143
NODE_63043_length_430_cov_49.791541	319	399	84	1	80	0.0125000
NODE_63043_length_430_cov_49.791541	319	399	85	1	80	0.0125000
NODE_63043_length_430_cov_49.791541	319	399	89	2	80	0.0250000
NODE_63043_length_430_cov_49.791541	319	399	91	1	80	0.0125000
NODE_63043_length_430_cov_49.791541	319	399	92	2	80	0.0250000
NODE_63043_length_430_cov_49.791541	319	399	93	1	80	0.0125000
NODE_63043_length_430_cov_49.791541	319	399	96	1	80	0.0125000
NODE_63043_length_430_cov_49.791541	319	399	105	3	80	0.0375000
NODE_63043_length_430_cov_49.791541	319	399	107	1	80	0.0125000
NODE_63043_length_430_cov_49.791541	319	399	111	1	80	0.0125000
NODE_63043_length_430_cov_49.791541	319	399	112	1	80	0.0125000
NODE_63043_length_430_cov_49.791541	319	399	113	1	80	0.0125000
NODE_63043_length_430_cov_49.791541	319	399	115	2	80	0.0250000
NODE_63043_length_430_cov_49.791541	319	399	117	1	80	0.0125000
NODE_63043_length_430_cov_49.791541	319	399	118	3	80	0.0375000
NODE_63043_length_430_cov_49.791541	319	399	121	1	80	0.0125000
NODE_63043_length_430_cov_49.791541	319	399	125	1	80	0.0125000
NODE_63043_length_430_cov_49.791541	319	399	128	2	80	0.0250000
NODE_63043_length_430_cov_49.791541	319	399	132	1	80	0.0125000
NODE_63043_length_430_cov_49.791541	319	399	136	1	80	0.0125000
NODE_63043_length_430_cov_49.791541	319	399	138	1	80	0.0125000
NODE_63043_length_430_cov_49.791541	319	399	140	1	80	0.0125000
NODE_63043_length_430_cov_49.791541	319	399	146	4	80	0.0500000
NODE_63043_length_430_cov_49.791541	319	399	148	1	80	0.0125000
NODE_63043_length_430_cov_49.791541	319	399	150	1	80	0.0125000
NODE_63043_length_430_cov_49.791541	319	399	158	2	80	0.0250000
NODE_63043_length_430_cov_49.791541	319	399	162	2	80	0.0250000
NODE_63043_length_430_cov_49.791541	319	399	164	1	80	0.0125000
NODE_63043_length_430_cov_49.791541	319	399	166	1	80	0.0125000
NODE_63043_length_430_cov_49.791541	319	399	170	4	80	0.0500000
NODE_63043_length_430_cov_49.791541	319	399	171	1	80	0.0125000
NODE_63043_length_430_cov_49.791541	319	399	179	1	80	0.0125000
NODE_63043_length_430_cov_49.791541	319	399	181	3	80	0.0375000
NODE_63043_length_430_cov_49.791541	319	399	184	2	80	0.0250000
NODE_63043_length_430_cov_49.791541	319	399	188	2	80	0.0250000
NODE_63043_length_430_cov_49.791541	319	399	190	1	80	0.0125000
NODE_63043_length_430_cov_49.791541	319	399	194	2	80	0.0250000
NODE_63043_length_430_cov_49.791541	319	399	196	1	80	0.0125000
NODE_63043_length_430_cov_49.791541	319	399	201	2	80	0.0250000
NODE_63043_length_430_cov_49.791541	319	399	202	1	80	0.0125000
NODE_63043_length_430_cov_49.791541	319	399	210	1	80	0.0125000
NODE_63043_length_430_cov_49.791541	319	399	211	1	80	0.0125000
NODE_63043_length_430_cov_49.791541	319	399	212	1	80	0.0125000
NODE_63043_length_430_cov_49.791541	319	399	213	3	80	0.0375000
NODE_63043_length_430_cov_49.791541	319	399	215	4	80	0.0500000
NODE_63043_length_430_cov_49.791541	319	399	217	3	80	0.0375000
NODE_63043_length_430_cov_49.791541	319	399	219	1	80	0.0125000
NODE_63043_length_430_cov_49.791541	319	399	221	4	80	0.0500000
NODE_63043_length_430_cov_49.791541	372	430	11	1	58	0.0172414
NODE_63043_length_430_cov_49.791541	372	430	16	2	58	0.0344828
NODE_63043_length_430_cov_49.791541	372	430	21	3	58	0.0517241
NODE_63043_length_430_cov_49.791541	372	430	29	2	58	0.0344828
NODE_63043_length_430_cov_49.791541	372	430	34	2	58	0.0344828
NODE_63043_length_430_cov_49.791541	372	430	35	1	58	0.0172414
NODE_63043_length_430_cov_49.791541	372	430	40	1	58	0.0172414
NODE_63043_length_430_cov_49.791541	372	430	42	1	58	0.0172414
NODE_63043_length_430_cov_49.791541	372	430	44	1	58	0.0172414
NODE_63043_length_430_cov_49.791541	372	430	46	2	58	0.0344828
NODE_63043_length_430_cov_49.791541	372	430	48	1	58	0.0172414
NODE_63043_length_430_cov_49.791541	372	430	50	4	58	0.0689655
NODE_63043_length_430_cov_49.791541	372	430	54	1	58	0.0172414
NODE_63043_length_430_cov_49.791541	372	430	56	1	58	0.0172414
NODE_63043_length_430_cov_49.791541	372	430	64	3	58	0.0517241
NODE_63043_length_430_cov_49.791541	372	430	66	1	58	0.0172414
NODE_63043_length_430_cov_49.791541	372	430	69	1	58	0.0172414
NODE_63043_length_430_cov_49.791541	372	430	71	1	58	0.0172414
NODE_63043_length_430_cov_49.791541	372	430	76	1	58	0.0172414
NODE_63043_length_430_cov_49.791541	372	430	82	1	58	0.0172414
NODE_63043_length_430_cov_49.791541	372	430	84	1	58	0.0172414
NODE_63043_length_430_cov_49.791541	372	430	85	1	58	0.0172414
NODE_63043_length_430_cov_49.791541	372	430	89	2	58	0.0344828
NODE_63043_length_430_cov_49.791541	372	430	91	1	58	0.0172414
NODE_63043_length_430_cov_49.791541	372	430	92	2	58	0.0344828
NODE_63043_length_430_cov_49.791541	372	430	93	1	58	0.0172414
NODE_63043_length_430_cov_49.791541	372	430	96	1	58	0.0172414
NODE_63043_length_430_cov_49.791541	372	430	105	3	58	0.0517241
NODE_63043_length_430_cov_49.791541	372	430	107	1	58	0.0172414
NODE_63043_length_430_cov_49.791541	372	430	111	1	58	0.0172414
NODE_63043_length_430_cov_49.791541	372	430	112	1	58	0.0172414
NODE_63043_length_430_cov_49.791541	372	430	113	1	58	0.0172414
NODE_63043_length_430_cov_49.791541	372	430	115	2	58	0.0344828
NODE_63043_length_430_cov_49.791541	372	430	117	1	58	0.0172414
NODE_63043_length_430_cov_49.791541	372	430	118	3	58	0.0517241
NODE_63043_length_430_cov_49.791541	372	430	121	1	58	0.0172414
NODE_63043_length_430_cov_49.791541	372	430	125	1	58	0.0172414
NODE_63043_length_430_cov_49.791541	372	430	128	2	58	0.0344828
NODE_63043_length_430_cov_49.791541	372	430	132	1	58	0.0172414
NODE_63044_length_430_cov_44.365559	109	189	0	80	80	1.0000000
NODE_63044_length_430_cov_44.365559	162	242	0	80	80	1.0000000
NODE_63045_length_430_cov_16.746224	92	172	0	65	80	0.8125000
NODE_63045_length_430_cov_16.746224	92	172	2	15	80	0.1875000
NODE_63045_length_430_cov_16.746224	145	225	0	30	80	0.3750000
NODE_63045_length_430_cov_16.746224	145	225	2	50	80	0.6250000
NODE_63048_length_430_cov_7.737160	180	263	4	22	83	0.2650602
NODE_63048_length_430_cov_7.737160	180	263	7	1	83	0.0120482
NODE_63048_length_430_cov_7.737160	180	263	8	60	83	0.7228916
NODE_63050_length_430_cov_6.163142	135	197	0	4	62	0.0645161
NODE_63050_length_430_cov_6.163142	135	197	2	41	62	0.6612903
NODE_63050_length_430_cov_6.163142	135	197	4	17	62	0.2741936
NODE_63051_length_430_cov_5.873112	7	90	0	37	83	0.4457831
NODE_63051_length_430_cov_5.873112	7	90	2	46	83	0.5542169
NODE_63051_length_430_cov_5.873112	60	126	2	36	66	0.5454546
NODE_63051_length_430_cov_5.873112	60	126	4	30	66	0.4545455
NODE_63066_length_430_cov_4.323263	18	90	6	4	72	0.0555556
NODE_63066_length_430_cov_4.323263	18	90	7	8	72	0.1111111
NODE_63066_length_430_cov_4.323263	18	90	8	13	72	0.1805556
NODE_63066_length_430_cov_4.323263	18	90	10	47	72	0.6527778
NODE_63161_length_430_cov_1.945619	153	233	0	28	80	0.3500000
NODE_63161_length_430_cov_1.945619	153	233	2	52	80	0.6500000
NODE_63401_length_430_cov_0.664653	391	430	0	39	39	1.0000000
NODE_63437_length_429_cov_10.424242	78	158	0	17	80	0.2125000
NODE_63437_length_429_cov_10.424242	78	158	2	63	80	0.7875000
NODE_63437_length_429_cov_10.424242	207	287	0	49	80	0.6125000
NODE_63437_length_429_cov_10.424242	207	287	4	31	80	0.3875000
NODE_63437_length_429_cov_10.424242	260	340	4	80	80	1.0000000
NODE_63439_length_429_cov_8.957576	213	293	0	80	80	1.0000000
NODE_63439_length_429_cov_8.957576	266	346	0	80	80	1.0000000
NODE_63441_length_429_cov_6.772727	337	366	0	29	29	1.0000000
NODE_63485_length_429_cov_3.003030	173	251	6	20	78	0.2564103
NODE_63485_length_429_cov_3.003030	173	251	8	58	78	0.7435898
NODE_63516_length_429_cov_2.433333	220	300	0	65	80	0.8125000
NODE_63516_length_429_cov_2.433333	220	300	2	15	80	0.1875000
NODE_63519_length_429_cov_2.360606	24	85	0	61	61	1.0000000
NODE_63527_length_429_cov_2.224242	115	195	0	80	80	1.0000000
NODE_63547_length_429_cov_2.051515	114	143	0	29	29	1.0000000
NODE_63547_length_429_cov_2.051515	286	348	0	62	62	1.0000000
NODE_63864_length_428_cov_40.449848	217	297	0	80	80	1.0000000
NODE_63864_length_428_cov_40.449848	270	350	0	80	80	1.0000000
NODE_63864_length_428_cov_40.449848	346	426	0	80	80	1.0000000
NODE_63865_length_428_cov_31.066869	249	325	4	66	76	0.8684211
NODE_63865_length_428_cov_31.066869	249	325	6	10	76	0.1315790
NODE_63865_length_428_cov_31.066869	297	378	4	81	81	1.0000000
NODE_63866_length_428_cov_11.799392	62	142	0	80	80	1.0000000
NODE_63866_length_428_cov_11.799392	115	195	0	80	80	1.0000000
NODE_63867_length_428_cov_10.595745	227	307	0	80	80	1.0000000
NODE_63870_length_428_cov_6.784195	344	374	2	30	30	1.0000000
NODE_63871_length_428_cov_6.768997	131	194	6	5	63	0.0793651
NODE_63871_length_428_cov_6.768997	131	194	8	58	63	0.9206349
NODE_63895_length_428_cov_4.206687	224	304	0	19	80	0.2375000
NODE_63895_length_428_cov_4.206687	224	304	2	14	80	0.1750000
NODE_63895_length_428_cov_4.206687	224	304	4	13	80	0.1625000
NODE_63895_length_428_cov_4.206687	224	304	6	9	80	0.1125000
NODE_63895_length_428_cov_4.206687	224	304	8	25	80	0.3125000
NODE_63905_length_428_cov_3.525836	168	236	0	68	68	1.0000000
NODE_63905_length_428_cov_3.525836	209	244	0	35	35	1.0000000
NODE_63959_length_428_cov_2.322188	1	42	0	41	41	1.0000000
NODE_63977_length_428_cov_2.124620	228	308	0	80	80	1.0000000
NODE_64011_length_428_cov_1.848024	178	260	2	82	82	1.0000000
NODE_64027_length_428_cov_1.772036	187	255	0	68	68	1.0000000
NODE_64245_length_428_cov_0.790274	275	308	0	33	33	1.0000000
NODE_64245_length_428_cov_0.790274	276	302	0	26	26	1.0000000
NODE_64310_length_427_cov_29.628049	312	392	0	79	80	0.9875000
NODE_64310_length_427_cov_29.628049	312	392	2	1	80	0.0125000
NODE_64310_length_427_cov_29.628049	365	427	0	62	62	1.0000000
NODE_64310_length_427_cov_29.628049	365	427	0	62	62	1.0000000
NODE_64312_length_427_cov_9.371951	184	239	3	3	55	0.0545455
NODE_64312_length_427_cov_9.371951	184	239	5	3	55	0.0545455
NODE_64312_length_427_cov_9.371951	184	239	14	4	55	0.0727273
NODE_64312_length_427_cov_9.371951	184	239	16	2	55	0.0363636
NODE_64312_length_427_cov_9.371951	184	239	22	5	55	0.0909091
NODE_64312_length_427_cov_9.371951	184	239	24	24	55	0.4363636
NODE_64312_length_427_cov_9.371951	184	239	26	14	55	0.2545455
NODE_64313_length_427_cov_9.359756	11	82	0	71	71	1.0000000
NODE_64313_length_427_cov_9.359756	70	149	0	79	79	1.0000000
NODE_64313_length_427_cov_9.359756	145	225	0	80	80	1.0000000
NODE_64313_length_427_cov_9.359756	198	278	0	80	80	1.0000000
NODE_64321_length_427_cov_5.929878	405	424	0	19	19	1.0000000
NODE_64324_length_427_cov_5.088415	257	332	0	47	75	0.6266667
NODE_64324_length_427_cov_5.088415	257	332	6	6	75	0.0800000
NODE_64324_length_427_cov_5.088415	257	332	8	22	75	0.2933333
NODE_64345_length_427_cov_3.884146	212	260	0	48	48	1.0000000
NODE_64383_length_427_cov_2.765244	312	363	2	51	51	1.0000000
NODE_64409_length_427_cov_2.362805	142	177	0	5	35	0.1428571
NODE_64409_length_427_cov_2.362805	142	177	2	30	35	0.8571429
NODE_64537_length_427_cov_1.359756	56	139	2	83	83	1.0000000
NODE_64728_length_426_cov_21.837920	178	258	0	80	80	1.0000000
NODE_64729_length_426_cov_16.850153	76	156	0	19	80	0.2375000
NODE_64729_length_426_cov_16.850153	76	156	4	28	80	0.3500000
NODE_64729_length_426_cov_16.850153	76	156	8	20	80	0.2500000
NODE_64729_length_426_cov_16.850153	76	156	10	13	80	0.1625000
NODE_64729_length_426_cov_16.850153	129	209	6	15	80	0.1875000
NODE_64729_length_426_cov_16.850153	129	209	8	14	80	0.1750000
NODE_64729_length_426_cov_16.850153	129	209	10	51	80	0.6375000
NODE_64731_length_426_cov_9.033639	152	232	0	80	80	1.0000000
NODE_64731_length_426_cov_9.033639	205	285	0	80	80	1.0000000
NODE_64734_length_426_cov_8.314985	133	213	0	80	80	1.0000000
NODE_64734_length_426_cov_8.314985	186	266	0	80	80	1.0000000
NODE_64735_length_426_cov_8.278287	132	212	0	80	80	1.0000000
NODE_64735_length_426_cov_8.278287	185	265	0	80	80	1.0000000
NODE_64752_length_426_cov_4.926606	116	196	0	80	80	1.0000000
NODE_64754_length_426_cov_4.743119	119	199	0	2	80	0.0250000
NODE_64754_length_426_cov_4.743119	119	199	2	19	80	0.2375000
NODE_64754_length_426_cov_4.743119	119	199	6	30	80	0.3750000
NODE_64754_length_426_cov_4.743119	119	199	8	29	80	0.3625000
NODE_64754_length_426_cov_4.743119	172	252	4	24	80	0.3000000
NODE_64754_length_426_cov_4.743119	172	252	8	56	80	0.7000000
NODE_64833_length_426_cov_2.278287	92	132	0	40	40	1.0000000
NODE_64833_length_426_cov_2.278287	139	205	0	66	66	1.0000000
NODE_64865_length_426_cov_1.896024	80	154	0	74	74	1.0000000
NODE_64948_length_426_cov_1.397554	240	290	0	50	50	1.0000000
NODE_65135_length_426_cov_0.602446	127	158	0	31	31	1.0000000
NODE_65152_length_425_cov_63.938650	0	61	0	61	61	1.0000000
NODE_65152_length_425_cov_63.938650	34	114	0	80	80	1.0000000
NODE_65164_length_425_cov_4.877301	171	229	63	7	58	0.1206897
NODE_65164_length_425_cov_4.877301	171	229	65	5	58	0.0862069
NODE_65164_length_425_cov_4.877301	171	229	67	16	58	0.2758621
NODE_65164_length_425_cov_4.877301	171	229	68	10	58	0.1724138
NODE_65164_length_425_cov_4.877301	171	229	69	5	58	0.0862069
NODE_65164_length_425_cov_4.877301	171	229	70	3	58	0.0517241
NODE_65164_length_425_cov_4.877301	171	229	72	12	58	0.2068966
NODE_65165_length_425_cov_4.822086	295	377	0	55	82	0.6707317
NODE_65165_length_425_cov_4.822086	295	377	2	27	82	0.3292683
NODE_65218_length_425_cov_2.809816	38	118	2	26	80	0.3250000
NODE_65218_length_425_cov_2.809816	38	118	4	54	80	0.6750000
NODE_65278_length_425_cov_1.935583	93	138	0	45	45	1.0000000
NODE_65278_length_425_cov_1.935583	170	225	0	41	55	0.7454545
NODE_65278_length_425_cov_1.935583	170	225	2	14	55	0.2545455
NODE_65278_length_425_cov_1.935583	312	355	8	4	43	0.0930233
NODE_65278_length_425_cov_1.935583	312	355	12	39	43	0.9069768
NODE_65565_length_425_cov_0.628834	104	131	0	27	27	1.0000000
NODE_65602_length_424_cov_5.295385	224	270	4	46	46	1.0000000
NODE_65634_length_424_cov_3.255385	266	329	0	63	63	1.0000000
NODE_65669_length_424_cov_2.578462	403	422	0	3	19	0.1578947
NODE_65669_length_424_cov_2.578462	403	422	2	16	19	0.8421053
NODE_65670_length_424_cov_2.578462	122	144	0	22	22	1.0000000
NODE_66111_length_423_cov_2.728395	150	229	0	24	79	0.3037975
NODE_66111_length_423_cov_2.728395	150	229	2	11	79	0.1392405
NODE_66111_length_423_cov_2.728395	150	229	4	38	79	0.4810127
NODE_66111_length_423_cov_2.728395	150	229	6	6	79	0.0759494
NODE_66181_length_423_cov_1.879630	94	142	0	48	48	1.0000000
NODE_66222_length_423_cov_1.580247	128	208	0	80	80	1.0000000
NODE_66258_length_423_cov_1.410494	206	286	0	80	80	1.0000000
NODE_66459_length_422_cov_12.021672	201	236	0	35	35	1.0000000
NODE_66459_length_422_cov_12.021672	247	289	0	42	42	1.0000000
NODE_66460_length_422_cov_10.712074	62	140	0	78	78	1.0000000
NODE_66460_length_422_cov_10.712074	115	195	0	80	80	1.0000000
NODE_66468_length_422_cov_6.281734	37	117	0	80	80	1.0000000
NODE_66468_length_422_cov_6.281734	90	170	0	80	80	1.0000000
NODE_66474_length_422_cov_5.266254	176	256	0	11	80	0.1375000
NODE_66474_length_422_cov_5.266254	176	256	1	5	80	0.0625000
NODE_66474_length_422_cov_5.266254	176	256	2	64	80	0.8000000
NODE_66485_length_422_cov_4.148607	159	224	0	65	65	1.0000000
NODE_66485_length_422_cov_4.148607	197	277	0	80	80	1.0000000
NODE_66488_length_422_cov_4.003096	146	226	0	80	80	1.0000000
NODE_66488_length_422_cov_4.003096	199	279	0	41	80	0.5125000
NODE_66488_length_422_cov_4.003096	199	279	1	5	80	0.0625000
NODE_66488_length_422_cov_4.003096	199	279	2	23	80	0.2875000
NODE_66488_length_422_cov_4.003096	199	279	4	11	80	0.1375000
NODE_66512_length_422_cov_3.130031	93	173	0	80	80	1.0000000
NODE_66512_length_422_cov_3.130031	146	226	0	44	80	0.5500000
NODE_66512_length_422_cov_3.130031	146	226	2	36	80	0.4500000
NODE_66515_length_422_cov_3.077399	291	359	6	5	68	0.0735294
NODE_66515_length_422_cov_3.077399	291	359	8	1	68	0.0147059
NODE_66515_length_422_cov_3.077399	291	359	10	9	68	0.1323529
NODE_66515_length_422_cov_3.077399	291	359	12	10	68	0.1470588
NODE_66515_length_422_cov_3.077399	291	359	16	24	68	0.3529412
NODE_66515_length_422_cov_3.077399	291	359	18	3	68	0.0441176
NODE_66515_length_422_cov_3.077399	291	359	20	2	68	0.0294118
NODE_66515_length_422_cov_3.077399	291	359	22	3	68	0.0441176
NODE_66515_length_422_cov_3.077399	291	359	24	6	68	0.0882353
NODE_66515_length_422_cov_3.077399	291	359	26	5	68	0.0735294
NODE_66550_length_422_cov_2.191950	5	24	0	19	19	1.0000000
NODE_66560_length_422_cov_2.108359	97	177	0	9	80	0.1125000
NODE_66560_length_422_cov_2.108359	97	177	2	15	80	0.1875000
NODE_66560_length_422_cov_2.108359	97	177	3	3	80	0.0375000
NODE_66560_length_422_cov_2.108359	97	177	4	17	80	0.2125000
NODE_66560_length_422_cov_2.108359	97	177	6	6	80	0.0750000
NODE_66560_length_422_cov_2.108359	97	177	8	20	80	0.2500000
NODE_66560_length_422_cov_2.108359	97	177	10	3	80	0.0375000
NODE_66560_length_422_cov_2.108359	97	177	12	7	80	0.0875000
NODE_66560_length_422_cov_2.108359	150	189	2	5	39	0.1282051
NODE_66560_length_422_cov_2.108359	150	189	3	3	39	0.0769231
NODE_66560_length_422_cov_2.108359	150	189	4	17	39	0.4358974
NODE_66560_length_422_cov_2.108359	150	189	6	6	39	0.1538462
NODE_66560_length_422_cov_2.108359	150	189	8	2	39	0.0512821
NODE_66560_length_422_cov_2.108359	150	189	10	6	39	0.1538462
NODE_66560_length_422_cov_2.108359	249	289	65	1	40	0.0250000
NODE_66560_length_422_cov_2.108359	249	289	67	1	40	0.0250000
NODE_66560_length_422_cov_2.108359	249	289	69	1	40	0.0250000
NODE_66560_length_422_cov_2.108359	249	289	74	1	40	0.0250000
NODE_66560_length_422_cov_2.108359	249	289	75	1	40	0.0250000
NODE_66560_length_422_cov_2.108359	249	289	77	2	40	0.0500000
NODE_66560_length_422_cov_2.108359	249	289	79	6	40	0.1500000
NODE_66560_length_422_cov_2.108359	249	289	81	2	40	0.0500000
NODE_66560_length_422_cov_2.108359	249	289	83	1	40	0.0250000
NODE_66560_length_422_cov_2.108359	249	289	88	1	40	0.0250000
NODE_66560_length_422_cov_2.108359	249	289	90	1	40	0.0250000
NODE_66560_length_422_cov_2.108359	249	289	92	1	40	0.0250000
NODE_66560_length_422_cov_2.108359	249	289	98	1	40	0.0250000
NODE_66560_length_422_cov_2.108359	249	289	104	2	40	0.0500000
NODE_66560_length_422_cov_2.108359	249	289	106	3	40	0.0750000
NODE_66560_length_422_cov_2.108359	249	289	112	8	40	0.2000000
NODE_66560_length_422_cov_2.108359	249	289	114	5	40	0.1250000
NODE_66560_length_422_cov_2.108359	249	289	116	2	40	0.0500000
NODE_66806_length_422_cov_0.845201	2	76	0	74	74	1.0000000
NODE_66869_length_421_cov_10.664596	178	256	0	78	78	1.0000000
NODE_66869_length_421_cov_10.664596	229	309	0	80	80	1.0000000
NODE_66874_length_421_cov_7.552795	325	407	0	80	82	0.9756098
NODE_66874_length_421_cov_7.552795	325	407	13	2	82	0.0243902
NODE_66874_length_421_cov_7.552795	380	421	0	41	41	1.0000000
NODE_66875_length_421_cov_7.431677	96	118	0	5	22	0.2272727
NODE_66875_length_421_cov_7.431677	96	118	2	17	22	0.7727273
NODE_66883_length_421_cov_5.279503	245	310	0	65	65	1.0000000
NODE_66884_length_421_cov_5.158385	68	145	0	77	77	1.0000000
NODE_66897_length_421_cov_4.114907	221	287	0	66	66	1.0000000
NODE_66898_length_421_cov_4.102484	202	277	0	75	75	1.0000000
NODE_66899_length_421_cov_4.040373	192	272	0	26	80	0.3250000
NODE_66899_length_421_cov_4.040373	192	272	2	54	80	0.6750000
NODE_66899_length_421_cov_4.040373	245	314	0	68	69	0.9855072
NODE_66899_length_421_cov_4.040373	245	314	2	1	69	0.0144928
NODE_66923_length_421_cov_3.319876	0	57	0	57	57	1.0000000
NODE_66955_length_421_cov_2.708075	95	118	0	23	23	1.0000000
NODE_66955_length_421_cov_2.708075	109	189	0	80	80	1.0000000
NODE_66955_length_421_cov_2.708075	248	300	0	52	52	1.0000000
NODE_67073_length_421_cov_1.559006	240	309	0	69	69	1.0000000
NODE_67073_length_421_cov_1.559006	240	310	0	70	70	1.0000000
NODE_67077_length_421_cov_1.537267	305	383	0	78	78	1.0000000
NODE_67098_length_421_cov_1.413043	254	303	2	49	49	1.0000000
NODE_67283_length_421_cov_0.633540	132	156	2	24	24	1.0000000
NODE_67317_length_420_cov_80.766355	90	170	0	80	80	1.0000000
NODE_67317_length_420_cov_80.766355	143	223	0	80	80	1.0000000
NODE_67319_length_420_cov_51.473520	171	250	0	79	79	1.0000000
NODE_67319_length_420_cov_51.473520	223	307	0	84	84	1.0000000
NODE_67319_length_420_cov_51.473520	303	383	0	80	80	1.0000000
NODE_67319_length_420_cov_51.473520	356	420	0	64	64	1.0000000
NODE_67330_length_420_cov_5.071651	230	310	0	68	80	0.8500000
NODE_67330_length_420_cov_5.071651	230	310	2	12	80	0.1500000
NODE_67334_length_420_cov_4.775701	177	221	0	44	44	1.0000000
NODE_67345_length_420_cov_4.037383	161	240	0	79	79	1.0000000
NODE_67358_length_420_cov_3.657321	291	373	0	76	82	0.9268293
NODE_67358_length_420_cov_3.657321	291	373	6	6	82	0.0731707
NODE_67398_length_420_cov_2.542056	96	176	0	80	80	1.0000000
NODE_67398_length_420_cov_2.542056	148	202	0	54	54	1.0000000
NODE_67398_length_420_cov_2.542056	149	195	0	46	46	1.0000000
NODE_67414_length_420_cov_2.323988	89	108	0	19	19	1.0000000
NODE_67506_length_420_cov_1.641745	277	312	0	35	35	1.0000000
NODE_67547_length_420_cov_1.429907	15	68	2	9	53	0.1698113
NODE_67547_length_420_cov_1.429907	15	68	4	15	53	0.2830189
NODE_67547_length_420_cov_1.429907	15	68	5	6	53	0.1132075
NODE_67547_length_420_cov_1.429907	15	68	7	6	53	0.1132075
NODE_67547_length_420_cov_1.429907	15	68	8	17	53	0.3207547
NODE_67547_length_420_cov_1.429907	69	111	8	18	42	0.4285714
NODE_67547_length_420_cov_1.429907	69	111	10	4	42	0.0952381
NODE_67547_length_420_cov_1.429907	69	111	14	18	42	0.4285714
NODE_67547_length_420_cov_1.429907	69	111	17	2	42	0.0476190
NODE_67770_length_419_cov_491.015625	0	67	0	5	67	0.0746269
NODE_67770_length_419_cov_491.015625	0	67	3	1	67	0.0149254
NODE_67770_length_419_cov_491.015625	0	67	4	8	67	0.1194030
NODE_67770_length_419_cov_491.015625	0	67	6	11	67	0.1641791
NODE_67770_length_419_cov_491.015625	0	67	7	14	67	0.2089552
NODE_67770_length_419_cov_491.015625	0	67	9	3	67	0.0447761
NODE_67770_length_419_cov_491.015625	0	67	15	6	67	0.0895522
NODE_67770_length_419_cov_491.015625	0	67	17	5	67	0.0746269
NODE_67770_length_419_cov_491.015625	0	67	18	1	67	0.0149254
NODE_67770_length_419_cov_491.015625	0	67	26	13	67	0.1940299
NODE_67770_length_419_cov_491.015625	0	67	0	5	67	0.0746269
NODE_67770_length_419_cov_491.015625	0	67	3	1	67	0.0149254
NODE_67770_length_419_cov_491.015625	0	67	4	8	67	0.1194030
NODE_67770_length_419_cov_491.015625	0	67	6	11	67	0.1641791
NODE_67770_length_419_cov_491.015625	0	67	7	14	67	0.2089552
NODE_67770_length_419_cov_491.015625	0	67	9	3	67	0.0447761
NODE_67770_length_419_cov_491.015625	0	67	15	6	67	0.0895522
NODE_67770_length_419_cov_491.015625	0	67	17	5	67	0.0746269
NODE_67770_length_419_cov_491.015625	0	67	18	1	67	0.0149254
NODE_67770_length_419_cov_491.015625	0	67	26	13	67	0.1940299
NODE_67770_length_419_cov_491.015625	0	67	0	5	67	0.0746269
NODE_67770_length_419_cov_491.015625	0	67	3	1	67	0.0149254
NODE_67770_length_419_cov_491.015625	0	67	4	8	67	0.1194030
NODE_67770_length_419_cov_491.015625	0	67	6	11	67	0.1641791
NODE_67770_length_419_cov_491.015625	0	67	7	14	67	0.2089552
NODE_67770_length_419_cov_491.015625	0	67	9	3	67	0.0447761
NODE_67770_length_419_cov_491.015625	0	67	15	6	67	0.0895522
NODE_67770_length_419_cov_491.015625	0	67	17	5	67	0.0746269
NODE_67770_length_419_cov_491.015625	0	67	18	1	67	0.0149254
NODE_67770_length_419_cov_491.015625	0	67	26	13	67	0.1940299
NODE_67770_length_419_cov_491.015625	0	67	0	5	67	0.0746269
NODE_67770_length_419_cov_491.015625	0	67	3	1	67	0.0149254
NODE_67770_length_419_cov_491.015625	0	67	4	8	67	0.1194030
NODE_67770_length_419_cov_491.015625	0	67	6	11	67	0.1641791
NODE_67770_length_419_cov_491.015625	0	67	7	14	67	0.2089552
NODE_67770_length_419_cov_491.015625	0	67	9	3	67	0.0447761
NODE_67770_length_419_cov_491.015625	0	67	15	6	67	0.0895522
NODE_67770_length_419_cov_491.015625	0	67	17	5	67	0.0746269
NODE_67770_length_419_cov_491.015625	0	67	18	1	67	0.0149254
NODE_67770_length_419_cov_491.015625	0	67	26	13	67	0.1940299
NODE_67770_length_419_cov_491.015625	63	143	26	16	80	0.2000000
NODE_67770_length_419_cov_491.015625	63	143	28	11	80	0.1375000
NODE_67770_length_419_cov_491.015625	63	143	34	4	80	0.0500000
NODE_67770_length_419_cov_491.015625	63	143	40	1	80	0.0125000
NODE_67770_length_419_cov_491.015625	63	143	44	2	80	0.0250000
NODE_67770_length_419_cov_491.015625	63	143	45	1	80	0.0125000
NODE_67770_length_419_cov_491.015625	63	143	50	1	80	0.0125000
NODE_67770_length_419_cov_491.015625	63	143	51	1	80	0.0125000
NODE_67770_length_419_cov_491.015625	63	143	52	15	80	0.1875000
NODE_67770_length_419_cov_491.015625	63	143	53	2	80	0.0250000
NODE_67770_length_419_cov_491.015625	63	143	54	6	80	0.0750000
NODE_67770_length_419_cov_491.015625	63	143	55	2	80	0.0250000
NODE_67770_length_419_cov_491.015625	63	143	57	4	80	0.0500000
NODE_67770_length_419_cov_491.015625	63	143	59	5	80	0.0625000
NODE_67770_length_419_cov_491.015625	63	143	61	5	80	0.0625000
NODE_67770_length_419_cov_491.015625	63	143	64	3	80	0.0375000
NODE_67770_length_419_cov_491.015625	63	143	66	1	80	0.0125000
NODE_67770_length_419_cov_491.015625	63	143	26	16	80	0.2000000
NODE_67770_length_419_cov_491.015625	63	143	28	11	80	0.1375000
NODE_67770_length_419_cov_491.015625	63	143	34	4	80	0.0500000
NODE_67770_length_419_cov_491.015625	63	143	40	1	80	0.0125000
NODE_67770_length_419_cov_491.015625	63	143	44	2	80	0.0250000
NODE_67770_length_419_cov_491.015625	63	143	45	1	80	0.0125000
NODE_67770_length_419_cov_491.015625	63	143	50	1	80	0.0125000
NODE_67770_length_419_cov_491.015625	63	143	51	1	80	0.0125000
NODE_67770_length_419_cov_491.015625	63	143	52	15	80	0.1875000
NODE_67770_length_419_cov_491.015625	63	143	53	2	80	0.0250000
NODE_67770_length_419_cov_491.015625	63	143	54	6	80	0.0750000
NODE_67770_length_419_cov_491.015625	63	143	55	2	80	0.0250000
NODE_67770_length_419_cov_491.015625	63	143	57	4	80	0.0500000
NODE_67770_length_419_cov_491.015625	63	143	59	5	80	0.0625000
NODE_67770_length_419_cov_491.015625	63	143	61	5	80	0.0625000
NODE_67770_length_419_cov_491.015625	63	143	64	3	80	0.0375000
NODE_67770_length_419_cov_491.015625	63	143	66	1	80	0.0125000
NODE_67770_length_419_cov_491.015625	63	143	26	16	80	0.2000000
NODE_67770_length_419_cov_491.015625	63	143	28	11	80	0.1375000
NODE_67770_length_419_cov_491.015625	63	143	34	4	80	0.0500000
NODE_67770_length_419_cov_491.015625	63	143	40	1	80	0.0125000
NODE_67770_length_419_cov_491.015625	63	143	44	2	80	0.0250000
NODE_67770_length_419_cov_491.015625	63	143	45	1	80	0.0125000
NODE_67770_length_419_cov_491.015625	63	143	50	1	80	0.0125000
NODE_67770_length_419_cov_491.015625	63	143	51	1	80	0.0125000
NODE_67770_length_419_cov_491.015625	63	143	52	15	80	0.1875000
NODE_67770_length_419_cov_491.015625	63	143	53	2	80	0.0250000
NODE_67770_length_419_cov_491.015625	63	143	54	6	80	0.0750000
NODE_67770_length_419_cov_491.015625	63	143	55	2	80	0.0250000
NODE_67770_length_419_cov_491.015625	63	143	57	4	80	0.0500000
NODE_67770_length_419_cov_491.015625	63	143	59	5	80	0.0625000
NODE_67770_length_419_cov_491.015625	63	143	61	5	80	0.0625000
NODE_67770_length_419_cov_491.015625	63	143	64	3	80	0.0375000
NODE_67770_length_419_cov_491.015625	63	143	66	1	80	0.0125000
NODE_67770_length_419_cov_491.015625	116	196	47	3	80	0.0375000
NODE_67770_length_419_cov_491.015625	116	196	48	1	80	0.0125000
NODE_67770_length_419_cov_491.015625	116	196	51	1	80	0.0125000
NODE_67770_length_419_cov_491.015625	116	196	52	12	80	0.1500000
NODE_67770_length_419_cov_491.015625	116	196	54	2	80	0.0250000
NODE_67770_length_419_cov_491.015625	116	196	55	11	80	0.1375000
NODE_67770_length_419_cov_491.015625	116	196	56	5	80	0.0625000
NODE_67770_length_419_cov_491.015625	116	196	57	4	80	0.0500000
NODE_67770_length_419_cov_491.015625	116	196	58	2	80	0.0250000
NODE_67770_length_419_cov_491.015625	116	196	59	10	80	0.1250000
NODE_67770_length_419_cov_491.015625	116	196	61	5	80	0.0625000
NODE_67770_length_419_cov_491.015625	116	196	62	1	80	0.0125000
NODE_67770_length_419_cov_491.015625	116	196	63	1	80	0.0125000
NODE_67770_length_419_cov_491.015625	116	196	64	16	80	0.2000000
NODE_67770_length_419_cov_491.015625	116	196	65	4	80	0.0500000
NODE_67770_length_419_cov_491.015625	116	196	66	2	80	0.0250000
NODE_67770_length_419_cov_491.015625	116	196	47	3	80	0.0375000
NODE_67770_length_419_cov_491.015625	116	196	48	1	80	0.0125000
NODE_67770_length_419_cov_491.015625	116	196	51	1	80	0.0125000
NODE_67770_length_419_cov_491.015625	116	196	52	12	80	0.1500000
NODE_67770_length_419_cov_491.015625	116	196	54	2	80	0.0250000
NODE_67770_length_419_cov_491.015625	116	196	55	11	80	0.1375000
NODE_67770_length_419_cov_491.015625	116	196	56	5	80	0.0625000
NODE_67770_length_419_cov_491.015625	116	196	57	4	80	0.0500000
NODE_67770_length_419_cov_491.015625	116	196	58	2	80	0.0250000
NODE_67770_length_419_cov_491.015625	116	196	59	10	80	0.1250000
NODE_67770_length_419_cov_491.015625	116	196	61	5	80	0.0625000
NODE_67770_length_419_cov_491.015625	116	196	62	1	80	0.0125000
NODE_67770_length_419_cov_491.015625	116	196	63	1	80	0.0125000
NODE_67770_length_419_cov_491.015625	116	196	64	16	80	0.2000000
NODE_67770_length_419_cov_491.015625	116	196	65	4	80	0.0500000
NODE_67770_length_419_cov_491.015625	116	196	66	2	80	0.0250000
NODE_67770_length_419_cov_491.015625	116	196	47	3	80	0.0375000
NODE_67770_length_419_cov_491.015625	116	196	48	1	80	0.0125000
NODE_67770_length_419_cov_491.015625	116	196	51	1	80	0.0125000
NODE_67770_length_419_cov_491.015625	116	196	52	12	80	0.1500000
NODE_67770_length_419_cov_491.015625	116	196	54	2	80	0.0250000
NODE_67770_length_419_cov_491.015625	116	196	55	11	80	0.1375000
NODE_67770_length_419_cov_491.015625	116	196	56	5	80	0.0625000
NODE_67770_length_419_cov_491.015625	116	196	57	4	80	0.0500000
NODE_67770_length_419_cov_491.015625	116	196	58	2	80	0.0250000
NODE_67770_length_419_cov_491.015625	116	196	59	10	80	0.1250000
NODE_67770_length_419_cov_491.015625	116	196	61	5	80	0.0625000
NODE_67770_length_419_cov_491.015625	116	196	62	1	80	0.0125000
NODE_67770_length_419_cov_491.015625	116	196	63	1	80	0.0125000
NODE_67770_length_419_cov_491.015625	116	196	64	16	80	0.2000000
NODE_67770_length_419_cov_491.015625	116	196	65	4	80	0.0500000
NODE_67770_length_419_cov_491.015625	116	196	66	2	80	0.0250000
NODE_67770_length_419_cov_491.015625	116	196	47	3	80	0.0375000
NODE_67770_length_419_cov_491.015625	116	196	48	1	80	0.0125000
NODE_67770_length_419_cov_491.015625	116	196	51	1	80	0.0125000
NODE_67770_length_419_cov_491.015625	116	196	52	12	80	0.1500000
NODE_67770_length_419_cov_491.015625	116	196	54	2	80	0.0250000
NODE_67770_length_419_cov_491.015625	116	196	55	11	80	0.1375000
NODE_67770_length_419_cov_491.015625	116	196	56	5	80	0.0625000
NODE_67770_length_419_cov_491.015625	116	196	57	4	80	0.0500000
NODE_67770_length_419_cov_491.015625	116	196	58	2	80	0.0250000
NODE_67770_length_419_cov_491.015625	116	196	59	10	80	0.1250000
NODE_67770_length_419_cov_491.015625	116	196	61	5	80	0.0625000
NODE_67770_length_419_cov_491.015625	116	196	62	1	80	0.0125000
NODE_67770_length_419_cov_491.015625	116	196	63	1	80	0.0125000
NODE_67770_length_419_cov_491.015625	116	196	64	16	80	0.2000000
NODE_67770_length_419_cov_491.015625	116	196	65	4	80	0.0500000
NODE_67770_length_419_cov_491.015625	116	196	66	2	80	0.0250000
NODE_67770_length_419_cov_491.015625	116	196	47	3	80	0.0375000
NODE_67770_length_419_cov_491.015625	116	196	48	1	80	0.0125000
NODE_67770_length_419_cov_491.015625	116	196	51	1	80	0.0125000
NODE_67770_length_419_cov_491.015625	116	196	52	12	80	0.1500000
NODE_67770_length_419_cov_491.015625	116	196	54	2	80	0.0250000
NODE_67770_length_419_cov_491.015625	116	196	55	11	80	0.1375000
NODE_67770_length_419_cov_491.015625	116	196	56	5	80	0.0625000
NODE_67770_length_419_cov_491.015625	116	196	57	4	80	0.0500000
NODE_67770_length_419_cov_491.015625	116	196	58	2	80	0.0250000
NODE_67770_length_419_cov_491.015625	116	196	59	10	80	0.1250000
NODE_67770_length_419_cov_491.015625	116	196	61	5	80	0.0625000
NODE_67770_length_419_cov_491.015625	116	196	62	1	80	0.0125000
NODE_67770_length_419_cov_491.015625	116	196	63	1	80	0.0125000
NODE_67770_length_419_cov_491.015625	116	196	64	16	80	0.2000000
NODE_67770_length_419_cov_491.015625	116	196	65	4	80	0.0500000
NODE_67770_length_419_cov_491.015625	116	196	66	2	80	0.0250000
NODE_67772_length_419_cov_31.725000	12	92	0	80	80	1.0000000
NODE_67772_length_419_cov_31.725000	65	145	0	80	80	1.0000000
NODE_67789_length_419_cov_4.862500	47	103	2	56	56	1.0000000
NODE_67789_length_419_cov_4.862500	258	327	4	69	69	1.0000000
NODE_67789_length_419_cov_4.862500	284	328	4	44	44	1.0000000
NODE_67803_length_419_cov_4.193750	215	262	0	47	47	1.0000000
NODE_67803_length_419_cov_4.193750	235	275	0	40	40	1.0000000
NODE_67817_length_419_cov_3.696875	165	215	0	31	50	0.6200000
NODE_67817_length_419_cov_3.696875	165	215	2	19	50	0.3800000
NODE_67854_length_419_cov_2.628125	234	314	0	8	80	0.1000000
NODE_67854_length_419_cov_2.628125	234	314	2	49	80	0.6125000
NODE_67854_length_419_cov_2.628125	234	314	4	23	80	0.2875000
NODE_67856_length_419_cov_2.603125	154	196	0	42	42	1.0000000
NODE_67878_length_419_cov_2.350000	156	220	11	19	64	0.2968750
NODE_67878_length_419_cov_2.350000	156	220	12	14	64	0.2187500
NODE_67878_length_419_cov_2.350000	156	220	13	2	64	0.0312500
NODE_67878_length_419_cov_2.350000	156	220	14	3	64	0.0468750
NODE_67878_length_419_cov_2.350000	156	220	15	2	64	0.0312500
NODE_67878_length_419_cov_2.350000	156	220	16	5	64	0.0781250
NODE_67878_length_419_cov_2.350000	156	220	17	10	64	0.1562500
NODE_67878_length_419_cov_2.350000	156	220	18	9	64	0.1406250
NODE_67961_length_419_cov_1.593750	339	358	0	19	19	1.0000000
NODE_68250_length_418_cov_63.059561	105	186	0	46	81	0.5679013
NODE_68250_length_418_cov_63.059561	105	186	2	35	81	0.4320988
NODE_68250_length_418_cov_63.059561	159	239	0	4	80	0.0500000
NODE_68250_length_418_cov_63.059561	159	239	2	76	80	0.9500000
NODE_68251_length_418_cov_49.796238	325	405	8	4	80	0.0500000
NODE_68251_length_418_cov_49.796238	325	405	12	1	80	0.0125000
NODE_68251_length_418_cov_49.796238	325	405	14	2	80	0.0250000
NODE_68251_length_418_cov_49.796238	325	405	16	2	80	0.0250000
NODE_68251_length_418_cov_49.796238	325	405	20	7	80	0.0875000
NODE_68251_length_418_cov_49.796238	325	405	22	5	80	0.0625000
NODE_68251_length_418_cov_49.796238	325	405	24	1	80	0.0125000
NODE_68251_length_418_cov_49.796238	325	405	26	1	80	0.0125000
NODE_68251_length_418_cov_49.796238	325	405	28	3	80	0.0375000
NODE_68251_length_418_cov_49.796238	325	405	30	1	80	0.0125000
NODE_68251_length_418_cov_49.796238	325	405	32	1	80	0.0125000
NODE_68251_length_418_cov_49.796238	325	405	34	2	80	0.0250000
NODE_68251_length_418_cov_49.796238	325	405	36	2	80	0.0250000
NODE_68251_length_418_cov_49.796238	325	405	38	2	80	0.0250000
NODE_68251_length_418_cov_49.796238	325	405	42	8	80	0.1000000
NODE_68251_length_418_cov_49.796238	325	405	44	1	80	0.0125000
NODE_68251_length_418_cov_49.796238	325	405	46	3	80	0.0375000
NODE_68251_length_418_cov_49.796238	325	405	52	1	80	0.0125000
NODE_68251_length_418_cov_49.796238	325	405	54	3	80	0.0375000
NODE_68251_length_418_cov_49.796238	325	405	56	2	80	0.0250000
NODE_68251_length_418_cov_49.796238	325	405	58	1	80	0.0125000
NODE_68251_length_418_cov_49.796238	325	405	60	4	80	0.0500000
NODE_68251_length_418_cov_49.796238	325	405	62	1	80	0.0125000
NODE_68251_length_418_cov_49.796238	325	405	64	4	80	0.0500000
NODE_68251_length_418_cov_49.796238	325	405	68	2	80	0.0250000
NODE_68251_length_418_cov_49.796238	325	405	70	1	80	0.0125000
NODE_68251_length_418_cov_49.796238	325	405	72	3	80	0.0375000
NODE_68251_length_418_cov_49.796238	325	405	74	1	80	0.0125000
NODE_68251_length_418_cov_49.796238	325	405	76	1	80	0.0125000
NODE_68251_length_418_cov_49.796238	325	405	80	1	80	0.0125000
NODE_68251_length_418_cov_49.796238	325	405	82	1	80	0.0125000
NODE_68251_length_418_cov_49.796238	325	405	84	2	80	0.0250000
NODE_68251_length_418_cov_49.796238	325	405	85	3	80	0.0375000
NODE_68251_length_418_cov_49.796238	325	405	87	3	80	0.0375000
NODE_68251_length_418_cov_49.796238	378	415	2	3	37	0.0810811
NODE_68251_length_418_cov_49.796238	378	415	4	1	37	0.0270270
NODE_68251_length_418_cov_49.796238	378	415	6	3	37	0.0810811
NODE_68251_length_418_cov_49.796238	378	415	8	7	37	0.1891892
NODE_68251_length_418_cov_49.796238	378	415	12	1	37	0.0270270
NODE_68251_length_418_cov_49.796238	378	415	14	2	37	0.0540541
NODE_68251_length_418_cov_49.796238	378	415	16	2	37	0.0540541
NODE_68251_length_418_cov_49.796238	378	415	20	7	37	0.1891892
NODE_68251_length_418_cov_49.796238	378	415	22	5	37	0.1351351
NODE_68251_length_418_cov_49.796238	378	415	24	1	37	0.0270270
NODE_68251_length_418_cov_49.796238	378	415	26	1	37	0.0270270
NODE_68251_length_418_cov_49.796238	378	415	28	3	37	0.0810811
NODE_68251_length_418_cov_49.796238	378	415	30	1	37	0.0270270
NODE_68252_length_418_cov_42.764890	119	196	0	27	77	0.3506494
NODE_68252_length_418_cov_42.764890	119	196	8	50	77	0.6493506
NODE_68252_length_418_cov_42.764890	172	250	8	78	78	1.0000000
NODE_68253_length_418_cov_23.830721	73	153	0	80	80	1.0000000
NODE_68253_length_418_cov_23.830721	126	200	0	74	74	1.0000000
NODE_68255_length_418_cov_7.216301	211	291	4	56	80	0.7000000
NODE_68255_length_418_cov_7.216301	211	291	6	2	80	0.0250000
NODE_68255_length_418_cov_7.216301	211	291	8	22	80	0.2750000
NODE_68265_length_418_cov_5.382445	134	215	0	81	81	1.0000000
NODE_68265_length_418_cov_5.382445	187	268	0	81	81	1.0000000
NODE_68275_length_418_cov_4.463950	191	272	0	75	81	0.9259259
NODE_68275_length_418_cov_4.463950	191	272	2	6	81	0.0740741
NODE_68280_length_418_cov_4.216301	148	230	0	82	82	1.0000000
NODE_68281_length_418_cov_4.065831	211	280	0	69	69	1.0000000
NODE_68284_length_418_cov_3.909091	95	175	0	2	80	0.0250000
NODE_68284_length_418_cov_3.909091	95	175	2	10	80	0.1250000
NODE_68284_length_418_cov_3.909091	95	175	4	14	80	0.1750000
NODE_68284_length_418_cov_3.909091	95	175	6	2	80	0.0250000
NODE_68284_length_418_cov_3.909091	95	175	11	3	80	0.0375000
NODE_68284_length_418_cov_3.909091	95	175	12	2	80	0.0250000
NODE_68284_length_418_cov_3.909091	95	175	14	5	80	0.0625000
NODE_68284_length_418_cov_3.909091	95	175	16	18	80	0.2250000
NODE_68284_length_418_cov_3.909091	95	175	18	11	80	0.1375000
NODE_68284_length_418_cov_3.909091	95	175	20	3	80	0.0375000
NODE_68284_length_418_cov_3.909091	95	175	21	2	80	0.0250000
NODE_68284_length_418_cov_3.909091	95	175	23	8	80	0.1000000
NODE_68284_length_418_cov_3.909091	148	224	0	35	76	0.4605263
NODE_68284_length_418_cov_3.909091	148	224	2	10	76	0.1315790
NODE_68284_length_418_cov_3.909091	148	224	4	25	76	0.3289474
NODE_68284_length_418_cov_3.909091	148	224	6	1	76	0.0131579
NODE_68284_length_418_cov_3.909091	148	224	8	5	76	0.0657895
NODE_68288_length_418_cov_3.749216	181	247	0	66	66	1.0000000
NODE_68289_length_418_cov_3.711599	249	313	2	1	64	0.0156250
NODE_68289_length_418_cov_3.711599	249	313	4	13	64	0.2031250
NODE_68289_length_418_cov_3.711599	249	313	6	50	64	0.7812500
NODE_68307_length_418_cov_3.012539	101	181	2	23	80	0.2875000
NODE_68307_length_418_cov_3.012539	101	181	4	15	80	0.1875000
NODE_68307_length_418_cov_3.012539	101	181	6	22	80	0.2750000
NODE_68307_length_418_cov_3.012539	101	181	8	20	80	0.2500000
NODE_68354_length_418_cov_2.376176	95	115	0	20	20	1.0000000
NODE_68436_length_418_cov_1.623824	47	128	0	38	81	0.4691358
NODE_68436_length_418_cov_1.623824	47	128	1	1	81	0.0123457
NODE_68436_length_418_cov_1.623824	47	128	2	42	81	0.5185185
NODE_68436_length_418_cov_1.623824	239	268	6	11	29	0.3793103
NODE_68436_length_418_cov_1.623824	239	268	8	18	29	0.6206896
NODE_68682_length_418_cov_0.626959	255	299	0	44	44	1.0000000
NODE_68708_length_417_cov_45.267296	212	292	0	80	80	1.0000000
NODE_68708_length_417_cov_45.267296	265	345	0	80	80	1.0000000
NODE_68708_length_417_cov_45.267296	341	417	0	76	76	1.0000000
NODE_68709_length_417_cov_36.006289	159	239	0	41	80	0.5125000
NODE_68709_length_417_cov_36.006289	159	239	2	39	80	0.4875000
NODE_68711_length_417_cov_12.886792	193	273	2	22	80	0.2750000
NODE_68711_length_417_cov_12.886792	193	273	6	58	80	0.7250000
NODE_68711_length_417_cov_12.886792	246	326	0	38	80	0.4750000
NODE_68711_length_417_cov_12.886792	246	326	2	37	80	0.4625000
NODE_68711_length_417_cov_12.886792	246	326	6	5	80	0.0625000
NODE_68717_length_417_cov_7.056604	210	271	0	61	61	1.0000000
NODE_68717_length_417_cov_7.056604	263	315	0	52	52	1.0000000
NODE_68718_length_417_cov_6.669811	194	264	2	18	70	0.2571429
NODE_68718_length_417_cov_6.669811	194	264	4	52	70	0.7428572
NODE_68779_length_417_cov_2.795597	20	91	0	71	71	1.0000000
NODE_69163_length_416_cov_115.782334	174	259	14	5	85	0.0588235
NODE_69163_length_416_cov_115.782334	174	259	16	2	85	0.0235294
NODE_69163_length_416_cov_115.782334	174	259	18	18	85	0.2117647
NODE_69163_length_416_cov_115.782334	174	259	22	7	85	0.0823529
NODE_69163_length_416_cov_115.782334	174	259	24	1	85	0.0117647
NODE_69163_length_416_cov_115.782334	174	259	26	1	85	0.0117647
NODE_69163_length_416_cov_115.782334	174	259	28	2	85	0.0235294
NODE_69163_length_416_cov_115.782334	174	259	30	2	85	0.0235294
NODE_69163_length_416_cov_115.782334	174	259	34	3	85	0.0352941
NODE_69163_length_416_cov_115.782334	174	259	36	11	85	0.1294118
NODE_69163_length_416_cov_115.782334	174	259	38	5	85	0.0588235
NODE_69163_length_416_cov_115.782334	174	259	40	5	85	0.0588235
NODE_69163_length_416_cov_115.782334	174	259	42	8	85	0.0941176
NODE_69163_length_416_cov_115.782334	174	259	43	1	85	0.0117647
NODE_69163_length_416_cov_115.782334	174	259	44	9	85	0.1058824
NODE_69163_length_416_cov_115.782334	174	259	46	4	85	0.0470588
NODE_69163_length_416_cov_115.782334	174	259	48	1	85	0.0117647
NODE_69164_length_416_cov_70.678233	180	244	2	10	64	0.1562500
NODE_69164_length_416_cov_70.678233	180	244	6	5	64	0.0781250
NODE_69164_length_416_cov_70.678233	180	244	8	2	64	0.0312500
NODE_69164_length_416_cov_70.678233	180	244	10	7	64	0.1093750
NODE_69164_length_416_cov_70.678233	180	244	16	2	64	0.0312500
NODE_69164_length_416_cov_70.678233	180	244	20	7	64	0.1093750
NODE_69164_length_416_cov_70.678233	180	244	24	7	64	0.1093750
NODE_69164_length_416_cov_70.678233	180	244	28	11	64	0.1718750
NODE_69164_length_416_cov_70.678233	180	244	30	2	64	0.0312500
NODE_69164_length_416_cov_70.678233	180	244	32	11	64	0.1718750
NODE_69166_length_416_cov_39.933754	288	368	0	14	80	0.1750000
NODE_69166_length_416_cov_39.933754	288	368	6	66	80	0.8250000
NODE_69166_length_416_cov_39.933754	341	416	0	31	75	0.4133333
NODE_69166_length_416_cov_39.933754	341	416	6	44	75	0.5866666
NODE_69167_length_416_cov_37.334385	158	238	0	47	80	0.5875000
NODE_69167_length_416_cov_37.334385	158	238	2	33	80	0.4125000
NODE_69167_length_416_cov_37.334385	211	291	0	80	80	1.0000000
NODE_69167_length_416_cov_37.334385	287	367	0	80	80	1.0000000
NODE_69167_length_416_cov_37.334385	340	416	0	76	76	1.0000000
NODE_69179_length_416_cov_5.242902	89	169	0	80	80	1.0000000
NODE_69179_length_416_cov_5.242902	142	222	0	80	80	1.0000000
NODE_69184_length_416_cov_4.892744	79	145	0	18	66	0.2727273
NODE_69184_length_416_cov_4.892744	79	145	7	1	66	0.0151515
NODE_69184_length_416_cov_4.892744	79	145	8	2	66	0.0303030
NODE_69184_length_416_cov_4.892744	79	145	10	30	66	0.4545455
NODE_69184_length_416_cov_4.892744	79	145	19	9	66	0.1363636
NODE_69184_length_416_cov_4.892744	79	145	20	6	66	0.0909091
NODE_69184_length_416_cov_4.892744	194	272	0	1	78	0.0128205
NODE_69184_length_416_cov_4.892744	194	272	8	24	78	0.3076923
NODE_69184_length_416_cov_4.892744	194	272	15	19	78	0.2435897
NODE_69184_length_416_cov_4.892744	194	272	17	1	78	0.0128205
NODE_69184_length_416_cov_4.892744	194	272	18	33	78	0.4230769
NODE_69184_length_416_cov_4.892744	247	272	0	1	25	0.0400000
NODE_69184_length_416_cov_4.892744	247	272	8	24	25	0.9600000
NODE_69204_length_416_cov_3.886435	79	136	2	14	57	0.2456140
NODE_69204_length_416_cov_3.886435	79	136	4	27	57	0.4736842
NODE_69204_length_416_cov_3.886435	79	136	6	16	57	0.2807018
NODE_69279_length_416_cov_2.230284	10	90	0	11	80	0.1375000
NODE_69279_length_416_cov_2.230284	10	90	2	37	80	0.4625000
NODE_69279_length_416_cov_2.230284	10	90	4	32	80	0.4000000
NODE_69399_length_416_cov_1.520505	198	244	6	7	46	0.1521739
NODE_69399_length_416_cov_1.520505	198	244	8	1	46	0.0217391
NODE_69399_length_416_cov_1.520505	198	244	11	27	46	0.5869565
NODE_69399_length_416_cov_1.520505	198	244	13	11	46	0.2391304
NODE_69399_length_416_cov_1.520505	261	328	22	3	67	0.0447761
NODE_69399_length_416_cov_1.520505	261	328	23	18	67	0.2686567
NODE_69399_length_416_cov_1.520505	261	328	24	5	67	0.0746269
NODE_69399_length_416_cov_1.520505	261	328	25	15	67	0.2238806
NODE_69399_length_416_cov_1.520505	261	328	27	1	67	0.0149254
NODE_69399_length_416_cov_1.520505	261	328	29	17	67	0.2537313
NODE_69399_length_416_cov_1.520505	261	328	31	8	67	0.1194030
NODE_69673_length_415_cov_35.924051	260	339	0	79	79	1.0000000
NODE_69673_length_415_cov_35.924051	316	392	0	76	76	1.0000000
NODE_69679_length_415_cov_6.376582	117	197	0	80	80	1.0000000
NODE_69679_length_415_cov_6.376582	254	334	0	80	80	1.0000000
NODE_69774_length_415_cov_2.224684	144	224	14	17	80	0.2125000
NODE_69774_length_415_cov_2.224684	144	224	16	7	80	0.0875000
NODE_69774_length_415_cov_2.224684	144	224	18	15	80	0.1875000
NODE_69774_length_415_cov_2.224684	144	224	20	41	80	0.5125000
NODE_69795_length_415_cov_2.069620	207	273	2	35	66	0.5303030
NODE_69795_length_415_cov_2.069620	207	273	4	31	66	0.4696970
NODE_69817_length_415_cov_1.832278	225	283	6	2	58	0.0344828
NODE_69817_length_415_cov_1.832278	225	283	8	24	58	0.4137931
NODE_69817_length_415_cov_1.832278	225	283	14	12	58	0.2068966
NODE_69817_length_415_cov_1.832278	225	283	16	10	58	0.1724138
NODE_69817_length_415_cov_1.832278	225	283	18	10	58	0.1724138
NODE_69845_length_415_cov_1.610759	90	170	6	3	80	0.0375000
NODE_69845_length_415_cov_1.610759	90	170	8	13	80	0.1625000
NODE_69845_length_415_cov_1.610759	90	170	10	8	80	0.1000000
NODE_69845_length_415_cov_1.610759	90	170	12	1	80	0.0125000
NODE_69845_length_415_cov_1.610759	90	170	14	13	80	0.1625000
NODE_69845_length_415_cov_1.610759	90	170	18	1	80	0.0125000
NODE_69845_length_415_cov_1.610759	90	170	20	5	80	0.0625000
NODE_69845_length_415_cov_1.610759	90	170	22	36	80	0.4500000
NODE_69845_length_415_cov_1.610759	335	376	0	35	41	0.8536586
NODE_69845_length_415_cov_1.610759	335	376	2	6	41	0.1463415
NODE_70175_length_414_cov_46.263492	0	49	0	49	49	1.0000000
NODE_70175_length_414_cov_46.263492	22	102	0	80	80	1.0000000
NODE_70183_length_414_cov_7.460317	167	247	0	2	80	0.0250000
NODE_70183_length_414_cov_7.460317	167	247	2	78	80	0.9750000
NODE_70183_length_414_cov_7.460317	220	300	0	55	80	0.6875000
NODE_70183_length_414_cov_7.460317	220	300	2	25	80	0.3125000
NODE_70192_length_414_cov_5.676190	54	134	0	80	80	1.0000000
NODE_70192_length_414_cov_5.676190	107	187	0	80	80	1.0000000
NODE_70222_length_414_cov_4.130159	257	303	0	44	46	0.9565217
NODE_70222_length_414_cov_4.130159	257	303	2	2	46	0.0434783
NODE_70222_length_414_cov_4.130159	276	356	0	80	80	1.0000000
NODE_70254_length_414_cov_2.996825	75	135	16	41	60	0.6833333
NODE_70254_length_414_cov_2.996825	75	135	18	19	60	0.3166667
NODE_70271_length_414_cov_2.631746	68	145	0	49	77	0.6363636
NODE_70271_length_414_cov_2.631746	68	145	2	28	77	0.3636364
NODE_70284_length_414_cov_2.473016	164	197	0	33	33	1.0000000
NODE_70284_length_414_cov_2.473016	170	255	0	85	85	1.0000000
NODE_70305_length_414_cov_2.222222	185	260	0	15	75	0.2000000
NODE_70305_length_414_cov_2.222222	185	260	2	28	75	0.3733333
NODE_70305_length_414_cov_2.222222	185	260	4	26	75	0.3466667
NODE_70305_length_414_cov_2.222222	185	260	6	6	75	0.0800000
NODE_70305_length_414_cov_2.222222	233	304	4	35	71	0.4929577
NODE_70305_length_414_cov_2.222222	233	304	6	36	71	0.5070422
NODE_70307_length_414_cov_2.206349	88	163	0	75	75	1.0000000
NODE_70326_length_414_cov_2.047619	298	349	0	51	51	1.0000000
NODE_70486_length_414_cov_1.177778	106	190	0	84	84	1.0000000
NODE_70494_length_414_cov_1.155556	0	23	0	23	23	1.0000000
NODE_70690_length_413_cov_41.471338	35	115	0	80	80	1.0000000
NODE_70690_length_413_cov_41.471338	35	115	0	80	80	1.0000000
NODE_70690_length_413_cov_41.471338	88	168	0	80	80	1.0000000
NODE_70690_length_413_cov_41.471338	88	168	0	80	80	1.0000000
NODE_70691_length_413_cov_16.687898	222	302	0	80	80	1.0000000
NODE_70691_length_413_cov_16.687898	275	355	0	80	80	1.0000000
NODE_70699_length_413_cov_7.057325	170	250	0	68	80	0.8500000
NODE_70699_length_413_cov_7.057325	170	250	2	12	80	0.1500000
NODE_70699_length_413_cov_7.057325	223	300	0	21	77	0.2727273
NODE_70699_length_413_cov_7.057325	223	300	2	56	77	0.7272727
NODE_70703_length_413_cov_5.665605	125	182	2	25	57	0.4385965
NODE_70703_length_413_cov_5.665605	125	182	4	7	57	0.1228070
NODE_70703_length_413_cov_5.665605	125	182	6	25	57	0.4385965
NODE_70712_length_413_cov_4.754777	140	184	0	44	44	1.0000000
NODE_70743_length_413_cov_3.506369	113	193	0	80	80	1.0000000
NODE_70749_length_413_cov_3.235669	251	331	0	80	80	1.0000000
NODE_70749_length_413_cov_3.235669	304	356	0	52	52	1.0000000
NODE_70792_length_413_cov_2.484076	209	257	0	48	48	1.0000000
NODE_70835_length_413_cov_1.949045	224	296	0	72	72	1.0000000
NODE_71196_length_412_cov_9.996805	172	244	0	72	72	1.0000000
NODE_71218_length_412_cov_4.686901	112	167	0	55	55	1.0000000
NODE_71253_length_412_cov_3.204473	44	124	0	80	80	1.0000000
NODE_71276_length_412_cov_2.824281	225	305	0	80	80	1.0000000
NODE_71371_length_412_cov_1.782748	262	342	2	7	80	0.0875000
NODE_71371_length_412_cov_1.782748	262	342	4	4	80	0.0500000
NODE_71371_length_412_cov_1.782748	262	342	6	15	80	0.1875000
NODE_71371_length_412_cov_1.782748	262	342	8	54	80	0.6750000
NODE_71398_length_412_cov_1.603834	143	182	0	8	39	0.2051282
NODE_71398_length_412_cov_1.603834	143	182	2	2	39	0.0512821
NODE_71398_length_412_cov_1.603834	143	182	4	5	39	0.1282051
NODE_71398_length_412_cov_1.603834	143	182	6	1	39	0.0256410
NODE_71398_length_412_cov_1.603834	143	182	8	5	39	0.1282051
NODE_71398_length_412_cov_1.603834	143	182	10	2	39	0.0512821
NODE_71398_length_412_cov_1.603834	143	182	12	5	39	0.1282051
NODE_71398_length_412_cov_1.603834	143	182	14	1	39	0.0256410
NODE_71398_length_412_cov_1.603834	143	182	20	2	39	0.0512821
NODE_71398_length_412_cov_1.603834	143	182	23	8	39	0.2051282
NODE_71665_length_411_cov_44.701923	4	72	0	17	68	0.2500000
NODE_71665_length_411_cov_44.701923	4	72	2	51	68	0.7500000
NODE_71665_length_411_cov_44.701923	35	116	2	81	81	1.0000000
NODE_71665_length_411_cov_44.701923	161	242	0	81	81	1.0000000
NODE_71665_length_411_cov_44.701923	293	374	0	81	81	1.0000000
NODE_71665_length_411_cov_44.701923	337	411	0	74	74	1.0000000
NODE_71666_length_411_cov_43.144231	102	183	0	76	81	0.9382716
NODE_71666_length_411_cov_43.144231	102	183	2	2	81	0.0246914
NODE_71666_length_411_cov_43.144231	102	183	4	3	81	0.0370370
NODE_71666_length_411_cov_43.144231	156	236	0	80	80	1.0000000
NODE_71666_length_411_cov_43.144231	232	312	0	80	80	1.0000000
NODE_71666_length_411_cov_43.144231	285	365	0	80	80	1.0000000
NODE_71672_length_411_cov_8.471154	133	213	0	80	80	1.0000000
NODE_71672_length_411_cov_8.471154	186	266	0	73	80	0.9125000
NODE_71672_length_411_cov_8.471154	186	266	2	7	80	0.0875000
NODE_71673_length_411_cov_8.407051	133	220	2	9	87	0.1034483
NODE_71673_length_411_cov_8.407051	133	220	4	66	87	0.7586207
NODE_71673_length_411_cov_8.407051	133	220	6	12	87	0.1379310
NODE_71675_length_411_cov_6.455128	249	316	0	67	67	1.0000000
NODE_71675_length_411_cov_6.455128	292	344	0	52	52	1.0000000
NODE_71687_length_411_cov_4.782051	98	178	0	52	80	0.6500000
NODE_71687_length_411_cov_4.782051	98	178	4	28	80	0.3500000
NODE_71687_length_411_cov_4.782051	151	228	2	6	77	0.0779221
NODE_71687_length_411_cov_4.782051	151	228	4	71	77	0.9220779
NODE_71705_length_411_cov_3.698718	282	347	0	65	65	1.0000000
NODE_71713_length_411_cov_3.378205	88	148	14	60	60	1.0000000
NODE_71714_length_411_cov_3.371795	145	225	0	80	80	1.0000000
NODE_71714_length_411_cov_3.371795	198	274	0	74	76	0.9736842
NODE_71714_length_411_cov_3.371795	198	274	2	2	76	0.0263158
NODE_72163_length_410_cov_49.331190	320	400	0	14	80	0.1750000
NODE_72163_length_410_cov_49.331190	320	400	11	43	80	0.5375000
NODE_72163_length_410_cov_49.331190	320	400	12	10	80	0.1250000
NODE_72163_length_410_cov_49.331190	320	400	13	1	80	0.0125000
NODE_72163_length_410_cov_49.331190	320	400	14	12	80	0.1500000
NODE_72163_length_410_cov_49.331190	320	400	0	14	80	0.1750000
NODE_72163_length_410_cov_49.331190	320	400	11	43	80	0.5375000
NODE_72163_length_410_cov_49.331190	320	400	12	10	80	0.1250000
NODE_72163_length_410_cov_49.331190	320	400	13	1	80	0.0125000
NODE_72163_length_410_cov_49.331190	320	400	14	12	80	0.1500000
NODE_72163_length_410_cov_49.331190	320	400	0	14	80	0.1750000
NODE_72163_length_410_cov_49.331190	320	400	11	43	80	0.5375000
NODE_72163_length_410_cov_49.331190	320	400	12	10	80	0.1250000
NODE_72163_length_410_cov_49.331190	320	400	13	1	80	0.0125000
NODE_72163_length_410_cov_49.331190	320	400	14	12	80	0.1500000
NODE_72163_length_410_cov_49.331190	320	400	0	14	80	0.1750000
NODE_72163_length_410_cov_49.331190	320	400	11	43	80	0.5375000
NODE_72163_length_410_cov_49.331190	320	400	12	10	80	0.1250000
NODE_72163_length_410_cov_49.331190	320	400	13	1	80	0.0125000
NODE_72163_length_410_cov_49.331190	320	400	14	12	80	0.1500000
NODE_72163_length_410_cov_49.331190	320	400	0	14	80	0.1750000
NODE_72163_length_410_cov_49.331190	320	400	11	43	80	0.5375000
NODE_72163_length_410_cov_49.331190	320	400	12	10	80	0.1250000
NODE_72163_length_410_cov_49.331190	320	400	13	1	80	0.0125000
NODE_72163_length_410_cov_49.331190	320	400	14	12	80	0.1500000
NODE_72163_length_410_cov_49.331190	329	400	0	14	71	0.1971831
NODE_72163_length_410_cov_49.331190	329	400	11	43	71	0.6056338
NODE_72163_length_410_cov_49.331190	329	400	12	10	71	0.1408451
NODE_72163_length_410_cov_49.331190	329	400	13	1	71	0.0140845
NODE_72163_length_410_cov_49.331190	329	400	14	3	71	0.0422535
NODE_72169_length_410_cov_6.797428	179	259	0	80	80	1.0000000
NODE_72169_length_410_cov_6.797428	232	312	0	80	80	1.0000000
NODE_72184_length_410_cov_5.102894	153	222	0	69	69	1.0000000
NODE_72186_length_410_cov_4.884244	101	179	2	48	78	0.6153846
NODE_72186_length_410_cov_4.884244	101	179	4	30	78	0.3846154
NODE_72187_length_410_cov_4.787781	287	344	2	57	57	1.0000000
NODE_72187_length_410_cov_4.787781	340	397	0	21	57	0.3684210
NODE_72187_length_410_cov_4.787781	340	397	2	36	57	0.6315789
NODE_72194_length_410_cov_4.591640	245	303	26	4	58	0.0689655
NODE_72194_length_410_cov_4.591640	245	303	28	1	58	0.0172414
NODE_72194_length_410_cov_4.591640	245	303	30	1	58	0.0172414
NODE_72194_length_410_cov_4.591640	245	303	32	3	58	0.0517241
NODE_72194_length_410_cov_4.591640	245	303	34	3	58	0.0517241
NODE_72194_length_410_cov_4.591640	245	303	37	1	58	0.0172414
NODE_72194_length_410_cov_4.591640	245	303	40	1	58	0.0172414
NODE_72194_length_410_cov_4.591640	245	303	44	1	58	0.0172414
NODE_72194_length_410_cov_4.591640	245	303	48	5	58	0.0862069
NODE_72194_length_410_cov_4.591640	245	303	50	4	58	0.0689655
NODE_72194_length_410_cov_4.591640	245	303	54	1	58	0.0172414
NODE_72194_length_410_cov_4.591640	245	303	56	5	58	0.0862069
NODE_72194_length_410_cov_4.591640	245	303	60	2	58	0.0344828
NODE_72194_length_410_cov_4.591640	245	303	62	1	58	0.0172414
NODE_72194_length_410_cov_4.591640	245	303	64	1	58	0.0172414
NODE_72194_length_410_cov_4.591640	245	303	66	13	58	0.2241379
NODE_72194_length_410_cov_4.591640	245	303	68	11	58	0.1896552
NODE_72194_length_410_cov_4.591640	298	356	42	5	58	0.0862069
NODE_72194_length_410_cov_4.591640	298	356	46	4	58	0.0689655
NODE_72194_length_410_cov_4.591640	298	356	48	1	58	0.0172414
NODE_72194_length_410_cov_4.591640	298	356	56	16	58	0.2758621
NODE_72194_length_410_cov_4.591640	298	356	58	6	58	0.1034483
NODE_72194_length_410_cov_4.591640	298	356	60	1	58	0.0172414
NODE_72194_length_410_cov_4.591640	298	356	64	5	58	0.0862069
NODE_72194_length_410_cov_4.591640	298	356	66	20	58	0.3448276
NODE_72230_length_410_cov_3.215434	32	112	0	80	80	1.0000000
NODE_72230_length_410_cov_3.215434	85	165	0	80	80	1.0000000
NODE_72327_length_410_cov_1.913183	227	285	0	53	58	0.9137931
NODE_72327_length_410_cov_1.913183	227	285	2	5	58	0.0862069
NODE_72526_length_410_cov_1.038585	272	316	0	44	44	1.0000000
NODE_72688_length_409_cov_11.506452	56	136	0	80	80	1.0000000
NODE_72688_length_409_cov_11.506452	109	189	0	80	80	1.0000000
NODE_72689_length_409_cov_10.329032	131	186	0	55	55	1.0000000
NODE_72690_length_409_cov_9.625806	62	142	0	80	80	1.0000000
NODE_72690_length_409_cov_9.625806	115	195	0	80	80	1.0000000
NODE_72697_length_409_cov_6.867742	41	71	0	30	30	1.0000000
NODE_72730_length_409_cov_3.822581	103	158	2	27	55	0.4909091
NODE_72730_length_409_cov_3.822581	103	158	4	28	55	0.5090909
NODE_72730_length_409_cov_3.822581	151	232	2	65	81	0.8024691
NODE_72730_length_409_cov_3.822581	151	232	4	16	81	0.1975309
NODE_72754_length_409_cov_2.987097	240	287	0	47	47	1.0000000
NODE_72951_length_409_cov_1.319355	49	131	0	59	82	0.7195122
NODE_72951_length_409_cov_1.319355	49	131	2	23	82	0.2804878
NODE_72951_length_409_cov_1.319355	104	161	0	57	57	1.0000000
NODE_73196_length_408_cov_8.585761	57	137	0	80	80	1.0000000
NODE_73196_length_408_cov_8.585761	110	190	0	80	80	1.0000000
NODE_73198_length_408_cov_6.948220	71	151	0	50	80	0.6250000
NODE_73198_length_408_cov_6.948220	71	151	2	30	80	0.3750000
NODE_73198_length_408_cov_6.948220	124	204	2	80	80	1.0000000
NODE_73219_length_408_cov_3.957929	83	132	0	49	49	1.0000000
NODE_73226_length_408_cov_3.511327	40	97	0	57	57	1.0000000
NODE_73226_length_408_cov_3.511327	357	398	0	41	41	1.0000000
NODE_73262_length_408_cov_2.724919	128	180	0	52	52	1.0000000
NODE_73269_length_408_cov_2.563107	164	241	4	21	77	0.2727273
NODE_73269_length_408_cov_2.563107	164	241	6	33	77	0.4285714
NODE_73269_length_408_cov_2.563107	164	241	8	17	77	0.2207792
NODE_73269_length_408_cov_2.563107	164	241	9	1	77	0.0129870
NODE_73269_length_408_cov_2.563107	164	241	13	1	77	0.0129870
NODE_73269_length_408_cov_2.563107	164	241	17	2	77	0.0259740
NODE_73269_length_408_cov_2.563107	164	241	21	2	77	0.0259740
NODE_73271_length_408_cov_2.456311	314	379	0	65	65	1.0000000
NODE_73271_length_408_cov_2.456311	352	408	0	56	56	1.0000000
NODE_73690_length_407_cov_6.191558	144	208	0	64	64	1.0000000
NODE_73698_length_407_cov_4.961039	212	291	0	79	79	1.0000000
NODE_73719_length_407_cov_3.681818	314	375	0	7	61	0.1147541
NODE_73719_length_407_cov_3.681818	314	375	1	54	61	0.8852459
NODE_73732_length_407_cov_3.344156	199	247	0	16	48	0.3333333
NODE_73732_length_407_cov_3.344156	199	247	4	32	48	0.6666667
NODE_73736_length_407_cov_3.250000	142	223	15	2	81	0.0246914
NODE_73736_length_407_cov_3.250000	142	223	19	4	81	0.0493827
NODE_73736_length_407_cov_3.250000	142	223	21	1	81	0.0123457
NODE_73736_length_407_cov_3.250000	142	223	25	1	81	0.0123457
NODE_73736_length_407_cov_3.250000	142	223	27	8	81	0.0987654
NODE_73736_length_407_cov_3.250000	142	223	29	15	81	0.1851852
NODE_73736_length_407_cov_3.250000	142	223	31	1	81	0.0123457
NODE_73736_length_407_cov_3.250000	142	223	33	49	81	0.6049383
NODE_73762_length_407_cov_2.594156	194	257	0	31	63	0.4920635
NODE_73762_length_407_cov_2.594156	194	257	4	32	63	0.5079365
NODE_73769_length_407_cov_2.538961	34	114	0	6	80	0.0750000
NODE_73769_length_407_cov_2.538961	34	114	2	10	80	0.1250000
NODE_73769_length_407_cov_2.538961	34	114	4	18	80	0.2250000
NODE_73769_length_407_cov_2.538961	34	114	6	32	80	0.4000000
NODE_73769_length_407_cov_2.538961	34	114	10	14	80	0.1750000
NODE_73853_length_407_cov_1.737013	208	264	0	6	56	0.1071429
NODE_73853_length_407_cov_1.737013	208	264	1	50	56	0.8928571
NODE_74200_length_406_cov_176.856678	200	271	78	1	71	0.0140845
NODE_74200_length_406_cov_176.856678	200	271	80	1	71	0.0140845
NODE_74200_length_406_cov_176.856678	200	271	82	3	71	0.0422535
NODE_74200_length_406_cov_176.856678	200	271	88	2	71	0.0281690
NODE_74200_length_406_cov_176.856678	200	271	90	1	71	0.0140845
NODE_74200_length_406_cov_176.856678	200	271	92	10	71	0.1408451
NODE_74200_length_406_cov_176.856678	200	271	94	5	71	0.0704225
NODE_74200_length_406_cov_176.856678	200	271	95	1	71	0.0140845
NODE_74200_length_406_cov_176.856678	200	271	96	4	71	0.0563380
NODE_74200_length_406_cov_176.856678	200	271	98	5	71	0.0704225
NODE_74200_length_406_cov_176.856678	200	271	99	3	71	0.0422535
NODE_74200_length_406_cov_176.856678	200	271	100	4	71	0.0563380
NODE_74200_length_406_cov_176.856678	200	271	103	2	71	0.0281690
NODE_74200_length_406_cov_176.856678	200	271	106	1	71	0.0140845
NODE_74200_length_406_cov_176.856678	200	271	107	1	71	0.0140845
NODE_74200_length_406_cov_176.856678	200	271	108	8	71	0.1126761
NODE_74200_length_406_cov_176.856678	200	271	109	1	71	0.0140845
NODE_74200_length_406_cov_176.856678	200	271	110	10	71	0.1408451
NODE_74200_length_406_cov_176.856678	200	271	111	3	71	0.0422535
NODE_74200_length_406_cov_176.856678	200	271	112	5	71	0.0704225
NODE_74200_length_406_cov_176.856678	244	321	49	5	77	0.0649351
NODE_74200_length_406_cov_176.856678	244	321	50	2	77	0.0259740
NODE_74200_length_406_cov_176.856678	244	321	51	4	77	0.0519481
NODE_74200_length_406_cov_176.856678	244	321	58	2	77	0.0259740
NODE_74200_length_406_cov_176.856678	244	321	60	3	77	0.0389610
NODE_74200_length_406_cov_176.856678	244	321	61	1	77	0.0129870
NODE_74200_length_406_cov_176.856678	244	321	64	5	77	0.0649351
NODE_74200_length_406_cov_176.856678	244	321	70	2	77	0.0259740
NODE_74200_length_406_cov_176.856678	244	321	72	4	77	0.0519481
NODE_74200_length_406_cov_176.856678	244	321	76	1	77	0.0129870
NODE_74200_length_406_cov_176.856678	244	321	78	4	77	0.0519481
NODE_74200_length_406_cov_176.856678	244	321	80	2	77	0.0259740
NODE_74200_length_406_cov_176.856678	244	321	82	3	77	0.0389610
NODE_74200_length_406_cov_176.856678	244	321	84	1	77	0.0129870
NODE_74200_length_406_cov_176.856678	244	321	86	3	77	0.0389610
NODE_74200_length_406_cov_176.856678	244	321	92	5	77	0.0649351
NODE_74200_length_406_cov_176.856678	244	321	94	9	77	0.1168831
NODE_74200_length_406_cov_176.856678	244	321	95	1	77	0.0129870
NODE_74200_length_406_cov_176.856678	244	321	96	6	77	0.0779221
NODE_74200_length_406_cov_176.856678	244	321	99	3	77	0.0389610
NODE_74200_length_406_cov_176.856678	244	321	103	2	77	0.0259740
NODE_74200_length_406_cov_176.856678	244	321	107	1	77	0.0129870
NODE_74200_length_406_cov_176.856678	244	321	109	1	77	0.0129870
NODE_74200_length_406_cov_176.856678	244	321	111	3	77	0.0389610
NODE_74200_length_406_cov_176.856678	244	321	112	4	77	0.0519481
NODE_74203_length_406_cov_37.723127	15	95	0	77	80	0.9625000
NODE_74203_length_406_cov_37.723127	15	95	4	1	80	0.0125000
NODE_74203_length_406_cov_37.723127	15	95	5	1	80	0.0125000
NODE_74203_length_406_cov_37.723127	15	95	12	1	80	0.0125000
NODE_74219_length_406_cov_4.960912	268	327	2	59	59	1.0000000
NODE_74253_length_406_cov_3.087948	261	302	0	41	41	1.0000000
NODE_74284_length_406_cov_2.475570	220	270	0	50	50	1.0000000
NODE_74332_length_406_cov_1.986971	238	276	2	38	38	1.0000000
NODE_74368_length_406_cov_1.778502	159	195	12	2	36	0.0555556
NODE_74368_length_406_cov_1.778502	159	195	14	18	36	0.5000000
NODE_74368_length_406_cov_1.778502	159	195	16	11	36	0.3055556
NODE_74368_length_406_cov_1.778502	159	195	20	2	36	0.0555556
NODE_74368_length_406_cov_1.778502	159	195	22	3	36	0.0833333
NODE_74368_length_406_cov_1.778502	234	294	17	9	60	0.1500000
NODE_74368_length_406_cov_1.778502	234	294	19	21	60	0.3500000
NODE_74368_length_406_cov_1.778502	234	294	20	10	60	0.1666667
NODE_74368_length_406_cov_1.778502	234	294	21	18	60	0.3000000
NODE_74368_length_406_cov_1.778502	234	294	23	2	60	0.0333333
NODE_74368_length_406_cov_1.778502	267	347	2	13	80	0.1625000
NODE_74368_length_406_cov_1.778502	267	347	4	9	80	0.1125000
NODE_74368_length_406_cov_1.778502	267	347	6	6	80	0.0750000
NODE_74368_length_406_cov_1.778502	267	347	8	6	80	0.0750000
NODE_74368_length_406_cov_1.778502	267	347	12	2	80	0.0250000
NODE_74368_length_406_cov_1.778502	267	347	14	3	80	0.0375000
NODE_74368_length_406_cov_1.778502	267	347	15	8	80	0.1000000
NODE_74368_length_406_cov_1.778502	267	347	17	15	80	0.1875000
NODE_74368_length_406_cov_1.778502	267	347	19	4	80	0.0500000
NODE_74368_length_406_cov_1.778502	267	347	20	10	80	0.1250000
NODE_74368_length_406_cov_1.778502	267	347	21	4	80	0.0500000
NODE_74427_length_406_cov_1.495114	173	212	0	39	39	1.0000000
NODE_74476_length_406_cov_1.325733	367	398	0	31	31	1.0000000
NODE_74588_length_406_cov_0.934853	1	32	0	31	31	1.0000000
NODE_74588_length_406_cov_0.934853	5	85	0	80	80	1.0000000
NODE_74696_length_405_cov_5.107843	332	380	0	48	48	1.0000000
NODE_74697_length_405_cov_4.915033	15	46	0	31	31	1.0000000
NODE_74727_length_405_cov_3.346405	195	240	8	14	45	0.3111111
NODE_74727_length_405_cov_3.346405	195	240	10	20	45	0.4444444
NODE_74727_length_405_cov_3.346405	195	240	12	11	45	0.2444444
NODE_74727_length_405_cov_3.346405	274	329	0	30	55	0.5454546
NODE_74727_length_405_cov_3.346405	274	329	2	25	55	0.4545455
NODE_74737_length_405_cov_3.124183	210	260	0	42	50	0.8400000
NODE_74737_length_405_cov_3.124183	210	260	2	8	50	0.1600000
NODE_74737_length_405_cov_3.124183	240	286	0	12	46	0.2608696
NODE_74737_length_405_cov_3.124183	240	286	2	34	46	0.7391304
NODE_74737_length_405_cov_3.124183	260	339	2	79	79	1.0000000
NODE_74737_length_405_cov_3.124183	272	339	2	67	67	1.0000000
NODE_74780_length_405_cov_2.503268	352	399	0	47	47	1.0000000
NODE_74787_length_405_cov_2.460784	0	73	0	73	73	1.0000000
NODE_75145_length_405_cov_0.666667	207	268	0	61	61	1.0000000
NODE_75196_length_404_cov_40.937705	40	120	0	80	80	1.0000000
NODE_75196_length_404_cov_40.937705	93	173	0	80	80	1.0000000
NODE_75197_length_404_cov_32.940984	46	126	0	80	80	1.0000000
NODE_75197_length_404_cov_32.940984	99	179	0	80	80	1.0000000
NODE_75197_length_404_cov_32.940984	175	255	0	12	80	0.1500000
NODE_75197_length_404_cov_32.940984	175	255	6	68	80	0.8500000
NODE_75197_length_404_cov_32.940984	228	308	0	34	80	0.4250000
NODE_75197_length_404_cov_32.940984	228	308	6	46	80	0.5750000
NODE_75198_length_404_cov_11.731148	130	210	0	15	80	0.1875000
NODE_75198_length_404_cov_11.731148	130	210	2	21	80	0.2625000
NODE_75198_length_404_cov_11.731148	130	210	4	44	80	0.5500000
NODE_75198_length_404_cov_11.731148	183	263	2	23	80	0.2875000
NODE_75198_length_404_cov_11.731148	183	263	4	57	80	0.7125000
NODE_75200_length_404_cov_9.170492	201	257	0	56	56	1.0000000
NODE_75236_length_404_cov_3.613115	323	385	0	62	62	1.0000000
NODE_75259_length_404_cov_2.914754	181	261	0	80	80	1.0000000
NODE_75345_length_404_cov_2.085246	245	325	0	25	80	0.3125000
NODE_75345_length_404_cov_2.085246	245	325	2	55	80	0.6875000
NODE_75357_length_404_cov_1.993443	95	148	0	53	53	1.0000000
NODE_75399_length_404_cov_1.672131	32	106	0	74	74	1.0000000
NODE_75440_length_404_cov_1.498361	94	174	7	5	80	0.0625000
NODE_75440_length_404_cov_1.498361	94	174	8	31	80	0.3875000
NODE_75440_length_404_cov_1.498361	94	174	10	36	80	0.4500000
NODE_75440_length_404_cov_1.498361	94	174	12	8	80	0.1000000
NODE_75446_length_404_cov_1.485246	234	282	8	48	48	1.0000000
NODE_75545_length_404_cov_1.121311	114	194	6	16	80	0.2000000
NODE_75545_length_404_cov_1.121311	114	194	8	1	80	0.0125000
NODE_75545_length_404_cov_1.121311	114	194	10	63	80	0.7875000
NODE_75750_length_403_cov_7.325658	80	146	0	66	66	1.0000000
NODE_75750_length_403_cov_7.325658	165	234	0	69	69	1.0000000
NODE_75750_length_403_cov_7.325658	215	255	0	40	40	1.0000000
NODE_75751_length_403_cov_7.217105	207	284	0	77	77	1.0000000
NODE_75751_length_403_cov_7.217105	257	334	0	77	77	1.0000000
NODE_75752_length_403_cov_6.776316	192	250	2	10	58	0.1724138
NODE_75752_length_403_cov_6.776316	192	250	4	12	58	0.2068966
NODE_75752_length_403_cov_6.776316	192	250	6	36	58	0.6206896
NODE_75788_length_403_cov_3.710526	327	373	0	46	46	1.0000000
NODE_75788_length_403_cov_3.710526	346	403	0	57	57	1.0000000
NODE_75793_length_403_cov_3.611842	283	363	18	41	80	0.5125000
NODE_75793_length_403_cov_3.611842	283	363	19	12	80	0.1500000
NODE_75793_length_403_cov_3.611842	283	363	20	18	80	0.2250000
NODE_75793_length_403_cov_3.611842	283	363	25	9	80	0.1125000
NODE_75824_length_403_cov_2.822368	201	282	4	12	81	0.1481481
NODE_75824_length_403_cov_2.822368	201	282	6	1	81	0.0123457
NODE_75824_length_403_cov_2.822368	201	282	10	36	81	0.4444444
NODE_75824_length_403_cov_2.822368	201	282	12	32	81	0.3950617
NODE_75871_length_403_cov_2.082237	102	145	0	43	43	1.0000000
NODE_75908_length_403_cov_1.871711	130	166	0	36	36	1.0000000
NODE_75993_length_403_cov_1.398026	79	116	0	37	37	1.0000000
NODE_76029_length_403_cov_1.269737	82	111	0	29	29	1.0000000
NODE_76239_length_402_cov_6.293729	217	297	0	31	80	0.3875000
NODE_76239_length_402_cov_6.293729	217	297	2	49	80	0.6125000
NODE_76239_length_402_cov_6.293729	270	350	0	80	80	1.0000000
NODE_76246_length_402_cov_5.227723	176	236	10	4	60	0.0666667
NODE_76246_length_402_cov_5.227723	176	236	12	56	60	0.9333333
NODE_76261_length_402_cov_4.356436	44	123	0	79	79	1.0000000
NODE_76261_length_402_cov_4.356436	119	199	0	4	80	0.0500000
NODE_76261_length_402_cov_4.356436	119	199	2	15	80	0.1875000
NODE_76261_length_402_cov_4.356436	119	199	3	3	80	0.0375000
NODE_76261_length_402_cov_4.356436	119	199	4	17	80	0.2125000
NODE_76261_length_402_cov_4.356436	119	199	8	3	80	0.0375000
NODE_76261_length_402_cov_4.356436	119	199	9	9	80	0.1125000
NODE_76261_length_402_cov_4.356436	119	199	11	29	80	0.3625000
NODE_76261_length_402_cov_4.356436	172	252	11	36	80	0.4500000
NODE_76261_length_402_cov_4.356436	172	252	12	5	80	0.0625000
NODE_76261_length_402_cov_4.356436	172	252	13	4	80	0.0500000
NODE_76261_length_402_cov_4.356436	172	252	14	9	80	0.1125000
NODE_76261_length_402_cov_4.356436	172	252	16	26	80	0.3250000
NODE_76276_length_402_cov_3.564356	197	257	0	16	60	0.2666667
NODE_76276_length_402_cov_3.564356	197	257	4	4	60	0.0666667
NODE_76276_length_402_cov_3.564356	197	257	6	40	60	0.6666667
NODE_76276_length_402_cov_3.564356	230	310	2	2	80	0.0250000
NODE_76276_length_402_cov_3.564356	230	310	6	78	80	0.9750000
NODE_76328_length_402_cov_2.633663	335	402	0	67	67	1.0000000
NODE_76336_length_402_cov_2.514851	82	162	4	3	80	0.0375000
NODE_76336_length_402_cov_2.514851	82	162	6	12	80	0.1500000
NODE_76336_length_402_cov_2.514851	82	162	8	3	80	0.0375000
NODE_76336_length_402_cov_2.514851	82	162	10	7	80	0.0875000
NODE_76336_length_402_cov_2.514851	82	162	12	11	80	0.1375000
NODE_76336_length_402_cov_2.514851	82	162	16	1	80	0.0125000
NODE_76336_length_402_cov_2.514851	82	162	20	4	80	0.0500000
NODE_76336_length_402_cov_2.514851	82	162	22	39	80	0.4875000
NODE_76336_length_402_cov_2.514851	135	200	0	28	65	0.4307692
NODE_76336_length_402_cov_2.514851	135	200	2	4	65	0.0615385
NODE_76336_length_402_cov_2.514851	135	200	4	9	65	0.1384615
NODE_76336_length_402_cov_2.514851	135	200	6	12	65	0.1846154
NODE_76336_length_402_cov_2.514851	135	200	8	3	65	0.0461538
NODE_76336_length_402_cov_2.514851	135	200	10	7	65	0.1076923
NODE_76336_length_402_cov_2.514851	135	200	12	2	65	0.0307692
NODE_76380_length_402_cov_2.102310	114	165	0	51	51	1.0000000
NODE_76380_length_402_cov_2.102310	138	195	0	57	57	1.0000000
NODE_76560_length_402_cov_1.214521	0	33	0	33	33	1.0000000
NODE_76646_length_402_cov_1.000000	119	188	0	69	69	1.0000000
NODE_76752_length_402_cov_0.663366	0	46	0	46	46	1.0000000
NODE_76780_length_401_cov_43.675497	285	343	24	11	58	0.1896552
NODE_76780_length_401_cov_43.675497	285	343	26	47	58	0.8103448
NODE_76801_length_401_cov_4.377483	309	389	0	80	80	1.0000000
NODE_76804_length_401_cov_4.241722	125	180	0	55	55	1.0000000
NODE_76808_length_401_cov_4.132450	195	275	6	24	80	0.3000000
NODE_76808_length_401_cov_4.132450	195	275	8	56	80	0.7000000
NODE_76811_length_401_cov_3.973510	138	181	2	43	43	1.0000000
NODE_76828_length_401_cov_3.370861	141	221	0	52	80	0.6500000
NODE_76828_length_401_cov_3.370861	141	221	2	28	80	0.3500000
NODE_76828_length_401_cov_3.370861	194	273	2	79	79	1.0000000
NODE_76830_length_401_cov_3.317881	67	147	0	60	80	0.7500000
NODE_76830_length_401_cov_3.317881	67	147	2	20	80	0.2500000
NODE_76918_length_401_cov_1.937086	160	239	2	12	79	0.1518987
NODE_76918_length_401_cov_1.937086	160	239	4	1	79	0.0126582
NODE_76918_length_401_cov_1.937086	160	239	12	3	79	0.0379747
NODE_76918_length_401_cov_1.937086	160	239	16	40	79	0.5063291
NODE_76918_length_401_cov_1.937086	160	239	18	23	79	0.2911392
NODE_76978_length_401_cov_1.615894	205	269	5	3	64	0.0468750
NODE_76978_length_401_cov_1.615894	205	269	6	4	64	0.0625000
NODE_76978_length_401_cov_1.615894	205	269	8	1	64	0.0156250
NODE_76978_length_401_cov_1.615894	205	269	10	3	64	0.0468750
NODE_76978_length_401_cov_1.615894	205	269	15	1	64	0.0156250
NODE_76978_length_401_cov_1.615894	205	269	20	4	64	0.0625000
NODE_76978_length_401_cov_1.615894	205	269	24	2	64	0.0312500
NODE_76978_length_401_cov_1.615894	205	269	26	2	64	0.0312500
NODE_76978_length_401_cov_1.615894	205	269	32	1	64	0.0156250
NODE_76978_length_401_cov_1.615894	205	269	35	1	64	0.0156250
NODE_76978_length_401_cov_1.615894	205	269	39	1	64	0.0156250
NODE_76978_length_401_cov_1.615894	205	269	41	1	64	0.0156250
NODE_76978_length_401_cov_1.615894	205	269	51	1	64	0.0156250
NODE_76978_length_401_cov_1.615894	205	269	55	1	64	0.0156250
NODE_76978_length_401_cov_1.615894	205	269	56	6	64	0.0937500
NODE_76978_length_401_cov_1.615894	205	269	62	2	64	0.0312500
NODE_76978_length_401_cov_1.615894	205	269	66	2	64	0.0312500
NODE_76978_length_401_cov_1.615894	205	269	68	3	64	0.0468750
NODE_76978_length_401_cov_1.615894	205	269	70	10	64	0.1562500
NODE_76978_length_401_cov_1.615894	205	269	72	2	64	0.0312500
NODE_76978_length_401_cov_1.615894	205	269	73	3	64	0.0468750
NODE_76978_length_401_cov_1.615894	205	269	75	2	64	0.0312500
NODE_76978_length_401_cov_1.615894	205	269	76	1	64	0.0156250
NODE_76978_length_401_cov_1.615894	205	269	79	1	64	0.0156250
NODE_76978_length_401_cov_1.615894	205	269	81	1	64	0.0156250
NODE_76978_length_401_cov_1.615894	205	269	85	3	64	0.0468750
NODE_76978_length_401_cov_1.615894	205	269	87	2	64	0.0312500
NODE_77017_length_401_cov_1.407285	23	92	0	69	69	1.0000000
NODE_77017_length_401_cov_1.407285	76	122	0	46	46	1.0000000
NODE_77236_length_401_cov_0.675497	292	372	0	39	80	0.4875000
NODE_77236_length_401_cov_0.675497	292	372	2	41	80	0.5125000
NODE_77236_length_401_cov_0.675497	345	401	2	56	56	1.0000000
NODE_77284_length_400_cov_40.584718	205	281	0	54	76	0.7105263
NODE_77284_length_400_cov_40.584718	205	281	2	22	76	0.2894737
NODE_77284_length_400_cov_40.584718	254	334	0	12	80	0.1500000
NODE_77284_length_400_cov_40.584718	254	334	2	68	80	0.8500000
NODE_77289_length_400_cov_8.631229	307	372	0	65	65	1.0000000
NODE_77292_length_400_cov_6.850498	281	329	0	48	48	1.0000000
NODE_77322_length_400_cov_4.000000	82	140	6	1	58	0.0172414
NODE_77322_length_400_cov_4.000000	82	140	9	4	58	0.0689655
NODE_77322_length_400_cov_4.000000	82	140	11	11	58	0.1896552
NODE_77322_length_400_cov_4.000000	82	140	13	42	58	0.7241379
NODE_77358_length_400_cov_3.029900	204	284	0	12	80	0.1500000
NODE_77358_length_400_cov_3.029900	204	284	2	12	80	0.1500000
NODE_77358_length_400_cov_3.029900	204	284	4	56	80	0.7000000
NODE_77358_length_400_cov_3.029900	205	231	4	26	26	1.0000000
NODE_77362_length_400_cov_3.009967	146	220	6	35	74	0.4729730
NODE_77362_length_400_cov_3.009967	146	220	8	35	74	0.4729730
NODE_77362_length_400_cov_3.009967	146	220	10	4	74	0.0540541
NODE_77362_length_400_cov_3.009967	195	261	6	28	66	0.4242424
NODE_77362_length_400_cov_3.009967	195	261	8	3	66	0.0454545
NODE_77362_length_400_cov_3.009967	195	261	9	1	66	0.0151515
NODE_77362_length_400_cov_3.009967	195	261	10	34	66	0.5151515
NODE_77363_length_400_cov_2.990033	253	332	42	5	79	0.0632911
NODE_77363_length_400_cov_2.990033	253	332	44	23	79	0.2911392
NODE_77363_length_400_cov_2.990033	253	332	46	2	79	0.0253165
NODE_77363_length_400_cov_2.990033	253	332	48	2	79	0.0253165
NODE_77363_length_400_cov_2.990033	253	332	50	4	79	0.0506329
NODE_77363_length_400_cov_2.990033	253	332	52	8	79	0.1012658
NODE_77363_length_400_cov_2.990033	253	332	54	1	79	0.0126582
NODE_77363_length_400_cov_2.990033	253	332	58	1	79	0.0126582
NODE_77363_length_400_cov_2.990033	253	332	60	3	79	0.0379747
NODE_77363_length_400_cov_2.990033	253	332	64	1	79	0.0126582
NODE_77363_length_400_cov_2.990033	253	332	66	2	79	0.0253165
NODE_77363_length_400_cov_2.990033	253	332	68	3	79	0.0379747
NODE_77363_length_400_cov_2.990033	253	332	70	1	79	0.0126582
NODE_77363_length_400_cov_2.990033	253	332	72	1	79	0.0126582
NODE_77363_length_400_cov_2.990033	253	332	78	2	79	0.0253165
NODE_77363_length_400_cov_2.990033	253	332	80	4	79	0.0506329
NODE_77363_length_400_cov_2.990033	253	332	82	1	79	0.0126582
NODE_77363_length_400_cov_2.990033	253	332	84	6	79	0.0759494
NODE_77363_length_400_cov_2.990033	253	332	86	1	79	0.0126582
NODE_77363_length_400_cov_2.990033	253	332	88	4	79	0.0506329
NODE_77363_length_400_cov_2.990033	253	332	92	4	79	0.0506329
NODE_77363_length_400_cov_2.990033	306	385	66	23	79	0.2911392
NODE_77363_length_400_cov_2.990033	306	385	67	5	79	0.0632911
NODE_77363_length_400_cov_2.990033	306	385	68	2	79	0.0253165
NODE_77363_length_400_cov_2.990033	306	385	69	6	79	0.0759494
NODE_77363_length_400_cov_2.990033	306	385	70	2	79	0.0253165
NODE_77363_length_400_cov_2.990033	306	385	71	3	79	0.0379747
NODE_77363_length_400_cov_2.990033	306	385	72	2	79	0.0253165
NODE_77363_length_400_cov_2.990033	306	385	74	6	79	0.0759494
NODE_77363_length_400_cov_2.990033	306	385	76	3	79	0.0379747
NODE_77363_length_400_cov_2.990033	306	385	78	2	79	0.0253165
NODE_77363_length_400_cov_2.990033	306	385	80	4	79	0.0506329
NODE_77363_length_400_cov_2.990033	306	385	81	1	79	0.0126582
NODE_77363_length_400_cov_2.990033	306	385	82	3	79	0.0379747
NODE_77363_length_400_cov_2.990033	306	385	84	8	79	0.1012658
NODE_77363_length_400_cov_2.990033	306	385	86	1	79	0.0126582
NODE_77363_length_400_cov_2.990033	306	385	88	4	79	0.0506329
NODE_77363_length_400_cov_2.990033	306	385	92	4	79	0.0506329
NODE_77368_length_400_cov_2.860465	365	400	0	35	35	1.0000000
NODE_77371_length_400_cov_2.797342	324	372	0	48	48	1.0000000
NODE_77380_length_400_cov_2.581395	192	254	0	62	62	1.0000000
NODE_77460_length_400_cov_1.940199	225	268	0	43	43	1.0000000
NODE_77460_length_400_cov_1.940199	293	374	0	81	81	1.0000000
NODE_77821_length_399_cov_71.493333	215	295	0	80	80	1.0000000
NODE_77821_length_399_cov_71.493333	268	348	0	80	80	1.0000000
NODE_77823_length_399_cov_7.510000	229	309	0	80	80	1.0000000
NODE_77823_length_399_cov_7.510000	282	362	0	80	80	1.0000000
NODE_77825_length_399_cov_7.310000	125	187	0	62	62	1.0000000
NODE_77854_length_399_cov_4.293333	86	164	2	10	78	0.1282051
NODE_77854_length_399_cov_4.293333	86	164	4	6	78	0.0769231
NODE_77854_length_399_cov_4.293333	86	164	6	11	78	0.1410256
NODE_77854_length_399_cov_4.293333	86	164	8	8	78	0.1025641
NODE_77854_length_399_cov_4.293333	86	164	10	43	78	0.5512820
NODE_77877_length_399_cov_3.406667	51	124	0	73	73	1.0000000
NODE_77933_length_399_cov_2.286667	310	390	0	8	80	0.1000000
NODE_77933_length_399_cov_2.286667	310	390	3	11	80	0.1375000
NODE_77933_length_399_cov_2.286667	310	390	4	61	80	0.7625000
NODE_77966_length_399_cov_1.916667	76	136	0	11	60	0.1833333
NODE_77966_length_399_cov_1.916667	76	136	2	8	60	0.1333333
NODE_77966_length_399_cov_1.916667	76	136	4	5	60	0.0833333
NODE_77966_length_399_cov_1.916667	76	136	6	13	60	0.2166667
NODE_77966_length_399_cov_1.916667	76	136	8	14	60	0.2333333
NODE_77966_length_399_cov_1.916667	76	136	10	3	60	0.0500000
NODE_77966_length_399_cov_1.916667	76	136	12	6	60	0.1000000
NODE_77966_length_399_cov_1.916667	123	189	8	4	66	0.0606061
NODE_77966_length_399_cov_1.916667	123	189	10	14	66	0.2121212
NODE_77966_length_399_cov_1.916667	123	189	12	48	66	0.7272727
NODE_78276_length_399_cov_0.710000	313	392	0	45	79	0.5696203
NODE_78276_length_399_cov_0.710000	313	392	2	34	79	0.4303797
NODE_78354_length_398_cov_9.688963	1	81	0	80	80	1.0000000
NODE_78354_length_398_cov_9.688963	247	327	0	80	80	1.0000000
NODE_78354_length_398_cov_9.688963	300	380	0	80	80	1.0000000
NODE_78360_length_398_cov_6.488294	130	210	0	80	80	1.0000000
NODE_78364_length_398_cov_5.765886	253	333	0	80	80	1.0000000
NODE_78372_length_398_cov_5.244147	248	312	0	10	64	0.1562500
NODE_78372_length_398_cov_5.244147	248	312	1	3	64	0.0468750
NODE_78372_length_398_cov_5.244147	248	312	2	3	64	0.0468750
NODE_78372_length_398_cov_5.244147	248	312	4	48	64	0.7500000
NODE_78376_length_398_cov_5.006689	116	196	2	80	80	1.0000000
NODE_78376_length_398_cov_5.006689	169	251	0	21	82	0.2560976
NODE_78376_length_398_cov_5.006689	169	251	2	61	82	0.7439024
NODE_78383_length_398_cov_4.284281	63	117	0	54	54	1.0000000
NODE_78383_length_398_cov_4.284281	135	160	0	25	25	1.0000000
NODE_78420_length_398_cov_2.993311	229	309	0	80	80	1.0000000
NODE_78429_length_398_cov_2.822742	236	271	0	35	35	1.0000000
NODE_78891_length_397_cov_52.855705	124	204	0	80	80	1.0000000
NODE_78891_length_397_cov_52.855705	177	257	0	80	80	1.0000000
NODE_78894_length_397_cov_35.036913	173	253	0	14	80	0.1750000
NODE_78894_length_397_cov_35.036913	173	253	2	66	80	0.8250000
NODE_78895_length_397_cov_13.667785	94	174	0	80	80	1.0000000
NODE_78895_length_397_cov_13.667785	147	227	0	80	80	1.0000000
NODE_78897_length_397_cov_7.496644	192	272	0	80	80	1.0000000
NODE_78897_length_397_cov_7.496644	245	325	0	80	80	1.0000000
NODE_78898_length_397_cov_6.828859	127	173	0	46	46	1.0000000
NODE_78913_length_397_cov_4.902685	293	364	0	55	71	0.7746479
NODE_78913_length_397_cov_4.902685	293	364	2	16	71	0.2253521
NODE_78933_length_397_cov_3.765101	164	244	0	8	80	0.1000000
NODE_78933_length_397_cov_3.765101	164	244	2	44	80	0.5500000
NODE_78933_length_397_cov_3.765101	164	244	4	28	80	0.3500000
NODE_78951_length_397_cov_3.325503	107	187	0	24	80	0.3000000
NODE_78951_length_397_cov_3.325503	107	187	4	1	80	0.0125000
NODE_78951_length_397_cov_3.325503	107	187	6	55	80	0.6875000
NODE_78951_length_397_cov_3.325503	163	236	0	12	73	0.1643836
NODE_78951_length_397_cov_3.325503	163	236	2	16	73	0.2191781
NODE_78951_length_397_cov_3.325503	163	236	6	45	73	0.6164383
NODE_78999_length_397_cov_2.530201	269	312	0	7	43	0.1627907
NODE_78999_length_397_cov_2.530201	269	312	2	36	43	0.8372093
NODE_79047_length_397_cov_1.959732	154	193	0	39	39	1.0000000
NODE_79072_length_397_cov_1.791946	218	283	0	22	65	0.3384615
NODE_79072_length_397_cov_1.791946	218	283	1	2	65	0.0307692
NODE_79072_length_397_cov_1.791946	218	283	2	3	65	0.0461538
NODE_79072_length_397_cov_1.791946	218	283	4	2	65	0.0307692
NODE_79072_length_397_cov_1.791946	218	283	6	9	65	0.1384615
NODE_79072_length_397_cov_1.791946	218	283	8	10	65	0.1538462
NODE_79072_length_397_cov_1.791946	218	283	10	17	65	0.2615385
NODE_79127_length_397_cov_1.560403	183	240	0	57	57	1.0000000
NODE_79456_length_396_cov_11.632997	162	242	0	80	80	1.0000000
NODE_79456_length_396_cov_11.632997	215	295	0	80	80	1.0000000
NODE_79460_length_396_cov_7.053872	71	101	0	30	30	1.0000000
NODE_79464_length_396_cov_6.097643	229	309	0	80	80	1.0000000
NODE_79464_length_396_cov_6.097643	282	362	0	80	80	1.0000000
NODE_79471_length_396_cov_5.484848	125	205	11	1	80	0.0125000
NODE_79471_length_396_cov_5.484848	125	205	12	6	80	0.0750000
NODE_79471_length_396_cov_5.484848	125	205	14	42	80	0.5250000
NODE_79471_length_396_cov_5.484848	125	205	18	31	80	0.3875000
NODE_79471_length_396_cov_5.484848	178	259	4	4	81	0.0493827
NODE_79471_length_396_cov_5.484848	178	259	10	37	81	0.4567901
NODE_79471_length_396_cov_5.484848	178	259	12	15	81	0.1851852
NODE_79471_length_396_cov_5.484848	178	259	14	1	81	0.0123457
NODE_79471_length_396_cov_5.484848	178	259	18	24	81	0.2962963
NODE_79473_length_396_cov_5.434343	224	275	0	6	51	0.1176471
NODE_79473_length_396_cov_5.434343	224	275	2	41	51	0.8039216
NODE_79473_length_396_cov_5.434343	224	275	4	4	51	0.0784314
NODE_79473_length_396_cov_5.434343	272	331	4	48	59	0.8135593
NODE_79473_length_396_cov_5.434343	272	331	6	11	59	0.1864407
NODE_79483_length_396_cov_4.414141	189	264	2	75	75	1.0000000
NODE_79483_length_396_cov_4.414141	241	317	0	36	76	0.4736842
NODE_79483_length_396_cov_4.414141	241	317	1	13	76	0.1710526
NODE_79483_length_396_cov_4.414141	241	317	2	27	76	0.3552631
NODE_79493_length_396_cov_4.010101	163	205	0	42	42	1.0000000
NODE_79522_length_396_cov_3.080808	95	161	0	66	66	1.0000000
NODE_79524_length_396_cov_3.067340	252	316	0	35	64	0.5468750
NODE_79524_length_396_cov_3.067340	252	316	2	12	64	0.1875000
NODE_79524_length_396_cov_3.067340	252	316	4	6	64	0.0937500
NODE_79524_length_396_cov_3.067340	252	316	6	11	64	0.1718750
NODE_79535_length_396_cov_2.892256	136	217	0	2	81	0.0246914
NODE_79535_length_396_cov_2.892256	136	217	2	29	81	0.3580247
NODE_79535_length_396_cov_2.892256	136	217	4	50	81	0.6172839
NODE_79557_length_396_cov_2.710438	88	168	9	4	80	0.0500000
NODE_79557_length_396_cov_2.710438	88	168	10	3	80	0.0375000
NODE_79557_length_396_cov_2.710438	88	168	11	8	80	0.1000000
NODE_79557_length_396_cov_2.710438	88	168	13	6	80	0.0750000
NODE_79557_length_396_cov_2.710438	88	168	14	1	80	0.0125000
NODE_79557_length_396_cov_2.710438	88	168	16	1	80	0.0125000
NODE_79557_length_396_cov_2.710438	88	168	18	4	80	0.0500000
NODE_79557_length_396_cov_2.710438	88	168	20	3	80	0.0375000
NODE_79557_length_396_cov_2.710438	88	168	22	5	80	0.0625000
NODE_79557_length_396_cov_2.710438	88	168	24	6	80	0.0750000
NODE_79557_length_396_cov_2.710438	88	168	26	2	80	0.0250000
NODE_79557_length_396_cov_2.710438	88	168	30	37	80	0.4625000
NODE_79561_length_396_cov_2.680135	297	335	0	38	38	1.0000000
NODE_79562_length_396_cov_2.659933	68	148	0	80	80	1.0000000
NODE_79562_length_396_cov_2.659933	121	168	0	47	47	1.0000000
NODE_79616_length_396_cov_2.060606	308	388	0	12	80	0.1500000
NODE_79616_length_396_cov_2.060606	308	388	1	1	80	0.0125000
NODE_79616_length_396_cov_2.060606	308	388	2	67	80	0.8375000
NODE_79643_length_396_cov_1.939394	63	142	6	2	79	0.0253165
NODE_79643_length_396_cov_1.939394	63	142	8	2	79	0.0253165
NODE_79643_length_396_cov_1.939394	63	142	10	1	79	0.0126582
NODE_79643_length_396_cov_1.939394	63	142	12	28	79	0.3544304
NODE_79643_length_396_cov_1.939394	63	142	13	1	79	0.0126582
NODE_79643_length_396_cov_1.939394	63	142	14	45	79	0.5696203
NODE_79643_length_396_cov_1.939394	115	164	6	1	49	0.0204082
NODE_79643_length_396_cov_1.939394	115	164	10	9	49	0.1836735
NODE_79643_length_396_cov_1.939394	115	164	12	18	49	0.3673469
NODE_79643_length_396_cov_1.939394	115	164	14	21	49	0.4285714
NODE_79683_length_396_cov_1.811448	82	162	0	80	80	1.0000000
NODE_79692_length_396_cov_1.734007	88	119	2	31	31	1.0000000
NODE_79930_length_396_cov_0.905724	101	151	11	15	50	0.3000000
NODE_79930_length_396_cov_0.905724	101	151	13	22	50	0.4400000
NODE_79930_length_396_cov_0.905724	101	151	15	13	50	0.2600000
NODE_80057_length_395_cov_449.327703	0	79	21	1	79	0.0126582
NODE_80057_length_395_cov_449.327703	0	79	31	1	79	0.0126582
NODE_80057_length_395_cov_449.327703	0	79	35	1	79	0.0126582
NODE_80057_length_395_cov_449.327703	0	79	39	1	79	0.0126582
NODE_80057_length_395_cov_449.327703	0	79	46	1	79	0.0126582
NODE_80057_length_395_cov_449.327703	0	79	61	1	79	0.0126582
NODE_80057_length_395_cov_449.327703	0	79	66	3	79	0.0379747
NODE_80057_length_395_cov_449.327703	0	79	69	1	79	0.0126582
NODE_80057_length_395_cov_449.327703	0	79	76	1	79	0.0126582
NODE_80057_length_395_cov_449.327703	0	79	79	1	79	0.0126582
NODE_80057_length_395_cov_449.327703	0	79	84	2	79	0.0253165
NODE_80057_length_395_cov_449.327703	0	79	85	1	79	0.0126582
NODE_80057_length_395_cov_449.327703	0	79	88	1	79	0.0126582
NODE_80057_length_395_cov_449.327703	0	79	95	1	79	0.0126582
NODE_80057_length_395_cov_449.327703	0	79	97	2	79	0.0253165
NODE_80057_length_395_cov_449.327703	0	79	100	1	79	0.0126582
NODE_80057_length_395_cov_449.327703	0	79	105	1	79	0.0126582
NODE_80057_length_395_cov_449.327703	0	79	106	1	79	0.0126582
NODE_80057_length_395_cov_449.327703	0	79	109	1	79	0.0126582
NODE_80057_length_395_cov_449.327703	0	79	122	1	79	0.0126582
NODE_80057_length_395_cov_449.327703	0	79	130	1	79	0.0126582
NODE_80057_length_395_cov_449.327703	0	79	136	2	79	0.0253165
NODE_80057_length_395_cov_449.327703	0	79	143	1	79	0.0126582
NODE_80057_length_395_cov_449.327703	0	79	149	1	79	0.0126582
NODE_80057_length_395_cov_449.327703	0	79	160	1	79	0.0126582
NODE_80057_length_395_cov_449.327703	0	79	162	1	79	0.0126582
NODE_80057_length_395_cov_449.327703	0	79	164	1	79	0.0126582
NODE_80057_length_395_cov_449.327703	0	79	165	1	79	0.0126582
NODE_80057_length_395_cov_449.327703	0	79	172	1	79	0.0126582
NODE_80057_length_395_cov_449.327703	0	79	174	2	79	0.0253165
NODE_80057_length_395_cov_449.327703	0	79	177	1	79	0.0126582
NODE_80057_length_395_cov_449.327703	0	79	181	1	79	0.0126582
NODE_80057_length_395_cov_449.327703	0	79	182	1	79	0.0126582
NODE_80057_length_395_cov_449.327703	0	79	186	2	79	0.0253165
NODE_80057_length_395_cov_449.327703	0	79	194	1	79	0.0126582
NODE_80057_length_395_cov_449.327703	0	79	198	1	79	0.0126582
NODE_80057_length_395_cov_449.327703	0	79	202	1	79	0.0126582
NODE_80057_length_395_cov_449.327703	0	79	206	2	79	0.0253165
NODE_80057_length_395_cov_449.327703	0	79	217	1	79	0.0126582
NODE_80057_length_395_cov_449.327703	0	79	220	1	79	0.0126582
NODE_80057_length_395_cov_449.327703	0	79	224	3	79	0.0379747
NODE_80057_length_395_cov_449.327703	0	79	226	1	79	0.0126582
NODE_80057_length_395_cov_449.327703	0	79	232	2	79	0.0253165
NODE_80057_length_395_cov_449.327703	0	79	235	2	79	0.0253165
NODE_80057_length_395_cov_449.327703	0	79	236	1	79	0.0126582
NODE_80057_length_395_cov_449.327703	0	79	240	3	79	0.0379747
NODE_80057_length_395_cov_449.327703	0	79	246	1	79	0.0126582
NODE_80057_length_395_cov_449.327703	0	79	247	2	79	0.0253165
NODE_80057_length_395_cov_449.327703	0	79	251	2	79	0.0253165
NODE_80057_length_395_cov_449.327703	0	79	253	1	79	0.0126582
NODE_80057_length_395_cov_449.327703	0	79	257	1	79	0.0126582
NODE_80057_length_395_cov_449.327703	0	79	262	2	79	0.0253165
NODE_80057_length_395_cov_449.327703	0	79	265	1	79	0.0126582
NODE_80057_length_395_cov_449.327703	0	79	267	1	79	0.0126582
NODE_80057_length_395_cov_449.327703	0	79	269	2	79	0.0253165
NODE_80057_length_395_cov_449.327703	0	79	271	1	79	0.0126582
NODE_80057_length_395_cov_449.327703	0	79	272	1	79	0.0126582
NODE_80057_length_395_cov_449.327703	0	79	284	2	79	0.0253165
NODE_80057_length_395_cov_449.327703	0	79	287	1	79	0.0126582
NODE_80057_length_395_cov_449.327703	0	79	293	1	79	0.0126582
NODE_80058_length_395_cov_13.695946	113	193	0	80	80	1.0000000
NODE_80058_length_395_cov_13.695946	166	246	0	80	80	1.0000000
NODE_80086_length_395_cov_4.179054	152	232	3	30	80	0.3750000
NODE_80086_length_395_cov_4.179054	152	232	4	2	80	0.0250000
NODE_80086_length_395_cov_4.179054	152	232	6	11	80	0.1375000
NODE_80086_length_395_cov_4.179054	152	232	16	15	80	0.1875000
NODE_80086_length_395_cov_4.179054	152	232	25	22	80	0.2750000
NODE_80116_length_395_cov_2.962838	118	198	0	80	80	1.0000000
NODE_80116_length_395_cov_2.962838	171	237	0	60	66	0.9090909
NODE_80116_length_395_cov_2.962838	171	237	2	6	66	0.0909091
NODE_80121_length_395_cov_2.878378	261	301	2	40	40	1.0000000
NODE_80139_length_395_cov_2.587838	111	188	0	12	77	0.1558442
NODE_80139_length_395_cov_2.587838	111	188	1	8	77	0.1038961
NODE_80139_length_395_cov_2.587838	111	188	2	37	77	0.4805195
NODE_80139_length_395_cov_2.587838	111	188	4	5	77	0.0649351
NODE_80139_length_395_cov_2.587838	111	188	6	15	77	0.1948052
NODE_80139_length_395_cov_2.587838	232	301	4	69	69	1.0000000
NODE_80139_length_395_cov_2.587838	258	302	4	44	44	1.0000000
NODE_80141_length_395_cov_2.560811	123	187	0	64	64	1.0000000
NODE_80146_length_395_cov_2.527027	194	274	0	80	80	1.0000000
NODE_80146_length_395_cov_2.527027	247	327	0	80	80	1.0000000
NODE_80439_length_395_cov_1.033784	103	151	2	48	48	1.0000000
NODE_80448_length_395_cov_1.010135	85	105	0	11	20	0.5500000
NODE_80448_length_395_cov_1.010135	85	105	2	9	20	0.4500000
NODE_80639_length_394_cov_9.464407	211	291	0	80	80	1.0000000
NODE_80639_length_394_cov_9.464407	264	344	0	80	80	1.0000000
NODE_80643_length_394_cov_7.437288	221	301	0	9	80	0.1125000
NODE_80643_length_394_cov_7.437288	221	301	2	71	80	0.8875000
NODE_80643_length_394_cov_7.437288	274	331	0	5	57	0.0877193
NODE_80643_length_394_cov_7.437288	274	331	2	52	57	0.9122807
NODE_80647_length_394_cov_6.444068	187	267	0	75	80	0.9375000
NODE_80647_length_394_cov_6.444068	187	267	2	5	80	0.0625000
NODE_80647_length_394_cov_6.444068	240	320	0	22	80	0.2750000
NODE_80647_length_394_cov_6.444068	240	320	2	58	80	0.7250000
NODE_80709_length_394_cov_2.932203	119	140	0	21	21	1.0000000
NODE_80710_length_394_cov_2.894915	79	135	0	48	56	0.8571429
NODE_80710_length_394_cov_2.894915	79	135	2	8	56	0.1428571
NODE_80710_length_394_cov_2.894915	166	202	0	5	36	0.1388889
NODE_80710_length_394_cov_2.894915	166	202	2	31	36	0.8611111
NODE_81216_length_393_cov_4.261905	201	267	0	66	66	1.0000000
NODE_81216_length_393_cov_4.261905	240	282	0	42	42	1.0000000
NODE_81240_length_393_cov_3.503401	121	201	0	80	80	1.0000000
NODE_81240_length_393_cov_3.503401	174	246	0	72	72	1.0000000
NODE_81277_length_393_cov_2.704082	198	271	0	73	73	1.0000000
NODE_81289_length_393_cov_2.493197	136	216	0	80	80	1.0000000
NODE_81289_length_393_cov_2.493197	189	269	0	80	80	1.0000000
NODE_81296_length_393_cov_2.360544	195	252	0	57	57	1.0000000
NODE_81416_length_393_cov_1.608844	207	270	0	63	63	1.0000000
NODE_81778_length_392_cov_7.873720	161	241	0	80	80	1.0000000
NODE_81778_length_392_cov_7.873720	214	294	0	80	80	1.0000000
NODE_81790_length_392_cov_5.262799	218	248	0	30	30	1.0000000
NODE_81805_length_392_cov_3.655290	109	157	2	48	48	1.0000000
NODE_81805_length_392_cov_3.655290	306	386	0	80	80	1.0000000
NODE_81823_length_392_cov_3.197952	102	171	0	35	69	0.5072464
NODE_81823_length_392_cov_3.197952	102	171	2	17	69	0.2463768
NODE_81823_length_392_cov_3.197952	102	171	4	9	69	0.1304348
NODE_81823_length_392_cov_3.197952	102	171	6	8	69	0.1159420
NODE_81823_length_392_cov_3.197952	233	314	0	5	81	0.0617284
NODE_81823_length_392_cov_3.197952	233	314	2	76	81	0.9382716
NODE_81857_length_392_cov_2.511945	67	133	30	2	66	0.0303030
NODE_81857_length_392_cov_2.511945	67	133	36	4	66	0.0606061
NODE_81857_length_392_cov_2.511945	67	133	42	5	66	0.0757576
NODE_81857_length_392_cov_2.511945	67	133	44	1	66	0.0151515
NODE_81857_length_392_cov_2.511945	67	133	48	4	66	0.0606061
NODE_81857_length_392_cov_2.511945	67	133	50	2	66	0.0303030
NODE_81857_length_392_cov_2.511945	67	133	53	1	66	0.0151515
NODE_81857_length_392_cov_2.511945	67	133	54	1	66	0.0151515
NODE_81857_length_392_cov_2.511945	67	133	56	1	66	0.0151515
NODE_81857_length_392_cov_2.511945	67	133	58	1	66	0.0151515
NODE_81857_length_392_cov_2.511945	67	133	60	2	66	0.0303030
NODE_81857_length_392_cov_2.511945	67	133	64	1	66	0.0151515
NODE_81857_length_392_cov_2.511945	67	133	68	2	66	0.0303030
NODE_81857_length_392_cov_2.511945	67	133	70	2	66	0.0303030
NODE_81857_length_392_cov_2.511945	67	133	74	2	66	0.0303030
NODE_81857_length_392_cov_2.511945	67	133	76	1	66	0.0151515
NODE_81857_length_392_cov_2.511945	67	133	78	5	66	0.0757576
NODE_81857_length_392_cov_2.511945	67	133	80	3	66	0.0454545
NODE_81857_length_392_cov_2.511945	67	133	82	6	66	0.0909091
NODE_81857_length_392_cov_2.511945	67	133	83	3	66	0.0454545
NODE_81857_length_392_cov_2.511945	67	133	85	3	66	0.0454545
NODE_81857_length_392_cov_2.511945	67	133	87	2	66	0.0303030
NODE_81857_length_392_cov_2.511945	67	133	89	2	66	0.0303030
NODE_81857_length_392_cov_2.511945	67	133	91	1	66	0.0151515
NODE_81857_length_392_cov_2.511945	67	133	93	1	66	0.0151515
NODE_81857_length_392_cov_2.511945	67	133	95	1	66	0.0151515
NODE_81857_length_392_cov_2.511945	67	133	101	1	66	0.0151515
NODE_81857_length_392_cov_2.511945	67	133	103	2	66	0.0303030
NODE_81857_length_392_cov_2.511945	67	133	105	2	66	0.0303030
NODE_81857_length_392_cov_2.511945	67	133	107	1	66	0.0151515
NODE_81857_length_392_cov_2.511945	67	133	109	1	66	0.0151515
NODE_81857_length_392_cov_2.511945	120	206	87	1	86	0.0116279
NODE_81857_length_392_cov_2.511945	120	206	89	2	86	0.0232558
NODE_81857_length_392_cov_2.511945	120	206	91	1	86	0.0116279
NODE_81857_length_392_cov_2.511945	120	206	93	1	86	0.0116279
NODE_81857_length_392_cov_2.511945	120	206	95	1	86	0.0116279
NODE_81857_length_392_cov_2.511945	120	206	101	1	86	0.0116279
NODE_81857_length_392_cov_2.511945	120	206	103	2	86	0.0232558
NODE_81857_length_392_cov_2.511945	120	206	105	2	86	0.0232558
NODE_81857_length_392_cov_2.511945	120	206	107	1	86	0.0116279
NODE_81857_length_392_cov_2.511945	120	206	109	1	86	0.0116279
NODE_81857_length_392_cov_2.511945	120	206	118	1	86	0.0116279
NODE_81857_length_392_cov_2.511945	120	206	122	1	86	0.0116279
NODE_81857_length_392_cov_2.511945	120	206	128	1	86	0.0116279
NODE_81857_length_392_cov_2.511945	120	206	129	3	86	0.0348837
NODE_81857_length_392_cov_2.511945	120	206	131	4	86	0.0465116
NODE_81857_length_392_cov_2.511945	120	206	132	1	86	0.0116279
NODE_81857_length_392_cov_2.511945	120	206	133	1	86	0.0116279
NODE_81857_length_392_cov_2.511945	120	206	134	1	86	0.0116279
NODE_81857_length_392_cov_2.511945	120	206	135	1	86	0.0116279
NODE_81857_length_392_cov_2.511945	120	206	136	4	86	0.0465116
NODE_81857_length_392_cov_2.511945	120	206	138	1	86	0.0116279
NODE_81857_length_392_cov_2.511945	120	206	140	8	86	0.0930233
NODE_81857_length_392_cov_2.511945	120	206	141	1	86	0.0116279
NODE_81857_length_392_cov_2.511945	120	206	145	4	86	0.0465116
NODE_81857_length_392_cov_2.511945	120	206	146	1	86	0.0116279
NODE_81857_length_392_cov_2.511945	120	206	147	3	86	0.0348837
NODE_81857_length_392_cov_2.511945	120	206	152	1	86	0.0116279
NODE_81857_length_392_cov_2.511945	120	206	157	1	86	0.0116279
NODE_81857_length_392_cov_2.511945	120	206	160	2	86	0.0232558
NODE_81857_length_392_cov_2.511945	120	206	161	6	86	0.0697674
NODE_81857_length_392_cov_2.511945	120	206	162	5	86	0.0581395
NODE_81857_length_392_cov_2.511945	120	206	164	5	86	0.0581395
NODE_81857_length_392_cov_2.511945	120	206	165	1	86	0.0116279
NODE_81857_length_392_cov_2.511945	120	206	167	1	86	0.0116279
NODE_81857_length_392_cov_2.511945	120	206	169	5	86	0.0581395
NODE_81857_length_392_cov_2.511945	120	206	171	10	86	0.1162791
NODE_81914_length_392_cov_2.075085	268	349	2	9	81	0.1111111
NODE_81914_length_392_cov_2.075085	268	349	4	10	81	0.1234568
NODE_81914_length_392_cov_2.075085	268	349	6	56	81	0.6913580
NODE_81914_length_392_cov_2.075085	268	349	8	6	81	0.0740741
NODE_81914_length_392_cov_2.075085	322	387	6	65	65	1.0000000
NODE_81928_length_392_cov_1.955631	11	56	0	45	45	1.0000000
NODE_81929_length_392_cov_1.952218	40	59	0	19	19	1.0000000
NODE_81940_length_392_cov_1.911263	238	315	0	77	77	1.0000000
NODE_81994_length_392_cov_1.631399	114	139	12	1	25	0.0400000
NODE_81994_length_392_cov_1.631399	114	139	18	9	25	0.3600000
NODE_81994_length_392_cov_1.631399	114	139	22	1	25	0.0400000
NODE_81994_length_392_cov_1.631399	114	139	26	1	25	0.0400000
NODE_81994_length_392_cov_1.631399	114	139	28	1	25	0.0400000
NODE_81994_length_392_cov_1.631399	114	139	32	5	25	0.2000000
NODE_81994_length_392_cov_1.631399	114	139	34	7	25	0.2800000
NODE_82008_length_392_cov_1.559727	83	163	2	7	80	0.0875000
NODE_82008_length_392_cov_1.559727	83	163	4	72	80	0.9000000
NODE_82008_length_392_cov_1.559727	83	163	6	1	80	0.0125000
NODE_82015_length_392_cov_1.552901	32	52	0	20	20	1.0000000
NODE_82390_length_391_cov_69.510274	9	89	54	1	80	0.0125000
NODE_82390_length_391_cov_69.510274	9	89	68	1	80	0.0125000
NODE_82390_length_391_cov_69.510274	9	89	71	1	80	0.0125000
NODE_82390_length_391_cov_69.510274	9	89	77	1	80	0.0125000
NODE_82390_length_391_cov_69.510274	9	89	87	1	80	0.0125000
NODE_82390_length_391_cov_69.510274	9	89	91	1	80	0.0125000
NODE_82390_length_391_cov_69.510274	9	89	106	5	80	0.0625000
NODE_82390_length_391_cov_69.510274	9	89	116	2	80	0.0250000
NODE_82390_length_391_cov_69.510274	9	89	118	1	80	0.0125000
NODE_82390_length_391_cov_69.510274	9	89	120	1	80	0.0125000
NODE_82390_length_391_cov_69.510274	9	89	126	1	80	0.0125000
NODE_82390_length_391_cov_69.510274	9	89	128	1	80	0.0125000
NODE_82390_length_391_cov_69.510274	9	89	137	1	80	0.0125000
NODE_82390_length_391_cov_69.510274	9	89	139	1	80	0.0125000
NODE_82390_length_391_cov_69.510274	9	89	143	1	80	0.0125000
NODE_82390_length_391_cov_69.510274	9	89	146	2	80	0.0250000
NODE_82390_length_391_cov_69.510274	9	89	162	2	80	0.0250000
NODE_82390_length_391_cov_69.510274	9	89	163	1	80	0.0125000
NODE_82390_length_391_cov_69.510274	9	89	167	1	80	0.0125000
NODE_82390_length_391_cov_69.510274	9	89	171	1	80	0.0125000
NODE_82390_length_391_cov_69.510274	9	89	175	1	80	0.0125000
NODE_82390_length_391_cov_69.510274	9	89	181	2	80	0.0250000
NODE_82390_length_391_cov_69.510274	9	89	185	1	80	0.0125000
NODE_82390_length_391_cov_69.510274	9	89	189	1	80	0.0125000
NODE_82390_length_391_cov_69.510274	9	89	192	1	80	0.0125000
NODE_82390_length_391_cov_69.510274	9	89	198	1	80	0.0125000
NODE_82390_length_391_cov_69.510274	9	89	201	1	80	0.0125000
NODE_82390_length_391_cov_69.510274	9	89	203	1	80	0.0125000
NODE_82390_length_391_cov_69.510274	9	89	205	1	80	0.0125000
NODE_82390_length_391_cov_69.510274	9	89	207	1	80	0.0125000
NODE_82390_length_391_cov_69.510274	9	89	215	1	80	0.0125000
NODE_82390_length_391_cov_69.510274	9	89	219	1	80	0.0125000
NODE_82390_length_391_cov_69.510274	9	89	230	1	80	0.0125000
NODE_82390_length_391_cov_69.510274	9	89	231	1	80	0.0125000
NODE_82390_length_391_cov_69.510274	9	89	237	1	80	0.0125000
NODE_82390_length_391_cov_69.510274	9	89	241	1	80	0.0125000
NODE_82390_length_391_cov_69.510274	9	89	253	5	80	0.0625000
NODE_82390_length_391_cov_69.510274	9	89	256	1	80	0.0125000
NODE_82390_length_391_cov_69.510274	9	89	258	2	80	0.0250000
NODE_82390_length_391_cov_69.510274	9	89	260	2	80	0.0250000
NODE_82390_length_391_cov_69.510274	9	89	262	1	80	0.0125000
NODE_82390_length_391_cov_69.510274	9	89	266	1	80	0.0125000
NODE_82390_length_391_cov_69.510274	9	89	276	1	80	0.0125000
NODE_82390_length_391_cov_69.510274	9	89	280	1	80	0.0125000
NODE_82390_length_391_cov_69.510274	9	89	283	1	80	0.0125000
NODE_82390_length_391_cov_69.510274	9	89	284	2	80	0.0250000
NODE_82390_length_391_cov_69.510274	9	89	286	1	80	0.0125000
NODE_82390_length_391_cov_69.510274	9	89	287	1	80	0.0125000
NODE_82390_length_391_cov_69.510274	9	89	291	1	80	0.0125000
NODE_82390_length_391_cov_69.510274	9	89	293	1	80	0.0125000
NODE_82390_length_391_cov_69.510274	9	89	294	1	80	0.0125000
NODE_82390_length_391_cov_69.510274	9	89	301	1	80	0.0125000
NODE_82390_length_391_cov_69.510274	9	89	305	6	80	0.0750000
NODE_82390_length_391_cov_69.510274	9	89	307	3	80	0.0375000
NODE_82390_length_391_cov_69.510274	9	89	311	2	80	0.0250000
NODE_82390_length_391_cov_69.510274	9	89	313	1	80	0.0125000
NODE_82390_length_391_cov_69.510274	9	89	320	1	80	0.0125000
NODE_82391_length_391_cov_39.414384	0	66	0	3	66	0.0454545
NODE_82391_length_391_cov_39.414384	0	66	5	15	66	0.2272727
NODE_82391_length_391_cov_39.414384	0	66	7	5	66	0.0757576
NODE_82391_length_391_cov_39.414384	0	66	9	7	66	0.1060606
NODE_82391_length_391_cov_39.414384	0	66	19	19	66	0.2878788
NODE_82391_length_391_cov_39.414384	0	66	25	17	66	0.2575758
NODE_82391_length_391_cov_39.414384	0	71	0	3	71	0.0422535
NODE_82391_length_391_cov_39.414384	0	71	5	15	71	0.2112676
NODE_82391_length_391_cov_39.414384	0	71	7	5	71	0.0704225
NODE_82391_length_391_cov_39.414384	0	71	9	7	71	0.0985916
NODE_82391_length_391_cov_39.414384	0	71	19	19	71	0.2676056
NODE_82391_length_391_cov_39.414384	0	71	25	17	71	0.2394366
NODE_82391_length_391_cov_39.414384	0	71	26	5	71	0.0704225
NODE_82391_length_391_cov_39.414384	44	124	16	4	80	0.0500000
NODE_82391_length_391_cov_39.414384	44	124	19	5	80	0.0625000
NODE_82391_length_391_cov_39.414384	44	124	22	1	80	0.0125000
NODE_82391_length_391_cov_39.414384	44	124	24	11	80	0.1375000
NODE_82391_length_391_cov_39.414384	44	124	25	17	80	0.2125000
NODE_82391_length_391_cov_39.414384	44	124	26	42	80	0.5250000
NODE_82394_length_391_cov_10.352740	156	235	0	2	79	0.0253165
NODE_82394_length_391_cov_10.352740	156	235	2	28	79	0.3544304
NODE_82394_length_391_cov_10.352740	156	235	4	49	79	0.6202531
NODE_82415_length_391_cov_5.030822	85	166	2	15	81	0.1851852
NODE_82415_length_391_cov_5.030822	85	166	4	2	81	0.0246914
NODE_82415_length_391_cov_5.030822	85	166	6	3	81	0.0370370
NODE_82415_length_391_cov_5.030822	85	166	8	8	81	0.0987654
NODE_82415_length_391_cov_5.030822	85	166	11	5	81	0.0617284
NODE_82415_length_391_cov_5.030822	85	166	12	2	81	0.0246914
NODE_82415_length_391_cov_5.030822	85	166	14	46	81	0.5679013
NODE_82498_length_391_cov_2.660959	267	343	4	9	76	0.1184211
NODE_82498_length_391_cov_2.660959	267	343	8	8	76	0.1052632
NODE_82498_length_391_cov_2.660959	267	343	11	8	76	0.1052632
NODE_82498_length_391_cov_2.660959	267	343	15	51	76	0.6710526
NODE_82552_length_391_cov_2.089041	176	256	2	48	80	0.6000000
NODE_82552_length_391_cov_2.089041	176	256	4	3	80	0.0375000
NODE_82552_length_391_cov_2.089041	176	256	6	4	80	0.0500000
NODE_82552_length_391_cov_2.089041	176	256	8	25	80	0.3125000
NODE_82552_length_391_cov_2.089041	229	280	0	9	51	0.1764706
NODE_82552_length_391_cov_2.089041	229	280	2	42	51	0.8235294
NODE_82574_length_391_cov_1.907534	200	257	0	57	57	1.0000000
NODE_82597_length_391_cov_1.773973	160	190	2	30	30	1.0000000
NODE_82632_length_391_cov_1.647260	298	378	0	43	80	0.5375000
NODE_82632_length_391_cov_1.647260	298	378	2	37	80	0.4625000
NODE_82662_length_391_cov_1.561644	241	261	0	20	20	1.0000000
NODE_83015_length_390_cov_29.030928	86	166	0	80	80	1.0000000
NODE_83015_length_390_cov_29.030928	139	219	0	74	80	0.9250000
NODE_83015_length_390_cov_29.030928	139	219	2	6	80	0.0750000
NODE_83016_length_390_cov_22.319588	118	198	0	80	80	1.0000000
NODE_83016_length_390_cov_22.319588	171	251	0	80	80	1.0000000
NODE_83044_length_390_cov_4.481100	208	277	0	69	69	1.0000000
NODE_83044_length_390_cov_4.481100	286	327	0	41	41	1.0000000
NODE_83045_length_390_cov_4.481100	93	171	2	17	78	0.2179487
NODE_83045_length_390_cov_4.481100	93	171	4	44	78	0.5641026
NODE_83045_length_390_cov_4.481100	93	171	5	17	78	0.2179487
NODE_83045_length_390_cov_4.481100	144	210	4	66	66	1.0000000
NODE_83060_length_390_cov_3.814433	66	99	0	33	33	1.0000000
NODE_83061_length_390_cov_3.783505	188	268	0	80	80	1.0000000
NODE_83061_length_390_cov_3.783505	241	321	0	80	80	1.0000000
NODE_83066_length_390_cov_3.560137	304	367	2	34	63	0.5396826
NODE_83066_length_390_cov_3.560137	304	367	4	28	63	0.4444444
NODE_83066_length_390_cov_3.560137	304	367	6	1	63	0.0158730
NODE_83066_length_390_cov_3.560137	340	381	0	2	41	0.0487805
NODE_83066_length_390_cov_3.560137	340	381	2	39	41	0.9512195
NODE_83169_length_390_cov_2.127148	242	322	0	17	80	0.2125000
NODE_83169_length_390_cov_2.127148	242	322	2	5	80	0.0625000
NODE_83169_length_390_cov_2.127148	242	322	6	58	80	0.7250000
NODE_83171_length_390_cov_2.123711	133	177	0	17	44	0.3863636
NODE_83171_length_390_cov_2.123711	133	177	2	26	44	0.5909091
NODE_83171_length_390_cov_2.123711	133	177	4	1	44	0.0227273
NODE_83171_length_390_cov_2.123711	157	237	2	19	80	0.2375000
NODE_83171_length_390_cov_2.123711	157	237	4	11	80	0.1375000
NODE_83171_length_390_cov_2.123711	157	237	6	1	80	0.0125000
NODE_83171_length_390_cov_2.123711	157	237	8	49	80	0.6125000
NODE_83288_length_390_cov_1.536082	223	276	0	5	53	0.0943396
NODE_83288_length_390_cov_1.536082	223	276	2	48	53	0.9056604
NODE_83338_length_390_cov_1.398625	49	110	1	4	61	0.0655738
NODE_83338_length_390_cov_1.398625	49	110	3	14	61	0.2295082
NODE_83338_length_390_cov_1.398625	49	110	5	43	61	0.7049180
NODE_83463_length_390_cov_1.034364	78	158	0	80	80	1.0000000
NODE_83633_length_389_cov_63.710345	32	112	0	80	80	1.0000000
NODE_83633_length_389_cov_63.710345	85	165	0	80	80	1.0000000
NODE_83633_length_389_cov_63.710345	161	241	0	80	80	1.0000000
NODE_83633_length_389_cov_63.710345	214	294	0	80	80	1.0000000
NODE_83650_length_389_cov_5.382759	154	234	4	70	80	0.8750000
NODE_83650_length_389_cov_5.382759	154	234	6	10	80	0.1250000
NODE_83662_length_389_cov_4.468966	199	269	0	70	70	1.0000000
NODE_83663_length_389_cov_4.424138	68	148	18	10	80	0.1250000
NODE_83663_length_389_cov_4.424138	68	148	20	1	80	0.0125000
NODE_83663_length_389_cov_4.424138	68	148	22	19	80	0.2375000
NODE_83663_length_389_cov_4.424138	68	148	26	4	80	0.0500000
NODE_83663_length_389_cov_4.424138	68	148	28	11	80	0.1375000
NODE_83663_length_389_cov_4.424138	68	148	30	35	80	0.4375000
NODE_83685_length_389_cov_3.782759	194	225	2	31	31	1.0000000
NODE_83689_length_389_cov_3.555172	107	153	4	46	46	1.0000000
NODE_83695_length_389_cov_3.251724	120	163	2	1	43	0.0232558
NODE_83695_length_389_cov_3.251724	120	163	4	42	43	0.9767442
NODE_83695_length_389_cov_3.251724	136	206	4	70	70	1.0000000
NODE_83816_length_389_cov_1.951724	68	148	0	80	80	1.0000000
NODE_83819_length_389_cov_1.937931	53	82	0	29	29	1.0000000
NODE_83819_length_389_cov_1.937931	153	233	14	11	80	0.1375000
NODE_83819_length_389_cov_1.937931	153	233	16	2	80	0.0250000
NODE_83819_length_389_cov_1.937931	153	233	18	35	80	0.4375000
NODE_83819_length_389_cov_1.937931	153	233	20	9	80	0.1125000
NODE_83819_length_389_cov_1.937931	153	233	22	5	80	0.0625000
NODE_83819_length_389_cov_1.937931	153	233	24	18	80	0.2250000
NODE_83829_length_389_cov_1.920690	296	365	6	69	69	1.0000000
NODE_84182_length_389_cov_0.720690	294	374	0	80	80	1.0000000
NODE_84267_length_388_cov_9.179931	47	127	0	80	80	1.0000000
NODE_84267_length_388_cov_9.179931	100	180	0	80	80	1.0000000
NODE_84270_length_388_cov_7.249135	171	251	0	43	80	0.5375000
NODE_84270_length_388_cov_7.249135	171	251	2	37	80	0.4625000
NODE_84270_length_388_cov_7.249135	224	304	0	80	80	1.0000000
NODE_84305_length_388_cov_3.913495	151	231	2	54	80	0.6750000
NODE_84305_length_388_cov_3.913495	151	231	4	26	80	0.3250000
NODE_84308_length_388_cov_3.809689	233	277	0	6	44	0.1363636
NODE_84308_length_388_cov_3.809689	233	277	2	38	44	0.8636364
NODE_84332_length_388_cov_3.103806	101	166	0	51	65	0.7846154
NODE_84332_length_388_cov_3.103806	101	166	2	14	65	0.2153846
NODE_84332_length_388_cov_3.103806	147	227	0	5	80	0.0625000
NODE_84332_length_388_cov_3.103806	147	227	2	75	80	0.9375000
NODE_84334_length_388_cov_3.041522	48	128	0	45	80	0.5625000
NODE_84334_length_388_cov_3.041522	48	128	2	35	80	0.4375000
NODE_84410_length_388_cov_2.114187	82	141	6	42	59	0.7118644
NODE_84410_length_388_cov_2.114187	82	141	8	17	59	0.2881356
NODE_84410_length_388_cov_2.114187	135	194	0	22	59	0.3728814
NODE_84410_length_388_cov_2.114187	135	194	2	11	59	0.1864407
NODE_84410_length_388_cov_2.114187	135	194	6	26	59	0.4406780
NODE_84423_length_388_cov_2.017301	99	151	2	52	52	1.0000000
NODE_84427_length_388_cov_1.989619	0	76	0	76	76	1.0000000
NODE_84427_length_388_cov_1.989619	49	114	0	65	65	1.0000000
NODE_84587_length_388_cov_1.352941	172	247	0	75	75	1.0000000
NODE_84631_length_388_cov_1.228374	308	339	4	27	31	0.8709677
NODE_84631_length_388_cov_1.228374	308	339	8	4	31	0.1290323
NODE_84885_length_387_cov_33.052083	194	274	0	4	80	0.0500000
NODE_84885_length_387_cov_33.052083	194	274	2	76	80	0.9500000
NODE_84885_length_387_cov_33.052083	247	327	0	50	80	0.6250000
NODE_84885_length_387_cov_33.052083	247	327	2	30	80	0.3750000
NODE_84890_length_387_cov_6.871528	26	106	0	17	80	0.2125000
NODE_84890_length_387_cov_6.871528	26	106	6	7	80	0.0875000
NODE_84890_length_387_cov_6.871528	26	106	8	56	80	0.7000000
NODE_84890_length_387_cov_6.871528	79	159	0	5	80	0.0625000
NODE_84890_length_387_cov_6.871528	79	159	2	21	80	0.2625000
NODE_84890_length_387_cov_6.871528	79	159	8	54	80	0.6750000
NODE_84902_length_387_cov_5.420139	286	341	2	55	55	1.0000000
NODE_84946_length_387_cov_3.364583	287	367	0	80	80	1.0000000
NODE_85007_length_387_cov_2.260417	140	210	6	46	70	0.6571429
NODE_85007_length_387_cov_2.260417	140	210	8	24	70	0.3428572
NODE_85019_length_387_cov_2.128472	220	286	0	66	66	1.0000000
NODE_85019_length_387_cov_2.128472	273	329	0	56	56	1.0000000
NODE_85032_length_387_cov_2.090278	318	352	0	34	34	1.0000000
NODE_85037_length_387_cov_2.055556	23	45	0	22	22	1.0000000
NODE_85047_length_387_cov_1.979167	259	316	2	57	57	1.0000000
NODE_85047_length_387_cov_1.979167	312	369	0	35	57	0.6140351
NODE_85047_length_387_cov_1.979167	312	369	2	22	57	0.3859649
NODE_85091_length_387_cov_1.770833	315	361	0	25	46	0.5434783
NODE_85091_length_387_cov_1.770833	315	361	2	12	46	0.2608696
NODE_85091_length_387_cov_1.770833	315	361	4	1	46	0.0217391
NODE_85091_length_387_cov_1.770833	315	361	6	8	46	0.1739130
NODE_85528_length_386_cov_9.979094	38	118	0	80	80	1.0000000
NODE_85528_length_386_cov_9.979094	91	174	0	83	83	1.0000000
NODE_85546_length_386_cov_4.428571	197	249	0	52	52	1.0000000
NODE_85570_length_386_cov_3.355401	151	231	0	80	80	1.0000000
NODE_85570_length_386_cov_3.355401	204	265	0	61	61	1.0000000
NODE_85602_length_386_cov_2.686411	293	325	0	9	32	0.2812500
NODE_85602_length_386_cov_2.686411	293	325	2	23	32	0.7187500
NODE_85602_length_386_cov_2.686411	349	379	0	5	30	0.1666667
NODE_85602_length_386_cov_2.686411	349	379	2	25	30	0.8333333
NODE_85629_length_386_cov_2.442509	55	135	0	80	80	1.0000000
NODE_85629_length_386_cov_2.442509	108	164	0	56	56	1.0000000
NODE_85793_length_386_cov_1.494774	79	121	0	42	42	1.0000000
NODE_85793_length_386_cov_1.494774	93	156	0	63	63	1.0000000
NODE_85816_length_386_cov_1.421603	160	236	0	76	76	1.0000000
NODE_85845_length_386_cov_1.372822	62	142	0	80	80	1.0000000
NODE_85845_length_386_cov_1.372822	115	195	0	80	80	1.0000000
NODE_85858_length_386_cov_1.317073	124	161	11	6	37	0.1621622
NODE_85858_length_386_cov_1.317073	124	161	13	29	37	0.7837838
NODE_85858_length_386_cov_1.317073	124	161	14	1	37	0.0270270
NODE_85858_length_386_cov_1.317073	124	161	15	1	37	0.0270270
NODE_85902_length_386_cov_1.170732	260	308	14	6	48	0.1250000
NODE_85902_length_386_cov_1.170732	260	308	16	8	48	0.1666667
NODE_85902_length_386_cov_1.170732	260	308	18	7	48	0.1458333
NODE_85902_length_386_cov_1.170732	260	308	20	4	48	0.0833333
NODE_85902_length_386_cov_1.170732	260	308	24	4	48	0.0833333
NODE_85902_length_386_cov_1.170732	260	308	26	8	48	0.1666667
NODE_85902_length_386_cov_1.170732	260	308	28	10	48	0.2083333
NODE_85902_length_386_cov_1.170732	260	308	32	1	48	0.0208333
NODE_86143_length_385_cov_167.877622	103	164	310	1	61	0.0163934
NODE_86143_length_385_cov_167.877622	103	164	314	1	61	0.0163934
NODE_86143_length_385_cov_167.877622	103	164	317	1	61	0.0163934
NODE_86143_length_385_cov_167.877622	103	164	331	1	61	0.0163934
NODE_86143_length_385_cov_167.877622	103	164	335	2	61	0.0327869
NODE_86143_length_385_cov_167.877622	103	164	339	1	61	0.0163934
NODE_86143_length_385_cov_167.877622	103	164	340	1	61	0.0163934
NODE_86143_length_385_cov_167.877622	103	164	341	1	61	0.0163934
NODE_86143_length_385_cov_167.877622	103	164	345	1	61	0.0163934
NODE_86143_length_385_cov_167.877622	103	164	347	2	61	0.0327869
NODE_86143_length_385_cov_167.877622	103	164	348	1	61	0.0163934
NODE_86143_length_385_cov_167.877622	103	164	349	1	61	0.0163934
NODE_86143_length_385_cov_167.877622	103	164	352	2	61	0.0327869
NODE_86143_length_385_cov_167.877622	103	164	353	2	61	0.0327869
NODE_86143_length_385_cov_167.877622	103	164	355	2	61	0.0327869
NODE_86143_length_385_cov_167.877622	103	164	358	1	61	0.0163934
NODE_86143_length_385_cov_167.877622	103	164	367	1	61	0.0163934
NODE_86143_length_385_cov_167.877622	103	164	371	1	61	0.0163934
NODE_86143_length_385_cov_167.877622	103	164	379	2	61	0.0327869
NODE_86143_length_385_cov_167.877622	103	164	381	1	61	0.0163934
NODE_86143_length_385_cov_167.877622	103	164	382	1	61	0.0163934
NODE_86143_length_385_cov_167.877622	103	164	386	2	61	0.0327869
NODE_86143_length_385_cov_167.877622	103	164	387	1	61	0.0163934
NODE_86143_length_385_cov_167.877622	103	164	388	2	61	0.0327869
NODE_86143_length_385_cov_167.877622	103	164	389	1	61	0.0163934
NODE_86143_length_385_cov_167.877622	103	164	390	2	61	0.0327869
NODE_86143_length_385_cov_167.877622	103	164	391	2	61	0.0327869
NODE_86143_length_385_cov_167.877622	103	164	392	1	61	0.0163934
NODE_86143_length_385_cov_167.877622	103	164	394	1	61	0.0163934
NODE_86143_length_385_cov_167.877622	103	164	398	1	61	0.0163934
NODE_86143_length_385_cov_167.877622	103	164	402	2	61	0.0327869
NODE_86143_length_385_cov_167.877622	103	164	408	1	61	0.0163934
NODE_86143_length_385_cov_167.877622	103	164	420	1	61	0.0163934
NODE_86143_length_385_cov_167.877622	103	164	435	1	61	0.0163934
NODE_86143_length_385_cov_167.877622	103	164	437	1	61	0.0163934
NODE_86143_length_385_cov_167.877622	103	164	442	1	61	0.0163934
NODE_86143_length_385_cov_167.877622	103	164	447	1	61	0.0163934
NODE_86143_length_385_cov_167.877622	103	164	448	3	61	0.0491803
NODE_86143_length_385_cov_167.877622	103	164	449	6	61	0.0983607
NODE_86143_length_385_cov_167.877622	103	164	452	4	61	0.0655738
NODE_86144_length_385_cov_38.695804	164	244	0	80	80	1.0000000
NODE_86144_length_385_cov_38.695804	217	297	0	80	80	1.0000000
NODE_86169_length_385_cov_4.335664	173	250	0	56	77	0.7272727
NODE_86169_length_385_cov_4.335664	173	250	2	5	77	0.0649351
NODE_86169_length_385_cov_4.335664	173	250	5	1	77	0.0129870
NODE_86169_length_385_cov_4.335664	173	250	6	15	77	0.1948052
NODE_86185_length_385_cov_3.793706	215	297	0	82	82	1.0000000
NODE_86230_length_385_cov_2.786713	99	179	0	17	80	0.2125000
NODE_86230_length_385_cov_2.786713	99	179	2	19	80	0.2375000
NODE_86230_length_385_cov_2.786713	99	179	4	44	80	0.5500000
NODE_86230_length_385_cov_2.786713	152	232	0	17	80	0.2125000
NODE_86230_length_385_cov_2.786713	152	232	2	34	80	0.4250000
NODE_86230_length_385_cov_2.786713	152	232	4	29	80	0.3625000
NODE_86230_length_385_cov_2.786713	281	362	0	77	81	0.9506173
NODE_86230_length_385_cov_2.786713	281	362	2	4	81	0.0493827
NODE_86448_length_385_cov_1.381119	71	145	0	32	74	0.4324324
NODE_86448_length_385_cov_1.381119	71	145	2	6	74	0.0810811
NODE_86448_length_385_cov_1.381119	71	145	6	21	74	0.2837838
NODE_86448_length_385_cov_1.381119	71	145	8	4	74	0.0540541
NODE_86448_length_385_cov_1.381119	71	145	12	11	74	0.1486486
NODE_86448_length_385_cov_1.381119	118	198	6	12	80	0.1500000
NODE_86448_length_385_cov_1.381119	118	198	8	4	80	0.0500000
NODE_86448_length_385_cov_1.381119	118	198	12	27	80	0.3375000
NODE_86448_length_385_cov_1.381119	118	198	14	18	80	0.2250000
NODE_86448_length_385_cov_1.381119	118	198	16	3	80	0.0375000
NODE_86448_length_385_cov_1.381119	118	198	18	16	80	0.2000000
NODE_86798_length_384_cov_3.996491	135	217	0	82	82	1.0000000
NODE_86809_length_384_cov_3.729825	181	228	0	47	47	1.0000000
NODE_86812_length_384_cov_3.715789	145	221	0	76	76	1.0000000
NODE_86841_length_384_cov_2.996491	147	227	4	57	80	0.7125000
NODE_86841_length_384_cov_2.996491	147	227	6	23	80	0.2875000
NODE_86847_length_384_cov_2.835088	65	145	2	13	80	0.1625000
NODE_86847_length_384_cov_2.835088	65	145	8	2	80	0.0250000
NODE_86847_length_384_cov_2.835088	65	145	10	5	80	0.0625000
NODE_86847_length_384_cov_2.835088	65	145	12	5	80	0.0625000
NODE_86847_length_384_cov_2.835088	65	145	14	8	80	0.1000000
NODE_86847_length_384_cov_2.835088	65	145	16	2	80	0.0250000
NODE_86847_length_384_cov_2.835088	65	145	18	3	80	0.0375000
NODE_86847_length_384_cov_2.835088	65	145	20	14	80	0.1750000
NODE_86847_length_384_cov_2.835088	65	145	22	1	80	0.0125000
NODE_86847_length_384_cov_2.835088	65	145	24	12	80	0.1500000
NODE_86847_length_384_cov_2.835088	65	145	26	15	80	0.1875000
NODE_86866_length_384_cov_2.575439	151	224	18	1	73	0.0136986
NODE_86866_length_384_cov_2.575439	151	224	20	11	73	0.1506849
NODE_86866_length_384_cov_2.575439	151	224	22	3	73	0.0410959
NODE_86866_length_384_cov_2.575439	151	224	26	6	73	0.0821918
NODE_86866_length_384_cov_2.575439	151	224	28	10	73	0.1369863
NODE_86866_length_384_cov_2.575439	151	224	30	42	73	0.5753425
NODE_86866_length_384_cov_2.575439	197	281	0	7	84	0.0833333
NODE_86866_length_384_cov_2.575439	197	281	2	26	84	0.3095238
NODE_86866_length_384_cov_2.575439	197	281	4	12	84	0.1428571
NODE_86866_length_384_cov_2.575439	197	281	6	1	84	0.0119048
NODE_86866_length_384_cov_2.575439	197	281	8	1	84	0.0119048
NODE_86866_length_384_cov_2.575439	197	281	10	3	84	0.0357143
NODE_86866_length_384_cov_2.575439	197	281	12	5	84	0.0595238
NODE_86866_length_384_cov_2.575439	197	281	16	2	84	0.0238095
NODE_86866_length_384_cov_2.575439	197	281	18	1	84	0.0119048
NODE_86866_length_384_cov_2.575439	197	281	20	11	84	0.1309524
NODE_86866_length_384_cov_2.575439	197	281	22	3	84	0.0357143
NODE_86866_length_384_cov_2.575439	197	281	26	6	84	0.0714286
NODE_86866_length_384_cov_2.575439	197	281	28	6	84	0.0714286
NODE_86907_length_384_cov_2.231579	78	153	0	75	75	1.0000000
NODE_86942_length_384_cov_1.940351	73	153	0	80	80	1.0000000
NODE_87431_length_383_cov_4.869718	117	197	0	45	80	0.5625000
NODE_87431_length_383_cov_4.869718	117	197	2	14	80	0.1750000
NODE_87431_length_383_cov_4.869718	117	197	4	21	80	0.2625000
NODE_87431_length_383_cov_4.869718	170	250	2	6	80	0.0750000
NODE_87431_length_383_cov_4.869718	170	250	4	74	80	0.9250000
NODE_87432_length_383_cov_4.841549	121	180	0	59	59	1.0000000
NODE_87438_length_383_cov_4.559859	33	109	0	76	76	1.0000000
NODE_87487_length_383_cov_2.940141	185	265	0	80	80	1.0000000
NODE_87495_length_383_cov_2.760563	123	203	302	1	80	0.0125000
NODE_87495_length_383_cov_2.760563	123	203	307	1	80	0.0125000
NODE_87495_length_383_cov_2.760563	123	203	318	1	80	0.0125000
NODE_87495_length_383_cov_2.760563	123	203	319	2	80	0.0250000
NODE_87495_length_383_cov_2.760563	123	203	320	1	80	0.0125000
NODE_87495_length_383_cov_2.760563	123	203	322	1	80	0.0125000
NODE_87495_length_383_cov_2.760563	123	203	323	1	80	0.0125000
NODE_87495_length_383_cov_2.760563	123	203	327	1	80	0.0125000
NODE_87495_length_383_cov_2.760563	123	203	335	1	80	0.0125000
NODE_87495_length_383_cov_2.760563	123	203	336	1	80	0.0125000
NODE_87495_length_383_cov_2.760563	123	203	338	3	80	0.0375000
NODE_87495_length_383_cov_2.760563	123	203	339	1	80	0.0125000
NODE_87495_length_383_cov_2.760563	123	203	345	1	80	0.0125000
NODE_87495_length_383_cov_2.760563	123	203	346	2	80	0.0250000
NODE_87495_length_383_cov_2.760563	123	203	350	1	80	0.0125000
NODE_87495_length_383_cov_2.760563	123	203	357	2	80	0.0250000
NODE_87495_length_383_cov_2.760563	123	203	359	1	80	0.0125000
NODE_87495_length_383_cov_2.760563	123	203	364	2	80	0.0250000
NODE_87495_length_383_cov_2.760563	123	203	368	2	80	0.0250000
NODE_87495_length_383_cov_2.760563	123	203	371	1	80	0.0125000
NODE_87495_length_383_cov_2.760563	123	203	374	1	80	0.0125000
NODE_87495_length_383_cov_2.760563	123	203	375	2	80	0.0250000
NODE_87495_length_383_cov_2.760563	123	203	379	1	80	0.0125000
NODE_87495_length_383_cov_2.760563	123	203	388	1	80	0.0125000
NODE_87495_length_383_cov_2.760563	123	203	391	1	80	0.0125000
NODE_87495_length_383_cov_2.760563	123	203	393	1	80	0.0125000
NODE_87495_length_383_cov_2.760563	123	203	394	1	80	0.0125000
NODE_87495_length_383_cov_2.760563	123	203	395	1	80	0.0125000
NODE_87495_length_383_cov_2.760563	123	203	397	1	80	0.0125000
NODE_87495_length_383_cov_2.760563	123	203	400	1	80	0.0125000
NODE_87495_length_383_cov_2.760563	123	203	402	1	80	0.0125000
NODE_87495_length_383_cov_2.760563	123	203	407	3	80	0.0375000
NODE_87495_length_383_cov_2.760563	123	203	409	1	80	0.0125000
NODE_87495_length_383_cov_2.760563	123	203	412	1	80	0.0125000
NODE_87495_length_383_cov_2.760563	123	203	414	1	80	0.0125000
NODE_87495_length_383_cov_2.760563	123	203	415	1	80	0.0125000
NODE_87495_length_383_cov_2.760563	123	203	419	1	80	0.0125000
NODE_87495_length_383_cov_2.760563	123	203	421	1	80	0.0125000
NODE_87495_length_383_cov_2.760563	123	203	422	2	80	0.0250000
NODE_87495_length_383_cov_2.760563	123	203	426	1	80	0.0125000
NODE_87495_length_383_cov_2.760563	123	203	431	1	80	0.0125000
NODE_87495_length_383_cov_2.760563	123	203	432	1	80	0.0125000
NODE_87495_length_383_cov_2.760563	123	203	435	1	80	0.0125000
NODE_87495_length_383_cov_2.760563	123	203	437	1	80	0.0125000
NODE_87495_length_383_cov_2.760563	123	203	438	2	80	0.0250000
NODE_87495_length_383_cov_2.760563	123	203	439	1	80	0.0125000
NODE_87495_length_383_cov_2.760563	123	203	441	3	80	0.0375000
NODE_87495_length_383_cov_2.760563	123	203	444	1	80	0.0125000
NODE_87495_length_383_cov_2.760563	123	203	450	1	80	0.0125000
NODE_87495_length_383_cov_2.760563	123	203	451	1	80	0.0125000
NODE_87495_length_383_cov_2.760563	123	203	454	2	80	0.0250000
NODE_87495_length_383_cov_2.760563	123	203	456	1	80	0.0125000
NODE_87495_length_383_cov_2.760563	123	203	458	3	80	0.0375000
NODE_87495_length_383_cov_2.760563	123	203	460	3	80	0.0375000
NODE_87495_length_383_cov_2.760563	123	203	461	3	80	0.0375000
NODE_87495_length_383_cov_2.760563	123	203	462	3	80	0.0375000
NODE_87495_length_383_cov_2.760563	123	203	465	1	80	0.0125000
NODE_87495_length_383_cov_2.760563	169	249	128	2	80	0.0250000
NODE_87495_length_383_cov_2.760563	169	249	134	1	80	0.0125000
NODE_87495_length_383_cov_2.760563	169	249	143	1	80	0.0125000
NODE_87495_length_383_cov_2.760563	169	249	157	1	80	0.0125000
NODE_87495_length_383_cov_2.760563	169	249	171	1	80	0.0125000
NODE_87495_length_383_cov_2.760563	169	249	181	3	80	0.0375000
NODE_87495_length_383_cov_2.760563	169	249	187	1	80	0.0125000
NODE_87495_length_383_cov_2.760563	169	249	191	1	80	0.0125000
NODE_87495_length_383_cov_2.760563	169	249	193	2	80	0.0250000
NODE_87495_length_383_cov_2.760563	169	249	195	1	80	0.0125000
NODE_87495_length_383_cov_2.760563	169	249	197	1	80	0.0125000
NODE_87495_length_383_cov_2.760563	169	249	205	2	80	0.0250000
NODE_87495_length_383_cov_2.760563	169	249	207	1	80	0.0125000
NODE_87495_length_383_cov_2.760563	169	249	209	1	80	0.0125000
NODE_87495_length_383_cov_2.760563	169	249	215	1	80	0.0125000
NODE_87495_length_383_cov_2.760563	169	249	217	1	80	0.0125000
NODE_87495_length_383_cov_2.760563	169	249	223	1	80	0.0125000
NODE_87495_length_383_cov_2.760563	169	249	225	2	80	0.0250000
NODE_87495_length_383_cov_2.760563	169	249	232	2	80	0.0250000
NODE_87495_length_383_cov_2.760563	169	249	240	4	80	0.0500000
NODE_87495_length_383_cov_2.760563	169	249	246	1	80	0.0125000
NODE_87495_length_383_cov_2.760563	169	249	250	1	80	0.0125000
NODE_87495_length_383_cov_2.760563	169	249	254	1	80	0.0125000
NODE_87495_length_383_cov_2.760563	169	249	260	1	80	0.0125000
NODE_87495_length_383_cov_2.760563	169	249	264	1	80	0.0125000
NODE_87495_length_383_cov_2.760563	169	249	266	1	80	0.0125000
NODE_87495_length_383_cov_2.760563	169	249	270	1	80	0.0125000
NODE_87495_length_383_cov_2.760563	169	249	274	1	80	0.0125000
NODE_87495_length_383_cov_2.760563	169	249	281	1	80	0.0125000
NODE_87495_length_383_cov_2.760563	169	249	282	1	80	0.0125000
NODE_87495_length_383_cov_2.760563	169	249	284	2	80	0.0250000
NODE_87495_length_383_cov_2.760563	169	249	293	1	80	0.0125000
NODE_87495_length_383_cov_2.760563	169	249	302	1	80	0.0125000
NODE_87495_length_383_cov_2.760563	169	249	304	1	80	0.0125000
NODE_87495_length_383_cov_2.760563	169	249	316	1	80	0.0125000
NODE_87495_length_383_cov_2.760563	169	249	318	1	80	0.0125000
NODE_87495_length_383_cov_2.760563	169	249	327	1	80	0.0125000
NODE_87495_length_383_cov_2.760563	169	249	335	1	80	0.0125000
NODE_87495_length_383_cov_2.760563	169	249	339	1	80	0.0125000
NODE_87495_length_383_cov_2.760563	169	249	345	1	80	0.0125000
NODE_87495_length_383_cov_2.760563	169	249	357	2	80	0.0250000
NODE_87495_length_383_cov_2.760563	169	249	359	1	80	0.0125000
NODE_87495_length_383_cov_2.760563	169	249	364	2	80	0.0250000
NODE_87495_length_383_cov_2.760563	169	249	371	1	80	0.0125000
NODE_87495_length_383_cov_2.760563	169	249	375	2	80	0.0250000
NODE_87495_length_383_cov_2.760563	169	249	379	1	80	0.0125000
NODE_87495_length_383_cov_2.760563	169	249	388	1	80	0.0125000
NODE_87495_length_383_cov_2.760563	169	249	394	1	80	0.0125000
NODE_87495_length_383_cov_2.760563	169	249	395	1	80	0.0125000
NODE_87495_length_383_cov_2.760563	169	249	407	1	80	0.0125000
NODE_87495_length_383_cov_2.760563	169	249	409	1	80	0.0125000
NODE_87495_length_383_cov_2.760563	169	249	412	1	80	0.0125000
NODE_87495_length_383_cov_2.760563	169	249	414	1	80	0.0125000
NODE_87495_length_383_cov_2.760563	169	249	422	1	80	0.0125000
NODE_87495_length_383_cov_2.760563	169	249	431	1	80	0.0125000
NODE_87495_length_383_cov_2.760563	169	249	432	1	80	0.0125000
NODE_87495_length_383_cov_2.760563	169	249	438	2	80	0.0250000
NODE_87495_length_383_cov_2.760563	169	249	441	2	80	0.0250000
NODE_87495_length_383_cov_2.760563	169	249	454	2	80	0.0250000
NODE_87495_length_383_cov_2.760563	169	249	456	1	80	0.0125000
NODE_87495_length_383_cov_2.760563	169	249	458	1	80	0.0125000
NODE_87495_length_383_cov_2.760563	169	249	462	2	80	0.0250000
NODE_87495_length_383_cov_2.760563	222	302	19	1	80	0.0125000
NODE_87495_length_383_cov_2.760563	222	302	20	5	80	0.0625000
NODE_87495_length_383_cov_2.760563	222	302	23	4	80	0.0500000
NODE_87495_length_383_cov_2.760563	222	302	24	10	80	0.1250000
NODE_87495_length_383_cov_2.760563	222	302	26	10	80	0.1250000
NODE_87495_length_383_cov_2.760563	222	302	30	2	80	0.0250000
NODE_87495_length_383_cov_2.760563	222	302	34	1	80	0.0125000
NODE_87495_length_383_cov_2.760563	222	302	45	1	80	0.0125000
NODE_87495_length_383_cov_2.760563	222	302	54	4	80	0.0500000
NODE_87495_length_383_cov_2.760563	222	302	56	1	80	0.0125000
NODE_87495_length_383_cov_2.760563	222	302	61	1	80	0.0125000
NODE_87495_length_383_cov_2.760563	222	302	91	2	80	0.0250000
NODE_87495_length_383_cov_2.760563	222	302	99	1	80	0.0125000
NODE_87495_length_383_cov_2.760563	222	302	106	1	80	0.0125000
NODE_87495_length_383_cov_2.760563	222	302	110	1	80	0.0125000
NODE_87495_length_383_cov_2.760563	222	302	112	3	80	0.0375000
NODE_87495_length_383_cov_2.760563	222	302	114	1	80	0.0125000
NODE_87495_length_383_cov_2.760563	222	302	118	1	80	0.0125000
NODE_87495_length_383_cov_2.760563	222	302	120	1	80	0.0125000
NODE_87495_length_383_cov_2.760563	222	302	122	1	80	0.0125000
NODE_87495_length_383_cov_2.760563	222	302	126	1	80	0.0125000
NODE_87495_length_383_cov_2.760563	222	302	128	2	80	0.0250000
NODE_87495_length_383_cov_2.760563	222	302	134	1	80	0.0125000
NODE_87495_length_383_cov_2.760563	222	302	143	1	80	0.0125000
NODE_87495_length_383_cov_2.760563	222	302	157	1	80	0.0125000
NODE_87495_length_383_cov_2.760563	222	302	171	1	80	0.0125000
NODE_87495_length_383_cov_2.760563	222	302	181	3	80	0.0375000
NODE_87495_length_383_cov_2.760563	222	302	187	1	80	0.0125000
NODE_87495_length_383_cov_2.760563	222	302	191	1	80	0.0125000
NODE_87495_length_383_cov_2.760563	222	302	193	2	80	0.0250000
NODE_87495_length_383_cov_2.760563	222	302	195	1	80	0.0125000
NODE_87495_length_383_cov_2.760563	222	302	197	1	80	0.0125000
NODE_87495_length_383_cov_2.760563	222	302	205	2	80	0.0250000
NODE_87495_length_383_cov_2.760563	222	302	207	1	80	0.0125000
NODE_87495_length_383_cov_2.760563	222	302	209	1	80	0.0125000
NODE_87495_length_383_cov_2.760563	222	302	215	1	80	0.0125000
NODE_87495_length_383_cov_2.760563	222	302	217	1	80	0.0125000
NODE_87495_length_383_cov_2.760563	222	302	223	1	80	0.0125000
NODE_87495_length_383_cov_2.760563	222	302	225	2	80	0.0250000
NODE_87495_length_383_cov_2.760563	222	302	232	2	80	0.0250000
NODE_87495_length_383_cov_2.760563	222	302	240	1	80	0.0125000
NODE_87566_length_383_cov_2.123239	29	94	0	65	65	1.0000000
NODE_87566_length_383_cov_2.123239	93	173	0	80	80	1.0000000
NODE_87566_length_383_cov_2.123239	146	193	0	47	47	1.0000000
NODE_87634_length_383_cov_1.728873	196	257	12	9	61	0.1475410
NODE_87634_length_383_cov_1.728873	196	257	16	2	61	0.0327869
NODE_87634_length_383_cov_1.728873	196	257	19	1	61	0.0163934
NODE_87634_length_383_cov_1.728873	196	257	21	21	61	0.3442623
NODE_87634_length_383_cov_1.728873	196	257	23	1	61	0.0163934
NODE_87634_length_383_cov_1.728873	196	257	25	5	61	0.0819672
NODE_87634_length_383_cov_1.728873	196	257	27	2	61	0.0327869
NODE_87634_length_383_cov_1.728873	196	257	28	14	61	0.2295082
NODE_87634_length_383_cov_1.728873	196	257	30	6	61	0.0983607
NODE_87634_length_383_cov_1.728873	239	310	12	19	71	0.2676056
NODE_87634_length_383_cov_1.728873	239	310	14	1	71	0.0140845
NODE_87634_length_383_cov_1.728873	239	310	20	17	71	0.2394366
NODE_87634_length_383_cov_1.728873	239	310	22	3	71	0.0422535
NODE_87634_length_383_cov_1.728873	239	310	26	1	71	0.0140845
NODE_87634_length_383_cov_1.728873	239	310	28	26	71	0.3661972
NODE_87634_length_383_cov_1.728873	239	310	30	4	71	0.0563380
NODE_88039_length_382_cov_43.724382	245	325	0	80	80	1.0000000
NODE_88039_length_382_cov_43.724382	298	378	0	80	80	1.0000000
NODE_88040_length_382_cov_35.908127	163	243	0	8	80	0.1000000
NODE_88040_length_382_cov_35.908127	163	243	2	72	80	0.9000000
NODE_88040_length_382_cov_35.908127	216	296	0	61	80	0.7625000
NODE_88040_length_382_cov_35.908127	216	296	2	19	80	0.2375000
NODE_88040_length_382_cov_35.908127	292	372	0	80	80	1.0000000
NODE_88041_length_382_cov_26.240283	57	137	0	18	80	0.2250000
NODE_88041_length_382_cov_26.240283	57	137	4	62	80	0.7750000
NODE_88041_length_382_cov_26.240283	110	190	0	1	80	0.0125000
NODE_88041_length_382_cov_26.240283	110	190	4	79	80	0.9875000
NODE_88054_length_382_cov_5.583039	63	143	0	80	80	1.0000000
NODE_88054_length_382_cov_5.583039	116	196	0	80	80	1.0000000
NODE_88063_length_382_cov_4.837456	19	78	0	59	59	1.0000000
NODE_88067_length_382_cov_4.618375	0	55	0	55	55	1.0000000
NODE_88067_length_382_cov_4.618375	104	184	2	19	80	0.2375000
NODE_88067_length_382_cov_4.618375	104	184	4	21	80	0.2625000
NODE_88067_length_382_cov_4.618375	104	184	6	11	80	0.1375000
NODE_88067_length_382_cov_4.618375	104	184	8	6	80	0.0750000
NODE_88067_length_382_cov_4.618375	104	184	10	4	80	0.0500000
NODE_88067_length_382_cov_4.618375	104	184	14	5	80	0.0625000
NODE_88067_length_382_cov_4.618375	104	184	16	14	80	0.1750000
NODE_88067_length_382_cov_4.618375	157	237	8	4	80	0.0500000
NODE_88067_length_382_cov_4.618375	157	237	10	4	80	0.0500000
NODE_88067_length_382_cov_4.618375	157	237	14	18	80	0.2250000
NODE_88067_length_382_cov_4.618375	157	237	15	6	80	0.0750000
NODE_88067_length_382_cov_4.618375	157	237	16	48	80	0.6000000
NODE_88075_length_382_cov_4.268551	71	152	0	39	81	0.4814815
NODE_88075_length_382_cov_4.268551	71	152	2	42	81	0.5185185
NODE_88075_length_382_cov_4.268551	124	205	0	81	81	1.0000000
NODE_88080_length_382_cov_4.091873	30	92	0	23	62	0.3709677
NODE_88080_length_382_cov_4.091873	30	92	2	39	62	0.6290323
NODE_88121_length_382_cov_3.031802	173	253	0	10	80	0.1250000
NODE_88121_length_382_cov_3.031802	173	253	2	2	80	0.0250000
NODE_88121_length_382_cov_3.031802	173	253	4	7	80	0.0875000
NODE_88121_length_382_cov_3.031802	173	253	10	14	80	0.1750000
NODE_88121_length_382_cov_3.031802	173	253	12	7	80	0.0875000
NODE_88121_length_382_cov_3.031802	173	253	14	9	80	0.1125000
NODE_88121_length_382_cov_3.031802	173	253	16	31	80	0.3875000
NODE_88121_length_382_cov_3.031802	226	295	10	7	69	0.1014493
NODE_88121_length_382_cov_3.031802	226	295	12	3	69	0.0434783
NODE_88121_length_382_cov_3.031802	226	295	14	26	69	0.3768116
NODE_88121_length_382_cov_3.031802	226	295	16	33	69	0.4782609
NODE_88135_length_382_cov_2.798587	231	293	4	62	62	1.0000000
NODE_88136_length_382_cov_2.791519	195	244	0	1	49	0.0204082
NODE_88136_length_382_cov_2.791519	195	244	2	14	49	0.2857143
NODE_88136_length_382_cov_2.791519	195	244	4	14	49	0.2857143
NODE_88136_length_382_cov_2.791519	195	244	6	20	49	0.4081633
NODE_88136_length_382_cov_2.791519	217	297	4	7	80	0.0875000
NODE_88136_length_382_cov_2.791519	217	297	6	73	80	0.9125000
NODE_88164_length_382_cov_2.611307	301	368	8	12	67	0.1791045
NODE_88164_length_382_cov_2.611307	301	368	10	53	67	0.7910448
NODE_88164_length_382_cov_2.611307	301	368	12	2	67	0.0298507
NODE_88276_length_382_cov_1.802120	0	60	0	60	60	1.0000000
NODE_88660_length_382_cov_0.738516	48	95	6	41	47	0.8723404
NODE_88660_length_382_cov_0.738516	48	95	8	6	47	0.1276596
NODE_88660_length_382_cov_0.738516	68	148	6	80	80	1.0000000
NODE_88758_length_381_cov_12.010638	195	274	0	16	79	0.2025317
NODE_88758_length_381_cov_12.010638	195	274	6	7	79	0.0886076
NODE_88758_length_381_cov_12.010638	195	274	8	56	79	0.7088608
NODE_88865_length_381_cov_2.606383	68	98	0	30	30	1.0000000
NODE_88867_length_381_cov_2.570922	115	175	0	60	60	1.0000000
NODE_88872_length_381_cov_2.514184	225	307	12	45	82	0.5487805
NODE_88872_length_381_cov_2.514184	225	307	14	37	82	0.4512195
NODE_88900_length_381_cov_2.198582	193	276	0	83	83	1.0000000
NODE_88935_length_381_cov_1.989362	279	325	0	46	46	1.0000000
NODE_89009_length_381_cov_1.663121	51	128	2	25	77	0.3246753
NODE_89009_length_381_cov_1.663121	51	128	6	52	77	0.6753247
NODE_89009_length_381_cov_1.663121	101	181	4	1	80	0.0125000
NODE_89009_length_381_cov_1.663121	101	181	6	79	80	0.9875000
NODE_89090_length_381_cov_1.400709	254	334	2	80	80	1.0000000
NODE_89090_length_381_cov_1.400709	254	334	2	80	80	1.0000000
NODE_89090_length_381_cov_1.400709	309	373	0	4	64	0.0625000
NODE_89090_length_381_cov_1.400709	309	373	2	60	64	0.9375000
NODE_89482_length_380_cov_57.604982	196	276	2	80	80	1.0000000
NODE_89482_length_380_cov_57.604982	249	329	0	45	80	0.5625000
NODE_89482_length_380_cov_57.604982	249	329	2	35	80	0.4375000
NODE_89482_length_380_cov_57.604982	325	359	0	34	34	1.0000000
NODE_89483_length_380_cov_11.185053	79	161	0	62	82	0.7560976
NODE_89483_length_380_cov_11.185053	79	161	2	20	82	0.2439024
NODE_89483_length_380_cov_11.185053	134	214	0	60	80	0.7500000
NODE_89483_length_380_cov_11.185053	134	214	2	20	80	0.2500000
NODE_89491_length_380_cov_5.811388	100	156	2	56	56	1.0000000
NODE_89491_length_380_cov_5.811388	177	213	0	36	36	1.0000000
NODE_89495_length_380_cov_5.377224	242	271	26	7	29	0.2413793
NODE_89495_length_380_cov_5.377224	242	271	28	1	29	0.0344828
NODE_89495_length_380_cov_5.377224	242	271	30	3	29	0.1034483
NODE_89495_length_380_cov_5.377224	242	271	32	17	29	0.5862069
NODE_89495_length_380_cov_5.377224	242	271	34	1	29	0.0344828
NODE_89508_length_380_cov_4.185053	158	230	0	72	72	1.0000000
NODE_89508_length_380_cov_4.185053	159	229	0	70	70	1.0000000
NODE_89508_length_380_cov_4.185053	203	283	0	80	80	1.0000000
NODE_89508_length_380_cov_4.185053	203	283	0	80	80	1.0000000
NODE_89527_length_380_cov_3.423488	164	233	0	11	69	0.1594203
NODE_89527_length_380_cov_3.423488	164	233	2	7	69	0.1014493
NODE_89527_length_380_cov_3.423488	164	233	4	44	69	0.6376812
NODE_89527_length_380_cov_3.423488	164	233	6	7	69	0.1014493
NODE_89540_length_380_cov_3.153025	188	260	6	6	72	0.0833333
NODE_89540_length_380_cov_3.153025	188	260	8	6	72	0.0833333
NODE_89540_length_380_cov_3.153025	188	260	13	41	72	0.5694444
NODE_89540_length_380_cov_3.153025	188	260	14	19	72	0.2638889
NODE_89568_length_380_cov_2.718861	51	131	3	10	80	0.1250000
NODE_89568_length_380_cov_2.718861	51	131	4	11	80	0.1375000
NODE_89568_length_380_cov_2.718861	51	131	6	59	80	0.7375000
NODE_89568_length_380_cov_2.718861	104	184	0	2	80	0.0250000
NODE_89568_length_380_cov_2.718861	104	184	4	2	80	0.0250000
NODE_89568_length_380_cov_2.718861	104	184	6	76	80	0.9500000
NODE_89658_length_380_cov_1.943060	22	56	0	14	34	0.4117647
NODE_89658_length_380_cov_1.943060	22	56	2	20	34	0.5882353
NODE_89750_length_380_cov_1.601423	292	332	22	12	40	0.3000000
NODE_89750_length_380_cov_1.601423	292	332	23	1	40	0.0250000
NODE_89750_length_380_cov_1.601423	292	332	24	1	40	0.0250000
NODE_89750_length_380_cov_1.601423	292	332	26	5	40	0.1250000
NODE_89750_length_380_cov_1.601423	292	332	27	2	40	0.0500000
NODE_89750_length_380_cov_1.601423	292	332	29	1	40	0.0250000
NODE_89750_length_380_cov_1.601423	292	332	34	2	40	0.0500000
NODE_89750_length_380_cov_1.601423	292	332	37	1	40	0.0250000
NODE_89750_length_380_cov_1.601423	292	332	39	1	40	0.0250000
NODE_89750_length_380_cov_1.601423	292	332	42	1	40	0.0250000
NODE_89750_length_380_cov_1.601423	292	332	43	1	40	0.0250000
NODE_89750_length_380_cov_1.601423	292	332	44	3	40	0.0750000
NODE_89750_length_380_cov_1.601423	292	332	46	3	40	0.0750000
NODE_89750_length_380_cov_1.601423	292	332	48	2	40	0.0500000
NODE_89750_length_380_cov_1.601423	292	332	51	1	40	0.0250000
NODE_89750_length_380_cov_1.601423	292	332	53	1	40	0.0250000
NODE_89750_length_380_cov_1.601423	292	332	56	2	40	0.0500000
NODE_89911_length_380_cov_1.088968	312	353	0	41	41	1.0000000
NODE_89911_length_380_cov_1.088968	326	380	0	54	54	1.0000000
NODE_90152_length_379_cov_42.339286	10	90	0	80	80	1.0000000
NODE_90152_length_379_cov_42.339286	86	166	0	80	80	1.0000000
NODE_90152_length_379_cov_42.339286	139	219	0	80	80	1.0000000
NODE_90153_length_379_cov_32.075000	0	62	0	62	62	1.0000000
NODE_90165_length_379_cov_5.607143	279	338	0	59	59	1.0000000
NODE_90180_length_379_cov_4.432143	219	243	0	24	24	1.0000000
NODE_90193_length_379_cov_3.778571	271	300	0	29	29	1.0000000
NODE_90198_length_379_cov_3.585714	128	152	0	24	24	1.0000000
NODE_90198_length_379_cov_3.585714	169	249	0	80	80	1.0000000
NODE_90203_length_379_cov_3.375000	19	43	0	24	24	1.0000000
NODE_90247_length_379_cov_2.692857	121	201	16	3	80	0.0375000
NODE_90247_length_379_cov_2.692857	121	201	18	54	80	0.6750000
NODE_90247_length_379_cov_2.692857	121	201	20	23	80	0.2875000
NODE_90247_length_379_cov_2.692857	174	221	8	8	47	0.1702128
NODE_90247_length_379_cov_2.692857	174	221	10	1	47	0.0212766
NODE_90247_length_379_cov_2.692857	174	221	13	1	47	0.0212766
NODE_90247_length_379_cov_2.692857	174	221	14	2	47	0.0425532
NODE_90247_length_379_cov_2.692857	174	221	16	6	47	0.1276596
NODE_90247_length_379_cov_2.692857	174	221	17	1	47	0.0212766
NODE_90247_length_379_cov_2.692857	174	221	18	6	47	0.1276596
NODE_90247_length_379_cov_2.692857	174	221	20	22	47	0.4680851
NODE_90789_length_378_cov_53.039427	147	227	0	80	80	1.0000000
NODE_90789_length_378_cov_53.039427	200	280	0	80	80	1.0000000
NODE_90789_length_378_cov_53.039427	276	356	0	80	80	1.0000000
NODE_90789_length_378_cov_53.039427	329	378	0	49	49	1.0000000
NODE_90794_length_378_cov_6.569892	223	304	4	3	81	0.0370370
NODE_90794_length_378_cov_6.569892	223	304	6	17	81	0.2098765
NODE_90794_length_378_cov_6.569892	223	304	8	3	81	0.0370370
NODE_90794_length_378_cov_6.569892	223	304	10	58	81	0.7160494
NODE_90795_length_378_cov_6.444444	217	297	0	80	80	1.0000000
NODE_90795_length_378_cov_6.444444	270	350	0	80	80	1.0000000
NODE_90808_length_378_cov_4.899642	135	191	4	3	56	0.0535714
NODE_90808_length_378_cov_4.899642	135	191	5	24	56	0.4285714
NODE_90808_length_378_cov_4.899642	135	191	6	29	56	0.5178571
NODE_90855_length_378_cov_3.236559	143	212	4	15	69	0.2173913
NODE_90855_length_378_cov_3.236559	143	212	6	54	69	0.7826087
NODE_90859_length_378_cov_3.132616	238	280	0	42	42	1.0000000
NODE_90898_length_378_cov_2.534050	203	243	2	40	40	1.0000000
NODE_90898_length_378_cov_2.534050	271	347	0	6	76	0.0789474
NODE_90898_length_378_cov_2.534050	271	347	2	70	76	0.9210526
NODE_90898_length_378_cov_2.534050	331	360	2	29	29	1.0000000
NODE_90948_length_378_cov_2.093190	179	250	0	71	71	1.0000000
NODE_90948_length_378_cov_2.093190	183	219	0	36	36	1.0000000
NODE_91002_length_378_cov_1.813620	36	89	0	53	53	1.0000000
NODE_91475_length_377_cov_71.723022	19	99	0	80	80	1.0000000
NODE_91475_length_377_cov_71.723022	72	152	0	80	80	1.0000000
NODE_91475_length_377_cov_71.723022	148	228	0	80	80	1.0000000
NODE_91475_length_377_cov_71.723022	201	281	0	80	80	1.0000000
NODE_91477_length_377_cov_41.787770	210	290	0	6	80	0.0750000
NODE_91477_length_377_cov_41.787770	210	290	2	74	80	0.9250000
NODE_91477_length_377_cov_41.787770	263	343	0	40	80	0.5000000
NODE_91477_length_377_cov_41.787770	263	343	2	40	80	0.5000000
NODE_91478_length_377_cov_9.982014	32	83	4	51	51	1.0000000
NODE_91486_length_377_cov_6.244604	101	177	2	13	76	0.1710526
NODE_91486_length_377_cov_6.244604	101	177	4	50	76	0.6578947
NODE_91486_length_377_cov_6.244604	101	177	6	13	76	0.1710526
NODE_91494_length_377_cov_5.183453	169	224	0	55	55	1.0000000
NODE_91499_length_377_cov_4.586331	186	266	0	80	80	1.0000000
NODE_91499_length_377_cov_4.586331	239	319	0	80	80	1.0000000
NODE_91500_length_377_cov_4.431655	139	216	0	77	77	1.0000000
NODE_91502_length_377_cov_4.330935	134	214	0	80	80	1.0000000
NODE_91502_length_377_cov_4.330935	187	267	0	80	80	1.0000000
NODE_91506_length_377_cov_4.032374	124	181	0	57	57	1.0000000
NODE_91506_length_377_cov_4.032374	154	201	0	47	47	1.0000000
NODE_91526_length_377_cov_3.615108	82	140	0	58	58	1.0000000
NODE_91526_length_377_cov_3.615108	82	140	0	58	58	1.0000000
NODE_91526_length_377_cov_3.615108	113	193	0	80	80	1.0000000
NODE_91526_length_377_cov_3.615108	113	193	0	80	80	1.0000000
NODE_91526_length_377_cov_3.615108	189	258	0	69	69	1.0000000
NODE_91526_length_377_cov_3.615108	243	313	0	70	70	1.0000000
NODE_91553_length_377_cov_2.913669	38	61	2	19	23	0.8260869
NODE_91553_length_377_cov_2.913669	38	61	4	4	23	0.1739130
NODE_91553_length_377_cov_2.913669	167	228	0	6	61	0.0983607
NODE_91553_length_377_cov_2.913669	167	228	2	2	61	0.0327869
NODE_91553_length_377_cov_2.913669	167	228	4	37	61	0.6065574
NODE_91553_length_377_cov_2.913669	167	228	6	16	61	0.2622951
NODE_91619_length_377_cov_2.104317	137	188	0	1	51	0.0196078
NODE_91619_length_377_cov_2.104317	137	188	2	50	51	0.9803922
NODE_91619_length_377_cov_2.104317	168	211	2	43	43	1.0000000
NODE_91619_length_377_cov_2.104317	190	241	0	2	51	0.0392157
NODE_91619_length_377_cov_2.104317	190	241	2	49	51	0.9607843
NODE_91727_length_377_cov_1.622302	123	181	0	6	58	0.1034483
NODE_91727_length_377_cov_1.622302	123	181	4	52	58	0.8965517
NODE_91727_length_377_cov_1.622302	176	234	4	58	58	1.0000000
NODE_91749_length_377_cov_1.539568	230	310	0	14	80	0.1750000
NODE_91749_length_377_cov_1.539568	230	310	2	66	80	0.8250000
NODE_91749_length_377_cov_1.539568	230	310	0	14	80	0.1750000
NODE_91749_length_377_cov_1.539568	230	310	2	66	80	0.8250000
NODE_91749_length_377_cov_1.539568	306	377	0	71	71	1.0000000
NODE_91749_length_377_cov_1.539568	327	351	0	24	24	1.0000000
NODE_91765_length_377_cov_1.471223	118	198	14	8	80	0.1000000
NODE_91765_length_377_cov_1.471223	118	198	20	16	80	0.2000000
NODE_91765_length_377_cov_1.471223	118	198	21	22	80	0.2750000
NODE_91765_length_377_cov_1.471223	118	198	23	34	80	0.4250000
NODE_91790_length_377_cov_1.456835	177	257	0	80	80	1.0000000
NODE_91790_length_377_cov_1.456835	230	310	0	80	80	1.0000000
NODE_91817_length_377_cov_1.330935	0	44	0	3	44	0.0681818
NODE_91817_length_377_cov_1.330935	0	44	2	3	44	0.0681818
NODE_91817_length_377_cov_1.330935	0	44	4	38	44	0.8636364
NODE_91817_length_377_cov_1.330935	45	117	0	20	72	0.2777778
NODE_91817_length_377_cov_1.330935	45	117	2	27	72	0.3750000
NODE_91817_length_377_cov_1.330935	45	117	4	25	72	0.3472222
NODE_92046_length_377_cov_0.762590	299	330	0	31	31	1.0000000
NODE_92166_length_376_cov_6.938628	0	63	9	4	63	0.0634921
NODE_92166_length_376_cov_6.938628	0	63	11	12	63	0.1904762
NODE_92166_length_376_cov_6.938628	0	63	13	2	63	0.0317460
NODE_92166_length_376_cov_6.938628	0	63	15	3	63	0.0476190
NODE_92166_length_376_cov_6.938628	0	63	16	4	63	0.0634921
NODE_92166_length_376_cov_6.938628	0	63	18	15	63	0.2380952
NODE_92166_length_376_cov_6.938628	0	63	20	1	63	0.0158730
NODE_92166_length_376_cov_6.938628	0	63	22	6	63	0.0952381
NODE_92166_length_376_cov_6.938628	0	63	24	1	63	0.0158730
NODE_92166_length_376_cov_6.938628	0	63	26	1	63	0.0158730
NODE_92166_length_376_cov_6.938628	0	63	30	14	63	0.2222222
NODE_92166_length_376_cov_6.938628	269	340	14	4	71	0.0563380
NODE_92166_length_376_cov_6.938628	269	340	15	22	71	0.3098592
NODE_92166_length_376_cov_6.938628	269	340	16	45	71	0.6338028
NODE_92168_length_376_cov_6.415162	177	257	0	80	80	1.0000000
NODE_92168_length_376_cov_6.415162	230	310	0	80	80	1.0000000
NODE_92173_length_376_cov_5.722022	100	171	0	8	71	0.1126761
NODE_92173_length_376_cov_5.722022	100	171	3	1	71	0.0140845
NODE_92173_length_376_cov_5.722022	100	171	7	35	71	0.4929577
NODE_92173_length_376_cov_5.722022	100	171	8	27	71	0.3802817
NODE_92173_length_376_cov_5.722022	155	192	4	7	37	0.1891892
NODE_92173_length_376_cov_5.722022	155	192	6	2	37	0.0540541
NODE_92173_length_376_cov_5.722022	155	192	8	28	37	0.7567568
NODE_92191_length_376_cov_4.148014	300	330	0	30	30	1.0000000
NODE_92196_length_376_cov_3.859206	168	236	2	7	68	0.1029412
NODE_92196_length_376_cov_3.859206	168	236	4	3	68	0.0441176
NODE_92196_length_376_cov_3.859206	168	236	6	10	68	0.1470588
NODE_92196_length_376_cov_3.859206	168	236	8	48	68	0.7058824
NODE_92219_length_376_cov_3.140794	122	188	0	66	66	1.0000000
NODE_92442_length_376_cov_1.516245	57	106	4	40	49	0.8163266
NODE_92442_length_376_cov_1.516245	57	106	8	9	49	0.1836735
NODE_92879_length_375_cov_4.217391	321	350	0	29	29	1.0000000
NODE_92897_length_375_cov_3.699275	287	367	0	80	80	1.0000000
NODE_92911_length_375_cov_3.376812	70	136	0	20	66	0.3030303
NODE_92911_length_375_cov_3.376812	70	136	2	46	66	0.6969697
NODE_93031_length_375_cov_2.032609	162	224	2	32	62	0.5161290
NODE_93031_length_375_cov_2.032609	162	224	4	30	62	0.4838710
NODE_93031_length_375_cov_2.032609	215	272	4	12	57	0.2105263
NODE_93031_length_375_cov_2.032609	215	272	6	42	57	0.7368421
NODE_93031_length_375_cov_2.032609	215	272	8	3	57	0.0526316
NODE_93050_length_375_cov_1.967391	131	190	0	3	59	0.0508475
NODE_93050_length_375_cov_1.967391	131	190	2	56	59	0.9491525
NODE_93050_length_375_cov_1.967391	184	235	0	6	51	0.1176471
NODE_93050_length_375_cov_1.967391	184	235	2	45	51	0.8823529
NODE_93081_length_375_cov_1.840580	195	276	0	81	81	1.0000000
NODE_93386_length_375_cov_1.000000	320	375	0	55	55	1.0000000
NODE_93609_length_374_cov_4.563636	93	160	0	67	67	1.0000000
NODE_93609_length_374_cov_4.563636	146	213	0	34	67	0.5074627
NODE_93609_length_374_cov_4.563636	146	213	2	33	67	0.4925373
NODE_93612_length_374_cov_4.523636	23	101	0	38	78	0.4871795
NODE_93612_length_374_cov_4.523636	23	101	2	40	78	0.5128205
NODE_93612_length_374_cov_4.523636	81	154	0	49	73	0.6712329
NODE_93612_length_374_cov_4.523636	81	154	2	24	73	0.3287671
NODE_93628_length_374_cov_3.810909	130	189	2	2	59	0.0338983
NODE_93628_length_374_cov_3.810909	130	189	6	5	59	0.0847458
NODE_93628_length_374_cov_3.810909	130	189	8	8	59	0.1355932
NODE_93628_length_374_cov_3.810909	130	189	10	7	59	0.1186441
NODE_93628_length_374_cov_3.810909	130	189	14	3	59	0.0508475
NODE_93628_length_374_cov_3.810909	130	189	16	34	59	0.5762712
NODE_93628_length_374_cov_3.810909	162	242	8	10	80	0.1250000
NODE_93628_length_374_cov_3.810909	162	242	10	10	80	0.1250000
NODE_93628_length_374_cov_3.810909	162	242	14	6	80	0.0750000
NODE_93628_length_374_cov_3.810909	162	242	16	54	80	0.6750000
NODE_93630_length_374_cov_3.789091	236	271	0	35	35	1.0000000
NODE_93630_length_374_cov_3.789091	238	280	0	42	42	1.0000000
NODE_93637_length_374_cov_3.458182	190	248	0	58	58	1.0000000
NODE_93688_length_374_cov_2.600000	142	217	2	1	75	0.0133333
NODE_93688_length_374_cov_2.600000	142	217	6	47	75	0.6266667
NODE_93688_length_374_cov_2.600000	142	217	8	1	75	0.0133333
NODE_93688_length_374_cov_2.600000	142	217	10	1	75	0.0133333
NODE_93688_length_374_cov_2.600000	142	217	11	10	75	0.1333333
NODE_93688_length_374_cov_2.600000	142	217	15	12	75	0.1600000
NODE_93688_length_374_cov_2.600000	142	217	16	3	75	0.0400000
NODE_93688_length_374_cov_2.600000	190	270	8	1	80	0.0125000
NODE_93688_length_374_cov_2.600000	190	270	10	1	80	0.0125000
NODE_93688_length_374_cov_2.600000	190	270	11	16	80	0.2000000
NODE_93688_length_374_cov_2.600000	190	270	12	2	80	0.0250000
NODE_93688_length_374_cov_2.600000	190	270	14	3	80	0.0375000
NODE_93688_length_374_cov_2.600000	190	270	15	13	80	0.1625000
NODE_93688_length_374_cov_2.600000	190	270	16	44	80	0.5500000
NODE_93718_length_374_cov_2.330909	40	120	0	80	80	1.0000000
NODE_93769_length_374_cov_2.010909	40	105	0	17	65	0.2615385
NODE_93769_length_374_cov_2.010909	40	105	2	48	65	0.7384616
NODE_93821_length_374_cov_1.796364	254	288	0	34	34	1.0000000
NODE_93852_length_374_cov_1.661818	95	157	0	62	62	1.0000000
NODE_93859_length_374_cov_1.621818	202	254	0	13	52	0.2500000
NODE_93859_length_374_cov_1.621818	202	254	2	39	52	0.7500000
NODE_93936_length_374_cov_1.360000	211	291	2	62	80	0.7750000
NODE_93936_length_374_cov_1.360000	211	291	3	1	80	0.0125000
NODE_93936_length_374_cov_1.360000	211	291	4	1	80	0.0125000
NODE_93936_length_374_cov_1.360000	211	291	5	1	80	0.0125000
NODE_93936_length_374_cov_1.360000	211	291	6	15	80	0.1875000
NODE_93981_length_374_cov_1.236364	263	336	2	11	73	0.1506849
NODE_93981_length_374_cov_1.236364	263	336	4	62	73	0.8493150
NODE_94321_length_373_cov_31.302920	0	53	0	29	53	0.5471698
NODE_94321_length_373_cov_31.302920	0	53	2	1	53	0.0188679
NODE_94321_length_373_cov_31.302920	0	53	4	23	53	0.4339623
NODE_94321_length_373_cov_31.302920	0	53	0	29	53	0.5471698
NODE_94321_length_373_cov_31.302920	0	53	2	1	53	0.0188679
NODE_94321_length_373_cov_31.302920	0	53	4	23	53	0.4339623
NODE_94321_length_373_cov_31.302920	0	53	0	29	53	0.5471698
NODE_94321_length_373_cov_31.302920	0	53	2	1	53	0.0188679
NODE_94321_length_373_cov_31.302920	0	53	4	23	53	0.4339623
NODE_94321_length_373_cov_31.302920	26	106	0	3	80	0.0375000
NODE_94321_length_373_cov_31.302920	26	106	2	1	80	0.0125000
NODE_94321_length_373_cov_31.302920	26	106	4	76	80	0.9500000
NODE_94340_length_373_cov_4.671533	76	142	2	66	66	1.0000000
NODE_94340_length_373_cov_4.671533	115	195	0	29	80	0.3625000
NODE_94340_length_373_cov_4.671533	115	195	2	51	80	0.6375000
NODE_94340_length_373_cov_4.671533	115	195	0	29	80	0.3625000
NODE_94340_length_373_cov_4.671533	115	195	2	51	80	0.6375000
NODE_94340_length_373_cov_4.671533	288	368	0	5	80	0.0625000
NODE_94340_length_373_cov_4.671533	288	368	2	75	80	0.9375000
NODE_94352_length_373_cov_4.080292	109	189	0	80	80	1.0000000
NODE_94352_length_373_cov_4.080292	162	220	0	27	58	0.4655173
NODE_94352_length_373_cov_4.080292	162	220	2	1	58	0.0172414
NODE_94352_length_373_cov_4.080292	162	220	4	12	58	0.2068966
NODE_94352_length_373_cov_4.080292	162	220	6	18	58	0.3103448
NODE_94380_length_373_cov_3.167883	131	210	8	71	79	0.8987342
NODE_94380_length_373_cov_3.167883	131	210	10	8	79	0.1012658
NODE_94414_length_373_cov_2.751825	80	151	0	56	71	0.7887324
NODE_94414_length_373_cov_2.751825	80	151	2	15	71	0.2112676
NODE_94414_length_373_cov_2.751825	124	162	0	12	38	0.3157895
NODE_94414_length_373_cov_2.751825	124	162	2	18	38	0.4736842
NODE_94414_length_373_cov_2.751825	124	162	6	8	38	0.2105263
NODE_94493_length_373_cov_2.036496	248	326	0	59	78	0.7564102
NODE_94493_length_373_cov_2.036496	248	326	1	8	78	0.1025641
NODE_94493_length_373_cov_2.036496	248	326	3	1	78	0.0128205
NODE_94493_length_373_cov_2.036496	248	326	5	10	78	0.1282051
NODE_94493_length_373_cov_2.036496	299	359	0	60	60	1.0000000
NODE_94500_length_373_cov_2.003650	150	194	0	44	44	1.0000000
NODE_94937_length_373_cov_0.759124	62	114	0	41	52	0.7884616
NODE_94937_length_373_cov_0.759124	62	114	2	11	52	0.2115385
NODE_95051_length_372_cov_30.135531	111	191	0	80	80	1.0000000
NODE_95051_length_372_cov_30.135531	159	222	0	63	63	1.0000000
NODE_95051_length_372_cov_30.135531	164	239	0	75	75	1.0000000
NODE_95051_length_372_cov_30.135531	182	253	0	71	71	1.0000000
NODE_95051_length_372_cov_30.135531	195	275	0	80	80	1.0000000
NODE_95051_length_372_cov_30.135531	213	276	0	63	63	1.0000000
NODE_95053_length_372_cov_9.091575	150	230	0	80	80	1.0000000
NODE_95053_length_372_cov_9.091575	203	283	0	80	80	1.0000000
NODE_95063_length_372_cov_5.706960	168	208	0	40	40	1.0000000
NODE_95067_length_372_cov_5.124542	146	211	0	65	65	1.0000000
NODE_95067_length_372_cov_5.124542	189	264	0	67	75	0.8933333
NODE_95067_length_372_cov_5.124542	189	264	4	8	75	0.1066667
NODE_95090_length_372_cov_3.761905	177	221	0	6	44	0.1363636
NODE_95090_length_372_cov_3.761905	177	221	2	38	44	0.8636364
NODE_95109_length_372_cov_3.186813	137	218	0	18	81	0.2222222
NODE_95109_length_372_cov_3.186813	137	218	1	63	81	0.7777778
NODE_95159_length_372_cov_2.582418	167	239	12	22	72	0.3055556
NODE_95159_length_372_cov_2.582418	167	239	16	3	72	0.0416667
NODE_95159_length_372_cov_2.582418	167	239	18	4	72	0.0555556
NODE_95159_length_372_cov_2.582418	167	239	20	2	72	0.0277778
NODE_95159_length_372_cov_2.582418	167	239	22	41	72	0.5694444
NODE_95159_length_372_cov_2.582418	212	292	6	7	80	0.0875000
NODE_95159_length_372_cov_2.582418	212	292	8	6	80	0.0750000
NODE_95159_length_372_cov_2.582418	212	292	14	3	80	0.0375000
NODE_95159_length_372_cov_2.582418	212	292	16	15	80	0.1875000
NODE_95159_length_372_cov_2.582418	212	292	18	4	80	0.0500000
NODE_95159_length_372_cov_2.582418	212	292	20	8	80	0.1000000
NODE_95159_length_372_cov_2.582418	212	292	22	37	80	0.4625000
NODE_95183_length_372_cov_2.347985	97	141	0	44	44	1.0000000
NODE_95183_length_372_cov_2.347985	98	133	0	35	35	1.0000000
NODE_95183_length_372_cov_2.347985	178	243	2	65	65	1.0000000
NODE_95303_length_372_cov_1.699634	195	276	8	3	81	0.0370370
NODE_95303_length_372_cov_1.699634	195	276	10	3	81	0.0370370
NODE_95303_length_372_cov_1.699634	195	276	12	4	81	0.0493827
NODE_95303_length_372_cov_1.699634	195	276	14	71	81	0.8765432
NODE_95453_length_372_cov_1.223443	264	334	0	70	70	1.0000000
NODE_95784_length_371_cov_52.040441	104	184	0	75	80	0.9375000
NODE_95784_length_371_cov_52.040441	104	184	1	5	80	0.0625000
NODE_95784_length_371_cov_52.040441	157	237	0	22	80	0.2750000
NODE_95784_length_371_cov_52.040441	157	237	1	11	80	0.1375000
NODE_95784_length_371_cov_52.040441	157	237	2	2	80	0.0250000
NODE_95784_length_371_cov_52.040441	157	237	4	6	80	0.0750000
NODE_95784_length_371_cov_52.040441	157	237	6	6	80	0.0750000
NODE_95784_length_371_cov_52.040441	157	237	7	2	80	0.0250000
NODE_95784_length_371_cov_52.040441	157	237	8	13	80	0.1625000
NODE_95784_length_371_cov_52.040441	157	237	10	1	80	0.0125000
NODE_95784_length_371_cov_52.040441	157	237	14	1	80	0.0125000
NODE_95784_length_371_cov_52.040441	157	237	15	1	80	0.0125000
NODE_95784_length_371_cov_52.040441	157	237	16	4	80	0.0500000
NODE_95784_length_371_cov_52.040441	157	237	18	4	80	0.0500000
NODE_95784_length_371_cov_52.040441	157	237	20	7	80	0.0875000
NODE_95784_length_371_cov_52.040441	180	232	1	10	52	0.1923077
NODE_95784_length_371_cov_52.040441	180	232	2	2	52	0.0384615
NODE_95784_length_371_cov_52.040441	180	232	4	6	52	0.1153846
NODE_95784_length_371_cov_52.040441	180	232	6	6	52	0.1153846
NODE_95784_length_371_cov_52.040441	180	232	7	2	52	0.0384615
NODE_95784_length_371_cov_52.040441	180	232	8	13	52	0.2500000
NODE_95784_length_371_cov_52.040441	180	232	10	1	52	0.0192308
NODE_95784_length_371_cov_52.040441	180	232	14	1	52	0.0192308
NODE_95784_length_371_cov_52.040441	180	232	15	1	52	0.0192308
NODE_95784_length_371_cov_52.040441	180	232	16	4	52	0.0769231
NODE_95784_length_371_cov_52.040441	180	232	18	4	52	0.0769231
NODE_95784_length_371_cov_52.040441	180	232	20	2	52	0.0384615
NODE_95785_length_371_cov_24.878676	91	171	0	80	80	1.0000000
NODE_95785_length_371_cov_24.878676	144	224	0	80	80	1.0000000
NODE_95797_length_371_cov_5.738971	170	245	6	25	75	0.3333333
NODE_95797_length_371_cov_5.738971	170	245	7	47	75	0.6266667
NODE_95797_length_371_cov_5.738971	170	245	8	3	75	0.0400000
NODE_95797_length_371_cov_5.738971	218	298	6	15	80	0.1875000
NODE_95797_length_371_cov_5.738971	218	298	7	24	80	0.3000000
NODE_95797_length_371_cov_5.738971	218	298	8	25	80	0.3125000
NODE_95797_length_371_cov_5.738971	218	298	9	13	80	0.1625000
NODE_95797_length_371_cov_5.738971	218	298	11	3	80	0.0375000
NODE_95807_length_371_cov_4.452206	65	145	0	80	80	1.0000000
NODE_95807_length_371_cov_4.452206	118	198	0	80	80	1.0000000
NODE_95863_length_371_cov_2.841912	288	350	0	57	62	0.9193549
NODE_95863_length_371_cov_2.841912	288	350	7	3	62	0.0483871
NODE_95863_length_371_cov_2.841912	288	350	23	2	62	0.0322581
NODE_96013_length_371_cov_1.790441	188	235	0	47	47	1.0000000
NODE_96105_length_371_cov_1.422794	199	287	0	88	88	1.0000000
NODE_96500_length_370_cov_50.380074	144	224	0	80	80	1.0000000
NODE_96500_length_370_cov_50.380074	197	277	0	80	80	1.0000000
NODE_96504_length_370_cov_7.553506	105	162	6	6	57	0.1052632
NODE_96504_length_370_cov_7.553506	105	162	10	8	57	0.1403509
NODE_96504_length_370_cov_7.553506	105	162	11	6	57	0.1052632
NODE_96504_length_370_cov_7.553506	105	162	13	37	57	0.6491228
NODE_96510_length_370_cov_5.811808	153	221	0	68	68	1.0000000
NODE_96510_length_370_cov_5.811808	206	286	0	80	80	1.0000000
NODE_96522_length_370_cov_4.915129	157	207	6	34	50	0.6800000
NODE_96522_length_370_cov_4.915129	157	207	10	16	50	0.3200000
NODE_96528_length_370_cov_4.535055	141	221	0	80	80	1.0000000
NODE_96528_length_370_cov_4.535055	194	274	0	80	80	1.0000000
NODE_96532_length_370_cov_4.199262	230	275	4	11	45	0.2444444
NODE_96532_length_370_cov_4.199262	230	275	6	34	45	0.7555556
NODE_96533_length_370_cov_4.151292	142	209	0	67	67	1.0000000
NODE_96542_length_370_cov_3.719557	214	251	24	14	37	0.3783784
NODE_96542_length_370_cov_3.719557	214	251	25	4	37	0.1081081
NODE_96542_length_370_cov_3.719557	214	251	26	19	37	0.5135135
NODE_96581_length_370_cov_2.822878	126	173	0	4	47	0.0851064
NODE_96581_length_370_cov_2.822878	126	173	1	7	47	0.1489362
NODE_96581_length_370_cov_2.822878	126	173	4	36	47	0.7659575
NODE_96668_length_370_cov_2.081181	0	52	0	1	52	0.0192308
NODE_96668_length_370_cov_2.081181	0	52	4	1	52	0.0192308
NODE_96668_length_370_cov_2.081181	0	52	10	2	52	0.0384615
NODE_96668_length_370_cov_2.081181	0	52	16	1	52	0.0192308
NODE_96668_length_370_cov_2.081181	0	52	20	1	52	0.0192308
NODE_96668_length_370_cov_2.081181	0	52	22	2	52	0.0384615
NODE_96668_length_370_cov_2.081181	0	52	24	3	52	0.0576923
NODE_96668_length_370_cov_2.081181	0	52	26	3	52	0.0576923
NODE_96668_length_370_cov_2.081181	0	52	36	2	52	0.0384615
NODE_96668_length_370_cov_2.081181	0	52	38	8	52	0.1538462
NODE_96668_length_370_cov_2.081181	0	52	40	4	52	0.0769231
NODE_96668_length_370_cov_2.081181	0	52	42	1	52	0.0192308
NODE_96668_length_370_cov_2.081181	0	52	44	6	52	0.1153846
NODE_96668_length_370_cov_2.081181	0	52	46	1	52	0.0192308
NODE_96668_length_370_cov_2.081181	0	52	48	1	52	0.0192308
NODE_96668_length_370_cov_2.081181	0	52	61	3	52	0.0576923
NODE_96668_length_370_cov_2.081181	0	52	64	4	52	0.0769231
NODE_96668_length_370_cov_2.081181	0	52	68	8	52	0.1538462
NODE_97207_length_369_cov_36.811111	273	358	0	16	85	0.1882353
NODE_97207_length_369_cov_36.811111	273	358	2	1	85	0.0117647
NODE_97207_length_369_cov_36.811111	273	358	4	1	85	0.0117647
NODE_97207_length_369_cov_36.811111	273	358	5	5	85	0.0588235
NODE_97207_length_369_cov_36.811111	273	358	10	14	85	0.1647059
NODE_97207_length_369_cov_36.811111	273	358	12	4	85	0.0470588
NODE_97207_length_369_cov_36.811111	273	358	14	10	85	0.1176471
NODE_97207_length_369_cov_36.811111	273	358	19	14	85	0.1647059
NODE_97207_length_369_cov_36.811111	273	358	20	20	85	0.2352941
NODE_97207_length_369_cov_36.811111	273	358	0	16	85	0.1882353
NODE_97207_length_369_cov_36.811111	273	358	2	1	85	0.0117647
NODE_97207_length_369_cov_36.811111	273	358	4	1	85	0.0117647
NODE_97207_length_369_cov_36.811111	273	358	5	5	85	0.0588235
NODE_97207_length_369_cov_36.811111	273	358	10	14	85	0.1647059
NODE_97207_length_369_cov_36.811111	273	358	12	4	85	0.0470588
NODE_97207_length_369_cov_36.811111	273	358	14	10	85	0.1176471
NODE_97207_length_369_cov_36.811111	273	358	19	14	85	0.1647059
NODE_97207_length_369_cov_36.811111	273	358	20	20	85	0.2352941
NODE_97207_length_369_cov_36.811111	273	358	0	16	85	0.1882353
NODE_97207_length_369_cov_36.811111	273	358	2	1	85	0.0117647
NODE_97207_length_369_cov_36.811111	273	358	4	1	85	0.0117647
NODE_97207_length_369_cov_36.811111	273	358	5	5	85	0.0588235
NODE_97207_length_369_cov_36.811111	273	358	10	14	85	0.1647059
NODE_97207_length_369_cov_36.811111	273	358	12	4	85	0.0470588
NODE_97207_length_369_cov_36.811111	273	358	14	10	85	0.1176471
NODE_97207_length_369_cov_36.811111	273	358	19	14	85	0.1647059
NODE_97207_length_369_cov_36.811111	273	358	20	20	85	0.2352941
NODE_97211_length_369_cov_8.751852	107	187	2	10	80	0.1250000
NODE_97211_length_369_cov_8.751852	107	187	4	70	80	0.8750000
NODE_97226_length_369_cov_6.677778	189	269	4	80	80	1.0000000
NODE_97226_length_369_cov_6.677778	242	323	0	43	81	0.5308642
NODE_97226_length_369_cov_6.677778	242	323	4	38	81	0.4691358
NODE_97236_length_369_cov_5.337037	199	264	0	64	65	0.9846154
NODE_97236_length_369_cov_5.337037	199	264	2	1	65	0.0153846
NODE_97249_length_369_cov_4.459259	89	157	0	56	68	0.8235294
NODE_97249_length_369_cov_4.459259	89	157	4	12	68	0.1764706
NODE_97249_length_369_cov_4.459259	130	210	0	15	80	0.1875000
NODE_97249_length_369_cov_4.459259	130	210	4	65	80	0.8125000
NODE_97255_length_369_cov_4.111111	216	279	0	63	63	1.0000000
NODE_97265_length_369_cov_3.837037	205	238	0	15	33	0.4545455
NODE_97265_length_369_cov_3.837037	205	238	4	18	33	0.5454546
NODE_97265_length_369_cov_3.837037	211	291	0	68	80	0.8500000
NODE_97265_length_369_cov_3.837037	211	291	4	12	80	0.1500000
NODE_97265_length_369_cov_3.837037	287	316	0	29	29	1.0000000
NODE_97346_length_369_cov_2.355556	62	142	0	80	80	1.0000000
NODE_97346_length_369_cov_2.355556	114	195	0	64	81	0.7901235
NODE_97346_length_369_cov_2.355556	114	195	2	17	81	0.2098765
NODE_97440_length_369_cov_1.803704	170	235	0	65	65	1.0000000
NODE_97936_length_368_cov_42.208178	231	311	0	5	80	0.0625000
NODE_97936_length_368_cov_42.208178	231	311	2	47	80	0.5875000
NODE_97936_length_368_cov_42.208178	231	311	4	28	80	0.3500000
NODE_97936_length_368_cov_42.208178	284	364	0	58	80	0.7250000
NODE_97936_length_368_cov_42.208178	284	364	2	22	80	0.2750000
NODE_97939_length_368_cov_11.988848	47	127	0	80	80	1.0000000
NODE_97939_length_368_cov_11.988848	100	180	0	80	80	1.0000000
NODE_97945_length_368_cov_6.267658	133	213	0	80	80	1.0000000
NODE_97945_length_368_cov_6.267658	186	266	0	80	80	1.0000000
NODE_97997_length_368_cov_3.486989	127	207	0	19	80	0.2375000
NODE_97997_length_368_cov_3.486989	127	207	2	52	80	0.6500000
NODE_97997_length_368_cov_3.486989	127	207	4	9	80	0.1125000
NODE_98008_length_368_cov_3.282528	182	255	1	5	73	0.0684932
NODE_98008_length_368_cov_3.282528	182	255	2	6	73	0.0821918
NODE_98008_length_368_cov_3.282528	182	255	4	8	73	0.1095890
NODE_98008_length_368_cov_3.282528	182	255	6	5	73	0.0684932
NODE_98008_length_368_cov_3.282528	182	255	7	17	73	0.2328767
NODE_98008_length_368_cov_3.282528	182	255	8	32	73	0.4383562
NODE_98058_length_368_cov_2.605948	192	246	0	39	54	0.7222222
NODE_98058_length_368_cov_2.605948	192	246	2	2	54	0.0370370
NODE_98058_length_368_cov_2.605948	192	246	4	13	54	0.2407407
NODE_98123_length_368_cov_2.182156	85	145	0	60	60	1.0000000
NODE_98129_length_368_cov_2.137546	66	107	6	2	41	0.0487805
NODE_98129_length_368_cov_2.137546	66	107	8	2	41	0.0487805
NODE_98129_length_368_cov_2.137546	66	107	12	1	41	0.0243902
NODE_98129_length_368_cov_2.137546	66	107	14	1	41	0.0243902
NODE_98129_length_368_cov_2.137546	66	107	16	17	41	0.4146341
NODE_98129_length_368_cov_2.137546	66	107	18	7	41	0.1707317
NODE_98129_length_368_cov_2.137546	66	107	20	11	41	0.2682927
NODE_98157_length_368_cov_1.944238	192	272	0	22	80	0.2750000
NODE_98157_length_368_cov_1.944238	192	272	2	58	80	0.7250000
NODE_98723_length_367_cov_7.156716	174	254	0	80	80	1.0000000
NODE_98723_length_367_cov_7.156716	227	307	0	80	80	1.0000000
NODE_98734_length_367_cov_5.313433	148	206	0	38	58	0.6551724
NODE_98734_length_367_cov_5.313433	148	206	4	4	58	0.0689655
NODE_98734_length_367_cov_5.313433	148	206	6	8	58	0.1379310
NODE_98734_length_367_cov_5.313433	148	206	8	8	58	0.1379310
NODE_98737_length_367_cov_5.138060	58	138	0	80	80	1.0000000
NODE_98737_length_367_cov_5.138060	111	191	0	80	80	1.0000000
NODE_98796_length_367_cov_3.059701	110	154	2	4	44	0.0909091
NODE_98796_length_367_cov_3.059701	110	154	3	8	44	0.1818182
NODE_98796_length_367_cov_3.059701	110	154	5	11	44	0.2500000
NODE_98796_length_367_cov_3.059701	110	154	9	21	44	0.4772727
NODE_98796_length_367_cov_3.059701	111	146	2	4	35	0.1142857
NODE_98796_length_367_cov_3.059701	111	146	5	11	35	0.3142857
NODE_98796_length_367_cov_3.059701	111	146	9	20	35	0.5714286
NODE_98843_length_367_cov_2.384328	246	326	0	33	80	0.4125000
NODE_98843_length_367_cov_2.384328	246	326	2	5	80	0.0625000
NODE_98843_length_367_cov_2.384328	246	326	4	42	80	0.5250000
NODE_98843_length_367_cov_2.384328	299	367	0	68	68	1.0000000
NODE_98849_length_367_cov_2.332090	127	207	0	80	80	1.0000000
NODE_98909_length_367_cov_1.944030	91	156	0	65	65	1.0000000
NODE_98980_length_367_cov_1.679104	173	252	8	4	79	0.0506329
NODE_98980_length_367_cov_1.679104	173	252	10	10	79	0.1265823
NODE_98980_length_367_cov_1.679104	173	252	13	14	79	0.1772152
NODE_98980_length_367_cov_1.679104	173	252	14	11	79	0.1392405
NODE_98980_length_367_cov_1.679104	173	252	15	32	79	0.4050633
NODE_98980_length_367_cov_1.679104	173	252	16	1	79	0.0126582
NODE_98980_length_367_cov_1.679104	173	252	17	7	79	0.0886076
NODE_99005_length_367_cov_1.552239	148	200	0	14	52	0.2692308
NODE_99005_length_367_cov_1.552239	148	200	2	38	52	0.7307692
NODE_99138_length_367_cov_1.201493	79	159	0	80	80	1.0000000
NODE_99138_length_367_cov_1.201493	136	179	0	43	43	1.0000000
NODE_99318_length_367_cov_0.761194	288	357	0	69	69	1.0000000
NODE_99451_length_366_cov_5.239700	193	253	0	60	60	1.0000000
NODE_99472_length_366_cov_4.168539	302	355	0	53	53	1.0000000
NODE_99478_length_366_cov_3.913858	183	229	2	46	46	1.0000000
NODE_99478_length_366_cov_3.913858	203	282	0	14	79	0.1772152
NODE_99478_length_366_cov_3.913858	203	282	2	65	79	0.8227848
NODE_99496_length_366_cov_3.168539	88	160	0	23	72	0.3194444
NODE_99496_length_366_cov_3.168539	88	160	1	49	72	0.6805556
NODE_99496_length_366_cov_3.168539	133	193	1	34	60	0.5666667
NODE_99496_length_366_cov_3.168539	133	193	2	2	60	0.0333333
NODE_99496_length_366_cov_3.168539	133	193	3	24	60	0.4000000
NODE_100137_length_365_cov_140.101504	40	107	76	1	67	0.0149254
NODE_100137_length_365_cov_140.101504	40	107	80	1	67	0.0149254
NODE_100137_length_365_cov_140.101504	40	107	86	2	67	0.0298507
NODE_100137_length_365_cov_140.101504	40	107	90	3	67	0.0447761
NODE_100137_length_365_cov_140.101504	40	107	100	6	67	0.0895522
NODE_100137_length_365_cov_140.101504	40	107	106	3	67	0.0447761
NODE_100137_length_365_cov_140.101504	40	107	115	1	67	0.0149254
NODE_100137_length_365_cov_140.101504	40	107	116	2	67	0.0298507
NODE_100137_length_365_cov_140.101504	40	107	124	1	67	0.0149254
NODE_100137_length_365_cov_140.101504	40	107	128	1	67	0.0149254
NODE_100137_length_365_cov_140.101504	40	107	130	1	67	0.0149254
NODE_100137_length_365_cov_140.101504	40	107	132	3	67	0.0447761
NODE_100137_length_365_cov_140.101504	40	107	138	1	67	0.0149254
NODE_100137_length_365_cov_140.101504	40	107	142	1	67	0.0149254
NODE_100137_length_365_cov_140.101504	40	107	144	2	67	0.0298507
NODE_100137_length_365_cov_140.101504	40	107	150	1	67	0.0149254
NODE_100137_length_365_cov_140.101504	40	107	152	1	67	0.0149254
NODE_100137_length_365_cov_140.101504	40	107	154	1	67	0.0149254
NODE_100137_length_365_cov_140.101504	40	107	160	1	67	0.0149254
NODE_100137_length_365_cov_140.101504	40	107	164	2	67	0.0298507
NODE_100137_length_365_cov_140.101504	40	107	176	3	67	0.0447761
NODE_100137_length_365_cov_140.101504	40	107	178	4	67	0.0597015
NODE_100137_length_365_cov_140.101504	40	107	180	7	67	0.1044776
NODE_100137_length_365_cov_140.101504	40	107	184	2	67	0.0298507
NODE_100137_length_365_cov_140.101504	40	107	186	1	67	0.0149254
NODE_100137_length_365_cov_140.101504	40	107	190	14	67	0.2089552
NODE_100137_length_365_cov_140.101504	40	107	192	1	67	0.0149254
NODE_100138_length_365_cov_45.815789	0	38	0	38	38	1.0000000
NODE_100138_length_365_cov_45.815789	11	91	0	80	80	1.0000000
NODE_100140_length_365_cov_8.169173	191	244	2	8	53	0.1509434
NODE_100140_length_365_cov_8.169173	191	244	4	2	53	0.0377358
NODE_100140_length_365_cov_8.169173	191	244	6	2	53	0.0377358
NODE_100140_length_365_cov_8.169173	191	244	8	37	53	0.6981132
NODE_100140_length_365_cov_8.169173	191	244	10	4	53	0.0754717
NODE_100140_length_365_cov_8.169173	217	297	4	23	80	0.2875000
NODE_100140_length_365_cov_8.169173	217	297	6	4	80	0.0500000
NODE_100140_length_365_cov_8.169173	217	297	8	50	80	0.6250000
NODE_100140_length_365_cov_8.169173	217	297	10	3	80	0.0375000
NODE_100145_length_365_cov_5.954887	136	216	4	5	80	0.0625000
NODE_100145_length_365_cov_5.954887	136	216	6	56	80	0.7000000
NODE_100145_length_365_cov_5.954887	136	216	8	19	80	0.2375000
NODE_100145_length_365_cov_5.954887	189	269	0	3	80	0.0375000
NODE_100145_length_365_cov_5.954887	189	269	2	7	80	0.0875000
NODE_100145_length_365_cov_5.954887	189	269	4	29	80	0.3625000
NODE_100145_length_365_cov_5.954887	189	269	6	41	80	0.5125000
NODE_100147_length_365_cov_5.721805	37	78	0	41	41	1.0000000
NODE_100168_length_365_cov_4.195489	269	329	20	2	60	0.0333333
NODE_100168_length_365_cov_4.195489	269	329	22	14	60	0.2333333
NODE_100168_length_365_cov_4.195489	269	329	28	6	60	0.1000000
NODE_100168_length_365_cov_4.195489	269	329	30	12	60	0.2000000
NODE_100168_length_365_cov_4.195489	269	329	32	26	60	0.4333333
NODE_100172_length_365_cov_4.071429	106	186	0	35	80	0.4375000
NODE_100172_length_365_cov_4.071429	106	186	4	45	80	0.5625000
NODE_100172_length_365_cov_4.071429	159	239	2	16	80	0.2000000
NODE_100172_length_365_cov_4.071429	159	239	4	64	80	0.8000000
NODE_100180_length_365_cov_3.879699	131	187	0	44	56	0.7857143
NODE_100180_length_365_cov_3.879699	131	187	2	12	56	0.2142857
NODE_100206_length_365_cov_3.270677	211	280	0	69	69	1.0000000
NODE_100253_length_365_cov_2.601504	189	265	0	76	76	1.0000000
NODE_100293_length_365_cov_2.289474	169	249	0	80	80	1.0000000
NODE_100407_length_365_cov_1.635338	156	235	2	12	79	0.1518987
NODE_100407_length_365_cov_1.635338	156	235	4	1	79	0.0126582
NODE_100407_length_365_cov_1.635338	156	235	6	2	79	0.0253165
NODE_100407_length_365_cov_1.635338	156	235	8	18	79	0.2278481
NODE_100407_length_365_cov_1.635338	156	235	10	9	79	0.1139240
NODE_100407_length_365_cov_1.635338	156	235	12	3	79	0.0379747
NODE_100407_length_365_cov_1.635338	156	235	14	9	79	0.1139240
NODE_100407_length_365_cov_1.635338	156	235	16	2	79	0.0253165
NODE_100407_length_365_cov_1.635338	156	235	18	14	79	0.1772152
NODE_100407_length_365_cov_1.635338	156	235	20	9	79	0.1139240
NODE_100485_length_365_cov_1.421053	228	309	0	48	81	0.5925926
NODE_100485_length_365_cov_1.421053	228	309	2	33	81	0.4074074
NODE_100570_length_365_cov_1.169173	57	137	0	30	80	0.3750000
NODE_100570_length_365_cov_1.169173	57	137	2	50	80	0.6250000
NODE_100570_length_365_cov_1.169173	65	145	0	22	80	0.2750000
NODE_100570_length_365_cov_1.169173	65	145	2	58	80	0.7250000
NODE_100570_length_365_cov_1.169173	194	274	0	4	80	0.0500000
NODE_100570_length_365_cov_1.169173	194	274	2	2	80	0.0250000
NODE_100570_length_365_cov_1.169173	194	274	4	14	80	0.1750000
NODE_100570_length_365_cov_1.169173	194	274	6	30	80	0.3750000
NODE_100570_length_365_cov_1.169173	194	274	8	5	80	0.0625000
NODE_100570_length_365_cov_1.169173	194	274	10	23	80	0.2875000
NODE_100570_length_365_cov_1.169173	194	274	12	2	80	0.0250000
NODE_100893_length_364_cov_24.600000	101	181	0	80	80	1.0000000
NODE_100893_length_364_cov_24.600000	154	234	0	80	80	1.0000000
NODE_100896_length_364_cov_7.377358	0	50	0	50	50	1.0000000
NODE_100933_length_364_cov_3.988679	122	168	0	35	46	0.7608696
NODE_100933_length_364_cov_3.988679	122	168	4	11	46	0.2391304
NODE_100935_length_364_cov_3.913208	151	208	0	57	57	1.0000000
NODE_100959_length_364_cov_3.305660	296	358	1	10	62	0.1612903
NODE_100959_length_364_cov_3.305660	296	358	2	38	62	0.6129032
NODE_100959_length_364_cov_3.305660	296	358	4	14	62	0.2258064
NODE_100966_length_364_cov_3.181132	78	138	0	60	60	1.0000000
NODE_100975_length_364_cov_3.041509	264	321	2	25	57	0.4385965
NODE_100975_length_364_cov_3.041509	264	321	4	32	57	0.5614035
NODE_100975_length_364_cov_3.041509	294	359	2	6	65	0.0923077
NODE_100975_length_364_cov_3.041509	294	359	4	59	65	0.9076923
NODE_100978_length_364_cov_3.015094	238	274	4	36	36	1.0000000
NODE_101087_length_364_cov_1.977358	126	201	4	34	75	0.4533333
NODE_101087_length_364_cov_1.977358	126	201	6	41	75	0.5466667
NODE_101141_length_364_cov_1.811321	209	256	2	47	47	1.0000000
NODE_101148_length_364_cov_1.781132	130	203	0	4	73	0.0547945
NODE_101148_length_364_cov_1.781132	130	203	2	2	73	0.0273973
NODE_101148_length_364_cov_1.781132	130	203	4	50	73	0.6849315
NODE_101148_length_364_cov_1.781132	130	203	6	4	73	0.0547945
NODE_101148_length_364_cov_1.781132	130	203	8	13	73	0.1780822
NODE_101148_length_364_cov_1.781132	183	203	0	4	20	0.2000000
NODE_101148_length_364_cov_1.781132	183	203	2	2	20	0.1000000
NODE_101148_length_364_cov_1.781132	183	203	4	14	20	0.7000000
NODE_101720_length_363_cov_7.791667	121	200	2	7	79	0.0886076
NODE_101720_length_363_cov_7.791667	121	200	4	28	79	0.3544304
NODE_101720_length_363_cov_7.791667	121	200	6	44	79	0.5569620
NODE_101725_length_363_cov_6.484848	33	90	6	8	57	0.1403509
NODE_101725_length_363_cov_6.484848	33	90	8	49	57	0.8596491
NODE_101725_length_363_cov_6.484848	93	146	2	2	53	0.0377358
NODE_101725_length_363_cov_6.484848	93	146	4	23	53	0.4339623
NODE_101725_length_363_cov_6.484848	93	146	6	11	53	0.2075472
NODE_101725_length_363_cov_6.484848	93	146	8	17	53	0.3207547
NODE_101734_length_363_cov_4.825758	154	215	2	23	61	0.3770492
NODE_101734_length_363_cov_4.825758	154	215	4	38	61	0.6229508
NODE_101760_length_363_cov_3.950758	112	183	0	1	71	0.0140845
NODE_101760_length_363_cov_3.950758	112	183	2	70	71	0.9859155
NODE_101760_length_363_cov_3.950758	156	236	0	54	80	0.6750000
NODE_101760_length_363_cov_3.950758	156	236	2	26	80	0.3250000
NODE_101769_length_363_cov_3.617424	16	79	2	1	63	0.0158730
NODE_101769_length_363_cov_3.617424	16	79	5	6	63	0.0952381
NODE_101769_length_363_cov_3.617424	16	79	9	30	63	0.4761905
NODE_101769_length_363_cov_3.617424	16	79	10	26	63	0.4126984
NODE_101774_length_363_cov_3.409091	241	267	0	26	26	1.0000000
NODE_101791_length_363_cov_3.087121	228	308	2	13	80	0.1625000
NODE_101791_length_363_cov_3.087121	228	308	4	2	80	0.0250000
NODE_101791_length_363_cov_3.087121	228	308	6	48	80	0.6000000
NODE_101791_length_363_cov_3.087121	228	308	8	6	80	0.0750000
NODE_101791_length_363_cov_3.087121	228	308	10	11	80	0.1375000
NODE_101809_length_363_cov_2.795455	240	320	12	14	80	0.1750000
NODE_101809_length_363_cov_2.795455	240	320	14	1	80	0.0125000
NODE_101809_length_363_cov_2.795455	240	320	16	2	80	0.0250000
NODE_101809_length_363_cov_2.795455	240	320	18	1	80	0.0125000
NODE_101809_length_363_cov_2.795455	240	320	20	6	80	0.0750000
NODE_101809_length_363_cov_2.795455	240	320	22	4	80	0.0500000
NODE_101809_length_363_cov_2.795455	240	320	24	2	80	0.0250000
NODE_101809_length_363_cov_2.795455	240	320	26	1	80	0.0125000
NODE_101809_length_363_cov_2.795455	240	320	28	3	80	0.0375000
NODE_101809_length_363_cov_2.795455	240	320	29	1	80	0.0125000
NODE_101809_length_363_cov_2.795455	240	320	30	2	80	0.0250000
NODE_101809_length_363_cov_2.795455	240	320	34	3	80	0.0375000
NODE_101809_length_363_cov_2.795455	240	320	36	1	80	0.0125000
NODE_101809_length_363_cov_2.795455	240	320	38	2	80	0.0250000
NODE_101809_length_363_cov_2.795455	240	320	39	4	80	0.0500000
NODE_101809_length_363_cov_2.795455	240	320	41	3	80	0.0375000
NODE_101809_length_363_cov_2.795455	240	320	43	7	80	0.0875000
NODE_101809_length_363_cov_2.795455	240	320	45	3	80	0.0375000
NODE_101809_length_363_cov_2.795455	240	320	46	1	80	0.0125000
NODE_101809_length_363_cov_2.795455	240	320	47	5	80	0.0625000
NODE_101809_length_363_cov_2.795455	240	320	49	8	80	0.1000000
NODE_101809_length_363_cov_2.795455	240	320	50	3	80	0.0375000
NODE_101809_length_363_cov_2.795455	240	320	51	2	80	0.0250000
NODE_101809_length_363_cov_2.795455	240	320	53	1	80	0.0125000
NODE_101822_length_363_cov_2.481061	86	166	0	80	80	1.0000000
NODE_101822_length_363_cov_2.481061	139	219	0	80	80	1.0000000
NODE_101879_length_363_cov_2.034091	46	126	0	80	80	1.0000000
NODE_101879_length_363_cov_2.034091	99	153	0	54	54	1.0000000
NODE_101992_length_363_cov_1.541667	235	315	0	80	80	1.0000000
NODE_102022_length_363_cov_1.477273	141	202	0	11	61	0.1803279
NODE_102022_length_363_cov_1.477273	141	202	2	19	61	0.3114754
NODE_102022_length_363_cov_1.477273	141	202	4	5	61	0.0819672
NODE_102022_length_363_cov_1.477273	141	202	6	9	61	0.1475410
NODE_102022_length_363_cov_1.477273	141	202	8	17	61	0.2786885
NODE_102022_length_363_cov_1.477273	153	210	2	18	57	0.3157895
NODE_102022_length_363_cov_1.477273	153	210	4	5	57	0.0877193
NODE_102022_length_363_cov_1.477273	153	210	6	9	57	0.1578947
NODE_102022_length_363_cov_1.477273	153	210	8	25	57	0.4385965
NODE_102187_length_363_cov_1.113636	245	316	0	10	71	0.1408451
NODE_102187_length_363_cov_1.113636	245	316	2	61	71	0.8591549
NODE_102464_length_362_cov_54.927757	52	116	0	64	64	1.0000000
NODE_102465_length_362_cov_29.273764	86	166	0	80	80	1.0000000
NODE_102465_length_362_cov_29.273764	139	219	0	80	80	1.0000000
NODE_102467_length_362_cov_14.847909	130	210	2	54	80	0.6750000
NODE_102467_length_362_cov_14.847909	130	210	4	26	80	0.3250000
NODE_102467_length_362_cov_14.847909	183	263	0	31	80	0.3875000
NODE_102467_length_362_cov_14.847909	183	263	2	49	80	0.6125000
NODE_102633_length_362_cov_2.159696	133	216	0	72	83	0.8674699
NODE_102633_length_362_cov_2.159696	133	216	2	11	83	0.1325301
NODE_103259_length_361_cov_4.641221	249	312	11	11	63	0.1746032
NODE_103259_length_361_cov_4.641221	249	312	13	13	63	0.2063492
NODE_103259_length_361_cov_4.641221	249	312	18	3	63	0.0476190
NODE_103259_length_361_cov_4.641221	249	312	19	33	63	0.5238096
NODE_103259_length_361_cov_4.641221	249	312	20	3	63	0.0476190
NODE_103280_length_361_cov_3.717557	185	265	0	9	80	0.1125000
NODE_103280_length_361_cov_3.717557	185	265	2	71	80	0.8875000
NODE_103280_length_361_cov_3.717557	238	265	2	27	27	1.0000000
NODE_103314_length_361_cov_2.988550	121	201	2	14	80	0.1750000
NODE_103314_length_361_cov_2.988550	121	201	4	66	80	0.8250000
NODE_103314_length_361_cov_2.988550	174	216	2	6	42	0.1428571
NODE_103314_length_361_cov_2.988550	174	216	4	36	42	0.8571429
NODE_103338_length_361_cov_2.641221	4	33	2	29	29	1.0000000
NODE_103338_length_361_cov_2.641221	101	182	0	81	81	1.0000000
NODE_103391_length_361_cov_2.137405	138	194	0	56	56	1.0000000
NODE_103396_length_361_cov_2.106870	192	256	0	64	64	1.0000000
NODE_103418_length_361_cov_1.969466	137	198	2	9	61	0.1475410
NODE_103418_length_361_cov_1.969466	137	198	4	52	61	0.8524590
NODE_103632_length_361_cov_1.343511	171	250	0	79	79	1.0000000
NODE_103802_length_361_cov_1.000000	60	123	0	63	63	1.0000000
NODE_104057_length_360_cov_8.191571	171	242	2	71	71	1.0000000
NODE_104057_length_360_cov_8.191571	176	242	2	66	66	1.0000000
NODE_104057_length_360_cov_8.191571	215	279	0	17	64	0.2656250
NODE_104057_length_360_cov_8.191571	215	279	2	47	64	0.7343750
NODE_104057_length_360_cov_8.191571	215	279	0	17	64	0.2656250
NODE_104057_length_360_cov_8.191571	215	279	2	47	64	0.7343750
NODE_104079_length_360_cov_5.003831	86	166	0	80	80	1.0000000
NODE_104091_length_360_cov_4.111111	158	238	48	2	80	0.0250000
NODE_104091_length_360_cov_4.111111	158	238	52	2	80	0.0250000
NODE_104091_length_360_cov_4.111111	158	238	54	1	80	0.0125000
NODE_104091_length_360_cov_4.111111	158	238	56	2	80	0.0250000
NODE_104091_length_360_cov_4.111111	158	238	65	1	80	0.0125000
NODE_104091_length_360_cov_4.111111	158	238	67	2	80	0.0250000
NODE_104091_length_360_cov_4.111111	158	238	69	1	80	0.0125000
NODE_104091_length_360_cov_4.111111	158	238	71	2	80	0.0250000
NODE_104091_length_360_cov_4.111111	158	238	77	1	80	0.0125000
NODE_104091_length_360_cov_4.111111	158	238	81	2	80	0.0250000
NODE_104091_length_360_cov_4.111111	158	238	82	2	80	0.0250000
NODE_104091_length_360_cov_4.111111	158	238	83	5	80	0.0625000
NODE_104091_length_360_cov_4.111111	158	238	84	6	80	0.0750000
NODE_104091_length_360_cov_4.111111	158	238	85	2	80	0.0250000
NODE_104091_length_360_cov_4.111111	158	238	87	11	80	0.1375000
NODE_104091_length_360_cov_4.111111	158	238	88	3	80	0.0375000
NODE_104091_length_360_cov_4.111111	158	238	91	12	80	0.1500000
NODE_104091_length_360_cov_4.111111	158	238	92	5	80	0.0625000
NODE_104091_length_360_cov_4.111111	158	238	93	1	80	0.0125000
NODE_104091_length_360_cov_4.111111	158	238	94	17	80	0.2125000
NODE_104102_length_360_cov_3.613027	123	203	0	80	80	1.0000000
NODE_104102_length_360_cov_3.613027	176	256	0	80	80	1.0000000
NODE_104129_length_360_cov_3.080460	48	70	0	22	22	1.0000000
NODE_104162_length_360_cov_2.689655	118	198	2	61	80	0.7625000
NODE_104162_length_360_cov_2.689655	118	198	4	19	80	0.2375000
NODE_104261_length_360_cov_1.977011	235	286	0	51	51	1.0000000
NODE_104572_length_360_cov_1.149425	273	353	0	80	80	1.0000000
NODE_104669_length_360_cov_0.965517	119	175	0	13	56	0.2321429
NODE_104669_length_360_cov_0.965517	119	175	2	6	56	0.1071429
NODE_104669_length_360_cov_0.965517	119	175	3	25	56	0.4464286
NODE_104669_length_360_cov_0.965517	119	175	4	12	56	0.2142857
NODE_104671_length_360_cov_0.957854	140	186	0	46	46	1.0000000
NODE_104858_length_359_cov_45.519231	140	220	2	22	80	0.2750000
NODE_104858_length_359_cov_45.519231	140	220	3	22	80	0.2750000
NODE_104858_length_359_cov_45.519231	140	220	5	2	80	0.0250000
NODE_104858_length_359_cov_45.519231	140	220	6	34	80	0.4250000
NODE_104858_length_359_cov_45.519231	193	273	0	8	80	0.1000000
NODE_104858_length_359_cov_45.519231	193	273	2	67	80	0.8375000
NODE_104858_length_359_cov_45.519231	193	273	6	5	80	0.0625000
NODE_104932_length_359_cov_3.296154	67	147	8	15	80	0.1875000
NODE_104932_length_359_cov_3.296154	67	147	10	25	80	0.3125000
NODE_104932_length_359_cov_3.296154	67	147	12	14	80	0.1750000
NODE_104932_length_359_cov_3.296154	67	147	13	9	80	0.1125000
NODE_104932_length_359_cov_3.296154	67	147	14	17	80	0.2125000
NODE_104932_length_359_cov_3.296154	120	177	10	31	57	0.5438597
NODE_104932_length_359_cov_3.296154	120	177	12	14	57	0.2456140
NODE_104932_length_359_cov_3.296154	120	177	13	9	57	0.1578947
NODE_104932_length_359_cov_3.296154	120	177	14	3	57	0.0526316
NODE_104932_length_359_cov_3.296154	201	256	0	43	55	0.7818182
NODE_104932_length_359_cov_3.296154	201	256	2	10	55	0.1818182
NODE_104932_length_359_cov_3.296154	201	256	4	2	55	0.0363636
NODE_104936_length_359_cov_3.276923	5	95	0	90	90	1.0000000
NODE_104954_length_359_cov_3.007692	156	212	4	13	56	0.2321429
NODE_104954_length_359_cov_3.007692	156	212	6	6	56	0.1071429
NODE_104954_length_359_cov_3.007692	156	212	8	37	56	0.6607143
NODE_104998_length_359_cov_2.523077	148	228	0	80	80	1.0000000
NODE_104998_length_359_cov_2.523077	201	278	0	77	77	1.0000000
NODE_105002_length_359_cov_2.419231	106	186	1	15	80	0.1875000
NODE_105002_length_359_cov_2.419231	106	186	2	56	80	0.7000000
NODE_105002_length_359_cov_2.419231	106	186	5	9	80	0.1125000
NODE_105002_length_359_cov_2.419231	159	211	2	50	52	0.9615384
NODE_105002_length_359_cov_2.419231	159	211	12	2	52	0.0384615
NODE_105006_length_359_cov_2.353846	172	243	0	71	71	1.0000000
NODE_105006_length_359_cov_2.353846	216	296	0	37	80	0.4625000
NODE_105006_length_359_cov_2.353846	216	296	2	43	80	0.5375000
NODE_105026_length_359_cov_2.257692	211	270	0	59	59	1.0000000
NODE_105063_length_359_cov_2.003846	8	88	0	80	80	1.0000000
NODE_105063_length_359_cov_2.003846	61	139	0	78	78	1.0000000
NODE_105106_length_359_cov_1.815385	126	207	0	81	81	1.0000000
NODE_105106_length_359_cov_1.815385	180	227	0	47	47	1.0000000
NODE_105142_length_359_cov_1.692308	88	116	0	28	28	1.0000000
NODE_105373_length_359_cov_1.096154	64	89	0	25	25	1.0000000
NODE_105599_length_359_cov_0.711538	222	248	1	26	26	1.0000000
NODE_105600_length_359_cov_0.707692	10	90	0	80	80	1.0000000
NODE_105600_length_359_cov_0.707692	10	90	0	80	80	1.0000000
NODE_105600_length_359_cov_0.707692	63	143	0	80	80	1.0000000
NODE_105678_length_358_cov_19.760618	213	293	0	8	80	0.1000000
NODE_105678_length_358_cov_19.760618	213	293	4	72	80	0.9000000
NODE_105678_length_358_cov_19.760618	266	346	0	46	80	0.5750000
NODE_105678_length_358_cov_19.760618	266	346	4	34	80	0.4250000
NODE_105679_length_358_cov_18.455598	303	358	0	33	55	0.6000000
NODE_105679_length_358_cov_18.455598	303	358	2	22	55	0.4000000
NODE_105680_length_358_cov_17.023166	0	63	1	20	63	0.3174603
NODE_105680_length_358_cov_17.023166	0	63	2	6	63	0.0952381
NODE_105680_length_358_cov_17.023166	0	63	4	9	63	0.1428571
NODE_105680_length_358_cov_17.023166	0	63	6	9	63	0.1428571
NODE_105680_length_358_cov_17.023166	0	63	8	19	63	0.3015873
NODE_105680_length_358_cov_17.023166	0	63	1	20	63	0.3174603
NODE_105680_length_358_cov_17.023166	0	63	2	6	63	0.0952381
NODE_105680_length_358_cov_17.023166	0	63	4	9	63	0.1428571
NODE_105680_length_358_cov_17.023166	0	63	6	9	63	0.1428571
NODE_105680_length_358_cov_17.023166	0	63	8	19	63	0.3015873
NODE_105680_length_358_cov_17.023166	0	63	1	20	63	0.3174603
NODE_105680_length_358_cov_17.023166	0	63	2	6	63	0.0952381
NODE_105680_length_358_cov_17.023166	0	63	4	9	63	0.1428571
NODE_105680_length_358_cov_17.023166	0	63	6	9	63	0.1428571
NODE_105680_length_358_cov_17.023166	0	63	8	19	63	0.3015873
NODE_105680_length_358_cov_17.023166	36	116	4	4	80	0.0500000
NODE_105680_length_358_cov_17.023166	36	116	6	11	80	0.1375000
NODE_105680_length_358_cov_17.023166	36	116	8	65	80	0.8125000
NODE_105680_length_358_cov_17.023166	53	115	4	3	62	0.0483871
NODE_105680_length_358_cov_17.023166	53	115	6	3	62	0.0483871
NODE_105680_length_358_cov_17.023166	53	115	8	56	62	0.9032258
NODE_105686_length_358_cov_6.509653	109	155	2	46	46	1.0000000
NODE_105710_length_358_cov_4.239382	114	143	6	23	29	0.7931035
NODE_105710_length_358_cov_4.239382	114	143	8	1	29	0.0344828
NODE_105710_length_358_cov_4.239382	114	143	12	5	29	0.1724138
NODE_105710_length_358_cov_4.239382	180	245	8	7	65	0.1076923
NODE_105710_length_358_cov_4.239382	180	245	12	4	65	0.0615385
NODE_105710_length_358_cov_4.239382	180	245	14	10	65	0.1538462
NODE_105710_length_358_cov_4.239382	180	245	16	10	65	0.1538462
NODE_105710_length_358_cov_4.239382	180	245	18	5	65	0.0769231
NODE_105710_length_358_cov_4.239382	180	245	20	4	65	0.0615385
NODE_105710_length_358_cov_4.239382	180	245	22	25	65	0.3846154
NODE_105710_length_358_cov_4.239382	218	298	8	42	80	0.5250000
NODE_105710_length_358_cov_4.239382	218	298	10	18	80	0.2250000
NODE_105710_length_358_cov_4.239382	218	298	12	4	80	0.0500000
NODE_105710_length_358_cov_4.239382	218	298	16	2	80	0.0250000
NODE_105710_length_358_cov_4.239382	218	298	18	5	80	0.0625000
NODE_105710_length_358_cov_4.239382	218	298	20	4	80	0.0500000
NODE_105710_length_358_cov_4.239382	218	298	22	5	80	0.0625000
NODE_105846_length_358_cov_2.162162	229	305	0	76	76	1.0000000
NODE_105902_length_358_cov_1.926641	290	358	0	68	68	1.0000000
NODE_105910_length_358_cov_1.884170	250	317	0	67	67	1.0000000
NODE_105923_length_358_cov_1.841699	189	269	24	6	80	0.0750000
NODE_105923_length_358_cov_1.841699	189	269	26	3	80	0.0375000
NODE_105923_length_358_cov_1.841699	189	269	28	1	80	0.0125000
NODE_105923_length_358_cov_1.841699	189	269	30	28	80	0.3500000
NODE_105923_length_358_cov_1.841699	189	269	32	34	80	0.4250000
NODE_105923_length_358_cov_1.841699	189	269	36	8	80	0.1000000
NODE_106096_length_358_cov_1.235521	99	179	10	3	80	0.0375000
NODE_106096_length_358_cov_1.235521	99	179	12	2	80	0.0250000
NODE_106096_length_358_cov_1.235521	99	179	13	34	80	0.4250000
NODE_106096_length_358_cov_1.235521	99	179	14	14	80	0.1750000
NODE_106096_length_358_cov_1.235521	99	179	15	9	80	0.1125000
NODE_106096_length_358_cov_1.235521	99	179	16	14	80	0.1750000
NODE_106096_length_358_cov_1.235521	99	179	17	1	80	0.0125000
NODE_106096_length_358_cov_1.235521	99	179	19	3	80	0.0375000
NODE_106096_length_358_cov_1.235521	152	222	4	23	70	0.3285714
NODE_106096_length_358_cov_1.235521	152	222	12	15	70	0.2142857
NODE_106096_length_358_cov_1.235521	152	222	13	13	70	0.1857143
NODE_106096_length_358_cov_1.235521	152	222	14	19	70	0.2714286
NODE_106189_length_358_cov_1.096525	148	228	0	74	80	0.9250000
NODE_106189_length_358_cov_1.096525	148	228	2	6	80	0.0750000
NODE_106233_length_358_cov_0.984556	193	265	0	16	72	0.2222222
NODE_106233_length_358_cov_0.984556	193	265	2	56	72	0.7777778
NODE_106489_length_357_cov_381.833333	244	324	91	1	80	0.0125000
NODE_106489_length_357_cov_381.833333	244	324	96	1	80	0.0125000
NODE_106489_length_357_cov_381.833333	244	324	97	2	80	0.0250000
NODE_106489_length_357_cov_381.833333	244	324	98	1	80	0.0125000
NODE_106489_length_357_cov_381.833333	244	324	99	5	80	0.0625000
NODE_106489_length_357_cov_381.833333	244	324	103	2	80	0.0250000
NODE_106489_length_357_cov_381.833333	244	324	105	5	80	0.0625000
NODE_106489_length_357_cov_381.833333	244	324	109	1	80	0.0125000
NODE_106489_length_357_cov_381.833333	244	324	111	1	80	0.0125000
NODE_106489_length_357_cov_381.833333	244	324	116	1	80	0.0125000
NODE_106489_length_357_cov_381.833333	244	324	117	1	80	0.0125000
NODE_106489_length_357_cov_381.833333	244	324	121	1	80	0.0125000
NODE_106489_length_357_cov_381.833333	244	324	123	2	80	0.0250000
NODE_106489_length_357_cov_381.833333	244	324	125	1	80	0.0125000
NODE_106489_length_357_cov_381.833333	244	324	127	2	80	0.0250000
NODE_106489_length_357_cov_381.833333	244	324	129	1	80	0.0125000
NODE_106489_length_357_cov_381.833333	244	324	131	1	80	0.0125000
NODE_106489_length_357_cov_381.833333	244	324	133	1	80	0.0125000
NODE_106489_length_357_cov_381.833333	244	324	135	50	80	0.6250000
NODE_106493_length_357_cov_7.643411	45	125	0	80	80	1.0000000
NODE_106493_length_357_cov_7.643411	98	178	0	80	80	1.0000000
NODE_106495_length_357_cov_7.027132	157	237	2	73	80	0.9125000
NODE_106495_length_357_cov_7.027132	157	237	4	7	80	0.0875000
NODE_106495_length_357_cov_7.027132	210	252	2	40	42	0.9523810
NODE_106495_length_357_cov_7.027132	210	252	4	2	42	0.0476190
NODE_106496_length_357_cov_6.732558	183	263	16	18	80	0.2250000
NODE_106496_length_357_cov_6.732558	183	263	18	42	80	0.5250000
NODE_106496_length_357_cov_6.732558	183	263	20	9	80	0.1125000
NODE_106496_length_357_cov_6.732558	183	263	22	11	80	0.1375000
NODE_106529_length_357_cov_4.081395	145	225	0	38	80	0.4750000
NODE_106529_length_357_cov_4.081395	145	225	2	42	80	0.5250000
NODE_106529_length_357_cov_4.081395	198	271	0	17	73	0.2328767
NODE_106529_length_357_cov_4.081395	198	271	2	56	73	0.7671233
NODE_106542_length_357_cov_3.724806	192	265	2	6	73	0.0821918
NODE_106542_length_357_cov_3.724806	192	265	3	3	73	0.0410959
NODE_106542_length_357_cov_3.724806	192	265	4	64	73	0.8767123
NODE_106558_length_357_cov_3.341085	205	285	0	10	80	0.1250000
NODE_106558_length_357_cov_3.341085	205	285	4	70	80	0.8750000
NODE_106558_length_357_cov_3.341085	258	338	0	63	80	0.7875000
NODE_106558_length_357_cov_3.341085	258	338	4	17	80	0.2125000
NODE_106625_length_357_cov_2.414729	245	302	4	57	57	1.0000000
NODE_106625_length_357_cov_2.414729	275	355	0	35	80	0.4375000
NODE_106625_length_357_cov_2.414729	275	355	2	8	80	0.1000000
NODE_106625_length_357_cov_2.414729	275	355	4	37	80	0.4625000
NODE_106661_length_357_cov_2.174419	250	330	0	75	80	0.9375000
NODE_106661_length_357_cov_2.174419	250	330	2	5	80	0.0625000
NODE_106666_length_357_cov_2.166667	103	133	0	30	30	1.0000000
NODE_106666_length_357_cov_2.166667	112	133	0	21	21	1.0000000
NODE_106702_length_357_cov_1.961240	150	169	0	19	19	1.0000000
NODE_106708_length_357_cov_1.918605	173	253	0	4	80	0.0500000
NODE_106708_length_357_cov_1.918605	173	253	2	17	80	0.2125000
NODE_106708_length_357_cov_1.918605	173	253	3	9	80	0.1125000
NODE_106708_length_357_cov_1.918605	173	253	4	18	80	0.2250000
NODE_106708_length_357_cov_1.918605	173	253	6	32	80	0.4000000
NODE_106737_length_357_cov_1.782946	73	142	0	69	69	1.0000000
NODE_106737_length_357_cov_1.782946	115	195	0	80	80	1.0000000
NODE_107002_length_357_cov_1.127907	98	129	2	4	31	0.1290323
NODE_107002_length_357_cov_1.127907	98	129	4	27	31	0.8709677
NODE_107306_length_356_cov_5.299611	140	200	12	2	60	0.0333333
NODE_107306_length_356_cov_5.299611	140	200	14	13	60	0.2166667
NODE_107306_length_356_cov_5.299611	140	200	16	8	60	0.1333333
NODE_107306_length_356_cov_5.299611	140	200	18	37	60	0.6166667
NODE_107347_length_356_cov_3.400778	255	317	2	51	62	0.8225806
NODE_107347_length_356_cov_3.400778	255	317	4	11	62	0.1774193
NODE_107347_length_356_cov_3.400778	308	353	0	13	45	0.2888889
NODE_107347_length_356_cov_3.400778	308	353	2	32	45	0.7111111
NODE_107402_length_356_cov_2.657588	256	298	32	6	42	0.1428571
NODE_107402_length_356_cov_2.657588	256	298	36	4	42	0.0952381
NODE_107402_length_356_cov_2.657588	256	298	38	6	42	0.1428571
NODE_107402_length_356_cov_2.657588	256	298	39	1	42	0.0238095
NODE_107402_length_356_cov_2.657588	256	298	40	21	42	0.5000000
NODE_107402_length_356_cov_2.657588	256	298	42	4	42	0.0952381
NODE_107402_length_356_cov_2.657588	265	338	15	1	73	0.0136986
NODE_107402_length_356_cov_2.657588	265	338	21	1	73	0.0136986
NODE_107402_length_356_cov_2.657588	265	338	23	4	73	0.0547945
NODE_107402_length_356_cov_2.657588	265	338	29	2	73	0.0273973
NODE_107402_length_356_cov_2.657588	265	338	30	19	73	0.2602740
NODE_107402_length_356_cov_2.657588	265	338	31	5	73	0.0684932
NODE_107402_length_356_cov_2.657588	265	338	32	14	73	0.1917808
NODE_107402_length_356_cov_2.657588	265	338	36	4	73	0.0547945
NODE_107402_length_356_cov_2.657588	265	338	38	3	73	0.0410959
NODE_107402_length_356_cov_2.657588	265	338	39	1	73	0.0136986
NODE_107402_length_356_cov_2.657588	265	338	40	19	73	0.2602740
NODE_107402_length_356_cov_2.657588	299	351	7	6	52	0.1153846
NODE_107402_length_356_cov_2.657588	299	351	8	2	52	0.0384615
NODE_107402_length_356_cov_2.657588	299	351	12	1	52	0.0192308
NODE_107402_length_356_cov_2.657588	299	351	14	3	52	0.0576923
NODE_107402_length_356_cov_2.657588	299	351	15	2	52	0.0384615
NODE_107402_length_356_cov_2.657588	299	351	21	1	52	0.0192308
NODE_107402_length_356_cov_2.657588	299	351	23	4	52	0.0769231
NODE_107402_length_356_cov_2.657588	299	351	29	2	52	0.0384615
NODE_107402_length_356_cov_2.657588	299	351	30	19	52	0.3653846
NODE_107402_length_356_cov_2.657588	299	351	31	5	52	0.0961538
NODE_107402_length_356_cov_2.657588	299	351	32	7	52	0.1346154
NODE_107452_length_356_cov_2.237354	90	135	6	11	45	0.2444444
NODE_107452_length_356_cov_2.237354	90	135	10	29	45	0.6444445
NODE_107452_length_356_cov_2.237354	90	135	12	5	45	0.1111111
NODE_107475_length_356_cov_1.996109	127	194	0	67	67	1.0000000
NODE_107521_length_356_cov_1.813230	296	341	0	45	45	1.0000000
NODE_107606_length_356_cov_1.560311	192	272	0	7	80	0.0875000
NODE_107606_length_356_cov_1.560311	192	272	1	6	80	0.0750000
NODE_107606_length_356_cov_1.560311	192	272	2	67	80	0.8375000
NODE_107606_length_356_cov_1.560311	245	319	0	35	74	0.4729730
NODE_107606_length_356_cov_1.560311	245	319	1	1	74	0.0135135
NODE_107606_length_356_cov_1.560311	245	319	2	38	74	0.5135135
NODE_108122_length_355_cov_6.796875	127	173	4	19	46	0.4130435
NODE_108122_length_355_cov_6.796875	127	173	6	27	46	0.5869565
NODE_108210_length_355_cov_2.734375	111	162	0	51	51	1.0000000
NODE_108210_length_355_cov_2.734375	142	222	0	80	80	1.0000000
NODE_108215_length_355_cov_2.707031	277	314	2	37	37	1.0000000
NODE_108215_length_355_cov_2.707031	287	353	2	66	66	1.0000000
NODE_108239_length_355_cov_2.500000	38	82	4	13	44	0.2954545
NODE_108239_length_355_cov_2.500000	38	82	6	31	44	0.7045454
NODE_108278_length_355_cov_2.207031	258	308	0	50	50	1.0000000
NODE_108284_length_355_cov_2.179688	153	233	4	80	80	1.0000000
NODE_108284_length_355_cov_2.179688	206	286	4	73	80	0.9125000
NODE_108284_length_355_cov_2.179688	206	286	6	7	80	0.0875000
NODE_108291_length_355_cov_2.132812	261	334	0	73	73	1.0000000
NODE_108291_length_355_cov_2.132812	301	342	0	41	41	1.0000000
NODE_108315_length_355_cov_2.007812	281	347	4	66	66	1.0000000
NODE_108395_length_355_cov_1.765625	186	247	0	61	61	1.0000000
NODE_108395_length_355_cov_1.765625	220	300	0	44	80	0.5500000
NODE_108395_length_355_cov_1.765625	220	300	2	8	80	0.1000000
NODE_108395_length_355_cov_1.765625	220	300	4	28	80	0.3500000
NODE_109015_length_354_cov_6.843137	53	132	0	79	79	1.0000000
NODE_109015_length_354_cov_6.843137	53	132	0	79	79	1.0000000
NODE_109015_length_354_cov_6.843137	105	185	0	80	80	1.0000000
NODE_109015_length_354_cov_6.843137	105	185	0	80	80	1.0000000
NODE_109033_length_354_cov_4.823529	208	255	0	47	47	1.0000000
NODE_109054_length_354_cov_3.956863	145	208	0	63	63	1.0000000
NODE_109054_length_354_cov_3.956863	181	261	0	80	80	1.0000000
NODE_109057_length_354_cov_3.878431	198	244	10	17	46	0.3695652
NODE_109057_length_354_cov_3.878431	198	244	12	9	46	0.1956522
NODE_109057_length_354_cov_3.878431	198	244	16	20	46	0.4347826
NODE_109089_length_354_cov_3.207843	130	199	0	69	69	1.0000000
NODE_109126_length_354_cov_2.725490	179	259	0	8	80	0.1000000
NODE_109126_length_354_cov_2.725490	179	259	2	44	80	0.5500000
NODE_109126_length_354_cov_2.725490	179	259	4	8	80	0.1000000
NODE_109126_length_354_cov_2.725490	179	259	6	20	80	0.2500000
NODE_109126_length_354_cov_2.725490	235	312	4	15	77	0.1948052
NODE_109126_length_354_cov_2.725490	235	312	6	62	77	0.8051948
NODE_109128_length_354_cov_2.713725	16	76	0	60	60	1.0000000
NODE_109128_length_354_cov_2.713725	90	149	0	59	59	1.0000000
NODE_109140_length_354_cov_2.580392	176	234	0	32	58	0.5517241
NODE_109140_length_354_cov_2.580392	176	234	4	7	58	0.1206897
NODE_109140_length_354_cov_2.580392	176	234	6	19	58	0.3275862
NODE_109140_length_354_cov_2.580392	207	251	0	1	44	0.0227273
NODE_109140_length_354_cov_2.580392	207	251	4	7	44	0.1590909
NODE_109140_length_354_cov_2.580392	207	251	6	36	44	0.8181818
NODE_109237_length_354_cov_1.996078	79	145	0	60	66	0.9090909
NODE_109237_length_354_cov_1.996078	79	145	2	6	66	0.0909091
NODE_109237_length_354_cov_1.996078	118	200	0	21	82	0.2560976
NODE_109237_length_354_cov_1.996078	118	200	2	34	82	0.4146341
NODE_109237_length_354_cov_1.996078	118	200	4	27	82	0.3292683
NODE_109244_length_354_cov_1.988235	7	77	0	45	70	0.6428571
NODE_109244_length_354_cov_1.988235	7	77	2	25	70	0.3571429
NODE_109244_length_354_cov_1.988235	64	130	2	38	66	0.5757576
NODE_109244_length_354_cov_1.988235	64	130	4	13	66	0.1969697
NODE_109244_length_354_cov_1.988235	64	130	6	15	66	0.2272727
NODE_109321_length_354_cov_1.682353	99	171	0	70	72	0.9722222
NODE_109321_length_354_cov_1.682353	99	171	2	2	72	0.0277778
NODE_109321_length_354_cov_1.682353	144	224	0	25	80	0.3125000
NODE_109321_length_354_cov_1.682353	144	224	2	55	80	0.6875000
NODE_109852_length_353_cov_11.169291	14	90	0	76	76	1.0000000
NODE_109852_length_353_cov_11.169291	67	143	0	76	76	1.0000000
NODE_109911_length_353_cov_3.874016	220	256	0	36	36	1.0000000
NODE_109911_length_353_cov_3.874016	265	334	0	69	69	1.0000000
NODE_109928_length_353_cov_3.488189	200	282	8	8	82	0.0975610
NODE_109928_length_353_cov_3.488189	200	282	10	28	82	0.3414634
NODE_109928_length_353_cov_3.488189	200	282	12	19	82	0.2317073
NODE_109928_length_353_cov_3.488189	200	282	16	27	82	0.3292683
NODE_109976_length_353_cov_2.826772	8	88	0	80	80	1.0000000
NODE_109976_length_353_cov_2.826772	61	120	0	59	59	1.0000000
NODE_110022_length_353_cov_2.417323	260	336	0	76	76	1.0000000
NODE_110610_length_353_cov_0.744094	299	318	2	19	19	1.0000000
NODE_110708_length_352_cov_34.691700	110	203	0	89	93	0.9569892
NODE_110708_length_352_cov_34.691700	110	203	4	2	93	0.0215054
NODE_110708_length_352_cov_34.691700	110	203	22	1	93	0.0107527
NODE_110708_length_352_cov_34.691700	110	203	25	1	93	0.0107527
NODE_110710_length_352_cov_17.944664	20	100	0	80	80	1.0000000
NODE_110710_length_352_cov_17.944664	73	153	0	80	80	1.0000000
NODE_110710_length_352_cov_17.944664	273	352	0	44	79	0.5569620
NODE_110710_length_352_cov_17.944664	273	352	2	35	79	0.4430380
NODE_110735_length_352_cov_4.707510	157	237	0	6	80	0.0750000
NODE_110735_length_352_cov_4.707510	157	237	2	15	80	0.1875000
NODE_110735_length_352_cov_4.707510	157	237	4	2	80	0.0250000
NODE_110735_length_352_cov_4.707510	157	237	6	13	80	0.1625000
NODE_110735_length_352_cov_4.707510	157	237	8	5	80	0.0625000
NODE_110735_length_352_cov_4.707510	157	237	10	5	80	0.0625000
NODE_110735_length_352_cov_4.707510	157	237	14	3	80	0.0375000
NODE_110735_length_352_cov_4.707510	157	237	16	31	80	0.3875000
NODE_110749_length_352_cov_4.221344	144	205	0	61	61	1.0000000
NODE_110749_length_352_cov_4.221344	178	259	0	81	81	1.0000000
NODE_110754_length_352_cov_4.011858	98	143	0	45	45	1.0000000
NODE_110754_length_352_cov_4.011858	151	228	4	11	77	0.1428571
NODE_110754_length_352_cov_4.011858	151	228	6	29	77	0.3766234
NODE_110754_length_352_cov_4.011858	151	228	8	37	77	0.4805195
NODE_110798_length_352_cov_2.849802	74	154	0	80	80	1.0000000
NODE_110798_length_352_cov_2.849802	127	198	0	71	71	1.0000000
NODE_110820_length_352_cov_2.683794	0	77	4	4	77	0.0519481
NODE_110820_length_352_cov_2.683794	0	77	6	13	77	0.1688312
NODE_110820_length_352_cov_2.683794	0	77	8	60	77	0.7792208
NODE_110820_length_352_cov_2.683794	50	130	0	8	80	0.1000000
NODE_110820_length_352_cov_2.683794	50	130	2	20	80	0.2500000
NODE_110820_length_352_cov_2.683794	50	130	6	8	80	0.1000000
NODE_110820_length_352_cov_2.683794	50	130	8	44	80	0.5500000
NODE_110832_length_352_cov_2.608696	90	136	0	46	46	1.0000000
NODE_110832_length_352_cov_2.608696	144	189	0	45	45	1.0000000
NODE_110838_length_352_cov_2.577075	111	191	0	80	80	1.0000000
NODE_110876_length_352_cov_2.264822	171	251	0	80	80	1.0000000
NODE_110938_length_352_cov_2.007905	277	326	4	49	49	1.0000000
NODE_111439_length_352_cov_0.806324	165	238	10	1	73	0.0136986
NODE_111439_length_352_cov_0.806324	165	238	13	1	73	0.0136986
NODE_111439_length_352_cov_0.806324	165	238	15	1	73	0.0136986
NODE_111439_length_352_cov_0.806324	165	238	20	1	73	0.0136986
NODE_111439_length_352_cov_0.806324	165	238	26	1	73	0.0136986
NODE_111439_length_352_cov_0.806324	165	238	30	2	73	0.0273973
NODE_111439_length_352_cov_0.806324	165	238	32	2	73	0.0273973
NODE_111439_length_352_cov_0.806324	165	238	33	6	73	0.0821918
NODE_111439_length_352_cov_0.806324	165	238	35	1	73	0.0136986
NODE_111439_length_352_cov_0.806324	165	238	36	1	73	0.0136986
NODE_111439_length_352_cov_0.806324	165	238	38	2	73	0.0273973
NODE_111439_length_352_cov_0.806324	165	238	44	1	73	0.0136986
NODE_111439_length_352_cov_0.806324	165	238	45	2	73	0.0273973
NODE_111439_length_352_cov_0.806324	165	238	46	6	73	0.0821918
NODE_111439_length_352_cov_0.806324	165	238	50	1	73	0.0136986
NODE_111439_length_352_cov_0.806324	165	238	52	2	73	0.0273973
NODE_111439_length_352_cov_0.806324	165	238	56	1	73	0.0136986
NODE_111439_length_352_cov_0.806324	165	238	58	1	73	0.0136986
NODE_111439_length_352_cov_0.806324	165	238	60	1	73	0.0136986
NODE_111439_length_352_cov_0.806324	165	238	63	6	73	0.0821918
NODE_111439_length_352_cov_0.806324	165	238	65	3	73	0.0410959
NODE_111439_length_352_cov_0.806324	165	238	66	3	73	0.0410959
NODE_111439_length_352_cov_0.806324	165	238	68	3	73	0.0410959
NODE_111439_length_352_cov_0.806324	165	238	70	1	73	0.0136986
NODE_111439_length_352_cov_0.806324	165	238	74	20	73	0.2739726
NODE_111439_length_352_cov_0.806324	165	238	76	3	73	0.0410959
NODE_111593_length_351_cov_5.003968	115	195	4	29	80	0.3625000
NODE_111593_length_351_cov_5.003968	115	195	6	51	80	0.6375000
NODE_111662_length_351_cov_2.900794	289	320	0	31	31	1.0000000
NODE_111738_length_351_cov_2.376984	79	159	0	10	80	0.1250000
NODE_111738_length_351_cov_2.376984	79	159	2	55	80	0.6875000
NODE_111738_length_351_cov_2.376984	79	159	4	6	80	0.0750000
NODE_111738_length_351_cov_2.376984	79	159	6	9	80	0.1125000
NODE_111759_length_351_cov_2.226190	116	170	4	13	54	0.2407407
NODE_111759_length_351_cov_2.226190	116	170	6	4	54	0.0740741
NODE_111759_length_351_cov_2.226190	116	170	8	21	54	0.3888889
NODE_111759_length_351_cov_2.226190	116	170	10	16	54	0.2962963
NODE_111769_length_351_cov_2.186508	198	277	4	17	79	0.2151899
NODE_111769_length_351_cov_2.186508	198	277	6	62	79	0.7848101
NODE_111861_length_351_cov_1.809524	276	309	2	33	33	1.0000000
NODE_111969_length_351_cov_1.515873	228	299	0	4	71	0.0563380
NODE_111969_length_351_cov_1.515873	228	299	1	52	71	0.7323943
NODE_111969_length_351_cov_1.515873	228	299	3	1	71	0.0140845
NODE_111969_length_351_cov_1.515873	228	299	5	14	71	0.1971831
NODE_112493_length_350_cov_232.529880	25	92	46	2	67	0.0298507
NODE_112493_length_350_cov_232.529880	25	92	50	9	67	0.1343284
NODE_112493_length_350_cov_232.529880	25	92	52	1	67	0.0149254
NODE_112493_length_350_cov_232.529880	25	92	56	1	67	0.0149254
NODE_112493_length_350_cov_232.529880	25	92	58	3	67	0.0447761
NODE_112493_length_350_cov_232.529880	25	92	68	3	67	0.0447761
NODE_112493_length_350_cov_232.529880	25	92	72	4	67	0.0597015
NODE_112493_length_350_cov_232.529880	25	92	76	1	67	0.0149254
NODE_112493_length_350_cov_232.529880	25	92	78	1	67	0.0149254
NODE_112493_length_350_cov_232.529880	25	92	80	1	67	0.0149254
NODE_112493_length_350_cov_232.529880	25	92	84	2	67	0.0298507
NODE_112493_length_350_cov_232.529880	25	92	86	1	67	0.0149254
NODE_112493_length_350_cov_232.529880	25	92	90	1	67	0.0149254
NODE_112493_length_350_cov_232.529880	25	92	94	1	67	0.0149254
NODE_112493_length_350_cov_232.529880	25	92	96	1	67	0.0149254
NODE_112493_length_350_cov_232.529880	25	92	102	2	67	0.0298507
NODE_112493_length_350_cov_232.529880	25	92	106	1	67	0.0149254
NODE_112493_length_350_cov_232.529880	25	92	110	5	67	0.0746269
NODE_112493_length_350_cov_232.529880	25	92	112	10	67	0.1492537
NODE_112493_length_350_cov_232.529880	25	92	122	2	67	0.0298507
NODE_112493_length_350_cov_232.529880	25	92	124	5	67	0.0746269
NODE_112493_length_350_cov_232.529880	25	92	126	10	67	0.1492537
NODE_112494_length_350_cov_40.677291	181	246	6	11	65	0.1692308
NODE_112494_length_350_cov_40.677291	181	246	8	34	65	0.5230770
NODE_112494_length_350_cov_40.677291	181	246	10	15	65	0.2307692
NODE_112494_length_350_cov_40.677291	181	246	12	5	65	0.0769231
NODE_112535_length_350_cov_4.179283	114	194	2	32	80	0.4000000
NODE_112535_length_350_cov_4.179283	114	194	4	48	80	0.6000000
NODE_112535_length_350_cov_4.179283	167	244	2	4	77	0.0519481
NODE_112535_length_350_cov_4.179283	167	244	4	40	77	0.5194805
NODE_112535_length_350_cov_4.179283	167	244	5	5	77	0.0649351
NODE_112535_length_350_cov_4.179283	167	244	6	26	77	0.3376623
NODE_112535_length_350_cov_4.179283	167	244	7	2	77	0.0259740
NODE_112554_length_350_cov_3.573705	128	202	2	2	74	0.0270270
NODE_112554_length_350_cov_3.573705	128	202	4	5	74	0.0675676
NODE_112554_length_350_cov_3.573705	128	202	10	25	74	0.3378378
NODE_112554_length_350_cov_3.573705	128	202	12	1	74	0.0135135
NODE_112554_length_350_cov_3.573705	128	202	15	3	74	0.0405405
NODE_112554_length_350_cov_3.573705	128	202	17	2	74	0.0270270
NODE_112554_length_350_cov_3.573705	128	202	21	3	74	0.0405405
NODE_112554_length_350_cov_3.573705	128	202	23	33	74	0.4459459
NODE_112554_length_350_cov_3.573705	178	241	0	21	63	0.3333333
NODE_112554_length_350_cov_3.573705	178	241	2	20	63	0.3174603
NODE_112554_length_350_cov_3.573705	178	241	4	5	63	0.0793651
NODE_112554_length_350_cov_3.573705	178	241	10	17	63	0.2698413
NODE_112627_length_350_cov_2.478088	266	297	6	15	31	0.4838710
NODE_112627_length_350_cov_2.478088	266	297	7	16	31	0.5161290
NODE_112647_length_350_cov_2.346614	97	148	72	3	51	0.0588235
NODE_112647_length_350_cov_2.346614	97	148	74	3	51	0.0588235
NODE_112647_length_350_cov_2.346614	97	148	75	1	51	0.0196078
NODE_112647_length_350_cov_2.346614	97	148	76	7	51	0.1372549
NODE_112647_length_350_cov_2.346614	97	148	78	6	51	0.1176471
NODE_112647_length_350_cov_2.346614	97	148	79	1	51	0.0196078
NODE_112647_length_350_cov_2.346614	97	148	80	1	51	0.0196078
NODE_112647_length_350_cov_2.346614	97	148	81	1	51	0.0196078
NODE_112647_length_350_cov_2.346614	97	148	82	6	51	0.1176471
NODE_112647_length_350_cov_2.346614	97	148	83	6	51	0.1176471
NODE_112647_length_350_cov_2.346614	97	148	84	11	51	0.2156863
NODE_112647_length_350_cov_2.346614	97	148	85	3	51	0.0588235
NODE_112647_length_350_cov_2.346614	97	148	87	2	51	0.0392157
NODE_112714_length_350_cov_2.031873	181	238	26	8	57	0.1403509
NODE_112714_length_350_cov_2.031873	181	238	34	1	57	0.0175439
NODE_112714_length_350_cov_2.031873	181	238	36	8	57	0.1403509
NODE_112714_length_350_cov_2.031873	181	238	38	18	57	0.3157895
NODE_112714_length_350_cov_2.031873	181	238	40	22	57	0.3859649
NODE_112997_length_350_cov_1.223108	202	275	0	37	73	0.5068493
NODE_112997_length_350_cov_1.223108	202	275	6	5	73	0.0684932
NODE_112997_length_350_cov_1.223108	202	275	10	6	73	0.0821918
NODE_112997_length_350_cov_1.223108	202	275	18	4	73	0.0547945
NODE_112997_length_350_cov_1.223108	202	275	20	6	73	0.0821918
NODE_112997_length_350_cov_1.223108	202	275	22	1	73	0.0136986
NODE_112997_length_350_cov_1.223108	202	275	24	2	73	0.0273973
NODE_112997_length_350_cov_1.223108	202	275	28	1	73	0.0136986
NODE_112997_length_350_cov_1.223108	202	275	32	6	73	0.0821918
NODE_112997_length_350_cov_1.223108	202	275	34	5	73	0.0684932
NODE_113450_length_349_cov_4.268000	83	163	0	17	80	0.2125000
NODE_113450_length_349_cov_4.268000	83	163	2	11	80	0.1375000
NODE_113450_length_349_cov_4.268000	83	163	4	52	80	0.6500000
NODE_113450_length_349_cov_4.268000	83	163	0	17	80	0.2125000
NODE_113450_length_349_cov_4.268000	83	163	2	11	80	0.1375000
NODE_113450_length_349_cov_4.268000	83	163	4	52	80	0.6500000
NODE_113450_length_349_cov_4.268000	136	216	2	25	80	0.3125000
NODE_113450_length_349_cov_4.268000	136	216	4	55	80	0.6875000
NODE_113450_length_349_cov_4.268000	145	180	4	35	35	1.0000000
NODE_113473_length_349_cov_3.648000	219	300	0	43	81	0.5308642
NODE_113473_length_349_cov_3.648000	219	300	2	34	81	0.4197531
NODE_113473_length_349_cov_3.648000	219	300	4	3	81	0.0370370
NODE_113473_length_349_cov_3.648000	219	300	6	1	81	0.0123457
NODE_113480_length_349_cov_3.484000	196	276	0	8	80	0.1000000
NODE_113480_length_349_cov_3.484000	196	276	2	8	80	0.1000000
NODE_113480_length_349_cov_3.484000	196	276	3	2	80	0.0250000
NODE_113480_length_349_cov_3.484000	196	276	5	1	80	0.0125000
NODE_113480_length_349_cov_3.484000	196	276	7	9	80	0.1125000
NODE_113480_length_349_cov_3.484000	196	276	10	36	80	0.4500000
NODE_113480_length_349_cov_3.484000	196	276	12	16	80	0.2000000
NODE_113486_length_349_cov_3.364000	219	284	0	2	65	0.0307692
NODE_113486_length_349_cov_3.364000	219	284	2	63	65	0.9692308
NODE_113511_length_349_cov_2.916000	94	189	2	76	95	0.8000000
NODE_113511_length_349_cov_2.916000	94	189	4	8	95	0.0842105
NODE_113511_length_349_cov_2.916000	94	189	6	11	95	0.1157895
NODE_113571_length_349_cov_2.420000	35	54	0	19	19	1.0000000
NODE_113647_length_349_cov_1.964000	32	63	0	31	31	1.0000000
NODE_113654_length_349_cov_1.928000	9	77	0	68	68	1.0000000
NODE_113654_length_349_cov_1.928000	62	115	0	53	53	1.0000000
NODE_113710_length_349_cov_1.684000	225	265	2	14	40	0.3500000
NODE_113710_length_349_cov_1.684000	225	265	4	17	40	0.4250000
NODE_113710_length_349_cov_1.684000	225	265	6	2	40	0.0500000
NODE_113710_length_349_cov_1.684000	225	265	8	3	40	0.0750000
NODE_113710_length_349_cov_1.684000	225	265	10	2	40	0.0500000
NODE_113710_length_349_cov_1.684000	225	265	14	2	40	0.0500000
NODE_113825_length_349_cov_1.392000	32	95	0	39	63	0.6190476
NODE_113825_length_349_cov_1.392000	32	95	2	24	63	0.3809524
NODE_113961_length_349_cov_1.056000	316	339	0	23	23	1.0000000
NODE_114002_length_349_cov_1.020000	177	257	2	80	80	1.0000000
NODE_114263_length_348_cov_34.867470	156	236	0	80	80	1.0000000
NODE_114263_length_348_cov_34.867470	209	289	0	80	80	1.0000000
NODE_114296_length_348_cov_4.180723	106	186	0	80	80	1.0000000
NODE_114296_length_348_cov_4.180723	159	239	0	80	80	1.0000000
NODE_114330_length_348_cov_3.277108	83	137	2	54	54	1.0000000
NODE_114330_length_348_cov_3.277108	145	197	0	23	52	0.4423077
NODE_114330_length_348_cov_3.277108	145	197	2	29	52	0.5576923
NODE_114424_length_348_cov_2.305221	204	273	0	19	69	0.2753623
NODE_114424_length_348_cov_2.305221	204	273	2	42	69	0.6086956
NODE_114424_length_348_cov_2.305221	204	273	4	8	69	0.1159420
NODE_114448_length_348_cov_2.216867	103	152	0	49	49	1.0000000
NODE_114505_length_348_cov_1.995984	170	239	0	5	69	0.0724638
NODE_114505_length_348_cov_1.995984	170	239	2	64	69	0.9275362
NODE_114591_length_348_cov_1.638554	309	346	0	32	37	0.8648649
NODE_114591_length_348_cov_1.638554	309	346	2	4	37	0.1081081
NODE_114591_length_348_cov_1.638554	309	346	4	1	37	0.0270270
NODE_114643_length_348_cov_1.485944	9	60	0	18	51	0.3529412
NODE_114643_length_348_cov_1.485944	9	60	2	33	51	0.6470588
NODE_115147_length_347_cov_15.100806	57	137	2	46	80	0.5750000
NODE_115147_length_347_cov_15.100806	57	137	4	34	80	0.4250000
NODE_115147_length_347_cov_15.100806	110	152	0	6	42	0.1428571
NODE_115147_length_347_cov_15.100806	110	152	2	36	42	0.8571429
NODE_115147_length_347_cov_15.100806	182	209	0	27	27	1.0000000
NODE_115147_length_347_cov_15.100806	290	317	0	27	27	1.0000000
NODE_115161_length_347_cov_5.967742	110	173	0	63	63	1.0000000
NODE_115195_length_347_cov_4.028226	260	329	0	69	69	1.0000000
NODE_115321_length_347_cov_2.463710	99	141	4	42	42	1.0000000
NODE_115321_length_347_cov_2.463710	108	143	4	35	35	1.0000000
NODE_115331_length_347_cov_2.391129	35	70	0	35	35	1.0000000
NODE_115331_length_347_cov_2.391129	37	79	0	42	42	1.0000000
NODE_115331_length_347_cov_2.391129	77	105	0	28	28	1.0000000
NODE_115397_length_347_cov_2.048387	15	34	0	19	19	1.0000000
NODE_115417_length_347_cov_1.967742	205	268	0	63	63	1.0000000
NODE_115450_length_347_cov_1.818548	109	156	0	47	47	1.0000000
NODE_115771_length_347_cov_1.028226	230	255	0	25	25	1.0000000
NODE_116114_length_346_cov_74.433198	10	90	0	1	80	0.0125000
NODE_116114_length_346_cov_74.433198	10	90	12	5	80	0.0625000
NODE_116114_length_346_cov_74.433198	10	90	16	2	80	0.0250000
NODE_116114_length_346_cov_74.433198	10	90	21	72	80	0.9000000
NODE_116114_length_346_cov_74.433198	19	90	21	71	71	1.0000000
NODE_116114_length_346_cov_74.433198	192	272	0	16	80	0.2000000
NODE_116114_length_346_cov_74.433198	192	272	4	10	80	0.1250000
NODE_116114_length_346_cov_74.433198	192	272	6	54	80	0.6750000
NODE_116115_length_346_cov_67.834008	133	213	0	80	80	1.0000000
NODE_116115_length_346_cov_67.834008	186	266	0	80	80	1.0000000
NODE_116117_length_346_cov_10.299595	190	270	0	80	80	1.0000000
NODE_116117_length_346_cov_10.299595	243	323	0	80	80	1.0000000
NODE_116119_length_346_cov_9.566802	159	239	3	11	80	0.1375000
NODE_116119_length_346_cov_9.566802	159	239	5	57	80	0.7125000
NODE_116119_length_346_cov_9.566802	159	239	6	12	80	0.1500000
NODE_116119_length_346_cov_9.566802	212	292	3	11	80	0.1375000
NODE_116119_length_346_cov_9.566802	212	292	5	4	80	0.0500000
NODE_116119_length_346_cov_9.566802	212	292	6	65	80	0.8125000
NODE_116134_length_346_cov_5.506073	157	238	4	7	81	0.0864198
NODE_116134_length_346_cov_5.506073	157	238	6	30	81	0.3703704
NODE_116134_length_346_cov_5.506073	157	238	8	44	81	0.5432099
NODE_116155_length_346_cov_4.368421	205	264	0	59	59	1.0000000
NODE_116159_length_346_cov_4.032389	121	141	0	20	20	1.0000000
NODE_116184_length_346_cov_3.400810	194	253	0	59	59	1.0000000
NODE_116212_length_346_cov_3.008097	183	263	0	80	80	1.0000000
NODE_116257_length_346_cov_2.538462	47	102	0	55	55	1.0000000
NODE_116257_length_346_cov_2.538462	118	173	0	42	55	0.7636364
NODE_116257_length_346_cov_2.538462	118	173	4	13	55	0.2363636
NODE_116439_length_346_cov_1.700405	71	107	0	36	36	1.0000000
NODE_117035_length_345_cov_47.699187	0	66	0	66	66	1.0000000
NODE_117035_length_345_cov_47.699187	39	119	0	80	80	1.0000000
NODE_117035_length_345_cov_47.699187	115	182	0	67	67	1.0000000
NODE_117035_length_345_cov_47.699187	246	311	0	65	65	1.0000000
NODE_117036_length_345_cov_13.439024	28	108	0	80	80	1.0000000
NODE_117036_length_345_cov_13.439024	81	161	0	80	80	1.0000000
NODE_117037_length_345_cov_9.906504	224	283	4	59	59	1.0000000
NODE_117051_length_345_cov_5.475610	52	132	6	27	80	0.3375000
NODE_117051_length_345_cov_5.475610	52	132	8	47	80	0.5875000
NODE_117051_length_345_cov_5.475610	52	132	10	6	80	0.0750000
NODE_117051_length_345_cov_5.475610	105	185	6	14	80	0.1750000
NODE_117051_length_345_cov_5.475610	105	185	8	8	80	0.1000000
NODE_117051_length_345_cov_5.475610	105	185	10	44	80	0.5500000
NODE_117051_length_345_cov_5.475610	105	185	12	14	80	0.1750000
NODE_117055_length_345_cov_5.321138	104	152	0	48	48	1.0000000
NODE_117065_length_345_cov_4.524390	205	269	0	64	64	1.0000000
NODE_117075_length_345_cov_4.109756	95	157	2	21	62	0.3387097
NODE_117075_length_345_cov_4.109756	95	157	4	19	62	0.3064516
NODE_117075_length_345_cov_4.109756	95	157	6	22	62	0.3548387
NODE_117075_length_345_cov_4.109756	162	204	2	35	42	0.8333333
NODE_117075_length_345_cov_4.109756	162	204	4	2	42	0.0476190
NODE_117075_length_345_cov_4.109756	162	204	6	5	42	0.1190476
NODE_117076_length_345_cov_4.073171	251	326	0	75	75	1.0000000
NODE_117084_length_345_cov_3.776423	199	273	0	74	74	1.0000000
NODE_117084_length_345_cov_3.776423	246	326	0	80	80	1.0000000
NODE_117148_length_345_cov_2.821138	61	141	0	14	80	0.1750000
NODE_117148_length_345_cov_2.821138	61	141	2	66	80	0.8250000
NODE_117205_length_345_cov_2.333333	47	90	10	1	43	0.0232558
NODE_117205_length_345_cov_2.333333	47	90	16	1	43	0.0232558
NODE_117205_length_345_cov_2.333333	47	90	18	3	43	0.0697674
NODE_117205_length_345_cov_2.333333	47	90	20	1	43	0.0232558
NODE_117205_length_345_cov_2.333333	47	90	22	1	43	0.0232558
NODE_117205_length_345_cov_2.333333	47	90	24	1	43	0.0232558
NODE_117205_length_345_cov_2.333333	47	90	30	9	43	0.2093023
NODE_117205_length_345_cov_2.333333	47	90	32	1	43	0.0232558
NODE_117205_length_345_cov_2.333333	47	90	34	2	43	0.0465116
NODE_117205_length_345_cov_2.333333	47	90	36	2	43	0.0465116
NODE_117205_length_345_cov_2.333333	47	90	42	2	43	0.0465116
NODE_117205_length_345_cov_2.333333	47	90	44	4	43	0.0930233
NODE_117205_length_345_cov_2.333333	47	90	46	1	43	0.0232558
NODE_117205_length_345_cov_2.333333	47	90	50	9	43	0.2093023
NODE_117205_length_345_cov_2.333333	47	90	52	1	43	0.0232558
NODE_117205_length_345_cov_2.333333	47	90	54	4	43	0.0930233
NODE_117205_length_345_cov_2.333333	63	147	30	1	84	0.0119048
NODE_117205_length_345_cov_2.333333	63	147	32	1	84	0.0119048
NODE_117205_length_345_cov_2.333333	63	147	34	2	84	0.0238095
NODE_117205_length_345_cov_2.333333	63	147	36	2	84	0.0238095
NODE_117205_length_345_cov_2.333333	63	147	42	2	84	0.0238095
NODE_117205_length_345_cov_2.333333	63	147	44	4	84	0.0476190
NODE_117205_length_345_cov_2.333333	63	147	46	1	84	0.0119048
NODE_117205_length_345_cov_2.333333	63	147	50	9	84	0.1071429
NODE_117205_length_345_cov_2.333333	63	147	51	7	84	0.0833333
NODE_117205_length_345_cov_2.333333	63	147	52	1	84	0.0119048
NODE_117205_length_345_cov_2.333333	63	147	53	1	84	0.0119048
NODE_117205_length_345_cov_2.333333	63	147	54	8	84	0.0952381
NODE_117205_length_345_cov_2.333333	63	147	55	1	84	0.0119048
NODE_117205_length_345_cov_2.333333	63	147	56	5	84	0.0595238
NODE_117205_length_345_cov_2.333333	63	147	58	9	84	0.1071429
NODE_117205_length_345_cov_2.333333	63	147	59	4	84	0.0476190
NODE_117205_length_345_cov_2.333333	63	147	62	10	84	0.1190476
NODE_117205_length_345_cov_2.333333	63	147	63	16	84	0.1904762
NODE_117219_length_345_cov_2.239837	0	81	0	2	81	0.0246914
NODE_117219_length_345_cov_2.239837	0	81	4	1	81	0.0123457
NODE_117219_length_345_cov_2.239837	0	81	6	5	81	0.0617284
NODE_117219_length_345_cov_2.239837	0	81	10	6	81	0.0740741
NODE_117219_length_345_cov_2.239837	0	81	12	1	81	0.0123457
NODE_117219_length_345_cov_2.239837	0	81	14	16	81	0.1975309
NODE_117219_length_345_cov_2.239837	0	81	16	5	81	0.0617284
NODE_117219_length_345_cov_2.239837	0	81	18	1	81	0.0123457
NODE_117219_length_345_cov_2.239837	0	81	20	11	81	0.1358025
NODE_117219_length_345_cov_2.239837	0	81	24	20	81	0.2469136
NODE_117219_length_345_cov_2.239837	0	81	26	2	81	0.0246914
NODE_117219_length_345_cov_2.239837	0	81	28	11	81	0.1358025
NODE_117669_length_345_cov_1.040650	6	73	4	2	67	0.0298507
NODE_117669_length_345_cov_1.040650	6	73	6	2	67	0.0298507
NODE_117669_length_345_cov_1.040650	6	73	10	18	67	0.2686567
NODE_117669_length_345_cov_1.040650	6	73	12	7	67	0.1044776
NODE_117669_length_345_cov_1.040650	6	73	14	2	67	0.0298507
NODE_117669_length_345_cov_1.040650	6	73	16	4	67	0.0597015
NODE_117669_length_345_cov_1.040650	6	73	18	32	67	0.4776119
NODE_117989_length_344_cov_54.020408	6	55	0	13	49	0.2653061
NODE_117989_length_344_cov_54.020408	6	55	4	19	49	0.3877551
NODE_117989_length_344_cov_54.020408	6	55	8	2	49	0.0408163
NODE_117989_length_344_cov_54.020408	6	55	14	1	49	0.0204082
NODE_117989_length_344_cov_54.020408	6	55	16	3	49	0.0612245
NODE_117989_length_344_cov_54.020408	6	55	26	11	49	0.2244898
NODE_117989_length_344_cov_54.020408	28	105	4	10	77	0.1298701
NODE_117989_length_344_cov_54.020408	28	105	8	2	77	0.0259740
NODE_117989_length_344_cov_54.020408	28	105	14	1	77	0.0129870
NODE_117989_length_344_cov_54.020408	28	105	16	3	77	0.0389610
NODE_117989_length_344_cov_54.020408	28	105	26	29	77	0.3766234
NODE_117989_length_344_cov_54.020408	28	105	28	32	77	0.4155844
NODE_117989_length_344_cov_54.020408	28	105	4	10	77	0.1298701
NODE_117989_length_344_cov_54.020408	28	105	8	2	77	0.0259740
NODE_117989_length_344_cov_54.020408	28	105	14	1	77	0.0129870
NODE_117989_length_344_cov_54.020408	28	105	16	3	77	0.0389610
NODE_117989_length_344_cov_54.020408	28	105	26	29	77	0.3766234
NODE_117989_length_344_cov_54.020408	28	105	28	32	77	0.4155844
NODE_117989_length_344_cov_54.020408	112	178	24	6	66	0.0909091
NODE_117989_length_344_cov_54.020408	112	178	28	23	66	0.3484848
NODE_117989_length_344_cov_54.020408	112	178	30	31	66	0.4696970
NODE_117989_length_344_cov_54.020408	112	178	32	4	66	0.0606061
NODE_117989_length_344_cov_54.020408	112	178	34	2	66	0.0303030
NODE_118009_length_344_cov_5.016327	72	125	2	9	53	0.1698113
NODE_118009_length_344_cov_5.016327	72	125	4	1	53	0.0188679
NODE_118009_length_344_cov_5.016327	72	125	6	2	53	0.0377358
NODE_118009_length_344_cov_5.016327	72	125	8	1	53	0.0188679
NODE_118009_length_344_cov_5.016327	72	125	10	18	53	0.3396226
NODE_118009_length_344_cov_5.016327	72	125	12	2	53	0.0377358
NODE_118009_length_344_cov_5.016327	72	125	14	20	53	0.3773585
NODE_118009_length_344_cov_5.016327	136	203	6	8	67	0.1194030
NODE_118009_length_344_cov_5.016327	136	203	10	8	67	0.1194030
NODE_118009_length_344_cov_5.016327	136	203	12	37	67	0.5522388
NODE_118009_length_344_cov_5.016327	136	203	14	14	67	0.2089552
NODE_118017_length_344_cov_4.579592	172	254	0	82	82	1.0000000
NODE_118045_length_344_cov_3.840816	197	240	0	43	43	1.0000000
NODE_118074_length_344_cov_3.293878	149	189	0	16	40	0.4000000
NODE_118074_length_344_cov_3.293878	149	189	2	24	40	0.6000000
NODE_118074_length_344_cov_3.293878	162	229	0	3	67	0.0447761
NODE_118074_length_344_cov_3.293878	162	229	2	64	67	0.9552239
NODE_118111_length_344_cov_2.751020	24	87	3	1	63	0.0158730
NODE_118111_length_344_cov_2.751020	24	87	4	62	63	0.9841270
NODE_118179_length_344_cov_2.126531	274	305	2	31	31	1.0000000
NODE_118243_length_344_cov_1.914286	114	194	0	80	80	1.0000000
NODE_118243_length_344_cov_1.914286	167	247	0	33	80	0.4125000
NODE_118243_length_344_cov_1.914286	167	247	2	47	80	0.5875000
NODE_118297_length_344_cov_1.685714	180	220	6	5	40	0.1250000
NODE_118297_length_344_cov_1.685714	180	220	10	9	40	0.2250000
NODE_118297_length_344_cov_1.685714	180	220	12	26	40	0.6500000
NODE_118393_length_344_cov_1.457143	160	240	9	3	80	0.0375000
NODE_118393_length_344_cov_1.457143	160	240	10	14	80	0.1750000
NODE_118393_length_344_cov_1.457143	160	240	12	5	80	0.0625000
NODE_118393_length_344_cov_1.457143	160	240	14	26	80	0.3250000
NODE_118393_length_344_cov_1.457143	160	240	15	2	80	0.0250000
NODE_118393_length_344_cov_1.457143	160	240	18	30	80	0.3750000
NODE_118393_length_344_cov_1.457143	213	273	1	4	60	0.0666667
NODE_118393_length_344_cov_1.457143	213	273	2	4	60	0.0666667
NODE_118393_length_344_cov_1.457143	213	273	3	2	60	0.0333333
NODE_118393_length_344_cov_1.457143	213	273	7	14	60	0.2333333
NODE_118393_length_344_cov_1.457143	213	273	9	12	60	0.2000000
NODE_118393_length_344_cov_1.457143	213	273	10	14	60	0.2333333
NODE_118393_length_344_cov_1.457143	213	273	12	5	60	0.0833333
NODE_118393_length_344_cov_1.457143	213	273	14	5	60	0.0833333
NODE_118743_length_344_cov_0.800000	123	163	2	40	40	1.0000000
NODE_118899_length_343_cov_3.770492	2	60	0	58	58	1.0000000
NODE_118905_length_343_cov_3.598361	97	170	4	3	73	0.0410959
NODE_118905_length_343_cov_3.598361	97	170	8	5	73	0.0684932
NODE_118905_length_343_cov_3.598361	97	170	10	25	73	0.3424658
NODE_118905_length_343_cov_3.598361	97	170	12	40	73	0.5479452
NODE_118905_length_343_cov_3.598361	150	223	4	5	73	0.0684932
NODE_118905_length_343_cov_3.598361	150	223	6	19	73	0.2602740
NODE_118905_length_343_cov_3.598361	150	223	8	1	73	0.0136986
NODE_118905_length_343_cov_3.598361	150	223	10	8	73	0.1095890
NODE_118905_length_343_cov_3.598361	150	223	12	40	73	0.5479452
NODE_118911_length_343_cov_3.401639	48	128	8	2	80	0.0250000
NODE_118911_length_343_cov_3.401639	48	128	9	3	80	0.0375000
NODE_118911_length_343_cov_3.401639	48	128	14	1	80	0.0125000
NODE_118911_length_343_cov_3.401639	48	128	16	2	80	0.0250000
NODE_118911_length_343_cov_3.401639	48	128	22	2	80	0.0250000
NODE_118911_length_343_cov_3.401639	48	128	24	4	80	0.0500000
NODE_118911_length_343_cov_3.401639	48	128	26	1	80	0.0125000
NODE_118911_length_343_cov_3.401639	48	128	27	3	80	0.0375000
NODE_118911_length_343_cov_3.401639	48	128	28	2	80	0.0250000
NODE_118911_length_343_cov_3.401639	48	128	30	2	80	0.0250000
NODE_118911_length_343_cov_3.401639	48	128	32	1	80	0.0125000
NODE_118911_length_343_cov_3.401639	48	128	33	1	80	0.0125000
NODE_118911_length_343_cov_3.401639	48	128	35	1	80	0.0125000
NODE_118911_length_343_cov_3.401639	48	128	37	2	80	0.0250000
NODE_118911_length_343_cov_3.401639	48	128	39	1	80	0.0125000
NODE_118911_length_343_cov_3.401639	48	128	41	2	80	0.0250000
NODE_118911_length_343_cov_3.401639	48	128	47	5	80	0.0625000
NODE_118911_length_343_cov_3.401639	48	128	49	22	80	0.2750000
NODE_118911_length_343_cov_3.401639	48	128	50	11	80	0.1375000
NODE_118911_length_343_cov_3.401639	48	128	51	2	80	0.0250000
NODE_118911_length_343_cov_3.401639	48	128	52	5	80	0.0625000
NODE_118911_length_343_cov_3.401639	48	128	53	1	80	0.0125000
NODE_118911_length_343_cov_3.401639	48	128	54	4	80	0.0500000
NODE_118941_length_343_cov_3.049180	12	62	0	50	50	1.0000000
NODE_118941_length_343_cov_3.049180	82	111	2	29	29	1.0000000
NODE_118941_length_343_cov_3.049180	133	205	0	29	72	0.4027778
NODE_118941_length_343_cov_3.049180	133	205	2	22	72	0.3055556
NODE_118941_length_343_cov_3.049180	133	205	4	21	72	0.2916667
NODE_118957_length_343_cov_2.770492	236	316	8	5	80	0.0625000
NODE_118957_length_343_cov_2.770492	236	316	10	49	80	0.6125000
NODE_118957_length_343_cov_2.770492	236	316	14	3	80	0.0375000
NODE_118957_length_343_cov_2.770492	236	316	16	5	80	0.0625000
NODE_118957_length_343_cov_2.770492	236	316	18	2	80	0.0250000
NODE_118957_length_343_cov_2.770492	236	316	20	10	80	0.1250000
NODE_118957_length_343_cov_2.770492	236	316	22	6	80	0.0750000
NODE_118978_length_343_cov_2.590164	167	225	4	25	58	0.4310345
NODE_118978_length_343_cov_2.590164	167	225	6	33	58	0.5689655
NODE_118998_length_343_cov_2.430328	208	274	0	36	66	0.5454546
NODE_118998_length_343_cov_2.430328	208	274	2	2	66	0.0303030
NODE_118998_length_343_cov_2.430328	208	274	4	11	66	0.1666667
NODE_118998_length_343_cov_2.430328	208	274	6	17	66	0.2575758
NODE_119040_length_343_cov_2.209016	32	111	0	72	79	0.9113924
NODE_119040_length_343_cov_2.209016	32	111	2	7	79	0.0886076
NODE_119067_length_343_cov_2.081967	95	177	0	82	82	1.0000000
NODE_119067_length_343_cov_2.081967	150	199	0	49	49	1.0000000
NODE_119202_length_343_cov_1.635246	0	52	0	9	52	0.1730769
NODE_119202_length_343_cov_1.635246	0	52	2	43	52	0.8269231
NODE_119439_length_343_cov_1.143443	60	120	0	60	60	1.0000000
NODE_119834_length_342_cov_3.872428	136	216	0	29	80	0.3625000
NODE_119834_length_342_cov_3.872428	136	216	2	25	80	0.3125000
NODE_119834_length_342_cov_3.872428	136	216	4	20	80	0.2500000
NODE_119834_length_342_cov_3.872428	136	216	6	6	80	0.0750000
NODE_119834_length_342_cov_3.872428	189	259	2	16	70	0.2285714
NODE_119834_length_342_cov_3.872428	189	259	4	54	70	0.7714286
NODE_119840_length_342_cov_3.769547	146	212	0	6	66	0.0909091
NODE_119840_length_342_cov_3.769547	146	212	1	15	66	0.2272727
NODE_119840_length_342_cov_3.769547	146	212	2	45	66	0.6818182
NODE_119841_length_342_cov_3.740741	113	146	10	33	33	1.0000000
NODE_119846_length_342_cov_3.674897	20	100	0	80	80	1.0000000
NODE_119846_length_342_cov_3.674897	73	153	0	80	80	1.0000000
NODE_119847_length_342_cov_3.588477	117	197	4	13	80	0.1625000
NODE_119847_length_342_cov_3.588477	117	197	6	67	80	0.8375000
NODE_119849_length_342_cov_3.530864	72	151	0	79	79	1.0000000
NODE_119852_length_342_cov_3.423868	172	252	2	25	80	0.3125000
NODE_119852_length_342_cov_3.423868	172	252	4	55	80	0.6875000
NODE_119852_length_342_cov_3.423868	225	283	2	29	58	0.5000000
NODE_119852_length_342_cov_3.423868	225	283	4	29	58	0.5000000
NODE_119922_length_342_cov_2.432099	16	81	0	65	65	1.0000000
NODE_119993_length_342_cov_2.049383	249	317	2	68	68	1.0000000
NODE_120047_length_342_cov_1.864198	138	190	11	5	52	0.0961538
NODE_120047_length_342_cov_1.864198	138	190	12	2	52	0.0384615
NODE_120047_length_342_cov_1.864198	138	190	13	7	52	0.1346154
NODE_120047_length_342_cov_1.864198	138	190	14	15	52	0.2884615
NODE_120047_length_342_cov_1.864198	138	190	15	6	52	0.1153846
NODE_120047_length_342_cov_1.864198	138	190	16	17	52	0.3269231
NODE_120047_length_342_cov_1.864198	183	243	6	15	60	0.2500000
NODE_120047_length_342_cov_1.864198	183	243	7	4	60	0.0666667
NODE_120047_length_342_cov_1.864198	183	243	9	10	60	0.1666667
NODE_120047_length_342_cov_1.864198	183	243	11	23	60	0.3833333
NODE_120047_length_342_cov_1.864198	183	243	13	8	60	0.1333333
NODE_120073_length_342_cov_1.720165	91	147	16	4	56	0.0714286
NODE_120073_length_342_cov_1.720165	91	147	18	11	56	0.1964286
NODE_120073_length_342_cov_1.720165	91	147	20	4	56	0.0714286
NODE_120073_length_342_cov_1.720165	91	147	22	37	56	0.6607143
NODE_120284_length_342_cov_1.271605	201	240	0	39	39	1.0000000
NODE_120755_length_341_cov_15.896694	50	130	2	80	80	1.0000000
NODE_120755_length_341_cov_15.896694	103	183	0	52	80	0.6500000
NODE_120755_length_341_cov_15.896694	103	183	2	28	80	0.3500000
NODE_120757_length_341_cov_9.756198	117	196	0	71	79	0.8987342
NODE_120757_length_341_cov_9.756198	117	196	2	8	79	0.1012658
NODE_120770_length_341_cov_5.404959	141	220	0	29	79	0.3670886
NODE_120770_length_341_cov_5.404959	141	220	2	6	79	0.0759494
NODE_120770_length_341_cov_5.404959	141	220	4	5	79	0.0632911
NODE_120770_length_341_cov_5.404959	141	220	5	2	79	0.0253165
NODE_120770_length_341_cov_5.404959	141	220	6	2	79	0.0253165
NODE_120770_length_341_cov_5.404959	141	220	8	8	79	0.1012658
NODE_120770_length_341_cov_5.404959	141	220	10	7	79	0.0886076
NODE_120770_length_341_cov_5.404959	141	220	11	2	79	0.0253165
NODE_120770_length_341_cov_5.404959	141	220	15	13	79	0.1645570
NODE_120770_length_341_cov_5.404959	141	220	17	5	79	0.0632911
NODE_120780_length_341_cov_4.669421	301	320	0	19	19	1.0000000
NODE_120783_length_341_cov_4.438017	57	132	0	75	75	1.0000000
NODE_120783_length_341_cov_4.438017	110	185	0	75	75	1.0000000
NODE_120785_length_341_cov_4.400826	164	244	0	80	80	1.0000000
NODE_120785_length_341_cov_4.400826	224	297	0	73	73	1.0000000
NODE_120797_length_341_cov_3.896694	58	122	4	3	64	0.0468750
NODE_120797_length_341_cov_3.896694	58	122	8	2	64	0.0312500
NODE_120797_length_341_cov_3.896694	58	122	9	3	64	0.0468750
NODE_120797_length_341_cov_3.896694	58	122	10	8	64	0.1250000
NODE_120797_length_341_cov_3.896694	58	122	12	7	64	0.1093750
NODE_120797_length_341_cov_3.896694	58	122	14	7	64	0.1093750
NODE_120797_length_341_cov_3.896694	58	122	17	9	64	0.1406250
NODE_120797_length_341_cov_3.896694	58	122	18	10	64	0.1562500
NODE_120797_length_341_cov_3.896694	58	122	20	2	64	0.0312500
NODE_120797_length_341_cov_3.896694	58	122	22	2	64	0.0312500
NODE_120797_length_341_cov_3.896694	58	122	25	2	64	0.0312500
NODE_120797_length_341_cov_3.896694	58	122	29	1	64	0.0156250
NODE_120797_length_341_cov_3.896694	58	122	31	5	64	0.0781250
NODE_120797_length_341_cov_3.896694	58	122	32	3	64	0.0468750
NODE_120805_length_341_cov_3.727273	191	273	8	1	82	0.0121951
NODE_120805_length_341_cov_3.727273	191	273	12	48	82	0.5853658
NODE_120805_length_341_cov_3.727273	191	273	14	8	82	0.0975610
NODE_120805_length_341_cov_3.727273	191	273	16	23	82	0.2804878
NODE_120805_length_341_cov_3.727273	191	273	18	1	82	0.0121951
NODE_120805_length_341_cov_3.727273	191	273	20	1	82	0.0121951
NODE_120805_length_341_cov_3.727273	253	326	2	17	73	0.2328767
NODE_120805_length_341_cov_3.727273	253	326	4	18	73	0.2465753
NODE_120805_length_341_cov_3.727273	253	326	6	9	73	0.1232877
NODE_120805_length_341_cov_3.727273	253	326	8	10	73	0.1369863
NODE_120805_length_341_cov_3.727273	253	326	12	19	73	0.2602740
NODE_120839_length_341_cov_3.000000	91	161	10	13	70	0.1857143
NODE_120839_length_341_cov_3.000000	91	161	12	3	70	0.0428571
NODE_120839_length_341_cov_3.000000	91	161	14	54	70	0.7714286
NODE_120839_length_341_cov_3.000000	146	215	0	29	69	0.4202898
NODE_120839_length_341_cov_3.000000	146	215	2	10	69	0.1449275
NODE_120839_length_341_cov_3.000000	146	215	4	3	69	0.0434783
NODE_120839_length_341_cov_3.000000	146	215	6	1	69	0.0144928
NODE_120839_length_341_cov_3.000000	146	215	8	4	69	0.0579710
NODE_120839_length_341_cov_3.000000	146	215	10	19	69	0.2753623
NODE_120839_length_341_cov_3.000000	146	215	12	1	69	0.0144928
NODE_120839_length_341_cov_3.000000	146	215	14	2	69	0.0289855
NODE_120840_length_341_cov_3.000000	127	207	0	80	80	1.0000000
NODE_120892_length_341_cov_2.533058	92	172	0	80	80	1.0000000
NODE_120901_length_341_cov_2.495868	8	89	0	57	81	0.7037037
NODE_120901_length_341_cov_2.495868	8	89	1	24	81	0.2962963
NODE_120946_length_341_cov_2.235537	10	90	0	18	80	0.2250000
NODE_120946_length_341_cov_2.235537	10	90	6	62	80	0.7750000
NODE_120972_length_341_cov_2.103306	46	125	0	24	79	0.3037975
NODE_120972_length_341_cov_2.103306	46	125	4	55	79	0.6962025
NODE_120994_length_341_cov_2.066116	147	184	8	1	37	0.0270270
NODE_120994_length_341_cov_2.066116	147	184	12	1	37	0.0270270
NODE_120994_length_341_cov_2.066116	147	184	14	1	37	0.0270270
NODE_120994_length_341_cov_2.066116	147	184	16	11	37	0.2972973
NODE_120994_length_341_cov_2.066116	147	184	18	12	37	0.3243243
NODE_120994_length_341_cov_2.066116	147	184	20	11	37	0.2972973
NODE_121052_length_341_cov_1.772727	179	250	0	50	71	0.7042254
NODE_121052_length_341_cov_1.772727	179	250	1	4	71	0.0563380
NODE_121052_length_341_cov_1.772727	179	250	2	13	71	0.1830986
NODE_121052_length_341_cov_1.772727	179	250	4	4	71	0.0563380
NODE_121064_length_341_cov_1.727273	105	185	0	80	80	1.0000000
NODE_121160_length_341_cov_1.475207	120	185	6	43	65	0.6615385
NODE_121160_length_341_cov_1.475207	120	185	8	22	65	0.3384615
NODE_121160_length_341_cov_1.475207	158	238	2	38	80	0.4750000
NODE_121160_length_341_cov_1.475207	158	238	6	25	80	0.3125000
NODE_121160_length_341_cov_1.475207	158	238	8	17	80	0.2125000
NODE_121173_length_341_cov_1.471074	186	266	9	2	80	0.0250000
NODE_121173_length_341_cov_1.471074	186	266	11	37	80	0.4625000
NODE_121173_length_341_cov_1.471074	186	266	13	14	80	0.1750000
NODE_121173_length_341_cov_1.471074	186	266	14	1	80	0.0125000
NODE_121173_length_341_cov_1.471074	186	266	15	1	80	0.0125000
NODE_121173_length_341_cov_1.471074	186	266	16	25	80	0.3125000
NODE_121173_length_341_cov_1.471074	239	319	6	32	80	0.4000000
NODE_121173_length_341_cov_1.471074	239	319	8	1	80	0.0125000
NODE_121173_length_341_cov_1.471074	239	319	12	20	80	0.2500000
NODE_121173_length_341_cov_1.471074	239	319	13	5	80	0.0625000
NODE_121173_length_341_cov_1.471074	239	319	14	1	80	0.0125000
NODE_121173_length_341_cov_1.471074	239	319	16	21	80	0.2625000
NODE_121211_length_341_cov_1.342975	284	322	0	38	38	1.0000000
NODE_121431_length_341_cov_0.991736	36	89	0	53	53	1.0000000
NODE_121693_length_340_cov_541.348548	86	144	498	2	58	0.0344828
NODE_121693_length_340_cov_541.348548	86	144	512	1	58	0.0172414
NODE_121693_length_340_cov_541.348548	86	144	519	1	58	0.0172414
NODE_121693_length_340_cov_541.348548	86	144	540	1	58	0.0172414
NODE_121693_length_340_cov_541.348548	86	144	554	1	58	0.0172414
NODE_121693_length_340_cov_541.348548	86	144	573	1	58	0.0172414
NODE_121693_length_340_cov_541.348548	86	144	578	1	58	0.0172414
NODE_121693_length_340_cov_541.348548	86	144	586	1	58	0.0172414
NODE_121693_length_340_cov_541.348548	86	144	625	1	58	0.0172414
NODE_121693_length_340_cov_541.348548	86	144	646	1	58	0.0172414
NODE_121693_length_340_cov_541.348548	86	144	675	1	58	0.0172414
NODE_121693_length_340_cov_541.348548	86	144	699	1	58	0.0172414
NODE_121693_length_340_cov_541.348548	86	144	738	1	58	0.0172414
NODE_121693_length_340_cov_541.348548	86	144	759	1	58	0.0172414
NODE_121693_length_340_cov_541.348548	86	144	776	1	58	0.0172414
NODE_121693_length_340_cov_541.348548	86	144	831	1	58	0.0172414
NODE_121693_length_340_cov_541.348548	86	144	842	1	58	0.0172414
NODE_121693_length_340_cov_541.348548	86	144	849	1	58	0.0172414
NODE_121693_length_340_cov_541.348548	86	144	868	1	58	0.0172414
NODE_121693_length_340_cov_541.348548	86	144	881	1	58	0.0172414
NODE_121693_length_340_cov_541.348548	86	144	931	1	58	0.0172414
NODE_121693_length_340_cov_541.348548	86	144	934	1	58	0.0172414
NODE_121693_length_340_cov_541.348548	86	144	950	2	58	0.0344828
NODE_121693_length_340_cov_541.348548	86	144	972	1	58	0.0172414
NODE_121693_length_340_cov_541.348548	86	144	1006	1	58	0.0172414
NODE_121693_length_340_cov_541.348548	86	144	1007	1	58	0.0172414
NODE_121693_length_340_cov_541.348548	86	144	1015	1	58	0.0172414
NODE_121693_length_340_cov_541.348548	86	144	1024	1	58	0.0172414
NODE_121693_length_340_cov_541.348548	86	144	1042	1	58	0.0172414
NODE_121693_length_340_cov_541.348548	86	144	1053	1	58	0.0172414
NODE_121693_length_340_cov_541.348548	86	144	1059	1	58	0.0172414
NODE_121693_length_340_cov_541.348548	86	144	1076	1	58	0.0172414
NODE_121693_length_340_cov_541.348548	86	144	1101	1	58	0.0172414
NODE_121693_length_340_cov_541.348548	86	144	1117	1	58	0.0172414
NODE_121693_length_340_cov_541.348548	86	144	1122	1	58	0.0172414
NODE_121693_length_340_cov_541.348548	86	144	1127	1	58	0.0172414
NODE_121693_length_340_cov_541.348548	86	144	1138	1	58	0.0172414
NODE_121693_length_340_cov_541.348548	86	144	1151	1	58	0.0172414
NODE_121693_length_340_cov_541.348548	86	144	1163	1	58	0.0172414
NODE_121693_length_340_cov_541.348548	86	144	1183	1	58	0.0172414
NODE_121693_length_340_cov_541.348548	86	144	1192	1	58	0.0172414
NODE_121693_length_340_cov_541.348548	86	144	1207	1	58	0.0172414
NODE_121693_length_340_cov_541.348548	86	144	1213	1	58	0.0172414
NODE_121693_length_340_cov_541.348548	86	144	1253	1	58	0.0172414
NODE_121693_length_340_cov_541.348548	86	144	1260	1	58	0.0172414
NODE_121693_length_340_cov_541.348548	86	144	1268	1	58	0.0172414
NODE_121693_length_340_cov_541.348548	86	144	1273	1	58	0.0172414
NODE_121693_length_340_cov_541.348548	86	144	1302	1	58	0.0172414
NODE_121693_length_340_cov_541.348548	86	144	1325	1	58	0.0172414
NODE_121693_length_340_cov_541.348548	86	144	1342	1	58	0.0172414
NODE_121693_length_340_cov_541.348548	86	144	1370	1	58	0.0172414
NODE_121693_length_340_cov_541.348548	86	144	1391	1	58	0.0172414
NODE_121693_length_340_cov_541.348548	86	144	1411	1	58	0.0172414
NODE_121693_length_340_cov_541.348548	86	144	1422	1	58	0.0172414
NODE_121693_length_340_cov_541.348548	86	144	1431	1	58	0.0172414
NODE_121693_length_340_cov_541.348548	86	144	1446	1	58	0.0172414
NODE_121693_length_340_cov_541.348548	86	154	498	2	68	0.0294118
NODE_121693_length_340_cov_541.348548	86	154	512	1	68	0.0147059
NODE_121693_length_340_cov_541.348548	86	154	519	1	68	0.0147059
NODE_121693_length_340_cov_541.348548	86	154	540	1	68	0.0147059
NODE_121693_length_340_cov_541.348548	86	154	554	1	68	0.0147059
NODE_121693_length_340_cov_541.348548	86	154	573	1	68	0.0147059
NODE_121693_length_340_cov_541.348548	86	154	578	1	68	0.0147059
NODE_121693_length_340_cov_541.348548	86	154	586	1	68	0.0147059
NODE_121693_length_340_cov_541.348548	86	154	625	1	68	0.0147059
NODE_121693_length_340_cov_541.348548	86	154	646	1	68	0.0147059
NODE_121693_length_340_cov_541.348548	86	154	675	1	68	0.0147059
NODE_121693_length_340_cov_541.348548	86	154	699	1	68	0.0147059
NODE_121693_length_340_cov_541.348548	86	154	738	1	68	0.0147059
NODE_121693_length_340_cov_541.348548	86	154	759	1	68	0.0147059
NODE_121693_length_340_cov_541.348548	86	154	776	1	68	0.0147059
NODE_121693_length_340_cov_541.348548	86	154	831	1	68	0.0147059
NODE_121693_length_340_cov_541.348548	86	154	842	1	68	0.0147059
NODE_121693_length_340_cov_541.348548	86	154	849	1	68	0.0147059
NODE_121693_length_340_cov_541.348548	86	154	868	1	68	0.0147059
NODE_121693_length_340_cov_541.348548	86	154	881	1	68	0.0147059
NODE_121693_length_340_cov_541.348548	86	154	931	1	68	0.0147059
NODE_121693_length_340_cov_541.348548	86	154	934	1	68	0.0147059
NODE_121693_length_340_cov_541.348548	86	154	950	2	68	0.0294118
NODE_121693_length_340_cov_541.348548	86	154	972	1	68	0.0147059
NODE_121693_length_340_cov_541.348548	86	154	1006	1	68	0.0147059
NODE_121693_length_340_cov_541.348548	86	154	1007	1	68	0.0147059
NODE_121693_length_340_cov_541.348548	86	154	1015	1	68	0.0147059
NODE_121693_length_340_cov_541.348548	86	154	1024	1	68	0.0147059
NODE_121693_length_340_cov_541.348548	86	154	1042	1	68	0.0147059
NODE_121693_length_340_cov_541.348548	86	154	1053	1	68	0.0147059
NODE_121693_length_340_cov_541.348548	86	154	1059	1	68	0.0147059
NODE_121693_length_340_cov_541.348548	86	154	1076	1	68	0.0147059
NODE_121693_length_340_cov_541.348548	86	154	1101	1	68	0.0147059
NODE_121693_length_340_cov_541.348548	86	154	1117	1	68	0.0147059
NODE_121693_length_340_cov_541.348548	86	154	1122	1	68	0.0147059
NODE_121693_length_340_cov_541.348548	86	154	1127	1	68	0.0147059
NODE_121693_length_340_cov_541.348548	86	154	1138	1	68	0.0147059
NODE_121693_length_340_cov_541.348548	86	154	1151	1	68	0.0147059
NODE_121693_length_340_cov_541.348548	86	154	1163	1	68	0.0147059
NODE_121693_length_340_cov_541.348548	86	154	1183	1	68	0.0147059
NODE_121693_length_340_cov_541.348548	86	154	1192	1	68	0.0147059
NODE_121693_length_340_cov_541.348548	86	154	1207	1	68	0.0147059
NODE_121693_length_340_cov_541.348548	86	154	1213	1	68	0.0147059
NODE_121693_length_340_cov_541.348548	86	154	1253	1	68	0.0147059
NODE_121693_length_340_cov_541.348548	86	154	1260	1	68	0.0147059
NODE_121693_length_340_cov_541.348548	86	154	1268	1	68	0.0147059
NODE_121693_length_340_cov_541.348548	86	154	1273	1	68	0.0147059
NODE_121693_length_340_cov_541.348548	86	154	1302	1	68	0.0147059
NODE_121693_length_340_cov_541.348548	86	154	1325	1	68	0.0147059
NODE_121693_length_340_cov_541.348548	86	154	1342	1	68	0.0147059
NODE_121693_length_340_cov_541.348548	86	154	1370	1	68	0.0147059
NODE_121693_length_340_cov_541.348548	86	154	1391	1	68	0.0147059
NODE_121693_length_340_cov_541.348548	86	154	1411	1	68	0.0147059
NODE_121693_length_340_cov_541.348548	86	154	1422	1	68	0.0147059
NODE_121693_length_340_cov_541.348548	86	154	1431	1	68	0.0147059
NODE_121693_length_340_cov_541.348548	86	154	1446	1	68	0.0147059
NODE_121693_length_340_cov_541.348548	86	154	1454	1	68	0.0147059
NODE_121693_length_340_cov_541.348548	86	154	1460	1	68	0.0147059
NODE_121693_length_340_cov_541.348548	86	154	1478	1	68	0.0147059
NODE_121693_length_340_cov_541.348548	86	154	1506	1	68	0.0147059
NODE_121693_length_340_cov_541.348548	86	154	1507	1	68	0.0147059
NODE_121693_length_340_cov_541.348548	86	154	1513	1	68	0.0147059
NODE_121693_length_340_cov_541.348548	86	154	1517	1	68	0.0147059
NODE_121693_length_340_cov_541.348548	86	154	1539	1	68	0.0147059
NODE_121693_length_340_cov_541.348548	86	154	1556	1	68	0.0147059
NODE_121693_length_340_cov_541.348548	86	154	1592	1	68	0.0147059
NODE_121693_length_340_cov_541.348548	86	107	498	2	21	0.0952381
NODE_121693_length_340_cov_541.348548	86	107	512	1	21	0.0476190
NODE_121693_length_340_cov_541.348548	86	107	519	1	21	0.0476190
NODE_121693_length_340_cov_541.348548	86	107	540	1	21	0.0476190
NODE_121693_length_340_cov_541.348548	86	107	554	1	21	0.0476190
NODE_121693_length_340_cov_541.348548	86	107	573	1	21	0.0476190
NODE_121693_length_340_cov_541.348548	86	107	578	1	21	0.0476190
NODE_121693_length_340_cov_541.348548	86	107	586	1	21	0.0476190
NODE_121693_length_340_cov_541.348548	86	107	625	1	21	0.0476190
NODE_121693_length_340_cov_541.348548	86	107	646	1	21	0.0476190
NODE_121693_length_340_cov_541.348548	86	107	675	1	21	0.0476190
NODE_121693_length_340_cov_541.348548	86	107	699	1	21	0.0476190
NODE_121693_length_340_cov_541.348548	86	107	738	1	21	0.0476190
NODE_121693_length_340_cov_541.348548	86	107	759	1	21	0.0476190
NODE_121693_length_340_cov_541.348548	86	107	776	1	21	0.0476190
NODE_121693_length_340_cov_541.348548	86	107	831	1	21	0.0476190
NODE_121693_length_340_cov_541.348548	86	107	842	1	21	0.0476190
NODE_121693_length_340_cov_541.348548	86	107	849	1	21	0.0476190
NODE_121693_length_340_cov_541.348548	86	107	868	1	21	0.0476190
NODE_121693_length_340_cov_541.348548	86	107	881	1	21	0.0476190
NODE_121694_length_340_cov_50.755187	196	266	19	4	70	0.0571429
NODE_121694_length_340_cov_50.755187	196	266	21	6	70	0.0857143
NODE_121694_length_340_cov_50.755187	196	266	25	1	70	0.0142857
NODE_121694_length_340_cov_50.755187	196	266	26	1	70	0.0142857
NODE_121694_length_340_cov_50.755187	196	266	28	1	70	0.0142857
NODE_121694_length_340_cov_50.755187	196	266	29	7	70	0.1000000
NODE_121694_length_340_cov_50.755187	196	266	31	27	70	0.3857143
NODE_121694_length_340_cov_50.755187	196	266	32	6	70	0.0857143
NODE_121694_length_340_cov_50.755187	196	266	33	6	70	0.0857143
NODE_121694_length_340_cov_50.755187	196	266	34	3	70	0.0428571
NODE_121694_length_340_cov_50.755187	196	266	35	8	70	0.1142857
NODE_121696_length_340_cov_8.917012	240	270	0	30	30	1.0000000
NODE_121696_length_340_cov_8.917012	243	315	0	72	72	1.0000000
NODE_121702_length_340_cov_6.439834	175	255	0	80	80	1.0000000
NODE_121702_length_340_cov_6.439834	228	310	0	82	82	1.0000000
NODE_121708_length_340_cov_5.883817	72	121	0	6	49	0.1224490
NODE_121708_length_340_cov_5.883817	72	121	4	1	49	0.0204082
NODE_121708_length_340_cov_5.883817	72	121	6	42	49	0.8571429
NODE_121708_length_340_cov_5.883817	82	113	6	31	31	1.0000000
NODE_121714_length_340_cov_5.228216	116	186	0	70	70	1.0000000
NODE_121714_length_340_cov_5.228216	159	201	0	42	42	1.0000000
NODE_121730_length_340_cov_4.497925	136	184	0	48	48	1.0000000
NODE_121752_length_340_cov_3.759336	88	169	0	81	81	1.0000000
NODE_121849_length_340_cov_2.506224	68	114	2	46	46	1.0000000
NODE_121951_length_340_cov_1.995851	29	101	0	72	72	1.0000000
NODE_121951_length_340_cov_1.995851	96	143	0	47	47	1.0000000
NODE_122154_length_340_cov_1.427386	244	274	2	30	30	1.0000000
NODE_122218_length_340_cov_1.282158	71	135	0	64	64	1.0000000
NODE_122218_length_340_cov_1.282158	128	188	0	12	60	0.2000000
NODE_122218_length_340_cov_1.282158	128	188	2	48	60	0.8000000
NODE_122218_length_340_cov_1.282158	142	189	2	47	47	1.0000000
NODE_122220_length_340_cov_1.278008	51	102	2	13	51	0.2549020
NODE_122220_length_340_cov_1.278008	51	102	4	2	51	0.0392157
NODE_122220_length_340_cov_1.278008	51	102	6	36	51	0.7058824
NODE_122321_length_340_cov_1.199170	98	160	0	39	62	0.6290323
NODE_122321_length_340_cov_1.199170	98	160	2	23	62	0.3709677
NODE_122381_length_340_cov_1.070539	32	65	0	33	33	1.0000000
NODE_122429_length_340_cov_1.020747	209	228	0	19	19	1.0000000
NODE_122686_length_339_cov_87.841667	149	227	124	1	78	0.0128205
NODE_122686_length_339_cov_87.841667	149	227	126	1	78	0.0128205
NODE_122686_length_339_cov_87.841667	149	227	128	3	78	0.0384615
NODE_122686_length_339_cov_87.841667	149	227	130	1	78	0.0128205
NODE_122686_length_339_cov_87.841667	149	227	134	1	78	0.0128205
NODE_122686_length_339_cov_87.841667	149	227	144	2	78	0.0256410
NODE_122686_length_339_cov_87.841667	149	227	145	2	78	0.0256410
NODE_122686_length_339_cov_87.841667	149	227	149	2	78	0.0256410
NODE_122686_length_339_cov_87.841667	149	227	150	2	78	0.0256410
NODE_122686_length_339_cov_87.841667	149	227	152	2	78	0.0256410
NODE_122686_length_339_cov_87.841667	149	227	154	2	78	0.0256410
NODE_122686_length_339_cov_87.841667	149	227	156	1	78	0.0128205
NODE_122686_length_339_cov_87.841667	149	227	159	1	78	0.0128205
NODE_122686_length_339_cov_87.841667	149	227	160	2	78	0.0256410
NODE_122686_length_339_cov_87.841667	149	227	161	1	78	0.0128205
NODE_122686_length_339_cov_87.841667	149	227	162	1	78	0.0128205
NODE_122686_length_339_cov_87.841667	149	227	163	1	78	0.0128205
NODE_122686_length_339_cov_87.841667	149	227	164	6	78	0.0769231
NODE_122686_length_339_cov_87.841667	149	227	165	4	78	0.0512821
NODE_122686_length_339_cov_87.841667	149	227	166	2	78	0.0256410
NODE_122686_length_339_cov_87.841667	149	227	167	5	78	0.0641026
NODE_122686_length_339_cov_87.841667	149	227	168	3	78	0.0384615
NODE_122686_length_339_cov_87.841667	149	227	169	6	78	0.0769231
NODE_122686_length_339_cov_87.841667	149	227	170	5	78	0.0641026
NODE_122686_length_339_cov_87.841667	149	227	172	2	78	0.0256410
NODE_122686_length_339_cov_87.841667	149	227	177	1	78	0.0128205
NODE_122686_length_339_cov_87.841667	149	227	181	1	78	0.0128205
NODE_122686_length_339_cov_87.841667	149	227	190	1	78	0.0128205
NODE_122686_length_339_cov_87.841667	149	227	196	1	78	0.0128205
NODE_122686_length_339_cov_87.841667	149	227	198	1	78	0.0128205
NODE_122686_length_339_cov_87.841667	149	227	203	1	78	0.0128205
NODE_122686_length_339_cov_87.841667	149	227	204	4	78	0.0512821
NODE_122686_length_339_cov_87.841667	149	227	206	2	78	0.0256410
NODE_122686_length_339_cov_87.841667	149	227	211	1	78	0.0128205
NODE_122686_length_339_cov_87.841667	149	227	213	1	78	0.0128205
NODE_122686_length_339_cov_87.841667	149	227	215	3	78	0.0384615
NODE_122686_length_339_cov_87.841667	149	227	216	1	78	0.0128205
NODE_122686_length_339_cov_87.841667	149	227	218	1	78	0.0128205
NODE_122687_length_339_cov_14.304167	69	138	8	10	69	0.1449275
NODE_122687_length_339_cov_14.304167	69	138	10	4	69	0.0579710
NODE_122687_length_339_cov_14.304167	69	138	15	1	69	0.0144928
NODE_122687_length_339_cov_14.304167	69	138	16	24	69	0.3478261
NODE_122687_length_339_cov_14.304167	69	138	20	30	69	0.4347826
NODE_122687_length_339_cov_14.304167	69	138	8	10	69	0.1449275
NODE_122687_length_339_cov_14.304167	69	138	10	4	69	0.0579710
NODE_122687_length_339_cov_14.304167	69	138	15	1	69	0.0144928
NODE_122687_length_339_cov_14.304167	69	138	16	24	69	0.3478261
NODE_122687_length_339_cov_14.304167	69	138	20	30	69	0.4347826
NODE_122687_length_339_cov_14.304167	69	138	8	10	69	0.1449275
NODE_122687_length_339_cov_14.304167	69	138	10	4	69	0.0579710
NODE_122687_length_339_cov_14.304167	69	138	15	1	69	0.0144928
NODE_122687_length_339_cov_14.304167	69	138	16	24	69	0.3478261
NODE_122687_length_339_cov_14.304167	69	138	20	30	69	0.4347826
NODE_122687_length_339_cov_14.304167	88	138	8	10	50	0.2000000
NODE_122687_length_339_cov_14.304167	88	138	10	4	50	0.0800000
NODE_122687_length_339_cov_14.304167	88	138	15	1	50	0.0200000
NODE_122687_length_339_cov_14.304167	88	138	16	24	50	0.4800000
NODE_122687_length_339_cov_14.304167	88	138	20	11	50	0.2200000
NODE_122687_length_339_cov_14.304167	111	160	6	2	49	0.0408163
NODE_122687_length_339_cov_14.304167	111	160	8	30	49	0.6122449
NODE_122687_length_339_cov_14.304167	111	160	10	4	49	0.0816327
NODE_122687_length_339_cov_14.304167	111	160	15	1	49	0.0204082
NODE_122687_length_339_cov_14.304167	111	160	16	12	49	0.2448980
NODE_122727_length_339_cov_4.320833	187	267	2	2	80	0.0250000
NODE_122727_length_339_cov_4.320833	187	267	6	6	80	0.0750000
NODE_122727_length_339_cov_4.320833	187	267	8	11	80	0.1375000
NODE_122727_length_339_cov_4.320833	187	267	10	61	80	0.7625000
NODE_122804_length_339_cov_2.754167	45	125	2	6	80	0.0750000
NODE_122804_length_339_cov_2.754167	45	125	15	15	80	0.1875000
NODE_122804_length_339_cov_2.754167	45	125	16	13	80	0.1625000
NODE_122804_length_339_cov_2.754167	45	125	18	46	80	0.5750000
NODE_122971_length_339_cov_1.841667	265	312	0	47	47	1.0000000
NODE_123041_length_339_cov_1.662500	10	57	4	47	47	1.0000000
NODE_123182_length_339_cov_1.275000	247	312	0	65	65	1.0000000
NODE_123285_length_339_cov_1.070833	147	169	0	22	22	1.0000000
NODE_123633_length_338_cov_57.163180	59	120	0	61	61	1.0000000
NODE_123633_length_338_cov_57.163180	102	176	0	74	74	1.0000000
NODE_123674_length_338_cov_4.263598	113	165	0	52	52	1.0000000
NODE_123679_length_338_cov_4.079498	96	151	0	1	55	0.0181818
NODE_123679_length_338_cov_4.079498	96	151	2	54	55	0.9818182
NODE_123689_length_338_cov_3.841004	122	149	0	27	27	1.0000000
NODE_123793_length_338_cov_2.393305	216	288	2	72	72	1.0000000
NODE_123795_length_338_cov_2.380753	29	93	0	64	64	1.0000000
NODE_123919_length_338_cov_1.878661	146	232	0	54	86	0.6279070
NODE_123919_length_338_cov_1.878661	146	232	4	10	86	0.1162791
NODE_123919_length_338_cov_1.878661	146	232	6	1	86	0.0116279
NODE_123919_length_338_cov_1.878661	146	232	8	5	86	0.0581395
NODE_123919_length_338_cov_1.878661	146	232	10	13	86	0.1511628
NODE_123919_length_338_cov_1.878661	146	232	12	3	86	0.0348837
NODE_123944_length_338_cov_1.740586	79	159	2	18	80	0.2250000
NODE_123944_length_338_cov_1.740586	79	159	4	62	80	0.7750000
NODE_123946_length_338_cov_1.732218	216	257	0	41	41	1.0000000
NODE_124046_length_338_cov_1.493724	14	90	0	76	76	1.0000000
NODE_124247_length_338_cov_1.100418	265	333	0	9	68	0.1323529
NODE_124247_length_338_cov_1.100418	265	333	3	59	68	0.8676471
NODE_124456_length_338_cov_0.849372	281	338	0	57	57	1.0000000
NODE_124533_length_338_cov_0.711297	188	263	0	5	75	0.0666667
NODE_124533_length_338_cov_0.711297	188	263	2	15	75	0.2000000
NODE_124533_length_338_cov_0.711297	188	263	4	55	75	0.7333333
NODE_124625_length_337_cov_468.180672	107	187	46	1	80	0.0125000
NODE_124625_length_337_cov_468.180672	107	187	50	3	80	0.0375000
NODE_124625_length_337_cov_468.180672	107	187	54	7	80	0.0875000
NODE_124625_length_337_cov_468.180672	107	187	57	3	80	0.0375000
NODE_124625_length_337_cov_468.180672	107	187	61	2	80	0.0250000
NODE_124625_length_337_cov_468.180672	107	187	63	18	80	0.2250000
NODE_124625_length_337_cov_468.180672	107	187	65	1	80	0.0125000
NODE_124625_length_337_cov_468.180672	107	187	66	3	80	0.0375000
NODE_124625_length_337_cov_468.180672	107	187	68	15	80	0.1875000
NODE_124625_length_337_cov_468.180672	107	187	70	2	80	0.0250000
NODE_124625_length_337_cov_468.180672	107	187	71	2	80	0.0250000
NODE_124625_length_337_cov_468.180672	107	187	72	4	80	0.0500000
NODE_124625_length_337_cov_468.180672	107	187	74	18	80	0.2250000
NODE_124625_length_337_cov_468.180672	107	187	76	1	80	0.0125000
NODE_124625_length_337_cov_468.180672	160	230	6	9	70	0.1285714
NODE_124625_length_337_cov_468.180672	160	230	8	2	70	0.0285714
NODE_124625_length_337_cov_468.180672	160	230	9	2	70	0.0285714
NODE_124625_length_337_cov_468.180672	160	230	10	3	70	0.0428571
NODE_124625_length_337_cov_468.180672	160	230	12	7	70	0.1000000
NODE_124625_length_337_cov_468.180672	160	230	16	5	70	0.0714286
NODE_124625_length_337_cov_468.180672	160	230	26	2	70	0.0285714
NODE_124625_length_337_cov_468.180672	160	230	28	2	70	0.0285714
NODE_124625_length_337_cov_468.180672	160	230	30	2	70	0.0285714
NODE_124625_length_337_cov_468.180672	160	230	34	1	70	0.0142857
NODE_124625_length_337_cov_468.180672	160	230	40	5	70	0.0714286
NODE_124625_length_337_cov_468.180672	160	230	44	3	70	0.0428571
NODE_124625_length_337_cov_468.180672	160	230	46	1	70	0.0142857
NODE_124625_length_337_cov_468.180672	160	230	50	3	70	0.0428571
NODE_124625_length_337_cov_468.180672	160	230	54	7	70	0.1000000
NODE_124625_length_337_cov_468.180672	160	230	57	3	70	0.0428571
NODE_124625_length_337_cov_468.180672	160	230	61	2	70	0.0285714
NODE_124625_length_337_cov_468.180672	160	230	63	11	70	0.1571429
NODE_124625_length_337_cov_468.180672	226	306	12	9	80	0.1125000
NODE_124625_length_337_cov_468.180672	226	306	14	8	80	0.1000000
NODE_124625_length_337_cov_468.180672	226	306	16	8	80	0.1000000
NODE_124625_length_337_cov_468.180672	226	306	18	55	80	0.6875000
NODE_124625_length_337_cov_468.180672	279	337	4	15	58	0.2586207
NODE_124625_length_337_cov_468.180672	279	337	6	14	58	0.2413793
NODE_124625_length_337_cov_468.180672	279	337	10	2	58	0.0344828
NODE_124625_length_337_cov_468.180672	279	337	12	9	58	0.1551724
NODE_124625_length_337_cov_468.180672	279	337	14	8	58	0.1379310
NODE_124625_length_337_cov_468.180672	279	337	18	10	58	0.1724138
NODE_124626_length_337_cov_91.344538	1	50	4	1	49	0.0204082
NODE_124626_length_337_cov_91.344538	1	50	10	1	49	0.0204082
NODE_124626_length_337_cov_91.344538	1	50	12	2	49	0.0408163
NODE_124626_length_337_cov_91.344538	1	50	17	1	49	0.0204082
NODE_124626_length_337_cov_91.344538	1	50	18	1	49	0.0204082
NODE_124626_length_337_cov_91.344538	1	50	22	1	49	0.0204082
NODE_124626_length_337_cov_91.344538	1	50	24	3	49	0.0612245
NODE_124626_length_337_cov_91.344538	1	50	26	4	49	0.0816327
NODE_124626_length_337_cov_91.344538	1	50	28	4	49	0.0816327
NODE_124626_length_337_cov_91.344538	1	50	30	1	49	0.0204082
NODE_124626_length_337_cov_91.344538	1	50	32	2	49	0.0408163
NODE_124626_length_337_cov_91.344538	1	50	34	3	49	0.0612245
NODE_124626_length_337_cov_91.344538	1	50	38	3	49	0.0612245
NODE_124626_length_337_cov_91.344538	1	50	44	6	49	0.1224490
NODE_124626_length_337_cov_91.344538	1	50	46	2	49	0.0408163
NODE_124626_length_337_cov_91.344538	1	50	57	1	49	0.0204082
NODE_124626_length_337_cov_91.344538	1	50	58	1	49	0.0204082
NODE_124626_length_337_cov_91.344538	1	50	65	3	49	0.0612245
NODE_124626_length_337_cov_91.344538	1	50	71	1	49	0.0204082
NODE_124626_length_337_cov_91.344538	1	50	73	1	49	0.0204082
NODE_124626_length_337_cov_91.344538	1	50	75	1	49	0.0204082
NODE_124626_length_337_cov_91.344538	1	50	85	1	49	0.0204082
NODE_124626_length_337_cov_91.344538	1	50	87	1	49	0.0204082
NODE_124626_length_337_cov_91.344538	1	50	92	1	49	0.0204082
NODE_124626_length_337_cov_91.344538	1	50	94	1	49	0.0204082
NODE_124626_length_337_cov_91.344538	1	50	96	2	49	0.0408163
NODE_124626_length_337_cov_91.344538	23	103	34	2	80	0.0250000
NODE_124626_length_337_cov_91.344538	23	103	38	3	80	0.0375000
NODE_124626_length_337_cov_91.344538	23	103	44	6	80	0.0750000
NODE_124626_length_337_cov_91.344538	23	103	46	2	80	0.0250000
NODE_124626_length_337_cov_91.344538	23	103	57	1	80	0.0125000
NODE_124626_length_337_cov_91.344538	23	103	58	1	80	0.0125000
NODE_124626_length_337_cov_91.344538	23	103	65	3	80	0.0375000
NODE_124626_length_337_cov_91.344538	23	103	71	1	80	0.0125000
NODE_124626_length_337_cov_91.344538	23	103	73	1	80	0.0125000
NODE_124626_length_337_cov_91.344538	23	103	75	1	80	0.0125000
NODE_124626_length_337_cov_91.344538	23	103	85	1	80	0.0125000
NODE_124626_length_337_cov_91.344538	23	103	87	1	80	0.0125000
NODE_124626_length_337_cov_91.344538	23	103	92	1	80	0.0125000
NODE_124626_length_337_cov_91.344538	23	103	94	1	80	0.0125000
NODE_124626_length_337_cov_91.344538	23	103	96	2	80	0.0250000
NODE_124626_length_337_cov_91.344538	23	103	97	1	80	0.0125000
NODE_124626_length_337_cov_91.344538	23	103	107	1	80	0.0125000
NODE_124626_length_337_cov_91.344538	23	103	109	1	80	0.0125000
NODE_124626_length_337_cov_91.344538	23	103	110	2	80	0.0250000
NODE_124626_length_337_cov_91.344538	23	103	114	1	80	0.0125000
NODE_124626_length_337_cov_91.344538	23	103	116	4	80	0.0500000
NODE_124626_length_337_cov_91.344538	23	103	122	1	80	0.0125000
NODE_124626_length_337_cov_91.344538	23	103	126	7	80	0.0875000
NODE_124626_length_337_cov_91.344538	23	103	128	5	80	0.0625000
NODE_124626_length_337_cov_91.344538	23	103	132	1	80	0.0125000
NODE_124626_length_337_cov_91.344538	23	103	134	2	80	0.0250000
NODE_124626_length_337_cov_91.344538	23	103	136	4	80	0.0500000
NODE_124626_length_337_cov_91.344538	23	103	139	1	80	0.0125000
NODE_124626_length_337_cov_91.344538	23	103	141	6	80	0.0750000
NODE_124626_length_337_cov_91.344538	23	103	143	2	80	0.0250000
NODE_124626_length_337_cov_91.344538	23	103	144	2	80	0.0250000
NODE_124626_length_337_cov_91.344538	23	103	145	10	80	0.1250000
NODE_124626_length_337_cov_91.344538	23	103	148	1	80	0.0125000
NODE_124626_length_337_cov_91.344538	23	103	149	1	80	0.0125000
NODE_124627_length_337_cov_73.352941	71	151	0	80	80	1.0000000
NODE_124627_length_337_cov_73.352941	124	204	0	80	80	1.0000000
NODE_124629_length_337_cov_46.978992	220	305	10	2	85	0.0235294
NODE_124629_length_337_cov_46.978992	220	305	18	2	85	0.0235294
NODE_124629_length_337_cov_46.978992	220	305	20	3	85	0.0352941
NODE_124629_length_337_cov_46.978992	220	305	26	12	85	0.1411765
NODE_124629_length_337_cov_46.978992	220	305	28	6	85	0.0705882
NODE_124629_length_337_cov_46.978992	220	305	30	14	85	0.1647059
NODE_124629_length_337_cov_46.978992	220	305	32	46	85	0.5411765
NODE_124629_length_337_cov_46.978992	220	305	10	2	85	0.0235294
NODE_124629_length_337_cov_46.978992	220	305	18	2	85	0.0235294
NODE_124629_length_337_cov_46.978992	220	305	20	3	85	0.0352941
NODE_124629_length_337_cov_46.978992	220	305	26	12	85	0.1411765
NODE_124629_length_337_cov_46.978992	220	305	28	6	85	0.0705882
NODE_124629_length_337_cov_46.978992	220	305	30	14	85	0.1647059
NODE_124629_length_337_cov_46.978992	220	305	32	46	85	0.5411765
NODE_124629_length_337_cov_46.978992	220	305	10	2	85	0.0235294
NODE_124629_length_337_cov_46.978992	220	305	18	2	85	0.0235294
NODE_124629_length_337_cov_46.978992	220	305	20	3	85	0.0352941
NODE_124629_length_337_cov_46.978992	220	305	26	12	85	0.1411765
NODE_124629_length_337_cov_46.978992	220	305	28	6	85	0.0705882
NODE_124629_length_337_cov_46.978992	220	305	30	14	85	0.1647059
NODE_124629_length_337_cov_46.978992	220	305	32	46	85	0.5411765
NODE_124629_length_337_cov_46.978992	278	327	14	1	49	0.0204082
NODE_124629_length_337_cov_46.978992	278	327	16	1	49	0.0204082
NODE_124629_length_337_cov_46.978992	278	327	20	1	49	0.0204082
NODE_124629_length_337_cov_46.978992	278	327	22	1	49	0.0204082
NODE_124629_length_337_cov_46.978992	278	327	23	4	49	0.0816327
NODE_124629_length_337_cov_46.978992	278	327	24	11	49	0.2244898
NODE_124629_length_337_cov_46.978992	278	327	26	15	49	0.3061225
NODE_124629_length_337_cov_46.978992	278	327	28	6	49	0.1224490
NODE_124629_length_337_cov_46.978992	278	327	30	7	49	0.1428571
NODE_124629_length_337_cov_46.978992	278	327	32	2	49	0.0408163
NODE_124629_length_337_cov_46.978992	278	337	7	10	59	0.1694915
NODE_124629_length_337_cov_46.978992	278	337	14	1	59	0.0169492
NODE_124629_length_337_cov_46.978992	278	337	16	1	59	0.0169492
NODE_124629_length_337_cov_46.978992	278	337	20	1	59	0.0169492
NODE_124629_length_337_cov_46.978992	278	337	22	1	59	0.0169492
NODE_124629_length_337_cov_46.978992	278	337	23	4	59	0.0677966
NODE_124629_length_337_cov_46.978992	278	337	24	11	59	0.1864407
NODE_124629_length_337_cov_46.978992	278	337	26	15	59	0.2542373
NODE_124629_length_337_cov_46.978992	278	337	28	6	59	0.1016949
NODE_124629_length_337_cov_46.978992	278	337	30	7	59	0.1186441
NODE_124629_length_337_cov_46.978992	278	337	32	2	59	0.0338983
NODE_124629_length_337_cov_46.978992	283	337	7	10	54	0.1851852
NODE_124629_length_337_cov_46.978992	283	337	14	1	54	0.0185185
NODE_124629_length_337_cov_46.978992	283	337	16	1	54	0.0185185
NODE_124629_length_337_cov_46.978992	283	337	20	1	54	0.0185185
NODE_124629_length_337_cov_46.978992	283	337	22	1	54	0.0185185
NODE_124629_length_337_cov_46.978992	283	337	23	4	54	0.0740741
NODE_124629_length_337_cov_46.978992	283	337	24	11	54	0.2037037
NODE_124629_length_337_cov_46.978992	283	337	26	15	54	0.2777778
NODE_124629_length_337_cov_46.978992	283	337	28	6	54	0.1111111
NODE_124629_length_337_cov_46.978992	283	337	30	4	54	0.0740741
NODE_124640_length_337_cov_6.214286	52	95	2	43	43	1.0000000
NODE_124669_length_337_cov_4.298319	5	58	0	53	53	1.0000000
NODE_124703_length_337_cov_3.478992	179	259	14	2	80	0.0250000
NODE_124703_length_337_cov_3.478992	179	259	18	7	80	0.0875000
NODE_124703_length_337_cov_3.478992	179	259	20	2	80	0.0250000
NODE_124703_length_337_cov_3.478992	179	259	23	1	80	0.0125000
NODE_124703_length_337_cov_3.478992	179	259	24	7	80	0.0875000
NODE_124703_length_337_cov_3.478992	179	259	25	1	80	0.0125000
NODE_124703_length_337_cov_3.478992	179	259	26	25	80	0.3125000
NODE_124703_length_337_cov_3.478992	179	259	27	9	80	0.1125000
NODE_124703_length_337_cov_3.478992	179	259	35	4	80	0.0500000
NODE_124703_length_337_cov_3.478992	179	259	36	4	80	0.0500000
NODE_124703_length_337_cov_3.478992	179	259	37	1	80	0.0125000
NODE_124703_length_337_cov_3.478992	179	259	38	3	80	0.0375000
NODE_124703_length_337_cov_3.478992	179	259	39	14	80	0.1750000
NODE_124703_length_337_cov_3.478992	232	307	2	2	75	0.0266667
NODE_124703_length_337_cov_3.478992	232	307	4	11	75	0.1466667
NODE_124703_length_337_cov_3.478992	232	307	10	11	75	0.1466667
NODE_124703_length_337_cov_3.478992	232	307	12	6	75	0.0800000
NODE_124703_length_337_cov_3.478992	232	307	14	20	75	0.2666667
NODE_124703_length_337_cov_3.478992	232	307	18	7	75	0.0933333
NODE_124703_length_337_cov_3.478992	232	307	20	2	75	0.0266667
NODE_124703_length_337_cov_3.478992	232	307	24	1	75	0.0133333
NODE_124703_length_337_cov_3.478992	232	307	26	15	75	0.2000000
NODE_124759_length_337_cov_2.647059	80	146	0	66	66	1.0000000
NODE_124858_length_337_cov_2.121849	23	103	6	80	80	1.0000000
NODE_124858_length_337_cov_2.121849	76	141	6	65	65	1.0000000
NODE_125001_length_337_cov_1.689076	138	218	0	71	80	0.8875000
NODE_125001_length_337_cov_1.689076	138	218	2	9	80	0.1125000
NODE_125024_length_337_cov_1.592437	109	151	0	41	42	0.9761904
NODE_125024_length_337_cov_1.592437	109	151	2	1	42	0.0238095
NODE_125024_length_337_cov_1.592437	126	204	0	78	78	1.0000000
NODE_125074_length_337_cov_1.466387	266	332	0	66	66	1.0000000
NODE_125271_length_337_cov_1.071429	279	319	2	1	40	0.0250000
NODE_125271_length_337_cov_1.071429	279	319	4	39	40	0.9750000
NODE_125332_length_337_cov_0.978992	227	272	0	45	45	1.0000000
NODE_125633_length_336_cov_7.843882	151	231	0	80	80	1.0000000
NODE_125645_length_336_cov_5.578059	159	220	0	25	61	0.4098361
NODE_125645_length_336_cov_5.578059	159	220	2	36	61	0.5901639
NODE_125645_length_336_cov_5.578059	212	273	2	61	61	1.0000000
NODE_125663_length_336_cov_4.481013	129	207	18	12	78	0.1538462
NODE_125663_length_336_cov_4.481013	129	207	20	11	78	0.1410256
NODE_125663_length_336_cov_4.481013	129	207	22	49	78	0.6282051
NODE_125663_length_336_cov_4.481013	129	207	24	6	78	0.0769231
NODE_125752_length_336_cov_2.755274	83	112	1	3	29	0.1034483
NODE_125752_length_336_cov_2.755274	83	112	2	26	29	0.8965517
NODE_125752_length_336_cov_2.755274	187	268	0	1	81	0.0123457
NODE_125752_length_336_cov_2.755274	187	268	4	14	81	0.1728395
NODE_125752_length_336_cov_2.755274	187	268	6	16	81	0.1975309
NODE_125752_length_336_cov_2.755274	187	268	7	25	81	0.3086420
NODE_125752_length_336_cov_2.755274	187	268	8	25	81	0.3086420
NODE_125806_length_336_cov_2.358650	60	133	0	10	73	0.1369863
NODE_125806_length_336_cov_2.358650	60	133	2	63	73	0.8630137
NODE_125811_length_336_cov_2.337553	93	173	0	80	80	1.0000000
NODE_125965_length_336_cov_1.729958	78	141	0	3	63	0.0476190
NODE_125965_length_336_cov_1.729958	78	141	2	60	63	0.9523810
NODE_125965_length_336_cov_1.729958	131	194	0	56	63	0.8888889
NODE_125965_length_336_cov_1.729958	131	194	2	7	63	0.1111111
NODE_126134_length_336_cov_1.333333	34	114	0	73	80	0.9125000
NODE_126134_length_336_cov_1.333333	34	114	1	7	80	0.0875000
NODE_126134_length_336_cov_1.333333	87	124	0	20	37	0.5405405
NODE_126134_length_336_cov_1.333333	87	124	1	7	37	0.1891892
NODE_126134_length_336_cov_1.333333	87	124	2	4	37	0.1081081
NODE_126134_length_336_cov_1.333333	87	124	4	6	37	0.1621622
NODE_126134_length_336_cov_1.333333	182	213	6	2	31	0.0645161
NODE_126134_length_336_cov_1.333333	182	213	8	29	31	0.9354839
NODE_126216_length_336_cov_1.244726	222	276	0	19	54	0.3518519
NODE_126216_length_336_cov_1.244726	222	276	2	35	54	0.6481481
NODE_126216_length_336_cov_1.244726	288	312	0	24	24	1.0000000
NODE_126260_length_336_cov_1.143460	129	154	0	25	25	1.0000000
NODE_126545_length_336_cov_0.670886	259	288	2	10	29	0.3448276
NODE_126545_length_336_cov_0.670886	259	288	4	19	29	0.6551724
NODE_126606_length_335_cov_16.114407	162	242	0	31	80	0.3875000
NODE_126606_length_335_cov_16.114407	162	242	2	49	80	0.6125000
NODE_126606_length_335_cov_16.114407	215	295	0	6	80	0.0750000
NODE_126606_length_335_cov_16.114407	215	295	2	74	80	0.9250000
NODE_126609_length_335_cov_9.258475	177	250	0	73	73	1.0000000
NODE_126614_length_335_cov_7.207627	29	109	0	38	80	0.4750000
NODE_126614_length_335_cov_7.207627	29	109	2	37	80	0.4625000
NODE_126614_length_335_cov_7.207627	29	109	4	5	80	0.0625000
NODE_126614_length_335_cov_7.207627	82	162	2	23	80	0.2875000
NODE_126614_length_335_cov_7.207627	82	162	4	57	80	0.7125000
NODE_126636_length_335_cov_5.046610	182	263	2	64	81	0.7901235
NODE_126636_length_335_cov_5.046610	182	263	4	17	81	0.2098765
NODE_126639_length_335_cov_4.995763	144	215	0	71	71	1.0000000
NODE_126665_length_335_cov_3.923729	163	231	0	10	68	0.1470588
NODE_126665_length_335_cov_3.923729	163	231	2	58	68	0.8529412
NODE_126787_length_335_cov_2.411017	230	294	0	57	64	0.8906250
NODE_126787_length_335_cov_2.411017	230	294	5	7	64	0.1093750
NODE_126791_length_335_cov_2.402542	164	240	0	15	76	0.1973684
NODE_126791_length_335_cov_2.402542	164	240	2	1	76	0.0131579
NODE_126791_length_335_cov_2.402542	164	240	6	15	76	0.1973684
NODE_126791_length_335_cov_2.402542	164	240	8	1	76	0.0131579
NODE_126791_length_335_cov_2.402542	164	240	12	2	76	0.0263158
NODE_126791_length_335_cov_2.402542	164	240	16	6	76	0.0789474
NODE_126791_length_335_cov_2.402542	164	240	23	8	76	0.1052632
NODE_126791_length_335_cov_2.402542	164	240	25	2	76	0.0263158
NODE_126791_length_335_cov_2.402542	164	240	27	5	76	0.0657895
NODE_126791_length_335_cov_2.402542	164	240	29	9	76	0.1184211
NODE_126791_length_335_cov_2.402542	164	240	31	1	76	0.0131579
NODE_126791_length_335_cov_2.402542	164	240	32	9	76	0.1184211
NODE_126791_length_335_cov_2.402542	164	240	34	2	76	0.0263158
NODE_126792_length_335_cov_2.398305	116	179	2	22	63	0.3492064
NODE_126792_length_335_cov_2.398305	116	179	4	41	63	0.6507937
NODE_126826_length_335_cov_2.161017	82	141	0	59	59	1.0000000
NODE_126835_length_335_cov_2.152542	61	134	0	2	73	0.0273973
NODE_126835_length_335_cov_2.152542	61	134	2	71	73	0.9726027
NODE_126835_length_335_cov_2.152542	114	134	0	2	20	0.1000000
NODE_126835_length_335_cov_2.152542	114	134	2	18	20	0.9000000
NODE_126920_length_335_cov_1.766949	257	330	4	1	73	0.0136986
NODE_126920_length_335_cov_1.766949	257	330	6	3	73	0.0410959
NODE_126920_length_335_cov_1.766949	257	330	8	6	73	0.0821918
NODE_126920_length_335_cov_1.766949	257	330	10	63	73	0.8630137
NODE_126920_length_335_cov_1.766949	297	335	0	1	38	0.0263158
NODE_126920_length_335_cov_1.766949	297	335	2	4	38	0.1052632
NODE_126920_length_335_cov_1.766949	297	335	4	1	38	0.0263158
NODE_126920_length_335_cov_1.766949	297	335	6	3	38	0.0789474
NODE_126920_length_335_cov_1.766949	297	335	8	6	38	0.1578947
NODE_126920_length_335_cov_1.766949	297	335	10	23	38	0.6052632
NODE_127022_length_335_cov_1.529661	255	320	0	31	65	0.4769231
NODE_127022_length_335_cov_1.529661	255	320	2	8	65	0.1230769
NODE_127022_length_335_cov_1.529661	255	320	4	26	65	0.4000000
NODE_127023_length_335_cov_1.525424	222	266	0	39	44	0.8863636
NODE_127023_length_335_cov_1.525424	222	266	2	5	44	0.1136364
NODE_127062_length_335_cov_1.457627	38	87	0	24	49	0.4897959
NODE_127062_length_335_cov_1.457627	38	87	1	13	49	0.2653061
NODE_127062_length_335_cov_1.457627	38	87	3	1	49	0.0204082
NODE_127062_length_335_cov_1.457627	38	87	4	11	49	0.2244898
NODE_127130_length_335_cov_1.296610	291	311	0	20	20	1.0000000
NODE_127130_length_335_cov_1.296610	291	311	0	20	20	1.0000000
NODE_127143_length_335_cov_1.292373	202	232	3	18	30	0.6000000
NODE_127143_length_335_cov_1.292373	202	232	5	8	30	0.2666667
NODE_127143_length_335_cov_1.292373	202	232	7	1	30	0.0333333
NODE_127143_length_335_cov_1.292373	202	232	8	3	30	0.1000000
NODE_127200_length_335_cov_1.194915	75	156	22	3	81	0.0370370
NODE_127200_length_335_cov_1.194915	75	156	24	21	81	0.2592593
NODE_127200_length_335_cov_1.194915	75	156	25	18	81	0.2222222
NODE_127200_length_335_cov_1.194915	75	156	26	39	81	0.4814815
NODE_127200_length_335_cov_1.194915	129	195	9	10	66	0.1515152
NODE_127200_length_335_cov_1.194915	129	195	10	5	66	0.0757576
NODE_127200_length_335_cov_1.194915	129	195	11	1	66	0.0151515
NODE_127200_length_335_cov_1.194915	129	195	13	1	66	0.0151515
NODE_127200_length_335_cov_1.194915	129	195	14	10	66	0.1515152
NODE_127200_length_335_cov_1.194915	129	195	20	1	66	0.0151515
NODE_127200_length_335_cov_1.194915	129	195	21	4	66	0.0606061
NODE_127200_length_335_cov_1.194915	129	195	22	7	66	0.1060606
NODE_127200_length_335_cov_1.194915	129	195	23	3	66	0.0454545
NODE_127200_length_335_cov_1.194915	129	195	25	8	66	0.1212121
NODE_127200_length_335_cov_1.194915	129	195	26	16	66	0.2424242
NODE_127310_length_335_cov_0.983051	96	117	0	21	21	1.0000000
NODE_127585_length_334_cov_275.425532	135	215	322	1	80	0.0125000
NODE_127585_length_334_cov_275.425532	135	215	326	1	80	0.0125000
NODE_127585_length_334_cov_275.425532	135	215	330	1	80	0.0125000
NODE_127585_length_334_cov_275.425532	135	215	336	2	80	0.0250000
NODE_127585_length_334_cov_275.425532	135	215	342	2	80	0.0250000
NODE_127585_length_334_cov_275.425532	135	215	344	1	80	0.0125000
NODE_127585_length_334_cov_275.425532	135	215	350	1	80	0.0125000
NODE_127585_length_334_cov_275.425532	135	215	354	1	80	0.0125000
NODE_127585_length_334_cov_275.425532	135	215	364	1	80	0.0125000
NODE_127585_length_334_cov_275.425532	135	215	372	1	80	0.0125000
NODE_127585_length_334_cov_275.425532	135	215	375	1	80	0.0125000
NODE_127585_length_334_cov_275.425532	135	215	381	1	80	0.0125000
NODE_127585_length_334_cov_275.425532	135	215	390	1	80	0.0125000
NODE_127585_length_334_cov_275.425532	135	215	392	1	80	0.0125000
NODE_127585_length_334_cov_275.425532	135	215	397	1	80	0.0125000
NODE_127585_length_334_cov_275.425532	135	215	400	1	80	0.0125000
NODE_127585_length_334_cov_275.425532	135	215	401	1	80	0.0125000
NODE_127585_length_334_cov_275.425532	135	215	403	1	80	0.0125000
NODE_127585_length_334_cov_275.425532	135	215	404	1	80	0.0125000
NODE_127585_length_334_cov_275.425532	135	215	406	2	80	0.0250000
NODE_127585_length_334_cov_275.425532	135	215	408	2	80	0.0250000
NODE_127585_length_334_cov_275.425532	135	215	409	1	80	0.0125000
NODE_127585_length_334_cov_275.425532	135	215	411	1	80	0.0125000
NODE_127585_length_334_cov_275.425532	135	215	418	1	80	0.0125000
NODE_127585_length_334_cov_275.425532	135	215	420	1	80	0.0125000
NODE_127585_length_334_cov_275.425532	135	215	432	1	80	0.0125000
NODE_127585_length_334_cov_275.425532	135	215	433	1	80	0.0125000
NODE_127585_length_334_cov_275.425532	135	215	436	1	80	0.0125000
NODE_127585_length_334_cov_275.425532	135	215	438	1	80	0.0125000
NODE_127585_length_334_cov_275.425532	135	215	439	1	80	0.0125000
NODE_127585_length_334_cov_275.425532	135	215	448	1	80	0.0125000
NODE_127585_length_334_cov_275.425532	135	215	453	1	80	0.0125000
NODE_127585_length_334_cov_275.425532	135	215	457	1	80	0.0125000
NODE_127585_length_334_cov_275.425532	135	215	458	1	80	0.0125000
NODE_127585_length_334_cov_275.425532	135	215	460	1	80	0.0125000
NODE_127585_length_334_cov_275.425532	135	215	464	1	80	0.0125000
NODE_127585_length_334_cov_275.425532	135	215	465	2	80	0.0250000
NODE_127585_length_334_cov_275.425532	135	215	473	3	80	0.0375000
NODE_127585_length_334_cov_275.425532	135	215	474	2	80	0.0250000
NODE_127585_length_334_cov_275.425532	135	215	475	2	80	0.0250000
NODE_127585_length_334_cov_275.425532	135	215	476	1	80	0.0125000
NODE_127585_length_334_cov_275.425532	135	215	480	1	80	0.0125000
NODE_127585_length_334_cov_275.425532	135	215	483	1	80	0.0125000
NODE_127585_length_334_cov_275.425532	135	215	488	1	80	0.0125000
NODE_127585_length_334_cov_275.425532	135	215	492	1	80	0.0125000
NODE_127585_length_334_cov_275.425532	135	215	493	2	80	0.0250000
NODE_127585_length_334_cov_275.425532	135	215	494	1	80	0.0125000
NODE_127585_length_334_cov_275.425532	135	215	495	3	80	0.0375000
NODE_127585_length_334_cov_275.425532	135	215	502	1	80	0.0125000
NODE_127585_length_334_cov_275.425532	135	215	504	1	80	0.0125000
NODE_127585_length_334_cov_275.425532	135	215	505	3	80	0.0375000
NODE_127585_length_334_cov_275.425532	135	215	506	2	80	0.0250000
NODE_127585_length_334_cov_275.425532	135	215	507	5	80	0.0625000
NODE_127585_length_334_cov_275.425532	135	215	508	1	80	0.0125000
NODE_127585_length_334_cov_275.425532	135	215	509	1	80	0.0125000
NODE_127585_length_334_cov_275.425532	135	215	510	2	80	0.0250000
NODE_127585_length_334_cov_275.425532	135	215	512	1	80	0.0125000
NODE_127585_length_334_cov_275.425532	135	215	515	1	80	0.0125000
NODE_127585_length_334_cov_275.425532	135	215	516	1	80	0.0125000
NODE_127585_length_334_cov_275.425532	135	215	519	1	80	0.0125000
NODE_127585_length_334_cov_275.425532	188	269	153	1	81	0.0123457
NODE_127585_length_334_cov_275.425532	188	269	154	3	81	0.0370370
NODE_127585_length_334_cov_275.425532	188	269	155	1	81	0.0123457
NODE_127585_length_334_cov_275.425532	188	269	156	2	81	0.0246914
NODE_127585_length_334_cov_275.425532	188	269	158	11	81	0.1358025
NODE_127585_length_334_cov_275.425532	188	269	159	6	81	0.0740741
NODE_127585_length_334_cov_275.425532	188	269	161	1	81	0.0123457
NODE_127585_length_334_cov_275.425532	188	269	163	3	81	0.0370370
NODE_127585_length_334_cov_275.425532	188	269	170	1	81	0.0123457
NODE_127585_length_334_cov_275.425532	188	269	172	1	81	0.0123457
NODE_127585_length_334_cov_275.425532	188	269	185	1	81	0.0123457
NODE_127585_length_334_cov_275.425532	188	269	189	1	81	0.0123457
NODE_127585_length_334_cov_275.425532	188	269	191	1	81	0.0123457
NODE_127585_length_334_cov_275.425532	188	269	195	1	81	0.0123457
NODE_127585_length_334_cov_275.425532	188	269	202	1	81	0.0123457
NODE_127585_length_334_cov_275.425532	188	269	210	1	81	0.0123457
NODE_127585_length_334_cov_275.425532	188	269	214	1	81	0.0123457
NODE_127585_length_334_cov_275.425532	188	269	215	1	81	0.0123457
NODE_127585_length_334_cov_275.425532	188	269	217	1	81	0.0123457
NODE_127585_length_334_cov_275.425532	188	269	225	1	81	0.0123457
NODE_127585_length_334_cov_275.425532	188	269	229	1	81	0.0123457
NODE_127585_length_334_cov_275.425532	188	269	239	1	81	0.0123457
NODE_127585_length_334_cov_275.425532	188	269	259	2	81	0.0246914
NODE_127585_length_334_cov_275.425532	188	269	267	1	81	0.0123457
NODE_127585_length_334_cov_275.425532	188	269	271	1	81	0.0123457
NODE_127585_length_334_cov_275.425532	188	269	282	1	81	0.0123457
NODE_127585_length_334_cov_275.425532	188	269	292	1	81	0.0123457
NODE_127585_length_334_cov_275.425532	188	269	296	1	81	0.0123457
NODE_127585_length_334_cov_275.425532	188	269	297	1	81	0.0123457
NODE_127585_length_334_cov_275.425532	188	269	306	1	81	0.0123457
NODE_127585_length_334_cov_275.425532	188	269	307	1	81	0.0123457
NODE_127585_length_334_cov_275.425532	188	269	312	1	81	0.0123457
NODE_127585_length_334_cov_275.425532	188	269	322	1	81	0.0123457
NODE_127585_length_334_cov_275.425532	188	269	324	1	81	0.0123457
NODE_127585_length_334_cov_275.425532	188	269	326	1	81	0.0123457
NODE_127585_length_334_cov_275.425532	188	269	330	1	81	0.0123457
NODE_127585_length_334_cov_275.425532	188	269	336	2	81	0.0246914
NODE_127585_length_334_cov_275.425532	188	269	342	2	81	0.0246914
NODE_127585_length_334_cov_275.425532	188	269	344	1	81	0.0123457
NODE_127585_length_334_cov_275.425532	188	269	350	1	81	0.0123457
NODE_127585_length_334_cov_275.425532	188	269	354	1	81	0.0123457
NODE_127585_length_334_cov_275.425532	188	269	364	1	81	0.0123457
NODE_127585_length_334_cov_275.425532	188	269	372	1	81	0.0123457
NODE_127585_length_334_cov_275.425532	188	269	375	1	81	0.0123457
NODE_127585_length_334_cov_275.425532	188	269	381	1	81	0.0123457
NODE_127585_length_334_cov_275.425532	188	269	390	1	81	0.0123457
NODE_127585_length_334_cov_275.425532	188	269	392	1	81	0.0123457
NODE_127585_length_334_cov_275.425532	188	269	397	1	81	0.0123457
NODE_127585_length_334_cov_275.425532	188	269	400	1	81	0.0123457
NODE_127585_length_334_cov_275.425532	188	269	401	1	81	0.0123457
NODE_127585_length_334_cov_275.425532	188	269	403	1	81	0.0123457
NODE_127585_length_334_cov_275.425532	188	269	404	1	81	0.0123457
NODE_127585_length_334_cov_275.425532	188	269	406	2	81	0.0246914
NODE_127585_length_334_cov_275.425532	188	269	408	2	81	0.0246914
NODE_127585_length_334_cov_275.425532	188	269	409	1	81	0.0123457
NODE_127585_length_334_cov_275.425532	188	269	411	1	81	0.0123457
NODE_127586_length_334_cov_14.753191	135	215	0	6	80	0.0750000
NODE_127586_length_334_cov_14.753191	135	215	2	74	80	0.9250000
NODE_127586_length_334_cov_14.753191	188	268	0	57	80	0.7125000
NODE_127586_length_334_cov_14.753191	188	268	2	23	80	0.2875000
NODE_127610_length_334_cov_4.829787	92	174	0	82	82	1.0000000
NODE_127610_length_334_cov_4.829787	151	237	0	86	86	1.0000000
NODE_127612_length_334_cov_4.817021	179	231	0	10	52	0.1923077
NODE_127612_length_334_cov_4.817021	179	231	2	42	52	0.8076923
NODE_127626_length_334_cov_4.438298	121	201	2	7	80	0.0875000
NODE_127626_length_334_cov_4.438298	121	201	4	64	80	0.8000000
NODE_127626_length_334_cov_4.438298	121	201	6	9	80	0.1125000
NODE_127672_length_334_cov_3.604255	248	314	4	66	66	1.0000000
NODE_127672_length_334_cov_3.604255	287	334	4	47	47	1.0000000
NODE_127844_length_334_cov_2.165957	0	48	0	48	48	1.0000000
NODE_128026_length_334_cov_1.595745	253	328	0	75	75	1.0000000
NODE_128258_length_334_cov_1.157447	146	177	0	31	31	1.0000000
NODE_128665_length_333_cov_5.423077	172	242	0	70	70	1.0000000
NODE_128673_length_333_cov_4.867521	122	172	10	30	50	0.6000000
NODE_128673_length_333_cov_4.867521	122	172	12	20	50	0.4000000
NODE_128673_length_333_cov_4.867521	175	255	0	50	80	0.6250000
NODE_128673_length_333_cov_4.867521	175	255	2	1	80	0.0125000
NODE_128673_length_333_cov_4.867521	175	255	8	17	80	0.2125000
NODE_128673_length_333_cov_4.867521	175	255	10	12	80	0.1500000
NODE_128673_length_333_cov_4.867521	194	219	0	14	25	0.5600000
NODE_128673_length_333_cov_4.867521	194	219	2	1	25	0.0400000
NODE_128673_length_333_cov_4.867521	194	219	8	10	25	0.4000000
NODE_128717_length_333_cov_3.717949	49	129	0	31	80	0.3875000
NODE_128717_length_333_cov_3.717949	49	129	2	37	80	0.4625000
NODE_128717_length_333_cov_3.717949	49	129	4	5	80	0.0625000
NODE_128717_length_333_cov_3.717949	49	129	5	7	80	0.0875000
NODE_128717_length_333_cov_3.717949	102	182	2	15	80	0.1875000
NODE_128717_length_333_cov_3.717949	102	182	4	5	80	0.0625000
NODE_128717_length_333_cov_3.717949	102	182	5	18	80	0.2250000
NODE_128717_length_333_cov_3.717949	102	182	6	19	80	0.2375000
NODE_128717_length_333_cov_3.717949	102	182	7	2	80	0.0250000
NODE_128717_length_333_cov_3.717949	102	182	8	21	80	0.2625000
NODE_128767_length_333_cov_2.897436	59	139	5	12	80	0.1500000
NODE_128767_length_333_cov_2.897436	59	139	6	3	80	0.0375000
NODE_128767_length_333_cov_2.897436	59	139	8	7	80	0.0875000
NODE_128767_length_333_cov_2.897436	59	139	10	6	80	0.0750000
NODE_128767_length_333_cov_2.897436	59	139	12	7	80	0.0875000
NODE_128767_length_333_cov_2.897436	59	139	13	2	80	0.0250000
NODE_128767_length_333_cov_2.897436	59	139	17	2	80	0.0250000
NODE_128767_length_333_cov_2.897436	59	139	19	1	80	0.0125000
NODE_128767_length_333_cov_2.897436	59	139	21	5	80	0.0625000
NODE_128767_length_333_cov_2.897436	59	139	22	4	80	0.0500000
NODE_128767_length_333_cov_2.897436	59	139	24	9	80	0.1125000
NODE_128767_length_333_cov_2.897436	59	139	26	4	80	0.0500000
NODE_128767_length_333_cov_2.897436	59	139	28	16	80	0.2000000
NODE_128767_length_333_cov_2.897436	59	139	30	2	80	0.0250000
NODE_128850_length_333_cov_2.307692	68	148	0	80	80	1.0000000
NODE_128933_length_333_cov_1.940171	135	215	5	5	80	0.0625000
NODE_128933_length_333_cov_1.940171	135	215	6	4	80	0.0500000
NODE_128933_length_333_cov_1.940171	135	215	7	71	80	0.8875000
NODE_129252_length_333_cov_1.200855	0	80	0	80	80	1.0000000
NODE_129263_length_333_cov_1.170940	146	193	2	9	47	0.1914894
NODE_129263_length_333_cov_1.170940	146	193	10	14	47	0.2978723
NODE_129263_length_333_cov_1.170940	146	193	12	24	47	0.5106383
NODE_129263_length_333_cov_1.170940	203	243	8	13	40	0.3250000
NODE_129263_length_333_cov_1.170940	203	243	10	8	40	0.2000000
NODE_129263_length_333_cov_1.170940	203	243	12	19	40	0.4750000
NODE_129303_length_333_cov_1.089744	241	306	0	28	65	0.4307692
NODE_129303_length_333_cov_1.089744	241	306	4	37	65	0.5692308
NODE_129310_length_333_cov_1.089744	206	226	0	20	20	1.0000000
NODE_129665_length_332_cov_5.386266	101	167	0	66	66	1.0000000
NODE_129680_length_332_cov_4.768240	221	250	2	29	29	1.0000000
NODE_129695_length_332_cov_4.343348	130	179	0	49	49	1.0000000
NODE_129698_length_332_cov_4.201717	191	237	0	46	46	1.0000000
NODE_129698_length_332_cov_4.201717	211	290	0	79	79	1.0000000
NODE_129879_length_332_cov_2.274678	187	227	8	4	40	0.1000000
NODE_129879_length_332_cov_2.274678	187	227	10	6	40	0.1500000
NODE_129879_length_332_cov_2.274678	187	227	14	2	40	0.0500000
NODE_129879_length_332_cov_2.274678	187	227	16	1	40	0.0250000
NODE_129879_length_332_cov_2.274678	187	227	18	1	40	0.0250000
NODE_129879_length_332_cov_2.274678	187	227	20	1	40	0.0250000
NODE_129879_length_332_cov_2.274678	187	227	22	6	40	0.1500000
NODE_129879_length_332_cov_2.274678	187	227	26	1	40	0.0250000
NODE_129879_length_332_cov_2.274678	187	227	30	1	40	0.0250000
NODE_129879_length_332_cov_2.274678	187	227	32	2	40	0.0500000
NODE_129879_length_332_cov_2.274678	187	227	34	1	40	0.0250000
NODE_129879_length_332_cov_2.274678	187	227	39	1	40	0.0250000
NODE_129879_length_332_cov_2.274678	187	227	41	2	40	0.0500000
NODE_129879_length_332_cov_2.274678	187	227	43	2	40	0.0500000
NODE_129879_length_332_cov_2.274678	187	227	45	2	40	0.0500000
NODE_129879_length_332_cov_2.274678	187	227	47	2	40	0.0500000
NODE_129879_length_332_cov_2.274678	187	227	51	1	40	0.0250000
NODE_129879_length_332_cov_2.274678	187	227	53	2	40	0.0500000
NODE_129879_length_332_cov_2.274678	187	227	61	2	40	0.0500000
NODE_129901_length_332_cov_2.184549	194	258	0	11	64	0.1718750
NODE_129901_length_332_cov_2.184549	194	258	2	32	64	0.5000000
NODE_129901_length_332_cov_2.184549	194	258	4	21	64	0.3281250
NODE_130053_length_332_cov_1.682403	241	316	4	75	75	1.0000000
NODE_130055_length_332_cov_1.673820	157	220	0	53	63	0.8412699
NODE_130055_length_332_cov_1.673820	157	220	2	10	63	0.1587302
NODE_130183_length_332_cov_1.364807	132	212	0	1	80	0.0125000
NODE_130183_length_332_cov_1.364807	132	212	4	36	80	0.4500000
NODE_130183_length_332_cov_1.364807	132	212	5	5	80	0.0625000
NODE_130183_length_332_cov_1.364807	132	212	9	6	80	0.0750000
NODE_130183_length_332_cov_1.364807	132	212	10	20	80	0.2500000
NODE_130183_length_332_cov_1.364807	132	212	12	12	80	0.1500000
NODE_130187_length_332_cov_1.356223	276	332	2	56	56	1.0000000
NODE_130312_length_332_cov_1.210300	120	176	0	15	56	0.2678571
NODE_130312_length_332_cov_1.210300	120	176	2	41	56	0.7321429
NODE_130757_length_331_cov_5.254310	141	221	0	80	80	1.0000000
NODE_130757_length_331_cov_5.254310	194	274	0	80	80	1.0000000
NODE_130781_length_331_cov_4.323276	26	108	0	8	82	0.0975610
NODE_130781_length_331_cov_4.323276	26	108	1	7	82	0.0853659
NODE_130781_length_331_cov_4.323276	26	108	2	23	82	0.2804878
NODE_130781_length_331_cov_4.323276	26	108	4	44	82	0.5365854
NODE_130902_length_331_cov_2.603448	128	181	0	53	53	1.0000000
NODE_131036_length_331_cov_1.965517	183	216	0	33	33	1.0000000
NODE_131054_length_331_cov_1.896552	266	331	0	29	65	0.4461538
NODE_131054_length_331_cov_1.896552	266	331	2	36	65	0.5538462
NODE_131817_length_330_cov_14.731602	209	280	2	13	71	0.1830986
NODE_131817_length_330_cov_14.731602	209	280	4	58	71	0.8169014
NODE_131840_length_330_cov_4.935065	16	97	4	14	81	0.1728395
NODE_131840_length_330_cov_4.935065	16	97	6	67	81	0.8271605
NODE_131840_length_330_cov_4.935065	81	149	0	25	68	0.3676471
NODE_131840_length_330_cov_4.935065	81	149	2	11	68	0.1617647
NODE_131840_length_330_cov_4.935065	81	149	4	29	68	0.4264706
NODE_131840_length_330_cov_4.935065	81	149	6	3	68	0.0441176
NODE_131841_length_330_cov_4.891775	177	255	0	78	78	1.0000000
NODE_131845_length_330_cov_4.740260	134	209	0	75	75	1.0000000
NODE_131892_length_330_cov_3.467532	161	225	2	4	64	0.0625000
NODE_131892_length_330_cov_3.467532	161	225	4	24	64	0.3750000
NODE_131892_length_330_cov_3.467532	161	225	6	36	64	0.5625000
NODE_131969_length_330_cov_2.601732	8	88	0	80	80	1.0000000
NODE_132188_length_330_cov_1.623377	154	200	0	46	46	1.0000000
NODE_132238_length_330_cov_1.541126	98	156	2	58	58	1.0000000
NODE_132268_length_330_cov_1.467532	234	287	0	53	53	1.0000000
NODE_132268_length_330_cov_1.467532	242	283	0	41	41	1.0000000
NODE_132306_length_330_cov_1.346320	230	296	0	66	66	1.0000000
NODE_132306_length_330_cov_1.346320	230	257	0	27	27	1.0000000
NODE_132410_length_330_cov_1.220779	249	272	0	23	23	1.0000000
NODE_132478_length_330_cov_1.103896	189	227	0	19	38	0.5000000
NODE_132478_length_330_cov_1.103896	189	227	2	19	38	0.5000000
NODE_132542_length_330_cov_1.038961	219	297	12	4	78	0.0512821
NODE_132542_length_330_cov_1.038961	219	297	22	5	78	0.0641026
NODE_132542_length_330_cov_1.038961	219	297	27	2	78	0.0256410
NODE_132542_length_330_cov_1.038961	219	297	34	4	78	0.0512821
NODE_132542_length_330_cov_1.038961	219	297	36	3	78	0.0384615
NODE_132542_length_330_cov_1.038961	219	297	40	2	78	0.0256410
NODE_132542_length_330_cov_1.038961	219	297	42	1	78	0.0128205
NODE_132542_length_330_cov_1.038961	219	297	44	4	78	0.0512821
NODE_132542_length_330_cov_1.038961	219	297	45	7	78	0.0897436
NODE_132542_length_330_cov_1.038961	219	297	47	6	78	0.0769231
NODE_132542_length_330_cov_1.038961	219	297	49	4	78	0.0512821
NODE_132542_length_330_cov_1.038961	219	297	55	2	78	0.0256410
NODE_132542_length_330_cov_1.038961	219	297	69	1	78	0.0128205
NODE_132542_length_330_cov_1.038961	219	297	77	3	78	0.0384615
NODE_132542_length_330_cov_1.038961	219	297	81	2	78	0.0256410
NODE_132542_length_330_cov_1.038961	219	297	83	1	78	0.0128205
NODE_132542_length_330_cov_1.038961	219	297	86	1	78	0.0128205
NODE_132542_length_330_cov_1.038961	219	297	89	1	78	0.0128205
NODE_132542_length_330_cov_1.038961	219	297	95	1	78	0.0128205
NODE_132542_length_330_cov_1.038961	219	297	99	1	78	0.0128205
NODE_132542_length_330_cov_1.038961	219	297	102	1	78	0.0128205
NODE_132542_length_330_cov_1.038961	219	297	104	5	78	0.0641026
NODE_132542_length_330_cov_1.038961	219	297	107	1	78	0.0128205
NODE_132542_length_330_cov_1.038961	219	297	113	2	78	0.0256410
NODE_132542_length_330_cov_1.038961	219	297	119	3	78	0.0384615
NODE_132542_length_330_cov_1.038961	219	297	127	2	78	0.0256410
NODE_132542_length_330_cov_1.038961	219	297	129	1	78	0.0128205
NODE_132542_length_330_cov_1.038961	219	297	130	1	78	0.0128205
NODE_132542_length_330_cov_1.038961	219	297	134	3	78	0.0384615
NODE_132542_length_330_cov_1.038961	219	297	135	1	78	0.0128205
NODE_132542_length_330_cov_1.038961	219	297	137	1	78	0.0128205
NODE_132542_length_330_cov_1.038961	219	297	140	2	78	0.0256410
NODE_132688_length_330_cov_0.883117	284	330	0	46	46	1.0000000
NODE_132873_length_329_cov_110.178261	138	167	14	2	29	0.0689655
NODE_132873_length_329_cov_110.178261	138	167	16	27	29	0.9310345
NODE_132873_length_329_cov_110.178261	189	269	10	8	80	0.1000000
NODE_132873_length_329_cov_110.178261	189	269	12	17	80	0.2125000
NODE_132873_length_329_cov_110.178261	189	269	14	11	80	0.1375000
NODE_132873_length_329_cov_110.178261	189	269	17	1	80	0.0125000
NODE_132873_length_329_cov_110.178261	189	269	18	39	80	0.4875000
NODE_132873_length_329_cov_110.178261	189	269	20	4	80	0.0500000
NODE_132873_length_329_cov_110.178261	242	322	0	3	80	0.0375000
NODE_132873_length_329_cov_110.178261	242	322	4	2	80	0.0250000
NODE_132873_length_329_cov_110.178261	242	322	6	24	80	0.3000000
NODE_132873_length_329_cov_110.178261	242	322	8	24	80	0.3000000
NODE_132873_length_329_cov_110.178261	242	322	10	8	80	0.1000000
NODE_132873_length_329_cov_110.178261	242	322	12	13	80	0.1625000
NODE_132873_length_329_cov_110.178261	242	322	14	5	80	0.0625000
NODE_132873_length_329_cov_110.178261	242	322	18	1	80	0.0125000
NODE_132879_length_329_cov_8.882609	61	141	0	80	80	1.0000000
NODE_132879_length_329_cov_8.882609	114	194	0	80	80	1.0000000
NODE_132885_length_329_cov_6.586957	166	207	8	41	41	1.0000000
NODE_132908_length_329_cov_4.617391	175	229	0	54	54	1.0000000
NODE_132970_length_329_cov_3.160870	59	139	0	19	80	0.2375000
NODE_132970_length_329_cov_3.160870	59	139	2	61	80	0.7625000
NODE_133003_length_329_cov_2.821739	164	209	0	41	45	0.9111111
NODE_133003_length_329_cov_2.821739	164	209	2	4	45	0.0888889
NODE_133003_length_329_cov_2.821739	184	262	0	78	78	1.0000000
NODE_133033_length_329_cov_2.560870	139	201	0	62	62	1.0000000
NODE_133036_length_329_cov_2.543478	145	206	10	5	61	0.0819672
NODE_133036_length_329_cov_2.543478	145	206	12	7	61	0.1147541
NODE_133036_length_329_cov_2.543478	145	206	14	49	61	0.8032787
NODE_133123_length_329_cov_2.143478	39	119	2	39	80	0.4875000
NODE_133123_length_329_cov_2.143478	39	119	4	22	80	0.2750000
NODE_133123_length_329_cov_2.143478	39	119	6	19	80	0.2375000
NODE_133123_length_329_cov_2.143478	92	158	4	8	66	0.1212121
NODE_133123_length_329_cov_2.143478	92	158	6	30	66	0.4545455
NODE_133123_length_329_cov_2.143478	92	158	7	8	66	0.1212121
NODE_133123_length_329_cov_2.143478	92	158	8	20	66	0.3030303
NODE_133184_length_329_cov_1.865217	182	252	2	47	70	0.6714286
NODE_133184_length_329_cov_1.865217	182	252	4	23	70	0.3285714
NODE_133200_length_329_cov_1.791304	50	84	0	34	34	1.0000000
NODE_133200_length_329_cov_1.791304	92	149	0	19	57	0.3333333
NODE_133200_length_329_cov_1.791304	92	149	2	4	57	0.0701754
NODE_133200_length_329_cov_1.791304	92	149	4	34	57	0.5964912
NODE_133200_length_329_cov_1.791304	145	203	4	28	58	0.4827586
NODE_133200_length_329_cov_1.791304	145	203	6	30	58	0.5172414
NODE_133332_length_329_cov_1.508696	261	323	0	62	62	1.0000000
NODE_133348_length_329_cov_1.469565	168	237	0	69	69	1.0000000
NODE_133376_length_329_cov_1.391304	275	307	10	32	32	1.0000000
NODE_133547_length_329_cov_1.165217	199	242	0	43	43	1.0000000
NODE_133768_length_329_cov_0.878261	221	296	0	19	75	0.2533333
NODE_133768_length_329_cov_0.878261	221	296	2	56	75	0.7466667
NODE_133970_length_328_cov_4.484716	95	175	2	6	80	0.0750000
NODE_133970_length_328_cov_4.484716	95	175	4	74	80	0.9250000
NODE_133989_length_328_cov_4.087336	79	159	10	7	80	0.0875000
NODE_133989_length_328_cov_4.087336	79	159	12	4	80	0.0500000
NODE_133989_length_328_cov_4.087336	79	159	14	29	80	0.3625000
NODE_133989_length_328_cov_4.087336	79	159	16	40	80	0.5000000
NODE_133989_length_328_cov_4.087336	132	207	2	25	75	0.3333333
NODE_133989_length_328_cov_4.087336	132	207	3	3	75	0.0400000
NODE_133989_length_328_cov_4.087336	132	207	5	1	75	0.0133333
NODE_133989_length_328_cov_4.087336	132	207	6	5	75	0.0666667
NODE_133989_length_328_cov_4.087336	132	207	8	13	75	0.1733333
NODE_133989_length_328_cov_4.087336	132	207	10	3	75	0.0400000
NODE_133989_length_328_cov_4.087336	132	207	12	3	75	0.0400000
NODE_133989_length_328_cov_4.087336	132	207	14	22	75	0.2933333
NODE_133993_length_328_cov_3.895197	110	190	4	5	80	0.0625000
NODE_133993_length_328_cov_3.895197	110	190	14	3	80	0.0375000
NODE_133993_length_328_cov_3.895197	110	190	16	72	80	0.9000000
NODE_134019_length_328_cov_3.393013	30	78	4	48	48	1.0000000
NODE_134144_length_328_cov_2.161572	103	134	4	1	31	0.0322581
NODE_134144_length_328_cov_2.161572	103	134	6	24	31	0.7741935
NODE_134144_length_328_cov_2.161572	103	134	8	6	31	0.1935484
NODE_134247_length_328_cov_1.781659	16	44	0	28	28	1.0000000
NODE_134335_length_328_cov_1.567686	0	76	0	2	76	0.0263158
NODE_134335_length_328_cov_1.567686	0	76	2	1	76	0.0131579
NODE_134335_length_328_cov_1.567686	0	76	3	9	76	0.1184211
NODE_134335_length_328_cov_1.567686	0	76	4	64	76	0.8421053
NODE_134335_length_328_cov_1.567686	49	94	4	45	45	1.0000000
NODE_134452_length_328_cov_1.336245	0	73	0	73	73	1.0000000
NODE_134508_length_328_cov_1.266376	78	158	8	64	80	0.8000000
NODE_134508_length_328_cov_1.266376	78	158	10	16	80	0.2000000
NODE_135002_length_327_cov_4.934211	170	250	0	80	80	1.0000000
NODE_135009_length_327_cov_4.701754	225	305	2	28	80	0.3500000
NODE_135009_length_327_cov_4.701754	225	305	4	27	80	0.3375000
NODE_135009_length_327_cov_4.701754	225	305	6	25	80	0.3125000
NODE_135018_length_327_cov_4.241228	97	173	2	13	76	0.1710526
NODE_135018_length_327_cov_4.241228	97	173	4	22	76	0.2894737
NODE_135018_length_327_cov_4.241228	97	173	6	41	76	0.5394737
NODE_135037_length_327_cov_3.719298	70	150	0	80	80	1.0000000
NODE_135063_length_327_cov_3.350877	156	227	0	49	71	0.6901408
NODE_135063_length_327_cov_3.350877	156	227	2	22	71	0.3098592
NODE_135328_length_327_cov_1.780702	191	271	4	8	80	0.1000000
NODE_135328_length_327_cov_1.780702	191	271	6	8	80	0.1000000
NODE_135328_length_327_cov_1.780702	191	271	8	2	80	0.0250000
NODE_135328_length_327_cov_1.780702	191	271	10	19	80	0.2375000
NODE_135328_length_327_cov_1.780702	191	271	11	3	80	0.0375000
NODE_135328_length_327_cov_1.780702	191	271	12	5	80	0.0625000
NODE_135328_length_327_cov_1.780702	191	271	14	35	80	0.4375000
NODE_136081_length_326_cov_3.964758	178	228	0	50	50	1.0000000
NODE_136100_length_326_cov_3.502203	211	253	0	42	42	1.0000000
NODE_136100_length_326_cov_3.502203	220	255	0	35	35	1.0000000
NODE_136116_length_326_cov_3.202643	149	203	0	54	54	1.0000000
NODE_136130_length_326_cov_3.057269	107	126	0	19	19	1.0000000
NODE_136176_length_326_cov_2.594714	125	196	0	71	71	1.0000000
NODE_136283_length_326_cov_2.123348	184	244	0	60	60	1.0000000
NODE_136496_length_326_cov_1.515419	86	166	0	80	80	1.0000000
NODE_137182_length_325_cov_4.893805	142	222	30	4	80	0.0500000
NODE_137182_length_325_cov_4.893805	142	222	32	11	80	0.1375000
NODE_137182_length_325_cov_4.893805	142	222	34	46	80	0.5750000
NODE_137182_length_325_cov_4.893805	142	222	36	19	80	0.2375000
NODE_137182_length_325_cov_4.893805	195	275	12	2	80	0.0250000
NODE_137182_length_325_cov_4.893805	195	275	13	8	80	0.1000000
NODE_137182_length_325_cov_4.893805	195	275	17	6	80	0.0750000
NODE_137182_length_325_cov_4.893805	195	275	19	13	80	0.1625000
NODE_137182_length_325_cov_4.893805	195	275	21	7	80	0.0875000
NODE_137182_length_325_cov_4.893805	195	275	26	1	80	0.0125000
NODE_137182_length_325_cov_4.893805	195	275	28	4	80	0.0500000
NODE_137182_length_325_cov_4.893805	195	275	30	3	80	0.0375000
NODE_137182_length_325_cov_4.893805	195	275	32	12	80	0.1500000
NODE_137182_length_325_cov_4.893805	195	275	34	19	80	0.2375000
NODE_137182_length_325_cov_4.893805	195	275	36	5	80	0.0625000
NODE_137199_length_325_cov_4.000000	134	198	0	64	64	1.0000000
NODE_137221_length_325_cov_3.513274	191	266	32	13	75	0.1733333
NODE_137221_length_325_cov_3.513274	191	266	33	10	75	0.1333333
NODE_137221_length_325_cov_3.513274	191	266	34	10	75	0.1333333
NODE_137221_length_325_cov_3.513274	191	266	35	1	75	0.0133333
NODE_137221_length_325_cov_3.513274	191	266	36	13	75	0.1733333
NODE_137221_length_325_cov_3.513274	191	266	37	11	75	0.1466667
NODE_137221_length_325_cov_3.513274	191	266	38	4	75	0.0533333
NODE_137221_length_325_cov_3.513274	191	266	40	13	75	0.1733333
NODE_137221_length_325_cov_3.513274	240	319	4	5	79	0.0632911
NODE_137221_length_325_cov_3.513274	240	319	6	4	79	0.0506329
NODE_137221_length_325_cov_3.513274	240	319	8	2	79	0.0253165
NODE_137221_length_325_cov_3.513274	240	319	10	8	79	0.1012658
NODE_137221_length_325_cov_3.513274	240	319	12	1	79	0.0126582
NODE_137221_length_325_cov_3.513274	240	319	14	3	79	0.0379747
NODE_137221_length_325_cov_3.513274	240	319	15	2	79	0.0253165
NODE_137221_length_325_cov_3.513274	240	319	17	9	79	0.1139240
NODE_137221_length_325_cov_3.513274	240	319	19	2	79	0.0253165
NODE_137221_length_325_cov_3.513274	240	319	23	1	79	0.0126582
NODE_137221_length_325_cov_3.513274	240	319	25	4	79	0.0506329
NODE_137221_length_325_cov_3.513274	240	319	26	1	79	0.0126582
NODE_137221_length_325_cov_3.513274	240	319	28	4	79	0.0506329
NODE_137221_length_325_cov_3.513274	240	319	30	1	79	0.0126582
NODE_137221_length_325_cov_3.513274	240	319	32	10	79	0.1265823
NODE_137221_length_325_cov_3.513274	240	319	34	9	79	0.1139240
NODE_137221_length_325_cov_3.513274	240	319	35	1	79	0.0126582
NODE_137221_length_325_cov_3.513274	240	319	36	1	79	0.0126582
NODE_137221_length_325_cov_3.513274	240	319	37	11	79	0.1392405
NODE_137223_length_325_cov_3.469027	216	278	0	62	62	1.0000000
NODE_137224_length_325_cov_3.429204	178	224	0	46	46	1.0000000
NODE_137243_length_325_cov_3.168142	188	274	1	81	86	0.9418604
NODE_137243_length_325_cov_3.168142	188	274	2	5	86	0.0581395
NODE_137268_length_325_cov_2.880531	72	152	6	4	80	0.0500000
NODE_137268_length_325_cov_2.880531	72	152	8	5	80	0.0625000
NODE_137268_length_325_cov_2.880531	72	152	10	22	80	0.2750000
NODE_137268_length_325_cov_2.880531	72	152	12	7	80	0.0875000
NODE_137268_length_325_cov_2.880531	72	152	14	9	80	0.1125000
NODE_137268_length_325_cov_2.880531	72	152	16	33	80	0.4125000
NODE_137268_length_325_cov_2.880531	125	205	16	57	80	0.7125000
NODE_137268_length_325_cov_2.880531	125	205	18	8	80	0.1000000
NODE_137268_length_325_cov_2.880531	125	205	20	8	80	0.1000000
NODE_137268_length_325_cov_2.880531	125	205	21	1	80	0.0125000
NODE_137268_length_325_cov_2.880531	125	205	22	5	80	0.0625000
NODE_137268_length_325_cov_2.880531	125	205	24	1	80	0.0125000
NODE_137291_length_325_cov_2.707965	203	261	0	45	58	0.7758621
NODE_137291_length_325_cov_2.707965	203	261	1	13	58	0.2241379
NODE_137296_length_325_cov_2.703540	68	148	8	9	80	0.1125000
NODE_137296_length_325_cov_2.703540	68	148	10	25	80	0.3125000
NODE_137296_length_325_cov_2.703540	68	148	12	8	80	0.1000000
NODE_137296_length_325_cov_2.703540	68	148	14	38	80	0.4750000
NODE_137330_length_325_cov_2.500000	0	42	0	42	42	1.0000000
NODE_137407_length_325_cov_2.048673	122	202	26	5	80	0.0625000
NODE_137407_length_325_cov_2.048673	122	202	28	2	80	0.0250000
NODE_137407_length_325_cov_2.048673	122	202	30	2	80	0.0250000
NODE_137407_length_325_cov_2.048673	122	202	32	1	80	0.0125000
NODE_137407_length_325_cov_2.048673	122	202	33	1	80	0.0125000
NODE_137407_length_325_cov_2.048673	122	202	34	3	80	0.0375000
NODE_137407_length_325_cov_2.048673	122	202	35	2	80	0.0250000
NODE_137407_length_325_cov_2.048673	122	202	36	42	80	0.5250000
NODE_137407_length_325_cov_2.048673	122	202	37	1	80	0.0125000
NODE_137407_length_325_cov_2.048673	122	202	38	17	80	0.2125000
NODE_137407_length_325_cov_2.048673	122	202	40	4	80	0.0500000
NODE_137409_length_325_cov_2.035398	83	154	0	51	71	0.7183099
NODE_137409_length_325_cov_2.035398	83	154	2	20	71	0.2816902
NODE_137642_length_325_cov_1.464602	153	224	0	71	71	1.0000000
NODE_137939_length_325_cov_1.017699	103	134	4	31	31	1.0000000
NODE_138113_length_325_cov_0.827434	258	308	1	48	50	0.9600000
NODE_138113_length_325_cov_0.827434	258	308	3	2	50	0.0400000
NODE_138309_length_324_cov_4.737778	113	160	0	47	47	1.0000000
NODE_138309_length_324_cov_4.737778	142	213	0	71	71	1.0000000
NODE_138358_length_324_cov_3.626667	218	273	0	16	55	0.2909091
NODE_138358_length_324_cov_3.626667	218	273	2	1	55	0.0181818
NODE_138358_length_324_cov_3.626667	218	273	4	38	55	0.6909091
NODE_138396_length_324_cov_3.124444	101	181	2	38	80	0.4750000
NODE_138396_length_324_cov_3.124444	101	181	4	22	80	0.2750000
NODE_138396_length_324_cov_3.124444	101	181	5	6	80	0.0750000
NODE_138396_length_324_cov_3.124444	101	181	6	14	80	0.1750000
NODE_138396_length_324_cov_3.124444	256	285	2	29	29	1.0000000
NODE_138416_length_324_cov_2.924444	114	198	0	76	84	0.9047619
NODE_138416_length_324_cov_2.924444	114	198	2	4	84	0.0476190
NODE_138416_length_324_cov_2.924444	114	198	6	4	84	0.0476190
NODE_138416_length_324_cov_2.924444	178	237	0	12	59	0.2033898
NODE_138416_length_324_cov_2.924444	178	237	2	4	59	0.0677966
NODE_138416_length_324_cov_2.924444	178	237	6	12	59	0.2033898
NODE_138416_length_324_cov_2.924444	178	237	8	3	59	0.0508475
NODE_138416_length_324_cov_2.924444	178	237	10	22	59	0.3728814
NODE_138416_length_324_cov_2.924444	178	237	12	4	59	0.0677966
NODE_138416_length_324_cov_2.924444	178	237	14	2	59	0.0338983
NODE_138418_length_324_cov_2.915556	141	221	0	8	80	0.1000000
NODE_138418_length_324_cov_2.915556	141	221	2	72	80	0.9000000
NODE_138434_length_324_cov_2.715556	4	51	2	47	47	1.0000000
NODE_138434_length_324_cov_2.715556	24	104	2	80	80	1.0000000
NODE_138463_length_324_cov_2.506667	270	306	0	33	36	0.9166667
NODE_138463_length_324_cov_2.506667	270	306	2	3	36	0.0833333
NODE_138483_length_324_cov_2.448889	187	238	0	31	51	0.6078432
NODE_138483_length_324_cov_2.448889	187	238	2	8	51	0.1568628
NODE_138483_length_324_cov_2.448889	187	238	4	1	51	0.0196078
NODE_138483_length_324_cov_2.448889	187	238	6	11	51	0.2156863
NODE_138527_length_324_cov_2.248889	30	96	0	66	66	1.0000000
NODE_138778_length_324_cov_1.502222	10	90	2	55	80	0.6875000
NODE_138778_length_324_cov_1.502222	10	90	4	25	80	0.3125000
NODE_138792_length_324_cov_1.457778	0	45	0	45	45	1.0000000
NODE_138792_length_324_cov_1.457778	18	75	0	49	57	0.8596491
NODE_138792_length_324_cov_1.457778	18	75	2	1	57	0.0175439
NODE_138792_length_324_cov_1.457778	18	75	13	2	57	0.0350877
NODE_138792_length_324_cov_1.457778	18	75	14	2	57	0.0350877
NODE_138792_length_324_cov_1.457778	18	75	16	3	57	0.0526316
NODE_138808_length_324_cov_1.382222	263	304	0	41	41	1.0000000
NODE_139129_length_324_cov_1.017778	0	59	0	59	59	1.0000000
NODE_139497_length_323_cov_6.669643	215	286	0	47	71	0.6619718
NODE_139497_length_323_cov_6.669643	215	286	2	24	71	0.3380282
NODE_139497_length_323_cov_6.669643	268	315	0	47	47	1.0000000
NODE_139511_length_323_cov_5.089286	224	290	0	66	66	1.0000000
NODE_139511_length_323_cov_5.089286	263	319	0	56	56	1.0000000
NODE_139572_length_323_cov_3.276786	189	269	0	34	80	0.4250000
NODE_139572_length_323_cov_3.276786	189	269	1	6	80	0.0750000
NODE_139572_length_323_cov_3.276786	189	269	6	1	80	0.0125000
NODE_139572_length_323_cov_3.276786	189	269	7	12	80	0.1500000
NODE_139572_length_323_cov_3.276786	189	269	10	7	80	0.0875000
NODE_139572_length_323_cov_3.276786	189	269	11	16	80	0.2000000
NODE_139572_length_323_cov_3.276786	189	269	15	3	80	0.0375000
NODE_139572_length_323_cov_3.276786	189	269	19	1	80	0.0125000
NODE_139575_length_323_cov_3.263393	101	181	8	22	80	0.2750000
NODE_139575_length_323_cov_3.263393	101	181	10	18	80	0.2250000
NODE_139575_length_323_cov_3.263393	101	181	16	40	80	0.5000000
NODE_139591_length_323_cov_3.089286	128	208	0	80	80	1.0000000
NODE_139591_length_323_cov_3.089286	166	208	0	42	42	1.0000000
NODE_139591_length_323_cov_3.089286	181	261	0	80	80	1.0000000
NODE_139591_length_323_cov_3.089286	181	261	0	80	80	1.0000000
NODE_139629_length_323_cov_2.683036	144	215	8	71	71	1.0000000
NODE_139746_length_323_cov_2.089286	64	144	0	80	80	1.0000000
NODE_139797_length_323_cov_1.888393	148	207	2	59	59	1.0000000
NODE_139901_length_323_cov_1.705357	195	262	0	67	67	1.0000000
NODE_139901_length_323_cov_1.705357	235	315	0	80	80	1.0000000
NODE_140651_length_322_cov_5.475336	56	136	0	70	80	0.8750000
NODE_140651_length_322_cov_5.475336	56	136	2	10	80	0.1250000
NODE_140651_length_322_cov_5.475336	113	189	0	13	76	0.1710526
NODE_140651_length_322_cov_5.475336	113	189	2	63	76	0.8289474
NODE_140692_length_322_cov_3.753363	63	133	0	70	70	1.0000000
NODE_140692_length_322_cov_3.753363	116	190	0	74	74	1.0000000
NODE_140693_length_322_cov_3.735426	60	86	0	26	26	1.0000000
NODE_140693_length_322_cov_3.735426	99	139	0	40	40	1.0000000
NODE_140701_length_322_cov_3.605381	73	116	18	2	43	0.0465116
NODE_140701_length_322_cov_3.605381	73	116	19	7	43	0.1627907
NODE_140701_length_322_cov_3.605381	73	116	20	22	43	0.5116279
NODE_140701_length_322_cov_3.605381	73	116	22	12	43	0.2790698
NODE_140702_length_322_cov_3.600897	75	145	2	20	70	0.2857143
NODE_140702_length_322_cov_3.600897	75	145	4	23	70	0.3285714
NODE_140702_length_322_cov_3.600897	75	145	6	27	70	0.3857143
NODE_140820_length_322_cov_2.304933	182	213	0	31	31	1.0000000
NODE_141738_length_321_cov_8.527027	176	240	12	18	64	0.2812500
NODE_141738_length_321_cov_8.527027	176	240	14	46	64	0.7187500
NODE_141786_length_321_cov_4.094595	196	266	0	70	70	1.0000000
NODE_141811_length_321_cov_3.563063	59	131	3	4	72	0.0555556
NODE_141811_length_321_cov_3.563063	59	131	5	5	72	0.0694444
NODE_141811_length_321_cov_3.563063	59	131	9	1	72	0.0138889
NODE_141811_length_321_cov_3.563063	59	131	10	62	72	0.8611111
NODE_141811_length_321_cov_3.563063	112	183	2	33	71	0.4647887
NODE_141811_length_321_cov_3.563063	112	183	3	8	71	0.1126761
NODE_141811_length_321_cov_3.563063	112	183	4	15	71	0.2112676
NODE_141811_length_321_cov_3.563063	112	183	5	5	71	0.0704225
NODE_141811_length_321_cov_3.563063	112	183	9	1	71	0.0140845
NODE_141811_length_321_cov_3.563063	112	183	10	9	71	0.1267606
NODE_141813_length_321_cov_3.540541	112	141	2	29	29	1.0000000
NODE_141833_length_321_cov_3.049550	65	115	28	5	50	0.1000000
NODE_141833_length_321_cov_3.049550	65	115	30	14	50	0.2800000
NODE_141833_length_321_cov_3.049550	65	115	32	1	50	0.0200000
NODE_141833_length_321_cov_3.049550	65	115	34	2	50	0.0400000
NODE_141833_length_321_cov_3.049550	65	115	38	1	50	0.0200000
NODE_141833_length_321_cov_3.049550	65	115	40	6	50	0.1200000
NODE_141833_length_321_cov_3.049550	65	115	42	21	50	0.4200000
NODE_141833_length_321_cov_3.049550	95	138	40	10	43	0.2325581
NODE_141833_length_321_cov_3.049550	95	138	42	33	43	0.7674419
NODE_141833_length_321_cov_3.049550	118	168	4	1	50	0.0200000
NODE_141833_length_321_cov_3.049550	118	168	8	1	50	0.0200000
NODE_141833_length_321_cov_3.049550	118	168	12	1	50	0.0200000
NODE_141833_length_321_cov_3.049550	118	168	16	2	50	0.0400000
NODE_141833_length_321_cov_3.049550	118	168	22	2	50	0.0400000
NODE_141833_length_321_cov_3.049550	118	168	25	1	50	0.0200000
NODE_141833_length_321_cov_3.049550	118	168	26	2	50	0.0400000
NODE_141833_length_321_cov_3.049550	118	168	28	6	50	0.1200000
NODE_141833_length_321_cov_3.049550	118	168	36	9	50	0.1800000
NODE_141833_length_321_cov_3.049550	118	168	38	1	50	0.0200000
NODE_141833_length_321_cov_3.049550	118	168	40	14	50	0.2800000
NODE_141833_length_321_cov_3.049550	118	168	42	10	50	0.2000000
NODE_141837_length_321_cov_2.995495	146	220	0	37	74	0.5000000
NODE_141837_length_321_cov_2.995495	146	220	2	37	74	0.5000000
NODE_141842_length_321_cov_2.981982	251	304	0	53	53	1.0000000
NODE_141876_length_321_cov_2.734234	239	306	0	67	67	1.0000000
NODE_141910_length_321_cov_2.427928	221	265	0	44	44	1.0000000
NODE_141922_length_321_cov_2.315315	22	65	0	43	43	1.0000000
NODE_141951_length_321_cov_2.270270	43	105	0	14	62	0.2258064
NODE_141951_length_321_cov_2.270270	43	105	4	48	62	0.7741935
NODE_141951_length_321_cov_2.270270	120	203	1	64	83	0.7710843
NODE_141951_length_321_cov_2.270270	120	203	5	19	83	0.2289157
NODE_141951_length_321_cov_2.270270	127	208	1	69	81	0.8518519
NODE_141951_length_321_cov_2.270270	127	208	5	12	81	0.1481481
NODE_142200_length_321_cov_1.576577	241	321	0	80	80	1.0000000
NODE_142363_length_321_cov_1.319820	253	304	0	51	51	1.0000000
NODE_142484_length_321_cov_1.130631	0	43	0	43	43	1.0000000
NODE_142700_length_321_cov_0.869369	248	294	0	46	46	1.0000000
NODE_142885_length_320_cov_200.484163	264	320	16	1	56	0.0178571
NODE_142885_length_320_cov_200.484163	264	320	17	5	56	0.0892857
NODE_142885_length_320_cov_200.484163	264	320	18	2	56	0.0357143
NODE_142885_length_320_cov_200.484163	264	320	22	2	56	0.0357143
NODE_142885_length_320_cov_200.484163	264	320	24	2	56	0.0357143
NODE_142885_length_320_cov_200.484163	264	320	28	1	56	0.0178571
NODE_142885_length_320_cov_200.484163	264	320	29	1	56	0.0178571
NODE_142885_length_320_cov_200.484163	264	320	33	1	56	0.0178571
NODE_142885_length_320_cov_200.484163	264	320	35	2	56	0.0357143
NODE_142885_length_320_cov_200.484163	264	320	39	1	56	0.0178571
NODE_142885_length_320_cov_200.484163	264	320	43	4	56	0.0714286
NODE_142885_length_320_cov_200.484163	264	320	49	3	56	0.0535714
NODE_142885_length_320_cov_200.484163	264	320	51	1	56	0.0178571
NODE_142885_length_320_cov_200.484163	264	320	53	1	56	0.0178571
NODE_142885_length_320_cov_200.484163	264	320	55	6	56	0.1071429
NODE_142885_length_320_cov_200.484163	264	320	57	2	56	0.0357143
NODE_142885_length_320_cov_200.484163	264	320	63	6	56	0.1071429
NODE_142885_length_320_cov_200.484163	264	320	65	12	56	0.2142857
NODE_142885_length_320_cov_200.484163	264	320	67	3	56	0.0535714
NODE_142886_length_320_cov_73.357466	51	97	0	46	46	1.0000000
NODE_142886_length_320_cov_73.357466	108	154	0	46	46	1.0000000
NODE_142886_length_320_cov_73.357466	165	245	0	33	80	0.4125000
NODE_142886_length_320_cov_73.357466	165	245	6	47	80	0.5875000
NODE_142886_length_320_cov_73.357466	218	296	6	78	78	1.0000000
NODE_142887_length_320_cov_35.787330	212	292	20	8	80	0.1000000
NODE_142887_length_320_cov_35.787330	212	292	27	8	80	0.1000000
NODE_142887_length_320_cov_35.787330	212	292	36	1	80	0.0125000
NODE_142887_length_320_cov_35.787330	212	292	39	35	80	0.4375000
NODE_142887_length_320_cov_35.787330	212	292	40	4	80	0.0500000
NODE_142887_length_320_cov_35.787330	212	292	41	3	80	0.0375000
NODE_142887_length_320_cov_35.787330	212	292	44	21	80	0.2625000
NODE_142887_length_320_cov_35.787330	212	292	20	8	80	0.1000000
NODE_142887_length_320_cov_35.787330	212	292	27	8	80	0.1000000
NODE_142887_length_320_cov_35.787330	212	292	36	1	80	0.0125000
NODE_142887_length_320_cov_35.787330	212	292	39	35	80	0.4375000
NODE_142887_length_320_cov_35.787330	212	292	40	4	80	0.0500000
NODE_142887_length_320_cov_35.787330	212	292	41	3	80	0.0375000
NODE_142887_length_320_cov_35.787330	212	292	44	21	80	0.2625000
NODE_142887_length_320_cov_35.787330	212	292	20	8	80	0.1000000
NODE_142887_length_320_cov_35.787330	212	292	27	8	80	0.1000000
NODE_142887_length_320_cov_35.787330	212	292	36	1	80	0.0125000
NODE_142887_length_320_cov_35.787330	212	292	39	35	80	0.4375000
NODE_142887_length_320_cov_35.787330	212	292	40	4	80	0.0500000
NODE_142887_length_320_cov_35.787330	212	292	41	3	80	0.0375000
NODE_142887_length_320_cov_35.787330	212	292	44	21	80	0.2625000
NODE_142887_length_320_cov_35.787330	212	292	20	8	80	0.1000000
NODE_142887_length_320_cov_35.787330	212	292	27	8	80	0.1000000
NODE_142887_length_320_cov_35.787330	212	292	36	1	80	0.0125000
NODE_142887_length_320_cov_35.787330	212	292	39	35	80	0.4375000
NODE_142887_length_320_cov_35.787330	212	292	40	4	80	0.0500000
NODE_142887_length_320_cov_35.787330	212	292	41	3	80	0.0375000
NODE_142887_length_320_cov_35.787330	212	292	44	21	80	0.2625000
NODE_142887_length_320_cov_35.787330	212	292	20	8	80	0.1000000
NODE_142887_length_320_cov_35.787330	212	292	27	8	80	0.1000000
NODE_142887_length_320_cov_35.787330	212	292	36	1	80	0.0125000
NODE_142887_length_320_cov_35.787330	212	292	39	35	80	0.4375000
NODE_142887_length_320_cov_35.787330	212	292	40	4	80	0.0500000
NODE_142887_length_320_cov_35.787330	212	292	41	3	80	0.0375000
NODE_142887_length_320_cov_35.787330	212	292	44	21	80	0.2625000
NODE_142887_length_320_cov_35.787330	265	314	4	1	49	0.0204082
NODE_142887_length_320_cov_35.787330	265	314	6	15	49	0.3061225
NODE_142887_length_320_cov_35.787330	265	314	8	3	49	0.0612245
NODE_142887_length_320_cov_35.787330	265	314	16	2	49	0.0408163
NODE_142887_length_320_cov_35.787330	265	314	20	9	49	0.1836735
NODE_142887_length_320_cov_35.787330	265	314	27	8	49	0.1632653
NODE_142887_length_320_cov_35.787330	265	314	36	1	49	0.0204082
NODE_142887_length_320_cov_35.787330	265	314	39	10	49	0.2040816
NODE_142887_length_320_cov_35.787330	265	320	0	6	55	0.1090909
NODE_142887_length_320_cov_35.787330	265	320	4	1	55	0.0181818
NODE_142887_length_320_cov_35.787330	265	320	6	15	55	0.2727273
NODE_142887_length_320_cov_35.787330	265	320	8	3	55	0.0545455
NODE_142887_length_320_cov_35.787330	265	320	16	2	55	0.0363636
NODE_142887_length_320_cov_35.787330	265	320	20	9	55	0.1636364
NODE_142887_length_320_cov_35.787330	265	320	27	8	55	0.1454545
NODE_142887_length_320_cov_35.787330	265	320	36	1	55	0.0181818
NODE_142887_length_320_cov_35.787330	265	320	39	10	55	0.1818182
NODE_142887_length_320_cov_35.787330	265	320	0	6	55	0.1090909
NODE_142887_length_320_cov_35.787330	265	320	4	1	55	0.0181818
NODE_142887_length_320_cov_35.787330	265	320	6	15	55	0.2727273
NODE_142887_length_320_cov_35.787330	265	320	8	3	55	0.0545455
NODE_142887_length_320_cov_35.787330	265	320	16	2	55	0.0363636
NODE_142887_length_320_cov_35.787330	265	320	20	9	55	0.1636364
NODE_142887_length_320_cov_35.787330	265	320	27	8	55	0.1454545
NODE_142887_length_320_cov_35.787330	265	320	36	1	55	0.0181818
NODE_142887_length_320_cov_35.787330	265	320	39	10	55	0.1818182
NODE_142887_length_320_cov_35.787330	268	320	0	6	52	0.1153846
NODE_142887_length_320_cov_35.787330	268	320	4	1	52	0.0192308
NODE_142887_length_320_cov_35.787330	268	320	6	15	52	0.2884615
NODE_142887_length_320_cov_35.787330	268	320	8	3	52	0.0576923
NODE_142887_length_320_cov_35.787330	268	320	16	2	52	0.0384615
NODE_142887_length_320_cov_35.787330	268	320	20	9	52	0.1730769
NODE_142887_length_320_cov_35.787330	268	320	27	8	52	0.1538462
NODE_142887_length_320_cov_35.787330	268	320	36	1	52	0.0192308
NODE_142887_length_320_cov_35.787330	268	320	39	7	52	0.1346154
NODE_142887_length_320_cov_35.787330	270	320	0	6	50	0.1200000
NODE_142887_length_320_cov_35.787330	270	320	4	1	50	0.0200000
NODE_142887_length_320_cov_35.787330	270	320	6	15	50	0.3000000
NODE_142887_length_320_cov_35.787330	270	320	8	3	50	0.0600000
NODE_142887_length_320_cov_35.787330	270	320	16	2	50	0.0400000
NODE_142887_length_320_cov_35.787330	270	320	20	9	50	0.1800000
NODE_142887_length_320_cov_35.787330	270	320	27	8	50	0.1600000
NODE_142887_length_320_cov_35.787330	270	320	36	1	50	0.0200000
NODE_142887_length_320_cov_35.787330	270	320	39	5	50	0.1000000
NODE_142900_length_320_cov_5.841629	115	172	0	57	57	1.0000000
NODE_142900_length_320_cov_5.841629	168	225	0	57	57	1.0000000
NODE_142934_length_320_cov_4.153846	134	200	0	66	66	1.0000000
NODE_142958_length_320_cov_3.733032	5	40	0	26	35	0.7428572
NODE_142958_length_320_cov_3.733032	5	40	2	9	35	0.2571429
NODE_142985_length_320_cov_3.402715	142	222	0	15	80	0.1875000
NODE_142985_length_320_cov_3.402715	142	222	2	1	80	0.0125000
NODE_142985_length_320_cov_3.402715	142	222	10	1	80	0.0125000
NODE_142985_length_320_cov_3.402715	142	222	12	63	80	0.7875000
NODE_143076_length_320_cov_2.475113	120	187	0	3	67	0.0447761
NODE_143076_length_320_cov_2.475113	120	187	1	1	67	0.0149254
NODE_143076_length_320_cov_2.475113	120	187	3	15	67	0.2238806
NODE_143076_length_320_cov_2.475113	120	187	4	11	67	0.1641791
NODE_143076_length_320_cov_2.475113	120	187	6	1	67	0.0149254
NODE_143076_length_320_cov_2.475113	120	187	8	1	67	0.0149254
NODE_143076_length_320_cov_2.475113	120	187	9	3	67	0.0447761
NODE_143076_length_320_cov_2.475113	120	187	11	1	67	0.0149254
NODE_143076_length_320_cov_2.475113	120	187	14	4	67	0.0597015
NODE_143076_length_320_cov_2.475113	120	187	16	2	67	0.0298507
NODE_143076_length_320_cov_2.475113	120	187	20	3	67	0.0447761
NODE_143076_length_320_cov_2.475113	120	187	24	3	67	0.0447761
NODE_143076_length_320_cov_2.475113	120	187	26	3	67	0.0447761
NODE_143076_length_320_cov_2.475113	120	187	30	6	67	0.0895522
NODE_143076_length_320_cov_2.475113	120	187	38	2	67	0.0298507
NODE_143076_length_320_cov_2.475113	120	187	40	1	67	0.0149254
NODE_143076_length_320_cov_2.475113	120	187	44	1	67	0.0149254
NODE_143076_length_320_cov_2.475113	120	187	46	4	67	0.0597015
NODE_143076_length_320_cov_2.475113	120	187	50	1	67	0.0149254
NODE_143076_length_320_cov_2.475113	120	187	52	1	67	0.0149254
NODE_143142_length_320_cov_2.171946	16	96	0	7	80	0.0875000
NODE_143142_length_320_cov_2.171946	16	96	4	1	80	0.0125000
NODE_143142_length_320_cov_2.171946	16	96	5	6	80	0.0750000
NODE_143142_length_320_cov_2.171946	16	96	7	9	80	0.1125000
NODE_143142_length_320_cov_2.171946	16	96	9	17	80	0.2125000
NODE_143142_length_320_cov_2.171946	16	96	13	1	80	0.0125000
NODE_143142_length_320_cov_2.171946	16	96	14	3	80	0.0375000
NODE_143142_length_320_cov_2.171946	16	96	15	2	80	0.0250000
NODE_143142_length_320_cov_2.171946	16	96	17	28	80	0.3500000
NODE_143142_length_320_cov_2.171946	16	96	21	4	80	0.0500000
NODE_143142_length_320_cov_2.171946	16	96	23	2	80	0.0250000
NODE_143142_length_320_cov_2.171946	69	149	17	21	80	0.2625000
NODE_143142_length_320_cov_2.171946	69	149	21	4	80	0.0500000
NODE_143142_length_320_cov_2.171946	69	149	23	4	80	0.0500000
NODE_143142_length_320_cov_2.171946	69	149	25	8	80	0.1000000
NODE_143142_length_320_cov_2.171946	69	149	29	1	80	0.0125000
NODE_143142_length_320_cov_2.171946	69	149	30	16	80	0.2000000
NODE_143142_length_320_cov_2.171946	69	149	32	14	80	0.1750000
NODE_143142_length_320_cov_2.171946	69	149	34	12	80	0.1500000
NODE_143207_length_320_cov_1.900452	37	117	2	80	80	1.0000000
NODE_143207_length_320_cov_1.900452	90	164	0	44	74	0.5945946
NODE_143207_length_320_cov_1.900452	90	164	2	30	74	0.4054054
NODE_143230_length_320_cov_1.846154	188	220	0	32	32	1.0000000
NODE_143309_length_320_cov_1.665158	144	198	2	8	54	0.1481481
NODE_143309_length_320_cov_1.665158	144	198	4	45	54	0.8333333
NODE_143309_length_320_cov_1.665158	144	198	6	1	54	0.0185185
NODE_143309_length_320_cov_1.665158	198	251	4	38	53	0.7169811
NODE_143309_length_320_cov_1.665158	198	251	6	15	53	0.2830189
NODE_143351_length_320_cov_1.601810	157	181	2	13	24	0.5416667
NODE_143351_length_320_cov_1.601810	157	181	4	11	24	0.4583333
NODE_143351_length_320_cov_1.601810	231	290	2	48	59	0.8135593
NODE_143351_length_320_cov_1.601810	231	290	4	11	59	0.1864407
NODE_143366_length_320_cov_1.556561	0	39	0	11	39	0.2820513
NODE_143366_length_320_cov_1.556561	0	39	4	11	39	0.2820513
NODE_143366_length_320_cov_1.556561	0	39	6	5	39	0.1282051
NODE_143366_length_320_cov_1.556561	0	39	9	1	39	0.0256410
NODE_143366_length_320_cov_1.556561	0	39	10	10	39	0.2564103
NODE_143366_length_320_cov_1.556561	0	39	12	1	39	0.0256410
NODE_143442_length_320_cov_1.384615	18	98	0	80	80	1.0000000
NODE_143442_length_320_cov_1.384615	71	145	0	47	74	0.6351351
NODE_143442_length_320_cov_1.384615	71	145	1	12	74	0.1621622
NODE_143442_length_320_cov_1.384615	71	145	2	6	74	0.0810811
NODE_143442_length_320_cov_1.384615	71	145	3	5	74	0.0675676
NODE_143442_length_320_cov_1.384615	71	145	4	4	74	0.0540541
NODE_143521_length_320_cov_1.312217	117	170	0	2	53	0.0377358
NODE_143521_length_320_cov_1.312217	117	170	2	51	53	0.9622642
NODE_143670_length_320_cov_1.117647	58	109	2	51	51	1.0000000
NODE_144091_length_319_cov_5.940909	122	202	2	25	80	0.3125000
NODE_144091_length_319_cov_5.940909	122	202	6	55	80	0.6875000
NODE_144107_length_319_cov_4.700000	16	47	0	31	31	1.0000000
NODE_144137_length_319_cov_4.068182	5	36	0	31	31	1.0000000
NODE_144162_length_319_cov_3.568182	149	229	0	18	80	0.2250000
NODE_144162_length_319_cov_3.568182	149	229	2	62	80	0.7750000
NODE_144206_length_319_cov_3.036364	112	174	0	62	62	1.0000000
NODE_144226_length_319_cov_2.800000	25	106	0	5	81	0.0617284
NODE_144226_length_319_cov_2.800000	25	106	2	1	81	0.0123457
NODE_144226_length_319_cov_2.800000	25	106	4	1	81	0.0123457
NODE_144226_length_319_cov_2.800000	25	106	5	2	81	0.0246914
NODE_144226_length_319_cov_2.800000	25	106	7	3	81	0.0370370
NODE_144226_length_319_cov_2.800000	25	106	11	3	81	0.0370370
NODE_144226_length_319_cov_2.800000	25	106	13	1	81	0.0123457
NODE_144226_length_319_cov_2.800000	25	106	23	2	81	0.0246914
NODE_144226_length_319_cov_2.800000	25	106	25	3	81	0.0370370
NODE_144226_length_319_cov_2.800000	25	106	30	1	81	0.0123457
NODE_144226_length_319_cov_2.800000	25	106	38	3	81	0.0370370
NODE_144226_length_319_cov_2.800000	25	106	42	2	81	0.0246914
NODE_144226_length_319_cov_2.800000	25	106	43	2	81	0.0246914
NODE_144226_length_319_cov_2.800000	25	106	48	1	81	0.0123457
NODE_144226_length_319_cov_2.800000	25	106	52	3	81	0.0370370
NODE_144226_length_319_cov_2.800000	25	106	60	2	81	0.0246914
NODE_144226_length_319_cov_2.800000	25	106	62	1	81	0.0123457
NODE_144226_length_319_cov_2.800000	25	106	73	2	81	0.0246914
NODE_144226_length_319_cov_2.800000	25	106	74	1	81	0.0123457
NODE_144226_length_319_cov_2.800000	25	106	78	3	81	0.0370370
NODE_144226_length_319_cov_2.800000	25	106	80	2	81	0.0246914
NODE_144226_length_319_cov_2.800000	25	106	81	3	81	0.0370370
NODE_144226_length_319_cov_2.800000	25	106	87	2	81	0.0246914
NODE_144226_length_319_cov_2.800000	25	106	89	2	81	0.0246914
NODE_144226_length_319_cov_2.800000	25	106	93	3	81	0.0370370
NODE_144226_length_319_cov_2.800000	25	106	95	1	81	0.0123457
NODE_144226_length_319_cov_2.800000	25	106	96	1	81	0.0123457
NODE_144226_length_319_cov_2.800000	25	106	98	2	81	0.0246914
NODE_144226_length_319_cov_2.800000	25	106	100	4	81	0.0493827
NODE_144226_length_319_cov_2.800000	25	106	108	2	81	0.0246914
NODE_144226_length_319_cov_2.800000	25	106	110	2	81	0.0246914
NODE_144226_length_319_cov_2.800000	25	106	114	15	81	0.1851852
NODE_144226_length_319_cov_2.800000	79	158	93	2	79	0.0253165
NODE_144226_length_319_cov_2.800000	79	158	94	5	79	0.0632911
NODE_144226_length_319_cov_2.800000	79	158	95	1	79	0.0126582
NODE_144226_length_319_cov_2.800000	79	158	96	1	79	0.0126582
NODE_144226_length_319_cov_2.800000	79	158	98	5	79	0.0632911
NODE_144226_length_319_cov_2.800000	79	158	100	5	79	0.0632911
NODE_144226_length_319_cov_2.800000	79	158	105	4	79	0.0506329
NODE_144226_length_319_cov_2.800000	79	158	107	1	79	0.0126582
NODE_144226_length_319_cov_2.800000	79	158	108	8	79	0.1012658
NODE_144226_length_319_cov_2.800000	79	158	109	8	79	0.1012658
NODE_144226_length_319_cov_2.800000	79	158	110	2	79	0.0253165
NODE_144226_length_319_cov_2.800000	79	158	113	5	79	0.0632911
NODE_144226_length_319_cov_2.800000	79	158	114	22	79	0.2784810
NODE_144226_length_319_cov_2.800000	79	158	115	10	79	0.1265823
NODE_144237_length_319_cov_2.740909	67	147	4	11	80	0.1375000
NODE_144237_length_319_cov_2.740909	67	147	10	12	80	0.1500000
NODE_144237_length_319_cov_2.740909	67	147	12	18	80	0.2250000
NODE_144237_length_319_cov_2.740909	67	147	14	39	80	0.4875000
NODE_144252_length_319_cov_2.586364	247	319	12	20	72	0.2777778
NODE_144252_length_319_cov_2.586364	247	319	16	52	72	0.7222222
NODE_144272_length_319_cov_2.463636	90	153	0	63	63	1.0000000
NODE_144272_length_319_cov_2.463636	163	216	0	53	53	1.0000000
NODE_144316_length_319_cov_2.259091	146	212	0	66	66	1.0000000
NODE_144340_length_319_cov_2.163636	213	275	0	62	62	1.0000000
NODE_144390_length_319_cov_1.968182	120	200	0	8	80	0.1000000
NODE_144390_length_319_cov_1.968182	120	200	2	72	80	0.9000000
NODE_144616_length_319_cov_1.431818	111	157	0	46	46	1.0000000
NODE_144629_length_319_cov_1.395455	129	179	0	50	50	1.0000000
NODE_144788_length_319_cov_1.190909	119	182	0	63	63	1.0000000
NODE_144788_length_319_cov_1.190909	197	232	0	35	35	1.0000000
NODE_145289_length_318_cov_232.639269	169	198	488	1	29	0.0344828
NODE_145289_length_318_cov_232.639269	169	198	496	1	29	0.0344828
NODE_145289_length_318_cov_232.639269	169	198	499	1	29	0.0344828
NODE_145289_length_318_cov_232.639269	169	198	511	1	29	0.0344828
NODE_145289_length_318_cov_232.639269	169	198	514	1	29	0.0344828
NODE_145289_length_318_cov_232.639269	169	198	522	1	29	0.0344828
NODE_145289_length_318_cov_232.639269	169	198	524	1	29	0.0344828
NODE_145289_length_318_cov_232.639269	169	198	526	1	29	0.0344828
NODE_145289_length_318_cov_232.639269	169	198	533	1	29	0.0344828
NODE_145289_length_318_cov_232.639269	169	198	545	1	29	0.0344828
NODE_145289_length_318_cov_232.639269	169	198	548	1	29	0.0344828
NODE_145289_length_318_cov_232.639269	169	198	549	1	29	0.0344828
NODE_145289_length_318_cov_232.639269	169	198	551	1	29	0.0344828
NODE_145289_length_318_cov_232.639269	169	198	554	1	29	0.0344828
NODE_145289_length_318_cov_232.639269	169	198	556	1	29	0.0344828
NODE_145289_length_318_cov_232.639269	169	198	557	1	29	0.0344828
NODE_145289_length_318_cov_232.639269	169	198	560	1	29	0.0344828
NODE_145289_length_318_cov_232.639269	169	198	561	1	29	0.0344828
NODE_145289_length_318_cov_232.639269	169	198	562	1	29	0.0344828
NODE_145289_length_318_cov_232.639269	169	198	564	2	29	0.0689655
NODE_145289_length_318_cov_232.639269	169	198	571	1	29	0.0344828
NODE_145289_length_318_cov_232.639269	169	198	572	1	29	0.0344828
NODE_145289_length_318_cov_232.639269	169	198	575	1	29	0.0344828
NODE_145289_length_318_cov_232.639269	169	198	578	2	29	0.0689655
NODE_145289_length_318_cov_232.639269	169	198	579	3	29	0.1034483
NODE_145289_length_318_cov_232.639269	171	246	460	1	75	0.0133333
NODE_145289_length_318_cov_232.639269	171	246	462	1	75	0.0133333
NODE_145289_length_318_cov_232.639269	171	246	466	1	75	0.0133333
NODE_145289_length_318_cov_232.639269	171	246	473	1	75	0.0133333
NODE_145289_length_318_cov_232.639269	171	246	477	1	75	0.0133333
NODE_145289_length_318_cov_232.639269	171	246	479	1	75	0.0133333
NODE_145289_length_318_cov_232.639269	171	246	481	1	75	0.0133333
NODE_145289_length_318_cov_232.639269	171	246	488	1	75	0.0133333
NODE_145289_length_318_cov_232.639269	171	246	489	1	75	0.0133333
NODE_145289_length_318_cov_232.639269	171	246	499	3	75	0.0400000
NODE_145289_length_318_cov_232.639269	171	246	504	1	75	0.0133333
NODE_145289_length_318_cov_232.639269	171	246	508	1	75	0.0133333
NODE_145289_length_318_cov_232.639269	171	246	511	1	75	0.0133333
NODE_145289_length_318_cov_232.639269	171	246	514	1	75	0.0133333
NODE_145289_length_318_cov_232.639269	171	246	516	1	75	0.0133333
NODE_145289_length_318_cov_232.639269	171	246	517	1	75	0.0133333
NODE_145289_length_318_cov_232.639269	171	246	520	1	75	0.0133333
NODE_145289_length_318_cov_232.639269	171	246	522	1	75	0.0133333
NODE_145289_length_318_cov_232.639269	171	246	524	1	75	0.0133333
NODE_145289_length_318_cov_232.639269	171	246	525	1	75	0.0133333
NODE_145289_length_318_cov_232.639269	171	246	526	2	75	0.0266667
NODE_145289_length_318_cov_232.639269	171	246	530	1	75	0.0133333
NODE_145289_length_318_cov_232.639269	171	246	532	1	75	0.0133333
NODE_145289_length_318_cov_232.639269	171	246	533	1	75	0.0133333
NODE_145289_length_318_cov_232.639269	171	246	534	1	75	0.0133333
NODE_145289_length_318_cov_232.639269	171	246	539	1	75	0.0133333
NODE_145289_length_318_cov_232.639269	171	246	545	1	75	0.0133333
NODE_145289_length_318_cov_232.639269	171	246	547	2	75	0.0266667
NODE_145289_length_318_cov_232.639269	171	246	548	1	75	0.0133333
NODE_145289_length_318_cov_232.639269	171	246	549	1	75	0.0133333
NODE_145289_length_318_cov_232.639269	171	246	551	1	75	0.0133333
NODE_145289_length_318_cov_232.639269	171	246	554	3	75	0.0400000
NODE_145289_length_318_cov_232.639269	171	246	556	1	75	0.0133333
NODE_145289_length_318_cov_232.639269	171	246	557	1	75	0.0133333
NODE_145289_length_318_cov_232.639269	171	246	560	2	75	0.0266667
NODE_145289_length_318_cov_232.639269	171	246	561	1	75	0.0133333
NODE_145289_length_318_cov_232.639269	171	246	562	1	75	0.0133333
NODE_145289_length_318_cov_232.639269	171	246	563	1	75	0.0133333
NODE_145289_length_318_cov_232.639269	171	246	564	2	75	0.0266667
NODE_145289_length_318_cov_232.639269	171	246	571	1	75	0.0133333
NODE_145289_length_318_cov_232.639269	171	246	572	2	75	0.0266667
NODE_145289_length_318_cov_232.639269	171	246	575	1	75	0.0133333
NODE_145289_length_318_cov_232.639269	171	246	576	4	75	0.0533333
NODE_145289_length_318_cov_232.639269	171	246	577	1	75	0.0133333
NODE_145289_length_318_cov_232.639269	171	246	578	3	75	0.0400000
NODE_145289_length_318_cov_232.639269	171	246	579	6	75	0.0800000
NODE_145289_length_318_cov_232.639269	171	246	580	2	75	0.0266667
NODE_145289_length_318_cov_232.639269	171	246	581	1	75	0.0133333
NODE_145289_length_318_cov_232.639269	171	246	584	2	75	0.0266667
NODE_145289_length_318_cov_232.639269	171	246	585	1	75	0.0133333
NODE_145289_length_318_cov_232.639269	171	246	586	2	75	0.0266667
NODE_145289_length_318_cov_232.639269	171	246	587	2	75	0.0266667
NODE_145333_length_318_cov_4.237443	222	294	2	14	72	0.1944444
NODE_145333_length_318_cov_4.237443	222	294	4	6	72	0.0833333
NODE_145333_length_318_cov_4.237443	222	294	6	52	72	0.7222222
NODE_145348_length_318_cov_3.721461	98	148	0	50	50	1.0000000
NODE_145362_length_318_cov_3.515982	60	129	0	69	69	1.0000000
NODE_145362_length_318_cov_3.515982	60	140	0	80	80	1.0000000
NODE_145362_length_318_cov_3.515982	60	140	0	80	80	1.0000000
NODE_145362_length_318_cov_3.515982	113	153	0	40	40	1.0000000
NODE_145362_length_318_cov_3.515982	122	153	0	31	31	1.0000000
NODE_145465_length_318_cov_2.557078	205	247	0	23	42	0.5476190
NODE_145465_length_318_cov_2.557078	205	247	2	19	42	0.4523810
NODE_145551_length_318_cov_2.109589	70	150	0	46	80	0.5750000
NODE_145551_length_318_cov_2.109589	70	150	2	34	80	0.4250000
NODE_145619_length_318_cov_1.945205	229	286	0	57	57	1.0000000
NODE_145709_length_318_cov_1.739726	242	308	0	42	66	0.6363636
NODE_145709_length_318_cov_1.739726	242	308	2	24	66	0.3636364
NODE_145725_length_318_cov_1.684932	49	80	2	31	31	1.0000000
NODE_145787_length_318_cov_1.561644	99	158	2	1	59	0.0169492
NODE_145787_length_318_cov_1.561644	99	158	4	42	59	0.7118644
NODE_145787_length_318_cov_1.561644	99	158	6	16	59	0.2711864
NODE_145807_length_318_cov_1.493151	151	195	0	32	44	0.7272727
NODE_145807_length_318_cov_1.493151	151	195	4	12	44	0.2727273
NODE_145807_length_318_cov_1.493151	199	258	4	59	59	1.0000000
NODE_145968_length_318_cov_1.301370	91	141	4	50	50	1.0000000
NODE_146017_length_318_cov_1.173516	83	150	2	67	67	1.0000000
NODE_146065_length_318_cov_1.127854	24	51	0	27	27	1.0000000
NODE_146065_length_318_cov_1.127854	24	60	0	36	36	1.0000000
NODE_146467_length_317_cov_55.467890	172	243	28	3	71	0.0422535
NODE_146467_length_317_cov_55.467890	172	243	30	1	71	0.0140845
NODE_146467_length_317_cov_55.467890	172	243	36	1	71	0.0140845
NODE_146467_length_317_cov_55.467890	172	243	38	6	71	0.0845070
NODE_146467_length_317_cov_55.467890	172	243	40	6	71	0.0845070
NODE_146467_length_317_cov_55.467890	172	243	44	9	71	0.1267606
NODE_146467_length_317_cov_55.467890	172	243	46	14	71	0.1971831
NODE_146467_length_317_cov_55.467890	172	243	48	1	71	0.0140845
NODE_146467_length_317_cov_55.467890	172	243	50	9	71	0.1267606
NODE_146467_length_317_cov_55.467890	172	243	51	1	71	0.0140845
NODE_146467_length_317_cov_55.467890	172	243	52	3	71	0.0422535
NODE_146467_length_317_cov_55.467890	172	243	53	9	71	0.1267606
NODE_146467_length_317_cov_55.467890	172	243	54	8	71	0.1126761
NODE_146487_length_317_cov_5.252294	247	307	0	60	60	1.0000000
NODE_146503_length_317_cov_4.467890	105	185	2	5	80	0.0625000
NODE_146503_length_317_cov_4.467890	105	185	4	43	80	0.5375000
NODE_146503_length_317_cov_4.467890	105	185	6	11	80	0.1375000
NODE_146503_length_317_cov_4.467890	105	185	8	21	80	0.2625000
NODE_146503_length_317_cov_4.467890	113	193	4	40	80	0.5000000
NODE_146503_length_317_cov_4.467890	113	193	6	19	80	0.2375000
NODE_146503_length_317_cov_4.467890	113	193	8	21	80	0.2625000
NODE_146554_length_317_cov_3.298165	146	206	0	1	60	0.0166667
NODE_146554_length_317_cov_3.298165	146	206	2	59	60	0.9833333
NODE_146562_length_317_cov_3.266055	111	191	2	9	80	0.1125000
NODE_146562_length_317_cov_3.266055	111	191	3	3	80	0.0375000
NODE_146562_length_317_cov_3.266055	111	191	4	15	80	0.1875000
NODE_146562_length_317_cov_3.266055	111	191	5	12	80	0.1500000
NODE_146562_length_317_cov_3.266055	111	191	6	1	80	0.0125000
NODE_146562_length_317_cov_3.266055	111	191	7	15	80	0.1875000
NODE_146562_length_317_cov_3.266055	111	191	8	12	80	0.1500000
NODE_146562_length_317_cov_3.266055	111	191	9	13	80	0.1625000
NODE_146562_length_317_cov_3.266055	164	244	2	62	80	0.7750000
NODE_146562_length_317_cov_3.266055	164	244	3	3	80	0.0375000
NODE_146562_length_317_cov_3.266055	164	244	4	15	80	0.1875000
NODE_146585_length_317_cov_3.036697	3	79	0	76	76	1.0000000
NODE_146601_length_317_cov_2.825688	14	94	0	67	80	0.8375000
NODE_146601_length_317_cov_2.825688	14	94	2	13	80	0.1625000
NODE_146601_length_317_cov_2.825688	67	147	0	14	80	0.1750000
NODE_146601_length_317_cov_2.825688	67	147	2	18	80	0.2250000
NODE_146601_length_317_cov_2.825688	67	147	4	48	80	0.6000000
NODE_146602_length_317_cov_2.821101	142	208	0	66	66	1.0000000
NODE_146604_length_317_cov_2.816514	121	201	0	80	80	1.0000000
NODE_146612_length_317_cov_2.779817	67	138	2	71	71	1.0000000
NODE_147046_length_317_cov_1.353211	166	239	4	29	73	0.3972603
NODE_147046_length_317_cov_1.353211	166	239	6	44	73	0.6027398
NODE_147046_length_317_cov_1.353211	212	292	0	32	80	0.4000000
NODE_147046_length_317_cov_1.353211	212	292	4	48	80	0.6000000
NODE_147172_length_317_cov_1.160550	58	117	0	25	59	0.4237288
NODE_147172_length_317_cov_1.160550	58	117	2	9	59	0.1525424
NODE_147172_length_317_cov_1.160550	58	117	4	17	59	0.2881356
NODE_147172_length_317_cov_1.160550	58	117	6	2	59	0.0338983
NODE_147172_length_317_cov_1.160550	58	117	10	6	59	0.1016949
NODE_147172_length_317_cov_1.160550	90	170	2	2	80	0.0250000
NODE_147172_length_317_cov_1.160550	90	170	4	17	80	0.2125000
NODE_147172_length_317_cov_1.160550	90	170	6	2	80	0.0250000
NODE_147172_length_317_cov_1.160550	90	170	10	25	80	0.3125000
NODE_147172_length_317_cov_1.160550	90	170	12	4	80	0.0500000
NODE_147172_length_317_cov_1.160550	90	170	14	20	80	0.2500000
NODE_147172_length_317_cov_1.160550	90	170	16	10	80	0.1250000
NODE_147187_length_317_cov_1.137615	245	313	0	68	68	1.0000000
NODE_147259_length_317_cov_0.967890	170	211	0	41	41	1.0000000
NODE_147373_length_317_cov_0.926606	194	232	0	38	38	1.0000000
NODE_147383_length_317_cov_0.912844	186	244	0	58	58	1.0000000
NODE_147595_length_316_cov_31.502304	96	174	0	9	78	0.1153846
NODE_147595_length_316_cov_31.502304	96	174	1	1	78	0.0128205
NODE_147595_length_316_cov_31.502304	96	174	5	1	78	0.0128205
NODE_147595_length_316_cov_31.502304	96	174	7	2	78	0.0256410
NODE_147595_length_316_cov_31.502304	96	174	8	1	78	0.0128205
NODE_147595_length_316_cov_31.502304	96	174	10	4	78	0.0512821
NODE_147595_length_316_cov_31.502304	96	174	11	1	78	0.0128205
NODE_147595_length_316_cov_31.502304	96	174	12	4	78	0.0512821
NODE_147595_length_316_cov_31.502304	96	174	13	2	78	0.0256410
NODE_147595_length_316_cov_31.502304	96	174	15	3	78	0.0384615
NODE_147595_length_316_cov_31.502304	96	174	17	2	78	0.0256410
NODE_147595_length_316_cov_31.502304	96	174	22	2	78	0.0256410
NODE_147595_length_316_cov_31.502304	96	174	24	2	78	0.0256410
NODE_147595_length_316_cov_31.502304	96	174	27	4	78	0.0512821
NODE_147595_length_316_cov_31.502304	96	174	28	2	78	0.0256410
NODE_147595_length_316_cov_31.502304	96	174	30	1	78	0.0128205
NODE_147595_length_316_cov_31.502304	96	174	38	2	78	0.0256410
NODE_147595_length_316_cov_31.502304	96	174	40	4	78	0.0512821
NODE_147595_length_316_cov_31.502304	96	174	42	3	78	0.0384615
NODE_147595_length_316_cov_31.502304	96	174	46	6	78	0.0769231
NODE_147595_length_316_cov_31.502304	96	174	48	1	78	0.0128205
NODE_147595_length_316_cov_31.502304	96	174	50	1	78	0.0128205
NODE_147595_length_316_cov_31.502304	96	174	52	2	78	0.0256410
NODE_147595_length_316_cov_31.502304	96	174	54	1	78	0.0128205
NODE_147595_length_316_cov_31.502304	96	174	58	6	78	0.0769231
NODE_147595_length_316_cov_31.502304	96	174	60	4	78	0.0512821
NODE_147595_length_316_cov_31.502304	96	174	62	1	78	0.0128205
NODE_147595_length_316_cov_31.502304	96	174	64	1	78	0.0128205
NODE_147595_length_316_cov_31.502304	96	174	68	1	78	0.0128205
NODE_147595_length_316_cov_31.502304	96	174	70	4	78	0.0512821
NODE_147595_length_316_cov_31.502304	96	121	0	9	25	0.3600000
NODE_147595_length_316_cov_31.502304	96	121	1	1	25	0.0400000
NODE_147595_length_316_cov_31.502304	96	121	5	1	25	0.0400000
NODE_147595_length_316_cov_31.502304	96	121	7	2	25	0.0800000
NODE_147595_length_316_cov_31.502304	96	121	8	1	25	0.0400000
NODE_147595_length_316_cov_31.502304	96	121	10	4	25	0.1600000
NODE_147595_length_316_cov_31.502304	96	121	11	1	25	0.0400000
NODE_147595_length_316_cov_31.502304	96	121	12	4	25	0.1600000
NODE_147595_length_316_cov_31.502304	96	121	13	2	25	0.0800000
NODE_147609_length_316_cov_6.179724	225	278	0	53	53	1.0000000
NODE_147623_length_316_cov_5.539171	91	171	8	57	80	0.7125000
NODE_147623_length_316_cov_5.539171	91	171	10	14	80	0.1750000
NODE_147623_length_316_cov_5.539171	91	171	12	9	80	0.1125000
NODE_147668_length_316_cov_3.732719	128	208	0	80	80	1.0000000
NODE_147668_length_316_cov_3.732719	181	257	0	50	76	0.6578947
NODE_147668_length_316_cov_3.732719	181	257	2	26	76	0.3421053
NODE_147680_length_316_cov_3.589862	185	247	0	62	62	1.0000000
NODE_147684_length_316_cov_3.520737	101	143	0	42	42	1.0000000
NODE_147702_length_316_cov_3.221198	108	184	2	10	76	0.1315790
NODE_147702_length_316_cov_3.221198	108	184	6	66	76	0.8684211
NODE_147734_length_316_cov_2.824885	274	311	0	37	37	1.0000000
NODE_147736_length_316_cov_2.820276	200	280	0	80	80	1.0000000
NODE_147757_length_316_cov_2.672811	23	80	0	57	57	1.0000000
NODE_147796_length_316_cov_2.456221	104	144	2	30	40	0.7500000
NODE_147796_length_316_cov_2.456221	104	144	3	10	40	0.2500000
NODE_147985_length_316_cov_1.751152	73	122	0	49	49	1.0000000
NODE_148030_length_316_cov_1.640553	218	300	0	82	82	1.0000000
NODE_148042_length_316_cov_1.631336	180	233	2	53	53	1.0000000
NODE_148042_length_316_cov_1.631336	180	215	2	35	35	1.0000000
NODE_148080_length_316_cov_1.520737	194	275	0	81	81	1.0000000
NODE_148080_length_316_cov_1.520737	248	302	0	54	54	1.0000000
NODE_148086_length_316_cov_1.493088	64	144	9	2	80	0.0250000
NODE_148086_length_316_cov_1.493088	64	144	11	1	80	0.0125000
NODE_148086_length_316_cov_1.493088	64	144	13	13	80	0.1625000
NODE_148086_length_316_cov_1.493088	64	144	15	1	80	0.0125000
NODE_148086_length_316_cov_1.493088	64	144	16	18	80	0.2250000
NODE_148086_length_316_cov_1.493088	64	144	18	3	80	0.0375000
NODE_148086_length_316_cov_1.493088	64	144	20	18	80	0.2250000
NODE_148086_length_316_cov_1.493088	64	144	22	24	80	0.3000000
NODE_148193_length_316_cov_1.377880	22	64	2	22	42	0.5238096
NODE_148193_length_316_cov_1.377880	22	64	5	20	42	0.4761905
NODE_148204_length_316_cov_1.350230	74	117	12	5	43	0.1162791
NODE_148204_length_316_cov_1.350230	74	117	14	38	43	0.8837209
NODE_148204_length_316_cov_1.350230	90	140	10	13	50	0.2600000
NODE_148204_length_316_cov_1.350230	90	140	12	5	50	0.1000000
NODE_148204_length_316_cov_1.350230	90	140	14	32	50	0.6400000
NODE_148533_length_316_cov_0.940092	104	180	0	76	76	1.0000000
NODE_148533_length_316_cov_0.940092	155	234	0	79	79	1.0000000
NODE_148693_length_316_cov_0.695853	232	267	0	35	35	1.0000000
NODE_148778_length_315_cov_6.967593	127	191	0	37	64	0.5781250
NODE_148778_length_315_cov_6.967593	127	191	2	27	64	0.4218750
NODE_148786_length_315_cov_6.300926	67	147	0	80	80	1.0000000
NODE_148786_length_315_cov_6.300926	120	200	0	80	80	1.0000000
NODE_148812_length_315_cov_4.449074	125	205	0	80	80	1.0000000
NODE_148812_length_315_cov_4.449074	178	225	0	47	47	1.0000000
NODE_148834_length_315_cov_4.009259	0	61	0	61	61	1.0000000
NODE_148834_length_315_cov_4.009259	42	61	0	19	19	1.0000000
NODE_148872_length_315_cov_3.421296	37	120	8	6	83	0.0722892
NODE_148872_length_315_cov_3.421296	37	120	9	3	83	0.0361446
NODE_148872_length_315_cov_3.421296	37	120	10	39	83	0.4698795
NODE_148872_length_315_cov_3.421296	37	120	12	35	83	0.4216867
NODE_148915_length_315_cov_2.847222	0	74	0	74	74	1.0000000
NODE_148915_length_315_cov_2.847222	47	127	0	80	80	1.0000000
NODE_148921_length_315_cov_2.833333	186	253	0	14	67	0.2089552
NODE_148921_length_315_cov_2.833333	186	253	4	53	67	0.7910448
NODE_148921_length_315_cov_2.833333	186	253	0	14	67	0.2089552
NODE_148921_length_315_cov_2.833333	186	253	4	53	67	0.7910448
NODE_148991_length_315_cov_2.416667	44	117	35	2	73	0.0273973
NODE_148991_length_315_cov_2.416667	44	117	37	2	73	0.0273973
NODE_148991_length_315_cov_2.416667	44	117	39	10	73	0.1369863
NODE_148991_length_315_cov_2.416667	44	117	43	1	73	0.0136986
NODE_148991_length_315_cov_2.416667	44	117	46	6	73	0.0821918
NODE_148991_length_315_cov_2.416667	44	117	48	2	73	0.0273973
NODE_148991_length_315_cov_2.416667	44	117	58	2	73	0.0273973
NODE_148991_length_315_cov_2.416667	44	117	60	3	73	0.0410959
NODE_148991_length_315_cov_2.416667	44	117	62	3	73	0.0410959
NODE_148991_length_315_cov_2.416667	44	117	64	5	73	0.0684932
NODE_148991_length_315_cov_2.416667	44	117	68	3	73	0.0410959
NODE_148991_length_315_cov_2.416667	44	117	70	3	73	0.0410959
NODE_148991_length_315_cov_2.416667	44	117	71	1	73	0.0136986
NODE_148991_length_315_cov_2.416667	44	117	73	1	73	0.0136986
NODE_148991_length_315_cov_2.416667	44	117	75	1	73	0.0136986
NODE_148991_length_315_cov_2.416667	44	117	77	2	73	0.0273973
NODE_148991_length_315_cov_2.416667	44	117	79	1	73	0.0136986
NODE_148991_length_315_cov_2.416667	44	117	81	6	73	0.0821918
NODE_148991_length_315_cov_2.416667	44	117	83	2	73	0.0273973
NODE_148991_length_315_cov_2.416667	44	117	85	1	73	0.0136986
NODE_148991_length_315_cov_2.416667	44	117	89	12	73	0.1643836
NODE_148991_length_315_cov_2.416667	44	117	90	4	73	0.0547945
NODE_149074_length_315_cov_2.115741	128	193	0	6	65	0.0923077
NODE_149074_length_315_cov_2.115741	128	193	2	59	65	0.9076923
NODE_149095_length_315_cov_2.004630	270	315	0	45	45	1.0000000
NODE_149201_length_315_cov_1.731481	125	202	0	76	77	0.9870130
NODE_149201_length_315_cov_1.731481	125	202	2	1	77	0.0129870
NODE_149391_length_315_cov_1.384259	183	233	2	1	50	0.0200000
NODE_149391_length_315_cov_1.384259	183	233	4	49	50	0.9800000
NODE_149935_length_315_cov_0.430556	125	145	0	20	20	1.0000000
NODE_149943_length_314_cov_108.139535	151	213	2	12	62	0.1935484
NODE_149943_length_314_cov_108.139535	151	213	4	10	62	0.1612903
NODE_149943_length_314_cov_108.139535	151	213	5	34	62	0.5483871
NODE_149943_length_314_cov_108.139535	151	213	6	6	62	0.0967742
NODE_149943_length_314_cov_108.139535	160	213	2	12	53	0.2264151
NODE_149943_length_314_cov_108.139535	160	213	4	10	53	0.1886792
NODE_149943_length_314_cov_108.139535	160	213	5	31	53	0.5849057
NODE_149944_length_314_cov_48.134884	245	314	0	69	69	1.0000000
NODE_149946_length_314_cov_9.097674	149	206	0	6	57	0.1052632
NODE_149946_length_314_cov_9.097674	149	206	2	10	57	0.1754386
NODE_149946_length_314_cov_9.097674	149	206	4	41	57	0.7192982
NODE_149967_length_314_cov_4.897674	109	189	6	9	80	0.1125000
NODE_149967_length_314_cov_4.897674	109	189	8	57	80	0.7125000
NODE_149967_length_314_cov_4.897674	109	189	10	14	80	0.1750000
NODE_150004_length_314_cov_3.823256	119	199	0	53	80	0.6625000
NODE_150004_length_314_cov_3.823256	119	199	2	18	80	0.2250000
NODE_150004_length_314_cov_3.823256	119	199	4	1	80	0.0125000
NODE_150004_length_314_cov_3.823256	119	199	6	8	80	0.1000000
NODE_150020_length_314_cov_3.558140	32	92	6	1	60	0.0166667
NODE_150020_length_314_cov_3.558140	32	92	8	8	60	0.1333333
NODE_150020_length_314_cov_3.558140	32	92	9	4	60	0.0666667
NODE_150020_length_314_cov_3.558140	32	92	10	11	60	0.1833333
NODE_150020_length_314_cov_3.558140	32	92	12	34	60	0.5666667
NODE_150020_length_314_cov_3.558140	32	92	14	2	60	0.0333333
NODE_150035_length_314_cov_3.316279	84	126	6	9	42	0.2142857
NODE_150035_length_314_cov_3.316279	84	126	8	20	42	0.4761905
NODE_150035_length_314_cov_3.316279	84	126	10	13	42	0.3095238
NODE_150035_length_314_cov_3.316279	127	180	0	31	53	0.5849057
NODE_150035_length_314_cov_3.316279	127	180	2	3	53	0.0566038
NODE_150035_length_314_cov_3.316279	127	180	4	3	53	0.0566038
NODE_150035_length_314_cov_3.316279	127	180	6	16	53	0.3018868
NODE_150035_length_314_cov_3.316279	128	148	2	2	20	0.1000000
NODE_150035_length_314_cov_3.316279	128	148	4	3	20	0.1500000
NODE_150035_length_314_cov_3.316279	128	148	6	15	20	0.7500000
NODE_150066_length_314_cov_3.032558	252	308	4	25	56	0.4464286
NODE_150066_length_314_cov_3.032558	252	308	6	4	56	0.0714286
NODE_150066_length_314_cov_3.032558	252	308	8	19	56	0.3392857
NODE_150066_length_314_cov_3.032558	252	308	10	8	56	0.1428571
NODE_150141_length_314_cov_2.520930	0	61	0	61	61	1.0000000
NODE_150141_length_314_cov_2.520930	34	93	0	59	59	1.0000000
NODE_150153_length_314_cov_2.441860	48	84	0	36	36	1.0000000
NODE_150159_length_314_cov_2.395349	62	112	9	19	50	0.3800000
NODE_150159_length_314_cov_2.395349	62	112	10	31	50	0.6200000
NODE_150200_length_314_cov_2.265116	7	53	0	13	46	0.2826087
NODE_150200_length_314_cov_2.265116	7	53	2	12	46	0.2608696
NODE_150200_length_314_cov_2.265116	7	53	6	21	46	0.4565217
NODE_150220_length_314_cov_2.144186	224	264	0	40	40	1.0000000
NODE_150257_length_314_cov_2.004651	68	148	0	80	80	1.0000000
NODE_150257_length_314_cov_2.004651	121	201	0	33	80	0.4125000
NODE_150257_length_314_cov_2.004651	121	201	2	47	80	0.5875000
NODE_150385_length_314_cov_1.665116	204	242	0	38	38	1.0000000
NODE_150385_length_314_cov_1.665116	215	295	0	80	80	1.0000000
NODE_150647_length_314_cov_1.223256	7	87	2	8	80	0.1000000
NODE_150647_length_314_cov_1.223256	7	87	4	72	80	0.9000000
NODE_150709_length_314_cov_1.167442	1	69	0	68	68	1.0000000
NODE_151193_length_313_cov_156.051402	177	254	3	3	77	0.0389610
NODE_151193_length_313_cov_156.051402	177	254	4	2	77	0.0259740
NODE_151193_length_313_cov_156.051402	177	254	5	1	77	0.0129870
NODE_151193_length_313_cov_156.051402	177	254	8	6	77	0.0779221
NODE_151193_length_313_cov_156.051402	177	254	14	13	77	0.1688312
NODE_151193_length_313_cov_156.051402	177	254	16	3	77	0.0389610
NODE_151193_length_313_cov_156.051402	177	254	20	10	77	0.1298701
NODE_151193_length_313_cov_156.051402	177	254	22	39	77	0.5064935
NODE_151193_length_313_cov_156.051402	177	254	3	3	77	0.0389610
NODE_151193_length_313_cov_156.051402	177	254	4	2	77	0.0259740
NODE_151193_length_313_cov_156.051402	177	254	5	1	77	0.0129870
NODE_151193_length_313_cov_156.051402	177	254	8	6	77	0.0779221
NODE_151193_length_313_cov_156.051402	177	254	14	13	77	0.1688312
NODE_151193_length_313_cov_156.051402	177	254	16	3	77	0.0389610
NODE_151193_length_313_cov_156.051402	177	254	20	10	77	0.1298701
NODE_151193_length_313_cov_156.051402	177	254	22	39	77	0.5064935
NODE_151214_length_313_cov_5.359813	135	196	0	21	61	0.3442623
NODE_151214_length_313_cov_5.359813	135	196	4	1	61	0.0163934
NODE_151214_length_313_cov_5.359813	135	196	6	39	61	0.6393443
NODE_151214_length_313_cov_5.359813	169	241	6	72	72	1.0000000
NODE_151230_length_313_cov_4.794393	126	206	6	34	80	0.4250000
NODE_151230_length_313_cov_4.794393	126	206	7	11	80	0.1375000
NODE_151230_length_313_cov_4.794393	126	206	8	19	80	0.2375000
NODE_151230_length_313_cov_4.794393	126	206	9	2	80	0.0250000
NODE_151230_length_313_cov_4.794393	126	206	12	1	80	0.0125000
NODE_151230_length_313_cov_4.794393	126	206	13	13	80	0.1625000
NODE_151230_length_313_cov_4.794393	179	259	7	11	80	0.1375000
NODE_151230_length_313_cov_4.794393	179	259	9	2	80	0.0250000
NODE_151230_length_313_cov_4.794393	179	259	10	47	80	0.5875000
NODE_151230_length_313_cov_4.794393	179	259	12	1	80	0.0125000
NODE_151230_length_313_cov_4.794393	179	259	13	19	80	0.2375000
NODE_151232_length_313_cov_4.761682	104	162	0	58	58	1.0000000
NODE_151232_length_313_cov_4.761682	135	215	0	80	80	1.0000000
NODE_151277_length_313_cov_3.560748	106	186	0	5	80	0.0625000
NODE_151277_length_313_cov_3.560748	106	186	2	25	80	0.3125000
NODE_151277_length_313_cov_3.560748	106	186	4	50	80	0.6250000
NODE_151331_length_313_cov_2.953271	92	153	0	4	61	0.0655738
NODE_151331_length_313_cov_2.953271	92	153	2	19	61	0.3114754
NODE_151331_length_313_cov_2.953271	92	153	4	38	61	0.6229508
NODE_151364_length_313_cov_2.640187	110	182	0	72	72	1.0000000
NODE_151364_length_313_cov_2.640187	113	184	0	71	71	1.0000000
NODE_151409_length_313_cov_2.383178	58	137	0	79	79	1.0000000
NODE_151409_length_313_cov_2.383178	110	190	0	78	80	0.9750000
NODE_151409_length_313_cov_2.383178	110	190	1	1	80	0.0125000
NODE_151409_length_313_cov_2.383178	110	190	2	1	80	0.0125000
NODE_151474_length_313_cov_2.107477	153	221	0	17	68	0.2500000
NODE_151474_length_313_cov_2.107477	153	221	2	51	68	0.7500000
NODE_151510_length_313_cov_1.934579	107	187	0	10	80	0.1250000
NODE_151510_length_313_cov_1.934579	107	187	1	11	80	0.1375000
NODE_151510_length_313_cov_1.934579	107	187	3	7	80	0.0875000
NODE_151510_length_313_cov_1.934579	107	187	7	2	80	0.0250000
NODE_151510_length_313_cov_1.934579	107	187	9	1	80	0.0125000
NODE_151510_length_313_cov_1.934579	107	187	11	1	80	0.0125000
NODE_151510_length_313_cov_1.934579	107	187	13	6	80	0.0750000
NODE_151510_length_313_cov_1.934579	107	187	15	9	80	0.1125000
NODE_151510_length_313_cov_1.934579	107	187	16	1	80	0.0125000
NODE_151510_length_313_cov_1.934579	107	187	18	4	80	0.0500000
NODE_151510_length_313_cov_1.934579	107	187	19	5	80	0.0625000
NODE_151510_length_313_cov_1.934579	107	187	20	1	80	0.0125000
NODE_151510_length_313_cov_1.934579	107	187	22	6	80	0.0750000
NODE_151510_length_313_cov_1.934579	107	187	26	2	80	0.0250000
NODE_151510_length_313_cov_1.934579	107	187	28	5	80	0.0625000
NODE_151510_length_313_cov_1.934579	107	187	30	2	80	0.0250000
NODE_151510_length_313_cov_1.934579	107	187	32	5	80	0.0625000
NODE_151510_length_313_cov_1.934579	107	187	34	2	80	0.0250000
NODE_151510_length_313_cov_1.934579	160	240	19	4	80	0.0500000
NODE_151510_length_313_cov_1.934579	160	240	20	1	80	0.0125000
NODE_151510_length_313_cov_1.934579	160	240	22	6	80	0.0750000
NODE_151510_length_313_cov_1.934579	160	240	25	6	80	0.0750000
NODE_151510_length_313_cov_1.934579	160	240	26	2	80	0.0250000
NODE_151510_length_313_cov_1.934579	160	240	27	10	80	0.1250000
NODE_151510_length_313_cov_1.934579	160	240	28	5	80	0.0625000
NODE_151510_length_313_cov_1.934579	160	240	29	14	80	0.1750000
NODE_151510_length_313_cov_1.934579	160	240	30	4	80	0.0500000
NODE_151510_length_313_cov_1.934579	160	240	32	12	80	0.1500000
NODE_151510_length_313_cov_1.934579	160	240	34	16	80	0.2000000
NODE_151576_length_313_cov_1.780374	236	296	0	60	60	1.0000000
NODE_151623_length_313_cov_1.663551	58	135	2	9	77	0.1168831
NODE_151623_length_313_cov_1.663551	58	135	4	68	77	0.8831169
NODE_151703_length_313_cov_1.439252	0	64	0	64	64	1.0000000
NODE_151703_length_313_cov_1.439252	37	82	0	45	45	1.0000000
NODE_151753_length_313_cov_1.429907	74	111	0	37	37	1.0000000
NODE_151753_length_313_cov_1.429907	109	172	0	63	63	1.0000000
NODE_151953_length_313_cov_1.172897	106	161	0	55	55	1.0000000
NODE_151953_length_313_cov_1.172897	149	214	0	18	65	0.2769231
NODE_151953_length_313_cov_1.172897	149	214	2	37	65	0.5692308
NODE_151953_length_313_cov_1.172897	149	214	4	10	65	0.1538462
NODE_152525_length_312_cov_3.723005	178	238	2	8	60	0.1333333
NODE_152525_length_312_cov_3.723005	178	238	4	22	60	0.3666667
NODE_152525_length_312_cov_3.723005	178	238	6	30	60	0.5000000
NODE_152525_length_312_cov_3.723005	231	291	2	19	60	0.3166667
NODE_152525_length_312_cov_3.723005	231	291	4	24	60	0.4000000
NODE_152525_length_312_cov_3.723005	231	291	6	17	60	0.2833333
NODE_152609_length_312_cov_2.723005	34	96	0	62	62	1.0000000
NODE_152609_length_312_cov_2.723005	87	149	0	62	62	1.0000000
NODE_152680_length_312_cov_2.333333	6	70	0	64	64	1.0000000
NODE_152680_length_312_cov_2.333333	43	123	0	80	80	1.0000000
NODE_152686_length_312_cov_2.267606	176	208	2	32	32	1.0000000
NODE_152697_length_312_cov_2.234742	108	169	0	57	61	0.9344262
NODE_152697_length_312_cov_2.234742	108	169	2	1	61	0.0163934
NODE_152697_length_312_cov_2.234742	108	169	3	3	61	0.0491803
NODE_152751_length_312_cov_2.014085	141	205	0	64	64	1.0000000
NODE_152751_length_312_cov_2.014085	178	258	0	80	80	1.0000000
NODE_152827_length_312_cov_1.835681	176	221	0	45	45	1.0000000
NODE_152827_length_312_cov_1.835681	194	269	0	75	75	1.0000000
NODE_153222_length_312_cov_1.173709	87	133	0	3	46	0.0652174
NODE_153222_length_312_cov_1.173709	87	133	6	6	46	0.1304348
NODE_153222_length_312_cov_1.173709	87	133	7	4	46	0.0869565
NODE_153222_length_312_cov_1.173709	87	133	11	4	46	0.0869565
NODE_153222_length_312_cov_1.173709	87	133	15	6	46	0.1304348
NODE_153222_length_312_cov_1.173709	87	133	17	12	46	0.2608696
NODE_153222_length_312_cov_1.173709	87	133	18	11	46	0.2391304
NODE_153222_length_312_cov_1.173709	150	217	34	3	67	0.0447761
NODE_153222_length_312_cov_1.173709	150	217	36	1	67	0.0149254
NODE_153222_length_312_cov_1.173709	150	217	40	1	67	0.0149254
NODE_153222_length_312_cov_1.173709	150	217	42	5	67	0.0746269
NODE_153222_length_312_cov_1.173709	150	217	50	1	67	0.0149254
NODE_153222_length_312_cov_1.173709	150	217	52	15	67	0.2238806
NODE_153222_length_312_cov_1.173709	150	217	54	4	67	0.0597015
NODE_153222_length_312_cov_1.173709	150	217	56	13	67	0.1940299
NODE_153222_length_312_cov_1.173709	150	217	58	19	67	0.2835821
NODE_153222_length_312_cov_1.173709	150	217	60	1	67	0.0149254
NODE_153222_length_312_cov_1.173709	150	217	62	2	67	0.0298507
NODE_153222_length_312_cov_1.173709	150	217	64	1	67	0.0149254
NODE_153222_length_312_cov_1.173709	150	217	66	1	67	0.0149254
NODE_153532_length_312_cov_0.788732	49	110	0	61	61	1.0000000
NODE_153532_length_312_cov_0.788732	102	163	0	14	61	0.2295082
NODE_153532_length_312_cov_0.788732	102	163	2	1	61	0.0163934
NODE_153532_length_312_cov_0.788732	102	163	4	39	61	0.6393443
NODE_153532_length_312_cov_0.788732	102	163	6	7	61	0.1147541
NODE_153708_length_311_cov_5.179245	155	235	0	80	80	1.0000000
NODE_153721_length_311_cov_4.589623	133	200	0	19	67	0.2835821
NODE_153721_length_311_cov_4.589623	133	200	2	48	67	0.7164179
NODE_153730_length_311_cov_4.358491	199	263	0	64	64	1.0000000
NODE_153743_length_311_cov_3.929245	91	127	6	36	36	1.0000000
NODE_153755_length_311_cov_3.825472	224	304	0	10	80	0.1250000
NODE_153755_length_311_cov_3.825472	224	304	2	4	80	0.0500000
NODE_153755_length_311_cov_3.825472	224	304	6	24	80	0.3000000
NODE_153755_length_311_cov_3.825472	224	304	8	8	80	0.1000000
NODE_153755_length_311_cov_3.825472	224	304	10	34	80	0.4250000
NODE_153773_length_311_cov_3.466981	106	186	0	80	80	1.0000000
NODE_153796_length_311_cov_3.188679	39	96	0	57	57	1.0000000
NODE_153846_length_311_cov_2.702830	144	193	0	49	49	1.0000000
NODE_153850_length_311_cov_2.665094	43	113	2	70	70	1.0000000
NODE_153859_length_311_cov_2.617925	206	284	0	78	78	1.0000000
NODE_153859_length_311_cov_2.617925	257	301	0	44	44	1.0000000
NODE_153913_length_311_cov_2.349057	177	204	4	27	27	1.0000000
NODE_153919_length_311_cov_2.325472	74	138	0	54	64	0.8437500
NODE_153919_length_311_cov_2.325472	74	138	2	10	64	0.1562500
NODE_153947_length_311_cov_2.188679	21	92	0	71	71	1.0000000
NODE_154014_length_311_cov_1.924528	46	65	2	19	19	1.0000000
NODE_154056_length_311_cov_1.891509	122	180	2	3	58	0.0517241
NODE_154056_length_311_cov_1.891509	122	180	4	55	58	0.9482759
NODE_154188_length_311_cov_1.594340	0	35	0	35	35	1.0000000
NODE_154190_length_311_cov_1.589623	96	151	4	55	55	1.0000000
NODE_154194_length_311_cov_1.570755	125	145	2	20	20	1.0000000
NODE_154957_length_311_cov_0.613208	136	216	0	80	80	1.0000000
NODE_154957_length_311_cov_0.613208	189	264	0	75	75	1.0000000
NODE_154996_length_310_cov_96.995261	211	249	62	3	38	0.0789474
NODE_154996_length_310_cov_96.995261	211	249	66	1	38	0.0263158
NODE_154996_length_310_cov_96.995261	211	249	72	1	38	0.0263158
NODE_154996_length_310_cov_96.995261	211	249	76	2	38	0.0526316
NODE_154996_length_310_cov_96.995261	211	249	80	3	38	0.0789474
NODE_154996_length_310_cov_96.995261	211	249	86	1	38	0.0263158
NODE_154996_length_310_cov_96.995261	211	249	87	3	38	0.0789474
NODE_154996_length_310_cov_96.995261	211	249	91	7	38	0.1842105
NODE_154996_length_310_cov_96.995261	211	249	96	8	38	0.2105263
NODE_154996_length_310_cov_96.995261	211	249	98	4	38	0.1052632
NODE_154996_length_310_cov_96.995261	211	249	100	3	38	0.0789474
NODE_154996_length_310_cov_96.995261	211	249	102	2	38	0.0526316
NODE_155001_length_310_cov_7.767773	80	151	0	71	71	1.0000000
NODE_155001_length_310_cov_7.767773	134	189	0	55	55	1.0000000
NODE_155017_length_310_cov_5.914692	84	134	2	49	50	0.9800000
NODE_155017_length_310_cov_5.914692	84	134	4	1	50	0.0200000
NODE_155017_length_310_cov_5.914692	113	134	2	21	21	1.0000000
NODE_155017_length_310_cov_5.914692	113	188	0	18	75	0.2400000
NODE_155017_length_310_cov_5.914692	113	188	2	57	75	0.7600000
NODE_155066_length_310_cov_3.777251	146	226	2	18	80	0.2250000
NODE_155066_length_310_cov_3.777251	146	226	4	62	80	0.7750000
NODE_155115_length_310_cov_3.180095	137	211	0	39	74	0.5270270
NODE_155115_length_310_cov_3.180095	137	211	2	4	74	0.0540541
NODE_155115_length_310_cov_3.180095	137	211	4	3	74	0.0405405
NODE_155115_length_310_cov_3.180095	137	211	6	14	74	0.1891892
NODE_155115_length_310_cov_3.180095	137	211	8	8	74	0.1081081
NODE_155115_length_310_cov_3.180095	137	211	12	5	74	0.0675676
NODE_155115_length_310_cov_3.180095	137	211	14	1	74	0.0135135
NODE_155179_length_310_cov_2.630332	122	174	0	21	52	0.4038461
NODE_155179_length_310_cov_2.630332	122	174	2	1	52	0.0192308
NODE_155179_length_310_cov_2.630332	122	174	5	1	52	0.0192308
NODE_155179_length_310_cov_2.630332	122	174	6	29	52	0.5576923
NODE_155179_length_310_cov_2.630332	175	222	6	21	47	0.4468085
NODE_155179_length_310_cov_2.630332	175	222	8	26	47	0.5531915
NODE_155180_length_310_cov_2.625592	258	301	0	43	43	1.0000000
NODE_155195_length_310_cov_2.563981	149	196	2	24	47	0.5106383
NODE_155195_length_310_cov_2.563981	149	196	4	23	47	0.4893617
NODE_155195_length_310_cov_2.563981	169	249	0	40	80	0.5000000
NODE_155195_length_310_cov_2.563981	169	249	2	37	80	0.4625000
NODE_155195_length_310_cov_2.563981	169	249	4	3	80	0.0375000
NODE_155261_length_310_cov_2.298578	213	259	0	46	46	1.0000000
NODE_155334_length_310_cov_2.009479	223	303	0	80	80	1.0000000
NODE_155439_length_310_cov_1.729858	53	91	0	38	38	1.0000000
NODE_155768_length_310_cov_1.222749	181	244	0	63	63	1.0000000
NODE_155864_length_310_cov_1.142180	65	135	0	1	70	0.0142857
NODE_155864_length_310_cov_1.142180	65	135	2	39	70	0.5571429
NODE_155864_length_310_cov_1.142180	65	135	4	30	70	0.4285714
NODE_155937_length_310_cov_0.966825	131	212	0	81	81	1.0000000
NODE_155937_length_310_cov_0.966825	193	256	0	63	63	1.0000000
NODE_156078_length_310_cov_0.924171	180	222	0	42	42	1.0000000
NODE_156174_length_310_cov_0.739336	208	288	0	80	80	1.0000000
NODE_156332_length_309_cov_8.552381	154	234	0	80	80	1.0000000
NODE_156340_length_309_cov_6.147619	20	83	0	63	63	1.0000000
NODE_156349_length_309_cov_5.147619	213	291	0	78	78	1.0000000
NODE_156364_length_309_cov_4.585714	15	95	0	18	80	0.2250000
NODE_156364_length_309_cov_4.585714	15	95	2	62	80	0.7750000
NODE_156472_length_309_cov_3.028571	0	47	0	47	47	1.0000000
NODE_156472_length_309_cov_3.028571	20	101	0	81	81	1.0000000
NODE_156563_length_309_cov_2.304762	179	218	0	39	39	1.0000000
NODE_156615_length_309_cov_2.095238	55	85	4	2	30	0.0666667
NODE_156615_length_309_cov_2.095238	55	85	6	28	30	0.9333333
NODE_156678_length_309_cov_1.938095	2	73	0	71	71	1.0000000
NODE_156950_length_309_cov_1.414286	189	231	0	42	42	1.0000000
NODE_156978_length_309_cov_1.376190	94	168	2	7	74	0.0945946
NODE_156978_length_309_cov_1.376190	94	168	4	67	74	0.9054054
NODE_157334_length_309_cov_0.966667	134	153	0	19	19	1.0000000
NODE_157469_length_309_cov_0.738095	150	215	12	3	65	0.0461538
NODE_157469_length_309_cov_0.738095	150	215	14	47	65	0.7230769
NODE_157469_length_309_cov_0.738095	150	215	16	13	65	0.2000000
NODE_157469_length_309_cov_0.738095	150	215	18	2	65	0.0307692
NODE_157661_length_308_cov_4.775120	137	174	0	37	37	1.0000000
NODE_157690_length_308_cov_3.966507	126	206	0	80	80	1.0000000
NODE_157705_length_308_cov_3.665072	11	75	0	64	64	1.0000000
NODE_157819_length_308_cov_2.593301	137	193	2	21	56	0.3750000
NODE_157819_length_308_cov_2.593301	137	193	4	35	56	0.6250000
NODE_157852_length_308_cov_2.435407	14	58	0	11	44	0.2500000
NODE_157852_length_308_cov_2.435407	14	58	2	33	44	0.7500000
NODE_157852_length_308_cov_2.435407	31	111	2	80	80	1.0000000
NODE_157898_length_308_cov_2.191388	14	80	0	66	66	1.0000000
NODE_157903_length_308_cov_2.191388	236	296	0	60	60	1.0000000
NODE_157969_length_308_cov_1.952153	251	296	0	45	45	1.0000000
NODE_158083_length_308_cov_1.708134	102	148	0	46	46	1.0000000
NODE_158276_length_308_cov_1.435407	196	276	0	80	80	1.0000000
NODE_158439_length_308_cov_1.162679	260	300	0	40	40	1.0000000
NODE_158439_length_308_cov_1.162679	273	307	0	34	34	1.0000000
NODE_158447_length_308_cov_1.148325	35	83	0	48	48	1.0000000
NODE_158448_length_308_cov_1.148325	253	308	0	5	55	0.0909091
NODE_158448_length_308_cov_1.148325	253	308	2	50	55	0.9090909
NODE_158510_length_308_cov_1.038278	147	202	0	50	55	0.9090909
NODE_158510_length_308_cov_1.038278	147	202	2	5	55	0.0909091
NODE_158811_length_308_cov_0.684211	196	275	0	79	79	1.0000000
NODE_158821_length_308_cov_0.660287	109	157	0	2	48	0.0416667
NODE_158821_length_308_cov_0.660287	109	157	2	20	48	0.4166667
NODE_158821_length_308_cov_0.660287	109	157	4	11	48	0.2291667
NODE_158821_length_308_cov_0.660287	109	157	6	15	48	0.3125000
NODE_158821_length_308_cov_0.660287	130	210	2	1	80	0.0125000
NODE_158821_length_308_cov_0.660287	130	210	4	11	80	0.1375000
NODE_158821_length_308_cov_0.660287	130	210	6	68	80	0.8500000
NODE_158905_length_307_cov_30.725962	0	73	0	73	73	1.0000000
NODE_158905_length_307_cov_30.725962	46	99	0	53	53	1.0000000
NODE_158906_length_307_cov_25.096154	84	164	0	80	80	1.0000000
NODE_158906_length_307_cov_25.096154	137	217	0	80	80	1.0000000
NODE_158933_length_307_cov_5.524038	150	221	0	71	71	1.0000000
NODE_158983_length_307_cov_3.730769	172	252	0	80	80	1.0000000
NODE_158983_length_307_cov_3.730769	225	305	0	80	80	1.0000000
NODE_158999_length_307_cov_3.322115	20	100	0	44	80	0.5500000
NODE_158999_length_307_cov_3.322115	20	100	2	20	80	0.2500000
NODE_158999_length_307_cov_3.322115	20	100	6	16	80	0.2000000
NODE_158999_length_307_cov_3.322115	78	153	2	7	75	0.0933333
NODE_158999_length_307_cov_3.322115	78	153	6	68	75	0.9066667
NODE_159000_length_307_cov_3.317308	12	94	0	18	82	0.2195122
NODE_159000_length_307_cov_3.317308	12	94	2	64	82	0.7804878
NODE_159000_length_307_cov_3.317308	76	134	0	16	58	0.2758621
NODE_159000_length_307_cov_3.317308	76	134	2	42	58	0.7241379
NODE_159053_length_307_cov_2.870192	43	108	0	65	65	1.0000000
NODE_159084_length_307_cov_2.653846	117	177	9	1	60	0.0166667
NODE_159084_length_307_cov_2.653846	117	177	16	16	60	0.2666667
NODE_159084_length_307_cov_2.653846	117	177	17	1	60	0.0166667
NODE_159084_length_307_cov_2.653846	117	177	18	35	60	0.5833333
NODE_159084_length_307_cov_2.653846	117	177	20	7	60	0.1166667
NODE_159142_length_307_cov_2.346154	54	105	2	51	51	1.0000000
NODE_159351_length_307_cov_1.716346	124	165	0	3	41	0.0731707
NODE_159351_length_307_cov_1.716346	124	165	2	26	41	0.6341463
NODE_159351_length_307_cov_1.716346	124	165	4	12	41	0.2926829
NODE_159362_length_307_cov_1.716346	30	93	0	10	63	0.1587302
NODE_159362_length_307_cov_1.716346	30	93	2	23	63	0.3650794
NODE_159362_length_307_cov_1.716346	30	93	5	30	63	0.4761905
NODE_159407_length_307_cov_1.600962	221	269	0	48	48	1.0000000
NODE_159407_length_307_cov_1.600962	242	307	0	65	65	1.0000000
NODE_159447_length_307_cov_1.475962	252	307	0	55	55	1.0000000
NODE_159585_length_307_cov_1.326923	96	142	4	46	46	1.0000000
NODE_159585_length_307_cov_1.326923	115	195	4	80	80	1.0000000
NODE_159618_length_307_cov_1.264423	13	61	2	25	48	0.5208333
NODE_159618_length_307_cov_1.264423	13	61	4	18	48	0.3750000
NODE_159618_length_307_cov_1.264423	13	61	12	3	48	0.0625000
NODE_159618_length_307_cov_1.264423	13	61	16	1	48	0.0208333
NODE_159618_length_307_cov_1.264423	13	61	18	1	48	0.0208333
NODE_159618_length_307_cov_1.264423	23	54	2	15	31	0.4838710
NODE_159618_length_307_cov_1.264423	23	54	4	16	31	0.5161290
NODE_159696_length_307_cov_1.197115	92	121	0	29	29	1.0000000
NODE_159787_length_307_cov_1.000000	132	168	0	36	36	1.0000000
NODE_160213_length_306_cov_74.526570	68	136	3	15	68	0.2205882
NODE_160213_length_306_cov_74.526570	68	136	5	26	68	0.3823529
NODE_160213_length_306_cov_74.526570	68	136	7	24	68	0.3529412
NODE_160213_length_306_cov_74.526570	68	136	11	3	68	0.0441176
NODE_160213_length_306_cov_74.526570	68	148	3	15	80	0.1875000
NODE_160213_length_306_cov_74.526570	68	148	5	26	80	0.3250000
NODE_160213_length_306_cov_74.526570	68	148	7	24	80	0.3000000
NODE_160213_length_306_cov_74.526570	68	148	11	15	80	0.1875000
NODE_160213_length_306_cov_74.526570	121	201	7	12	80	0.1500000
NODE_160213_length_306_cov_74.526570	121	201	10	17	80	0.2125000
NODE_160213_length_306_cov_74.526570	121	201	11	15	80	0.1875000
NODE_160213_length_306_cov_74.526570	121	201	12	30	80	0.3750000
NODE_160213_length_306_cov_74.526570	121	201	16	6	80	0.0750000
NODE_160213_length_306_cov_74.526570	121	201	7	12	80	0.1500000
NODE_160213_length_306_cov_74.526570	121	201	10	17	80	0.2125000
NODE_160213_length_306_cov_74.526570	121	201	11	15	80	0.1875000
NODE_160213_length_306_cov_74.526570	121	201	12	30	80	0.3750000
NODE_160213_length_306_cov_74.526570	121	201	16	6	80	0.0750000
NODE_160213_length_306_cov_74.526570	197	277	6	39	80	0.4875000
NODE_160213_length_306_cov_74.526570	197	277	8	32	80	0.4000000
NODE_160213_length_306_cov_74.526570	197	277	12	3	80	0.0375000
NODE_160213_length_306_cov_74.526570	197	277	16	6	80	0.0750000
NODE_160213_length_306_cov_74.526570	197	277	6	39	80	0.4875000
NODE_160213_length_306_cov_74.526570	197	277	8	32	80	0.4000000
NODE_160213_length_306_cov_74.526570	197	277	12	3	80	0.0375000
NODE_160213_length_306_cov_74.526570	197	277	16	6	80	0.0750000
NODE_160213_length_306_cov_74.526570	197	277	6	39	80	0.4875000
NODE_160213_length_306_cov_74.526570	197	277	8	32	80	0.4000000
NODE_160213_length_306_cov_74.526570	197	277	12	3	80	0.0375000
NODE_160213_length_306_cov_74.526570	197	277	16	6	80	0.0750000
NODE_160213_length_306_cov_74.526570	250	299	0	16	49	0.3265306
NODE_160213_length_306_cov_74.526570	250	299	6	33	49	0.6734694
NODE_160213_length_306_cov_74.526570	250	306	0	23	56	0.4107143
NODE_160213_length_306_cov_74.526570	250	306	6	33	56	0.5892857
NODE_160213_length_306_cov_74.526570	255	306	0	23	51	0.4509804
NODE_160213_length_306_cov_74.526570	255	306	6	28	51	0.5490196
NODE_160217_length_306_cov_7.396135	23	117	0	39	94	0.4148936
NODE_160217_length_306_cov_7.396135	23	117	2	29	94	0.3085106
NODE_160217_length_306_cov_7.396135	23	117	4	26	94	0.2765957
NODE_160217_length_306_cov_7.396135	90	170	2	1	80	0.0125000
NODE_160217_length_306_cov_7.396135	90	170	4	79	80	0.9875000
NODE_160261_length_306_cov_4.275362	67	147	0	62	80	0.7750000
NODE_160261_length_306_cov_4.275362	67	147	2	18	80	0.2250000
NODE_160275_length_306_cov_3.937198	104	176	0	72	72	1.0000000
NODE_160300_length_306_cov_3.444444	130	206	0	76	76	1.0000000
NODE_160323_length_306_cov_3.217391	198	278	0	80	80	1.0000000
NODE_160333_length_306_cov_3.043478	90	171	2	16	81	0.1975309
NODE_160333_length_306_cov_3.043478	90	171	3	3	81	0.0370370
NODE_160333_length_306_cov_3.043478	90	171	4	62	81	0.7654321
NODE_160333_length_306_cov_3.043478	144	202	0	2	58	0.0344828
NODE_160333_length_306_cov_3.043478	144	202	2	34	58	0.5862069
NODE_160333_length_306_cov_3.043478	144	202	3	3	58	0.0517241
NODE_160333_length_306_cov_3.043478	144	202	4	19	58	0.3275862
NODE_160340_length_306_cov_2.956522	242	273	6	15	31	0.4838710
NODE_160340_length_306_cov_2.956522	242	273	8	16	31	0.5161290
NODE_160355_length_306_cov_2.884058	173	243	3	9	70	0.1285714
NODE_160355_length_306_cov_2.884058	173	243	4	61	70	0.8714285
NODE_160403_length_306_cov_2.574879	122	203	4	18	81	0.2222222
NODE_160403_length_306_cov_2.574879	122	203	6	14	81	0.1728395
NODE_160403_length_306_cov_2.574879	122	203	8	6	81	0.0740741
NODE_160403_length_306_cov_2.574879	122	203	9	1	81	0.0123457
NODE_160403_length_306_cov_2.574879	122	203	10	2	81	0.0246914
NODE_160403_length_306_cov_2.574879	122	203	12	8	81	0.0987654
NODE_160403_length_306_cov_2.574879	122	203	14	6	81	0.0740741
NODE_160403_length_306_cov_2.574879	122	203	16	4	81	0.0493827
NODE_160403_length_306_cov_2.574879	122	203	18	8	81	0.0987654
NODE_160403_length_306_cov_2.574879	122	203	20	14	81	0.1728395
NODE_160403_length_306_cov_2.574879	176	254	8	3	78	0.0384615
NODE_160403_length_306_cov_2.574879	176	254	9	1	78	0.0128205
NODE_160403_length_306_cov_2.574879	176	254	10	5	78	0.0641026
NODE_160403_length_306_cov_2.574879	176	254	12	3	78	0.0384615
NODE_160403_length_306_cov_2.574879	176	254	14	4	78	0.0512821
NODE_160403_length_306_cov_2.574879	176	254	16	25	78	0.3205128
NODE_160403_length_306_cov_2.574879	176	254	18	16	78	0.2051282
NODE_160403_length_306_cov_2.574879	176	254	20	21	78	0.2692308
NODE_160475_length_306_cov_2.265700	223	278	4	1	55	0.0181818
NODE_160475_length_306_cov_2.265700	223	278	6	2	55	0.0363636
NODE_160475_length_306_cov_2.265700	223	278	7	6	55	0.1090909
NODE_160475_length_306_cov_2.265700	223	278	8	46	55	0.8363636
NODE_160512_length_306_cov_2.106280	73	149	0	69	76	0.9078947
NODE_160512_length_306_cov_2.106280	73	149	2	7	76	0.0921053
NODE_160512_length_306_cov_2.106280	125	205	0	17	80	0.2125000
NODE_160512_length_306_cov_2.106280	125	205	2	51	80	0.6375000
NODE_160512_length_306_cov_2.106280	125	205	6	12	80	0.1500000
NODE_160608_length_306_cov_1.879227	165	196	4	31	31	1.0000000
NODE_160752_length_306_cov_1.478261	206	237	2	31	31	1.0000000
NODE_160761_length_306_cov_1.478261	157	220	0	63	63	1.0000000
NODE_160833_length_306_cov_1.434783	40	88	0	48	48	1.0000000
NODE_160875_length_306_cov_1.357488	128	171	0	43	43	1.0000000
NODE_160992_length_306_cov_1.222222	216	252	0	36	36	1.0000000
NODE_160992_length_306_cov_1.222222	230	305	0	75	75	1.0000000
NODE_161018_length_306_cov_1.188406	79	159	0	80	80	1.0000000
NODE_161042_length_306_cov_1.130435	122	202	0	80	80	1.0000000
NODE_161042_length_306_cov_1.130435	175	255	0	80	80	1.0000000
NODE_161078_length_306_cov_1.067633	156	188	0	32	32	1.0000000
NODE_161234_length_306_cov_0.975845	219	247	0	28	28	1.0000000
NODE_161246_length_306_cov_0.956522	206	284	0	11	78	0.1410256
NODE_161246_length_306_cov_0.956522	206	284	2	67	78	0.8589743
NODE_161550_length_305_cov_5.718447	177	243	0	66	66	1.0000000
NODE_161566_length_305_cov_4.854369	55	135	0	80	80	1.0000000
NODE_161584_length_305_cov_4.266990	186	266	0	80	80	1.0000000
NODE_161723_length_305_cov_2.616505	220	263	0	43	43	1.0000000
NODE_161723_length_305_cov_2.616505	236	305	0	69	69	1.0000000
NODE_161726_length_305_cov_2.597087	171	256	23	9	85	0.1058824
NODE_161726_length_305_cov_2.597087	171	256	24	1	85	0.0117647
NODE_161726_length_305_cov_2.597087	171	256	30	4	85	0.0470588
NODE_161726_length_305_cov_2.597087	171	256	32	1	85	0.0117647
NODE_161726_length_305_cov_2.597087	171	256	34	3	85	0.0352941
NODE_161726_length_305_cov_2.597087	171	256	35	4	85	0.0470588
NODE_161726_length_305_cov_2.597087	171	256	37	4	85	0.0470588
NODE_161726_length_305_cov_2.597087	171	256	43	1	85	0.0117647
NODE_161726_length_305_cov_2.597087	171	256	45	1	85	0.0117647
NODE_161726_length_305_cov_2.597087	171	256	51	2	85	0.0235294
NODE_161726_length_305_cov_2.597087	171	256	53	1	85	0.0117647
NODE_161726_length_305_cov_2.597087	171	256	55	1	85	0.0117647
NODE_161726_length_305_cov_2.597087	171	256	61	1	85	0.0117647
NODE_161726_length_305_cov_2.597087	171	256	63	2	85	0.0235294
NODE_161726_length_305_cov_2.597087	171	256	66	6	85	0.0705882
NODE_161726_length_305_cov_2.597087	171	256	71	1	85	0.0117647
NODE_161726_length_305_cov_2.597087	171	256	72	1	85	0.0117647
NODE_161726_length_305_cov_2.597087	171	256	83	1	85	0.0117647
NODE_161726_length_305_cov_2.597087	171	256	84	3	85	0.0352941
NODE_161726_length_305_cov_2.597087	171	256	85	1	85	0.0117647
NODE_161726_length_305_cov_2.597087	171	256	86	1	85	0.0117647
NODE_161726_length_305_cov_2.597087	171	256	87	4	85	0.0470588
NODE_161726_length_305_cov_2.597087	171	256	88	1	85	0.0117647
NODE_161726_length_305_cov_2.597087	171	256	90	1	85	0.0117647
NODE_161726_length_305_cov_2.597087	171	256	92	11	85	0.1294118
NODE_161726_length_305_cov_2.597087	171	256	94	19	85	0.2235294
NODE_161732_length_305_cov_2.533981	3	57	0	54	54	1.0000000
NODE_161775_length_305_cov_2.339806	149	237	26	7	88	0.0795455
NODE_161775_length_305_cov_2.339806	149	237	28	14	88	0.1590909
NODE_161775_length_305_cov_2.339806	149	237	30	59	88	0.6704546
NODE_161775_length_305_cov_2.339806	149	237	32	8	88	0.0909091
NODE_161795_length_305_cov_2.228155	194	274	0	80	80	1.0000000
NODE_161795_length_305_cov_2.228155	247	300	0	53	53	1.0000000
NODE_161877_length_305_cov_1.975728	44	116	0	72	72	1.0000000
NODE_161908_length_305_cov_1.883495	135	172	25	1	37	0.0270270
NODE_161908_length_305_cov_1.883495	135	172	27	2	37	0.0540541
NODE_161908_length_305_cov_1.883495	135	172	29	4	37	0.1081081
NODE_161908_length_305_cov_1.883495	135	172	31	6	37	0.1621622
NODE_161908_length_305_cov_1.883495	135	172	33	4	37	0.1081081
NODE_161908_length_305_cov_1.883495	135	172	35	3	37	0.0810811
NODE_161908_length_305_cov_1.883495	135	172	36	3	37	0.0810811
NODE_161908_length_305_cov_1.883495	135	172	38	2	37	0.0540541
NODE_161908_length_305_cov_1.883495	135	172	40	4	37	0.1081081
NODE_161908_length_305_cov_1.883495	135	172	44	8	37	0.2162162
NODE_161990_length_305_cov_1.674757	14	80	0	47	66	0.7121212
NODE_161990_length_305_cov_1.674757	14	80	2	19	66	0.2878788
NODE_161990_length_305_cov_1.674757	53	133	0	8	80	0.1000000
NODE_161990_length_305_cov_1.674757	53	133	2	72	80	0.9000000
NODE_161996_length_305_cov_1.655340	110	179	6	18	69	0.2608696
NODE_161996_length_305_cov_1.655340	110	179	10	45	69	0.6521739
NODE_161996_length_305_cov_1.655340	110	179	12	6	69	0.0869565
NODE_162123_length_305_cov_1.466019	153	238	16	2	85	0.0235294
NODE_162123_length_305_cov_1.466019	153	238	18	2	85	0.0235294
NODE_162123_length_305_cov_1.466019	153	238	20	11	85	0.1294118
NODE_162123_length_305_cov_1.466019	153	238	22	7	85	0.0823529
NODE_162123_length_305_cov_1.466019	153	238	24	2	85	0.0235294
NODE_162123_length_305_cov_1.466019	153	238	26	1	85	0.0117647
NODE_162123_length_305_cov_1.466019	153	238	28	3	85	0.0352941
NODE_162123_length_305_cov_1.466019	153	238	30	6	85	0.0705882
NODE_162123_length_305_cov_1.466019	153	238	32	14	85	0.1647059
NODE_162123_length_305_cov_1.466019	153	238	34	16	85	0.1882353
NODE_162123_length_305_cov_1.466019	153	238	38	5	85	0.0588235
NODE_162123_length_305_cov_1.466019	153	238	40	2	85	0.0235294
NODE_162123_length_305_cov_1.466019	153	238	44	1	85	0.0117647
NODE_162123_length_305_cov_1.466019	153	238	45	7	85	0.0823529
NODE_162123_length_305_cov_1.466019	153	238	51	5	85	0.0588235
NODE_162123_length_305_cov_1.466019	153	238	53	1	85	0.0117647
NODE_162123_length_305_cov_1.466019	222	284	40	2	62	0.0322581
NODE_162123_length_305_cov_1.466019	222	284	44	1	62	0.0161290
NODE_162123_length_305_cov_1.466019	222	284	45	7	62	0.1129032
NODE_162123_length_305_cov_1.466019	222	284	50	1	62	0.0161290
NODE_162123_length_305_cov_1.466019	222	284	51	5	62	0.0806452
NODE_162123_length_305_cov_1.466019	222	284	52	5	62	0.0806452
NODE_162123_length_305_cov_1.466019	222	284	53	1	62	0.0161290
NODE_162123_length_305_cov_1.466019	222	284	54	5	62	0.0806452
NODE_162123_length_305_cov_1.466019	222	284	55	2	62	0.0322581
NODE_162123_length_305_cov_1.466019	222	284	56	5	62	0.0806452
NODE_162123_length_305_cov_1.466019	222	284	57	15	62	0.2419355
NODE_162123_length_305_cov_1.466019	222	284	59	13	62	0.2096774
NODE_162169_length_305_cov_1.398058	28	75	0	47	47	1.0000000
NODE_162198_length_305_cov_1.330097	212	292	12	8	80	0.1000000
NODE_162198_length_305_cov_1.330097	212	292	14	1	80	0.0125000
NODE_162198_length_305_cov_1.330097	212	292	18	5	80	0.0625000
NODE_162198_length_305_cov_1.330097	212	292	20	1	80	0.0125000
NODE_162198_length_305_cov_1.330097	212	292	22	1	80	0.0125000
NODE_162198_length_305_cov_1.330097	212	292	26	1	80	0.0125000
NODE_162198_length_305_cov_1.330097	212	292	32	4	80	0.0500000
NODE_162198_length_305_cov_1.330097	212	292	34	1	80	0.0125000
NODE_162198_length_305_cov_1.330097	212	292	36	6	80	0.0750000
NODE_162198_length_305_cov_1.330097	212	292	40	3	80	0.0375000
NODE_162198_length_305_cov_1.330097	212	292	42	5	80	0.0625000
NODE_162198_length_305_cov_1.330097	212	292	44	6	80	0.0750000
NODE_162198_length_305_cov_1.330097	212	292	46	3	80	0.0375000
NODE_162198_length_305_cov_1.330097	212	292	48	3	80	0.0375000
NODE_162198_length_305_cov_1.330097	212	292	52	1	80	0.0125000
NODE_162198_length_305_cov_1.330097	212	292	54	3	80	0.0375000
NODE_162198_length_305_cov_1.330097	212	292	56	8	80	0.1000000
NODE_162198_length_305_cov_1.330097	212	292	58	5	80	0.0625000
NODE_162198_length_305_cov_1.330097	212	292	60	6	80	0.0750000
NODE_162198_length_305_cov_1.330097	212	292	62	4	80	0.0500000
NODE_162198_length_305_cov_1.330097	212	292	66	5	80	0.0625000
NODE_162198_length_305_cov_1.330097	265	305	2	1	40	0.0250000
NODE_162198_length_305_cov_1.330097	265	305	4	1	40	0.0250000
NODE_162198_length_305_cov_1.330097	265	305	6	1	40	0.0250000
NODE_162198_length_305_cov_1.330097	265	305	7	3	40	0.0750000
NODE_162198_length_305_cov_1.330097	265	305	11	6	40	0.1500000
NODE_162198_length_305_cov_1.330097	265	305	12	9	40	0.2250000
NODE_162198_length_305_cov_1.330097	265	305	14	1	40	0.0250000
NODE_162198_length_305_cov_1.330097	265	305	18	5	40	0.1250000
NODE_162198_length_305_cov_1.330097	265	305	20	1	40	0.0250000
NODE_162198_length_305_cov_1.330097	265	305	22	1	40	0.0250000
NODE_162198_length_305_cov_1.330097	265	305	26	1	40	0.0250000
NODE_162198_length_305_cov_1.330097	265	305	32	4	40	0.1000000
NODE_162198_length_305_cov_1.330097	265	305	34	1	40	0.0250000
NODE_162198_length_305_cov_1.330097	265	305	36	5	40	0.1250000
NODE_162359_length_305_cov_1.111650	245	275	0	30	30	1.0000000
NODE_162411_length_305_cov_0.990291	46	126	2	25	80	0.3125000
NODE_162411_length_305_cov_0.990291	46	126	6	25	80	0.3125000
NODE_162411_length_305_cov_0.990291	46	126	8	30	80	0.3750000
NODE_162593_length_305_cov_0.873786	73	109	0	36	36	1.0000000
NODE_162782_length_305_cov_0.631068	86	166	0	80	80	1.0000000
NODE_162782_length_305_cov_0.631068	139	186	0	47	47	1.0000000
NODE_162854_length_304_cov_44.482927	61	102	61	2	41	0.0487805
NODE_162854_length_304_cov_44.482927	61	102	63	6	41	0.1463415
NODE_162854_length_304_cov_44.482927	61	102	70	1	41	0.0243902
NODE_162854_length_304_cov_44.482927	61	102	71	1	41	0.0243902
NODE_162854_length_304_cov_44.482927	61	102	73	14	41	0.3414634
NODE_162854_length_304_cov_44.482927	61	102	75	7	41	0.1707317
NODE_162854_length_304_cov_44.482927	61	102	82	1	41	0.0243902
NODE_162854_length_304_cov_44.482927	61	102	83	9	41	0.2195122
NODE_162855_length_304_cov_30.678049	205	281	0	76	76	1.0000000
NODE_162855_length_304_cov_30.678049	254	304	0	50	50	1.0000000
NODE_162886_length_304_cov_4.956098	72	152	0	80	80	1.0000000
NODE_162919_length_304_cov_3.980488	46	126	2	43	80	0.5375000
NODE_162919_length_304_cov_3.980488	46	126	4	37	80	0.4625000
NODE_162919_length_304_cov_3.980488	99	179	0	27	80	0.3375000
NODE_162919_length_304_cov_3.980488	99	179	2	21	80	0.2625000
NODE_162919_length_304_cov_3.980488	99	179	4	32	80	0.4000000
NODE_162932_length_304_cov_3.809756	108	156	0	34	48	0.7083333
NODE_162932_length_304_cov_3.809756	108	156	2	14	48	0.2916667
NODE_162955_length_304_cov_3.424390	67	129	0	62	62	1.0000000
NODE_162955_length_304_cov_3.424390	120	182	0	62	62	1.0000000
NODE_162997_length_304_cov_2.980488	105	126	0	21	21	1.0000000
NODE_163048_length_304_cov_2.629268	106	186	3	4	80	0.0500000
NODE_163048_length_304_cov_2.629268	106	186	12	1	80	0.0125000
NODE_163048_length_304_cov_2.629268	106	186	13	9	80	0.1125000
NODE_163048_length_304_cov_2.629268	106	186	14	4	80	0.0500000
NODE_163048_length_304_cov_2.629268	106	186	16	7	80	0.0875000
NODE_163048_length_304_cov_2.629268	106	186	20	55	80	0.6875000
NODE_163048_length_304_cov_2.629268	159	209	10	1	50	0.0200000
NODE_163048_length_304_cov_2.629268	159	209	20	49	50	0.9800000
NODE_163116_length_304_cov_2.239024	57	137	6	3	80	0.0375000
NODE_163116_length_304_cov_2.239024	57	137	8	18	80	0.2250000
NODE_163116_length_304_cov_2.239024	57	137	10	59	80	0.7375000
NODE_163116_length_304_cov_2.239024	110	152	6	18	42	0.4285714
NODE_163116_length_304_cov_2.239024	110	152	8	18	42	0.4285714
NODE_163116_length_304_cov_2.239024	110	152	10	6	42	0.1428571
NODE_163148_length_304_cov_2.170732	112	145	0	20	33	0.6060606
NODE_163148_length_304_cov_2.170732	112	145	2	11	33	0.3333333
NODE_163148_length_304_cov_2.170732	112	145	4	2	33	0.0606061
NODE_163148_length_304_cov_2.170732	146	198	0	52	52	1.0000000
NODE_163333_length_304_cov_1.687805	219	288	0	62	69	0.8985507
NODE_163333_length_304_cov_1.687805	219	288	2	7	69	0.1014493
NODE_163432_length_304_cov_1.492683	190	238	6	34	48	0.7083333
NODE_163432_length_304_cov_1.492683	190	238	8	14	48	0.2916667
NODE_163559_length_304_cov_1.287805	99	165	0	66	66	1.0000000
NODE_163670_length_304_cov_1.175610	0	30	0	30	30	1.0000000
NODE_163895_length_304_cov_0.951220	70	150	8	30	80	0.3750000
NODE_163895_length_304_cov_0.951220	70	150	12	34	80	0.4250000
NODE_163895_length_304_cov_0.951220	70	150	14	16	80	0.2000000
NODE_164171_length_303_cov_30.843137	46	97	0	51	51	1.0000000
NODE_164194_length_303_cov_5.401961	33	79	0	46	46	1.0000000
NODE_164224_length_303_cov_4.210784	136	205	12	14	69	0.2028985
NODE_164224_length_303_cov_4.210784	136	205	14	55	69	0.7971014
NODE_164224_length_303_cov_4.210784	178	259	0	49	81	0.6049383
NODE_164224_length_303_cov_4.210784	178	259	4	1	81	0.0123457
NODE_164224_length_303_cov_4.210784	178	259	6	2	81	0.0246914
NODE_164224_length_303_cov_4.210784	178	259	8	2	81	0.0246914
NODE_164224_length_303_cov_4.210784	178	259	12	13	81	0.1604938
NODE_164224_length_303_cov_4.210784	178	259	14	14	81	0.1728395
NODE_164251_length_303_cov_3.671569	9	75	0	66	66	1.0000000
NODE_164251_length_303_cov_3.671569	48	128	0	52	80	0.6500000
NODE_164251_length_303_cov_3.671569	48	128	2	28	80	0.3500000
NODE_164251_length_303_cov_3.671569	48	128	0	52	80	0.6500000
NODE_164251_length_303_cov_3.671569	48	128	2	28	80	0.3500000
NODE_164251_length_303_cov_3.671569	220	300	0	7	80	0.0875000
NODE_164251_length_303_cov_3.671569	220	300	8	73	80	0.9125000
NODE_164267_length_303_cov_3.500000	55	123	2	3	68	0.0441176
NODE_164267_length_303_cov_3.500000	55	123	4	24	68	0.3529412
NODE_164267_length_303_cov_3.500000	55	123	6	41	68	0.6029412
NODE_164272_length_303_cov_3.460784	0	67	0	1	67	0.0149254
NODE_164272_length_303_cov_3.460784	0	67	2	3	67	0.0447761
NODE_164272_length_303_cov_3.460784	0	67	4	11	67	0.1641791
NODE_164272_length_303_cov_3.460784	0	67	6	15	67	0.2238806
NODE_164272_length_303_cov_3.460784	0	67	11	1	67	0.0149254
NODE_164272_length_303_cov_3.460784	0	67	13	1	67	0.0149254
NODE_164272_length_303_cov_3.460784	0	67	16	1	67	0.0149254
NODE_164272_length_303_cov_3.460784	0	67	24	4	67	0.0597015
NODE_164272_length_303_cov_3.460784	0	67	32	1	67	0.0149254
NODE_164272_length_303_cov_3.460784	0	67	36	1	67	0.0149254
NODE_164272_length_303_cov_3.460784	0	67	50	1	67	0.0149254
NODE_164272_length_303_cov_3.460784	0	67	51	1	67	0.0149254
NODE_164272_length_303_cov_3.460784	0	67	52	1	67	0.0149254
NODE_164272_length_303_cov_3.460784	0	67	54	2	67	0.0298507
NODE_164272_length_303_cov_3.460784	0	67	56	1	67	0.0149254
NODE_164272_length_303_cov_3.460784	0	67	60	1	67	0.0149254
NODE_164272_length_303_cov_3.460784	0	67	62	1	67	0.0149254
NODE_164272_length_303_cov_3.460784	0	67	63	1	67	0.0149254
NODE_164272_length_303_cov_3.460784	0	67	65	2	67	0.0298507
NODE_164272_length_303_cov_3.460784	0	67	69	2	67	0.0298507
NODE_164272_length_303_cov_3.460784	0	67	72	4	67	0.0597015
NODE_164272_length_303_cov_3.460784	0	67	74	1	67	0.0149254
NODE_164272_length_303_cov_3.460784	0	67	82	1	67	0.0149254
NODE_164272_length_303_cov_3.460784	0	67	84	1	67	0.0149254
NODE_164272_length_303_cov_3.460784	0	67	86	1	67	0.0149254
NODE_164272_length_303_cov_3.460784	0	67	88	2	67	0.0298507
NODE_164272_length_303_cov_3.460784	0	67	89	4	67	0.0597015
NODE_164272_length_303_cov_3.460784	0	67	91	1	67	0.0149254
NODE_164272_length_303_cov_3.460784	98	178	246	1	80	0.0125000
NODE_164272_length_303_cov_3.460784	98	178	250	1	80	0.0125000
NODE_164272_length_303_cov_3.460784	98	178	259	1	80	0.0125000
NODE_164272_length_303_cov_3.460784	98	178	272	1	80	0.0125000
NODE_164272_length_303_cov_3.460784	98	178	279	1	80	0.0125000
NODE_164272_length_303_cov_3.460784	98	178	286	1	80	0.0125000
NODE_164272_length_303_cov_3.460784	98	178	288	1	80	0.0125000
NODE_164272_length_303_cov_3.460784	98	178	300	1	80	0.0125000
NODE_164272_length_303_cov_3.460784	98	178	302	1	80	0.0125000
NODE_164272_length_303_cov_3.460784	98	178	310	1	80	0.0125000
NODE_164272_length_303_cov_3.460784	98	178	317	2	80	0.0250000
NODE_164272_length_303_cov_3.460784	98	178	333	1	80	0.0125000
NODE_164272_length_303_cov_3.460784	98	178	338	1	80	0.0125000
NODE_164272_length_303_cov_3.460784	98	178	349	1	80	0.0125000
NODE_164272_length_303_cov_3.460784	98	178	359	1	80	0.0125000
NODE_164272_length_303_cov_3.460784	98	178	363	1	80	0.0125000
NODE_164272_length_303_cov_3.460784	98	178	374	1	80	0.0125000
NODE_164272_length_303_cov_3.460784	98	178	376	1	80	0.0125000
NODE_164272_length_303_cov_3.460784	98	178	380	1	80	0.0125000
NODE_164272_length_303_cov_3.460784	98	178	384	1	80	0.0125000
NODE_164272_length_303_cov_3.460784	98	178	386	1	80	0.0125000
NODE_164272_length_303_cov_3.460784	98	178	388	1	80	0.0125000
NODE_164272_length_303_cov_3.460784	98	178	391	1	80	0.0125000
NODE_164272_length_303_cov_3.460784	98	178	393	1	80	0.0125000
NODE_164272_length_303_cov_3.460784	98	178	395	1	80	0.0125000
NODE_164272_length_303_cov_3.460784	98	178	400	1	80	0.0125000
NODE_164272_length_303_cov_3.460784	98	178	404	1	80	0.0125000
NODE_164272_length_303_cov_3.460784	98	178	407	1	80	0.0125000
NODE_164272_length_303_cov_3.460784	98	178	412	1	80	0.0125000
NODE_164272_length_303_cov_3.460784	98	178	414	1	80	0.0125000
NODE_164272_length_303_cov_3.460784	98	178	416	1	80	0.0125000
NODE_164272_length_303_cov_3.460784	98	178	426	1	80	0.0125000
NODE_164272_length_303_cov_3.460784	98	178	433	1	80	0.0125000
NODE_164272_length_303_cov_3.460784	98	178	439	1	80	0.0125000
NODE_164272_length_303_cov_3.460784	98	178	445	1	80	0.0125000
NODE_164272_length_303_cov_3.460784	98	178	455	1	80	0.0125000
NODE_164272_length_303_cov_3.460784	98	178	471	1	80	0.0125000
NODE_164272_length_303_cov_3.460784	98	178	473	1	80	0.0125000
NODE_164272_length_303_cov_3.460784	98	178	477	1	80	0.0125000
NODE_164272_length_303_cov_3.460784	98	178	479	1	80	0.0125000
NODE_164272_length_303_cov_3.460784	98	178	491	1	80	0.0125000
NODE_164272_length_303_cov_3.460784	98	178	496	1	80	0.0125000
NODE_164272_length_303_cov_3.460784	98	178	501	1	80	0.0125000
NODE_164272_length_303_cov_3.460784	98	178	503	3	80	0.0375000
NODE_164272_length_303_cov_3.460784	98	178	504	1	80	0.0125000
NODE_164272_length_303_cov_3.460784	98	178	505	1	80	0.0125000
NODE_164272_length_303_cov_3.460784	98	178	507	2	80	0.0250000
NODE_164272_length_303_cov_3.460784	98	178	511	1	80	0.0125000
NODE_164272_length_303_cov_3.460784	98	178	514	1	80	0.0125000
NODE_164272_length_303_cov_3.460784	98	178	516	1	80	0.0125000
NODE_164272_length_303_cov_3.460784	98	178	520	1	80	0.0125000
NODE_164272_length_303_cov_3.460784	98	178	522	1	80	0.0125000
NODE_164272_length_303_cov_3.460784	98	178	523	1	80	0.0125000
NODE_164272_length_303_cov_3.460784	98	178	525	3	80	0.0375000
NODE_164272_length_303_cov_3.460784	98	178	526	1	80	0.0125000
NODE_164272_length_303_cov_3.460784	98	178	527	4	80	0.0500000
NODE_164272_length_303_cov_3.460784	98	178	530	1	80	0.0125000
NODE_164272_length_303_cov_3.460784	98	178	531	2	80	0.0250000
NODE_164272_length_303_cov_3.460784	98	178	532	1	80	0.0125000
NODE_164272_length_303_cov_3.460784	98	178	536	1	80	0.0125000
NODE_164272_length_303_cov_3.460784	98	178	542	1	80	0.0125000
NODE_164272_length_303_cov_3.460784	98	178	552	1	80	0.0125000
NODE_164272_length_303_cov_3.460784	98	178	564	1	80	0.0125000
NODE_164272_length_303_cov_3.460784	98	178	576	2	80	0.0250000
NODE_164272_length_303_cov_3.460784	98	178	594	1	80	0.0125000
NODE_164272_length_303_cov_3.460784	98	178	602	1	80	0.0125000
NODE_164272_length_303_cov_3.460784	98	178	616	1	80	0.0125000
NODE_164272_length_303_cov_3.460784	98	178	640	1	80	0.0125000
NODE_164272_length_303_cov_3.460784	98	178	642	1	80	0.0125000
NODE_164272_length_303_cov_3.460784	151	191	516	1	40	0.0250000
NODE_164272_length_303_cov_3.460784	151	191	520	1	40	0.0250000
NODE_164272_length_303_cov_3.460784	151	191	522	1	40	0.0250000
NODE_164272_length_303_cov_3.460784	151	191	523	1	40	0.0250000
NODE_164272_length_303_cov_3.460784	151	191	525	3	40	0.0750000
NODE_164272_length_303_cov_3.460784	151	191	526	1	40	0.0250000
NODE_164272_length_303_cov_3.460784	151	191	527	4	40	0.1000000
NODE_164272_length_303_cov_3.460784	151	191	530	1	40	0.0250000
NODE_164272_length_303_cov_3.460784	151	191	531	2	40	0.0500000
NODE_164272_length_303_cov_3.460784	151	191	532	1	40	0.0250000
NODE_164272_length_303_cov_3.460784	151	191	536	1	40	0.0250000
NODE_164272_length_303_cov_3.460784	151	191	542	1	40	0.0250000
NODE_164272_length_303_cov_3.460784	151	191	552	1	40	0.0250000
NODE_164272_length_303_cov_3.460784	151	191	564	1	40	0.0250000
NODE_164272_length_303_cov_3.460784	151	191	576	2	40	0.0500000
NODE_164272_length_303_cov_3.460784	151	191	594	1	40	0.0250000
NODE_164272_length_303_cov_3.460784	151	191	602	1	40	0.0250000
NODE_164272_length_303_cov_3.460784	151	191	616	1	40	0.0250000
NODE_164272_length_303_cov_3.460784	151	191	640	1	40	0.0250000
NODE_164272_length_303_cov_3.460784	151	191	642	2	40	0.0500000
NODE_164272_length_303_cov_3.460784	151	191	648	1	40	0.0250000
NODE_164272_length_303_cov_3.460784	151	191	649	1	40	0.0250000
NODE_164272_length_303_cov_3.460784	151	191	656	1	40	0.0250000
NODE_164272_length_303_cov_3.460784	151	191	657	1	40	0.0250000
NODE_164272_length_303_cov_3.460784	151	191	670	1	40	0.0250000
NODE_164272_length_303_cov_3.460784	151	191	672	1	40	0.0250000
NODE_164272_length_303_cov_3.460784	151	191	674	1	40	0.0250000
NODE_164272_length_303_cov_3.460784	151	191	680	1	40	0.0250000
NODE_164272_length_303_cov_3.460784	151	191	682	1	40	0.0250000
NODE_164272_length_303_cov_3.460784	151	191	684	1	40	0.0250000
NODE_164272_length_303_cov_3.460784	151	191	691	1	40	0.0250000
NODE_164272_length_303_cov_3.460784	151	191	692	1	40	0.0250000
NODE_164283_length_303_cov_3.352941	77	146	0	69	69	1.0000000
NODE_164433_length_303_cov_2.284314	78	158	0	1	80	0.0125000
NODE_164433_length_303_cov_2.284314	78	158	2	79	80	0.9875000
NODE_164433_length_303_cov_2.284314	215	295	0	80	80	1.0000000
NODE_164581_length_303_cov_1.848039	90	170	0	80	80	1.0000000
NODE_164581_length_303_cov_1.848039	143	223	0	80	80	1.0000000
NODE_164581_length_303_cov_1.848039	212	235	0	23	23	1.0000000
NODE_164668_length_303_cov_1.686275	62	88	0	26	26	1.0000000
NODE_164695_length_303_cov_1.583333	206	270	0	64	64	1.0000000
NODE_164800_length_303_cov_1.475490	155	221	0	3	66	0.0454545
NODE_164800_length_303_cov_1.475490	155	221	2	63	66	0.9545454
NODE_164846_length_303_cov_1.392157	135	213	4	78	78	1.0000000
NODE_164878_length_303_cov_1.318627	0	75	0	75	75	1.0000000
NODE_164974_length_303_cov_1.215686	278	297	0	19	19	1.0000000
NODE_165498_length_302_cov_10.852217	266	300	0	34	34	1.0000000
NODE_165502_length_302_cov_7.896552	46	131	0	85	85	1.0000000
NODE_165502_length_302_cov_7.896552	104	160	0	56	56	1.0000000
NODE_165505_length_302_cov_7.266010	135	191	2	56	56	1.0000000
NODE_165507_length_302_cov_7.216749	93	149	2	56	56	1.0000000
NODE_165507_length_302_cov_7.216749	155	226	2	68	71	0.9577465
NODE_165507_length_302_cov_7.216749	155	226	4	3	71	0.0422535
NODE_165517_length_302_cov_6.172414	179	243	0	64	64	1.0000000
NODE_165517_length_302_cov_6.172414	232	287	0	55	55	1.0000000
NODE_165528_length_302_cov_5.586207	221	293	2	5	72	0.0694444
NODE_165528_length_302_cov_5.586207	221	293	3	10	72	0.1388889
NODE_165528_length_302_cov_5.586207	221	293	4	6	72	0.0833333
NODE_165528_length_302_cov_5.586207	221	293	6	7	72	0.0972222
NODE_165528_length_302_cov_5.586207	221	293	8	13	72	0.1805556
NODE_165528_length_302_cov_5.586207	221	293	10	16	72	0.2222222
NODE_165528_length_302_cov_5.586207	221	293	12	9	72	0.1250000
NODE_165528_length_302_cov_5.586207	221	293	14	6	72	0.0833333
NODE_165641_length_302_cov_2.985222	104	186	4	4	82	0.0487805
NODE_165641_length_302_cov_2.985222	104	186	6	4	82	0.0487805
NODE_165641_length_302_cov_2.985222	104	186	8	21	82	0.2560976
NODE_165641_length_302_cov_2.985222	104	186	9	7	82	0.0853659
NODE_165641_length_302_cov_2.985222	104	186	10	41	82	0.5000000
NODE_165641_length_302_cov_2.985222	104	186	12	5	82	0.0609756
NODE_165848_length_302_cov_2.009852	12	34	0	22	22	1.0000000
NODE_165934_length_302_cov_1.758621	98	152	0	11	54	0.2037037
NODE_165934_length_302_cov_1.758621	98	152	2	16	54	0.2962963
NODE_165934_length_302_cov_1.758621	98	152	4	15	54	0.2777778
NODE_165934_length_302_cov_1.758621	98	152	8	12	54	0.2222222
NODE_165945_length_302_cov_1.758621	230	294	0	64	64	1.0000000
NODE_166007_length_302_cov_1.620690	172	232	2	4	60	0.0666667
NODE_166007_length_302_cov_1.620690	172	232	3	3	60	0.0500000
NODE_166007_length_302_cov_1.620690	172	232	4	50	60	0.8333333
NODE_166007_length_302_cov_1.620690	172	232	8	3	60	0.0500000
NODE_166007_length_302_cov_1.620690	225	277	0	1	52	0.0192308
NODE_166007_length_302_cov_1.620690	225	277	2	33	52	0.6346154
NODE_166007_length_302_cov_1.620690	225	277	4	18	52	0.3461539
NODE_166320_length_302_cov_1.172414	34	103	0	69	69	1.0000000
NODE_166381_length_302_cov_1.044335	54	130	0	49	76	0.6447368
NODE_166381_length_302_cov_1.044335	54	130	2	27	76	0.3552631
NODE_166617_length_302_cov_0.847291	94	172	0	8	78	0.1025641
NODE_166617_length_302_cov_0.847291	94	172	2	33	78	0.4230769
NODE_166617_length_302_cov_0.847291	94	172	4	22	78	0.2820513
NODE_166617_length_302_cov_0.847291	94	172	8	15	78	0.1923077
NODE_166617_length_302_cov_0.847291	94	172	0	8	78	0.1025641
NODE_166617_length_302_cov_0.847291	94	172	2	33	78	0.4230769
NODE_166617_length_302_cov_0.847291	94	172	4	22	78	0.2820513
NODE_166617_length_302_cov_0.847291	94	172	8	15	78	0.1923077
NODE_166617_length_302_cov_0.847291	103	172	2	32	69	0.4637681
NODE_166617_length_302_cov_0.847291	103	172	4	22	69	0.3188406
NODE_166617_length_302_cov_0.847291	103	172	8	15	69	0.2173913
NODE_166638_length_302_cov_0.807882	97	177	0	80	80	1.0000000
NODE_166819_length_301_cov_6.960396	268	299	0	31	31	1.0000000
NODE_166827_length_301_cov_6.148515	214	283	0	69	69	1.0000000
NODE_166889_length_301_cov_3.747525	116	196	4	13	80	0.1625000
NODE_166889_length_301_cov_3.747525	116	196	6	2	80	0.0250000
NODE_166889_length_301_cov_3.747525	116	196	8	17	80	0.2125000
NODE_166889_length_301_cov_3.747525	116	196	10	48	80	0.6000000
NODE_166904_length_301_cov_3.509901	217	277	3	8	60	0.1333333
NODE_166904_length_301_cov_3.509901	217	277	6	2	60	0.0333333
NODE_166904_length_301_cov_3.509901	217	277	11	4	60	0.0666667
NODE_166904_length_301_cov_3.509901	217	277	13	2	60	0.0333333
NODE_166904_length_301_cov_3.509901	217	277	15	4	60	0.0666667
NODE_166904_length_301_cov_3.509901	217	277	17	3	60	0.0500000
NODE_166904_length_301_cov_3.509901	217	277	19	3	60	0.0500000
NODE_166904_length_301_cov_3.509901	217	277	20	4	60	0.0666667
NODE_166904_length_301_cov_3.509901	217	277	22	2	60	0.0333333
NODE_166904_length_301_cov_3.509901	217	277	24	1	60	0.0166667
NODE_166904_length_301_cov_3.509901	217	277	25	1	60	0.0166667
NODE_166904_length_301_cov_3.509901	217	277	26	3	60	0.0500000
NODE_166904_length_301_cov_3.509901	217	277	28	1	60	0.0166667
NODE_166904_length_301_cov_3.509901	217	277	30	4	60	0.0666667
NODE_166904_length_301_cov_3.509901	217	277	32	3	60	0.0500000
NODE_166904_length_301_cov_3.509901	217	277	35	1	60	0.0166667
NODE_166904_length_301_cov_3.509901	217	277	39	3	60	0.0500000
NODE_166904_length_301_cov_3.509901	217	277	42	1	60	0.0166667
NODE_166904_length_301_cov_3.509901	217	277	43	1	60	0.0166667
NODE_166904_length_301_cov_3.509901	217	277	47	1	60	0.0166667
NODE_166904_length_301_cov_3.509901	217	277	53	1	60	0.0166667
NODE_166904_length_301_cov_3.509901	217	277	59	1	60	0.0166667
NODE_166904_length_301_cov_3.509901	217	277	63	1	60	0.0166667
NODE_166904_length_301_cov_3.509901	217	277	67	1	60	0.0166667
NODE_166904_length_301_cov_3.509901	217	277	71	1	60	0.0166667
NODE_166904_length_301_cov_3.509901	217	277	73	3	60	0.0500000
NODE_166993_length_301_cov_2.653465	133	213	4	61	80	0.7625000
NODE_166993_length_301_cov_2.653465	133	213	6	19	80	0.2375000
NODE_167126_length_301_cov_2.084158	178	258	26	1	80	0.0125000
NODE_167126_length_301_cov_2.084158	178	258	28	1	80	0.0125000
NODE_167126_length_301_cov_2.084158	178	258	30	2	80	0.0250000
NODE_167126_length_301_cov_2.084158	178	258	34	3	80	0.0375000
NODE_167126_length_301_cov_2.084158	178	258	40	1	80	0.0125000
NODE_167126_length_301_cov_2.084158	178	258	42	1	80	0.0125000
NODE_167126_length_301_cov_2.084158	178	258	44	5	80	0.0625000
NODE_167126_length_301_cov_2.084158	178	258	56	2	80	0.0250000
NODE_167126_length_301_cov_2.084158	178	258	58	5	80	0.0625000
NODE_167126_length_301_cov_2.084158	178	258	60	3	80	0.0375000
NODE_167126_length_301_cov_2.084158	178	258	62	31	80	0.3875000
NODE_167126_length_301_cov_2.084158	178	258	64	25	80	0.3125000
NODE_167215_length_301_cov_1.831683	111	175	0	64	64	1.0000000
NODE_167215_length_301_cov_1.831683	164	228	0	55	64	0.8593750
NODE_167215_length_301_cov_1.831683	164	228	2	9	64	0.1406250
NODE_167308_length_301_cov_1.603960	173	233	0	60	60	1.0000000
NODE_167313_length_301_cov_1.584158	30	108	0	18	78	0.2307692
NODE_167313_length_301_cov_1.584158	30	108	1	2	78	0.0256410
NODE_167313_length_301_cov_1.584158	30	108	2	58	78	0.7435898
NODE_167434_length_301_cov_1.470297	90	165	0	75	75	1.0000000
NODE_167508_length_301_cov_1.326733	175	247	6	1	72	0.0138889
NODE_167508_length_301_cov_1.326733	175	247	8	1	72	0.0138889
NODE_167508_length_301_cov_1.326733	175	247	10	29	72	0.4027778
NODE_167508_length_301_cov_1.326733	175	247	12	41	72	0.5694444
NODE_167612_length_301_cov_1.247525	29	73	0	44	44	1.0000000
NODE_167642_length_301_cov_1.183168	123	203	0	23	80	0.2875000
NODE_167642_length_301_cov_1.183168	123	203	2	2	80	0.0250000
NODE_167642_length_301_cov_1.183168	123	203	4	7	80	0.0875000
NODE_167642_length_301_cov_1.183168	123	203	6	9	80	0.1125000
NODE_167642_length_301_cov_1.183168	123	203	10	5	80	0.0625000
NODE_167642_length_301_cov_1.183168	123	203	14	8	80	0.1000000
NODE_167642_length_301_cov_1.183168	123	203	16	6	80	0.0750000
NODE_167642_length_301_cov_1.183168	123	203	18	1	80	0.0125000
NODE_167642_length_301_cov_1.183168	123	203	20	19	80	0.2375000
NODE_167659_length_301_cov_1.163366	10	83	0	73	73	1.0000000
NODE_167659_length_301_cov_1.163366	91	121	0	30	30	1.0000000
NODE_167668_length_301_cov_1.148515	161	209	0	48	48	1.0000000
NODE_167880_length_301_cov_0.980198	242	297	0	55	55	1.0000000
NODE_167891_length_301_cov_0.960396	22	63	0	41	41	1.0000000
NODE_168253_length_300_cov_3.402985	44	124	0	21	80	0.2625000
NODE_168253_length_300_cov_3.402985	44	124	4	17	80	0.2125000
NODE_168253_length_300_cov_3.402985	44	124	6	16	80	0.2000000
NODE_168253_length_300_cov_3.402985	44	124	8	26	80	0.3250000
NODE_168253_length_300_cov_3.402985	97	177	6	15	80	0.1875000
NODE_168253_length_300_cov_3.402985	97	177	8	41	80	0.5125000
NODE_168253_length_300_cov_3.402985	97	177	10	9	80	0.1125000
NODE_168253_length_300_cov_3.402985	97	177	12	15	80	0.1875000
NODE_168253_length_300_cov_3.402985	173	254	6	36	81	0.4444444
NODE_168253_length_300_cov_3.402985	173	254	8	6	81	0.0740741
NODE_168253_length_300_cov_3.402985	173	254	10	39	81	0.4814815
NODE_168253_length_300_cov_3.402985	233	300	0	1	67	0.0149254
NODE_168253_length_300_cov_3.402985	233	300	2	1	67	0.0149254
NODE_168253_length_300_cov_3.402985	233	300	4	7	67	0.1044776
NODE_168253_length_300_cov_3.402985	233	300	6	1	67	0.0149254
NODE_168253_length_300_cov_3.402985	233	300	8	1	67	0.0149254
NODE_168253_length_300_cov_3.402985	233	300	10	56	67	0.8358209
NODE_168265_length_300_cov_3.298507	18	98	0	80	80	1.0000000
NODE_168360_length_300_cov_2.597015	110	182	2	1	72	0.0138889
NODE_168360_length_300_cov_2.597015	110	182	8	4	72	0.0555556
NODE_168360_length_300_cov_2.597015	110	182	10	2	72	0.0277778
NODE_168360_length_300_cov_2.597015	110	182	12	65	72	0.9027778
NODE_168363_length_300_cov_2.572139	28	102	2	1	74	0.0135135
NODE_168363_length_300_cov_2.572139	28	102	3	10	74	0.1351351
NODE_168363_length_300_cov_2.572139	28	102	4	9	74	0.1216216
NODE_168363_length_300_cov_2.572139	28	102	9	2	74	0.0270270
NODE_168363_length_300_cov_2.572139	28	102	10	6	74	0.0810811
NODE_168363_length_300_cov_2.572139	28	102	12	22	74	0.2972973
NODE_168363_length_300_cov_2.572139	28	102	16	1	74	0.0135135
NODE_168363_length_300_cov_2.572139	28	102	18	1	74	0.0135135
NODE_168363_length_300_cov_2.572139	28	102	20	2	74	0.0270270
NODE_168363_length_300_cov_2.572139	28	102	24	3	74	0.0405405
NODE_168363_length_300_cov_2.572139	28	102	26	1	74	0.0135135
NODE_168363_length_300_cov_2.572139	28	102	32	3	74	0.0405405
NODE_168363_length_300_cov_2.572139	28	102	34	2	74	0.0270270
NODE_168363_length_300_cov_2.572139	28	102	36	5	74	0.0675676
NODE_168363_length_300_cov_2.572139	28	102	38	6	74	0.0810811
NODE_168363_length_300_cov_2.572139	75	141	12	3	66	0.0454545
NODE_168363_length_300_cov_2.572139	75	141	16	1	66	0.0151515
NODE_168363_length_300_cov_2.572139	75	141	18	1	66	0.0151515
NODE_168363_length_300_cov_2.572139	75	141	20	2	66	0.0303030
NODE_168363_length_300_cov_2.572139	75	141	24	3	66	0.0454545
NODE_168363_length_300_cov_2.572139	75	141	26	1	66	0.0151515
NODE_168363_length_300_cov_2.572139	75	141	32	3	66	0.0454545
NODE_168363_length_300_cov_2.572139	75	141	34	2	66	0.0303030
NODE_168363_length_300_cov_2.572139	75	141	36	6	66	0.0909091
NODE_168363_length_300_cov_2.572139	75	141	38	9	66	0.1363636
NODE_168363_length_300_cov_2.572139	75	141	40	35	66	0.5303030
NODE_168402_length_300_cov_2.417910	0	44	0	44	44	1.0000000
NODE_168459_length_300_cov_2.174129	117	197	0	13	80	0.1625000
NODE_168459_length_300_cov_2.174129	117	197	1	1	80	0.0125000
NODE_168459_length_300_cov_2.174129	117	197	2	49	80	0.6125000
NODE_168459_length_300_cov_2.174129	117	197	4	9	80	0.1125000
NODE_168459_length_300_cov_2.174129	117	197	6	2	80	0.0250000
NODE_168459_length_300_cov_2.174129	117	197	8	1	80	0.0125000
NODE_168459_length_300_cov_2.174129	117	197	12	5	80	0.0625000
NODE_168459_length_300_cov_2.174129	170	250	2	22	80	0.2750000
NODE_168459_length_300_cov_2.174129	170	250	4	17	80	0.2125000
NODE_168459_length_300_cov_2.174129	170	250	6	4	80	0.0500000
NODE_168459_length_300_cov_2.174129	170	250	10	1	80	0.0125000
NODE_168459_length_300_cov_2.174129	170	250	12	1	80	0.0125000
NODE_168459_length_300_cov_2.174129	170	250	30	1	80	0.0125000
NODE_168459_length_300_cov_2.174129	170	250	36	1	80	0.0125000
NODE_168459_length_300_cov_2.174129	170	250	40	1	80	0.0125000
NODE_168459_length_300_cov_2.174129	170	250	44	1	80	0.0125000
NODE_168459_length_300_cov_2.174129	170	250	50	2	80	0.0250000
NODE_168459_length_300_cov_2.174129	170	250	52	5	80	0.0625000
NODE_168459_length_300_cov_2.174129	170	250	58	24	80	0.3000000
NODE_168459_length_300_cov_2.174129	216	296	30	1	80	0.0125000
NODE_168459_length_300_cov_2.174129	216	296	33	1	80	0.0125000
NODE_168459_length_300_cov_2.174129	216	296	36	1	80	0.0125000
NODE_168459_length_300_cov_2.174129	216	296	40	1	80	0.0125000
NODE_168459_length_300_cov_2.174129	216	296	44	1	80	0.0125000
NODE_168459_length_300_cov_2.174129	216	296	48	2	80	0.0250000
NODE_168459_length_300_cov_2.174129	216	296	50	5	80	0.0625000
NODE_168459_length_300_cov_2.174129	216	296	52	6	80	0.0750000
NODE_168459_length_300_cov_2.174129	216	296	54	1	80	0.0125000
NODE_168459_length_300_cov_2.174129	216	296	56	2	80	0.0250000
NODE_168459_length_300_cov_2.174129	216	296	58	59	80	0.7375000
NODE_168462_length_300_cov_2.164179	122	141	0	19	19	1.0000000
NODE_168479_length_300_cov_2.079602	127	207	2	24	80	0.3000000
NODE_168479_length_300_cov_2.079602	127	207	4	56	80	0.7000000
NODE_168479_length_300_cov_2.079602	203	273	0	59	70	0.8428571
NODE_168479_length_300_cov_2.079602	203	273	2	11	70	0.1571429
NODE_168541_length_300_cov_1.965174	15	86	0	71	71	1.0000000
NODE_168656_length_300_cov_1.731343	31	88	19	3	57	0.0526316
NODE_168656_length_300_cov_1.731343	31	88	21	6	57	0.1052632
NODE_168656_length_300_cov_1.731343	31	88	22	5	57	0.0877193
NODE_168656_length_300_cov_1.731343	31	88	24	43	57	0.7543859
NODE_168906_length_300_cov_1.268657	62	98	0	36	36	1.0000000
NODE_168906_length_300_cov_1.268657	151	186	0	35	35	1.0000000
NODE_169014_length_300_cov_1.104478	86	165	2	3	79	0.0379747
NODE_169014_length_300_cov_1.104478	86	165	6	21	79	0.2658228
NODE_169014_length_300_cov_1.104478	86	165	8	6	79	0.0759494
NODE_169014_length_300_cov_1.104478	86	165	10	49	79	0.6202531
NODE_169053_length_300_cov_1.029851	110	177	0	20	67	0.2985075
NODE_169053_length_300_cov_1.029851	110	177	2	47	67	0.7014925
NODE_169053_length_300_cov_1.029851	120	177	0	20	57	0.3508772
NODE_169053_length_300_cov_1.029851	120	177	2	37	57	0.6491228
NODE_169378_length_300_cov_0.716418	191	210	0	19	19	1.0000000
NODE_169528_length_299_cov_4.435000	48	128	10	3	80	0.0375000
NODE_169528_length_299_cov_4.435000	48	128	12	59	80	0.7375000
NODE_169528_length_299_cov_4.435000	48	128	14	18	80	0.2250000
NODE_169528_length_299_cov_4.435000	101	167	6	12	66	0.1818182
NODE_169528_length_299_cov_4.435000	101	167	8	9	66	0.1363636
NODE_169528_length_299_cov_4.435000	101	167	10	14	66	0.2121212
NODE_169528_length_299_cov_4.435000	101	167	12	31	66	0.4696970
NODE_169567_length_299_cov_3.780000	114	181	2	67	67	1.0000000
NODE_169631_length_299_cov_3.095000	0	73	0	73	73	1.0000000
NODE_169631_length_299_cov_3.095000	0	20	0	20	20	1.0000000
NODE_169725_length_299_cov_2.495000	46	126	0	13	80	0.1625000
NODE_169725_length_299_cov_2.495000	46	126	2	67	80	0.8375000
NODE_169725_length_299_cov_2.495000	99	179	0	66	80	0.8250000
NODE_169725_length_299_cov_2.495000	99	179	2	14	80	0.1750000
NODE_169769_length_299_cov_2.275000	127	192	0	65	65	1.0000000
NODE_169781_length_299_cov_2.250000	72	135	0	1	63	0.0158730
NODE_169781_length_299_cov_2.250000	72	135	2	5	63	0.0793651
NODE_169781_length_299_cov_2.250000	72	135	4	57	63	0.9047619
NODE_169781_length_299_cov_2.250000	108	188	0	13	80	0.1625000
NODE_169781_length_299_cov_2.250000	108	188	2	3	80	0.0375000
NODE_169781_length_299_cov_2.250000	108	188	4	64	80	0.8000000
NODE_169811_length_299_cov_2.090000	25	105	0	50	80	0.6250000
NODE_169811_length_299_cov_2.090000	25	105	2	30	80	0.3750000
NODE_169888_length_299_cov_1.955000	173	214	20	1	41	0.0243902
NODE_169888_length_299_cov_1.955000	173	214	22	3	41	0.0731707
NODE_169888_length_299_cov_1.955000	173	214	28	3	41	0.0731707
NODE_169888_length_299_cov_1.955000	173	214	32	4	41	0.0975610
NODE_169888_length_299_cov_1.955000	173	214	36	13	41	0.3170732
NODE_169888_length_299_cov_1.955000	173	214	38	4	41	0.0975610
NODE_169888_length_299_cov_1.955000	173	214	42	1	41	0.0243902
NODE_169888_length_299_cov_1.955000	173	214	44	2	41	0.0487805
NODE_169888_length_299_cov_1.955000	173	214	46	1	41	0.0243902
NODE_169888_length_299_cov_1.955000	173	214	52	2	41	0.0487805
NODE_169888_length_299_cov_1.955000	173	214	54	6	41	0.1463415
NODE_169888_length_299_cov_1.955000	173	214	56	1	41	0.0243902
NODE_169888_length_299_cov_1.955000	187	227	36	10	40	0.2500000
NODE_169888_length_299_cov_1.955000	187	227	38	4	40	0.1000000
NODE_169888_length_299_cov_1.955000	187	227	42	1	40	0.0250000
NODE_169888_length_299_cov_1.955000	187	227	44	2	40	0.0500000
NODE_169888_length_299_cov_1.955000	187	227	46	1	40	0.0250000
NODE_169888_length_299_cov_1.955000	187	227	52	2	40	0.0500000
NODE_169888_length_299_cov_1.955000	187	227	54	6	40	0.1500000
NODE_169888_length_299_cov_1.955000	187	227	56	4	40	0.1000000
NODE_169888_length_299_cov_1.955000	187	227	60	8	40	0.2000000
NODE_169888_length_299_cov_1.955000	187	227	62	2	40	0.0500000
NODE_169916_length_299_cov_1.885000	29	109	2	77	80	0.9625000
NODE_169916_length_299_cov_1.885000	29	109	4	3	80	0.0375000
NODE_169920_length_299_cov_1.880000	204	236	0	32	32	1.0000000
NODE_169938_length_299_cov_1.840000	154	190	0	36	36	1.0000000
NODE_169995_length_299_cov_1.710000	211	291	2	10	80	0.1250000
NODE_169995_length_299_cov_1.710000	211	291	4	70	80	0.8750000
NODE_170048_length_299_cov_1.550000	174	205	0	31	31	1.0000000
NODE_170501_length_299_cov_1.020000	42	115	0	14	73	0.1917808
NODE_170501_length_299_cov_1.020000	42	115	2	59	73	0.8082192
NODE_170546_length_299_cov_1.020000	132	175	0	43	43	1.0000000
NODE_170620_length_299_cov_0.935000	173	216	14	1	43	0.0232558
NODE_170620_length_299_cov_0.935000	173	216	16	19	43	0.4418605
NODE_170620_length_299_cov_0.935000	173	216	18	23	43	0.5348837
NODE_170691_length_299_cov_0.765000	86	128	0	42	42	1.0000000
NODE_170887_length_298_cov_20.894472	70	150	0	80	80	1.0000000
NODE_170887_length_298_cov_20.894472	123	203	0	80	80	1.0000000
NODE_170888_length_298_cov_13.859296	228	298	2	43	70	0.6142857
NODE_170888_length_298_cov_13.859296	228	298	4	2	70	0.0285714
NODE_170888_length_298_cov_13.859296	228	298	6	1	70	0.0142857
NODE_170888_length_298_cov_13.859296	228	298	10	2	70	0.0285714
NODE_170888_length_298_cov_13.859296	228	298	12	9	70	0.1285714
NODE_170888_length_298_cov_13.859296	228	298	16	2	70	0.0285714
NODE_170888_length_298_cov_13.859296	228	298	18	11	70	0.1571429
NODE_170909_length_298_cov_5.859296	1	65	0	16	64	0.2500000
NODE_170909_length_298_cov_5.859296	1	65	2	48	64	0.7500000
NODE_170909_length_298_cov_5.859296	38	118	2	61	80	0.7625000
NODE_170909_length_298_cov_5.859296	38	118	4	18	80	0.2250000
NODE_170909_length_298_cov_5.859296	38	118	12	1	80	0.0125000
NODE_170909_length_298_cov_5.859296	114	194	4	3	80	0.0375000
NODE_170909_length_298_cov_5.859296	114	194	8	13	80	0.1625000
NODE_170909_length_298_cov_5.859296	114	194	9	7	80	0.0875000
NODE_170909_length_298_cov_5.859296	114	194	10	51	80	0.6375000
NODE_170909_length_298_cov_5.859296	114	194	11	2	80	0.0250000
NODE_170909_length_298_cov_5.859296	114	194	12	4	80	0.0500000
NODE_170909_length_298_cov_5.859296	167	238	6	11	71	0.1549296
NODE_170909_length_298_cov_5.859296	167	238	8	13	71	0.1830986
NODE_170909_length_298_cov_5.859296	167	238	9	7	71	0.0985916
NODE_170909_length_298_cov_5.859296	167	238	10	8	71	0.1126761
NODE_170909_length_298_cov_5.859296	167	238	11	2	71	0.0281690
NODE_170909_length_298_cov_5.859296	167	238	12	29	71	0.4084507
NODE_170909_length_298_cov_5.859296	167	238	14	1	71	0.0140845
NODE_170964_length_298_cov_3.829146	80	160	43	15	80	0.1875000
NODE_170964_length_298_cov_3.829146	80	160	44	10	80	0.1250000
NODE_170964_length_298_cov_3.829146	80	160	45	2	80	0.0250000
NODE_170964_length_298_cov_3.829146	80	160	46	7	80	0.0875000
NODE_170964_length_298_cov_3.829146	80	160	47	3	80	0.0375000
NODE_170964_length_298_cov_3.829146	80	160	49	10	80	0.1250000
NODE_170964_length_298_cov_3.829146	80	160	50	4	80	0.0500000
NODE_170964_length_298_cov_3.829146	80	160	51	9	80	0.1125000
NODE_170964_length_298_cov_3.829146	80	160	53	4	80	0.0500000
NODE_170964_length_298_cov_3.829146	80	160	54	1	80	0.0125000
NODE_170964_length_298_cov_3.829146	80	160	55	4	80	0.0500000
NODE_170964_length_298_cov_3.829146	80	160	57	9	80	0.1125000
NODE_170964_length_298_cov_3.829146	80	160	59	2	80	0.0250000
NODE_170964_length_298_cov_3.829146	133	213	26	5	80	0.0625000
NODE_170964_length_298_cov_3.829146	133	213	28	1	80	0.0125000
NODE_170964_length_298_cov_3.829146	133	213	30	3	80	0.0375000
NODE_170964_length_298_cov_3.829146	133	213	31	1	80	0.0125000
NODE_170964_length_298_cov_3.829146	133	213	32	1	80	0.0125000
NODE_170964_length_298_cov_3.829146	133	213	34	1	80	0.0125000
NODE_170964_length_298_cov_3.829146	133	213	36	2	80	0.0250000
NODE_170964_length_298_cov_3.829146	133	213	38	6	80	0.0750000
NODE_170964_length_298_cov_3.829146	133	213	43	7	80	0.0875000
NODE_170964_length_298_cov_3.829146	133	213	44	6	80	0.0750000
NODE_170964_length_298_cov_3.829146	133	213	49	2	80	0.0250000
NODE_170964_length_298_cov_3.829146	133	213	50	10	80	0.1250000
NODE_170964_length_298_cov_3.829146	133	213	51	7	80	0.0875000
NODE_170964_length_298_cov_3.829146	133	213	52	5	80	0.0625000
NODE_170964_length_298_cov_3.829146	133	213	53	10	80	0.1250000
NODE_170964_length_298_cov_3.829146	133	213	54	11	80	0.1375000
NODE_170964_length_298_cov_3.829146	133	213	55	1	80	0.0125000
NODE_170964_length_298_cov_3.829146	133	213	56	1	80	0.0125000
NODE_170968_length_298_cov_3.733668	203	283	0	5	80	0.0625000
NODE_170968_length_298_cov_3.733668	203	283	2	21	80	0.2625000
NODE_170968_length_298_cov_3.733668	203	283	4	8	80	0.1000000
NODE_170968_length_298_cov_3.733668	203	283	6	46	80	0.5750000
NODE_170972_length_298_cov_3.673367	117	175	2	26	58	0.4482759
NODE_170972_length_298_cov_3.673367	117	175	4	32	58	0.5517241
NODE_171043_length_298_cov_2.924623	159	239	5	5	80	0.0625000
NODE_171043_length_298_cov_2.924623	159	239	8	1	80	0.0125000
NODE_171043_length_298_cov_2.924623	159	239	9	3	80	0.0375000
NODE_171043_length_298_cov_2.924623	159	239	10	11	80	0.1375000
NODE_171043_length_298_cov_2.924623	159	239	12	36	80	0.4500000
NODE_171043_length_298_cov_2.924623	159	239	14	20	80	0.2500000
NODE_171043_length_298_cov_2.924623	159	239	16	4	80	0.0500000
NODE_171043_length_298_cov_2.924623	212	265	4	4	53	0.0754717
NODE_171043_length_298_cov_2.924623	212	265	5	27	53	0.5094340
NODE_171043_length_298_cov_2.924623	212	265	8	1	53	0.0188679
NODE_171043_length_298_cov_2.924623	212	265	9	3	53	0.0566038
NODE_171043_length_298_cov_2.924623	212	265	10	3	53	0.0566038
NODE_171043_length_298_cov_2.924623	212	265	12	15	53	0.2830189
NODE_171047_length_298_cov_2.854271	50	120	0	70	70	1.0000000
NODE_171082_length_298_cov_2.663317	87	167	0	48	80	0.6000000
NODE_171082_length_298_cov_2.663317	87	167	2	28	80	0.3500000
NODE_171082_length_298_cov_2.663317	87	167	4	4	80	0.0500000
NODE_171082_length_298_cov_2.663317	140	192	0	52	52	1.0000000
NODE_171191_length_298_cov_2.201005	112	166	0	54	54	1.0000000
NODE_171210_length_298_cov_2.120603	135	166	0	11	31	0.3548387
NODE_171210_length_298_cov_2.120603	135	166	2	20	31	0.6451613
NODE_171226_length_298_cov_2.055276	69	132	0	63	63	1.0000000
NODE_171286_length_298_cov_2.025126	21	92	0	71	71	1.0000000
NODE_171356_length_298_cov_1.798995	0	67	0	19	67	0.2835821
NODE_171356_length_298_cov_1.798995	0	67	2	2	67	0.0298507
NODE_171356_length_298_cov_1.798995	0	67	4	46	67	0.6865672
NODE_171356_length_298_cov_1.798995	40	106	0	1	66	0.0151515
NODE_171356_length_298_cov_1.798995	40	106	2	7	66	0.1060606
NODE_171356_length_298_cov_1.798995	40	106	4	58	66	0.8787879
NODE_171391_length_298_cov_1.788945	140	197	0	57	57	1.0000000
NODE_171415_length_298_cov_1.733668	56	91	10	10	35	0.2857143
NODE_171415_length_298_cov_1.733668	56	91	16	20	35	0.5714286
NODE_171415_length_298_cov_1.733668	56	91	18	4	35	0.1142857
NODE_171415_length_298_cov_1.733668	56	91	20	1	35	0.0285714
NODE_171415_length_298_cov_1.733668	118	172	4	6	54	0.1111111
NODE_171415_length_298_cov_1.733668	118	172	6	10	54	0.1851852
NODE_171415_length_298_cov_1.733668	118	172	8	2	54	0.0370370
NODE_171415_length_298_cov_1.733668	118	172	10	1	54	0.0185185
NODE_171415_length_298_cov_1.733668	118	172	12	9	54	0.1666667
NODE_171415_length_298_cov_1.733668	118	172	14	23	54	0.4259259
NODE_171415_length_298_cov_1.733668	118	172	16	3	54	0.0555556
NODE_171505_length_298_cov_1.537688	101	154	0	6	53	0.1132075
NODE_171505_length_298_cov_1.537688	101	154	2	47	53	0.8867925
NODE_172083_length_298_cov_0.829146	34	96	0	62	62	1.0000000
NODE_172330_length_297_cov_6.525253	100	122	0	22	22	1.0000000
NODE_172352_length_297_cov_4.888889	150	218	4	4	68	0.0588235
NODE_172352_length_297_cov_4.888889	150	218	6	7	68	0.1029412
NODE_172352_length_297_cov_4.888889	150	218	8	49	68	0.7205882
NODE_172352_length_297_cov_4.888889	150	218	10	8	68	0.1176471
NODE_172356_length_297_cov_4.671717	56	120	0	64	64	1.0000000
NODE_172422_length_297_cov_3.338384	96	176	0	33	80	0.4125000
NODE_172422_length_297_cov_3.338384	96	176	2	47	80	0.5875000
NODE_172422_length_297_cov_3.338384	149	198	0	48	49	0.9795918
NODE_172422_length_297_cov_3.338384	149	198	2	1	49	0.0204082
NODE_172447_length_297_cov_3.040404	0	55	0	55	55	1.0000000
NODE_172447_length_297_cov_3.040404	14	55	0	41	41	1.0000000
NODE_172447_length_297_cov_3.040404	65	119	0	54	54	1.0000000
NODE_172574_length_297_cov_2.308081	8	70	0	62	62	1.0000000
NODE_172606_length_297_cov_2.196970	219	259	55	1	40	0.0250000
NODE_172606_length_297_cov_2.196970	219	259	56	1	40	0.0250000
NODE_172606_length_297_cov_2.196970	219	259	57	1	40	0.0250000
NODE_172606_length_297_cov_2.196970	219	259	61	3	40	0.0750000
NODE_172606_length_297_cov_2.196970	219	259	63	1	40	0.0250000
NODE_172606_length_297_cov_2.196970	219	259	65	2	40	0.0500000
NODE_172606_length_297_cov_2.196970	219	259	69	1	40	0.0250000
NODE_172606_length_297_cov_2.196970	219	259	71	1	40	0.0250000
NODE_172606_length_297_cov_2.196970	219	259	77	1	40	0.0250000
NODE_172606_length_297_cov_2.196970	219	259	79	2	40	0.0500000
NODE_172606_length_297_cov_2.196970	219	259	81	1	40	0.0250000
NODE_172606_length_297_cov_2.196970	219	259	83	2	40	0.0500000
NODE_172606_length_297_cov_2.196970	219	259	85	2	40	0.0500000
NODE_172606_length_297_cov_2.196970	219	259	87	1	40	0.0250000
NODE_172606_length_297_cov_2.196970	219	259	89	4	40	0.1000000
NODE_172606_length_297_cov_2.196970	219	259	90	1	40	0.0250000
NODE_172606_length_297_cov_2.196970	219	259	92	3	40	0.0750000
NODE_172606_length_297_cov_2.196970	219	259	94	12	40	0.3000000
NODE_172629_length_297_cov_2.106061	81	161	2	42	80	0.5250000
NODE_172629_length_297_cov_2.106061	81	161	4	14	80	0.1750000
NODE_172629_length_297_cov_2.106061	81	161	6	24	80	0.3000000
NODE_172629_length_297_cov_2.106061	134	178	4	11	44	0.2500000
NODE_172629_length_297_cov_2.106061	134	178	6	33	44	0.7500000
NODE_172668_length_297_cov_2.060606	46	76	0	30	30	1.0000000
NODE_172697_length_297_cov_2.010101	9	85	2	76	76	1.0000000
NODE_172783_length_297_cov_1.777778	168	208	11	3	40	0.0750000
NODE_172783_length_297_cov_1.777778	168	208	13	4	40	0.1000000
NODE_172783_length_297_cov_1.777778	168	208	15	8	40	0.2000000
NODE_172783_length_297_cov_1.777778	168	208	16	4	40	0.1000000
NODE_172783_length_297_cov_1.777778	168	208	17	21	40	0.5250000
NODE_172855_length_297_cov_1.595960	175	255	0	6	80	0.0750000
NODE_172855_length_297_cov_1.595960	175	255	2	17	80	0.2125000
NODE_172855_length_297_cov_1.595960	175	255	4	4	80	0.0500000
NODE_172855_length_297_cov_1.595960	175	255	6	1	80	0.0125000
NODE_172855_length_297_cov_1.595960	175	255	8	1	80	0.0125000
NODE_172855_length_297_cov_1.595960	175	255	10	1	80	0.0125000
NODE_172855_length_297_cov_1.595960	175	255	12	3	80	0.0375000
NODE_172855_length_297_cov_1.595960	175	255	14	27	80	0.3375000
NODE_172855_length_297_cov_1.595960	175	255	16	20	80	0.2500000
NODE_172862_length_297_cov_1.570707	100	177	0	77	77	1.0000000
NODE_172863_length_297_cov_1.570707	194	275	0	81	81	1.0000000
NODE_173063_length_297_cov_1.338384	140	199	0	59	59	1.0000000
NODE_173136_length_297_cov_1.277778	39	115	0	76	76	1.0000000
NODE_173176_length_297_cov_1.196970	7	87	0	80	80	1.0000000
NODE_173176_length_297_cov_1.196970	60	116	0	56	56	1.0000000
NODE_173345_length_297_cov_1.030303	0	33	0	33	33	1.0000000
NODE_173467_length_297_cov_0.888889	109	172	0	63	63	1.0000000
NODE_173520_length_297_cov_0.782828	24	104	0	80	80	1.0000000
NODE_173708_length_296_cov_41.390863	189	260	4	71	71	1.0000000
NODE_173709_length_296_cov_34.776650	214	294	0	80	80	1.0000000
NODE_173758_length_296_cov_4.243655	14	54	0	40	40	1.0000000
NODE_173773_length_296_cov_3.954315	120	200	0	80	80	1.0000000
NODE_173787_length_296_cov_3.736041	6	46	0	40	40	1.0000000
NODE_173797_length_296_cov_3.619289	193	251	0	58	58	1.0000000
NODE_173797_length_296_cov_3.619289	246	296	0	50	50	1.0000000
NODE_173859_length_296_cov_3.015228	177	257	0	80	80	1.0000000
NODE_173992_length_296_cov_2.309645	5	77	5	3	72	0.0416667
NODE_173992_length_296_cov_2.309645	5	77	7	5	72	0.0694444
NODE_173992_length_296_cov_2.309645	5	77	9	2	72	0.0277778
NODE_173992_length_296_cov_2.309645	5	77	11	5	72	0.0694444
NODE_173992_length_296_cov_2.309645	5	77	13	3	72	0.0416667
NODE_173992_length_296_cov_2.309645	5	77	15	1	72	0.0138889
NODE_173992_length_296_cov_2.309645	5	77	16	1	72	0.0138889
NODE_173992_length_296_cov_2.309645	5	77	18	2	72	0.0277778
NODE_173992_length_296_cov_2.309645	5	77	20	3	72	0.0416667
NODE_173992_length_296_cov_2.309645	5	77	22	1	72	0.0138889
NODE_173992_length_296_cov_2.309645	5	77	26	20	72	0.2777778
NODE_173992_length_296_cov_2.309645	5	77	28	26	72	0.3611111
NODE_173992_length_296_cov_2.309645	50	130	26	1	80	0.0125000
NODE_173992_length_296_cov_2.309645	50	130	28	27	80	0.3375000
NODE_173992_length_296_cov_2.309645	50	130	30	5	80	0.0625000
NODE_173992_length_296_cov_2.309645	50	130	32	4	80	0.0500000
NODE_173992_length_296_cov_2.309645	50	130	34	2	80	0.0250000
NODE_173992_length_296_cov_2.309645	50	130	36	12	80	0.1500000
NODE_173992_length_296_cov_2.309645	50	130	38	8	80	0.1000000
NODE_173992_length_296_cov_2.309645	50	130	40	21	80	0.2625000
NODE_174040_length_296_cov_2.081218	90	139	0	49	49	1.0000000
NODE_174167_length_296_cov_1.807107	199	246	0	47	47	1.0000000
NODE_174167_length_296_cov_1.807107	219	296	0	77	77	1.0000000
NODE_174213_length_296_cov_1.670051	28	103	2	51	75	0.6800000
NODE_174213_length_296_cov_1.670051	28	103	4	24	75	0.3200000
NODE_174274_length_296_cov_1.553299	102	179	2	77	77	1.0000000
NODE_174274_length_296_cov_1.553299	160	179	2	19	19	1.0000000
NODE_174438_length_296_cov_1.319797	82	162	0	15	80	0.1875000
NODE_174438_length_296_cov_1.319797	82	162	2	20	80	0.2500000
NODE_174438_length_296_cov_1.319797	82	162	4	8	80	0.1000000
NODE_174438_length_296_cov_1.319797	82	162	6	37	80	0.4625000
NODE_174438_length_296_cov_1.319797	135	205	6	42	70	0.6000000
NODE_174438_length_296_cov_1.319797	135	205	8	1	70	0.0142857
NODE_174438_length_296_cov_1.319797	135	205	10	27	70	0.3857143
NODE_174545_length_296_cov_1.258883	222	280	0	4	58	0.0689655
NODE_174545_length_296_cov_1.258883	222	280	2	54	58	0.9310345
NODE_174554_length_296_cov_1.238579	90	147	0	25	57	0.4385965
NODE_174554_length_296_cov_1.238579	90	147	2	32	57	0.5614035
NODE_174614_length_296_cov_1.116751	130	169	6	2	39	0.0512821
NODE_174614_length_296_cov_1.116751	130	169	9	2	39	0.0512821
NODE_174614_length_296_cov_1.116751	130	169	11	5	39	0.1282051
NODE_174614_length_296_cov_1.116751	130	169	13	2	39	0.0512821
NODE_174614_length_296_cov_1.116751	130	169	15	10	39	0.2564103
NODE_174614_length_296_cov_1.116751	130	169	17	10	39	0.2564103
NODE_174614_length_296_cov_1.116751	130	169	19	8	39	0.2051282
NODE_175210_length_295_cov_4.290816	2	70	0	68	68	1.0000000
NODE_175210_length_295_cov_4.290816	55	123	0	68	68	1.0000000
NODE_175220_length_295_cov_4.040816	119	165	6	46	46	1.0000000
NODE_175258_length_295_cov_3.576531	130	198	0	62	68	0.9117647
NODE_175258_length_295_cov_3.576531	130	198	4	6	68	0.0882353
NODE_175324_length_295_cov_2.918367	0	77	0	55	77	0.7142857
NODE_175324_length_295_cov_2.918367	0	77	4	22	77	0.2857143
NODE_175416_length_295_cov_2.454082	216	277	2	61	61	1.0000000
NODE_175475_length_295_cov_2.224490	11	91	2	5	80	0.0625000
NODE_175475_length_295_cov_2.224490	11	91	4	7	80	0.0875000
NODE_175475_length_295_cov_2.224490	11	91	6	8	80	0.1000000
NODE_175475_length_295_cov_2.224490	11	91	10	60	80	0.7500000
NODE_175483_length_295_cov_2.183673	93	151	5	2	58	0.0344828
NODE_175483_length_295_cov_2.183673	93	151	6	5	58	0.0862069
NODE_175483_length_295_cov_2.183673	93	151	7	2	58	0.0344828
NODE_175483_length_295_cov_2.183673	93	151	8	3	58	0.0517241
NODE_175483_length_295_cov_2.183673	93	151	9	1	58	0.0172414
NODE_175483_length_295_cov_2.183673	93	151	11	1	58	0.0172414
NODE_175483_length_295_cov_2.183673	93	151	12	1	58	0.0172414
NODE_175483_length_295_cov_2.183673	93	151	14	4	58	0.0689655
NODE_175483_length_295_cov_2.183673	93	151	16	2	58	0.0344828
NODE_175483_length_295_cov_2.183673	93	151	18	3	58	0.0517241
NODE_175483_length_295_cov_2.183673	93	151	20	1	58	0.0172414
NODE_175483_length_295_cov_2.183673	93	151	21	3	58	0.0517241
NODE_175483_length_295_cov_2.183673	93	151	22	13	58	0.2241379
NODE_175483_length_295_cov_2.183673	93	151	34	3	58	0.0517241
NODE_175483_length_295_cov_2.183673	93	151	35	12	58	0.2068966
NODE_175483_length_295_cov_2.183673	93	151	36	2	58	0.0344828
NODE_175483_length_295_cov_2.183673	124	204	22	10	80	0.1250000
NODE_175483_length_295_cov_2.183673	124	204	32	12	80	0.1500000
NODE_175483_length_295_cov_2.183673	124	204	34	19	80	0.2375000
NODE_175483_length_295_cov_2.183673	124	204	35	12	80	0.1500000
NODE_175483_length_295_cov_2.183673	124	204	36	27	80	0.3375000
NODE_175597_length_295_cov_1.867347	191	239	10	1	48	0.0208333
NODE_175597_length_295_cov_1.867347	191	239	12	47	48	0.9791667
NODE_175598_length_295_cov_1.862245	225	285	0	4	60	0.0666667
NODE_175598_length_295_cov_1.862245	225	285	2	56	60	0.9333333
NODE_175721_length_295_cov_1.596939	173	254	4	4	81	0.0493827
NODE_175721_length_295_cov_1.596939	173	254	6	77	81	0.9506173
NODE_175804_length_295_cov_1.520408	217	282	0	12	65	0.1846154
NODE_175804_length_295_cov_1.520408	217	282	2	8	65	0.1230769
NODE_175804_length_295_cov_1.520408	217	282	3	3	65	0.0461538
NODE_175804_length_295_cov_1.520408	217	282	4	3	65	0.0461538
NODE_175804_length_295_cov_1.520408	217	282	8	16	65	0.2461538
NODE_175804_length_295_cov_1.520408	217	282	10	17	65	0.2615385
NODE_175804_length_295_cov_1.520408	217	282	12	6	65	0.0923077
NODE_175930_length_295_cov_1.301020	99	121	0	22	22	1.0000000
NODE_176250_length_295_cov_0.938776	200	247	0	47	47	1.0000000
NODE_176367_length_295_cov_0.780612	24	44	0	20	20	1.0000000
NODE_176436_length_295_cov_0.724490	6	87	0	81	81	1.0000000
NODE_176436_length_295_cov_0.724490	83	163	0	80	80	1.0000000
NODE_176436_length_295_cov_0.724490	136	216	0	80	80	1.0000000
NODE_176547_length_294_cov_83.882051	143	173	0	30	30	1.0000000
NODE_176547_length_294_cov_83.882051	209	239	0	30	30	1.0000000
NODE_176549_length_294_cov_50.589744	187	258	11	3	71	0.0422535
NODE_176549_length_294_cov_50.589744	187	258	13	39	71	0.5492958
NODE_176549_length_294_cov_50.589744	187	258	17	5	71	0.0704225
NODE_176549_length_294_cov_50.589744	187	258	18	18	71	0.2535211
NODE_176549_length_294_cov_50.589744	187	258	19	6	71	0.0845070
NODE_176561_length_294_cov_6.676923	61	138	0	77	77	1.0000000
NODE_176596_length_294_cov_4.538462	127	214	2	27	87	0.3103448
NODE_176596_length_294_cov_4.538462	127	214	4	19	87	0.2183908
NODE_176596_length_294_cov_4.538462	127	214	6	41	87	0.4712644
NODE_176598_length_294_cov_4.512821	218	248	0	30	30	1.0000000
NODE_176600_length_294_cov_4.497436	159	200	0	41	41	1.0000000
NODE_176697_length_294_cov_2.953846	114	194	0	14	80	0.1750000
NODE_176697_length_294_cov_2.953846	114	194	2	3	80	0.0375000
NODE_176697_length_294_cov_2.953846	114	194	4	63	80	0.7875000
NODE_176727_length_294_cov_2.764103	103	183	0	80	80	1.0000000
NODE_176727_length_294_cov_2.764103	156	236	0	80	80	1.0000000
NODE_176728_length_294_cov_2.764103	224	282	0	53	58	0.9137931
NODE_176728_length_294_cov_2.764103	224	282	2	1	58	0.0172414
NODE_176728_length_294_cov_2.764103	224	282	8	4	58	0.0689655
NODE_176728_length_294_cov_2.764103	225	277	0	48	52	0.9230769
NODE_176728_length_294_cov_2.764103	225	277	2	1	52	0.0192308
NODE_176728_length_294_cov_2.764103	225	277	8	3	52	0.0576923
NODE_176735_length_294_cov_2.697436	204	261	4	57	57	1.0000000
NODE_176735_length_294_cov_2.697436	234	294	2	3	60	0.0500000
NODE_176735_length_294_cov_2.697436	234	294	4	57	60	0.9500000
NODE_176779_length_294_cov_2.517949	23	85	2	61	62	0.9838710
NODE_176779_length_294_cov_2.517949	23	85	4	1	62	0.0161290
NODE_176816_length_294_cov_2.353846	129	167	8	2	38	0.0526316
NODE_176816_length_294_cov_2.353846	129	167	10	36	38	0.9473684
NODE_176833_length_294_cov_2.338462	133	213	2	16	80	0.2000000
NODE_176833_length_294_cov_2.338462	133	213	3	14	80	0.1750000
NODE_176833_length_294_cov_2.338462	133	213	4	16	80	0.2000000
NODE_176833_length_294_cov_2.338462	133	213	10	17	80	0.2125000
NODE_176833_length_294_cov_2.338462	133	213	12	17	80	0.2125000
NODE_176943_length_294_cov_2.046154	219	269	0	50	50	1.0000000
NODE_176957_length_294_cov_2.010256	191	235	0	44	44	1.0000000
NODE_176999_length_294_cov_1.902564	52	83	4	31	31	1.0000000
NODE_177102_length_294_cov_1.692308	46	112	0	8	66	0.1212121
NODE_177102_length_294_cov_1.692308	46	112	2	58	66	0.8787879
NODE_177187_length_294_cov_1.569231	49	95	0	46	46	1.0000000
NODE_177252_length_294_cov_1.482051	28	108	0	80	80	1.0000000
NODE_177252_length_294_cov_1.482051	201	281	0	80	80	1.0000000
NODE_177252_length_294_cov_1.482051	201	281	0	80	80	1.0000000
NODE_177298_length_294_cov_1.420513	216	262	0	46	46	1.0000000
NODE_177298_length_294_cov_1.420513	235	294	0	59	59	1.0000000
NODE_177972_length_294_cov_0.666667	245	293	0	48	48	1.0000000
NODE_178066_length_293_cov_6.257732	167	247	0	80	80	1.0000000
NODE_178161_length_293_cov_3.567010	50	130	4	6	80	0.0750000
NODE_178161_length_293_cov_3.567010	50	130	6	4	80	0.0500000
NODE_178161_length_293_cov_3.567010	50	130	8	27	80	0.3375000
NODE_178161_length_293_cov_3.567010	50	130	10	7	80	0.0875000
NODE_178161_length_293_cov_3.567010	50	130	11	18	80	0.2250000
NODE_178161_length_293_cov_3.567010	50	130	12	18	80	0.2250000
NODE_178226_length_293_cov_2.907216	218	281	0	16	63	0.2539683
NODE_178226_length_293_cov_2.907216	218	281	3	47	63	0.7460318
NODE_178246_length_293_cov_2.768041	95	175	0	37	80	0.4625000
NODE_178246_length_293_cov_2.768041	95	175	1	25	80	0.3125000
NODE_178246_length_293_cov_2.768041	95	175	2	18	80	0.2250000
NODE_178246_length_293_cov_2.768041	148	228	1	9	80	0.1125000
NODE_178246_length_293_cov_2.768041	148	228	2	71	80	0.8875000
NODE_178268_length_293_cov_2.628866	207	266	2	59	59	1.0000000
NODE_178277_length_293_cov_2.623711	182	223	4	41	41	1.0000000
NODE_178299_length_293_cov_2.561856	139	192	0	53	53	1.0000000
NODE_178299_length_293_cov_2.561856	177	223	0	46	46	1.0000000
NODE_178317_length_293_cov_2.448454	98	158	2	1	60	0.0166667
NODE_178317_length_293_cov_2.448454	98	158	4	58	60	0.9666666
NODE_178317_length_293_cov_2.448454	98	158	6	1	60	0.0166667
NODE_178351_length_293_cov_2.335052	62	91	2	29	29	1.0000000
NODE_178357_length_293_cov_2.314433	35	89	0	54	54	1.0000000
NODE_178523_length_293_cov_1.840206	27	107	2	80	80	1.0000000
NODE_178523_length_293_cov_1.840206	80	160	0	50	80	0.6250000
NODE_178523_length_293_cov_1.840206	80	160	2	30	80	0.3750000
NODE_178560_length_293_cov_1.804124	144	173	17	10	29	0.3448276
NODE_178560_length_293_cov_1.804124	144	173	18	7	29	0.2413793
NODE_178560_length_293_cov_1.804124	144	173	20	12	29	0.4137931
NODE_178570_length_293_cov_1.778351	224	258	0	34	34	1.0000000
NODE_178646_length_293_cov_1.577320	158	177	0	19	19	1.0000000
NODE_178692_length_293_cov_1.577320	161	225	0	4	64	0.0625000
NODE_178692_length_293_cov_1.577320	161	225	4	60	64	0.9375000
NODE_178693_length_293_cov_1.577320	15	55	0	40	40	1.0000000
NODE_178788_length_293_cov_1.402062	3	72	0	50	69	0.7246377
NODE_178788_length_293_cov_1.402062	3	72	1	6	69	0.0869565
NODE_178788_length_293_cov_1.402062	3	72	2	13	69	0.1884058
NODE_178822_length_293_cov_1.319588	202	268	0	66	66	1.0000000
NODE_178927_length_293_cov_1.226804	84	141	0	57	57	1.0000000
NODE_179542_length_292_cov_4.523316	240	290	0	50	50	1.0000000
NODE_179552_length_292_cov_4.145078	106	186	0	12	80	0.1500000
NODE_179552_length_292_cov_4.145078	106	186	2	59	80	0.7375000
NODE_179552_length_292_cov_4.145078	106	186	4	9	80	0.1125000
NODE_179604_length_292_cov_3.502591	129	205	6	5	76	0.0657895
NODE_179604_length_292_cov_3.502591	129	205	8	7	76	0.0921053
NODE_179604_length_292_cov_3.502591	129	205	10	64	76	0.8421053
NODE_179613_length_292_cov_3.435233	176	200	0	20	24	0.8333333
NODE_179613_length_292_cov_3.435233	176	200	2	4	24	0.1666667
NODE_179621_length_292_cov_3.341969	70	150	4	16	80	0.2000000
NODE_179621_length_292_cov_3.341969	70	150	6	16	80	0.2000000
NODE_179621_length_292_cov_3.341969	70	150	8	48	80	0.6000000
NODE_179621_length_292_cov_3.341969	118	175	2	7	57	0.1228070
NODE_179621_length_292_cov_3.341969	118	175	3	3	57	0.0526316
NODE_179621_length_292_cov_3.341969	118	175	4	31	57	0.5438597
NODE_179621_length_292_cov_3.341969	118	175	6	16	57	0.2807018
NODE_179627_length_292_cov_3.222798	47	127	0	80	80	1.0000000
NODE_179627_length_292_cov_3.222798	100	129	0	29	29	1.0000000
NODE_179819_length_292_cov_2.238342	211	290	0	79	79	1.0000000
NODE_179943_length_292_cov_1.865285	34	114	35	1	80	0.0125000
NODE_179943_length_292_cov_1.865285	34	114	41	1	80	0.0125000
NODE_179943_length_292_cov_1.865285	34	114	43	1	80	0.0125000
NODE_179943_length_292_cov_1.865285	34	114	48	2	80	0.0250000
NODE_179943_length_292_cov_1.865285	34	114	50	4	80	0.0500000
NODE_179943_length_292_cov_1.865285	34	114	52	4	80	0.0500000
NODE_179943_length_292_cov_1.865285	34	114	62	3	80	0.0375000
NODE_179943_length_292_cov_1.865285	34	114	64	11	80	0.1375000
NODE_179943_length_292_cov_1.865285	34	114	66	27	80	0.3375000
NODE_179943_length_292_cov_1.865285	34	114	67	10	80	0.1250000
NODE_179943_length_292_cov_1.865285	34	114	68	16	80	0.2000000
NODE_179943_length_292_cov_1.865285	87	167	10	6	80	0.0750000
NODE_179943_length_292_cov_1.865285	87	167	12	9	80	0.1125000
NODE_179943_length_292_cov_1.865285	87	167	13	5	80	0.0625000
NODE_179943_length_292_cov_1.865285	87	167	14	4	80	0.0500000
NODE_179943_length_292_cov_1.865285	87	167	20	11	80	0.1375000
NODE_179943_length_292_cov_1.865285	87	167	22	4	80	0.0500000
NODE_179943_length_292_cov_1.865285	87	167	23	3	80	0.0375000
NODE_179943_length_292_cov_1.865285	87	167	25	1	80	0.0125000
NODE_179943_length_292_cov_1.865285	87	167	27	3	80	0.0375000
NODE_179943_length_292_cov_1.865285	87	167	31	4	80	0.0500000
NODE_179943_length_292_cov_1.865285	87	167	33	1	80	0.0125000
NODE_179943_length_292_cov_1.865285	87	167	35	2	80	0.0250000
NODE_179943_length_292_cov_1.865285	87	167	36	1	80	0.0125000
NODE_179943_length_292_cov_1.865285	87	167	41	1	80	0.0125000
NODE_179943_length_292_cov_1.865285	87	167	43	1	80	0.0125000
NODE_179943_length_292_cov_1.865285	87	167	48	2	80	0.0250000
NODE_179943_length_292_cov_1.865285	87	167	50	4	80	0.0500000
NODE_179943_length_292_cov_1.865285	87	167	52	4	80	0.0500000
NODE_179943_length_292_cov_1.865285	87	167	62	3	80	0.0375000
NODE_179943_length_292_cov_1.865285	87	167	64	11	80	0.1375000
NODE_180013_length_292_cov_1.761658	174	254	0	80	80	1.0000000
NODE_180029_length_292_cov_1.699482	0	80	0	63	80	0.7875000
NODE_180029_length_292_cov_1.699482	0	80	2	9	80	0.1125000
NODE_180029_length_292_cov_1.699482	0	80	4	8	80	0.1000000
NODE_180068_length_292_cov_1.611399	89	157	0	68	68	1.0000000
NODE_180210_length_292_cov_1.455959	72	115	0	43	43	1.0000000
NODE_180210_length_292_cov_1.455959	203	265	4	3	62	0.0483871
NODE_180210_length_292_cov_1.455959	203	265	6	28	62	0.4516129
NODE_180210_length_292_cov_1.455959	203	265	8	31	62	0.5000000
NODE_180302_length_292_cov_1.321244	102	182	8	7	80	0.0875000
NODE_180302_length_292_cov_1.321244	102	182	10	13	80	0.1625000
NODE_180302_length_292_cov_1.321244	102	182	12	15	80	0.1875000
NODE_180302_length_292_cov_1.321244	102	182	14	1	80	0.0125000
NODE_180302_length_292_cov_1.321244	102	182	15	4	80	0.0500000
NODE_180302_length_292_cov_1.321244	102	182	17	1	80	0.0125000
NODE_180302_length_292_cov_1.321244	102	182	18	6	80	0.0750000
NODE_180302_length_292_cov_1.321244	102	182	20	33	80	0.4125000
NODE_180302_length_292_cov_1.321244	155	217	8	42	62	0.6774194
NODE_180302_length_292_cov_1.321244	155	217	10	13	62	0.2096774
NODE_180302_length_292_cov_1.321244	155	217	12	7	62	0.1129032
NODE_180968_length_291_cov_45.031250	71	145	13	4	74	0.0540541
NODE_180968_length_291_cov_45.031250	71	145	14	6	74	0.0810811
NODE_180968_length_291_cov_45.031250	71	145	15	7	74	0.0945946
NODE_180968_length_291_cov_45.031250	71	145	16	17	74	0.2297297
NODE_180968_length_291_cov_45.031250	71	145	18	4	74	0.0540541
NODE_180968_length_291_cov_45.031250	71	145	20	26	74	0.3513514
NODE_180968_length_291_cov_45.031250	71	145	22	3	74	0.0405405
NODE_180968_length_291_cov_45.031250	71	145	24	7	74	0.0945946
NODE_180968_length_291_cov_45.031250	71	145	13	4	74	0.0540541
NODE_180968_length_291_cov_45.031250	71	145	14	6	74	0.0810811
NODE_180968_length_291_cov_45.031250	71	145	15	7	74	0.0945946
NODE_180968_length_291_cov_45.031250	71	145	16	17	74	0.2297297
NODE_180968_length_291_cov_45.031250	71	145	18	4	74	0.0540541
NODE_180968_length_291_cov_45.031250	71	145	20	26	74	0.3513514
NODE_180968_length_291_cov_45.031250	71	145	22	3	74	0.0405405
NODE_180968_length_291_cov_45.031250	71	145	24	7	74	0.0945946
NODE_180968_length_291_cov_45.031250	118	184	13	4	66	0.0606061
NODE_180968_length_291_cov_45.031250	118	184	14	6	66	0.0909091
NODE_180968_length_291_cov_45.031250	118	184	15	7	66	0.1060606
NODE_180968_length_291_cov_45.031250	118	184	22	18	66	0.2727273
NODE_180968_length_291_cov_45.031250	118	184	23	9	66	0.1363636
NODE_180968_length_291_cov_45.031250	118	184	24	18	66	0.2727273
NODE_180968_length_291_cov_45.031250	118	184	25	4	66	0.0606061
NODE_180969_length_291_cov_14.791667	125	205	0	80	80	1.0000000
NODE_180969_length_291_cov_14.791667	178	258	0	80	80	1.0000000
NODE_180983_length_291_cov_5.536458	97	169	0	72	72	1.0000000
NODE_180986_length_291_cov_5.401042	77	130	2	53	53	1.0000000
NODE_180998_length_291_cov_4.859375	185	257	6	72	72	1.0000000
NODE_181043_length_291_cov_3.723958	196	276	0	80	80	1.0000000
NODE_181057_length_291_cov_3.531250	129	152	0	23	23	1.0000000
NODE_181191_length_291_cov_2.390625	18	80	0	62	62	1.0000000
NODE_181272_length_291_cov_2.125000	70	117	0	47	47	1.0000000
NODE_181391_length_291_cov_1.859375	197	228	0	4	31	0.1290323
NODE_181391_length_291_cov_1.859375	197	228	2	27	31	0.8709677
NODE_181497_length_291_cov_1.593750	144	175	0	31	31	1.0000000
NODE_181530_length_291_cov_1.593750	206	281	0	75	75	1.0000000
NODE_181599_length_291_cov_1.552083	189	269	4	25	80	0.3125000
NODE_181599_length_291_cov_1.552083	189	269	6	55	80	0.6875000
NODE_181615_length_291_cov_1.520833	180	258	0	78	78	1.0000000
NODE_181623_length_291_cov_1.510417	245	291	0	46	46	1.0000000
NODE_181696_length_291_cov_1.385417	80	120	0	25	40	0.6250000
NODE_181696_length_291_cov_1.385417	80	120	2	15	40	0.3750000
NODE_181791_length_291_cov_1.322917	70	96	0	26	26	1.0000000
NODE_181799_length_291_cov_1.307292	108	188	0	7	80	0.0875000
NODE_181799_length_291_cov_1.307292	108	188	2	41	80	0.5125000
NODE_181799_length_291_cov_1.307292	108	188	6	3	80	0.0375000
NODE_181799_length_291_cov_1.307292	108	188	8	1	80	0.0125000
NODE_181799_length_291_cov_1.307292	108	188	12	3	80	0.0375000
NODE_181799_length_291_cov_1.307292	108	188	16	14	80	0.1750000
NODE_181799_length_291_cov_1.307292	108	188	18	4	80	0.0500000
NODE_181799_length_291_cov_1.307292	108	188	20	7	80	0.0875000
NODE_181907_length_291_cov_1.114583	79	174	16	4	95	0.0421053
NODE_181907_length_291_cov_1.114583	79	174	17	13	95	0.1368421
NODE_181907_length_291_cov_1.114583	79	174	21	5	95	0.0526316
NODE_181907_length_291_cov_1.114583	79	174	24	6	95	0.0631579
NODE_181907_length_291_cov_1.114583	79	174	25	2	95	0.0210526
NODE_181907_length_291_cov_1.114583	79	174	26	5	95	0.0526316
NODE_181907_length_291_cov_1.114583	79	174	27	22	95	0.2315789
NODE_181907_length_291_cov_1.114583	79	174	28	10	95	0.1052632
NODE_181907_length_291_cov_1.114583	79	174	29	28	95	0.2947368
NODE_181930_length_291_cov_1.078125	4	85	2	36	81	0.4444444
NODE_181930_length_291_cov_1.078125	4	85	4	2	81	0.0246914
NODE_181930_length_291_cov_1.078125	4	85	6	3	81	0.0370370
NODE_181930_length_291_cov_1.078125	4	85	8	4	81	0.0493827
NODE_181930_length_291_cov_1.078125	4	85	10	28	81	0.3456790
NODE_181930_length_291_cov_1.078125	4	85	12	8	81	0.0987654
NODE_182112_length_291_cov_1.031250	5	50	0	45	45	1.0000000
NODE_182205_length_291_cov_0.890625	0	55	0	55	55	1.0000000
NODE_182252_length_291_cov_0.802083	80	160	0	74	80	0.9250000
NODE_182252_length_291_cov_0.802083	80	160	2	6	80	0.0750000
NODE_182491_length_290_cov_96.963351	44	124	0	80	80	1.0000000
NODE_182491_length_290_cov_96.963351	97	177	0	80	80	1.0000000
NODE_182512_length_290_cov_5.968586	89	150	0	32	61	0.5245901
NODE_182512_length_290_cov_5.968586	89	150	1	1	61	0.0163934
NODE_182512_length_290_cov_5.968586	89	150	2	4	61	0.0655738
NODE_182512_length_290_cov_5.968586	89	150	4	10	61	0.1639344
NODE_182512_length_290_cov_5.968586	89	150	7	3	61	0.0491803
NODE_182512_length_290_cov_5.968586	89	150	8	11	61	0.1803279
NODE_182512_length_290_cov_5.968586	142	203	8	38	61	0.6229508
NODE_182512_length_290_cov_5.968586	142	203	10	12	61	0.1967213
NODE_182512_length_290_cov_5.968586	142	203	12	11	61	0.1803279
NODE_182535_length_290_cov_4.968586	32	52	0	20	20	1.0000000
NODE_182535_length_290_cov_4.968586	73	93	0	20	20	1.0000000
NODE_182547_length_290_cov_4.670157	63	139	0	5	76	0.0657895
NODE_182547_length_290_cov_4.670157	63	139	2	71	76	0.9342105
NODE_182550_length_290_cov_4.575916	110	153	2	30	43	0.6976744
NODE_182550_length_290_cov_4.575916	110	153	4	13	43	0.3023256
NODE_182589_length_290_cov_3.816754	113	186	0	73	73	1.0000000
NODE_182607_length_290_cov_3.612565	114	181	2	67	67	1.0000000
NODE_182622_length_290_cov_3.445026	91	150	0	59	59	1.0000000
NODE_182772_length_290_cov_2.596859	189	218	0	29	29	1.0000000
NODE_182844_length_290_cov_2.319372	45	74	0	7	29	0.2413793
NODE_182844_length_290_cov_2.319372	45	74	2	22	29	0.7586207
NODE_182973_length_290_cov_2.041885	59	139	2	9	80	0.1125000
NODE_182973_length_290_cov_2.041885	59	139	4	71	80	0.8875000
NODE_182995_length_290_cov_1.979058	229	271	9	6	42	0.1428571
NODE_182995_length_290_cov_1.979058	229	271	11	2	42	0.0476190
NODE_182995_length_290_cov_1.979058	229	271	12	13	42	0.3095238
NODE_182995_length_290_cov_1.979058	229	271	16	21	42	0.5000000
NODE_183288_length_290_cov_1.602094	16	68	0	52	52	1.0000000
NODE_183347_length_290_cov_1.575916	173	250	0	77	77	1.0000000
NODE_183373_length_290_cov_1.544503	151	203	0	52	52	1.0000000
NODE_183403_length_290_cov_1.513089	22	107	0	85	85	1.0000000
NODE_183436_length_290_cov_1.460733	11	91	0	80	80	1.0000000
NODE_183546_length_290_cov_1.335079	91	163	0	24	72	0.3333333
NODE_183546_length_290_cov_1.335079	91	163	2	48	72	0.6666667
NODE_183546_length_290_cov_1.335079	144	216	2	72	72	1.0000000
NODE_183642_length_290_cov_1.314136	0	80	0	80	80	1.0000000
NODE_183663_length_290_cov_1.287958	17	97	1	32	80	0.4000000
NODE_183663_length_290_cov_1.287958	17	97	2	48	80	0.6000000
NODE_183946_length_290_cov_1.068063	0	60	0	60	60	1.0000000
NODE_183946_length_290_cov_1.068063	33	113	0	80	80	1.0000000
NODE_184119_length_290_cov_1.000000	198	254	0	2	56	0.0357143
NODE_184119_length_290_cov_1.000000	198	254	1	5	56	0.0892857
NODE_184119_length_290_cov_1.000000	198	254	2	49	56	0.8750000
NODE_184326_length_290_cov_0.832461	154	236	0	82	82	1.0000000
NODE_184585_length_290_cov_0.701571	201	281	0	80	80	1.0000000
NODE_184716_length_289_cov_554.947368	45	125	470	1	80	0.0125000
NODE_184716_length_289_cov_554.947368	45	125	484	1	80	0.0125000
NODE_184716_length_289_cov_554.947368	45	125	491	1	80	0.0125000
NODE_184716_length_289_cov_554.947368	45	125	497	1	80	0.0125000
NODE_184716_length_289_cov_554.947368	45	125	523	1	80	0.0125000
NODE_184716_length_289_cov_554.947368	45	125	529	1	80	0.0125000
NODE_184716_length_289_cov_554.947368	45	125	533	1	80	0.0125000
NODE_184716_length_289_cov_554.947368	45	125	538	1	80	0.0125000
NODE_184716_length_289_cov_554.947368	45	125	548	1	80	0.0125000
NODE_184716_length_289_cov_554.947368	45	125	567	1	80	0.0125000
NODE_184716_length_289_cov_554.947368	45	125	569	1	80	0.0125000
NODE_184716_length_289_cov_554.947368	45	125	573	1	80	0.0125000
NODE_184716_length_289_cov_554.947368	45	125	575	3	80	0.0375000
NODE_184716_length_289_cov_554.947368	45	125	577	1	80	0.0125000
NODE_184716_length_289_cov_554.947368	45	125	580	1	80	0.0125000
NODE_184716_length_289_cov_554.947368	45	125	586	3	80	0.0375000
NODE_184716_length_289_cov_554.947368	45	125	590	1	80	0.0125000
NODE_184716_length_289_cov_554.947368	45	125	592	1	80	0.0125000
NODE_184716_length_289_cov_554.947368	45	125	594	2	80	0.0250000
NODE_184716_length_289_cov_554.947368	45	125	598	1	80	0.0125000
NODE_184716_length_289_cov_554.947368	45	125	600	1	80	0.0125000
NODE_184716_length_289_cov_554.947368	45	125	602	4	80	0.0500000
NODE_184716_length_289_cov_554.947368	45	125	606	1	80	0.0125000
NODE_184716_length_289_cov_554.947368	45	125	608	1	80	0.0125000
NODE_184716_length_289_cov_554.947368	45	125	614	1	80	0.0125000
NODE_184716_length_289_cov_554.947368	45	125	616	3	80	0.0375000
NODE_184716_length_289_cov_554.947368	45	125	617	2	80	0.0250000
NODE_184716_length_289_cov_554.947368	45	125	618	2	80	0.0250000
NODE_184716_length_289_cov_554.947368	45	125	619	4	80	0.0500000
NODE_184716_length_289_cov_554.947368	45	125	620	2	80	0.0250000
NODE_184716_length_289_cov_554.947368	45	125	622	2	80	0.0250000
NODE_184716_length_289_cov_554.947368	45	125	623	1	80	0.0125000
NODE_184716_length_289_cov_554.947368	45	125	624	4	80	0.0500000
NODE_184716_length_289_cov_554.947368	45	125	625	3	80	0.0375000
NODE_184716_length_289_cov_554.947368	45	125	629	3	80	0.0375000
NODE_184716_length_289_cov_554.947368	45	125	630	2	80	0.0250000
NODE_184716_length_289_cov_554.947368	45	125	632	1	80	0.0125000
NODE_184716_length_289_cov_554.947368	45	125	634	1	80	0.0125000
NODE_184716_length_289_cov_554.947368	45	125	637	1	80	0.0125000
NODE_184716_length_289_cov_554.947368	45	125	638	9	80	0.1125000
NODE_184716_length_289_cov_554.947368	45	125	639	6	80	0.0750000
NODE_184716_length_289_cov_554.947368	45	125	641	1	80	0.0125000
NODE_184729_length_289_cov_7.436842	181	229	0	48	48	1.0000000
NODE_184745_length_289_cov_5.789474	35	100	0	65	65	1.0000000
NODE_184745_length_289_cov_5.789474	85	153	0	68	68	1.0000000
NODE_184745_length_289_cov_5.789474	146	181	0	35	35	1.0000000
NODE_184781_length_289_cov_4.515789	192	254	0	62	62	1.0000000
NODE_184806_length_289_cov_4.136842	101	148	2	9	47	0.1914894
NODE_184806_length_289_cov_4.136842	101	148	4	38	47	0.8085107
NODE_184892_length_289_cov_2.973684	38	83	0	8	45	0.1777778
NODE_184892_length_289_cov_2.973684	38	83	6	10	45	0.2222222
NODE_184892_length_289_cov_2.973684	38	83	8	27	45	0.6000000
NODE_184960_length_289_cov_2.678947	105	168	6	51	63	0.8095238
NODE_184960_length_289_cov_2.678947	105	168	8	12	63	0.1904762
NODE_184960_length_289_cov_2.678947	158	204	2	8	46	0.1739130
NODE_184960_length_289_cov_2.678947	158	204	4	15	46	0.3260870
NODE_184960_length_289_cov_2.678947	158	204	6	20	46	0.4347826
NODE_184960_length_289_cov_2.678947	158	204	8	3	46	0.0652174
NODE_184963_length_289_cov_2.673684	216	263	0	47	47	1.0000000
NODE_185036_length_289_cov_2.378947	233	289	0	56	56	1.0000000
NODE_185152_length_289_cov_2.089474	26	91	0	65	65	1.0000000
NODE_185213_length_289_cov_1.921053	0	54	0	54	54	1.0000000
NODE_185383_length_289_cov_1.642105	58	123	0	65	65	1.0000000
NODE_185570_length_289_cov_1.547368	81	124	0	43	43	1.0000000
NODE_185617_length_289_cov_1.489474	192	274	0	82	82	1.0000000
NODE_185622_length_289_cov_1.484211	50	69	0	19	19	1.0000000
NODE_185708_length_289_cov_1.357895	31	74	0	43	43	1.0000000
NODE_185852_length_289_cov_1.278947	239	270	0	31	31	1.0000000
NODE_185864_length_289_cov_1.252632	23	66	0	43	43	1.0000000
NODE_185926_length_289_cov_1.168421	40	100	4	60	60	1.0000000
NODE_185937_length_289_cov_1.152632	0	50	0	50	50	1.0000000
NODE_185937_length_289_cov_1.152632	41	103	0	62	62	1.0000000
NODE_186095_length_289_cov_1.073684	152	198	2	46	46	1.0000000
NODE_186491_length_289_cov_0.878947	113	193	0	6	80	0.0750000
NODE_186491_length_289_cov_0.878947	113	193	2	1	80	0.0125000
NODE_186491_length_289_cov_0.878947	113	193	6	3	80	0.0375000
NODE_186491_length_289_cov_0.878947	113	193	10	1	80	0.0125000
NODE_186491_length_289_cov_0.878947	113	193	12	1	80	0.0125000
NODE_186491_length_289_cov_0.878947	113	193	14	1	80	0.0125000
NODE_186491_length_289_cov_0.878947	113	193	16	1	80	0.0125000
NODE_186491_length_289_cov_0.878947	113	193	18	2	80	0.0250000
NODE_186491_length_289_cov_0.878947	113	193	20	2	80	0.0250000
NODE_186491_length_289_cov_0.878947	113	193	22	16	80	0.2000000
NODE_186491_length_289_cov_0.878947	113	193	26	46	80	0.5750000
NODE_186491_length_289_cov_0.878947	166	246	0	14	80	0.1750000
NODE_186491_length_289_cov_0.878947	166	246	18	2	80	0.0250000
NODE_186491_length_289_cov_0.878947	166	246	20	3	80	0.0375000
NODE_186491_length_289_cov_0.878947	166	246	22	1	80	0.0125000
NODE_186491_length_289_cov_0.878947	166	246	24	1	80	0.0125000
NODE_186491_length_289_cov_0.878947	166	246	26	59	80	0.7375000
NODE_186507_length_289_cov_0.863158	116	211	0	8	95	0.0842105
NODE_186507_length_289_cov_0.863158	116	211	2	10	95	0.1052632
NODE_186507_length_289_cov_0.863158	116	211	3	2	95	0.0210526
NODE_186507_length_289_cov_0.863158	116	211	4	75	95	0.7894737
NODE_186515_length_289_cov_0.857895	6	75	0	69	69	1.0000000
NODE_186547_length_289_cov_0.831579	230	289	0	46	59	0.7796610
NODE_186547_length_289_cov_0.831579	230	289	1	2	59	0.0338983
NODE_186547_length_289_cov_0.831579	230	289	3	6	59	0.1016949
NODE_186547_length_289_cov_0.831579	230	289	4	5	59	0.0847458
NODE_186631_length_289_cov_0.805263	98	159	2	7	61	0.1147541
NODE_186631_length_289_cov_0.805263	98	159	4	54	61	0.8852459
NODE_186865_length_289_cov_0.568421	141	213	0	72	72	1.0000000
NODE_186934_length_288_cov_11.089947	135	195	0	13	60	0.2166667
NODE_186934_length_288_cov_11.089947	135	195	8	47	60	0.7833334
NODE_187025_length_288_cov_3.587302	108	188	0	8	80	0.1000000
NODE_187025_length_288_cov_3.587302	108	188	2	7	80	0.0875000
NODE_187025_length_288_cov_3.587302	108	188	4	65	80	0.8125000
NODE_187049_length_288_cov_3.296296	61	125	2	1	64	0.0156250
NODE_187049_length_288_cov_3.296296	61	125	4	63	64	0.9843750
NODE_187049_length_288_cov_3.296296	102	178	0	9	76	0.1184211
NODE_187049_length_288_cov_3.296296	102	178	2	6	76	0.0789474
NODE_187049_length_288_cov_3.296296	102	178	4	61	76	0.8026316
NODE_187062_length_288_cov_3.206349	149	202	0	53	53	1.0000000
NODE_187170_length_288_cov_2.539683	4	68	4	3	64	0.0468750
NODE_187170_length_288_cov_2.539683	4	68	6	61	64	0.9531250
NODE_187187_length_288_cov_2.465608	137	182	0	13	45	0.2888889
NODE_187187_length_288_cov_2.465608	137	182	2	32	45	0.7111111
NODE_187191_length_288_cov_2.449735	216	278	0	62	62	1.0000000
NODE_187191_length_288_cov_2.449735	237	273	0	36	36	1.0000000
NODE_187248_length_288_cov_2.275132	10	46	2	36	36	1.0000000
NODE_187248_length_288_cov_2.275132	13	86	2	73	73	1.0000000
NODE_187248_length_288_cov_2.275132	47	100	0	3	53	0.0566038
NODE_187248_length_288_cov_2.275132	47	100	2	50	53	0.9433962
NODE_187318_length_288_cov_2.153439	50	81	2	31	31	1.0000000
NODE_187431_length_288_cov_1.915344	0	75	0	75	75	1.0000000
NODE_187443_length_288_cov_1.888889	49	125	0	76	76	1.0000000
NODE_187484_length_288_cov_1.878307	0	42	0	42	42	1.0000000
NODE_187484_length_288_cov_1.878307	15	63	0	48	48	1.0000000
NODE_187810_length_288_cov_1.492063	0	42	0	42	42	1.0000000
NODE_188135_length_288_cov_1.158730	213	288	0	75	75	1.0000000
NODE_188161_length_288_cov_1.100529	256	288	0	32	32	1.0000000
NODE_188169_length_288_cov_1.079365	10	74	0	64	64	1.0000000
NODE_188169_length_288_cov_1.079365	65	110	0	17	45	0.3777778
NODE_188169_length_288_cov_1.079365	65	110	2	28	45	0.6222222
NODE_188760_length_288_cov_0.809524	141	170	2	16	29	0.5517241
NODE_188760_length_288_cov_0.809524	141	170	4	13	29	0.4482759
NODE_189068_length_287_cov_7.632979	117	184	28	4	67	0.0597015
NODE_189068_length_287_cov_7.632979	117	184	30	6	67	0.0895522
NODE_189068_length_287_cov_7.632979	117	184	31	35	67	0.5223880
NODE_189068_length_287_cov_7.632979	117	184	32	7	67	0.1044776
NODE_189068_length_287_cov_7.632979	117	184	33	15	67	0.2238806
NODE_189079_length_287_cov_6.510638	20	100	0	80	80	1.0000000
NODE_189097_length_287_cov_5.781915	164	246	2	6	82	0.0731707
NODE_189097_length_287_cov_5.781915	164	246	4	14	82	0.1707317
NODE_189097_length_287_cov_5.781915	164	246	5	55	82	0.6707317
NODE_189097_length_287_cov_5.781915	164	246	6	7	82	0.0853659
NODE_189182_length_287_cov_3.590426	114	194	0	41	80	0.5125000
NODE_189182_length_287_cov_3.590426	114	194	2	1	80	0.0125000
NODE_189182_length_287_cov_3.590426	114	194	4	38	80	0.4750000
NODE_189192_length_287_cov_3.452128	0	52	0	52	52	1.0000000
NODE_189208_length_287_cov_3.281915	263	286	0	23	23	1.0000000
NODE_189266_length_287_cov_2.936170	41	110	0	69	69	1.0000000
NODE_189266_length_287_cov_2.936170	41	111	0	70	70	1.0000000
NODE_189266_length_287_cov_2.936170	94	167	0	52	73	0.7123288
NODE_189266_length_287_cov_2.936170	94	167	2	21	73	0.2876712
NODE_189266_length_287_cov_2.936170	156	179	2	23	23	1.0000000
NODE_189330_length_287_cov_2.638298	22	86	0	64	64	1.0000000
NODE_189381_length_287_cov_2.436170	182	262	4	7	80	0.0875000
NODE_189381_length_287_cov_2.436170	182	262	6	70	80	0.8750000
NODE_189381_length_287_cov_2.436170	182	262	8	3	80	0.0375000
NODE_189582_length_287_cov_1.984043	137	166	8	17	29	0.5862069
NODE_189582_length_287_cov_1.984043	137	166	10	12	29	0.4137931
NODE_189594_length_287_cov_1.941489	56	123	0	67	67	1.0000000
NODE_189614_length_287_cov_1.904255	8	51	2	9	43	0.2093023
NODE_189614_length_287_cov_1.904255	8	51	4	4	43	0.0930233
NODE_189614_length_287_cov_1.904255	8	51	5	1	43	0.0232558
NODE_189614_length_287_cov_1.904255	8	51	6	23	43	0.5348837
NODE_189614_length_287_cov_1.904255	8	51	10	6	43	0.1395349
NODE_189710_length_287_cov_1.803191	146	217	0	18	71	0.2535211
NODE_189710_length_287_cov_1.803191	146	217	2	53	71	0.7464789
NODE_189843_length_287_cov_1.627660	113	175	17	3	62	0.0483871
NODE_189843_length_287_cov_1.627660	113	175	18	5	62	0.0806452
NODE_189843_length_287_cov_1.627660	113	175	20	7	62	0.1129032
NODE_189843_length_287_cov_1.627660	113	175	22	20	62	0.3225806
NODE_189843_length_287_cov_1.627660	113	175	24	9	62	0.1451613
NODE_189843_length_287_cov_1.627660	113	175	26	10	62	0.1612903
NODE_189843_length_287_cov_1.627660	113	175	27	2	62	0.0322581
NODE_189843_length_287_cov_1.627660	113	175	28	6	62	0.0967742
NODE_189843_length_287_cov_1.627660	148	228	5	8	80	0.1000000
NODE_189843_length_287_cov_1.627660	148	228	6	12	80	0.1500000
NODE_189843_length_287_cov_1.627660	148	228	8	20	80	0.2500000
NODE_189843_length_287_cov_1.627660	148	228	9	2	80	0.0250000
NODE_189843_length_287_cov_1.627660	148	228	10	1	80	0.0125000
NODE_189843_length_287_cov_1.627660	148	228	12	3	80	0.0375000
NODE_189843_length_287_cov_1.627660	148	228	14	2	80	0.0250000
NODE_189843_length_287_cov_1.627660	148	228	16	4	80	0.0500000
NODE_189843_length_287_cov_1.627660	148	228	17	4	80	0.0500000
NODE_189843_length_287_cov_1.627660	148	228	18	5	80	0.0625000
NODE_189843_length_287_cov_1.627660	148	228	20	3	80	0.0375000
NODE_189843_length_287_cov_1.627660	148	228	22	16	80	0.2000000
NODE_189864_length_287_cov_1.627660	14	59	0	45	45	1.0000000
NODE_189864_length_287_cov_1.627660	41	112	0	71	71	1.0000000
NODE_189949_length_287_cov_1.574468	150	220	2	33	70	0.4714286
NODE_189949_length_287_cov_1.574468	150	220	4	37	70	0.5285714
NODE_189985_length_287_cov_1.531915	123	154	0	31	31	1.0000000
NODE_190122_length_287_cov_1.356383	93	147	0	5	54	0.0925926
NODE_190122_length_287_cov_1.356383	93	147	2	49	54	0.9074074
NODE_190142_length_287_cov_1.356383	135	199	0	64	64	1.0000000
NODE_190189_length_287_cov_1.335106	149	201	0	52	52	1.0000000
NODE_190654_length_287_cov_1.037234	23	44	0	21	21	1.0000000
NODE_190701_length_287_cov_0.994681	206	225	0	19	19	1.0000000
NODE_190802_length_287_cov_0.898936	0	57	0	13	57	0.2280702
NODE_190802_length_287_cov_0.898936	0	57	3	3	57	0.0526316
NODE_190802_length_287_cov_0.898936	0	57	4	1	57	0.0175439
NODE_190802_length_287_cov_0.898936	0	57	6	3	57	0.0526316
NODE_190802_length_287_cov_0.898936	0	57	7	9	57	0.1578947
NODE_190802_length_287_cov_0.898936	0	57	9	3	57	0.0526316
NODE_190802_length_287_cov_0.898936	0	57	11	3	57	0.0526316
NODE_190802_length_287_cov_0.898936	0	57	13	2	57	0.0350877
NODE_190802_length_287_cov_0.898936	0	57	15	1	57	0.0175439
NODE_190802_length_287_cov_0.898936	0	57	18	3	57	0.0526316
NODE_190802_length_287_cov_0.898936	0	57	20	7	57	0.1228070
NODE_190802_length_287_cov_0.898936	0	57	22	6	57	0.1052632
NODE_190802_length_287_cov_0.898936	0	57	24	2	57	0.0350877
NODE_190802_length_287_cov_0.898936	0	57	26	1	57	0.0175439
NODE_190873_length_287_cov_0.840426	46	121	0	29	75	0.3866667
NODE_190873_length_287_cov_0.840426	46	121	2	46	75	0.6133333
NODE_191306_length_286_cov_141.540107	4	63	0	59	59	1.0000000
NODE_191389_length_286_cov_3.935829	79	123	0	44	44	1.0000000
NODE_191391_length_286_cov_3.871658	45	121	0	76	76	1.0000000
NODE_191391_length_286_cov_3.871658	102	169	0	67	67	1.0000000
NODE_191393_length_286_cov_3.812834	62	142	2	6	80	0.0750000
NODE_191393_length_286_cov_3.812834	62	142	4	49	80	0.6125000
NODE_191393_length_286_cov_3.812834	62	142	6	25	80	0.3125000
NODE_191430_length_286_cov_3.352941	63	143	0	19	80	0.2375000
NODE_191430_length_286_cov_3.352941	63	143	2	61	80	0.7625000
NODE_191430_length_286_cov_3.352941	116	196	0	19	80	0.2375000
NODE_191430_length_286_cov_3.352941	116	196	2	61	80	0.7625000
NODE_191466_length_286_cov_3.101604	217	271	0	54	54	1.0000000
NODE_191509_length_286_cov_2.823529	56	122	4	7	66	0.1060606
NODE_191509_length_286_cov_2.823529	56	122	8	6	66	0.0909091
NODE_191509_length_286_cov_2.823529	56	122	10	2	66	0.0303030
NODE_191509_length_286_cov_2.823529	56	122	12	1	66	0.0151515
NODE_191509_length_286_cov_2.823529	56	122	20	1	66	0.0151515
NODE_191509_length_286_cov_2.823529	56	122	22	1	66	0.0151515
NODE_191509_length_286_cov_2.823529	56	122	24	1	66	0.0151515
NODE_191509_length_286_cov_2.823529	56	122	26	3	66	0.0454545
NODE_191509_length_286_cov_2.823529	56	122	34	2	66	0.0303030
NODE_191509_length_286_cov_2.823529	56	122	36	1	66	0.0151515
NODE_191509_length_286_cov_2.823529	56	122	38	1	66	0.0151515
NODE_191509_length_286_cov_2.823529	56	122	44	2	66	0.0303030
NODE_191509_length_286_cov_2.823529	56	122	48	2	66	0.0303030
NODE_191509_length_286_cov_2.823529	56	122	52	1	66	0.0151515
NODE_191509_length_286_cov_2.823529	56	122	58	1	66	0.0151515
NODE_191509_length_286_cov_2.823529	56	122	64	1	66	0.0151515
NODE_191509_length_286_cov_2.823529	56	122	66	2	66	0.0303030
NODE_191509_length_286_cov_2.823529	56	122	69	7	66	0.1060606
NODE_191509_length_286_cov_2.823529	56	122	73	3	66	0.0454545
NODE_191509_length_286_cov_2.823529	56	122	77	3	66	0.0454545
NODE_191509_length_286_cov_2.823529	56	122	79	3	66	0.0454545
NODE_191509_length_286_cov_2.823529	56	122	85	1	66	0.0151515
NODE_191509_length_286_cov_2.823529	56	122	87	1	66	0.0151515
NODE_191509_length_286_cov_2.823529	56	122	89	2	66	0.0303030
NODE_191509_length_286_cov_2.823529	56	122	91	11	66	0.1666667
NODE_191598_length_286_cov_2.438503	151	218	2	67	67	1.0000000
NODE_191754_length_286_cov_2.037433	57	138	0	30	81	0.3703704
NODE_191754_length_286_cov_2.037433	57	138	2	7	81	0.0864198
NODE_191754_length_286_cov_2.037433	57	138	4	44	81	0.5432099
NODE_191892_length_286_cov_1.807487	186	232	0	24	46	0.5217391
NODE_191892_length_286_cov_1.807487	186	232	2	22	46	0.4782609
NODE_191892_length_286_cov_1.807487	239	285	0	35	46	0.7608696
NODE_191892_length_286_cov_1.807487	239	285	2	11	46	0.2391304
NODE_192100_length_286_cov_1.566845	112	160	0	48	48	1.0000000
NODE_192100_length_286_cov_1.566845	165	213	0	48	48	1.0000000
NODE_192150_length_286_cov_1.497326	107	160	2	53	53	1.0000000
NODE_192233_length_286_cov_1.363636	20	87	0	67	67	1.0000000
NODE_192302_length_286_cov_1.358289	218	262	1	13	44	0.2954545
NODE_192302_length_286_cov_1.358289	218	262	2	31	44	0.7045454
NODE_192357_length_286_cov_1.304813	147	205	0	54	58	0.9310345
NODE_192357_length_286_cov_1.304813	147	205	2	4	58	0.0689655
NODE_192427_length_286_cov_1.203209	30	76	0	22	46	0.4782609
NODE_192427_length_286_cov_1.203209	30	76	2	24	46	0.5217391
NODE_192427_length_286_cov_1.203209	49	129	0	75	80	0.9375000
NODE_192427_length_286_cov_1.203209	49	129	2	5	80	0.0625000
NODE_192757_length_286_cov_1.074866	160	220	0	60	60	1.0000000
NODE_193023_length_286_cov_0.871658	218	279	0	52	61	0.8524590
NODE_193023_length_286_cov_0.871658	218	279	2	9	61	0.1475410
NODE_193038_length_286_cov_0.855615	224	281	0	52	57	0.9122807
NODE_193038_length_286_cov_0.855615	224	281	2	5	57	0.0877193
NODE_193362_length_286_cov_0.625668	110	190	0	80	80	1.0000000
NODE_193362_length_286_cov_0.625668	163	240	0	77	77	1.0000000
NODE_193481_length_285_cov_7.392473	91	152	0	61	61	1.0000000
NODE_193481_length_285_cov_7.392473	150	184	0	34	34	1.0000000
NODE_193513_length_285_cov_4.650538	0	74	0	74	74	1.0000000
NODE_193513_length_285_cov_4.650538	47	127	0	80	80	1.0000000
NODE_193513_length_285_cov_4.650538	123	203	0	80	80	1.0000000
NODE_193513_length_285_cov_4.650538	176	256	0	80	80	1.0000000
NODE_193532_length_285_cov_4.091398	91	154	0	31	63	0.4920635
NODE_193532_length_285_cov_4.091398	91	154	2	32	63	0.5079365
NODE_193538_length_285_cov_4.010753	120	201	0	33	81	0.4074074
NODE_193538_length_285_cov_4.010753	120	201	2	48	81	0.5925926
NODE_193547_length_285_cov_3.854839	97	151	0	25	54	0.4629630
NODE_193547_length_285_cov_3.854839	97	151	6	29	54	0.5370370
NODE_193547_length_285_cov_3.854839	106	153	0	26	47	0.5531915
NODE_193547_length_285_cov_3.854839	106	153	2	1	47	0.0212766
NODE_193547_length_285_cov_3.854839	106	153	6	20	47	0.4255319
NODE_193566_length_285_cov_3.607527	197	258	0	19	61	0.3114754
NODE_193566_length_285_cov_3.607527	197	258	2	1	61	0.0163934
NODE_193566_length_285_cov_3.607527	197	258	4	3	61	0.0491803
NODE_193566_length_285_cov_3.607527	197	258	5	2	61	0.0327869
NODE_193566_length_285_cov_3.607527	197	258	7	3	61	0.0491803
NODE_193566_length_285_cov_3.607527	197	258	8	3	61	0.0491803
NODE_193566_length_285_cov_3.607527	197	258	10	2	61	0.0327869
NODE_193566_length_285_cov_3.607527	197	258	11	4	61	0.0655738
NODE_193566_length_285_cov_3.607527	197	258	12	3	61	0.0491803
NODE_193566_length_285_cov_3.607527	197	258	14	11	61	0.1803279
NODE_193566_length_285_cov_3.607527	197	258	16	10	61	0.1639344
NODE_193624_length_285_cov_3.037634	190	272	0	82	82	1.0000000
NODE_193660_length_285_cov_2.806452	215	279	4	64	64	1.0000000
NODE_193688_length_285_cov_2.736559	106	173	4	2	67	0.0298507
NODE_193688_length_285_cov_2.736559	106	173	6	33	67	0.4925373
NODE_193688_length_285_cov_2.736559	106	173	7	20	67	0.2985075
NODE_193688_length_285_cov_2.736559	106	173	8	12	67	0.1791045
NODE_193784_length_285_cov_2.311828	220	262	0	42	42	1.0000000
NODE_193883_length_285_cov_2.043011	77	150	0	73	73	1.0000000
NODE_193883_length_285_cov_2.043011	155	197	0	25	42	0.5952381
NODE_193883_length_285_cov_2.043011	155	197	2	17	42	0.4047619
NODE_193978_length_285_cov_1.876344	67	110	0	43	43	1.0000000
NODE_194150_length_285_cov_1.645161	112	160	6	38	48	0.7916667
NODE_194150_length_285_cov_1.645161	112	160	8	10	48	0.2083333
NODE_194260_length_285_cov_1.548387	124	172	0	37	48	0.7708333
NODE_194260_length_285_cov_1.548387	124	172	1	1	48	0.0208333
NODE_194260_length_285_cov_1.548387	124	172	2	10	48	0.2083333
NODE_194332_length_285_cov_1.456989	210	277	0	67	67	1.0000000
NODE_194499_length_285_cov_1.327957	114	191	2	1	77	0.0129870
NODE_194499_length_285_cov_1.327957	114	191	4	21	77	0.2727273
NODE_194499_length_285_cov_1.327957	114	191	6	55	77	0.7142857
NODE_194865_length_285_cov_1.096774	175	229	2	54	54	1.0000000
NODE_194865_length_285_cov_1.096774	230	271	0	13	41	0.3170732
NODE_194865_length_285_cov_1.096774	230	271	1	21	41	0.5121951
NODE_194865_length_285_cov_1.096774	230	271	2	7	41	0.1707317
NODE_195109_length_285_cov_0.924731	128	208	2	15	80	0.1875000
NODE_195109_length_285_cov_0.924731	128	208	4	47	80	0.5875000
NODE_195109_length_285_cov_0.924731	128	208	6	18	80	0.2250000
NODE_195115_length_285_cov_0.919355	5	65	0	60	60	1.0000000
NODE_195124_length_285_cov_0.913978	6	80	0	9	74	0.1216216
NODE_195124_length_285_cov_0.913978	6	80	2	11	74	0.1486486
NODE_195124_length_285_cov_0.913978	6	80	4	54	74	0.7297297
NODE_195124_length_285_cov_0.913978	58	133	0	56	75	0.7466667
NODE_195124_length_285_cov_0.913978	58	133	2	17	75	0.2266667
NODE_195124_length_285_cov_0.913978	58	133	4	2	75	0.0266667
NODE_195642_length_284_cov_7.967568	143	207	6	2	64	0.0312500
NODE_195642_length_284_cov_7.967568	143	207	10	11	64	0.1718750
NODE_195642_length_284_cov_7.967568	143	207	12	2	64	0.0312500
NODE_195642_length_284_cov_7.967568	143	207	14	4	64	0.0625000
NODE_195642_length_284_cov_7.967568	143	207	16	8	64	0.1250000
NODE_195642_length_284_cov_7.967568	143	207	18	20	64	0.3125000
NODE_195642_length_284_cov_7.967568	143	207	20	17	64	0.2656250
NODE_195667_length_284_cov_5.016216	115	169	3	12	54	0.2222222
NODE_195667_length_284_cov_5.016216	115	169	4	35	54	0.6481481
NODE_195667_length_284_cov_5.016216	115	169	5	7	54	0.1296296
NODE_195715_length_284_cov_3.913514	26	82	2	56	56	1.0000000
NODE_195760_length_284_cov_3.405405	209	283	0	51	74	0.6891892
NODE_195760_length_284_cov_3.405405	209	283	2	23	74	0.3108108
NODE_195863_length_284_cov_2.718919	138	162	0	6	24	0.2500000
NODE_195863_length_284_cov_2.718919	138	162	6	4	24	0.1666667
NODE_195863_length_284_cov_2.718919	138	162	8	14	24	0.5833333
NODE_195863_length_284_cov_2.718919	138	215	0	6	77	0.0779221
NODE_195863_length_284_cov_2.718919	138	215	6	4	77	0.0519481
NODE_195863_length_284_cov_2.718919	138	215	8	67	77	0.8701299
NODE_196090_length_284_cov_2.097297	46	122	0	76	76	1.0000000
NODE_196253_length_284_cov_1.756757	27	100	2	3	73	0.0410959
NODE_196253_length_284_cov_1.756757	27	100	4	24	73	0.3287671
NODE_196253_length_284_cov_1.756757	27	100	5	7	73	0.0958904
NODE_196253_length_284_cov_1.756757	27	100	7	25	73	0.3424658
NODE_196253_length_284_cov_1.756757	27	100	8	14	73	0.1917808
NODE_196253_length_284_cov_1.756757	97	153	2	6	56	0.1071429
NODE_196253_length_284_cov_1.756757	97	153	4	31	56	0.5535714
NODE_196253_length_284_cov_1.756757	97	153	6	9	56	0.1607143
NODE_196253_length_284_cov_1.756757	97	153	8	10	56	0.1785714
NODE_196273_length_284_cov_1.713514	24	59	0	35	35	1.0000000
NODE_196372_length_284_cov_1.654054	207	251	0	44	44	1.0000000
NODE_196426_length_284_cov_1.643243	180	239	0	59	59	1.0000000
NODE_196505_length_284_cov_1.540541	148	186	26	1	38	0.0263158
NODE_196505_length_284_cov_1.540541	148	186	28	1	38	0.0263158
NODE_196505_length_284_cov_1.540541	148	186	30	2	38	0.0526316
NODE_196505_length_284_cov_1.540541	148	186	32	10	38	0.2631579
NODE_196505_length_284_cov_1.540541	148	186	34	11	38	0.2894737
NODE_196505_length_284_cov_1.540541	148	186	36	7	38	0.1842105
NODE_196505_length_284_cov_1.540541	148	186	38	6	38	0.1578947
NODE_196670_length_284_cov_1.378378	65	145	0	5	80	0.0625000
NODE_196670_length_284_cov_1.378378	65	145	2	26	80	0.3250000
NODE_196670_length_284_cov_1.378378	65	145	4	23	80	0.2875000
NODE_196670_length_284_cov_1.378378	65	145	6	26	80	0.3250000
NODE_196670_length_284_cov_1.378378	118	165	4	3	47	0.0638298
NODE_196670_length_284_cov_1.378378	118	165	6	44	47	0.9361702
NODE_196733_length_284_cov_1.329730	114	170	0	56	56	1.0000000
NODE_197755_length_284_cov_0.686486	13	94	0	81	81	1.0000000
NODE_197755_length_284_cov_0.686486	13	94	0	81	81	1.0000000
NODE_197755_length_284_cov_0.686486	13	94	0	81	81	1.0000000
NODE_197835_length_284_cov_0.551351	167	219	0	52	52	1.0000000
NODE_197936_length_283_cov_4.434783	81	137	2	19	56	0.3392857
NODE_197936_length_283_cov_4.434783	81	137	4	20	56	0.3571429
NODE_197936_length_283_cov_4.434783	81	137	6	4	56	0.0714286
NODE_197936_length_283_cov_4.434783	81	137	8	13	56	0.2321429
NODE_197936_length_283_cov_4.434783	114	190	0	50	76	0.6578947
NODE_197936_length_283_cov_4.434783	114	190	2	21	76	0.2763158
NODE_197936_length_283_cov_4.434783	114	190	4	5	76	0.0657895
NODE_197936_length_283_cov_4.434783	190	270	0	3	80	0.0375000
NODE_197936_length_283_cov_4.434783	190	270	2	4	80	0.0500000
NODE_197936_length_283_cov_4.434783	190	270	4	73	80	0.9125000
NODE_197937_length_283_cov_4.429348	104	168	9	3	64	0.0468750
NODE_197937_length_283_cov_4.429348	104	168	10	7	64	0.1093750
NODE_197937_length_283_cov_4.429348	104	168	11	42	64	0.6562500
NODE_197937_length_283_cov_4.429348	104	168	13	12	64	0.1875000
NODE_197937_length_283_cov_4.429348	104	168	9	3	64	0.0468750
NODE_197937_length_283_cov_4.429348	104	168	10	7	64	0.1093750
NODE_197937_length_283_cov_4.429348	104	168	11	42	64	0.6562500
NODE_197937_length_283_cov_4.429348	104	168	13	12	64	0.1875000
NODE_197937_length_283_cov_4.429348	141	207	7	11	66	0.1666667
NODE_197937_length_283_cov_4.429348	141	207	9	5	66	0.0757576
NODE_197937_length_283_cov_4.429348	141	207	10	7	66	0.1060606
NODE_197937_length_283_cov_4.429348	141	207	11	11	66	0.1666667
NODE_197937_length_283_cov_4.429348	141	207	12	17	66	0.2575758
NODE_197937_length_283_cov_4.429348	141	207	13	15	66	0.2272727
NODE_197937_length_283_cov_4.429348	141	221	7	25	80	0.3125000
NODE_197937_length_283_cov_4.429348	141	221	9	5	80	0.0625000
NODE_197937_length_283_cov_4.429348	141	221	10	7	80	0.0875000
NODE_197937_length_283_cov_4.429348	141	221	11	11	80	0.1375000
NODE_197937_length_283_cov_4.429348	141	221	12	17	80	0.2125000
NODE_197937_length_283_cov_4.429348	141	221	13	15	80	0.1875000
NODE_198007_length_283_cov_3.369565	0	35	0	35	35	1.0000000
NODE_198022_length_283_cov_3.309783	47	91	0	44	44	1.0000000
NODE_198081_length_283_cov_2.923913	95	137	0	42	42	1.0000000
NODE_198081_length_283_cov_2.923913	110	190	0	49	80	0.6125000
NODE_198081_length_283_cov_2.923913	110	190	2	31	80	0.3875000
NODE_198098_length_283_cov_2.782609	120	200	0	2	80	0.0250000
NODE_198098_length_283_cov_2.782609	120	200	2	10	80	0.1250000
NODE_198098_length_283_cov_2.782609	120	200	4	68	80	0.8500000
NODE_198109_length_283_cov_2.771739	29	72	0	43	43	1.0000000
NODE_198171_length_283_cov_2.494565	186	229	0	43	43	1.0000000
NODE_198176_length_283_cov_2.494565	181	238	0	57	57	1.0000000
NODE_198271_length_283_cov_2.217391	222	281	0	59	59	1.0000000
NODE_198518_length_283_cov_1.777174	40	120	0	80	80	1.0000000
NODE_198745_length_283_cov_1.543478	125	161	13	5	36	0.1388889
NODE_198745_length_283_cov_1.543478	125	161	21	1	36	0.0277778
NODE_198745_length_283_cov_1.543478	125	161	25	2	36	0.0555556
NODE_198745_length_283_cov_1.543478	125	161	31	5	36	0.1388889
NODE_198745_length_283_cov_1.543478	125	161	33	5	36	0.1388889
NODE_198745_length_283_cov_1.543478	125	161	37	1	36	0.0277778
NODE_198745_length_283_cov_1.543478	125	161	38	17	36	0.4722222
NODE_198751_length_283_cov_1.538043	182	203	0	21	21	1.0000000
NODE_198986_length_283_cov_1.304348	208	270	0	62	62	1.0000000
NODE_199042_length_283_cov_1.211957	157	234	0	5	77	0.0649351
NODE_199042_length_283_cov_1.211957	157	234	2	17	77	0.2207792
NODE_199042_length_283_cov_1.211957	157	234	4	55	77	0.7142857
NODE_199070_length_283_cov_1.168478	183	250	8	67	67	1.0000000
NODE_199606_length_283_cov_0.918478	146	226	1	6	80	0.0750000
NODE_199606_length_283_cov_0.918478	146	226	3	7	80	0.0875000
NODE_199606_length_283_cov_0.918478	146	226	4	67	80	0.8375000
NODE_199606_length_283_cov_0.918478	199	279	1	59	80	0.7375000
NODE_199606_length_283_cov_0.918478	199	279	3	7	80	0.0875000
NODE_199606_length_283_cov_0.918478	199	279	4	14	80	0.1750000
NODE_199641_length_283_cov_0.885870	143	205	4	62	62	1.0000000
NODE_199958_length_283_cov_0.706522	119	159	0	40	40	1.0000000
NODE_200085_length_282_cov_51.027322	219	280	0	61	61	1.0000000
NODE_200085_length_282_cov_51.027322	219	282	0	63	63	1.0000000
NODE_200166_length_282_cov_3.901639	38	118	0	80	80	1.0000000
NODE_200166_length_282_cov_3.901639	91	171	0	80	80	1.0000000
NODE_200171_length_282_cov_3.874317	96	116	6	20	20	1.0000000
NODE_200201_length_282_cov_3.562842	224	279	0	55	55	1.0000000
NODE_200270_length_282_cov_2.890710	41	123	0	12	82	0.1463415
NODE_200270_length_282_cov_2.890710	41	123	3	70	82	0.8536586
NODE_200276_length_282_cov_2.846995	26	47	0	21	21	1.0000000
NODE_200304_length_282_cov_2.770492	145	225	0	80	80	1.0000000
NODE_200304_length_282_cov_2.770492	198	278	0	80	80	1.0000000
NODE_200329_length_282_cov_2.655738	46	119	0	25	73	0.3424658
NODE_200329_length_282_cov_2.655738	46	119	2	20	73	0.2739726
NODE_200329_length_282_cov_2.655738	46	119	4	28	73	0.3835616
NODE_200329_length_282_cov_2.655738	100	159	2	41	59	0.6949152
NODE_200329_length_282_cov_2.655738	100	159	4	18	59	0.3050847
NODE_200335_length_282_cov_2.622951	0	36	0	36	36	1.0000000
NODE_200335_length_282_cov_2.622951	9	89	0	41	80	0.5125000
NODE_200335_length_282_cov_2.622951	9	89	2	3	80	0.0375000
NODE_200335_length_282_cov_2.622951	9	89	4	36	80	0.4500000
NODE_200336_length_282_cov_2.622951	38	111	0	73	73	1.0000000
NODE_200336_length_282_cov_2.622951	98	144	0	46	46	1.0000000
NODE_200367_length_282_cov_2.508197	138	186	0	48	48	1.0000000
NODE_200367_length_282_cov_2.508197	191	234	0	43	43	1.0000000
NODE_200425_length_282_cov_2.289617	68	137	2	17	69	0.2463768
NODE_200425_length_282_cov_2.289617	68	137	4	52	69	0.7536232
NODE_200443_length_282_cov_2.229508	169	249	2	80	80	1.0000000
NODE_200501_length_282_cov_2.163934	138	192	0	27	54	0.5000000
NODE_200501_length_282_cov_2.163934	138	192	2	27	54	0.5000000
NODE_200634_length_282_cov_1.901639	149	216	4	37	67	0.5522388
NODE_200634_length_282_cov_1.901639	149	216	6	30	67	0.4477612
NODE_200924_length_282_cov_1.612022	123	162	0	39	39	1.0000000
NODE_201084_length_282_cov_1.393443	158	225	0	18	67	0.2686567
NODE_201084_length_282_cov_1.393443	158	225	2	49	67	0.7313433
NODE_201219_length_282_cov_1.273224	91	140	0	49	49	1.0000000
NODE_201413_length_282_cov_1.114754	5	53	0	3	48	0.0625000
NODE_201413_length_282_cov_1.114754	5	53	2	45	48	0.9375000
NODE_202284_length_281_cov_7.895604	165	210	22	1	45	0.0222222
NODE_202284_length_281_cov_7.895604	165	210	28	39	45	0.8666667
NODE_202284_length_281_cov_7.895604	165	210	30	1	45	0.0222222
NODE_202284_length_281_cov_7.895604	165	210	34	2	45	0.0444444
NODE_202284_length_281_cov_7.895604	165	210	36	1	45	0.0222222
NODE_202284_length_281_cov_7.895604	165	210	45	1	45	0.0222222
NODE_202284_length_281_cov_7.895604	183	263	12	4	80	0.0500000
NODE_202284_length_281_cov_7.895604	183	263	14	9	80	0.1125000
NODE_202284_length_281_cov_7.895604	183	263	16	5	80	0.0625000
NODE_202284_length_281_cov_7.895604	183	263	18	1	80	0.0125000
NODE_202284_length_281_cov_7.895604	183	263	20	2	80	0.0250000
NODE_202284_length_281_cov_7.895604	183	263	24	2	80	0.0250000
NODE_202284_length_281_cov_7.895604	183	263	26	11	80	0.1375000
NODE_202284_length_281_cov_7.895604	183	263	28	46	80	0.5750000
NODE_202294_length_281_cov_6.379121	151	231	0	80	80	1.0000000
NODE_202333_length_281_cov_4.565934	71	127	2	56	56	1.0000000
NODE_202337_length_281_cov_4.494505	211	261	2	50	50	1.0000000
NODE_202356_length_281_cov_4.219780	85	135	0	50	50	1.0000000
NODE_202356_length_281_cov_4.219780	145	188	0	43	43	1.0000000
NODE_202401_length_281_cov_3.620879	245	281	0	36	36	1.0000000
NODE_202421_length_281_cov_3.324176	104	161	3	11	57	0.1929825
NODE_202421_length_281_cov_3.324176	104	161	4	37	57	0.6491228
NODE_202421_length_281_cov_3.324176	104	161	5	9	57	0.1578947
NODE_202421_length_281_cov_3.324176	112	192	2	28	80	0.3500000
NODE_202421_length_281_cov_3.324176	112	192	3	11	80	0.1375000
NODE_202421_length_281_cov_3.324176	112	192	4	36	80	0.4500000
NODE_202421_length_281_cov_3.324176	112	192	5	5	80	0.0625000
NODE_202436_length_281_cov_3.197802	6	80	0	74	74	1.0000000
NODE_202473_length_281_cov_2.923077	92	150	0	38	58	0.6551724
NODE_202473_length_281_cov_2.923077	92	150	2	20	58	0.3448276
NODE_202650_length_281_cov_2.241758	5	58	0	53	53	1.0000000
NODE_202712_length_281_cov_2.120879	56	136	2	17	80	0.2125000
NODE_202712_length_281_cov_2.120879	56	136	6	63	80	0.7875000
NODE_202788_length_281_cov_1.961538	199	270	0	71	71	1.0000000
NODE_203008_length_281_cov_1.675824	147	199	0	52	52	1.0000000
NODE_203008_length_281_cov_1.675824	178	198	0	20	20	1.0000000
NODE_203008_length_281_cov_1.675824	200	241	0	41	41	1.0000000
NODE_203065_length_281_cov_1.653846	29	65	0	36	36	1.0000000
NODE_203168_length_281_cov_1.483516	85	135	0	50	50	1.0000000
NODE_203168_length_281_cov_1.483516	86	166	0	80	80	1.0000000
NODE_203168_length_281_cov_1.483516	139	184	0	45	45	1.0000000
NODE_203183_length_281_cov_1.461538	223	276	0	53	53	1.0000000
NODE_203262_length_281_cov_1.401099	237	281	0	44	44	1.0000000
NODE_203281_length_281_cov_1.401099	150	214	2	24	64	0.3750000
NODE_203281_length_281_cov_1.401099	150	214	8	1	64	0.0156250
NODE_203281_length_281_cov_1.401099	150	214	10	1	64	0.0156250
NODE_203281_length_281_cov_1.401099	150	214	12	38	64	0.5937500
NODE_203281_length_281_cov_1.401099	187	267	0	39	80	0.4875000
NODE_203281_length_281_cov_1.401099	187	267	2	38	80	0.4750000
NODE_203281_length_281_cov_1.401099	187	267	8	1	80	0.0125000
NODE_203281_length_281_cov_1.401099	187	267	10	1	80	0.0125000
NODE_203281_length_281_cov_1.401099	187	267	12	1	80	0.0125000
NODE_203292_length_281_cov_1.401099	31	111	12	66	80	0.8250000
NODE_203292_length_281_cov_1.401099	31	111	14	14	80	0.1750000
NODE_203440_length_281_cov_1.186813	0	79	0	4	79	0.0506329
NODE_203440_length_281_cov_1.186813	0	79	6	41	79	0.5189874
NODE_203440_length_281_cov_1.186813	0	79	8	12	79	0.1518987
NODE_203440_length_281_cov_1.186813	0	79	10	8	79	0.1012658
NODE_203440_length_281_cov_1.186813	0	79	12	4	79	0.0506329
NODE_203440_length_281_cov_1.186813	0	79	14	1	79	0.0126582
NODE_203440_length_281_cov_1.186813	0	79	16	4	79	0.0506329
NODE_203440_length_281_cov_1.186813	0	79	18	5	79	0.0632911
NODE_203440_length_281_cov_1.186813	52	132	8	5	80	0.0625000
NODE_203440_length_281_cov_1.186813	52	132	10	8	80	0.1000000
NODE_203440_length_281_cov_1.186813	52	132	12	4	80	0.0500000
NODE_203440_length_281_cov_1.186813	52	132	14	1	80	0.0125000
NODE_203440_length_281_cov_1.186813	52	132	16	32	80	0.4000000
NODE_203440_length_281_cov_1.186813	52	132	18	14	80	0.1750000
NODE_203440_length_281_cov_1.186813	52	132	20	16	80	0.2000000
NODE_203516_length_281_cov_1.120879	47	82	0	35	35	1.0000000
NODE_203534_length_281_cov_1.120879	243	276	0	33	33	1.0000000
NODE_203544_length_281_cov_1.120879	216	281	0	8	65	0.1230769
NODE_203544_length_281_cov_1.120879	216	281	2	5	65	0.0769231
NODE_203544_length_281_cov_1.120879	216	281	4	52	65	0.8000000
NODE_203785_length_281_cov_1.060440	139	179	10	2	40	0.0500000
NODE_203785_length_281_cov_1.060440	139	179	12	11	40	0.2750000
NODE_203785_length_281_cov_1.060440	139	179	14	5	40	0.1250000
NODE_203785_length_281_cov_1.060440	139	179	16	5	40	0.1250000
NODE_203785_length_281_cov_1.060440	139	179	18	1	40	0.0250000
NODE_203785_length_281_cov_1.060440	139	179	20	11	40	0.2750000
NODE_203785_length_281_cov_1.060440	139	179	22	3	40	0.0750000
NODE_203785_length_281_cov_1.060440	139	179	24	2	40	0.0500000
NODE_204094_length_281_cov_0.840659	72	138	0	66	66	1.0000000
NODE_204094_length_281_cov_0.840659	111	191	0	80	80	1.0000000
NODE_204467_length_280_cov_39.320442	118	198	0	80	80	1.0000000
NODE_204467_length_280_cov_39.320442	181	251	0	70	70	1.0000000
NODE_204468_length_280_cov_34.259669	97	137	0	3	40	0.0750000
NODE_204468_length_280_cov_34.259669	97	137	4	2	40	0.0500000
NODE_204468_length_280_cov_34.259669	97	137	6	5	40	0.1250000
NODE_204468_length_280_cov_34.259669	97	137	9	1	40	0.0250000
NODE_204468_length_280_cov_34.259669	97	137	10	1	40	0.0250000
NODE_204468_length_280_cov_34.259669	97	137	12	24	40	0.6000000
NODE_204468_length_280_cov_34.259669	97	137	14	4	40	0.1000000
NODE_204532_length_280_cov_4.287293	53	100	0	43	47	0.9148936
NODE_204532_length_280_cov_4.287293	53	100	2	4	47	0.0851064
NODE_204532_length_280_cov_4.287293	129	186	2	57	57	1.0000000
NODE_204596_length_280_cov_3.436464	34	103	16	1	69	0.0144928
NODE_204596_length_280_cov_3.436464	34	103	18	3	69	0.0434783
NODE_204596_length_280_cov_3.436464	34	103	20	4	69	0.0579710
NODE_204596_length_280_cov_3.436464	34	103	22	2	69	0.0289855
NODE_204596_length_280_cov_3.436464	34	103	26	1	69	0.0144928
NODE_204596_length_280_cov_3.436464	34	103	30	2	69	0.0289855
NODE_204596_length_280_cov_3.436464	34	103	32	4	69	0.0579710
NODE_204596_length_280_cov_3.436464	34	103	34	2	69	0.0289855
NODE_204596_length_280_cov_3.436464	34	103	36	4	69	0.0579710
NODE_204596_length_280_cov_3.436464	34	103	38	3	69	0.0434783
NODE_204596_length_280_cov_3.436464	34	103	40	43	69	0.6231884
NODE_204597_length_280_cov_3.430939	17	97	2	1	80	0.0125000
NODE_204597_length_280_cov_3.430939	17	97	4	1	80	0.0125000
NODE_204597_length_280_cov_3.430939	17	97	6	1	80	0.0125000
NODE_204597_length_280_cov_3.430939	17	97	8	9	80	0.1125000
NODE_204597_length_280_cov_3.430939	17	97	12	68	80	0.8500000
NODE_204597_length_280_cov_3.430939	27	97	8	2	70	0.0285714
NODE_204597_length_280_cov_3.430939	27	97	12	68	70	0.9714286
NODE_204674_length_280_cov_2.988950	118	164	0	46	46	1.0000000
NODE_204938_length_280_cov_2.165746	2	48	0	46	46	1.0000000
NODE_204938_length_280_cov_2.165746	6	48	0	42	42	1.0000000
NODE_204938_length_280_cov_2.165746	21	101	0	80	80	1.0000000
NODE_204938_length_280_cov_2.165746	22	101	0	79	79	1.0000000
NODE_204938_length_280_cov_2.165746	32	101	0	69	69	1.0000000
NODE_204976_length_280_cov_2.022099	105	148	2	43	43	1.0000000
NODE_204976_length_280_cov_2.022099	121	148	2	27	27	1.0000000
NODE_205044_length_280_cov_1.889503	50	132	0	82	82	1.0000000
NODE_205062_length_280_cov_1.828729	45	75	0	30	30	1.0000000
NODE_205410_length_280_cov_1.425414	17	50	0	33	33	1.0000000
NODE_205410_length_280_cov_1.425414	70	112	0	42	42	1.0000000
NODE_205416_length_280_cov_1.414365	37	97	0	60	60	1.0000000
NODE_205633_length_280_cov_1.187845	56	136	0	80	80	1.0000000
NODE_205635_length_280_cov_1.182320	154	234	2	4	80	0.0500000
NODE_205635_length_280_cov_1.182320	154	234	6	19	80	0.2375000
NODE_205635_length_280_cov_1.182320	154	234	8	57	80	0.7125000
NODE_205635_length_280_cov_1.182320	207	280	0	20	73	0.2739726
NODE_205635_length_280_cov_1.182320	207	280	2	30	73	0.4109589
NODE_205635_length_280_cov_1.182320	207	280	6	19	73	0.2602740
NODE_205635_length_280_cov_1.182320	207	280	8	4	73	0.0547945
NODE_205701_length_280_cov_1.127072	204	265	0	36	61	0.5901639
NODE_205701_length_280_cov_1.127072	204	265	2	25	61	0.4098361
NODE_205794_length_280_cov_1.127072	0	39	0	39	39	1.0000000
NODE_205801_length_280_cov_1.127072	218	253	0	35	35	1.0000000
NODE_205894_length_280_cov_1.127072	0	59	0	59	59	1.0000000
NODE_206211_length_280_cov_0.911602	176	256	0	80	80	1.0000000
NODE_206211_length_280_cov_0.911602	229	280	0	51	51	1.0000000
NODE_206319_length_280_cov_0.845304	211	268	0	57	57	1.0000000
NODE_206531_length_280_cov_0.779006	129	203	8	11	74	0.1486486
NODE_206531_length_280_cov_0.779006	129	203	10	2	74	0.0270270
NODE_206531_length_280_cov_0.779006	129	203	14	27	74	0.3648649
NODE_206531_length_280_cov_0.779006	129	203	16	5	74	0.0675676
NODE_206531_length_280_cov_0.779006	129	203	18	27	74	0.3648649
NODE_206531_length_280_cov_0.779006	129	203	22	2	74	0.0270270
NODE_206721_length_279_cov_50.005556	51	130	56	9	79	0.1139240
NODE_206721_length_279_cov_50.005556	51	130	58	3	79	0.0379747
NODE_206721_length_279_cov_50.005556	51	130	60	1	79	0.0126582
NODE_206721_length_279_cov_50.005556	51	130	66	3	79	0.0379747
NODE_206721_length_279_cov_50.005556	51	130	68	1	79	0.0126582
NODE_206721_length_279_cov_50.005556	51	130	70	1	79	0.0126582
NODE_206721_length_279_cov_50.005556	51	130	72	1	79	0.0126582
NODE_206721_length_279_cov_50.005556	51	130	73	1	79	0.0126582
NODE_206721_length_279_cov_50.005556	51	130	75	3	79	0.0379747
NODE_206721_length_279_cov_50.005556	51	130	76	4	79	0.0506329
NODE_206721_length_279_cov_50.005556	51	130	79	1	79	0.0126582
NODE_206721_length_279_cov_50.005556	51	130	80	2	79	0.0253165
NODE_206721_length_279_cov_50.005556	51	130	82	4	79	0.0506329
NODE_206721_length_279_cov_50.005556	51	130	83	1	79	0.0126582
NODE_206721_length_279_cov_50.005556	51	130	85	1	79	0.0126582
NODE_206721_length_279_cov_50.005556	51	130	87	3	79	0.0379747
NODE_206721_length_279_cov_50.005556	51	130	88	2	79	0.0253165
NODE_206721_length_279_cov_50.005556	51	130	89	1	79	0.0126582
NODE_206721_length_279_cov_50.005556	51	130	90	2	79	0.0253165
NODE_206721_length_279_cov_50.005556	51	130	92	6	79	0.0759494
NODE_206721_length_279_cov_50.005556	51	130	93	7	79	0.0886076
NODE_206721_length_279_cov_50.005556	51	130	96	7	79	0.0886076
NODE_206721_length_279_cov_50.005556	51	130	97	1	79	0.0126582
NODE_206721_length_279_cov_50.005556	51	130	98	14	79	0.1772152
NODE_206721_length_279_cov_50.005556	103	179	18	1	76	0.0131579
NODE_206721_length_279_cov_50.005556	103	179	20	2	76	0.0263158
NODE_206721_length_279_cov_50.005556	103	179	22	5	76	0.0657895
NODE_206721_length_279_cov_50.005556	103	179	24	1	76	0.0131579
NODE_206721_length_279_cov_50.005556	103	179	26	2	76	0.0263158
NODE_206721_length_279_cov_50.005556	103	179	28	2	76	0.0263158
NODE_206721_length_279_cov_50.005556	103	179	34	5	76	0.0657895
NODE_206721_length_279_cov_50.005556	103	179	36	4	76	0.0526316
NODE_206721_length_279_cov_50.005556	103	179	38	1	76	0.0131579
NODE_206721_length_279_cov_50.005556	103	179	40	1	76	0.0131579
NODE_206721_length_279_cov_50.005556	103	179	47	1	76	0.0131579
NODE_206721_length_279_cov_50.005556	103	179	53	1	76	0.0131579
NODE_206721_length_279_cov_50.005556	103	179	55	1	76	0.0131579
NODE_206721_length_279_cov_50.005556	103	179	56	7	76	0.0921053
NODE_206721_length_279_cov_50.005556	103	179	59	2	76	0.0263158
NODE_206721_length_279_cov_50.005556	103	179	61	9	76	0.1184211
NODE_206721_length_279_cov_50.005556	103	179	63	1	76	0.0131579
NODE_206721_length_279_cov_50.005556	103	179	66	1	76	0.0131579
NODE_206721_length_279_cov_50.005556	103	179	67	1	76	0.0131579
NODE_206721_length_279_cov_50.005556	103	179	69	1	76	0.0131579
NODE_206721_length_279_cov_50.005556	103	179	73	1	76	0.0131579
NODE_206721_length_279_cov_50.005556	103	179	75	3	76	0.0394737
NODE_206721_length_279_cov_50.005556	103	179	79	1	76	0.0131579
NODE_206721_length_279_cov_50.005556	103	179	82	1	76	0.0131579
NODE_206721_length_279_cov_50.005556	103	179	83	1	76	0.0131579
NODE_206721_length_279_cov_50.005556	103	179	87	3	76	0.0394737
NODE_206721_length_279_cov_50.005556	103	179	89	1	76	0.0131579
NODE_206721_length_279_cov_50.005556	103	179	93	7	76	0.0921053
NODE_206721_length_279_cov_50.005556	103	179	96	7	76	0.0921053
NODE_206721_length_279_cov_50.005556	103	179	98	2	76	0.0263158
NODE_206744_length_279_cov_6.055556	196	228	0	32	32	1.0000000
NODE_206762_length_279_cov_5.166667	197	277	0	80	80	1.0000000
NODE_206788_length_279_cov_4.427778	107	187	0	5	80	0.0625000
NODE_206788_length_279_cov_4.427778	107	187	4	23	80	0.2875000
NODE_206788_length_279_cov_4.427778	107	187	6	28	80	0.3500000
NODE_206788_length_279_cov_4.427778	107	187	8	24	80	0.3000000
NODE_206879_length_279_cov_3.200000	205	225	0	20	20	1.0000000
NODE_206886_length_279_cov_3.116667	115	195	0	60	80	0.7500000
NODE_206886_length_279_cov_3.116667	115	195	1	4	80	0.0500000
NODE_206886_length_279_cov_3.116667	115	195	2	16	80	0.2000000
NODE_206886_length_279_cov_3.116667	168	248	0	80	80	1.0000000
NODE_206972_length_279_cov_2.600000	67	147	4	40	80	0.5000000
NODE_206972_length_279_cov_2.600000	67	147	5	1	80	0.0125000
NODE_206972_length_279_cov_2.600000	67	147	6	39	80	0.4875000
NODE_206972_length_279_cov_2.600000	120	199	0	45	79	0.5696203
NODE_206972_length_279_cov_2.600000	120	199	4	34	79	0.4303797
NODE_207023_length_279_cov_2.427778	155	199	4	44	44	1.0000000
NODE_207052_length_279_cov_2.283333	168	240	0	72	72	1.0000000
NODE_207054_length_279_cov_2.277778	190	265	0	25	75	0.3333333
NODE_207054_length_279_cov_2.277778	190	265	2	16	75	0.2133333
NODE_207054_length_279_cov_2.277778	190	265	4	34	75	0.4533333
NODE_207086_length_279_cov_2.266667	66	109	2	43	43	1.0000000
NODE_207115_length_279_cov_2.255556	115	176	0	20	61	0.3278688
NODE_207115_length_279_cov_2.255556	115	176	2	41	61	0.6721311
NODE_207115_length_279_cov_2.255556	168	222	0	1	54	0.0185185
NODE_207115_length_279_cov_2.255556	168	222	2	53	54	0.9814815
NODE_207155_length_279_cov_2.200000	57	104	0	11	47	0.2340426
NODE_207155_length_279_cov_2.200000	57	104	2	2	47	0.0425532
NODE_207155_length_279_cov_2.200000	57	104	4	3	47	0.0638298
NODE_207155_length_279_cov_2.200000	57	104	6	31	47	0.6595744
NODE_207269_length_279_cov_1.977778	0	62	0	62	62	1.0000000
NODE_207293_length_279_cov_1.944444	63	105	0	42	42	1.0000000
NODE_207306_length_279_cov_1.916667	182	262	0	80	80	1.0000000
NODE_207318_length_279_cov_1.866667	63	143	0	80	80	1.0000000
NODE_207387_length_279_cov_1.700000	8	37	4	29	29	1.0000000
NODE_207389_length_279_cov_1.700000	10	42	0	32	32	1.0000000
NODE_207534_length_279_cov_1.672222	103	183	0	2	80	0.0250000
NODE_207534_length_279_cov_1.672222	103	183	2	78	80	0.9750000
NODE_207641_length_279_cov_1.433333	51	110	0	6	59	0.1016949
NODE_207641_length_279_cov_1.433333	51	110	2	53	59	0.8983051
NODE_207641_length_279_cov_1.433333	83	119	2	36	36	1.0000000
NODE_207929_length_279_cov_1.144444	146	211	0	3	65	0.0461538
NODE_207929_length_279_cov_1.144444	146	211	2	5	65	0.0769231
NODE_207929_length_279_cov_1.144444	146	211	6	57	65	0.8769231
NODE_207929_length_279_cov_1.144444	184	266	2	30	82	0.3658537
NODE_207929_length_279_cov_1.144444	184	266	6	52	82	0.6341463
NODE_207931_length_279_cov_1.138889	125	188	129	1	63	0.0158730
NODE_207931_length_279_cov_1.138889	125	188	137	1	63	0.0158730
NODE_207931_length_279_cov_1.138889	125	188	143	1	63	0.0158730
NODE_207931_length_279_cov_1.138889	125	188	149	1	63	0.0158730
NODE_207931_length_279_cov_1.138889	125	188	150	2	63	0.0317460
NODE_207931_length_279_cov_1.138889	125	188	152	1	63	0.0158730
NODE_207931_length_279_cov_1.138889	125	188	158	2	63	0.0317460
NODE_207931_length_279_cov_1.138889	125	188	164	1	63	0.0158730
NODE_207931_length_279_cov_1.138889	125	188	167	1	63	0.0158730
NODE_207931_length_279_cov_1.138889	125	188	169	1	63	0.0158730
NODE_207931_length_279_cov_1.138889	125	188	170	1	63	0.0158730
NODE_207931_length_279_cov_1.138889	125	188	171	1	63	0.0158730
NODE_207931_length_279_cov_1.138889	125	188	173	9	63	0.1428571
NODE_207931_length_279_cov_1.138889	125	188	175	4	63	0.0634921
NODE_207931_length_279_cov_1.138889	125	188	177	1	63	0.0158730
NODE_207931_length_279_cov_1.138889	125	188	178	1	63	0.0158730
NODE_207931_length_279_cov_1.138889	125	188	180	4	63	0.0634921
NODE_207931_length_279_cov_1.138889	125	188	181	1	63	0.0158730
NODE_207931_length_279_cov_1.138889	125	188	182	1	63	0.0158730
NODE_207931_length_279_cov_1.138889	125	188	185	4	63	0.0634921
NODE_207931_length_279_cov_1.138889	125	188	187	6	63	0.0952381
NODE_207931_length_279_cov_1.138889	125	188	189	3	63	0.0476190
NODE_207931_length_279_cov_1.138889	125	188	190	3	63	0.0476190
NODE_207931_length_279_cov_1.138889	125	188	193	6	63	0.0952381
NODE_207931_length_279_cov_1.138889	125	188	195	2	63	0.0317460
NODE_207931_length_279_cov_1.138889	125	188	196	2	63	0.0317460
NODE_207931_length_279_cov_1.138889	125	188	197	1	63	0.0158730
NODE_207931_length_279_cov_1.138889	125	188	198	1	63	0.0158730
NODE_207932_length_279_cov_1.138889	111	191	0	56	80	0.7000000
NODE_207932_length_279_cov_1.138889	111	191	2	24	80	0.3000000
NODE_207948_length_279_cov_1.133333	231	271	0	40	40	1.0000000
NODE_208183_length_279_cov_1.116667	15	92	0	77	77	1.0000000
NODE_208334_length_279_cov_0.988889	181	261	4	50	80	0.6250000
NODE_208334_length_279_cov_0.988889	181	261	6	30	80	0.3750000
NODE_208410_length_279_cov_0.927778	50	69	0	19	19	1.0000000
NODE_208410_length_279_cov_0.927778	50	69	0	19	19	1.0000000
NODE_208664_length_279_cov_0.844444	35	70	0	24	35	0.6857143
NODE_208664_length_279_cov_0.844444	35	70	4	11	35	0.3142857
NODE_209293_length_278_cov_44.882682	158	210	8	6	52	0.1153846
NODE_209293_length_278_cov_44.882682	158	210	10	16	52	0.3076923
NODE_209293_length_278_cov_44.882682	158	210	14	3	52	0.0576923
NODE_209293_length_278_cov_44.882682	158	210	18	8	52	0.1538462
NODE_209293_length_278_cov_44.882682	158	210	20	8	52	0.1538462
NODE_209293_length_278_cov_44.882682	158	210	22	4	52	0.0769231
NODE_209293_length_278_cov_44.882682	158	210	28	5	52	0.0961538
NODE_209293_length_278_cov_44.882682	158	210	30	2	52	0.0384615
NODE_209293_length_278_cov_44.882682	206	232	6	6	26	0.2307692
NODE_209293_length_278_cov_44.882682	206	232	8	20	26	0.7692308
NODE_209293_length_278_cov_44.882682	206	265	2	11	59	0.1864407
NODE_209293_length_278_cov_44.882682	206	265	4	19	59	0.3220339
NODE_209293_length_278_cov_44.882682	206	265	6	9	59	0.1525424
NODE_209293_length_278_cov_44.882682	206	265	8	20	59	0.3389831
NODE_209294_length_278_cov_37.474860	0	52	0	52	52	1.0000000
NODE_209294_length_278_cov_37.474860	48	128	0	42	80	0.5250000
NODE_209294_length_278_cov_37.474860	48	128	11	1	80	0.0125000
NODE_209294_length_278_cov_37.474860	48	128	12	1	80	0.0125000
NODE_209294_length_278_cov_37.474860	48	128	16	36	80	0.4500000
NODE_209294_length_278_cov_37.474860	101	181	4	15	80	0.1875000
NODE_209294_length_278_cov_37.474860	101	181	16	65	80	0.8125000
NODE_209295_length_278_cov_21.340782	84	164	0	80	80	1.0000000
NODE_209295_length_278_cov_21.340782	137	217	0	80	80	1.0000000
NODE_209360_length_278_cov_4.156425	132	210	2	22	78	0.2820513
NODE_209360_length_278_cov_4.156425	132	210	4	12	78	0.1538462
NODE_209360_length_278_cov_4.156425	132	210	6	4	78	0.0512821
NODE_209360_length_278_cov_4.156425	132	210	10	15	78	0.1923077
NODE_209360_length_278_cov_4.156425	132	210	12	12	78	0.1538462
NODE_209360_length_278_cov_4.156425	132	210	14	13	78	0.1666667
NODE_209360_length_278_cov_4.156425	193	263	0	47	70	0.6714286
NODE_209360_length_278_cov_4.156425	193	263	1	4	70	0.0571429
NODE_209360_length_278_cov_4.156425	193	263	2	19	70	0.2714286
NODE_209372_length_278_cov_3.977654	142	221	0	50	79	0.6329114
NODE_209372_length_278_cov_3.977654	142	221	2	29	79	0.3670886
NODE_209378_length_278_cov_3.865922	168	210	0	42	42	1.0000000
NODE_209552_length_278_cov_2.558659	93	123	0	30	30	1.0000000
NODE_209565_length_278_cov_2.513966	54	106	0	52	52	1.0000000
NODE_209565_length_278_cov_2.513966	79	158	0	67	79	0.8481013
NODE_209565_length_278_cov_2.513966	79	158	2	12	79	0.1518987
NODE_209605_length_278_cov_2.296089	127	207	14	28	80	0.3500000
NODE_209605_length_278_cov_2.296089	127	207	16	1	80	0.0125000
NODE_209605_length_278_cov_2.296089	127	207	17	1	80	0.0125000
NODE_209605_length_278_cov_2.296089	127	207	20	7	80	0.0875000
NODE_209605_length_278_cov_2.296089	127	207	22	1	80	0.0125000
NODE_209605_length_278_cov_2.296089	127	207	23	11	80	0.1375000
NODE_209605_length_278_cov_2.296089	127	207	26	5	80	0.0625000
NODE_209605_length_278_cov_2.296089	127	207	27	1	80	0.0125000
NODE_209605_length_278_cov_2.296089	127	207	28	14	80	0.1750000
NODE_209605_length_278_cov_2.296089	127	207	29	5	80	0.0625000
NODE_209605_length_278_cov_2.296089	127	207	30	6	80	0.0750000
NODE_209883_length_278_cov_1.731844	145	194	35	3	49	0.0612245
NODE_209883_length_278_cov_1.731844	145	194	38	1	49	0.0204082
NODE_209883_length_278_cov_1.731844	145	194	39	1	49	0.0204082
NODE_209883_length_278_cov_1.731844	145	194	41	6	49	0.1224490
NODE_209883_length_278_cov_1.731844	145	194	43	2	49	0.0408163
NODE_209883_length_278_cov_1.731844	145	194	45	1	49	0.0204082
NODE_209883_length_278_cov_1.731844	145	194	47	4	49	0.0816327
NODE_209883_length_278_cov_1.731844	145	194	49	3	49	0.0612245
NODE_209883_length_278_cov_1.731844	145	194	53	10	49	0.2040816
NODE_209883_length_278_cov_1.731844	145	194	55	2	49	0.0408163
NODE_209883_length_278_cov_1.731844	145	194	57	5	49	0.1020408
NODE_209883_length_278_cov_1.731844	145	194	59	6	49	0.1224490
NODE_209883_length_278_cov_1.731844	145	194	61	1	49	0.0204082
NODE_209883_length_278_cov_1.731844	145	194	63	4	49	0.0816327
NODE_210038_length_278_cov_1.681564	129	184	0	34	55	0.6181818
NODE_210038_length_278_cov_1.681564	129	184	2	21	55	0.3818182
NODE_210068_length_278_cov_1.636872	13	41	10	1	28	0.0357143
NODE_210068_length_278_cov_1.636872	13	41	12	1	28	0.0357143
NODE_210068_length_278_cov_1.636872	13	41	14	5	28	0.1785714
NODE_210068_length_278_cov_1.636872	13	41	16	21	28	0.7500000
NODE_210373_length_278_cov_1.290503	3	67	7	1	64	0.0156250
NODE_210373_length_278_cov_1.290503	3	67	8	3	64	0.0468750
NODE_210373_length_278_cov_1.290503	3	67	13	3	64	0.0468750
NODE_210373_length_278_cov_1.290503	3	67	14	1	64	0.0156250
NODE_210373_length_278_cov_1.290503	3	67	16	4	64	0.0625000
NODE_210373_length_278_cov_1.290503	3	67	20	1	64	0.0156250
NODE_210373_length_278_cov_1.290503	3	67	22	1	64	0.0156250
NODE_210373_length_278_cov_1.290503	3	67	26	2	64	0.0312500
NODE_210373_length_278_cov_1.290503	3	67	31	2	64	0.0312500
NODE_210373_length_278_cov_1.290503	3	67	32	1	64	0.0156250
NODE_210373_length_278_cov_1.290503	3	67	34	1	64	0.0156250
NODE_210373_length_278_cov_1.290503	3	67	40	1	64	0.0156250
NODE_210373_length_278_cov_1.290503	3	67	42	1	64	0.0156250
NODE_210373_length_278_cov_1.290503	3	67	44	1	64	0.0156250
NODE_210373_length_278_cov_1.290503	3	67	47	4	64	0.0625000
NODE_210373_length_278_cov_1.290503	3	67	51	7	64	0.1093750
NODE_210373_length_278_cov_1.290503	3	67	52	1	64	0.0156250
NODE_210373_length_278_cov_1.290503	3	67	53	1	64	0.0156250
NODE_210373_length_278_cov_1.290503	3	67	55	2	64	0.0312500
NODE_210373_length_278_cov_1.290503	3	67	57	11	64	0.1718750
NODE_210373_length_278_cov_1.290503	3	67	58	6	64	0.0937500
NODE_210373_length_278_cov_1.290503	3	67	60	9	64	0.1406250
NODE_210373_length_278_cov_1.290503	3	67	7	1	64	0.0156250
NODE_210373_length_278_cov_1.290503	3	67	8	3	64	0.0468750
NODE_210373_length_278_cov_1.290503	3	67	13	3	64	0.0468750
NODE_210373_length_278_cov_1.290503	3	67	14	1	64	0.0156250
NODE_210373_length_278_cov_1.290503	3	67	16	4	64	0.0625000
NODE_210373_length_278_cov_1.290503	3	67	20	1	64	0.0156250
NODE_210373_length_278_cov_1.290503	3	67	22	1	64	0.0156250
NODE_210373_length_278_cov_1.290503	3	67	26	2	64	0.0312500
NODE_210373_length_278_cov_1.290503	3	67	31	2	64	0.0312500
NODE_210373_length_278_cov_1.290503	3	67	32	1	64	0.0156250
NODE_210373_length_278_cov_1.290503	3	67	34	1	64	0.0156250
NODE_210373_length_278_cov_1.290503	3	67	40	1	64	0.0156250
NODE_210373_length_278_cov_1.290503	3	67	42	1	64	0.0156250
NODE_210373_length_278_cov_1.290503	3	67	44	1	64	0.0156250
NODE_210373_length_278_cov_1.290503	3	67	47	4	64	0.0625000
NODE_210373_length_278_cov_1.290503	3	67	51	7	64	0.1093750
NODE_210373_length_278_cov_1.290503	3	67	52	1	64	0.0156250
NODE_210373_length_278_cov_1.290503	3	67	53	1	64	0.0156250
NODE_210373_length_278_cov_1.290503	3	67	55	2	64	0.0312500
NODE_210373_length_278_cov_1.290503	3	67	57	11	64	0.1718750
NODE_210373_length_278_cov_1.290503	3	67	58	6	64	0.0937500
NODE_210373_length_278_cov_1.290503	3	67	60	9	64	0.1406250
NODE_210373_length_278_cov_1.290503	3	67	7	1	64	0.0156250
NODE_210373_length_278_cov_1.290503	3	67	8	3	64	0.0468750
NODE_210373_length_278_cov_1.290503	3	67	13	3	64	0.0468750
NODE_210373_length_278_cov_1.290503	3	67	14	1	64	0.0156250
NODE_210373_length_278_cov_1.290503	3	67	16	4	64	0.0625000
NODE_210373_length_278_cov_1.290503	3	67	20	1	64	0.0156250
NODE_210373_length_278_cov_1.290503	3	67	22	1	64	0.0156250
NODE_210373_length_278_cov_1.290503	3	67	26	2	64	0.0312500
NODE_210373_length_278_cov_1.290503	3	67	31	2	64	0.0312500
NODE_210373_length_278_cov_1.290503	3	67	32	1	64	0.0156250
NODE_210373_length_278_cov_1.290503	3	67	34	1	64	0.0156250
NODE_210373_length_278_cov_1.290503	3	67	40	1	64	0.0156250
NODE_210373_length_278_cov_1.290503	3	67	42	1	64	0.0156250
NODE_210373_length_278_cov_1.290503	3	67	44	1	64	0.0156250
NODE_210373_length_278_cov_1.290503	3	67	47	4	64	0.0625000
NODE_210373_length_278_cov_1.290503	3	67	51	7	64	0.1093750
NODE_210373_length_278_cov_1.290503	3	67	52	1	64	0.0156250
NODE_210373_length_278_cov_1.290503	3	67	53	1	64	0.0156250
NODE_210373_length_278_cov_1.290503	3	67	55	2	64	0.0312500
NODE_210373_length_278_cov_1.290503	3	67	57	11	64	0.1718750
NODE_210373_length_278_cov_1.290503	3	67	58	6	64	0.0937500
NODE_210373_length_278_cov_1.290503	3	67	60	9	64	0.1406250
NODE_210463_length_278_cov_1.150838	52	76	6	24	24	1.0000000
NODE_210463_length_278_cov_1.150838	58	84	4	6	26	0.2307692
NODE_210463_length_278_cov_1.150838	58	84	6	20	26	0.7692308
NODE_210559_length_278_cov_1.139665	108	187	0	79	79	1.0000000
NODE_210612_length_278_cov_1.139665	232	278	0	46	46	1.0000000
NODE_210691_length_278_cov_1.139665	210	278	0	18	68	0.2647059
NODE_210691_length_278_cov_1.139665	210	278	2	50	68	0.7352941
NODE_212166_length_277_cov_2.691011	0	60	0	60	60	1.0000000
NODE_212166_length_277_cov_2.691011	33	113	0	80	80	1.0000000
NODE_212175_length_277_cov_2.617978	85	127	0	42	42	1.0000000
NODE_212233_length_277_cov_2.438202	137	218	2	6	81	0.0740741
NODE_212233_length_277_cov_2.438202	137	218	4	52	81	0.6419753
NODE_212233_length_277_cov_2.438202	137	218	6	23	81	0.2839506
NODE_212357_length_277_cov_2.140449	234	276	0	42	42	1.0000000
NODE_212377_length_277_cov_2.095506	41	114	0	73	73	1.0000000
NODE_212377_length_277_cov_2.095506	41	114	0	73	73	1.0000000
NODE_212377_length_277_cov_2.095506	94	161	0	54	67	0.8059701
NODE_212377_length_277_cov_2.095506	94	161	2	13	67	0.1940299
NODE_212525_length_277_cov_1.837079	92	172	0	80	80	1.0000000
NODE_212558_length_277_cov_1.764045	115	155	0	16	40	0.4000000
NODE_212558_length_277_cov_1.764045	115	155	2	7	40	0.1750000
NODE_212558_length_277_cov_1.764045	115	155	3	4	40	0.1000000
NODE_212558_length_277_cov_1.764045	115	155	5	8	40	0.2000000
NODE_212558_length_277_cov_1.764045	115	155	7	1	40	0.0250000
NODE_212558_length_277_cov_1.764045	115	155	9	4	40	0.1000000
NODE_212605_length_277_cov_1.719101	150	215	4	65	65	1.0000000
NODE_212845_length_277_cov_1.505618	0	47	8	2	47	0.0425532
NODE_212845_length_277_cov_1.505618	0	47	14	45	47	0.9574468
NODE_212845_length_277_cov_1.505618	20	100	0	11	80	0.1375000
NODE_212845_length_277_cov_1.505618	20	100	2	2	80	0.0250000
NODE_212845_length_277_cov_1.505618	20	100	4	1	80	0.0125000
NODE_212845_length_277_cov_1.505618	20	100	14	66	80	0.8250000
NODE_212970_length_277_cov_1.426966	113	191	0	5	78	0.0641026
NODE_212970_length_277_cov_1.426966	113	191	2	29	78	0.3717949
NODE_212970_length_277_cov_1.426966	113	191	4	22	78	0.2820513
NODE_212970_length_277_cov_1.426966	113	191	6	22	78	0.2820513
NODE_213057_length_277_cov_1.314607	127	176	4	49	49	1.0000000
NODE_213091_length_277_cov_1.258427	141	222	0	81	81	1.0000000
NODE_213223_length_277_cov_1.146067	19	95	2	15	76	0.1973684
NODE_213223_length_277_cov_1.146067	19	95	4	15	76	0.1973684
NODE_213223_length_277_cov_1.146067	19	95	6	27	76	0.3552631
NODE_213223_length_277_cov_1.146067	19	95	8	11	76	0.1447368
NODE_213223_length_277_cov_1.146067	19	95	10	7	76	0.0921053
NODE_213223_length_277_cov_1.146067	19	95	11	1	76	0.0131579
NODE_213490_length_277_cov_1.061798	67	105	0	38	38	1.0000000
NODE_213505_length_277_cov_1.044944	19	77	0	58	58	1.0000000
NODE_214572_length_276_cov_31.774011	91	153	9	7	62	0.1129032
NODE_214572_length_276_cov_31.774011	91	153	11	1	62	0.0161290
NODE_214572_length_276_cov_31.774011	91	153	13	1	62	0.0161290
NODE_214572_length_276_cov_31.774011	91	153	14	4	62	0.0645161
NODE_214572_length_276_cov_31.774011	91	153	15	3	62	0.0483871
NODE_214572_length_276_cov_31.774011	91	153	16	5	62	0.0806452
NODE_214572_length_276_cov_31.774011	91	153	17	1	62	0.0161290
NODE_214572_length_276_cov_31.774011	91	153	18	1	62	0.0161290
NODE_214572_length_276_cov_31.774011	91	153	25	3	62	0.0483871
NODE_214572_length_276_cov_31.774011	91	153	26	2	62	0.0322581
NODE_214572_length_276_cov_31.774011	91	153	28	6	62	0.0967742
NODE_214572_length_276_cov_31.774011	91	153	30	4	62	0.0645161
NODE_214572_length_276_cov_31.774011	91	153	34	1	62	0.0161290
NODE_214572_length_276_cov_31.774011	91	153	37	1	62	0.0161290
NODE_214572_length_276_cov_31.774011	91	153	43	5	62	0.0806452
NODE_214572_length_276_cov_31.774011	91	153	45	3	62	0.0483871
NODE_214572_length_276_cov_31.774011	91	153	47	5	62	0.0806452
NODE_214572_length_276_cov_31.774011	91	153	49	6	62	0.0967742
NODE_214572_length_276_cov_31.774011	91	153	51	1	62	0.0161290
NODE_214572_length_276_cov_31.774011	91	153	55	2	62	0.0322581
NODE_214576_length_276_cov_10.056497	66	146	0	51	80	0.6375000
NODE_214576_length_276_cov_10.056497	66	146	2	29	80	0.3625000
NODE_214698_length_276_cov_3.564972	176	256	0	12	80	0.1500000
NODE_214698_length_276_cov_3.564972	176	256	2	68	80	0.8500000
NODE_214785_length_276_cov_2.920904	203	260	0	57	57	1.0000000
NODE_214785_length_276_cov_2.920904	233	276	0	43	43	1.0000000
NODE_214883_length_276_cov_2.542373	164	204	6	13	40	0.3250000
NODE_214883_length_276_cov_2.542373	164	204	8	2	40	0.0500000
NODE_214883_length_276_cov_2.542373	164	204	10	11	40	0.2750000
NODE_214883_length_276_cov_2.542373	164	204	11	1	40	0.0250000
NODE_214883_length_276_cov_2.542373	164	204	12	13	40	0.3250000
NODE_215016_length_276_cov_2.197740	64	144	2	80	80	1.0000000
NODE_215086_length_276_cov_2.022599	136	193	0	1	57	0.0175439
NODE_215086_length_276_cov_2.022599	136	193	2	2	57	0.0350877
NODE_215086_length_276_cov_2.022599	136	193	4	54	57	0.9473684
NODE_215105_length_276_cov_2.016949	97	138	0	41	41	1.0000000
NODE_215139_length_276_cov_2.005650	82	153	0	15	71	0.2112676
NODE_215139_length_276_cov_2.005650	82	153	2	56	71	0.7887324
NODE_215234_length_276_cov_1.734463	102	182	2	3	80	0.0375000
NODE_215234_length_276_cov_1.734463	102	182	6	1	80	0.0125000
NODE_215234_length_276_cov_1.734463	102	182	8	1	80	0.0125000
NODE_215234_length_276_cov_1.734463	102	182	10	6	80	0.0750000
NODE_215234_length_276_cov_1.734463	102	182	12	2	80	0.0250000
NODE_215234_length_276_cov_1.734463	102	182	15	2	80	0.0250000
NODE_215234_length_276_cov_1.734463	102	182	16	1	80	0.0125000
NODE_215234_length_276_cov_1.734463	102	182	24	4	80	0.0500000
NODE_215234_length_276_cov_1.734463	102	182	29	3	80	0.0375000
NODE_215234_length_276_cov_1.734463	102	182	31	4	80	0.0500000
NODE_215234_length_276_cov_1.734463	102	182	35	2	80	0.0250000
NODE_215234_length_276_cov_1.734463	102	182	39	1	80	0.0125000
NODE_215234_length_276_cov_1.734463	102	182	41	24	80	0.3000000
NODE_215234_length_276_cov_1.734463	102	182	44	8	80	0.1000000
NODE_215234_length_276_cov_1.734463	102	182	46	6	80	0.0750000
NODE_215234_length_276_cov_1.734463	102	182	48	1	80	0.0125000
NODE_215234_length_276_cov_1.734463	102	182	52	5	80	0.0625000
NODE_215234_length_276_cov_1.734463	102	182	56	6	80	0.0750000
NODE_215516_length_276_cov_1.525424	70	116	2	46	46	1.0000000
NODE_215516_length_276_cov_1.525424	123	169	0	42	46	0.9130435
NODE_215516_length_276_cov_1.525424	123	169	2	4	46	0.0869565
NODE_215519_length_276_cov_1.514124	115	155	16	2	40	0.0500000
NODE_215519_length_276_cov_1.514124	115	155	18	38	40	0.9500000
NODE_215748_length_276_cov_1.288136	114	154	4	17	40	0.4250000
NODE_215748_length_276_cov_1.288136	114	154	6	23	40	0.5750000
NODE_216141_length_276_cov_1.124294	122	170	2	34	48	0.7083333
NODE_216141_length_276_cov_1.124294	122	170	4	14	48	0.2916667
NODE_216141_length_276_cov_1.124294	132	163	2	21	31	0.6774194
NODE_216141_length_276_cov_1.124294	132	163	4	10	31	0.3225806
NODE_216220_length_276_cov_1.039548	7	68	0	16	61	0.2622951
NODE_216220_length_276_cov_1.039548	7	68	2	45	61	0.7377049
NODE_216220_length_276_cov_1.039548	7	70	0	16	63	0.2539683
NODE_216220_length_276_cov_1.039548	7	70	2	47	63	0.7460318
NODE_216220_length_276_cov_1.039548	7	70	0	16	63	0.2539683
NODE_216220_length_276_cov_1.039548	7	70	2	47	63	0.7460318
NODE_216220_length_276_cov_1.039548	7	70	0	16	63	0.2539683
NODE_216220_length_276_cov_1.039548	7	70	2	47	63	0.7460318
NODE_216269_length_276_cov_1.000000	48	89	4	41	41	1.0000000
NODE_216269_length_276_cov_1.000000	62	106	4	44	44	1.0000000
NODE_216414_length_276_cov_0.898305	54	105	2	51	51	1.0000000
NODE_217265_length_275_cov_85.085227	94	174	6	29	80	0.3625000
NODE_217265_length_275_cov_85.085227	94	174	10	4	80	0.0500000
NODE_217265_length_275_cov_85.085227	94	174	11	9	80	0.1125000
NODE_217265_length_275_cov_85.085227	94	174	12	38	80	0.4750000
NODE_217265_length_275_cov_85.085227	147	227	0	34	80	0.4250000
NODE_217265_length_275_cov_85.085227	147	227	6	46	80	0.5750000
NODE_217287_length_275_cov_5.818182	0	44	0	44	44	1.0000000
NODE_217355_length_275_cov_3.857955	0	67	0	67	67	1.0000000
NODE_217396_length_275_cov_3.306818	199	275	0	76	76	1.0000000
NODE_217402_length_275_cov_3.284091	127	175	0	48	48	1.0000000
NODE_217433_length_275_cov_2.977273	95	145	10	27	50	0.5400000
NODE_217433_length_275_cov_2.977273	95	145	12	23	50	0.4600000
NODE_217531_length_275_cov_2.585227	85	122	70	20	37	0.5405405
NODE_217531_length_275_cov_2.585227	85	122	72	17	37	0.4594595
NODE_217714_length_275_cov_2.090909	0	47	0	47	47	1.0000000
NODE_217714_length_275_cov_2.090909	20	91	0	71	71	1.0000000
NODE_217801_length_275_cov_1.960227	198	251	0	53	53	1.0000000
NODE_217835_length_275_cov_1.875000	190	247	0	57	57	1.0000000
NODE_217839_length_275_cov_1.857955	52	119	2	67	67	1.0000000
NODE_217839_length_275_cov_1.857955	136	182	0	19	46	0.4130435
NODE_217839_length_275_cov_1.857955	136	182	2	27	46	0.5869565
NODE_217885_length_275_cov_1.755682	21	76	2	13	55	0.2363636
NODE_217885_length_275_cov_1.755682	21	76	5	2	55	0.0363636
NODE_217885_length_275_cov_1.755682	21	76	7	40	55	0.7272727
NODE_217912_length_275_cov_1.738636	225	256	0	31	31	1.0000000
NODE_217967_length_275_cov_1.738636	161	241	0	80	80	1.0000000
NODE_218257_length_275_cov_1.448864	123	155	12	15	32	0.4687500
NODE_218257_length_275_cov_1.448864	123	155	13	6	32	0.1875000
NODE_218257_length_275_cov_1.448864	123	155	14	11	32	0.3437500
NODE_218402_length_275_cov_1.301136	132	196	0	64	64	1.0000000
NODE_218706_length_275_cov_1.159091	13	93	1	4	80	0.0500000
NODE_218706_length_275_cov_1.159091	13	93	2	19	80	0.2375000
NODE_218706_length_275_cov_1.159091	13	93	3	57	80	0.7125000
NODE_218734_length_275_cov_1.153409	11	91	0	80	80	1.0000000
NODE_219031_length_275_cov_0.937500	13	49	15	1	36	0.0277778
NODE_219031_length_275_cov_0.937500	13	49	16	11	36	0.3055556
NODE_219031_length_275_cov_0.937500	13	49	17	5	36	0.1388889
NODE_219031_length_275_cov_0.937500	13	49	21	1	36	0.0277778
NODE_219031_length_275_cov_0.937500	13	49	23	11	36	0.3055556
NODE_219031_length_275_cov_0.937500	13	49	24	1	36	0.0277778
NODE_219031_length_275_cov_0.937500	13	49	26	6	36	0.1666667
NODE_219031_length_275_cov_0.937500	22	86	16	3	64	0.0468750
NODE_219031_length_275_cov_0.937500	22	86	17	5	64	0.0781250
NODE_219031_length_275_cov_0.937500	22	86	21	1	64	0.0156250
NODE_219031_length_275_cov_0.937500	22	86	23	11	64	0.1718750
NODE_219031_length_275_cov_0.937500	22	86	24	1	64	0.0156250
NODE_219031_length_275_cov_0.937500	22	86	26	6	64	0.0937500
NODE_219031_length_275_cov_0.937500	22	86	29	10	64	0.1562500
NODE_219031_length_275_cov_0.937500	22	86	31	2	64	0.0312500
NODE_219031_length_275_cov_0.937500	22	86	32	10	64	0.1562500
NODE_219031_length_275_cov_0.937500	22	86	34	7	64	0.1093750
NODE_219031_length_275_cov_0.937500	22	86	44	1	64	0.0156250
NODE_219031_length_275_cov_0.937500	22	86	48	1	64	0.0156250
NODE_219031_length_275_cov_0.937500	22	86	54	1	64	0.0156250
NODE_219031_length_275_cov_0.937500	22	86	58	2	64	0.0312500
NODE_219031_length_275_cov_0.937500	22	86	60	1	64	0.0156250
NODE_219031_length_275_cov_0.937500	22	86	62	2	64	0.0312500
NODE_219220_length_275_cov_0.869318	67	126	0	59	59	1.0000000
NODE_219655_length_275_cov_0.579545	40	70	0	30	30	1.0000000
NODE_220021_length_274_cov_6.074286	141	175	2	34	34	1.0000000
NODE_220047_length_274_cov_4.845714	48	105	0	57	57	1.0000000
NODE_220047_length_274_cov_4.845714	113	175	0	62	62	1.0000000
NODE_220078_length_274_cov_4.080000	210	274	0	64	64	1.0000000
NODE_220215_length_274_cov_2.988571	104	161	0	57	57	1.0000000
NODE_220221_length_274_cov_2.937143	199	234	0	35	35	1.0000000
NODE_220293_length_274_cov_2.622857	29	76	3	13	47	0.2765957
NODE_220293_length_274_cov_2.622857	29	76	5	34	47	0.7234042
NODE_220293_length_274_cov_2.622857	82	157	0	14	75	0.1866667
NODE_220293_length_274_cov_2.622857	82	157	1	61	75	0.8133333
NODE_220413_length_274_cov_2.308571	51	130	3	2	79	0.0253165
NODE_220413_length_274_cov_2.308571	51	130	5	2	79	0.0253165
NODE_220413_length_274_cov_2.308571	51	130	7	5	79	0.0632911
NODE_220413_length_274_cov_2.308571	51	130	9	7	79	0.0886076
NODE_220413_length_274_cov_2.308571	51	130	13	3	79	0.0379747
NODE_220413_length_274_cov_2.308571	51	130	15	5	79	0.0632911
NODE_220413_length_274_cov_2.308571	51	130	18	5	79	0.0632911
NODE_220413_length_274_cov_2.308571	51	130	19	1	79	0.0126582
NODE_220413_length_274_cov_2.308571	51	130	20	4	79	0.0506329
NODE_220413_length_274_cov_2.308571	51	130	22	4	79	0.0506329
NODE_220413_length_274_cov_2.308571	51	130	29	2	79	0.0253165
NODE_220413_length_274_cov_2.308571	51	130	30	2	79	0.0253165
NODE_220413_length_274_cov_2.308571	51	130	32	1	79	0.0126582
NODE_220413_length_274_cov_2.308571	51	130	34	8	79	0.1012658
NODE_220413_length_274_cov_2.308571	51	130	36	1	79	0.0126582
NODE_220413_length_274_cov_2.308571	51	130	40	1	79	0.0126582
NODE_220413_length_274_cov_2.308571	51	130	42	1	79	0.0126582
NODE_220413_length_274_cov_2.308571	51	130	44	1	79	0.0126582
NODE_220413_length_274_cov_2.308571	51	130	45	2	79	0.0253165
NODE_220413_length_274_cov_2.308571	51	130	47	20	79	0.2531646
NODE_220413_length_274_cov_2.308571	51	130	49	2	79	0.0253165
NODE_220504_length_274_cov_2.062857	172	242	2	65	70	0.9285714
NODE_220504_length_274_cov_2.062857	172	242	4	5	70	0.0714286
NODE_220504_length_274_cov_2.062857	215	256	0	3	41	0.0731707
NODE_220504_length_274_cov_2.062857	215	256	2	38	41	0.9268293
NODE_220662_length_274_cov_1.754286	219	259	2	40	40	1.0000000
NODE_220681_length_274_cov_1.748571	168	231	0	63	63	1.0000000
NODE_220806_length_274_cov_1.737143	134	172	0	38	38	1.0000000
NODE_220847_length_274_cov_1.685714	132	189	0	57	57	1.0000000
NODE_220847_length_274_cov_1.685714	141	199	0	58	58	1.0000000
NODE_220966_length_274_cov_1.502857	170	232	0	62	62	1.0000000
NODE_220966_length_274_cov_1.502857	223	274	0	51	51	1.0000000
NODE_221005_length_274_cov_1.457143	118	147	0	29	29	1.0000000
NODE_221101_length_274_cov_1.434286	25	69	2	7	44	0.1590909
NODE_221101_length_274_cov_1.434286	25	69	4	37	44	0.8409091
NODE_221211_length_274_cov_1.285714	84	156	0	34	72	0.4722222
NODE_221211_length_274_cov_1.285714	84	156	2	38	72	0.5277778
NODE_221612_length_274_cov_1.131429	205	251	2	1	46	0.0217391
NODE_221612_length_274_cov_1.131429	205	251	4	43	46	0.9347826
NODE_221612_length_274_cov_1.131429	205	251	6	2	46	0.0434783
NODE_221764_length_274_cov_0.994286	219	260	0	41	41	1.0000000
NODE_222849_length_273_cov_4.948276	204	262	0	58	58	1.0000000
NODE_222849_length_273_cov_4.948276	204	258	0	54	54	1.0000000
NODE_222914_length_273_cov_3.712644	103	183	4	1	80	0.0125000
NODE_222914_length_273_cov_3.712644	103	183	7	2	80	0.0250000
NODE_222914_length_273_cov_3.712644	103	183	9	4	80	0.0500000
NODE_222914_length_273_cov_3.712644	103	183	13	2	80	0.0250000
NODE_222914_length_273_cov_3.712644	103	183	15	2	80	0.0250000
NODE_222914_length_273_cov_3.712644	103	183	17	7	80	0.0875000
NODE_222914_length_273_cov_3.712644	103	183	19	10	80	0.1250000
NODE_222914_length_273_cov_3.712644	103	183	21	52	80	0.6500000
NODE_222955_length_273_cov_3.298851	69	100	2	31	31	1.0000000
NODE_222955_length_273_cov_3.298851	73	153	0	29	80	0.3625000
NODE_222955_length_273_cov_3.298851	73	153	2	51	80	0.6375000
NODE_222974_length_273_cov_3.195402	122	189	0	9	67	0.1343284
NODE_222974_length_273_cov_3.195402	122	189	2	17	67	0.2537313
NODE_222974_length_273_cov_3.195402	122	189	4	2	67	0.0298507
NODE_222974_length_273_cov_3.195402	122	189	6	39	67	0.5820895
NODE_222991_length_273_cov_3.063218	76	151	19	2	75	0.0266667
NODE_222991_length_273_cov_3.063218	76	151	23	3	75	0.0400000
NODE_222991_length_273_cov_3.063218	76	151	24	5	75	0.0666667
NODE_222991_length_273_cov_3.063218	76	151	25	2	75	0.0266667
NODE_222991_length_273_cov_3.063218	76	151	27	1	75	0.0133333
NODE_222991_length_273_cov_3.063218	76	151	33	3	75	0.0400000
NODE_222991_length_273_cov_3.063218	76	151	35	1	75	0.0133333
NODE_222991_length_273_cov_3.063218	76	151	37	1	75	0.0133333
NODE_222991_length_273_cov_3.063218	76	151	38	1	75	0.0133333
NODE_222991_length_273_cov_3.063218	76	151	40	17	75	0.2266667
NODE_222991_length_273_cov_3.063218	76	151	42	22	75	0.2933333
NODE_222991_length_273_cov_3.063218	76	151	44	14	75	0.1866667
NODE_222991_length_273_cov_3.063218	76	151	46	3	75	0.0400000
NODE_222991_length_273_cov_3.063218	135	191	2	10	56	0.1785714
NODE_222991_length_273_cov_3.063218	135	191	4	8	56	0.1428571
NODE_222991_length_273_cov_3.063218	135	191	8	17	56	0.3035714
NODE_222991_length_273_cov_3.063218	135	191	10	1	56	0.0178571
NODE_222991_length_273_cov_3.063218	135	191	14	3	56	0.0535714
NODE_222991_length_273_cov_3.063218	135	191	18	1	56	0.0178571
NODE_222991_length_273_cov_3.063218	135	191	19	2	56	0.0357143
NODE_222991_length_273_cov_3.063218	135	191	23	3	56	0.0535714
NODE_222991_length_273_cov_3.063218	135	191	24	5	56	0.0892857
NODE_222991_length_273_cov_3.063218	135	191	25	2	56	0.0357143
NODE_222991_length_273_cov_3.063218	135	191	27	1	56	0.0178571
NODE_222991_length_273_cov_3.063218	135	191	33	3	56	0.0535714
NODE_223066_length_273_cov_2.706897	11	45	0	34	34	1.0000000
NODE_223203_length_273_cov_2.339080	69	145	6	11	76	0.1447368
NODE_223203_length_273_cov_2.339080	69	145	8	20	76	0.2631579
NODE_223203_length_273_cov_2.339080	69	145	10	14	76	0.1842105
NODE_223203_length_273_cov_2.339080	69	145	12	1	76	0.0131579
NODE_223203_length_273_cov_2.339080	69	145	16	24	76	0.3157895
NODE_223203_length_273_cov_2.339080	69	145	18	6	76	0.0789474
NODE_223353_length_273_cov_2.051724	31	74	0	43	43	1.0000000
NODE_223377_length_273_cov_2.034483	81	161	4	66	80	0.8250000
NODE_223377_length_273_cov_2.034483	81	161	6	14	80	0.1750000
NODE_223377_length_273_cov_2.034483	213	263	0	27	50	0.5400000
NODE_223377_length_273_cov_2.034483	213	263	2	23	50	0.4600000
NODE_223680_length_273_cov_1.706897	181	238	0	57	57	1.0000000
NODE_223913_length_273_cov_1.442529	5	47	2	42	42	1.0000000
NODE_224023_length_273_cov_1.281609	167	247	0	80	80	1.0000000
NODE_224082_length_273_cov_1.189655	120	156	0	36	36	1.0000000
NODE_224082_length_273_cov_1.189655	129	160	0	31	31	1.0000000
NODE_224165_length_273_cov_1.172414	94	130	4	35	36	0.9722222
NODE_224165_length_273_cov_1.172414	94	130	6	1	36	0.0277778
NODE_224254_length_273_cov_1.172414	8	58	0	50	50	1.0000000
NODE_224367_length_273_cov_1.166667	74	93	0	19	19	1.0000000
NODE_224441_length_273_cov_1.091954	6	42	0	8	36	0.2222222
NODE_224441_length_273_cov_1.091954	6	42	2	28	36	0.7777778
NODE_224441_length_273_cov_1.091954	43	95	2	52	52	1.0000000
NODE_224587_length_273_cov_0.971264	188	235	0	47	47	1.0000000
NODE_225303_length_273_cov_0.586207	27	88	0	61	61	1.0000000
NODE_225344_length_273_cov_0.586207	24	79	0	3	55	0.0545455
NODE_225344_length_273_cov_0.586207	24	79	2	19	55	0.3454545
NODE_225344_length_273_cov_0.586207	24	79	4	33	55	0.6000000
NODE_225344_length_273_cov_0.586207	81	113	4	13	32	0.4062500
NODE_225344_length_273_cov_0.586207	81	113	6	19	32	0.5937500
NODE_225592_length_272_cov_6.190751	172	236	0	64	64	1.0000000
NODE_225607_length_272_cov_5.335260	193	272	0	79	79	1.0000000
NODE_225633_length_272_cov_4.716763	228	257	0	29	29	1.0000000
NODE_225656_length_272_cov_4.219653	93	166	0	13	73	0.1780822
NODE_225656_length_272_cov_4.219653	93	166	4	60	73	0.8219178
NODE_225656_length_272_cov_4.219653	146	219	4	73	73	1.0000000
NODE_225658_length_272_cov_4.184971	75	128	2	4	53	0.0754717
NODE_225658_length_272_cov_4.184971	75	128	4	4	53	0.0754717
NODE_225658_length_272_cov_4.184971	75	128	6	4	53	0.0754717
NODE_225658_length_272_cov_4.184971	75	128	8	30	53	0.5660377
NODE_225658_length_272_cov_4.184971	75	128	10	5	53	0.0943396
NODE_225658_length_272_cov_4.184971	75	128	11	3	53	0.0566038
NODE_225658_length_272_cov_4.184971	75	128	14	3	53	0.0566038
NODE_225739_length_272_cov_3.352601	154	199	0	3	45	0.0666667
NODE_225739_length_272_cov_3.352601	154	199	2	42	45	0.9333333
NODE_225872_length_272_cov_2.664740	106	186	0	11	80	0.1375000
NODE_225872_length_272_cov_2.664740	106	186	2	4	80	0.0500000
NODE_225872_length_272_cov_2.664740	106	186	4	65	80	0.8125000
NODE_226010_length_272_cov_2.335260	33	103	0	70	70	1.0000000
NODE_226029_length_272_cov_2.277457	219	256	0	37	37	1.0000000
NODE_226045_length_272_cov_2.236994	104	184	2	6	80	0.0750000
NODE_226045_length_272_cov_2.236994	104	184	4	12	80	0.1500000
NODE_226045_length_272_cov_2.236994	104	184	6	1	80	0.0125000
NODE_226045_length_272_cov_2.236994	104	184	8	1	80	0.0125000
NODE_226045_length_272_cov_2.236994	104	184	10	5	80	0.0625000
NODE_226045_length_272_cov_2.236994	104	184	12	12	80	0.1500000
NODE_226045_length_272_cov_2.236994	104	184	14	2	80	0.0250000
NODE_226045_length_272_cov_2.236994	104	184	16	4	80	0.0500000
NODE_226045_length_272_cov_2.236994	104	184	18	37	80	0.4625000
NODE_226169_length_272_cov_1.982659	172	252	0	80	80	1.0000000
NODE_226245_length_272_cov_1.780347	37	99	0	39	62	0.6290323
NODE_226245_length_272_cov_1.780347	37	99	2	23	62	0.3709677
NODE_226245_length_272_cov_1.780347	90	152	0	62	62	1.0000000
NODE_226248_length_272_cov_1.768786	12	45	0	33	33	1.0000000
NODE_226461_length_272_cov_1.618497	97	160	6	5	63	0.0793651
NODE_226461_length_272_cov_1.618497	97	160	10	19	63	0.3015873
NODE_226461_length_272_cov_1.618497	97	160	12	7	63	0.1111111
NODE_226461_length_272_cov_1.618497	97	160	14	6	63	0.0952381
NODE_226461_length_272_cov_1.618497	97	160	16	12	63	0.1904762
NODE_226461_length_272_cov_1.618497	97	160	18	9	63	0.1428571
NODE_226461_length_272_cov_1.618497	97	160	19	1	63	0.0158730
NODE_226461_length_272_cov_1.618497	97	160	20	4	63	0.0634921
NODE_226508_length_272_cov_1.543353	69	137	2	68	68	1.0000000
NODE_227037_length_272_cov_1.173410	147	203	2	19	56	0.3392857
NODE_227037_length_272_cov_1.173410	147	203	4	37	56	0.6607143
NODE_227265_length_272_cov_0.988439	169	215	0	46	46	1.0000000
NODE_227444_length_272_cov_0.884393	126	163	0	37	37	1.0000000
NODE_228332_length_271_cov_5.238372	103	183	2	80	80	1.0000000
NODE_228423_length_271_cov_3.546512	102	165	0	51	63	0.8095238
NODE_228423_length_271_cov_3.546512	102	165	2	12	63	0.1904762
NODE_228429_length_271_cov_3.476744	62	93	0	31	31	1.0000000
NODE_228494_length_271_cov_2.959302	96	176	0	42	80	0.5250000
NODE_228494_length_271_cov_2.959302	96	176	2	12	80	0.1500000
NODE_228494_length_271_cov_2.959302	96	176	4	3	80	0.0375000
NODE_228494_length_271_cov_2.959302	96	176	6	23	80	0.2875000
NODE_228494_length_271_cov_2.959302	149	229	2	1	80	0.0125000
NODE_228494_length_271_cov_2.959302	149	229	4	3	80	0.0375000
NODE_228494_length_271_cov_2.959302	149	229	6	76	80	0.9500000
NODE_228554_length_271_cov_2.715116	160	241	0	81	81	1.0000000
NODE_228593_length_271_cov_2.622093	180	253	0	73	73	1.0000000
NODE_228623_length_271_cov_2.465116	45	75	0	17	30	0.5666667
NODE_228623_length_271_cov_2.465116	45	75	2	13	30	0.4333333
NODE_228731_length_271_cov_2.284884	95	158	4	2	63	0.0317460
NODE_228731_length_271_cov_2.284884	95	158	6	22	63	0.3492064
NODE_228731_length_271_cov_2.284884	95	158	7	1	63	0.0158730
NODE_228731_length_271_cov_2.284884	95	158	8	31	63	0.4920635
NODE_228731_length_271_cov_2.284884	95	158	10	7	63	0.1111111
NODE_228731_length_271_cov_2.284884	131	211	2	52	80	0.6500000
NODE_228731_length_271_cov_2.284884	131	211	4	3	80	0.0375000
NODE_228731_length_271_cov_2.284884	131	211	6	22	80	0.2750000
NODE_228731_length_271_cov_2.284884	131	211	7	1	80	0.0125000
NODE_228731_length_271_cov_2.284884	131	211	8	2	80	0.0250000
NODE_228737_length_271_cov_2.273256	163	219	0	56	56	1.0000000
NODE_228830_length_271_cov_2.069767	130	212	2	5	82	0.0609756
NODE_228830_length_271_cov_2.069767	130	212	4	74	82	0.9024390
NODE_228830_length_271_cov_2.069767	130	212	6	3	82	0.0365854
NODE_228932_length_271_cov_1.784884	135	183	0	48	48	1.0000000
NODE_228937_length_271_cov_1.779070	204	268	0	64	64	1.0000000
NODE_229085_length_271_cov_1.755814	119	199	0	23	80	0.2875000
NODE_229085_length_271_cov_1.755814	119	199	2	57	80	0.7125000
NODE_229242_length_271_cov_1.523256	122	183	2	29	61	0.4754098
NODE_229242_length_271_cov_1.523256	122	183	3	15	61	0.2459016
NODE_229242_length_271_cov_1.523256	122	183	4	17	61	0.2786885
NODE_229254_length_271_cov_1.511628	106	186	38	3	80	0.0375000
NODE_229254_length_271_cov_1.511628	106	186	40	5	80	0.0625000
NODE_229254_length_271_cov_1.511628	106	186	42	3	80	0.0375000
NODE_229254_length_271_cov_1.511628	106	186	43	8	80	0.1000000
NODE_229254_length_271_cov_1.511628	106	186	44	4	80	0.0500000
NODE_229254_length_271_cov_1.511628	106	186	46	2	80	0.0250000
NODE_229254_length_271_cov_1.511628	106	186	48	3	80	0.0375000
NODE_229254_length_271_cov_1.511628	106	186	50	4	80	0.0500000
NODE_229254_length_271_cov_1.511628	106	186	52	1	80	0.0125000
NODE_229254_length_271_cov_1.511628	106	186	53	2	80	0.0250000
NODE_229254_length_271_cov_1.511628	106	186	55	1	80	0.0125000
NODE_229254_length_271_cov_1.511628	106	186	56	3	80	0.0375000
NODE_229254_length_271_cov_1.511628	106	186	57	6	80	0.0750000
NODE_229254_length_271_cov_1.511628	106	186	59	7	80	0.0875000
NODE_229254_length_271_cov_1.511628	106	186	61	5	80	0.0625000
NODE_229254_length_271_cov_1.511628	106	186	63	5	80	0.0625000
NODE_229254_length_271_cov_1.511628	106	186	64	3	80	0.0375000
NODE_229254_length_271_cov_1.511628	106	186	65	1	80	0.0125000
NODE_229254_length_271_cov_1.511628	106	186	66	2	80	0.0250000
NODE_229254_length_271_cov_1.511628	106	186	67	2	80	0.0250000
NODE_229254_length_271_cov_1.511628	106	186	68	1	80	0.0125000
NODE_229254_length_271_cov_1.511628	106	186	69	1	80	0.0125000
NODE_229254_length_271_cov_1.511628	106	186	70	8	80	0.1000000
NODE_229525_length_271_cov_1.226744	119	184	0	65	65	1.0000000
NODE_229541_length_271_cov_1.197674	88	145	2	9	57	0.1578947
NODE_229541_length_271_cov_1.197674	88	145	4	2	57	0.0350877
NODE_229541_length_271_cov_1.197674	88	145	5	32	57	0.5614035
NODE_229541_length_271_cov_1.197674	88	145	6	11	57	0.1929825
NODE_229541_length_271_cov_1.197674	88	145	7	3	57	0.0526316
NODE_229541_length_271_cov_1.197674	118	192	5	31	74	0.4189189
NODE_229541_length_271_cov_1.197674	118	192	6	43	74	0.5810811
NODE_230154_length_271_cov_0.918605	155	227	0	72	72	1.0000000
NODE_230255_length_271_cov_0.889535	101	148	0	46	47	0.9787234
NODE_230255_length_271_cov_0.889535	101	148	2	1	47	0.0212766
NODE_230318_length_271_cov_0.889535	127	188	0	61	61	1.0000000
NODE_231165_length_270_cov_4.818713	72	118	0	5	46	0.1086956
NODE_231165_length_270_cov_4.818713	72	118	2	41	46	0.8913044
NODE_231187_length_270_cov_4.327485	5	82	0	77	77	1.0000000
NODE_231240_length_270_cov_3.666667	87	154	0	67	67	1.0000000
NODE_231240_length_270_cov_3.666667	140	207	0	34	67	0.5074627
NODE_231240_length_270_cov_3.666667	140	207	2	33	67	0.4925373
NODE_231263_length_270_cov_3.491228	186	270	0	35	84	0.4166667
NODE_231263_length_270_cov_3.491228	186	270	2	42	84	0.5000000
NODE_231263_length_270_cov_3.491228	186	270	4	7	84	0.0833333
NODE_231310_length_270_cov_3.105263	43	90	6	47	47	1.0000000
NODE_231316_length_270_cov_3.046784	64	135	0	71	71	1.0000000
NODE_231439_length_270_cov_2.649123	210	270	0	19	60	0.3166667
NODE_231439_length_270_cov_2.649123	210	270	2	41	60	0.6833333
NODE_231655_length_270_cov_2.087719	16	55	0	39	39	1.0000000
NODE_231655_length_270_cov_2.087719	78	108	0	30	30	1.0000000
NODE_231714_length_270_cov_2.040936	103	159	14	1	56	0.0178571
NODE_231714_length_270_cov_2.040936	103	159	20	2	56	0.0357143
NODE_231714_length_270_cov_2.040936	103	159	25	1	56	0.0178571
NODE_231714_length_270_cov_2.040936	103	159	30	1	56	0.0178571
NODE_231714_length_270_cov_2.040936	103	159	38	1	56	0.0178571
NODE_231714_length_270_cov_2.040936	103	159	42	2	56	0.0357143
NODE_231714_length_270_cov_2.040936	103	159	47	1	56	0.0178571
NODE_231714_length_270_cov_2.040936	103	159	49	3	56	0.0535714
NODE_231714_length_270_cov_2.040936	103	159	53	2	56	0.0357143
NODE_231714_length_270_cov_2.040936	103	159	55	1	56	0.0178571
NODE_231714_length_270_cov_2.040936	103	159	59	2	56	0.0357143
NODE_231714_length_270_cov_2.040936	103	159	61	1	56	0.0178571
NODE_231714_length_270_cov_2.040936	103	159	65	1	56	0.0178571
NODE_231714_length_270_cov_2.040936	103	159	69	1	56	0.0178571
NODE_231714_length_270_cov_2.040936	103	159	71	1	56	0.0178571
NODE_231714_length_270_cov_2.040936	103	159	76	2	56	0.0357143
NODE_231714_length_270_cov_2.040936	103	159	77	2	56	0.0357143
NODE_231714_length_270_cov_2.040936	103	159	79	2	56	0.0357143
NODE_231714_length_270_cov_2.040936	103	159	81	1	56	0.0178571
NODE_231714_length_270_cov_2.040936	103	159	85	2	56	0.0357143
NODE_231714_length_270_cov_2.040936	103	159	88	1	56	0.0178571
NODE_231714_length_270_cov_2.040936	103	159	91	1	56	0.0178571
NODE_231714_length_270_cov_2.040936	103	159	93	1	56	0.0178571
NODE_231714_length_270_cov_2.040936	103	159	95	2	56	0.0357143
NODE_231714_length_270_cov_2.040936	103	159	101	5	56	0.0892857
NODE_231714_length_270_cov_2.040936	103	159	103	1	56	0.0178571
NODE_231714_length_270_cov_2.040936	103	159	107	2	56	0.0357143
NODE_231714_length_270_cov_2.040936	103	159	109	11	56	0.1964286
NODE_231714_length_270_cov_2.040936	103	159	111	2	56	0.0357143
NODE_231726_length_270_cov_2.017544	1	48	0	47	47	1.0000000
NODE_231820_length_270_cov_1.789474	146	228	0	28	82	0.3414634
NODE_231820_length_270_cov_1.789474	146	228	2	54	82	0.6585366
NODE_232008_length_270_cov_1.678363	178	246	0	4	68	0.0588235
NODE_232008_length_270_cov_1.678363	178	246	2	64	68	0.9411765
NODE_232021_length_270_cov_1.666667	127	191	14	4	64	0.0625000
NODE_232021_length_270_cov_1.666667	127	191	16	1	64	0.0156250
NODE_232021_length_270_cov_1.666667	127	191	19	1	64	0.0156250
NODE_232021_length_270_cov_1.666667	127	191	23	4	64	0.0625000
NODE_232021_length_270_cov_1.666667	127	191	27	9	64	0.1406250
NODE_232021_length_270_cov_1.666667	127	191	30	1	64	0.0156250
NODE_232021_length_270_cov_1.666667	127	191	34	1	64	0.0156250
NODE_232021_length_270_cov_1.666667	127	191	38	1	64	0.0156250
NODE_232021_length_270_cov_1.666667	127	191	40	1	64	0.0156250
NODE_232021_length_270_cov_1.666667	127	191	42	1	64	0.0156250
NODE_232021_length_270_cov_1.666667	127	191	44	1	64	0.0156250
NODE_232021_length_270_cov_1.666667	127	191	46	1	64	0.0156250
NODE_232021_length_270_cov_1.666667	127	191	50	3	64	0.0468750
NODE_232021_length_270_cov_1.666667	127	191	52	6	64	0.0937500
NODE_232021_length_270_cov_1.666667	127	191	54	1	64	0.0156250
NODE_232021_length_270_cov_1.666667	127	191	60	2	64	0.0312500
NODE_232021_length_270_cov_1.666667	127	191	62	4	64	0.0625000
NODE_232021_length_270_cov_1.666667	127	191	64	5	64	0.0781250
NODE_232021_length_270_cov_1.666667	127	191	66	1	64	0.0156250
NODE_232021_length_270_cov_1.666667	127	191	68	1	64	0.0156250
NODE_232021_length_270_cov_1.666667	127	191	70	3	64	0.0468750
NODE_232021_length_270_cov_1.666667	127	191	74	3	64	0.0468750
NODE_232021_length_270_cov_1.666667	127	191	80	2	64	0.0312500
NODE_232021_length_270_cov_1.666667	127	191	88	5	64	0.0781250
NODE_232021_length_270_cov_1.666667	127	191	90	2	64	0.0312500
NODE_232021_length_270_cov_1.666667	180	227	2	11	47	0.2340426
NODE_232021_length_270_cov_1.666667	180	227	4	12	47	0.2553191
NODE_232021_length_270_cov_1.666667	180	227	6	1	47	0.0212766
NODE_232021_length_270_cov_1.666667	180	227	11	2	47	0.0425532
NODE_232021_length_270_cov_1.666667	180	227	12	7	47	0.1489362
NODE_232021_length_270_cov_1.666667	180	227	14	7	47	0.1489362
NODE_232021_length_270_cov_1.666667	180	227	16	1	47	0.0212766
NODE_232021_length_270_cov_1.666667	180	227	19	1	47	0.0212766
NODE_232021_length_270_cov_1.666667	180	227	23	4	47	0.0851064
NODE_232021_length_270_cov_1.666667	180	227	27	1	47	0.0212766
NODE_232087_length_270_cov_1.555556	138	218	0	74	80	0.9250000
NODE_232087_length_270_cov_1.555556	138	218	2	6	80	0.0750000
NODE_232331_length_270_cov_1.280702	4	75	0	71	71	1.0000000
NODE_232331_length_270_cov_1.280702	57	137	0	73	80	0.9125000
NODE_232331_length_270_cov_1.280702	57	137	2	3	80	0.0375000
NODE_232331_length_270_cov_1.280702	57	137	4	4	80	0.0500000
NODE_232331_length_270_cov_1.280702	65	120	0	55	55	1.0000000
NODE_232331_length_270_cov_1.280702	125	198	0	5	73	0.0684932
NODE_232331_length_270_cov_1.280702	125	198	2	3	73	0.0410959
NODE_232331_length_270_cov_1.280702	125	198	4	65	73	0.8904110
NODE_232440_length_270_cov_1.192982	146	194	0	48	48	1.0000000
NODE_232583_length_270_cov_1.192982	61	141	0	80	80	1.0000000
NODE_233290_length_270_cov_0.847953	53	128	2	2	75	0.0266667
NODE_233290_length_270_cov_0.847953	53	128	8	2	75	0.0266667
NODE_233290_length_270_cov_0.847953	53	128	10	1	75	0.0133333
NODE_233290_length_270_cov_0.847953	53	128	12	70	75	0.9333333
NODE_234072_length_269_cov_3.894118	30	110	0	53	80	0.6625000
NODE_234072_length_269_cov_3.894118	30	110	2	27	80	0.3375000
NODE_234072_length_269_cov_3.894118	83	163	0	1	80	0.0125000
NODE_234072_length_269_cov_3.894118	83	163	2	79	80	0.9875000
NODE_234100_length_269_cov_3.605882	175	205	0	30	30	1.0000000
NODE_234116_length_269_cov_3.523529	192	233	2	19	41	0.4634146
NODE_234116_length_269_cov_3.523529	192	233	4	17	41	0.4146341
NODE_234116_length_269_cov_3.523529	192	233	6	5	41	0.1219512
NODE_234116_length_269_cov_3.523529	206	268	0	6	62	0.0967742
NODE_234116_length_269_cov_3.523529	206	268	1	14	62	0.2258064
NODE_234116_length_269_cov_3.523529	206	268	2	34	62	0.5483871
NODE_234116_length_269_cov_3.523529	206	268	4	8	62	0.1290323
NODE_234118_length_269_cov_3.505882	13	93	0	80	80	1.0000000
NODE_234118_length_269_cov_3.505882	66	145	0	79	79	1.0000000
NODE_234162_length_269_cov_3.147059	134	174	0	40	40	1.0000000
NODE_234167_length_269_cov_3.111765	39	119	2	4	80	0.0500000
NODE_234167_length_269_cov_3.111765	39	119	4	27	80	0.3375000
NODE_234167_length_269_cov_3.111765	39	119	8	49	80	0.6125000
NODE_234167_length_269_cov_3.111765	92	169	1	12	77	0.1558442
NODE_234167_length_269_cov_3.111765	92	169	2	17	77	0.2207792
NODE_234167_length_269_cov_3.111765	92	169	8	48	77	0.6233766
NODE_234178_length_269_cov_3.000000	166	233	0	67	67	1.0000000
NODE_234205_length_269_cov_2.947059	55	123	0	19	68	0.2794118
NODE_234205_length_269_cov_2.947059	55	123	2	49	68	0.7205882
NODE_234224_length_269_cov_2.858824	9	89	0	80	80	1.0000000
NODE_234224_length_269_cov_2.858824	62	91	0	29	29	1.0000000
NODE_234228_length_269_cov_2.823529	0	73	2	22	73	0.3013699
NODE_234228_length_269_cov_2.823529	0	73	3	2	73	0.0273973
NODE_234228_length_269_cov_2.823529	0	73	4	6	73	0.0821918
NODE_234228_length_269_cov_2.823529	0	73	6	6	73	0.0821918
NODE_234228_length_269_cov_2.823529	0	73	8	37	73	0.5068493
NODE_234228_length_269_cov_2.823529	46	77	8	31	31	1.0000000
NODE_234431_length_269_cov_2.311765	111	157	0	46	46	1.0000000
NODE_234431_length_269_cov_2.311765	130	209	0	79	79	1.0000000
NODE_234606_length_269_cov_1.958824	176	248	2	6	72	0.0833333
NODE_234606_length_269_cov_1.958824	176	248	4	66	72	0.9166667
NODE_234647_length_269_cov_1.847059	72	99	0	27	27	1.0000000
NODE_234657_length_269_cov_1.823529	30	81	6	35	51	0.6862745
NODE_234657_length_269_cov_1.823529	30	81	8	2	51	0.0392157
NODE_234657_length_269_cov_1.823529	30	81	14	14	51	0.2745098
NODE_234758_length_269_cov_1.800000	0	42	0	42	42	1.0000000
NODE_234978_length_269_cov_1.552941	90	170	0	78	80	0.9750000
NODE_234978_length_269_cov_1.552941	90	170	2	2	80	0.0250000
NODE_235157_length_269_cov_1.400000	139	219	2	7	80	0.0875000
NODE_235157_length_269_cov_1.400000	139	219	4	1	80	0.0125000
NODE_235157_length_269_cov_1.400000	139	219	6	16	80	0.2000000
NODE_235157_length_269_cov_1.400000	139	219	10	35	80	0.4375000
NODE_235157_length_269_cov_1.400000	139	219	11	2	80	0.0250000
NODE_235157_length_269_cov_1.400000	139	219	13	2	80	0.0250000
NODE_235157_length_269_cov_1.400000	139	219	15	3	80	0.0375000
NODE_235157_length_269_cov_1.400000	139	219	17	13	80	0.1625000
NODE_235157_length_269_cov_1.400000	139	219	19	1	80	0.0125000
NODE_235168_length_269_cov_1.388235	185	252	0	67	67	1.0000000
NODE_235239_length_269_cov_1.288235	150	179	0	13	29	0.4482759
NODE_235239_length_269_cov_1.288235	150	179	4	16	29	0.5517241
NODE_235292_length_269_cov_1.217647	141	221	0	80	80	1.0000000
NODE_235561_length_269_cov_1.194118	107	170	0	63	63	1.0000000
NODE_235561_length_269_cov_1.194118	143	221	0	78	78	1.0000000
NODE_235714_length_269_cov_1.094118	38	72	0	34	34	1.0000000
NODE_235780_length_269_cov_1.035294	6	36	0	11	30	0.3666667
NODE_235780_length_269_cov_1.035294	6	36	2	19	30	0.6333333
NODE_235780_length_269_cov_1.035294	96	150	0	14	54	0.2592593
NODE_235780_length_269_cov_1.035294	96	150	2	40	54	0.7407407
NODE_235930_length_269_cov_0.917647	4	79	0	75	75	1.0000000
NODE_235930_length_269_cov_0.917647	57	93	0	36	36	1.0000000
NODE_236243_length_269_cov_0.782353	2	52	0	32	50	0.6400000
NODE_236243_length_269_cov_0.782353	2	52	2	18	50	0.3600000
NODE_236243_length_269_cov_0.782353	76	132	2	47	56	0.8392857
NODE_236243_length_269_cov_0.782353	76	132	4	9	56	0.1607143
NODE_236856_length_268_cov_223.165680	161	188	0	27	27	1.0000000
NODE_236856_length_268_cov_223.165680	161	241	0	80	80	1.0000000
NODE_236878_length_268_cov_6.266272	29	111	0	72	82	0.8780488
NODE_236878_length_268_cov_6.266272	29	111	4	10	82	0.1219512
NODE_236909_length_268_cov_5.053254	137	217	0	80	80	1.0000000
NODE_236909_length_268_cov_5.053254	190	253	0	63	63	1.0000000
NODE_236911_length_268_cov_4.994083	92	168	0	12	76	0.1578947
NODE_236911_length_268_cov_4.994083	92	168	2	1	76	0.0131579
NODE_236911_length_268_cov_4.994083	92	168	3	4	76	0.0526316
NODE_236911_length_268_cov_4.994083	92	168	4	17	76	0.2236842
NODE_236911_length_268_cov_4.994083	92	168	6	19	76	0.2500000
NODE_236911_length_268_cov_4.994083	92	168	8	4	76	0.0526316
NODE_236911_length_268_cov_4.994083	92	168	10	19	76	0.2500000
NODE_236972_length_268_cov_3.905325	1	61	4	60	60	1.0000000
NODE_237107_length_268_cov_2.982249	95	175	0	15	80	0.1875000
NODE_237107_length_268_cov_2.982249	95	175	6	6	80	0.0750000
NODE_237107_length_268_cov_2.982249	95	175	8	6	80	0.0750000
NODE_237107_length_268_cov_2.982249	95	175	10	19	80	0.2375000
NODE_237107_length_268_cov_2.982249	95	175	12	8	80	0.1000000
NODE_237107_length_268_cov_2.982249	95	175	14	23	80	0.2875000
NODE_237107_length_268_cov_2.982249	95	175	16	3	80	0.0375000
NODE_237115_length_268_cov_2.940828	28	97	2	69	69	1.0000000
NODE_237185_length_268_cov_2.668639	57	110	0	53	53	1.0000000
NODE_237190_length_268_cov_2.621302	149	176	0	27	27	1.0000000
NODE_237325_length_268_cov_2.289941	87	127	221	3	40	0.0750000
NODE_237325_length_268_cov_2.289941	87	127	223	1	40	0.0250000
NODE_237325_length_268_cov_2.289941	87	127	225	1	40	0.0250000
NODE_237325_length_268_cov_2.289941	87	127	234	4	40	0.1000000
NODE_237325_length_268_cov_2.289941	87	127	239	1	40	0.0250000
NODE_237325_length_268_cov_2.289941	87	127	242	2	40	0.0500000
NODE_237325_length_268_cov_2.289941	87	127	252	2	40	0.0500000
NODE_237325_length_268_cov_2.289941	87	127	258	1	40	0.0250000
NODE_237325_length_268_cov_2.289941	87	127	261	3	40	0.0750000
NODE_237325_length_268_cov_2.289941	87	127	267	1	40	0.0250000
NODE_237325_length_268_cov_2.289941	87	127	278	1	40	0.0250000
NODE_237325_length_268_cov_2.289941	87	127	282	1	40	0.0250000
NODE_237325_length_268_cov_2.289941	87	127	285	1	40	0.0250000
NODE_237325_length_268_cov_2.289941	87	127	287	1	40	0.0250000
NODE_237325_length_268_cov_2.289941	87	127	293	1	40	0.0250000
NODE_237325_length_268_cov_2.289941	87	127	297	1	40	0.0250000
NODE_237325_length_268_cov_2.289941	87	127	308	4	40	0.1000000
NODE_237325_length_268_cov_2.289941	87	127	310	4	40	0.1000000
NODE_237325_length_268_cov_2.289941	87	127	312	1	40	0.0250000
NODE_237325_length_268_cov_2.289941	87	127	314	1	40	0.0250000
NODE_237325_length_268_cov_2.289941	87	127	318	1	40	0.0250000
NODE_237325_length_268_cov_2.289941	87	127	320	2	40	0.0500000
NODE_237325_length_268_cov_2.289941	87	127	322	2	40	0.0500000
NODE_237345_length_268_cov_2.224852	96	176	0	80	80	1.0000000
NODE_237345_length_268_cov_2.224852	149	229	0	80	80	1.0000000
NODE_237457_length_268_cov_2.005917	97	162	0	65	65	1.0000000
NODE_237502_length_268_cov_1.840237	80	155	0	47	75	0.6266667
NODE_237502_length_268_cov_1.840237	80	155	4	28	75	0.3733333
NODE_237572_length_268_cov_1.810651	8	84	0	56	76	0.7368421
NODE_237572_length_268_cov_1.810651	8	84	2	20	76	0.2631579
NODE_237831_length_268_cov_1.532544	186	257	10	1	71	0.0140845
NODE_237831_length_268_cov_1.532544	186	257	12	38	71	0.5352113
NODE_237831_length_268_cov_1.532544	186	257	14	32	71	0.4507042
NODE_237906_length_268_cov_1.508876	52	131	0	26	79	0.3291139
NODE_237906_length_268_cov_1.508876	52	131	4	53	79	0.6708861
NODE_238009_length_268_cov_1.384615	0	46	0	46	46	1.0000000
NODE_238070_length_268_cov_1.278107	100	175	0	75	75	1.0000000
NODE_238153_length_268_cov_1.207101	187	209	4	22	22	1.0000000
NODE_238478_length_268_cov_1.153846	135	195	0	2	60	0.0333333
NODE_238478_length_268_cov_1.153846	135	195	2	58	60	0.9666666
NODE_239018_length_268_cov_0.852071	59	119	6	21	60	0.3500000
NODE_239018_length_268_cov_0.852071	59	119	7	4	60	0.0666667
NODE_239018_length_268_cov_0.852071	59	119	9	34	60	0.5666667
NODE_239018_length_268_cov_0.852071	59	119	11	1	60	0.0166667
NODE_239805_length_267_cov_4.297619	0	52	0	52	52	1.0000000
NODE_239817_length_267_cov_4.119048	41	87	2	5	46	0.1086956
NODE_239817_length_267_cov_4.119048	41	87	4	41	46	0.8913044
NODE_239845_length_267_cov_3.785714	96	163	0	67	67	1.0000000
NODE_239845_length_267_cov_3.785714	136	178	0	42	42	1.0000000
NODE_239873_length_267_cov_3.535714	40	101	0	30	61	0.4918033
NODE_239873_length_267_cov_3.535714	40	101	2	31	61	0.5081967
NODE_239873_length_267_cov_3.535714	74	154	2	80	80	1.0000000
NODE_239958_length_267_cov_3.005952	216	267	0	51	51	1.0000000
NODE_239959_length_267_cov_3.000000	87	144	0	5	57	0.0877193
NODE_239959_length_267_cov_3.000000	87	144	2	5	57	0.0877193
NODE_239959_length_267_cov_3.000000	87	144	4	18	57	0.3157895
NODE_239959_length_267_cov_3.000000	87	144	5	10	57	0.1754386
NODE_239959_length_267_cov_3.000000	87	144	7	11	57	0.1929825
NODE_239959_length_267_cov_3.000000	87	144	8	2	57	0.0350877
NODE_239959_length_267_cov_3.000000	87	144	12	6	57	0.1052632
NODE_240007_length_267_cov_2.726190	177	220	0	43	43	1.0000000
NODE_240024_length_267_cov_2.690476	117	170	8	1	53	0.0188679
NODE_240024_length_267_cov_2.690476	117	170	10	4	53	0.0754717
NODE_240024_length_267_cov_2.690476	117	170	12	13	53	0.2452830
NODE_240024_length_267_cov_2.690476	117	170	14	4	53	0.0754717
NODE_240024_length_267_cov_2.690476	117	170	16	15	53	0.2830189
NODE_240024_length_267_cov_2.690476	117	170	18	16	53	0.3018868
NODE_240029_length_267_cov_2.666667	198	267	0	69	69	1.0000000
NODE_240114_length_267_cov_2.428571	189	254	18	1	65	0.0153846
NODE_240114_length_267_cov_2.428571	189	254	19	3	65	0.0461538
NODE_240114_length_267_cov_2.428571	189	254	22	1	65	0.0153846
NODE_240114_length_267_cov_2.428571	189	254	23	3	65	0.0461538
NODE_240114_length_267_cov_2.428571	189	254	24	3	65	0.0461538
NODE_240114_length_267_cov_2.428571	189	254	25	3	65	0.0461538
NODE_240114_length_267_cov_2.428571	189	254	29	1	65	0.0153846
NODE_240114_length_267_cov_2.428571	189	254	34	1	65	0.0153846
NODE_240114_length_267_cov_2.428571	189	254	35	2	65	0.0307692
NODE_240114_length_267_cov_2.428571	189	254	41	1	65	0.0153846
NODE_240114_length_267_cov_2.428571	189	254	43	1	65	0.0153846
NODE_240114_length_267_cov_2.428571	189	254	47	1	65	0.0153846
NODE_240114_length_267_cov_2.428571	189	254	53	2	65	0.0307692
NODE_240114_length_267_cov_2.428571	189	254	57	3	65	0.0461538
NODE_240114_length_267_cov_2.428571	189	254	61	1	65	0.0153846
NODE_240114_length_267_cov_2.428571	189	254	63	2	65	0.0307692
NODE_240114_length_267_cov_2.428571	189	254	69	2	65	0.0307692
NODE_240114_length_267_cov_2.428571	189	254	73	1	65	0.0153846
NODE_240114_length_267_cov_2.428571	189	254	75	2	65	0.0307692
NODE_240114_length_267_cov_2.428571	189	254	77	1	65	0.0153846
NODE_240114_length_267_cov_2.428571	189	254	83	2	65	0.0307692
NODE_240114_length_267_cov_2.428571	189	254	85	4	65	0.0615385
NODE_240114_length_267_cov_2.428571	189	254	87	4	65	0.0615385
NODE_240114_length_267_cov_2.428571	189	254	89	1	65	0.0153846
NODE_240114_length_267_cov_2.428571	189	254	91	3	65	0.0461538
NODE_240114_length_267_cov_2.428571	189	254	92	6	65	0.0923077
NODE_240114_length_267_cov_2.428571	189	254	94	8	65	0.1230769
NODE_240114_length_267_cov_2.428571	189	254	107	2	65	0.0307692
NODE_240207_length_267_cov_2.208333	45	103	8	29	58	0.5000000
NODE_240207_length_267_cov_2.208333	45	103	10	29	58	0.5000000
NODE_240246_length_267_cov_2.125000	124	175	0	6	51	0.1176471
NODE_240246_length_267_cov_2.125000	124	175	2	45	51	0.8823529
NODE_240303_length_267_cov_2.077381	65	146	6	4	81	0.0493827
NODE_240303_length_267_cov_2.077381	65	146	10	77	81	0.9506173
NODE_240303_length_267_cov_2.077381	229	264	0	35	35	1.0000000
NODE_240331_length_267_cov_2.005952	147	228	0	31	81	0.3827161
NODE_240331_length_267_cov_2.005952	147	228	1	17	81	0.2098765
NODE_240331_length_267_cov_2.005952	147	228	2	9	81	0.1111111
NODE_240331_length_267_cov_2.005952	147	228	6	16	81	0.1975309
NODE_240331_length_267_cov_2.005952	147	228	8	8	81	0.0987654
NODE_240331_length_267_cov_2.005952	201	267	0	66	66	1.0000000
NODE_240336_length_267_cov_1.988095	77	157	0	80	80	1.0000000
NODE_240336_length_267_cov_1.988095	130	210	0	80	80	1.0000000
NODE_240620_length_267_cov_1.755952	119	199	0	80	80	1.0000000
NODE_240624_length_267_cov_1.750000	23	104	12	1	81	0.0123457
NODE_240624_length_267_cov_1.750000	23	104	14	8	81	0.0987654
NODE_240624_length_267_cov_1.750000	23	104	16	4	81	0.0493827
NODE_240624_length_267_cov_1.750000	23	104	18	11	81	0.1358025
NODE_240624_length_267_cov_1.750000	23	104	22	4	81	0.0493827
NODE_240624_length_267_cov_1.750000	23	104	24	8	81	0.0987654
NODE_240624_length_267_cov_1.750000	23	104	26	12	81	0.1481481
NODE_240624_length_267_cov_1.750000	23	104	28	4	81	0.0493827
NODE_240624_length_267_cov_1.750000	23	104	30	17	81	0.2098765
NODE_240624_length_267_cov_1.750000	23	104	32	12	81	0.1481481
NODE_240624_length_267_cov_1.750000	179	208	2	4	29	0.1379310
NODE_240624_length_267_cov_1.750000	179	208	4	9	29	0.3103448
NODE_240624_length_267_cov_1.750000	179	208	6	16	29	0.5517241
NODE_240653_length_267_cov_1.690476	18	90	0	72	72	1.0000000
NODE_240790_length_267_cov_1.517857	6	43	0	37	37	1.0000000
NODE_241075_length_267_cov_1.214286	37	91	0	54	54	1.0000000
NODE_241240_length_267_cov_1.214286	89	126	0	37	37	1.0000000
NODE_241352_length_267_cov_1.208333	124	164	2	40	40	1.0000000
NODE_241484_length_267_cov_1.125000	57	103	0	46	46	1.0000000
NODE_241512_length_267_cov_1.089286	119	196	0	77	77	1.0000000
NODE_241512_length_267_cov_1.089286	169	249	0	80	80	1.0000000
NODE_241517_length_267_cov_1.083333	133	152	2	18	19	0.9473684
NODE_241517_length_267_cov_1.083333	133	152	4	1	19	0.0526316
NODE_241517_length_267_cov_1.083333	183	264	0	81	81	1.0000000
NODE_241588_length_267_cov_1.017857	205	267	0	62	62	1.0000000
NODE_241633_length_267_cov_0.982143	4	75	0	71	71	1.0000000
NODE_242999_length_266_cov_5.706587	120	199	0	79	79	1.0000000
NODE_242999_length_266_cov_5.706587	172	239	0	67	67	1.0000000
NODE_243010_length_266_cov_5.107784	68	150	0	82	82	1.0000000
NODE_243064_length_266_cov_4.125749	99	168	4	3	69	0.0434783
NODE_243064_length_266_cov_4.125749	99	168	6	6	69	0.0869565
NODE_243064_length_266_cov_4.125749	99	168	12	29	69	0.4202898
NODE_243064_length_266_cov_4.125749	99	168	14	31	69	0.4492754
NODE_243079_length_266_cov_3.958084	40	120	0	80	80	1.0000000
NODE_243079_length_266_cov_3.958084	93	159	0	66	66	1.0000000
NODE_243136_length_266_cov_3.419162	68	130	0	5	62	0.0806452
NODE_243136_length_266_cov_3.419162	68	130	2	57	62	0.9193549
NODE_243136_length_266_cov_3.419162	116	183	0	58	67	0.8656716
NODE_243136_length_266_cov_3.419162	116	183	2	9	67	0.1343284
NODE_243168_length_266_cov_3.137725	6	86	0	80	80	1.0000000
NODE_243168_length_266_cov_3.137725	59	120	0	61	61	1.0000000
NODE_243174_length_266_cov_3.107784	166	232	0	1	66	0.0151515
NODE_243174_length_266_cov_3.107784	166	232	2	2	66	0.0303030
NODE_243174_length_266_cov_3.107784	166	232	4	22	66	0.3333333
NODE_243174_length_266_cov_3.107784	166	232	7	1	66	0.0151515
NODE_243174_length_266_cov_3.107784	166	232	9	2	66	0.0303030
NODE_243174_length_266_cov_3.107784	166	232	11	7	66	0.1060606
NODE_243174_length_266_cov_3.107784	166	232	14	5	66	0.0757576
NODE_243174_length_266_cov_3.107784	166	232	16	2	66	0.0303030
NODE_243174_length_266_cov_3.107784	166	232	18	2	66	0.0303030
NODE_243174_length_266_cov_3.107784	166	232	19	1	66	0.0151515
NODE_243174_length_266_cov_3.107784	166	232	20	1	66	0.0151515
NODE_243174_length_266_cov_3.107784	166	232	22	1	66	0.0151515
NODE_243174_length_266_cov_3.107784	166	232	23	6	66	0.0909091
NODE_243174_length_266_cov_3.107784	166	232	25	2	66	0.0303030
NODE_243174_length_266_cov_3.107784	166	232	26	1	66	0.0151515
NODE_243174_length_266_cov_3.107784	166	232	27	2	66	0.0303030
NODE_243174_length_266_cov_3.107784	166	232	28	6	66	0.0909091
NODE_243174_length_266_cov_3.107784	166	232	30	2	66	0.0303030
NODE_243475_length_266_cov_2.179641	110	191	4	2	81	0.0246914
NODE_243475_length_266_cov_2.179641	110	191	6	10	81	0.1234568
NODE_243475_length_266_cov_2.179641	110	191	9	1	81	0.0123457
NODE_243475_length_266_cov_2.179641	110	191	10	1	81	0.0123457
NODE_243475_length_266_cov_2.179641	110	191	12	31	81	0.3827161
NODE_243475_length_266_cov_2.179641	110	191	14	7	81	0.0864198
NODE_243475_length_266_cov_2.179641	110	191	16	29	81	0.3580247
NODE_243497_length_266_cov_2.137725	156	236	0	17	80	0.2125000
NODE_243497_length_266_cov_2.137725	156	236	2	8	80	0.1000000
NODE_243497_length_266_cov_2.137725	156	236	6	55	80	0.6875000
NODE_243570_length_266_cov_2.023952	47	123	0	76	76	1.0000000
NODE_243972_length_266_cov_1.532934	155	235	0	58	80	0.7250000
NODE_243972_length_266_cov_1.532934	155	235	2	22	80	0.2750000
NODE_244681_length_266_cov_1.113772	70	97	0	19	27	0.7037037
NODE_244681_length_266_cov_1.113772	70	97	2	8	27	0.2962963
NODE_244760_length_266_cov_1.023952	144	201	2	57	57	1.0000000
NODE_244760_length_266_cov_1.023952	199	265	0	49	66	0.7424242
NODE_244760_length_266_cov_1.023952	199	265	2	17	66	0.2575758
NODE_245049_length_266_cov_0.916168	51	122	0	71	71	1.0000000
NODE_245280_length_266_cov_0.730539	132	158	2	26	26	1.0000000
NODE_245538_length_266_cov_0.610778	99	139	0	40	40	1.0000000
NODE_245538_length_266_cov_0.610778	112	156	0	44	44	1.0000000
NODE_246087_length_265_cov_7.843373	128	208	0	65	80	0.8125000
NODE_246087_length_265_cov_7.843373	128	208	2	1	80	0.0125000
NODE_246087_length_265_cov_7.843373	128	208	3	4	80	0.0500000
NODE_246087_length_265_cov_7.843373	128	208	4	1	80	0.0125000
NODE_246087_length_265_cov_7.843373	128	208	6	9	80	0.1125000
NODE_246192_length_265_cov_4.054217	65	145	0	80	80	1.0000000
NODE_246192_length_265_cov_4.054217	118	198	0	80	80	1.0000000
NODE_246198_length_265_cov_3.993976	195	231	2	36	36	1.0000000
NODE_246284_length_265_cov_3.150602	183	263	0	80	80	1.0000000
NODE_246374_length_265_cov_2.789157	177	238	0	61	61	1.0000000
NODE_246409_length_265_cov_2.734940	167	247	0	80	80	1.0000000
NODE_246432_length_265_cov_2.608434	188	259	0	71	71	1.0000000
NODE_246606_length_265_cov_2.156627	197	237	19	5	40	0.1250000
NODE_246606_length_265_cov_2.156627	197	237	21	1	40	0.0250000
NODE_246606_length_265_cov_2.156627	197	237	23	3	40	0.0750000
NODE_246606_length_265_cov_2.156627	197	237	27	1	40	0.0250000
NODE_246606_length_265_cov_2.156627	197	237	28	1	40	0.0250000
NODE_246606_length_265_cov_2.156627	197	237	34	1	40	0.0250000
NODE_246606_length_265_cov_2.156627	197	237	36	4	40	0.1000000
NODE_246606_length_265_cov_2.156627	197	237	40	2	40	0.0500000
NODE_246606_length_265_cov_2.156627	197	237	44	2	40	0.0500000
NODE_246606_length_265_cov_2.156627	197	237	49	2	40	0.0500000
NODE_246606_length_265_cov_2.156627	197	237	53	2	40	0.0500000
NODE_246606_length_265_cov_2.156627	197	237	55	1	40	0.0250000
NODE_246606_length_265_cov_2.156627	197	237	63	5	40	0.1250000
NODE_246606_length_265_cov_2.156627	197	237	65	5	40	0.1250000
NODE_246606_length_265_cov_2.156627	197	237	66	4	40	0.1000000
NODE_246606_length_265_cov_2.156627	197	237	68	1	40	0.0250000
NODE_246624_length_265_cov_2.150602	169	218	0	49	49	1.0000000
NODE_246692_length_265_cov_1.975904	15	44	0	29	29	1.0000000
NODE_246811_length_265_cov_1.843373	195	265	0	60	70	0.8571429
NODE_246811_length_265_cov_1.843373	195	265	2	10	70	0.1428571
NODE_247028_length_265_cov_1.620482	115	186	0	11	71	0.1549296
NODE_247028_length_265_cov_1.620482	115	186	1	1	71	0.0140845
NODE_247028_length_265_cov_1.620482	115	186	2	59	71	0.8309859
NODE_247028_length_265_cov_1.620482	117	171	2	54	54	1.0000000
NODE_247031_length_265_cov_1.614458	53	113	4	7	60	0.1166667
NODE_247031_length_265_cov_1.614458	53	113	6	5	60	0.0833333
NODE_247031_length_265_cov_1.614458	53	113	11	5	60	0.0833333
NODE_247031_length_265_cov_1.614458	53	113	13	3	60	0.0500000
NODE_247031_length_265_cov_1.614458	53	113	15	8	60	0.1333333
NODE_247031_length_265_cov_1.614458	53	113	16	1	60	0.0166667
NODE_247031_length_265_cov_1.614458	53	113	18	3	60	0.0500000
NODE_247031_length_265_cov_1.614458	53	113	20	6	60	0.1000000
NODE_247031_length_265_cov_1.614458	53	113	22	1	60	0.0166667
NODE_247031_length_265_cov_1.614458	53	113	23	1	60	0.0166667
NODE_247031_length_265_cov_1.614458	53	113	24	20	60	0.3333333
NODE_247031_length_265_cov_1.614458	86	166	20	5	80	0.0625000
NODE_247031_length_265_cov_1.614458	86	166	22	1	80	0.0125000
NODE_247031_length_265_cov_1.614458	86	166	23	1	80	0.0125000
NODE_247031_length_265_cov_1.614458	86	166	24	21	80	0.2625000
NODE_247031_length_265_cov_1.614458	86	166	26	4	80	0.0500000
NODE_247031_length_265_cov_1.614458	86	166	28	20	80	0.2500000
NODE_247031_length_265_cov_1.614458	86	166	30	19	80	0.2375000
NODE_247031_length_265_cov_1.614458	86	166	34	9	80	0.1125000
NODE_247314_length_265_cov_1.337349	107	168	8	2	61	0.0327869
NODE_247314_length_265_cov_1.337349	107	168	10	1	61	0.0163934
NODE_247314_length_265_cov_1.337349	107	168	14	7	61	0.1147541
NODE_247314_length_265_cov_1.337349	107	168	16	2	61	0.0327869
NODE_247314_length_265_cov_1.337349	107	168	18	8	61	0.1311475
NODE_247314_length_265_cov_1.337349	107	168	20	6	61	0.0983607
NODE_247314_length_265_cov_1.337349	107	168	24	35	61	0.5737705
NODE_247952_length_265_cov_1.000000	187	251	0	2	64	0.0312500
NODE_247952_length_265_cov_1.000000	187	251	4	62	64	0.9687500
NODE_247972_length_265_cov_0.987952	44	63	0	19	19	1.0000000
NODE_249395_length_264_cov_4.018182	141	178	0	37	37	1.0000000
NODE_249404_length_264_cov_3.957576	59	132	0	73	73	1.0000000
NODE_249404_length_264_cov_3.957576	112	192	0	80	80	1.0000000
NODE_249415_length_264_cov_3.824242	178	220	2	42	42	1.0000000
NODE_249452_length_264_cov_3.400000	73	125	0	52	52	1.0000000
NODE_249452_length_264_cov_3.400000	124	165	0	11	41	0.2682927
NODE_249452_length_264_cov_3.400000	124	165	2	30	41	0.7317073
NODE_249485_length_264_cov_3.133333	119	186	0	67	67	1.0000000
NODE_249530_length_264_cov_3.012121	122	198	0	36	76	0.4736842
NODE_249530_length_264_cov_3.012121	122	198	2	27	76	0.3552631
NODE_249530_length_264_cov_3.012121	122	198	4	13	76	0.1710526
NODE_249904_length_264_cov_2.048485	32	98	2	14	66	0.2121212
NODE_249904_length_264_cov_2.048485	32	98	4	43	66	0.6515151
NODE_249904_length_264_cov_2.048485	32	98	10	5	66	0.0757576
NODE_249904_length_264_cov_2.048485	32	98	12	3	66	0.0454545
NODE_249904_length_264_cov_2.048485	32	98	14	1	66	0.0151515
NODE_249905_length_264_cov_2.048485	133	176	0	43	43	1.0000000
NODE_249912_length_264_cov_2.012121	20	84	0	64	64	1.0000000
NODE_249931_length_264_cov_1.951515	178	211	2	33	33	1.0000000
NODE_249982_length_264_cov_1.854545	130	161	0	31	31	1.0000000
NODE_250202_length_264_cov_1.745455	26	81	0	55	55	1.0000000
NODE_250202_length_264_cov_1.745455	86	153	0	67	67	1.0000000
NODE_250203_length_264_cov_1.745455	90	169	4	8	79	0.1012658
NODE_250203_length_264_cov_1.745455	90	169	6	4	79	0.0506329
NODE_250203_length_264_cov_1.745455	90	169	8	6	79	0.0759494
NODE_250203_length_264_cov_1.745455	90	169	10	20	79	0.2531646
NODE_250203_length_264_cov_1.745455	90	169	12	7	79	0.0886076
NODE_250203_length_264_cov_1.745455	90	169	14	21	79	0.2658228
NODE_250203_length_264_cov_1.745455	90	169	16	13	79	0.1645570
NODE_250203_length_264_cov_1.745455	143	207	12	7	64	0.1093750
NODE_250203_length_264_cov_1.745455	143	207	14	47	64	0.7343750
NODE_250203_length_264_cov_1.745455	143	207	16	10	64	0.1562500
NODE_250297_length_264_cov_1.569697	173	236	0	63	63	1.0000000
NODE_250314_length_264_cov_1.545455	206	255	4	49	49	1.0000000
NODE_250381_length_264_cov_1.545455	35	66	6	31	31	1.0000000
NODE_250446_length_264_cov_1.503030	0	63	0	63	63	1.0000000
NODE_250513_length_264_cov_1.406061	149	230	2	81	81	1.0000000
NODE_250513_length_264_cov_1.406061	225	260	0	22	35	0.6285715
NODE_250513_length_264_cov_1.406061	225	260	2	13	35	0.3714286
NODE_250635_length_264_cov_1.236364	2	63	0	2	61	0.0327869
NODE_250635_length_264_cov_1.236364	2	63	2	59	61	0.9672131
NODE_251015_length_264_cov_1.151515	11	68	0	57	57	1.0000000
NODE_251529_length_264_cov_0.921212	49	85	0	36	36	1.0000000
NODE_251703_length_264_cov_0.721212	233	252	0	19	19	1.0000000
NODE_252559_length_263_cov_5.115854	132	219	24	1	87	0.0114943
NODE_252559_length_263_cov_5.115854	132	219	26	1	87	0.0114943
NODE_252559_length_263_cov_5.115854	132	219	30	1	87	0.0114943
NODE_252559_length_263_cov_5.115854	132	219	32	2	87	0.0229885
NODE_252559_length_263_cov_5.115854	132	219	36	1	87	0.0114943
NODE_252559_length_263_cov_5.115854	132	219	44	2	87	0.0229885
NODE_252559_length_263_cov_5.115854	132	219	46	6	87	0.0689655
NODE_252559_length_263_cov_5.115854	132	219	54	2	87	0.0229885
NODE_252559_length_263_cov_5.115854	132	219	56	3	87	0.0344828
NODE_252559_length_263_cov_5.115854	132	219	60	1	87	0.0114943
NODE_252559_length_263_cov_5.115854	132	219	62	3	87	0.0344828
NODE_252559_length_263_cov_5.115854	132	219	64	1	87	0.0114943
NODE_252559_length_263_cov_5.115854	132	219	66	6	87	0.0689655
NODE_252559_length_263_cov_5.115854	132	219	67	2	87	0.0229885
NODE_252559_length_263_cov_5.115854	132	219	68	2	87	0.0229885
NODE_252559_length_263_cov_5.115854	132	219	70	4	87	0.0459770
NODE_252559_length_263_cov_5.115854	132	219	72	4	87	0.0459770
NODE_252559_length_263_cov_5.115854	132	219	74	45	87	0.5172414
NODE_252563_length_263_cov_4.914634	45	117	4	1	72	0.0138889
NODE_252563_length_263_cov_4.914634	45	117	6	5	72	0.0694444
NODE_252563_length_263_cov_4.914634	45	117	10	1	72	0.0138889
NODE_252563_length_263_cov_4.914634	45	117	14	9	72	0.1250000
NODE_252563_length_263_cov_4.914634	45	117	16	2	72	0.0277778
NODE_252563_length_263_cov_4.914634	45	117	18	1	72	0.0138889
NODE_252563_length_263_cov_4.914634	45	117	20	15	72	0.2083333
NODE_252563_length_263_cov_4.914634	45	117	22	6	72	0.0833333
NODE_252563_length_263_cov_4.914634	45	117	24	5	72	0.0694444
NODE_252563_length_263_cov_4.914634	45	117	26	27	72	0.3750000
NODE_252595_length_263_cov_4.225610	67	124	2	14	57	0.2456140
NODE_252595_length_263_cov_4.225610	67	124	4	43	57	0.7543859
NODE_252663_length_263_cov_3.518293	104	176	6	23	72	0.3194444
NODE_252663_length_263_cov_3.518293	104	176	8	24	72	0.3333333
NODE_252663_length_263_cov_3.518293	104	176	10	8	72	0.1111111
NODE_252663_length_263_cov_3.518293	104	176	12	17	72	0.2361111
NODE_252766_length_263_cov_2.908537	7	93	0	28	86	0.3255814
NODE_252766_length_263_cov_2.908537	7	93	2	38	86	0.4418605
NODE_252766_length_263_cov_2.908537	7	93	4	9	86	0.1046512
NODE_252766_length_263_cov_2.908537	7	93	8	3	86	0.0348837
NODE_252766_length_263_cov_2.908537	7	93	10	8	86	0.0930233
NODE_252778_length_263_cov_2.798780	67	146	8	16	79	0.2025317
NODE_252778_length_263_cov_2.798780	67	146	10	63	79	0.7974684
NODE_252932_length_263_cov_2.396341	207	238	0	31	31	1.0000000
NODE_253261_length_263_cov_1.865854	51	81	8	21	30	0.7000000
NODE_253261_length_263_cov_1.865854	51	81	10	9	30	0.3000000
NODE_253310_length_263_cov_1.847561	113	189	0	76	76	1.0000000
NODE_253379_length_263_cov_1.750000	151	231	0	80	80	1.0000000
NODE_253468_length_263_cov_1.579268	32	95	20	16	63	0.2539683
NODE_253468_length_263_cov_1.579268	32	95	22	7	63	0.1111111
NODE_253468_length_263_cov_1.579268	32	95	24	1	63	0.0158730
NODE_253468_length_263_cov_1.579268	32	95	26	7	63	0.1111111
NODE_253468_length_263_cov_1.579268	32	95	28	1	63	0.0158730
NODE_253468_length_263_cov_1.579268	32	95	30	1	63	0.0158730
NODE_253468_length_263_cov_1.579268	32	95	32	9	63	0.1428571
NODE_253468_length_263_cov_1.579268	32	95	34	1	63	0.0158730
NODE_253468_length_263_cov_1.579268	32	95	36	15	63	0.2380952
NODE_253468_length_263_cov_1.579268	32	95	38	1	63	0.0158730
NODE_253468_length_263_cov_1.579268	32	95	39	4	63	0.0634921
NODE_253477_length_263_cov_1.567073	98	155	2	57	57	1.0000000
NODE_253619_length_263_cov_1.506098	157	217	2	60	60	1.0000000
NODE_253620_length_263_cov_1.506098	84	113	4	9	29	0.3103448
NODE_253620_length_263_cov_1.506098	84	113	5	6	29	0.2068966
NODE_253620_length_263_cov_1.506098	84	113	6	1	29	0.0344828
NODE_253620_length_263_cov_1.506098	84	113	7	13	29	0.4482759
NODE_253753_length_263_cov_1.286585	143	223	0	6	80	0.0750000
NODE_253753_length_263_cov_1.286585	143	223	2	9	80	0.1125000
NODE_253753_length_263_cov_1.286585	143	223	4	5	80	0.0625000
NODE_253753_length_263_cov_1.286585	143	223	6	13	80	0.1625000
NODE_253753_length_263_cov_1.286585	143	223	8	2	80	0.0250000
NODE_253753_length_263_cov_1.286585	143	223	16	1	80	0.0125000
NODE_253753_length_263_cov_1.286585	143	223	20	2	80	0.0250000
NODE_253753_length_263_cov_1.286585	143	223	22	1	80	0.0125000
NODE_253753_length_263_cov_1.286585	143	223	24	3	80	0.0375000
NODE_253753_length_263_cov_1.286585	143	223	28	6	80	0.0750000
NODE_253753_length_263_cov_1.286585	143	223	30	5	80	0.0625000
NODE_253753_length_263_cov_1.286585	143	223	32	3	80	0.0375000
NODE_253753_length_263_cov_1.286585	143	223	34	3	80	0.0375000
NODE_253753_length_263_cov_1.286585	143	223	36	6	80	0.0750000
NODE_253753_length_263_cov_1.286585	143	223	38	5	80	0.0625000
NODE_253753_length_263_cov_1.286585	143	223	40	10	80	0.1250000
NODE_253788_length_263_cov_1.243902	206	263	0	57	57	1.0000000
NODE_254174_length_263_cov_1.170732	12	66	0	54	54	1.0000000
NODE_254174_length_263_cov_1.170732	39	119	0	80	80	1.0000000
NODE_254301_length_263_cov_1.067073	137	202	0	65	65	1.0000000
NODE_254301_length_263_cov_1.067073	175	255	0	80	80	1.0000000
NODE_254783_length_263_cov_0.810976	163	245	64	1	82	0.0121951
NODE_254783_length_263_cov_0.810976	163	245	66	1	82	0.0121951
NODE_254783_length_263_cov_0.810976	163	245	69	1	82	0.0121951
NODE_254783_length_263_cov_0.810976	163	245	74	1	82	0.0121951
NODE_254783_length_263_cov_0.810976	163	245	83	1	82	0.0121951
NODE_254783_length_263_cov_0.810976	163	245	91	1	82	0.0121951
NODE_254783_length_263_cov_0.810976	163	245	93	1	82	0.0121951
NODE_254783_length_263_cov_0.810976	163	245	98	1	82	0.0121951
NODE_254783_length_263_cov_0.810976	163	245	100	1	82	0.0121951
NODE_254783_length_263_cov_0.810976	163	245	105	3	82	0.0365854
NODE_254783_length_263_cov_0.810976	163	245	111	1	82	0.0121951
NODE_254783_length_263_cov_0.810976	163	245	117	1	82	0.0121951
NODE_254783_length_263_cov_0.810976	163	245	123	2	82	0.0243902
NODE_254783_length_263_cov_0.810976	163	245	127	1	82	0.0121951
NODE_254783_length_263_cov_0.810976	163	245	140	2	82	0.0243902
NODE_254783_length_263_cov_0.810976	163	245	150	1	82	0.0121951
NODE_254783_length_263_cov_0.810976	163	245	162	1	82	0.0121951
NODE_254783_length_263_cov_0.810976	163	245	164	1	82	0.0121951
NODE_254783_length_263_cov_0.810976	163	245	165	2	82	0.0243902
NODE_254783_length_263_cov_0.810976	163	245	169	1	82	0.0121951
NODE_254783_length_263_cov_0.810976	163	245	170	1	82	0.0121951
NODE_254783_length_263_cov_0.810976	163	245	171	1	82	0.0121951
NODE_254783_length_263_cov_0.810976	163	245	177	1	82	0.0121951
NODE_254783_length_263_cov_0.810976	163	245	179	1	82	0.0121951
NODE_254783_length_263_cov_0.810976	163	245	182	1	82	0.0121951
NODE_254783_length_263_cov_0.810976	163	245	184	1	82	0.0121951
NODE_254783_length_263_cov_0.810976	163	245	188	2	82	0.0243902
NODE_254783_length_263_cov_0.810976	163	245	192	1	82	0.0121951
NODE_254783_length_263_cov_0.810976	163	245	202	1	82	0.0121951
NODE_254783_length_263_cov_0.810976	163	245	203	1	82	0.0121951
NODE_254783_length_263_cov_0.810976	163	245	213	1	82	0.0121951
NODE_254783_length_263_cov_0.810976	163	245	223	1	82	0.0121951
NODE_254783_length_263_cov_0.810976	163	245	232	1	82	0.0121951
NODE_254783_length_263_cov_0.810976	163	245	239	1	82	0.0121951
NODE_254783_length_263_cov_0.810976	163	245	250	1	82	0.0121951
NODE_254783_length_263_cov_0.810976	163	245	266	1	82	0.0121951
NODE_254783_length_263_cov_0.810976	163	245	270	1	82	0.0121951
NODE_254783_length_263_cov_0.810976	163	245	272	1	82	0.0121951
NODE_254783_length_263_cov_0.810976	163	245	277	1	82	0.0121951
NODE_254783_length_263_cov_0.810976	163	245	291	1	82	0.0121951
NODE_254783_length_263_cov_0.810976	163	245	293	2	82	0.0243902
NODE_254783_length_263_cov_0.810976	163	245	295	2	82	0.0243902
NODE_254783_length_263_cov_0.810976	163	245	299	1	82	0.0121951
NODE_254783_length_263_cov_0.810976	163	245	301	1	82	0.0121951
NODE_254783_length_263_cov_0.810976	163	245	302	1	82	0.0121951
NODE_254783_length_263_cov_0.810976	163	245	303	1	82	0.0121951
NODE_254783_length_263_cov_0.810976	163	245	305	1	82	0.0121951
NODE_254783_length_263_cov_0.810976	163	245	309	1	82	0.0121951
NODE_254783_length_263_cov_0.810976	163	245	313	1	82	0.0121951
NODE_254783_length_263_cov_0.810976	163	245	318	1	82	0.0121951
NODE_254783_length_263_cov_0.810976	163	245	322	1	82	0.0121951
NODE_254783_length_263_cov_0.810976	163	245	324	1	82	0.0121951
NODE_254783_length_263_cov_0.810976	163	245	328	1	82	0.0121951
NODE_254783_length_263_cov_0.810976	163	245	334	1	82	0.0121951
NODE_254783_length_263_cov_0.810976	163	245	342	1	82	0.0121951
NODE_254783_length_263_cov_0.810976	163	245	344	1	82	0.0121951
NODE_254783_length_263_cov_0.810976	163	245	348	1	82	0.0121951
NODE_254783_length_263_cov_0.810976	163	245	354	1	82	0.0121951
NODE_254783_length_263_cov_0.810976	163	245	362	1	82	0.0121951
NODE_254783_length_263_cov_0.810976	163	245	364	1	82	0.0121951
NODE_254783_length_263_cov_0.810976	163	245	368	1	82	0.0121951
NODE_254783_length_263_cov_0.810976	163	245	378	1	82	0.0121951
NODE_254783_length_263_cov_0.810976	163	245	379	2	82	0.0243902
NODE_254783_length_263_cov_0.810976	163	245	383	1	82	0.0121951
NODE_254783_length_263_cov_0.810976	163	245	385	1	82	0.0121951
NODE_254783_length_263_cov_0.810976	163	245	386	5	82	0.0609756
NODE_254783_length_263_cov_0.810976	163	245	387	1	82	0.0121951
NODE_254783_length_263_cov_0.810976	163	245	388	2	82	0.0243902
NODE_255446_length_263_cov_0.621951	212	258	0	46	46	1.0000000
NODE_255524_length_263_cov_0.621951	131	151	0	20	20	1.0000000
NODE_255559_length_263_cov_0.621951	67	86	1	4	19	0.2105263
NODE_255559_length_263_cov_0.621951	67	86	2	8	19	0.4210526
NODE_255559_length_263_cov_0.621951	67	86	3	7	19	0.3684210
NODE_255727_length_262_cov_5.312883	20	82	0	62	62	1.0000000
NODE_255769_length_262_cov_4.447853	102	155	0	18	53	0.3396226
NODE_255769_length_262_cov_4.447853	102	155	2	35	53	0.6603774
NODE_255821_length_262_cov_3.766871	48	89	0	41	41	1.0000000
NODE_255860_length_262_cov_3.435583	158	235	0	6	77	0.0779221
NODE_255860_length_262_cov_3.435583	158	235	2	71	77	0.9220779
NODE_255945_length_262_cov_2.938650	142	222	0	10	80	0.1250000
NODE_255945_length_262_cov_2.938650	142	222	2	70	80	0.8750000
NODE_256009_length_262_cov_2.723926	103	183	0	80	80	1.0000000
NODE_256049_length_262_cov_2.509202	88	148	2	60	60	1.0000000
NODE_256050_length_262_cov_2.509202	0	61	0	61	61	1.0000000
NODE_256050_length_262_cov_2.509202	107	171	0	45	64	0.7031250
NODE_256050_length_262_cov_2.509202	107	171	2	19	64	0.2968750
NODE_256050_length_262_cov_2.509202	144	224	0	8	80	0.1000000
NODE_256050_length_262_cov_2.509202	144	224	2	72	80	0.9000000
NODE_256129_length_262_cov_2.429448	14	87	0	73	73	1.0000000
NODE_256129_length_262_cov_2.429448	62	149	0	87	87	1.0000000
NODE_256176_length_262_cov_2.226994	2	79	2	31	77	0.4025974
NODE_256176_length_262_cov_2.226994	2	79	4	46	77	0.5974026
NODE_256187_length_262_cov_2.202454	61	81	0	20	20	1.0000000
NODE_256199_length_262_cov_2.190184	172	235	0	63	63	1.0000000
NODE_256239_length_262_cov_2.177914	133	189	0	56	56	1.0000000
NODE_256265_length_262_cov_2.122699	96	157	6	10	61	0.1639344
NODE_256265_length_262_cov_2.122699	96	157	8	51	61	0.8360656
NODE_256386_length_262_cov_1.877301	0	77	0	77	77	1.0000000
NODE_256390_length_262_cov_1.877301	77	124	4	47	47	1.0000000
NODE_256481_length_262_cov_1.871166	192	252	0	60	60	1.0000000
NODE_256596_length_262_cov_1.736196	149	208	0	59	59	1.0000000
NODE_256630_length_262_cov_1.680982	2	82	0	80	80	1.0000000
NODE_256650_length_262_cov_1.656442	135	166	2	31	31	1.0000000
NODE_256659_length_262_cov_1.638037	111	142	10	3	31	0.0967742
NODE_256659_length_262_cov_1.638037	111	142	12	12	31	0.3870968
NODE_256659_length_262_cov_1.638037	111	142	14	1	31	0.0322581
NODE_256659_length_262_cov_1.638037	111	142	16	4	31	0.1290323
NODE_256659_length_262_cov_1.638037	111	142	18	11	31	0.3548387
NODE_256704_length_262_cov_1.576687	102	182	2	80	80	1.0000000
NODE_256704_length_262_cov_1.576687	155	221	0	5	66	0.0757576
NODE_256704_length_262_cov_1.576687	155	221	2	61	66	0.9242424
NODE_256742_length_262_cov_1.564417	69	124	0	28	55	0.5090909
NODE_256742_length_262_cov_1.564417	69	124	2	5	55	0.0909091
NODE_256742_length_262_cov_1.564417	69	124	4	22	55	0.4000000
NODE_256742_length_262_cov_1.564417	106	177	4	50	71	0.7042254
NODE_256742_length_262_cov_1.564417	106	177	6	21	71	0.2957746
NODE_256933_length_262_cov_1.349693	52	102	0	50	50	1.0000000
NODE_256933_length_262_cov_1.349693	83	149	0	66	66	1.0000000
NODE_257199_length_262_cov_1.251534	44	124	0	8	80	0.1000000
NODE_257199_length_262_cov_1.251534	44	124	2	23	80	0.2875000
NODE_257199_length_262_cov_1.251534	44	124	4	1	80	0.0125000
NODE_257199_length_262_cov_1.251534	44	124	6	5	80	0.0625000
NODE_257199_length_262_cov_1.251534	44	124	8	13	80	0.1625000
NODE_257199_length_262_cov_1.251534	44	124	10	30	80	0.3750000
NODE_257199_length_262_cov_1.251534	97	171	4	1	74	0.0135135
NODE_257199_length_262_cov_1.251534	97	171	6	11	74	0.1486486
NODE_257199_length_262_cov_1.251534	97	171	8	2	74	0.0270270
NODE_257199_length_262_cov_1.251534	97	171	10	60	74	0.8108108
NODE_258876_length_261_cov_31.913580	32	112	4	80	80	1.0000000
NODE_258876_length_261_cov_31.913580	85	171	0	48	86	0.5581396
NODE_258876_length_261_cov_31.913580	85	171	4	38	86	0.4418605
NODE_258901_length_261_cov_6.376543	126	201	0	9	75	0.1200000
NODE_258901_length_261_cov_6.376543	126	201	1	1	75	0.0133333
NODE_258901_length_261_cov_6.376543	126	201	2	65	75	0.8666667
NODE_258901_length_261_cov_6.376543	179	254	0	2	75	0.0266667
NODE_258901_length_261_cov_6.376543	179	254	2	73	75	0.9733334
NODE_258929_length_261_cov_5.469136	56	132	0	76	76	1.0000000
NODE_259329_length_261_cov_2.425926	53	134	0	45	81	0.5555556
NODE_259329_length_261_cov_2.425926	53	134	2	36	81	0.4444444
NODE_259361_length_261_cov_2.333333	41	136	0	22	95	0.2315789
NODE_259361_length_261_cov_2.333333	41	136	2	1	95	0.0105263
NODE_259361_length_261_cov_2.333333	41	136	4	72	95	0.7578948
NODE_259435_length_261_cov_2.191358	86	122	0	36	36	1.0000000
NODE_259495_length_261_cov_1.993827	134	214	0	80	80	1.0000000
NODE_259672_length_261_cov_1.882716	51	105	5	2	54	0.0370370
NODE_259672_length_261_cov_1.882716	51	105	11	5	54	0.0925926
NODE_259672_length_261_cov_1.882716	51	105	13	13	54	0.2407407
NODE_259672_length_261_cov_1.882716	51	105	14	3	54	0.0555556
NODE_259672_length_261_cov_1.882716	51	105	18	5	54	0.0925926
NODE_259672_length_261_cov_1.882716	51	105	20	26	54	0.4814815
NODE_259740_length_261_cov_1.839506	118	197	0	15	79	0.1898734
NODE_259740_length_261_cov_1.839506	118	197	2	54	79	0.6835443
NODE_259740_length_261_cov_1.839506	118	197	4	1	79	0.0126582
NODE_259740_length_261_cov_1.839506	118	197	6	1	79	0.0126582
NODE_259740_length_261_cov_1.839506	118	197	8	2	79	0.0253165
NODE_259740_length_261_cov_1.839506	118	197	10	6	79	0.0759494
NODE_259769_length_261_cov_1.783951	69	141	0	25	72	0.3472222
NODE_259769_length_261_cov_1.783951	69	141	2	47	72	0.6527778
NODE_260089_length_261_cov_1.388889	202	247	0	45	45	1.0000000
NODE_260090_length_261_cov_1.382716	14	61	0	47	47	1.0000000
NODE_260428_length_261_cov_1.253086	100	138	2	38	38	1.0000000
NODE_260738_length_261_cov_1.030864	122	205	4	20	83	0.2409639
NODE_260738_length_261_cov_1.030864	122	205	6	63	83	0.7590361
NODE_260738_length_261_cov_1.030864	129	210	4	13	81	0.1604938
NODE_260738_length_261_cov_1.030864	129	210	6	68	81	0.8395061
NODE_260738_length_261_cov_1.030864	129	184	4	13	55	0.2363636
NODE_260738_length_261_cov_1.030864	129	184	6	42	55	0.7636364
NODE_260738_length_261_cov_1.030864	187	248	0	3	61	0.0491803
NODE_260738_length_261_cov_1.030864	187	248	2	18	61	0.2950820
NODE_260738_length_261_cov_1.030864	187	248	4	8	61	0.1311475
NODE_260738_length_261_cov_1.030864	187	248	6	32	61	0.5245901
NODE_260767_length_261_cov_1.006173	3	45	0	42	42	1.0000000
NODE_260767_length_261_cov_1.006173	46	98	0	52	52	1.0000000
NODE_262062_length_261_cov_0.580247	11	31	0	20	20	1.0000000
NODE_262121_length_260_cov_8.844720	74	138	4	64	64	1.0000000
NODE_262123_length_260_cov_8.447205	30	110	0	80	80	1.0000000
NODE_262123_length_260_cov_8.447205	83	167	0	84	84	1.0000000
NODE_262123_length_260_cov_8.447205	163	243	0	80	80	1.0000000
NODE_262149_length_260_cov_5.807453	38	118	0	80	80	1.0000000
NODE_262149_length_260_cov_5.807453	91	171	0	80	80	1.0000000
NODE_262264_length_260_cov_3.645963	5	57	2	20	52	0.3846154
NODE_262264_length_260_cov_3.645963	5	57	4	32	52	0.6153846
NODE_262329_length_260_cov_3.167702	91	163	2	1	72	0.0138889
NODE_262329_length_260_cov_3.167702	91	163	4	53	72	0.7361111
NODE_262329_length_260_cov_3.167702	91	163	6	18	72	0.2500000
NODE_262378_length_260_cov_2.981366	58	127	0	69	69	1.0000000
NODE_262384_length_260_cov_2.913043	10	90	0	80	80	1.0000000
NODE_262708_length_260_cov_2.161491	174	251	0	77	77	1.0000000
NODE_262733_length_260_cov_2.080745	188	258	0	70	70	1.0000000
NODE_262788_length_260_cov_1.950311	27	85	4	50	58	0.8620690
NODE_262788_length_260_cov_1.950311	27	85	6	8	58	0.1379310
NODE_262930_length_260_cov_1.900621	14	50	0	36	36	1.0000000
NODE_263117_length_260_cov_1.683230	50	130	0	3	80	0.0375000
NODE_263117_length_260_cov_1.683230	50	130	2	77	80	0.9625000
NODE_263428_length_260_cov_1.347826	38	118	0	3	80	0.0375000
NODE_263428_length_260_cov_1.347826	38	118	2	77	80	0.9625000
NODE_263533_length_260_cov_1.267081	114	199	0	85	85	1.0000000
NODE_263556_length_260_cov_1.267081	198	244	0	46	46	1.0000000
NODE_263568_length_260_cov_1.267081	145	189	2	4	44	0.0909091
NODE_263568_length_260_cov_1.267081	145	189	4	40	44	0.9090909
NODE_265483_length_259_cov_4.800000	35	95	0	60	60	1.0000000
NODE_265584_length_259_cov_3.675000	119	161	0	42	42	1.0000000
NODE_265584_length_259_cov_3.675000	134	214	0	80	80	1.0000000
NODE_265592_length_259_cov_3.593750	100	143	0	11	43	0.2558140
NODE_265592_length_259_cov_3.593750	100	143	2	32	43	0.7441860
NODE_265611_length_259_cov_3.475000	198	259	2	26	61	0.4262295
NODE_265611_length_259_cov_3.475000	198	259	4	35	61	0.5737705
NODE_265625_length_259_cov_3.331250	72	118	2	1	46	0.0217391
NODE_265625_length_259_cov_3.331250	72	118	4	24	46	0.5217391
NODE_265625_length_259_cov_3.331250	72	118	6	7	46	0.1521739
NODE_265625_length_259_cov_3.331250	72	118	10	14	46	0.3043478
NODE_265636_length_259_cov_3.237500	103	160	0	11	57	0.1929825
NODE_265636_length_259_cov_3.237500	103	160	2	46	57	0.8070176
NODE_265704_length_259_cov_2.937500	209	233	0	24	24	1.0000000
NODE_265735_length_259_cov_2.850000	0	41	0	10	41	0.2439024
NODE_265735_length_259_cov_2.850000	0	41	2	31	41	0.7560976
NODE_265735_length_259_cov_2.850000	14	94	2	80	80	1.0000000
NODE_265818_length_259_cov_2.550000	9	82	4	73	73	1.0000000
NODE_265942_length_259_cov_2.287500	147	225	2	78	78	1.0000000
NODE_265942_length_259_cov_2.287500	198	241	2	43	43	1.0000000
NODE_266032_length_259_cov_2.156250	0	72	0	72	72	1.0000000
NODE_266080_length_259_cov_2.012500	8	73	0	4	65	0.0615385
NODE_266080_length_259_cov_2.012500	8	73	2	61	65	0.9384615
NODE_266080_length_259_cov_2.012500	53	126	2	41	73	0.5616438
NODE_266080_length_259_cov_2.012500	53	126	4	23	73	0.3150685
NODE_266080_length_259_cov_2.012500	53	126	6	9	73	0.1232877
NODE_266101_length_259_cov_1.962500	108	189	2	6	81	0.0740741
NODE_266101_length_259_cov_1.962500	108	189	4	28	81	0.3456790
NODE_266101_length_259_cov_1.962500	108	189	6	47	81	0.5802469
NODE_266117_length_259_cov_1.918750	49	120	0	30	71	0.4225352
NODE_266117_length_259_cov_1.918750	49	120	2	41	71	0.5774648
NODE_266183_length_259_cov_1.912500	114	177	0	56	63	0.8888889
NODE_266183_length_259_cov_1.912500	114	177	4	2	63	0.0317460
NODE_266183_length_259_cov_1.912500	114	177	10	5	63	0.0793651
NODE_266365_length_259_cov_1.837500	180	252	1	20	72	0.2777778
NODE_266365_length_259_cov_1.837500	180	252	2	52	72	0.7222222
NODE_266609_length_259_cov_1.593750	27	67	2	31	40	0.7750000
NODE_266609_length_259_cov_1.593750	27	67	4	9	40	0.2250000
NODE_266746_length_259_cov_1.400000	117	164	0	47	47	1.0000000
NODE_266746_length_259_cov_1.400000	137	217	0	80	80	1.0000000
NODE_268816_length_258_cov_6.415094	129	209	0	5	80	0.0625000
NODE_268816_length_258_cov_6.415094	129	209	2	75	80	0.9375000
NODE_268816_length_258_cov_6.415094	182	258	0	54	76	0.7105263
NODE_268816_length_258_cov_6.415094	182	258	2	22	76	0.2894737
NODE_268823_length_258_cov_6.157233	1	81	0	80	80	1.0000000
NODE_268823_length_258_cov_6.157233	9	64	0	55	55	1.0000000
NODE_268852_length_258_cov_4.798742	83	163	2	80	80	1.0000000
NODE_268870_length_258_cov_4.396226	0	44	0	44	44	1.0000000
NODE_268870_length_258_cov_4.396226	24	97	0	32	73	0.4383562
NODE_268870_length_258_cov_4.396226	24	97	2	41	73	0.5616438
NODE_268880_length_258_cov_4.301887	0	54	0	54	54	1.0000000
NODE_268942_length_258_cov_3.616352	29	58	0	29	29	1.0000000
NODE_268982_length_258_cov_3.352201	47	127	16	1	80	0.0125000
NODE_268982_length_258_cov_3.352201	47	127	18	1	80	0.0125000
NODE_268982_length_258_cov_3.352201	47	127	22	3	80	0.0375000
NODE_268982_length_258_cov_3.352201	47	127	24	1	80	0.0125000
NODE_268982_length_258_cov_3.352201	47	127	25	1	80	0.0125000
NODE_268982_length_258_cov_3.352201	47	127	26	5	80	0.0625000
NODE_268982_length_258_cov_3.352201	47	127	27	1	80	0.0125000
NODE_268982_length_258_cov_3.352201	47	127	28	41	80	0.5125000
NODE_268982_length_258_cov_3.352201	47	127	29	25	80	0.3125000
NODE_268982_length_258_cov_3.352201	47	127	31	1	80	0.0125000
NODE_269086_length_258_cov_2.886792	102	121	0	19	19	1.0000000
NODE_269091_length_258_cov_2.880503	92	172	0	80	80	1.0000000
NODE_269102_length_258_cov_2.855346	96	138	16	1	42	0.0238095
NODE_269102_length_258_cov_2.855346	96	138	20	15	42	0.3571429
NODE_269102_length_258_cov_2.855346	96	138	22	5	42	0.1190476
NODE_269102_length_258_cov_2.855346	96	138	24	21	42	0.5000000
NODE_269102_length_258_cov_2.855346	148	191	0	8	43	0.1860465
NODE_269102_length_258_cov_2.855346	148	191	3	2	43	0.0465116
NODE_269102_length_258_cov_2.855346	148	191	4	10	43	0.2325581
NODE_269102_length_258_cov_2.855346	148	191	6	6	43	0.1395349
NODE_269102_length_258_cov_2.855346	148	191	7	1	43	0.0232558
NODE_269102_length_258_cov_2.855346	148	191	8	3	43	0.0697674
NODE_269102_length_258_cov_2.855346	148	191	10	13	43	0.3023256
NODE_269113_length_258_cov_2.817610	10	58	0	47	48	0.9791667
NODE_269113_length_258_cov_2.817610	10	58	2	1	48	0.0208333
NODE_269264_length_258_cov_2.383648	48	128	0	80	80	1.0000000
NODE_269264_length_258_cov_2.383648	101	182	0	81	81	1.0000000
NODE_269338_length_258_cov_2.238994	61	141	0	12	80	0.1500000
NODE_269338_length_258_cov_2.238994	61	141	2	68	80	0.8500000
NODE_269615_length_258_cov_1.918239	0	51	0	51	51	1.0000000
NODE_269682_length_258_cov_1.855346	26	47	2	10	21	0.4761905
NODE_269682_length_258_cov_1.855346	26	47	6	3	21	0.1428571
NODE_269682_length_258_cov_1.855346	26	47	9	1	21	0.0476190
NODE_269682_length_258_cov_1.855346	26	47	11	1	21	0.0476190
NODE_269682_length_258_cov_1.855346	26	47	12	4	21	0.1904762
NODE_269682_length_258_cov_1.855346	26	47	13	1	21	0.0476190
NODE_269682_length_258_cov_1.855346	26	47	15	1	21	0.0476190
NODE_269682_length_258_cov_1.855346	71	104	19	3	33	0.0909091
NODE_269682_length_258_cov_1.855346	71	104	20	30	33	0.9090909
NODE_269682_length_258_cov_1.855346	81	156	14	13	75	0.1733333
NODE_269682_length_258_cov_1.855346	81	156	18	12	75	0.1600000
NODE_269682_length_258_cov_1.855346	81	156	20	50	75	0.6666667
NODE_269749_length_258_cov_1.735849	105	176	0	5	71	0.0704225
NODE_269749_length_258_cov_1.735849	105	176	3	1	71	0.0140845
NODE_269749_length_258_cov_1.735849	105	176	4	49	71	0.6901408
NODE_269749_length_258_cov_1.735849	105	176	8	2	71	0.0281690
NODE_269749_length_258_cov_1.735849	105	176	10	2	71	0.0281690
NODE_269749_length_258_cov_1.735849	105	176	12	12	71	0.1690141
NODE_269767_length_258_cov_1.710692	8	49	0	41	41	1.0000000
NODE_270191_length_258_cov_1.283019	127	191	0	10	64	0.1562500
NODE_270191_length_258_cov_1.283019	127	191	2	54	64	0.8437500
NODE_270191_length_258_cov_1.283019	164	227	0	46	63	0.7301587
NODE_270191_length_258_cov_1.283019	164	227	2	17	63	0.2698413
NODE_270465_length_258_cov_1.270440	4	55	4	51	51	1.0000000
NODE_270504_length_258_cov_1.232704	90	166	6	4	76	0.0526316
NODE_270504_length_258_cov_1.232704	90	166	8	11	76	0.1447368
NODE_270504_length_258_cov_1.232704	90	166	10	14	76	0.1842105
NODE_270504_length_258_cov_1.232704	90	166	12	9	76	0.1184211
NODE_270504_length_258_cov_1.232704	90	166	13	1	76	0.0131579
NODE_270504_length_258_cov_1.232704	90	166	14	28	76	0.3684210
NODE_270504_length_258_cov_1.232704	90	166	16	9	76	0.1184211
NODE_270547_length_258_cov_1.201258	49	98	1	49	49	1.0000000
NODE_270876_length_258_cov_0.962264	186	258	0	72	72	1.0000000
NODE_270970_length_258_cov_0.962264	69	124	0	55	55	1.0000000
NODE_272169_length_257_cov_71.158228	81	165	99	2	84	0.0238095
NODE_272169_length_257_cov_71.158228	81	165	101	1	84	0.0119048
NODE_272169_length_257_cov_71.158228	81	165	102	1	84	0.0119048
NODE_272169_length_257_cov_71.158228	81	165	103	1	84	0.0119048
NODE_272169_length_257_cov_71.158228	81	165	104	1	84	0.0119048
NODE_272169_length_257_cov_71.158228	81	165	111	4	84	0.0476190
NODE_272169_length_257_cov_71.158228	81	165	112	2	84	0.0238095
NODE_272169_length_257_cov_71.158228	81	165	115	5	84	0.0595238
NODE_272169_length_257_cov_71.158228	81	165	117	1	84	0.0119048
NODE_272169_length_257_cov_71.158228	81	165	119	7	84	0.0833333
NODE_272169_length_257_cov_71.158228	81	165	121	3	84	0.0357143
NODE_272169_length_257_cov_71.158228	81	165	123	3	84	0.0357143
NODE_272169_length_257_cov_71.158228	81	165	124	4	84	0.0476190
NODE_272169_length_257_cov_71.158228	81	165	125	1	84	0.0119048
NODE_272169_length_257_cov_71.158228	81	165	126	2	84	0.0238095
NODE_272169_length_257_cov_71.158228	81	165	128	1	84	0.0119048
NODE_272169_length_257_cov_71.158228	81	165	129	2	84	0.0238095
NODE_272169_length_257_cov_71.158228	81	165	133	1	84	0.0119048
NODE_272169_length_257_cov_71.158228	81	165	134	2	84	0.0238095
NODE_272169_length_257_cov_71.158228	81	165	136	5	84	0.0595238
NODE_272169_length_257_cov_71.158228	81	165	139	2	84	0.0238095
NODE_272169_length_257_cov_71.158228	81	165	140	2	84	0.0238095
NODE_272169_length_257_cov_71.158228	81	165	141	1	84	0.0119048
NODE_272169_length_257_cov_71.158228	81	165	142	5	84	0.0595238
NODE_272169_length_257_cov_71.158228	81	165	143	2	84	0.0238095
NODE_272169_length_257_cov_71.158228	81	165	144	5	84	0.0595238
NODE_272169_length_257_cov_71.158228	81	165	145	4	84	0.0476190
NODE_272169_length_257_cov_71.158228	81	165	146	4	84	0.0476190
NODE_272169_length_257_cov_71.158228	81	165	147	2	84	0.0238095
NODE_272169_length_257_cov_71.158228	81	165	150	4	84	0.0476190
NODE_272169_length_257_cov_71.158228	81	165	152	4	84	0.0476190
NODE_272169_length_257_cov_71.158228	145	218	47	2	73	0.0273973
NODE_272169_length_257_cov_71.158228	145	218	49	1	73	0.0136986
NODE_272169_length_257_cov_71.158228	145	218	53	1	73	0.0136986
NODE_272169_length_257_cov_71.158228	145	218	55	4	73	0.0547945
NODE_272169_length_257_cov_71.158228	145	218	57	6	73	0.0821918
NODE_272169_length_257_cov_71.158228	145	218	61	3	73	0.0410959
NODE_272169_length_257_cov_71.158228	145	218	65	4	73	0.0547945
NODE_272169_length_257_cov_71.158228	145	218	70	1	73	0.0136986
NODE_272169_length_257_cov_71.158228	145	218	76	1	73	0.0136986
NODE_272169_length_257_cov_71.158228	145	218	78	1	73	0.0136986
NODE_272169_length_257_cov_71.158228	145	218	80	10	73	0.1369863
NODE_272169_length_257_cov_71.158228	145	218	82	2	73	0.0273973
NODE_272169_length_257_cov_71.158228	145	218	86	4	73	0.0547945
NODE_272169_length_257_cov_71.158228	145	218	90	1	73	0.0136986
NODE_272169_length_257_cov_71.158228	145	218	92	1	73	0.0136986
NODE_272169_length_257_cov_71.158228	145	218	93	3	73	0.0410959
NODE_272169_length_257_cov_71.158228	145	218	95	1	73	0.0136986
NODE_272169_length_257_cov_71.158228	145	218	96	2	73	0.0273973
NODE_272169_length_257_cov_71.158228	145	218	100	2	73	0.0273973
NODE_272169_length_257_cov_71.158228	145	218	102	4	73	0.0547945
NODE_272169_length_257_cov_71.158228	145	218	104	1	73	0.0136986
NODE_272169_length_257_cov_71.158228	145	218	112	2	73	0.0273973
NODE_272169_length_257_cov_71.158228	145	218	115	5	73	0.0684932
NODE_272169_length_257_cov_71.158228	145	218	119	1	73	0.0136986
NODE_272169_length_257_cov_71.158228	145	218	121	1	73	0.0136986
NODE_272169_length_257_cov_71.158228	145	218	123	1	73	0.0136986
NODE_272169_length_257_cov_71.158228	145	218	126	2	73	0.0273973
NODE_272169_length_257_cov_71.158228	145	218	129	2	73	0.0273973
NODE_272169_length_257_cov_71.158228	145	218	133	1	73	0.0136986
NODE_272169_length_257_cov_71.158228	145	218	134	2	73	0.0273973
NODE_272169_length_257_cov_71.158228	145	218	136	1	73	0.0136986
NODE_272194_length_257_cov_6.329114	15	93	0	78	78	1.0000000
NODE_272275_length_257_cov_4.177215	25	86	0	58	61	0.9508197
NODE_272275_length_257_cov_4.177215	25	86	2	3	61	0.0491803
NODE_272291_length_257_cov_3.987342	55	107	0	26	52	0.5000000
NODE_272291_length_257_cov_3.987342	55	107	2	26	52	0.5000000
NODE_272304_length_257_cov_3.873418	145	225	0	80	80	1.0000000
NODE_272304_length_257_cov_3.873418	198	254	0	56	56	1.0000000
NODE_272322_length_257_cov_3.740506	133	199	0	13	66	0.1969697
NODE_272322_length_257_cov_3.740506	133	199	2	5	66	0.0757576
NODE_272322_length_257_cov_3.740506	133	199	6	8	66	0.1212121
NODE_272322_length_257_cov_3.740506	133	199	8	3	66	0.0454545
NODE_272322_length_257_cov_3.740506	133	199	9	1	66	0.0151515
NODE_272322_length_257_cov_3.740506	133	199	11	1	66	0.0151515
NODE_272322_length_257_cov_3.740506	133	199	13	2	66	0.0303030
NODE_272322_length_257_cov_3.740506	133	199	19	9	66	0.1363636
NODE_272322_length_257_cov_3.740506	133	199	21	5	66	0.0757576
NODE_272322_length_257_cov_3.740506	133	199	22	4	66	0.0606061
NODE_272322_length_257_cov_3.740506	133	199	24	2	66	0.0303030
NODE_272322_length_257_cov_3.740506	133	199	26	3	66	0.0454545
NODE_272322_length_257_cov_3.740506	133	199	28	2	66	0.0303030
NODE_272322_length_257_cov_3.740506	133	199	30	5	66	0.0757576
NODE_272322_length_257_cov_3.740506	133	199	32	1	66	0.0151515
NODE_272322_length_257_cov_3.740506	133	199	34	2	66	0.0303030
NODE_272322_length_257_cov_3.740506	177	256	0	70	79	0.8860760
NODE_272322_length_257_cov_3.740506	177	256	2	5	79	0.0632911
NODE_272322_length_257_cov_3.740506	177	256	6	4	79	0.0506329
NODE_272486_length_257_cov_2.734177	1	65	0	64	64	1.0000000
NODE_272491_length_257_cov_2.677215	170	250	0	31	80	0.3875000
NODE_272491_length_257_cov_2.677215	170	250	4	1	80	0.0125000
NODE_272491_length_257_cov_2.677215	170	250	6	6	80	0.0750000
NODE_272491_length_257_cov_2.677215	170	250	8	3	80	0.0375000
NODE_272491_length_257_cov_2.677215	170	250	10	4	80	0.0500000
NODE_272491_length_257_cov_2.677215	170	250	12	8	80	0.1000000
NODE_272491_length_257_cov_2.677215	170	250	14	11	80	0.1375000
NODE_272491_length_257_cov_2.677215	170	250	16	2	80	0.0250000
NODE_272491_length_257_cov_2.677215	170	250	20	2	80	0.0250000
NODE_272491_length_257_cov_2.677215	170	250	22	1	80	0.0125000
NODE_272491_length_257_cov_2.677215	170	250	26	1	80	0.0125000
NODE_272491_length_257_cov_2.677215	170	250	28	10	80	0.1250000
NODE_272580_length_257_cov_2.537975	60	137	1	3	77	0.0389610
NODE_272580_length_257_cov_2.537975	60	137	2	74	77	0.9610389
NODE_272596_length_257_cov_2.487342	95	172	0	49	77	0.6363636
NODE_272596_length_257_cov_2.487342	95	172	6	4	77	0.0519481
NODE_272596_length_257_cov_2.487342	95	172	8	24	77	0.3116883
NODE_272625_length_257_cov_2.379747	106	186	4	1	80	0.0125000
NODE_272625_length_257_cov_2.379747	106	186	8	4	80	0.0500000
NODE_272625_length_257_cov_2.379747	106	186	10	4	80	0.0500000
NODE_272625_length_257_cov_2.379747	106	186	12	25	80	0.3125000
NODE_272625_length_257_cov_2.379747	106	186	14	19	80	0.2375000
NODE_272625_length_257_cov_2.379747	106	186	16	12	80	0.1500000
NODE_272625_length_257_cov_2.379747	106	186	18	15	80	0.1875000
NODE_272625_length_257_cov_2.379747	159	207	6	4	48	0.0833333
NODE_272625_length_257_cov_2.379747	159	207	8	4	48	0.0833333
NODE_272625_length_257_cov_2.379747	159	207	10	12	48	0.2500000
NODE_272625_length_257_cov_2.379747	159	207	12	6	48	0.1250000
NODE_272625_length_257_cov_2.379747	159	207	14	7	48	0.1458333
NODE_272625_length_257_cov_2.379747	159	207	16	1	48	0.0208333
NODE_272625_length_257_cov_2.379747	159	207	18	14	48	0.2916667
NODE_272724_length_257_cov_2.221519	163	240	0	11	77	0.1428571
NODE_272724_length_257_cov_2.221519	163	240	2	66	77	0.8571429
NODE_272729_length_257_cov_2.202532	16	97	2	16	81	0.1975309
NODE_272729_length_257_cov_2.202532	16	97	4	39	81	0.4814815
NODE_272729_length_257_cov_2.202532	16	97	6	13	81	0.1604938
NODE_272729_length_257_cov_2.202532	16	97	8	7	81	0.0864198
NODE_272729_length_257_cov_2.202532	16	97	10	6	81	0.0740741
NODE_273151_length_257_cov_1.664557	220	239	0	19	19	1.0000000
NODE_273357_length_257_cov_1.500000	85	166	0	8	81	0.0987654
NODE_273357_length_257_cov_1.500000	85	166	2	73	81	0.9012346
NODE_273462_length_257_cov_1.329114	120	186	6	2	66	0.0303030
NODE_273462_length_257_cov_1.329114	120	186	8	64	66	0.9696970
NODE_273533_length_257_cov_1.291139	13	53	0	40	40	1.0000000
NODE_273697_length_257_cov_1.291139	205	257	0	52	52	1.0000000
NODE_273894_length_257_cov_1.221519	10	74	0	64	64	1.0000000
NODE_273917_length_257_cov_1.196203	70	150	0	9	80	0.1125000
NODE_273917_length_257_cov_1.196203	70	150	2	43	80	0.5375000
NODE_273917_length_257_cov_1.196203	70	150	4	28	80	0.3500000
NODE_273917_length_257_cov_1.196203	123	204	0	31	81	0.3827161
NODE_273917_length_257_cov_1.196203	123	204	2	22	81	0.2716049
NODE_273917_length_257_cov_1.196203	123	204	4	28	81	0.3456790
NODE_275399_length_257_cov_0.645570	138	158	0	20	20	1.0000000
NODE_275419_length_257_cov_0.645570	181	241	0	18	60	0.3000000
NODE_275419_length_257_cov_0.645570	181	241	2	40	60	0.6666667
NODE_275419_length_257_cov_0.645570	181	241	4	2	60	0.0333333
NODE_275598_length_256_cov_5.235669	30	77	0	4	47	0.0851064
NODE_275598_length_256_cov_5.235669	30	77	2	43	47	0.9148936
NODE_275624_length_256_cov_4.598726	100	180	0	80	80	1.0000000
NODE_275624_length_256_cov_4.598726	160	211	0	51	51	1.0000000
NODE_275682_length_256_cov_3.866242	112	166	0	5	54	0.0925926
NODE_275682_length_256_cov_3.866242	112	166	2	11	54	0.2037037
NODE_275682_length_256_cov_3.866242	112	166	4	11	54	0.2037037
NODE_275682_length_256_cov_3.866242	112	166	6	27	54	0.5000000
NODE_275840_length_256_cov_2.878981	79	159	0	80	80	1.0000000
NODE_275840_length_256_cov_2.878981	132	212	0	80	80	1.0000000
NODE_275909_length_256_cov_2.598726	157	222	0	5	65	0.0769231
NODE_275909_length_256_cov_2.598726	157	222	2	17	65	0.2615385
NODE_275909_length_256_cov_2.598726	157	222	4	43	65	0.6615385
NODE_275909_length_256_cov_2.598726	195	249	2	5	54	0.0925926
NODE_275909_length_256_cov_2.598726	195	249	4	49	54	0.9074074
NODE_275981_length_256_cov_2.445860	104	183	0	16	79	0.2025317
NODE_275981_length_256_cov_2.445860	104	183	2	63	79	0.7974684
NODE_276082_length_256_cov_2.229299	0	58	0	42	58	0.7241379
NODE_276082_length_256_cov_2.229299	0	58	2	16	58	0.2758621
NODE_276082_length_256_cov_2.229299	17	68	0	25	51	0.4901961
NODE_276082_length_256_cov_2.229299	17	68	2	26	51	0.5098040
NODE_276082_length_256_cov_2.229299	41	88	0	1	47	0.0212766
NODE_276082_length_256_cov_2.229299	41	88	2	46	47	0.9787234
NODE_276082_length_256_cov_2.229299	42	122	2	80	80	1.0000000
NODE_276098_length_256_cov_2.184713	192	246	0	54	54	1.0000000
NODE_276119_length_256_cov_2.121019	150	236	0	45	86	0.5232558
NODE_276119_length_256_cov_2.121019	150	236	2	41	86	0.4767442
NODE_276174_length_256_cov_1.974522	130	174	0	44	44	1.0000000
NODE_276471_length_256_cov_1.707006	39	92	0	9	53	0.1698113
NODE_276471_length_256_cov_1.707006	39	92	2	21	53	0.3962264
NODE_276471_length_256_cov_1.707006	39	92	4	23	53	0.4339623
NODE_276471_length_256_cov_1.707006	93	135	4	1	42	0.0238095
NODE_276471_length_256_cov_1.707006	93	135	6	20	42	0.4761905
NODE_276471_length_256_cov_1.707006	93	135	8	1	42	0.0238095
NODE_276471_length_256_cov_1.707006	93	135	10	6	42	0.1428571
NODE_276471_length_256_cov_1.707006	93	135	12	7	42	0.1666667
NODE_276471_length_256_cov_1.707006	93	135	14	6	42	0.1428571
NODE_276471_length_256_cov_1.707006	93	135	18	1	42	0.0238095
NODE_276484_length_256_cov_1.700637	107	129	0	22	22	1.0000000
NODE_276495_length_256_cov_1.675159	52	98	0	46	46	1.0000000
NODE_276654_length_256_cov_1.598726	125	202	2	15	77	0.1948052
NODE_276654_length_256_cov_1.598726	125	202	4	26	77	0.3376623
NODE_276654_length_256_cov_1.598726	125	202	6	36	77	0.4675325
NODE_276654_length_256_cov_1.598726	178	256	2	31	78	0.3974359
NODE_276654_length_256_cov_1.598726	178	256	4	21	78	0.2692308
NODE_276654_length_256_cov_1.598726	178	256	6	26	78	0.3333333
NODE_276672_length_256_cov_1.579618	110	172	4	62	62	1.0000000
NODE_276672_length_256_cov_1.579618	194	239	0	33	45	0.7333333
NODE_276672_length_256_cov_1.579618	194	239	2	12	45	0.2666667
NODE_276742_length_256_cov_1.464968	112	135	0	23	23	1.0000000
NODE_276826_length_256_cov_1.331210	138	209	2	6	71	0.0845070
NODE_276826_length_256_cov_1.331210	138	209	4	17	71	0.2394366
NODE_276826_length_256_cov_1.331210	138	209	6	48	71	0.6760563
NODE_276826_length_256_cov_1.331210	182	240	0	11	58	0.1896552
NODE_276826_length_256_cov_1.331210	182	240	2	8	58	0.1379310
NODE_276826_length_256_cov_1.331210	182	240	4	24	58	0.4137931
NODE_276826_length_256_cov_1.331210	182	240	6	15	58	0.2586207
NODE_277113_length_256_cov_1.299363	88	160	4	6	72	0.0833333
NODE_277113_length_256_cov_1.299363	88	160	6	13	72	0.1805556
NODE_277113_length_256_cov_1.299363	88	160	8	53	72	0.7361111
NODE_277305_length_256_cov_1.203822	3	43	0	1	40	0.0250000
NODE_277305_length_256_cov_1.203822	3	43	1	16	40	0.4000000
NODE_277305_length_256_cov_1.203822	3	43	4	5	40	0.1250000
NODE_277305_length_256_cov_1.203822	3	43	6	1	40	0.0250000
NODE_277305_length_256_cov_1.203822	3	43	7	2	40	0.0500000
NODE_277305_length_256_cov_1.203822	3	43	11	8	40	0.2000000
NODE_277305_length_256_cov_1.203822	3	43	12	7	40	0.1750000
NODE_277305_length_256_cov_1.203822	16	96	1	4	80	0.0500000
NODE_277305_length_256_cov_1.203822	16	96	4	5	80	0.0625000
NODE_277305_length_256_cov_1.203822	16	96	6	1	80	0.0125000
NODE_277305_length_256_cov_1.203822	16	96	7	2	80	0.0250000
NODE_277305_length_256_cov_1.203822	16	96	11	8	80	0.1000000
NODE_277305_length_256_cov_1.203822	16	96	12	24	80	0.3000000
NODE_277305_length_256_cov_1.203822	16	96	14	34	80	0.4250000
NODE_277305_length_256_cov_1.203822	16	96	16	2	80	0.0250000
NODE_278934_length_255_cov_73.756410	52	99	3	3	47	0.0638298
NODE_278934_length_255_cov_73.756410	52	99	4	7	47	0.1489362
NODE_278934_length_255_cov_73.756410	52	99	6	20	47	0.4255319
NODE_278934_length_255_cov_73.756410	52	99	8	3	47	0.0638298
NODE_278934_length_255_cov_73.756410	52	99	10	14	47	0.2978723
NODE_278934_length_255_cov_73.756410	133	184	29	1	51	0.0196078
NODE_278934_length_255_cov_73.756410	133	184	31	6	51	0.1176471
NODE_278934_length_255_cov_73.756410	133	184	32	9	51	0.1764706
NODE_278934_length_255_cov_73.756410	133	184	34	20	51	0.3921569
NODE_278934_length_255_cov_73.756410	133	184	35	15	51	0.2941177
NODE_278934_length_255_cov_73.756410	157	237	0	5	80	0.0625000
NODE_278934_length_255_cov_73.756410	157	237	4	5	80	0.0625000
NODE_278934_length_255_cov_73.756410	157	237	6	5	80	0.0625000
NODE_278934_length_255_cov_73.756410	157	237	8	3	80	0.0375000
NODE_278934_length_255_cov_73.756410	157	237	10	8	80	0.1000000
NODE_278934_length_255_cov_73.756410	157	237	14	2	80	0.0250000
NODE_278934_length_255_cov_73.756410	157	237	16	2	80	0.0250000
NODE_278934_length_255_cov_73.756410	157	237	20	6	80	0.0750000
NODE_278934_length_255_cov_73.756410	157	237	22	2	80	0.0250000
NODE_278934_length_255_cov_73.756410	157	237	23	4	80	0.0500000
NODE_278934_length_255_cov_73.756410	157	237	25	3	80	0.0375000
NODE_278934_length_255_cov_73.756410	157	237	27	5	80	0.0625000
NODE_278934_length_255_cov_73.756410	157	237	29	4	80	0.0500000
NODE_278934_length_255_cov_73.756410	157	237	31	1	80	0.0125000
NODE_278934_length_255_cov_73.756410	157	237	32	9	80	0.1125000
NODE_278934_length_255_cov_73.756410	157	237	34	16	80	0.2000000
NODE_278937_length_255_cov_15.538462	219	255	0	36	36	1.0000000
NODE_279003_length_255_cov_4.884615	157	230	0	71	73	0.9726027
NODE_279003_length_255_cov_4.884615	157	230	16	2	73	0.0273973
NODE_279003_length_255_cov_4.884615	203	248	0	45	45	1.0000000
NODE_279058_length_255_cov_4.012821	68	148	22	35	80	0.4375000
NODE_279058_length_255_cov_4.012821	68	148	24	5	80	0.0625000
NODE_279058_length_255_cov_4.012821	68	148	32	40	80	0.5000000
NODE_279075_length_255_cov_3.826923	16	80	0	18	64	0.2812500
NODE_279075_length_255_cov_3.826923	16	80	2	13	64	0.2031250
NODE_279075_length_255_cov_3.826923	16	80	4	12	64	0.1875000
NODE_279075_length_255_cov_3.826923	16	80	6	19	64	0.2968750
NODE_279075_length_255_cov_3.826923	16	80	8	2	64	0.0312500
NODE_279102_length_255_cov_3.596154	30	60	2	30	30	1.0000000
NODE_279134_length_255_cov_3.423077	64	109	4	45	45	1.0000000
NODE_279166_length_255_cov_3.262821	0	48	0	6	48	0.1250000
NODE_279166_length_255_cov_3.262821	0	48	2	21	48	0.4375000
NODE_279166_length_255_cov_3.262821	0	48	4	17	48	0.3541667
NODE_279166_length_255_cov_3.262821	0	48	6	4	48	0.0833333
NODE_279166_length_255_cov_3.262821	66	113	4	16	47	0.3404255
NODE_279166_length_255_cov_3.262821	66	113	6	31	47	0.6595744
NODE_279241_length_255_cov_2.942308	157	176	0	19	19	1.0000000
NODE_279320_length_255_cov_2.621795	227	254	0	27	27	1.0000000
NODE_279379_length_255_cov_2.602564	131	185	4	23	54	0.4259259
NODE_279379_length_255_cov_2.602564	131	185	5	1	54	0.0185185
NODE_279379_length_255_cov_2.602564	131	185	6	30	54	0.5555556
NODE_279427_length_255_cov_2.487179	43	119	10	6	76	0.0789474
NODE_279427_length_255_cov_2.487179	43	119	12	2	76	0.0263158
NODE_279427_length_255_cov_2.487179	43	119	13	16	76	0.2105263
NODE_279427_length_255_cov_2.487179	43	119	14	24	76	0.3157895
NODE_279427_length_255_cov_2.487179	43	119	16	28	76	0.3684210
NODE_279447_length_255_cov_2.435897	0	58	0	58	58	1.0000000
NODE_279462_length_255_cov_2.391026	189	255	0	66	66	1.0000000
NODE_279507_length_255_cov_2.288462	0	60	0	60	60	1.0000000
NODE_279510_length_255_cov_2.288462	0	74	0	74	74	1.0000000
NODE_279620_length_255_cov_2.089744	105	145	2	40	40	1.0000000
NODE_279649_length_255_cov_1.987179	0	72	0	72	72	1.0000000
NODE_279842_length_255_cov_1.910256	198	255	0	57	57	1.0000000
NODE_279871_length_255_cov_1.871795	16	68	2	52	52	1.0000000
NODE_279892_length_255_cov_1.826923	146	218	0	7	72	0.0972222
NODE_279892_length_255_cov_1.826923	146	218	4	65	72	0.9027778
NODE_279956_length_255_cov_1.705128	0	45	0	45	45	1.0000000
NODE_279956_length_255_cov_1.705128	41	121	0	15	80	0.1875000
NODE_279956_length_255_cov_1.705128	41	121	2	63	80	0.7875000
NODE_279956_length_255_cov_1.705128	41	121	4	2	80	0.0250000
NODE_279956_length_255_cov_1.705128	94	174	2	74	80	0.9250000
NODE_279956_length_255_cov_1.705128	94	174	4	6	80	0.0750000
NODE_280153_length_255_cov_1.576923	43	117	0	46	74	0.6216216
NODE_280153_length_255_cov_1.576923	43	117	2	28	74	0.3783784
NODE_280153_length_255_cov_1.576923	90	175	0	52	85	0.6117647
NODE_280153_length_255_cov_1.576923	90	175	2	33	85	0.3882353
NODE_280168_length_255_cov_1.557692	62	125	4	63	63	1.0000000
NODE_280297_length_255_cov_1.358974	178	246	0	66	68	0.9705882
NODE_280297_length_255_cov_1.358974	178	246	4	2	68	0.0294118
NODE_280904_length_255_cov_1.128205	183	219	2	36	36	1.0000000
NODE_281094_length_255_cov_0.987179	220	241	0	21	21	1.0000000
NODE_281380_length_255_cov_0.955128	119	171	2	2	52	0.0384615
NODE_281380_length_255_cov_0.955128	119	171	4	50	52	0.9615384
NODE_281384_length_255_cov_0.955128	12	92	4	80	80	1.0000000
NODE_282137_length_255_cov_0.653846	87	106	2	19	19	1.0000000
NODE_282534_length_254_cov_4.935484	144	189	4	45	45	1.0000000
NODE_282534_length_254_cov_4.935484	164	242	0	19	78	0.2435897
NODE_282534_length_254_cov_4.935484	164	242	2	16	78	0.2051282
NODE_282534_length_254_cov_4.935484	164	242	4	43	78	0.5512820
NODE_282548_length_254_cov_4.722581	44	85	10	17	41	0.4146341
NODE_282548_length_254_cov_4.722581	44	85	12	24	41	0.5853658
NODE_282576_length_254_cov_4.296774	149	174	0	25	25	1.0000000
NODE_282576_length_254_cov_4.296774	149	223	0	74	74	1.0000000
NODE_282590_length_254_cov_4.206452	57	86	7	13	29	0.4482759
NODE_282590_length_254_cov_4.206452	57	86	9	4	29	0.1379310
NODE_282590_length_254_cov_4.206452	57	86	11	12	29	0.4137931
NODE_282626_length_254_cov_3.677419	7	64	6	5	57	0.0877193
NODE_282626_length_254_cov_3.677419	7	64	12	3	57	0.0526316
NODE_282626_length_254_cov_3.677419	7	64	14	1	57	0.0175439
NODE_282626_length_254_cov_3.677419	7	64	18	12	57	0.2105263
NODE_282626_length_254_cov_3.677419	7	64	20	1	57	0.0175439
NODE_282626_length_254_cov_3.677419	7	64	22	35	57	0.6140351
NODE_282626_length_254_cov_3.677419	60	117	6	20	57	0.3508772
NODE_282626_length_254_cov_3.677419	60	117	8	1	57	0.0175439
NODE_282626_length_254_cov_3.677419	60	117	10	1	57	0.0175439
NODE_282626_length_254_cov_3.677419	60	117	14	1	57	0.0175439
NODE_282626_length_254_cov_3.677419	60	117	16	5	57	0.0877193
NODE_282626_length_254_cov_3.677419	60	117	18	4	57	0.0701754
NODE_282626_length_254_cov_3.677419	60	117	22	25	57	0.4385965
NODE_282642_length_254_cov_3.593548	154	197	0	5	43	0.1162791
NODE_282642_length_254_cov_3.593548	154	197	2	38	43	0.8837209
NODE_282659_length_254_cov_3.438710	82	129	0	47	47	1.0000000
NODE_282659_length_254_cov_3.438710	102	182	0	36	80	0.4500000
NODE_282659_length_254_cov_3.438710	102	182	4	44	80	0.5500000
NODE_282736_length_254_cov_2.961290	5	79	0	66	74	0.8918919
NODE_282736_length_254_cov_2.961290	5	79	2	8	74	0.1081081
NODE_282736_length_254_cov_2.961290	52	118	0	19	66	0.2878788
NODE_282736_length_254_cov_2.961290	52	118	2	47	66	0.7121212
NODE_282771_length_254_cov_2.780645	169	252	0	8	83	0.0963855
NODE_282771_length_254_cov_2.780645	169	252	2	1	83	0.0120482
NODE_282771_length_254_cov_2.780645	169	252	4	5	83	0.0602410
NODE_282771_length_254_cov_2.780645	169	252	6	2	83	0.0240964
NODE_282771_length_254_cov_2.780645	169	252	8	3	83	0.0361446
NODE_282771_length_254_cov_2.780645	169	252	10	18	83	0.2168675
NODE_282771_length_254_cov_2.780645	169	252	12	2	83	0.0240964
NODE_282771_length_254_cov_2.780645	169	252	14	5	83	0.0602410
NODE_282771_length_254_cov_2.780645	169	252	18	11	83	0.1325301
NODE_282771_length_254_cov_2.780645	169	252	20	1	83	0.0120482
NODE_282771_length_254_cov_2.780645	169	252	22	6	83	0.0722892
NODE_282771_length_254_cov_2.780645	169	252	24	4	83	0.0481928
NODE_282771_length_254_cov_2.780645	169	252	26	1	83	0.0120482
NODE_282771_length_254_cov_2.780645	169	252	28	7	83	0.0843373
NODE_282771_length_254_cov_2.780645	169	252	29	1	83	0.0120482
NODE_282771_length_254_cov_2.780645	169	252	30	5	83	0.0602410
NODE_282771_length_254_cov_2.780645	169	252	32	1	83	0.0120482
NODE_282771_length_254_cov_2.780645	169	252	36	2	83	0.0240964
NODE_282947_length_254_cov_2.341935	167	201	0	34	34	1.0000000
NODE_283082_length_254_cov_2.161290	14	74	0	60	60	1.0000000
NODE_283244_length_254_cov_1.974194	156	204	0	39	48	0.8125000
NODE_283244_length_254_cov_1.974194	156	204	3	9	48	0.1875000
NODE_283440_length_254_cov_1.780645	79	126	13	19	47	0.4042553
NODE_283440_length_254_cov_1.780645	79	126	14	28	47	0.5957447
NODE_283952_length_254_cov_1.316129	23	87	0	64	64	1.0000000
NODE_284013_length_254_cov_1.316129	193	215	0	21	22	0.9545454
NODE_284013_length_254_cov_1.316129	193	215	2	1	22	0.0454545
NODE_284256_length_254_cov_1.258065	181	249	0	68	68	1.0000000
NODE_284275_length_254_cov_1.238710	9	82	0	73	73	1.0000000
NODE_284275_length_254_cov_1.238710	62	82	0	20	20	1.0000000
NODE_284277_length_254_cov_1.238710	54	73	0	19	19	1.0000000
NODE_284301_length_254_cov_1.219355	98	157	0	56	59	0.9491525
NODE_284301_length_254_cov_1.219355	98	157	1	2	59	0.0338983
NODE_284301_length_254_cov_1.219355	98	157	3	1	59	0.0169492
NODE_284638_length_254_cov_0.987097	139	193	0	54	54	1.0000000
NODE_284638_length_254_cov_0.987097	205	254	0	49	49	1.0000000
NODE_284796_length_254_cov_0.987097	121	152	0	31	31	1.0000000
NODE_285963_length_253_cov_60.311688	137	202	4	3	65	0.0461538
NODE_285963_length_253_cov_60.311688	137	202	6	1	65	0.0153846
NODE_285963_length_253_cov_60.311688	137	202	8	6	65	0.0923077
NODE_285963_length_253_cov_60.311688	137	202	13	1	65	0.0153846
NODE_285963_length_253_cov_60.311688	137	202	14	54	65	0.8307692
NODE_285963_length_253_cov_60.311688	175	253	0	5	78	0.0641026
NODE_285963_length_253_cov_60.311688	175	253	6	5	78	0.0641026
NODE_285963_length_253_cov_60.311688	175	253	8	1	78	0.0128205
NODE_285963_length_253_cov_60.311688	175	253	10	2	78	0.0256410
NODE_285963_length_253_cov_60.311688	175	253	12	1	78	0.0128205
NODE_285963_length_253_cov_60.311688	175	253	14	64	78	0.8205128
NODE_285965_length_253_cov_41.519481	0	68	0	5	68	0.0735294
NODE_285965_length_253_cov_41.519481	0	68	1	3	68	0.0441176
NODE_285965_length_253_cov_41.519481	0	68	2	6	68	0.0882353
NODE_285965_length_253_cov_41.519481	0	68	4	11	68	0.1617647
NODE_285965_length_253_cov_41.519481	0	68	6	10	68	0.1470588
NODE_285965_length_253_cov_41.519481	0	68	14	1	68	0.0147059
NODE_285965_length_253_cov_41.519481	0	68	16	15	68	0.2205882
NODE_285965_length_253_cov_41.519481	0	68	22	17	68	0.2500000
NODE_285965_length_253_cov_41.519481	0	70	0	5	70	0.0714286
NODE_285965_length_253_cov_41.519481	0	70	1	3	70	0.0428571
NODE_285965_length_253_cov_41.519481	0	70	2	6	70	0.0857143
NODE_285965_length_253_cov_41.519481	0	70	4	11	70	0.1571429
NODE_285965_length_253_cov_41.519481	0	70	6	10	70	0.1428571
NODE_285965_length_253_cov_41.519481	0	70	14	1	70	0.0142857
NODE_285965_length_253_cov_41.519481	0	70	16	15	70	0.2142857
NODE_285965_length_253_cov_41.519481	0	70	22	19	70	0.2714286
NODE_285965_length_253_cov_41.519481	2	73	0	3	71	0.0422535
NODE_285965_length_253_cov_41.519481	2	73	1	3	71	0.0422535
NODE_285965_length_253_cov_41.519481	2	73	2	6	71	0.0845070
NODE_285965_length_253_cov_41.519481	2	73	4	11	71	0.1549296
NODE_285965_length_253_cov_41.519481	2	73	6	10	71	0.1408451
NODE_285965_length_253_cov_41.519481	2	73	14	1	71	0.0140845
NODE_285965_length_253_cov_41.519481	2	73	16	15	71	0.2112676
NODE_285965_length_253_cov_41.519481	2	73	22	22	71	0.3098592
NODE_285965_length_253_cov_41.519481	7	73	1	1	66	0.0151515
NODE_285965_length_253_cov_41.519481	7	73	2	6	66	0.0909091
NODE_285965_length_253_cov_41.519481	7	73	4	11	66	0.1666667
NODE_285965_length_253_cov_41.519481	7	73	6	10	66	0.1515152
NODE_285965_length_253_cov_41.519481	7	73	14	1	66	0.0151515
NODE_285965_length_253_cov_41.519481	7	73	16	15	66	0.2272727
NODE_285965_length_253_cov_41.519481	7	73	22	22	66	0.3333333
NODE_285965_length_253_cov_41.519481	46	123	12	5	77	0.0649351
NODE_285965_length_253_cov_41.519481	46	123	16	11	77	0.1428571
NODE_285965_length_253_cov_41.519481	46	123	18	2	77	0.0259740
NODE_285965_length_253_cov_41.519481	46	123	22	28	77	0.3636364
NODE_285965_length_253_cov_41.519481	46	123	23	1	77	0.0129870
NODE_285965_length_253_cov_41.519481	46	123	24	30	77	0.3896104
NODE_285965_length_253_cov_41.519481	46	123	12	5	77	0.0649351
NODE_285965_length_253_cov_41.519481	46	123	16	11	77	0.1428571
NODE_285965_length_253_cov_41.519481	46	123	18	2	77	0.0259740
NODE_285965_length_253_cov_41.519481	46	123	22	28	77	0.3636364
NODE_285965_length_253_cov_41.519481	46	123	23	1	77	0.0129870
NODE_285965_length_253_cov_41.519481	46	123	24	30	77	0.3896104
NODE_285965_length_253_cov_41.519481	46	123	12	5	77	0.0649351
NODE_285965_length_253_cov_41.519481	46	123	16	11	77	0.1428571
NODE_285965_length_253_cov_41.519481	46	123	18	2	77	0.0259740
NODE_285965_length_253_cov_41.519481	46	123	22	28	77	0.3636364
NODE_285965_length_253_cov_41.519481	46	123	23	1	77	0.0129870
NODE_285965_length_253_cov_41.519481	46	123	24	30	77	0.3896104
NODE_285967_length_253_cov_13.967532	25	105	0	80	80	1.0000000
NODE_285967_length_253_cov_13.967532	78	158	0	80	80	1.0000000
NODE_285969_length_253_cov_12.259740	0	54	0	54	54	1.0000000
NODE_285969_length_253_cov_12.259740	27	62	0	35	35	1.0000000
NODE_285969_length_253_cov_12.259740	51	131	0	80	80	1.0000000
NODE_285969_length_253_cov_12.259740	104	139	0	35	35	1.0000000
NODE_285969_length_253_cov_12.259740	128	208	0	80	80	1.0000000
NODE_285969_length_253_cov_12.259740	181	216	0	35	35	1.0000000
NODE_285987_length_253_cov_7.279221	184	250	0	1	66	0.0151515
NODE_285987_length_253_cov_7.279221	184	250	2	31	66	0.4696970
NODE_285987_length_253_cov_7.279221	184	250	4	34	66	0.5151515
NODE_286022_length_253_cov_5.376623	66	147	2	29	81	0.3580247
NODE_286022_length_253_cov_5.376623	66	147	6	32	81	0.3950617
NODE_286022_length_253_cov_5.376623	66	147	8	20	81	0.2469136
NODE_286022_length_253_cov_5.376623	120	185	2	3	65	0.0461538
NODE_286022_length_253_cov_5.376623	120	185	6	23	65	0.3538462
NODE_286022_length_253_cov_5.376623	120	185	8	39	65	0.6000000
NODE_286042_length_253_cov_4.896104	102	182	23	5	80	0.0625000
NODE_286042_length_253_cov_4.896104	102	182	24	2	80	0.0250000
NODE_286042_length_253_cov_4.896104	102	182	31	2	80	0.0250000
NODE_286042_length_253_cov_4.896104	102	182	34	2	80	0.0250000
NODE_286042_length_253_cov_4.896104	102	182	36	2	80	0.0250000
NODE_286042_length_253_cov_4.896104	102	182	45	1	80	0.0125000
NODE_286042_length_253_cov_4.896104	102	182	49	1	80	0.0125000
NODE_286042_length_253_cov_4.896104	102	182	51	2	80	0.0250000
NODE_286042_length_253_cov_4.896104	102	182	62	1	80	0.0125000
NODE_286042_length_253_cov_4.896104	102	182	63	1	80	0.0125000
NODE_286042_length_253_cov_4.896104	102	182	64	1	80	0.0125000
NODE_286042_length_253_cov_4.896104	102	182	65	2	80	0.0250000
NODE_286042_length_253_cov_4.896104	102	182	67	1	80	0.0125000
NODE_286042_length_253_cov_4.896104	102	182	68	1	80	0.0125000
NODE_286042_length_253_cov_4.896104	102	182	69	4	80	0.0500000
NODE_286042_length_253_cov_4.896104	102	182	70	1	80	0.0125000
NODE_286042_length_253_cov_4.896104	102	182	71	3	80	0.0375000
NODE_286042_length_253_cov_4.896104	102	182	72	2	80	0.0250000
NODE_286042_length_253_cov_4.896104	102	182	73	2	80	0.0250000
NODE_286042_length_253_cov_4.896104	102	182	76	6	80	0.0750000
NODE_286042_length_253_cov_4.896104	102	182	82	3	80	0.0375000
NODE_286042_length_253_cov_4.896104	102	182	84	4	80	0.0500000
NODE_286042_length_253_cov_4.896104	102	182	85	2	80	0.0250000
NODE_286042_length_253_cov_4.896104	102	182	89	1	80	0.0125000
NODE_286042_length_253_cov_4.896104	102	182	95	1	80	0.0125000
NODE_286042_length_253_cov_4.896104	102	182	97	1	80	0.0125000
NODE_286042_length_253_cov_4.896104	102	182	98	2	80	0.0250000
NODE_286042_length_253_cov_4.896104	102	182	100	2	80	0.0250000
NODE_286042_length_253_cov_4.896104	102	182	101	4	80	0.0500000
NODE_286042_length_253_cov_4.896104	102	182	102	7	80	0.0875000
NODE_286042_length_253_cov_4.896104	102	182	104	2	80	0.0250000
NODE_286042_length_253_cov_4.896104	102	182	106	9	80	0.1125000
NODE_286046_length_253_cov_4.798701	199	253	0	54	54	1.0000000
NODE_286069_length_253_cov_4.487013	85	126	0	41	41	1.0000000
NODE_286151_length_253_cov_3.500000	44	105	0	61	61	1.0000000
NODE_286151_length_253_cov_3.500000	90	158	0	68	68	1.0000000
NODE_286259_length_253_cov_2.987013	85	165	0	80	80	1.0000000
NODE_286259_length_253_cov_2.987013	138	169	0	31	31	1.0000000
NODE_286275_length_253_cov_2.954545	100	148	0	48	48	1.0000000
NODE_286281_length_253_cov_2.909091	34	99	8	24	65	0.3692308
NODE_286281_length_253_cov_2.909091	34	99	10	9	65	0.1384615
NODE_286281_length_253_cov_2.909091	34	99	12	5	65	0.0769231
NODE_286281_length_253_cov_2.909091	34	99	14	17	65	0.2615385
NODE_286281_length_253_cov_2.909091	34	99	15	1	65	0.0153846
NODE_286281_length_253_cov_2.909091	34	99	16	9	65	0.1384615
NODE_286288_length_253_cov_2.889610	129	200	8	12	71	0.1690141
NODE_286288_length_253_cov_2.889610	129	200	10	13	71	0.1830986
NODE_286288_length_253_cov_2.889610	129	200	12	11	71	0.1549296
NODE_286288_length_253_cov_2.889610	129	200	14	23	71	0.3239437
NODE_286288_length_253_cov_2.889610	129	200	16	12	71	0.1690141
NODE_286288_length_253_cov_2.889610	173	253	4	4	80	0.0500000
NODE_286288_length_253_cov_2.889610	173	253	6	1	80	0.0125000
NODE_286288_length_253_cov_2.889610	173	253	8	4	80	0.0500000
NODE_286288_length_253_cov_2.889610	173	253	9	1	80	0.0125000
NODE_286288_length_253_cov_2.889610	173	253	10	1	80	0.0125000
NODE_286288_length_253_cov_2.889610	173	253	12	8	80	0.1000000
NODE_286288_length_253_cov_2.889610	173	253	14	61	80	0.7625000
NODE_286289_length_253_cov_2.889610	21	76	0	55	55	1.0000000
NODE_286289_length_253_cov_2.889610	149	229	0	2	80	0.0250000
NODE_286289_length_253_cov_2.889610	149	229	2	78	80	0.9750000
NODE_286379_length_253_cov_2.610390	113	193	0	80	80	1.0000000
NODE_286386_length_253_cov_2.584416	97	154	0	28	57	0.4912281
NODE_286386_length_253_cov_2.584416	97	154	2	29	57	0.5087720
NODE_286545_length_253_cov_2.240260	185	250	0	65	65	1.0000000
NODE_286667_length_253_cov_1.987013	157	237	0	80	80	1.0000000
NODE_286667_length_253_cov_1.987013	210	253	0	43	43	1.0000000
NODE_286685_length_253_cov_1.987013	18	60	4	28	42	0.6666667
NODE_286685_length_253_cov_1.987013	18	60	6	8	42	0.1904762
NODE_286685_length_253_cov_1.987013	18	60	7	6	42	0.1428571
NODE_286829_length_253_cov_1.961039	186	232	0	46	46	1.0000000
NODE_286837_length_253_cov_1.948052	68	120	0	52	52	1.0000000
NODE_286838_length_253_cov_1.948052	63	114	0	30	51	0.5882353
NODE_286838_length_253_cov_1.948052	63	114	2	21	51	0.4117647
NODE_286947_length_253_cov_1.746753	164	193	0	29	29	1.0000000
NODE_287031_length_253_cov_1.655844	40	120	2	25	80	0.3125000
NODE_287031_length_253_cov_1.655844	40	120	4	1	80	0.0125000
NODE_287031_length_253_cov_1.655844	40	120	8	32	80	0.4000000
NODE_287031_length_253_cov_1.655844	40	120	10	22	80	0.2750000
NODE_287031_length_253_cov_1.655844	93	152	0	2	59	0.0338983
NODE_287031_length_253_cov_1.655844	93	152	4	9	59	0.1525424
NODE_287031_length_253_cov_1.655844	93	152	6	16	59	0.2711864
NODE_287031_length_253_cov_1.655844	93	152	8	23	59	0.3898305
NODE_287031_length_253_cov_1.655844	93	152	10	9	59	0.1525424
NODE_287133_length_253_cov_1.590909	102	148	2	46	46	1.0000000
NODE_287156_length_253_cov_1.558442	67	149	0	31	82	0.3780488
NODE_287156_length_253_cov_1.558442	67	149	2	32	82	0.3902439
NODE_287156_length_253_cov_1.558442	67	149	4	19	82	0.2317073
NODE_287230_length_253_cov_1.441558	49	113	0	64	64	1.0000000
NODE_287230_length_253_cov_1.441558	102	166	0	64	64	1.0000000
NODE_287232_length_253_cov_1.441558	121	185	0	21	64	0.3281250
NODE_287232_length_253_cov_1.441558	121	185	2	43	64	0.6718750
NODE_287234_length_253_cov_1.435065	50	81	0	31	31	1.0000000
NODE_287584_length_253_cov_1.324675	193	239	2	4	46	0.0869565
NODE_287584_length_253_cov_1.324675	193	239	4	38	46	0.8260869
NODE_287584_length_253_cov_1.324675	193	239	8	4	46	0.0869565
NODE_287599_length_253_cov_1.324675	90	132	28	13	42	0.3095238
NODE_287599_length_253_cov_1.324675	90	132	30	18	42	0.4285714
NODE_287599_length_253_cov_1.324675	90	132	31	2	42	0.0476190
NODE_287599_length_253_cov_1.324675	90	132	32	9	42	0.2142857
NODE_287599_length_253_cov_1.324675	133	185	7	1	52	0.0192308
NODE_287599_length_253_cov_1.324675	133	185	8	4	52	0.0769231
NODE_287599_length_253_cov_1.324675	133	185	10	2	52	0.0384615
NODE_287599_length_253_cov_1.324675	133	185	11	1	52	0.0192308
NODE_287599_length_253_cov_1.324675	133	185	18	1	52	0.0192308
NODE_287599_length_253_cov_1.324675	133	185	20	2	52	0.0384615
NODE_287599_length_253_cov_1.324675	133	185	22	8	52	0.1538462
NODE_287599_length_253_cov_1.324675	133	185	24	1	52	0.0192308
NODE_287599_length_253_cov_1.324675	133	185	26	6	52	0.1153846
NODE_287599_length_253_cov_1.324675	133	185	28	6	52	0.1153846
NODE_287599_length_253_cov_1.324675	133	185	30	4	52	0.0769231
NODE_287599_length_253_cov_1.324675	133	185	32	16	52	0.3076923
NODE_287721_length_253_cov_1.285714	87	125	0	10	38	0.2631579
NODE_287721_length_253_cov_1.285714	87	125	4	9	38	0.2368421
NODE_287721_length_253_cov_1.285714	87	125	6	19	38	0.5000000
NODE_287794_length_253_cov_1.214286	99	148	0	49	49	1.0000000
NODE_287845_length_253_cov_1.181818	185	247	0	62	62	1.0000000
NODE_287845_length_253_cov_1.181818	185	247	0	62	62	1.0000000
NODE_287989_length_253_cov_1.064935	83	159	9	3	76	0.0394737
NODE_287989_length_253_cov_1.064935	83	159	10	1	76	0.0131579
NODE_287989_length_253_cov_1.064935	83	159	11	10	76	0.1315790
NODE_287989_length_253_cov_1.064935	83	159	13	5	76	0.0657895
NODE_287989_length_253_cov_1.064935	83	159	15	12	76	0.1578947
NODE_287989_length_253_cov_1.064935	83	159	16	7	76	0.0921053
NODE_287989_length_253_cov_1.064935	83	159	17	1	76	0.0131579
NODE_287989_length_253_cov_1.064935	83	159	18	24	76	0.3157895
NODE_287989_length_253_cov_1.064935	83	159	19	10	76	0.1315790
NODE_287989_length_253_cov_1.064935	83	159	20	3	76	0.0394737
NODE_288099_length_253_cov_0.993506	0	44	0	44	44	1.0000000
NODE_288465_length_253_cov_0.870130	17	46	4	29	29	1.0000000
NODE_288478_length_253_cov_0.850649	0	89	0	89	89	1.0000000
NODE_289563_length_252_cov_4.771242	94	148	0	54	54	1.0000000
NODE_289574_length_252_cov_4.614379	16	37	0	3	21	0.1428571
NODE_289574_length_252_cov_4.614379	16	37	2	18	21	0.8571429
NODE_289624_length_252_cov_3.960784	7	85	0	24	78	0.3076923
NODE_289624_length_252_cov_3.960784	7	85	2	54	78	0.6923077
NODE_289624_length_252_cov_3.960784	63	136	0	73	73	1.0000000
NODE_289663_length_252_cov_3.549020	89	157	0	68	68	1.0000000
NODE_289672_length_252_cov_3.405229	26	107	4	2	81	0.0246914
NODE_289672_length_252_cov_3.405229	26	107	6	1	81	0.0123457
NODE_289672_length_252_cov_3.405229	26	107	8	12	81	0.1481481
NODE_289672_length_252_cov_3.405229	26	107	10	9	81	0.1111111
NODE_289672_length_252_cov_3.405229	26	107	14	9	81	0.1111111
NODE_289672_length_252_cov_3.405229	26	107	16	5	81	0.0617284
NODE_289672_length_252_cov_3.405229	26	107	18	6	81	0.0740741
NODE_289672_length_252_cov_3.405229	26	107	20	1	81	0.0123457
NODE_289672_length_252_cov_3.405229	26	107	22	9	81	0.1111111
NODE_289672_length_252_cov_3.405229	26	107	24	16	81	0.1975309
NODE_289672_length_252_cov_3.405229	26	107	26	11	81	0.1358025
NODE_289705_length_252_cov_3.307190	91	141	0	50	50	1.0000000
NODE_289742_length_252_cov_3.032680	135	212	0	52	77	0.6753247
NODE_289742_length_252_cov_3.032680	135	212	2	25	77	0.3246753
NODE_289775_length_252_cov_2.928105	0	57	0	57	57	1.0000000
NODE_289799_length_252_cov_2.803922	41	121	0	17	80	0.2125000
NODE_289799_length_252_cov_2.803922	41	121	6	63	80	0.7875000
NODE_290032_length_252_cov_2.320261	0	64	0	59	64	0.9218750
NODE_290032_length_252_cov_2.320261	0	64	30	1	64	0.0156250
NODE_290032_length_252_cov_2.320261	0	64	33	2	64	0.0312500
NODE_290032_length_252_cov_2.320261	0	64	35	1	64	0.0156250
NODE_290032_length_252_cov_2.320261	0	64	37	1	64	0.0156250
NODE_290046_length_252_cov_2.281046	120	170	0	50	50	1.0000000
NODE_290066_length_252_cov_2.215686	137	175	38	2	38	0.0526316
NODE_290066_length_252_cov_2.215686	137	175	43	3	38	0.0789474
NODE_290066_length_252_cov_2.215686	137	175	44	3	38	0.0789474
NODE_290066_length_252_cov_2.215686	137	175	45	7	38	0.1842105
NODE_290066_length_252_cov_2.215686	137	175	46	5	38	0.1315790
NODE_290066_length_252_cov_2.215686	137	175	47	17	38	0.4473684
NODE_290066_length_252_cov_2.215686	137	175	49	1	38	0.0263158
NODE_290103_length_252_cov_2.052288	18	39	0	21	21	1.0000000
NODE_290238_length_252_cov_1.993464	80	139	1	14	59	0.2372881
NODE_290238_length_252_cov_1.993464	80	139	3	45	59	0.7627119
NODE_290385_length_252_cov_1.810458	3	49	0	46	46	1.0000000
NODE_290623_length_252_cov_1.594771	103	156	0	53	53	1.0000000
NODE_290623_length_252_cov_1.594771	152	192	0	35	40	0.8750000
NODE_290623_length_252_cov_1.594771	152	192	4	5	40	0.1250000
NODE_290638_length_252_cov_1.568627	1	68	2	67	67	1.0000000
NODE_290767_length_252_cov_1.359477	26	93	0	67	67	1.0000000
NODE_290790_length_252_cov_1.333333	179	232	0	53	53	1.0000000
NODE_290850_length_252_cov_1.333333	187	222	2	35	35	1.0000000
NODE_291072_length_252_cov_1.333333	31	111	0	80	80	1.0000000
NODE_291076_length_252_cov_1.333333	90	140	1	50	50	1.0000000
NODE_291118_length_252_cov_1.326797	112	143	2	31	31	1.0000000
NODE_291351_length_252_cov_1.156863	1	32	0	31	31	1.0000000
NODE_291650_length_252_cov_1.000000	49	79	0	30	30	1.0000000
NODE_291911_length_252_cov_0.836601	125	172	0	47	47	1.0000000
NODE_293004_length_251_cov_5.032895	0	62	0	62	62	1.0000000
NODE_293005_length_251_cov_5.026316	84	164	0	80	80	1.0000000
NODE_293165_length_251_cov_3.302632	187	249	0	62	62	1.0000000
NODE_293195_length_251_cov_3.131579	96	148	0	52	52	1.0000000
NODE_293238_length_251_cov_2.980263	11	38	16	1	27	0.0370370
NODE_293238_length_251_cov_2.980263	11	38	17	1	27	0.0370370
NODE_293238_length_251_cov_2.980263	11	38	19	2	27	0.0740741
NODE_293238_length_251_cov_2.980263	11	38	20	1	27	0.0370370
NODE_293238_length_251_cov_2.980263	11	38	22	1	27	0.0370370
NODE_293238_length_251_cov_2.980263	11	38	24	6	27	0.2222222
NODE_293238_length_251_cov_2.980263	11	38	26	7	27	0.2592593
NODE_293238_length_251_cov_2.980263	11	38	34	8	27	0.2962963
NODE_293238_length_251_cov_2.980263	11	91	16	1	80	0.0125000
NODE_293238_length_251_cov_2.980263	11	91	17	1	80	0.0125000
NODE_293238_length_251_cov_2.980263	11	91	19	2	80	0.0250000
NODE_293238_length_251_cov_2.980263	11	91	20	1	80	0.0125000
NODE_293238_length_251_cov_2.980263	11	91	22	1	80	0.0125000
NODE_293238_length_251_cov_2.980263	11	91	24	6	80	0.0750000
NODE_293238_length_251_cov_2.980263	11	91	26	7	80	0.0875000
NODE_293238_length_251_cov_2.980263	11	91	34	61	80	0.7625000
NODE_293259_length_251_cov_2.842105	170	198	4	9	28	0.3214286
NODE_293259_length_251_cov_2.842105	170	198	6	5	28	0.1785714
NODE_293259_length_251_cov_2.842105	170	198	8	2	28	0.0714286
NODE_293259_length_251_cov_2.842105	170	198	10	12	28	0.4285714
NODE_293279_length_251_cov_2.743421	181	232	0	51	51	1.0000000
NODE_293335_length_251_cov_2.677632	35	54	0	19	19	1.0000000
NODE_293454_length_251_cov_2.348684	196	251	0	55	55	1.0000000
NODE_293502_length_251_cov_2.328947	86	149	0	63	63	1.0000000
NODE_293516_length_251_cov_2.296053	91	171	2	80	80	1.0000000
NODE_293516_length_251_cov_2.296053	144	224	0	53	80	0.6625000
NODE_293516_length_251_cov_2.296053	144	224	2	27	80	0.3375000
NODE_293591_length_251_cov_2.065789	7	52	0	45	45	1.0000000
NODE_293698_length_251_cov_2.013158	96	179	0	83	83	1.0000000
NODE_293698_length_251_cov_2.013158	96	179	0	83	83	1.0000000
NODE_293698_length_251_cov_2.013158	152	203	0	51	51	1.0000000
NODE_293698_length_251_cov_2.013158	152	201	0	49	49	1.0000000
NODE_293919_length_251_cov_1.710526	135	194	0	59	59	1.0000000
NODE_294028_length_251_cov_1.671053	94	127	0	33	33	1.0000000
NODE_294063_length_251_cov_1.644737	135	164	0	29	29	1.0000000
NODE_294147_length_251_cov_1.473684	137	202	0	6	65	0.0923077
NODE_294147_length_251_cov_1.473684	137	202	2	59	65	0.9076923
NODE_294153_length_251_cov_1.460526	17	78	0	61	61	1.0000000
NODE_294190_length_251_cov_1.407895	182	246	0	19	64	0.2968750
NODE_294190_length_251_cov_1.407895	182	246	1	6	64	0.0937500
NODE_294190_length_251_cov_1.407895	182	246	3	39	64	0.6093750
NODE_294393_length_251_cov_1.342105	9	89	0	80	80	1.0000000
NODE_294393_length_251_cov_1.342105	62	91	0	29	29	1.0000000
NODE_294624_length_251_cov_1.296053	7	47	0	40	40	1.0000000
NODE_294624_length_251_cov_1.296053	24	47	0	23	23	1.0000000
NODE_295165_length_251_cov_1.006579	4	50	0	46	46	1.0000000
NODE_296033_length_251_cov_0.671053	184	204	0	20	20	1.0000000
NODE_296386_length_251_cov_0.572368	54	74	0	20	20	1.0000000
NODE_296437_length_250_cov_35.662252	33	99	0	66	66	1.0000000
NODE_296437_length_250_cov_35.662252	143	223	0	80	80	1.0000000
NODE_296456_length_250_cov_6.503311	186	250	0	64	64	1.0000000
NODE_296467_length_250_cov_5.867550	99	120	0	21	21	1.0000000
NODE_296520_length_250_cov_4.662252	143	187	0	44	44	1.0000000
NODE_296520_length_250_cov_4.662252	160	227	0	67	67	1.0000000
NODE_296598_length_250_cov_3.715232	37	90	0	12	53	0.2264151
NODE_296598_length_250_cov_3.715232	37	90	4	41	53	0.7735849
NODE_296633_length_250_cov_3.417219	113	193	2	80	80	1.0000000
NODE_296633_length_250_cov_3.417219	166	246	0	16	80	0.2000000
NODE_296633_length_250_cov_3.417219	166	246	2	64	80	0.8000000
NODE_296653_length_250_cov_3.364238	0	61	0	4	61	0.0655738
NODE_296653_length_250_cov_3.364238	0	61	2	32	61	0.5245901
NODE_296653_length_250_cov_3.364238	0	61	4	25	61	0.4098361
NODE_296653_length_250_cov_3.364238	34	94	2	2	60	0.0333333
NODE_296653_length_250_cov_3.364238	34	94	4	58	60	0.9666666
NODE_296680_length_250_cov_3.225166	157	209	2	52	52	1.0000000
NODE_296680_length_250_cov_3.225166	182	250	0	6	68	0.0882353
NODE_296680_length_250_cov_3.225166	182	250	2	62	68	0.9117647
NODE_296699_length_250_cov_3.086093	33	67	0	34	34	1.0000000
NODE_296703_length_250_cov_3.052980	29	94	2	16	65	0.2461538
NODE_296703_length_250_cov_3.052980	29	94	6	49	65	0.7538462
NODE_296707_length_250_cov_3.039735	51	106	0	55	55	1.0000000
NODE_296737_length_250_cov_2.986755	124	185	2	5	61	0.0819672
NODE_296737_length_250_cov_2.986755	124	185	4	45	61	0.7377049
NODE_296737_length_250_cov_2.986755	124	185	6	11	61	0.1803279
NODE_296737_length_250_cov_2.986755	172	243	2	63	71	0.8873239
NODE_296737_length_250_cov_2.986755	172	243	4	3	71	0.0422535
NODE_296737_length_250_cov_2.986755	172	243	6	5	71	0.0704225
NODE_296885_length_250_cov_2.516556	0	49	0	49	49	1.0000000
NODE_296893_length_250_cov_2.476821	94	174	0	80	80	1.0000000
NODE_296893_length_250_cov_2.476821	147	227	0	80	80	1.0000000
NODE_296897_length_250_cov_2.470199	166	212	2	6	46	0.1304348
NODE_296897_length_250_cov_2.470199	166	212	4	15	46	0.3260870
NODE_296897_length_250_cov_2.470199	166	212	6	25	46	0.5434783
NODE_297070_length_250_cov_2.059603	150	207	0	57	57	1.0000000
NODE_297211_length_250_cov_2.019868	74	141	12	16	67	0.2388060
NODE_297211_length_250_cov_2.019868	74	141	14	7	67	0.1044776
NODE_297211_length_250_cov_2.019868	74	141	18	17	67	0.2537313
NODE_297211_length_250_cov_2.019868	74	141	20	27	67	0.4029851
NODE_297211_length_250_cov_2.019868	158	204	8	8	46	0.1739130
NODE_297211_length_250_cov_2.019868	158	204	10	1	46	0.0217391
NODE_297211_length_250_cov_2.019868	158	204	14	5	46	0.1086956
NODE_297211_length_250_cov_2.019868	158	204	16	7	46	0.1521739
NODE_297211_length_250_cov_2.019868	158	204	20	25	46	0.5434783
NODE_297550_length_250_cov_1.688742	6	42	0	36	36	1.0000000
NODE_297624_length_250_cov_1.635762	150	191	6	1	41	0.0243902
NODE_297624_length_250_cov_1.635762	150	191	8	5	41	0.1219512
NODE_297624_length_250_cov_1.635762	150	191	10	35	41	0.8536586
NODE_297679_length_250_cov_1.529801	59	108	0	49	49	1.0000000
NODE_297679_length_250_cov_1.529801	81	161	0	80	80	1.0000000
NODE_297693_length_250_cov_1.516556	124	184	4	32	60	0.5333334
NODE_297693_length_250_cov_1.516556	124	184	8	28	60	0.4666667
NODE_297693_length_250_cov_1.516556	166	237	4	71	71	1.0000000
NODE_297762_length_250_cov_1.377483	0	80	0	80	80	1.0000000
NODE_297963_length_250_cov_1.350993	40	98	0	58	58	1.0000000
NODE_298213_length_250_cov_1.291391	116	196	0	11	80	0.1375000
NODE_298213_length_250_cov_1.291391	116	196	2	26	80	0.3250000
NODE_298213_length_250_cov_1.291391	116	196	4	43	80	0.5375000
NODE_298719_length_250_cov_1.013245	126	163	0	37	37	1.0000000
NODE_298794_length_250_cov_1.006623	129	148	0	19	19	1.0000000
NODE_298900_length_250_cov_0.920530	126	178	24	1	52	0.0192308
NODE_298900_length_250_cov_0.920530	126	178	26	3	52	0.0576923
NODE_298900_length_250_cov_0.920530	126	178	30	1	52	0.0192308
NODE_298900_length_250_cov_0.920530	126	178	32	4	52	0.0769231
NODE_298900_length_250_cov_0.920530	126	178	36	23	52	0.4423077
NODE_298900_length_250_cov_0.920530	126	178	37	4	52	0.0769231
NODE_298900_length_250_cov_0.920530	126	178	39	2	52	0.0384615
NODE_298900_length_250_cov_0.920530	126	178	41	14	52	0.2692308
NODE_299979_length_249_cov_55.413333	97	172	0	75	75	1.0000000
NODE_299979_length_249_cov_55.413333	150	225	0	75	75	1.0000000
NODE_300012_length_247_cov_51.243243	172	247	0	75	75	1.0000000
NODE_300014_length_247_cov_37.614865	156	239	0	83	83	1.0000000
NODE_300056_length_245_cov_40.876712	138	202	54	4	64	0.0625000
NODE_300056_length_245_cov_40.876712	138	202	60	3	64	0.0468750
NODE_300056_length_245_cov_40.876712	138	202	61	1	64	0.0156250
NODE_300056_length_245_cov_40.876712	138	202	67	6	64	0.0937500
NODE_300056_length_245_cov_40.876712	138	202	70	1	64	0.0156250
NODE_300056_length_245_cov_40.876712	138	202	71	1	64	0.0156250
NODE_300056_length_245_cov_40.876712	138	202	73	1	64	0.0156250
NODE_300056_length_245_cov_40.876712	138	202	75	5	64	0.0781250
NODE_300056_length_245_cov_40.876712	138	202	77	3	64	0.0468750
NODE_300056_length_245_cov_40.876712	138	202	78	2	64	0.0312500
NODE_300056_length_245_cov_40.876712	138	202	83	1	64	0.0156250
NODE_300056_length_245_cov_40.876712	138	202	84	20	64	0.3125000
NODE_300056_length_245_cov_40.876712	138	202	86	3	64	0.0468750
NODE_300056_length_245_cov_40.876712	138	202	88	4	64	0.0625000
NODE_300056_length_245_cov_40.876712	138	202	90	1	64	0.0156250
NODE_300056_length_245_cov_40.876712	138	202	92	2	64	0.0312500
NODE_300056_length_245_cov_40.876712	138	202	94	4	64	0.0625000
NODE_300056_length_245_cov_40.876712	138	202	96	2	64	0.0312500
NODE_300056_length_245_cov_40.876712	138	202	54	4	64	0.0625000
NODE_300056_length_245_cov_40.876712	138	202	60	3	64	0.0468750
NODE_300056_length_245_cov_40.876712	138	202	61	1	64	0.0156250
NODE_300056_length_245_cov_40.876712	138	202	67	6	64	0.0937500
NODE_300056_length_245_cov_40.876712	138	202	70	1	64	0.0156250
NODE_300056_length_245_cov_40.876712	138	202	71	1	64	0.0156250
NODE_300056_length_245_cov_40.876712	138	202	73	1	64	0.0156250
NODE_300056_length_245_cov_40.876712	138	202	75	5	64	0.0781250
NODE_300056_length_245_cov_40.876712	138	202	77	3	64	0.0468750
NODE_300056_length_245_cov_40.876712	138	202	78	2	64	0.0312500
NODE_300056_length_245_cov_40.876712	138	202	83	1	64	0.0156250
NODE_300056_length_245_cov_40.876712	138	202	84	20	64	0.3125000
NODE_300056_length_245_cov_40.876712	138	202	86	3	64	0.0468750
NODE_300056_length_245_cov_40.876712	138	202	88	4	64	0.0625000
NODE_300056_length_245_cov_40.876712	138	202	90	1	64	0.0156250
NODE_300056_length_245_cov_40.876712	138	202	92	2	64	0.0312500
NODE_300056_length_245_cov_40.876712	138	202	94	4	64	0.0625000
NODE_300056_length_245_cov_40.876712	138	202	96	2	64	0.0312500
NODE_300056_length_245_cov_40.876712	138	202	54	4	64	0.0625000
NODE_300056_length_245_cov_40.876712	138	202	60	3	64	0.0468750
NODE_300056_length_245_cov_40.876712	138	202	61	1	64	0.0156250
NODE_300056_length_245_cov_40.876712	138	202	67	6	64	0.0937500
NODE_300056_length_245_cov_40.876712	138	202	70	1	64	0.0156250
NODE_300056_length_245_cov_40.876712	138	202	71	1	64	0.0156250
NODE_300056_length_245_cov_40.876712	138	202	73	1	64	0.0156250
NODE_300056_length_245_cov_40.876712	138	202	75	5	64	0.0781250
NODE_300056_length_245_cov_40.876712	138	202	77	3	64	0.0468750
NODE_300056_length_245_cov_40.876712	138	202	78	2	64	0.0312500
NODE_300056_length_245_cov_40.876712	138	202	83	1	64	0.0156250
NODE_300056_length_245_cov_40.876712	138	202	84	20	64	0.3125000
NODE_300056_length_245_cov_40.876712	138	202	86	3	64	0.0468750
NODE_300056_length_245_cov_40.876712	138	202	88	4	64	0.0625000
NODE_300056_length_245_cov_40.876712	138	202	90	1	64	0.0156250
NODE_300056_length_245_cov_40.876712	138	202	92	2	64	0.0312500
NODE_300056_length_245_cov_40.876712	138	202	94	4	64	0.0625000
NODE_300056_length_245_cov_40.876712	138	202	96	2	64	0.0312500
NODE_300056_length_245_cov_40.876712	175	241	11	1	66	0.0151515
NODE_300056_length_245_cov_40.876712	175	241	12	2	66	0.0303030
NODE_300056_length_245_cov_40.876712	175	241	30	2	66	0.0303030
NODE_300056_length_245_cov_40.876712	175	241	32	3	66	0.0454545
NODE_300056_length_245_cov_40.876712	175	241	36	7	66	0.1060606
NODE_300056_length_245_cov_40.876712	175	241	38	2	66	0.0303030
NODE_300056_length_245_cov_40.876712	175	241	44	10	66	0.1515152
NODE_300056_length_245_cov_40.876712	175	241	50	2	66	0.0303030
NODE_300056_length_245_cov_40.876712	175	241	51	3	66	0.0454545
NODE_300056_length_245_cov_40.876712	175	241	52	1	66	0.0151515
NODE_300056_length_245_cov_40.876712	175	241	54	10	66	0.1515152
NODE_300056_length_245_cov_40.876712	175	241	60	3	66	0.0454545
NODE_300056_length_245_cov_40.876712	175	241	61	1	66	0.0151515
NODE_300056_length_245_cov_40.876712	175	241	67	6	66	0.0909091
NODE_300056_length_245_cov_40.876712	175	241	70	1	66	0.0151515
NODE_300056_length_245_cov_40.876712	175	241	71	1	66	0.0151515
NODE_300056_length_245_cov_40.876712	175	241	73	1	66	0.0151515
NODE_300056_length_245_cov_40.876712	175	241	75	5	66	0.0757576
NODE_300056_length_245_cov_40.876712	175	241	77	3	66	0.0454545
NODE_300056_length_245_cov_40.876712	175	241	78	2	66	0.0303030
NODE_300147_length_240_cov_80.744681	167	238	0	28	71	0.3943662
NODE_300147_length_240_cov_80.744681	167	238	2	16	71	0.2253521
NODE_300147_length_240_cov_80.744681	167	238	22	1	71	0.0140845
NODE_300147_length_240_cov_80.744681	167	238	23	3	71	0.0422535
NODE_300147_length_240_cov_80.744681	167	238	25	15	71	0.2112676
NODE_300147_length_240_cov_80.744681	167	238	27	6	71	0.0845070
NODE_300147_length_240_cov_80.744681	167	238	28	2	71	0.0281690
NODE_300148_length_240_cov_38.035461	31	82	0	51	51	1.0000000
NODE_300165_length_239_cov_72.878571	0	48	0	28	48	0.5833333
NODE_300165_length_239_cov_72.878571	0	48	4	20	48	0.4166667
NODE_300165_length_239_cov_72.878571	21	101	0	7	80	0.0875000
NODE_300165_length_239_cov_72.878571	21	101	4	31	80	0.3875000
NODE_300165_length_239_cov_72.878571	21	101	10	15	80	0.1875000
NODE_300165_length_239_cov_72.878571	21	101	25	27	80	0.3375000
NODE_300165_length_239_cov_72.878571	150	230	0	43	80	0.5375000
NODE_300165_length_239_cov_72.878571	150	230	6	29	80	0.3625000
NODE_300165_length_239_cov_72.878571	150	230	22	8	80	0.1000000
NODE_300165_length_239_cov_72.878571	150	230	0	43	80	0.5375000
NODE_300165_length_239_cov_72.878571	150	230	6	29	80	0.3625000
NODE_300165_length_239_cov_72.878571	150	230	22	8	80	0.1000000
NODE_300165_length_239_cov_72.878571	150	212	0	25	62	0.4032258
NODE_300165_length_239_cov_72.878571	150	212	6	29	62	0.4677419
NODE_300165_length_239_cov_72.878571	150	212	22	8	62	0.1290323
NODE_300165_length_239_cov_72.878571	150	221	0	34	71	0.4788733
NODE_300165_length_239_cov_72.878571	150	221	6	29	71	0.4084507
NODE_300165_length_239_cov_72.878571	150	221	22	8	71	0.1126761
NODE_300208_length_238_cov_385.683453	35	104	137	2	69	0.0289855
NODE_300208_length_238_cov_385.683453	35	104	142	1	69	0.0144928
NODE_300208_length_238_cov_385.683453	35	104	151	1	69	0.0144928
NODE_300208_length_238_cov_385.683453	35	104	157	1	69	0.0144928
NODE_300208_length_238_cov_385.683453	35	104	159	1	69	0.0144928
NODE_300208_length_238_cov_385.683453	35	104	163	1	69	0.0144928
NODE_300208_length_238_cov_385.683453	35	104	171	1	69	0.0144928
NODE_300208_length_238_cov_385.683453	35	104	179	1	69	0.0144928
NODE_300208_length_238_cov_385.683453	35	104	185	1	69	0.0144928
NODE_300208_length_238_cov_385.683453	35	104	193	2	69	0.0289855
NODE_300208_length_238_cov_385.683453	35	104	205	1	69	0.0144928
NODE_300208_length_238_cov_385.683453	35	104	209	1	69	0.0144928
NODE_300208_length_238_cov_385.683453	35	104	225	1	69	0.0144928
NODE_300208_length_238_cov_385.683453	35	104	227	1	69	0.0144928
NODE_300208_length_238_cov_385.683453	35	104	231	1	69	0.0144928
NODE_300208_length_238_cov_385.683453	35	104	233	1	69	0.0144928
NODE_300208_length_238_cov_385.683453	35	104	239	1	69	0.0144928
NODE_300208_length_238_cov_385.683453	35	104	240	1	69	0.0144928
NODE_300208_length_238_cov_385.683453	35	104	246	1	69	0.0144928
NODE_300208_length_238_cov_385.683453	35	104	249	1	69	0.0144928
NODE_300208_length_238_cov_385.683453	35	104	252	1	69	0.0144928
NODE_300208_length_238_cov_385.683453	35	104	254	2	69	0.0289855
NODE_300208_length_238_cov_385.683453	35	104	266	5	69	0.0724638
NODE_300208_length_238_cov_385.683453	35	104	268	1	69	0.0144928
NODE_300208_length_238_cov_385.683453	35	104	280	1	69	0.0144928
NODE_300208_length_238_cov_385.683453	35	104	343	1	69	0.0144928
NODE_300208_length_238_cov_385.683453	35	104	345	1	69	0.0144928
NODE_300208_length_238_cov_385.683453	35	104	351	2	69	0.0289855
NODE_300208_length_238_cov_385.683453	35	104	360	1	69	0.0144928
NODE_300208_length_238_cov_385.683453	35	104	368	1	69	0.0144928
NODE_300208_length_238_cov_385.683453	35	104	382	1	69	0.0144928
NODE_300208_length_238_cov_385.683453	35	104	384	1	69	0.0144928
NODE_300208_length_238_cov_385.683453	35	104	392	1	69	0.0144928
NODE_300208_length_238_cov_385.683453	35	104	400	1	69	0.0144928
NODE_300208_length_238_cov_385.683453	35	104	408	1	69	0.0144928
NODE_300208_length_238_cov_385.683453	35	104	411	1	69	0.0144928
NODE_300208_length_238_cov_385.683453	35	104	412	1	69	0.0144928
NODE_300208_length_238_cov_385.683453	35	104	422	1	69	0.0144928
NODE_300208_length_238_cov_385.683453	35	104	425	1	69	0.0144928
NODE_300208_length_238_cov_385.683453	35	104	430	1	69	0.0144928
NODE_300208_length_238_cov_385.683453	35	104	439	1	69	0.0144928
NODE_300208_length_238_cov_385.683453	35	104	445	1	69	0.0144928
NODE_300208_length_238_cov_385.683453	35	104	452	1	69	0.0144928
NODE_300208_length_238_cov_385.683453	35	104	454	2	69	0.0289855
NODE_300208_length_238_cov_385.683453	35	104	456	1	69	0.0144928
NODE_300208_length_238_cov_385.683453	35	104	463	1	69	0.0144928
NODE_300208_length_238_cov_385.683453	35	104	465	1	69	0.0144928
NODE_300208_length_238_cov_385.683453	35	104	474	1	69	0.0144928
NODE_300208_length_238_cov_385.683453	35	104	476	2	69	0.0289855
NODE_300208_length_238_cov_385.683453	35	104	488	1	69	0.0144928
NODE_300208_length_238_cov_385.683453	35	104	491	1	69	0.0144928
NODE_300208_length_238_cov_385.683453	35	104	497	1	69	0.0144928
NODE_300208_length_238_cov_385.683453	35	104	506	1	69	0.0144928
NODE_300208_length_238_cov_385.683453	35	104	508	2	69	0.0289855
NODE_300208_length_238_cov_385.683453	35	104	509	1	69	0.0144928
NODE_300208_length_238_cov_385.683453	35	104	519	1	69	0.0144928
NODE_300208_length_238_cov_385.683453	35	104	523	1	69	0.0144928
NODE_300208_length_238_cov_385.683453	35	104	531	1	69	0.0144928
NODE_300225_length_237_cov_101.543478	83	163	8	9	80	0.1125000
NODE_300225_length_237_cov_101.543478	83	163	10	6	80	0.0750000
NODE_300225_length_237_cov_101.543478	83	163	12	6	80	0.0750000
NODE_300225_length_237_cov_101.543478	83	163	14	55	80	0.6875000
NODE_300225_length_237_cov_101.543478	83	163	16	4	80	0.0500000
NODE_300225_length_237_cov_101.543478	83	163	8	9	80	0.1125000
NODE_300225_length_237_cov_101.543478	83	163	10	6	80	0.0750000
NODE_300225_length_237_cov_101.543478	83	163	12	6	80	0.0750000
NODE_300225_length_237_cov_101.543478	83	163	14	55	80	0.6875000
NODE_300225_length_237_cov_101.543478	83	163	16	4	80	0.0500000
NODE_300225_length_237_cov_101.543478	83	163	8	9	80	0.1125000
NODE_300225_length_237_cov_101.543478	83	163	10	6	80	0.0750000
NODE_300225_length_237_cov_101.543478	83	163	12	6	80	0.0750000
NODE_300225_length_237_cov_101.543478	83	163	14	55	80	0.6875000
NODE_300225_length_237_cov_101.543478	83	163	16	4	80	0.0500000
NODE_300225_length_237_cov_101.543478	83	163	8	9	80	0.1125000
NODE_300225_length_237_cov_101.543478	83	163	10	6	80	0.0750000
NODE_300225_length_237_cov_101.543478	83	163	12	6	80	0.0750000
NODE_300225_length_237_cov_101.543478	83	163	14	55	80	0.6875000
NODE_300225_length_237_cov_101.543478	83	163	16	4	80	0.0500000
NODE_300225_length_237_cov_101.543478	136	216	6	18	80	0.2250000
NODE_300225_length_237_cov_101.543478	136	216	8	44	80	0.5500000
NODE_300225_length_237_cov_101.543478	136	216	14	18	80	0.2250000
NODE_300225_length_237_cov_101.543478	136	216	6	18	80	0.2250000
NODE_300225_length_237_cov_101.543478	136	216	8	44	80	0.5500000
NODE_300225_length_237_cov_101.543478	136	216	14	18	80	0.2250000
NODE_300225_length_237_cov_101.543478	136	216	6	18	80	0.2250000
NODE_300225_length_237_cov_101.543478	136	216	8	44	80	0.5500000
NODE_300225_length_237_cov_101.543478	136	216	14	18	80	0.2250000
NODE_300225_length_237_cov_101.543478	138	216	6	18	78	0.2307692
NODE_300225_length_237_cov_101.543478	138	216	8	44	78	0.5641026
NODE_300225_length_237_cov_101.543478	138	216	14	16	78	0.2051282
NODE_300225_length_237_cov_101.543478	138	216	6	18	78	0.2307692
NODE_300225_length_237_cov_101.543478	138	216	8	44	78	0.5641026
NODE_300225_length_237_cov_101.543478	138	216	14	16	78	0.2051282
NODE_300227_length_237_cov_49.623188	13	88	0	75	75	1.0000000
NODE_300227_length_237_cov_49.623188	73	153	0	80	80	1.0000000
NODE_300227_length_237_cov_49.623188	126	206	0	80	80	1.0000000
NODE_300289_length_235_cov_67.904412	0	62	0	27	62	0.4354839
NODE_300289_length_235_cov_67.904412	0	62	2	35	62	0.5645161
NODE_300289_length_235_cov_67.904412	25	111	0	2	86	0.0232558
NODE_300289_length_235_cov_67.904412	25	111	2	84	86	0.9767442
NODE_300289_length_235_cov_67.904412	69	150	0	35	81	0.4320988
NODE_300289_length_235_cov_67.904412	69	150	2	46	81	0.5679013
NODE_300289_length_235_cov_67.904412	113	194	0	79	81	0.9753087
NODE_300289_length_235_cov_67.904412	113	194	2	2	81	0.0246914
NODE_300289_length_235_cov_67.904412	157	235	0	78	78	1.0000000
NODE_300322_length_234_cov_76.496296	0	76	0	52	76	0.6842105
NODE_300322_length_234_cov_76.496296	0	76	2	24	76	0.3157895
NODE_300322_length_234_cov_76.496296	0	76	0	52	76	0.6842105
NODE_300322_length_234_cov_76.496296	0	76	2	24	76	0.3157895
NODE_300322_length_234_cov_76.496296	0	76	0	52	76	0.6842105
NODE_300322_length_234_cov_76.496296	0	76	2	24	76	0.3157895
NODE_300322_length_234_cov_76.496296	0	76	0	52	76	0.6842105
NODE_300322_length_234_cov_76.496296	0	76	2	24	76	0.3157895
NODE_300322_length_234_cov_76.496296	49	128	0	3	79	0.0379747
NODE_300322_length_234_cov_76.496296	49	128	2	32	79	0.4050633
NODE_300322_length_234_cov_76.496296	49	128	4	17	79	0.2151899
NODE_300322_length_234_cov_76.496296	49	128	8	1	79	0.0126582
NODE_300322_length_234_cov_76.496296	49	128	10	16	79	0.2025317
NODE_300322_length_234_cov_76.496296	49	128	12	10	79	0.1265823
NODE_300322_length_234_cov_76.496296	49	128	0	3	79	0.0379747
NODE_300322_length_234_cov_76.496296	49	128	2	32	79	0.4050633
NODE_300322_length_234_cov_76.496296	49	128	4	17	79	0.2151899
NODE_300322_length_234_cov_76.496296	49	128	8	1	79	0.0126582
NODE_300322_length_234_cov_76.496296	49	128	10	16	79	0.2025317
NODE_300322_length_234_cov_76.496296	49	128	12	10	79	0.1265823
NODE_300322_length_234_cov_76.496296	124	204	0	4	80	0.0500000
NODE_300322_length_234_cov_76.496296	124	204	2	2	80	0.0250000
NODE_300322_length_234_cov_76.496296	124	204	6	29	80	0.3625000
NODE_300322_length_234_cov_76.496296	124	204	8	1	80	0.0125000
NODE_300322_length_234_cov_76.496296	124	204	10	9	80	0.1125000
NODE_300322_length_234_cov_76.496296	124	204	12	35	80	0.4375000
NODE_300322_length_234_cov_76.496296	124	204	0	4	80	0.0500000
NODE_300322_length_234_cov_76.496296	124	204	2	2	80	0.0250000
NODE_300322_length_234_cov_76.496296	124	204	6	29	80	0.3625000
NODE_300322_length_234_cov_76.496296	124	204	8	1	80	0.0125000
NODE_300322_length_234_cov_76.496296	124	204	10	9	80	0.1125000
NODE_300322_length_234_cov_76.496296	124	204	12	35	80	0.4375000
NODE_300322_length_234_cov_76.496296	124	204	0	4	80	0.0500000
NODE_300322_length_234_cov_76.496296	124	204	2	2	80	0.0250000
NODE_300322_length_234_cov_76.496296	124	204	6	29	80	0.3625000
NODE_300322_length_234_cov_76.496296	124	204	8	1	80	0.0125000
NODE_300322_length_234_cov_76.496296	124	204	10	9	80	0.1125000
NODE_300322_length_234_cov_76.496296	124	204	12	35	80	0.4375000
NODE_300322_length_234_cov_76.496296	177	226	0	26	49	0.5306122
NODE_300322_length_234_cov_76.496296	177	226	2	2	49	0.0408163
NODE_300322_length_234_cov_76.496296	177	226	6	21	49	0.4285714
NODE_300322_length_234_cov_76.496296	177	234	0	34	57	0.5964912
NODE_300322_length_234_cov_76.496296	177	234	2	2	57	0.0350877
NODE_300322_length_234_cov_76.496296	177	234	6	21	57	0.3684210
NODE_300322_length_234_cov_76.496296	182	234	0	34	52	0.6538461
NODE_300322_length_234_cov_76.496296	182	234	2	2	52	0.0384615
NODE_300322_length_234_cov_76.496296	182	234	6	16	52	0.3076923
NODE_300323_length_234_cov_71.548148	90	162	0	25	72	0.3472222
NODE_300323_length_234_cov_71.548148	90	162	2	47	72	0.6527778
NODE_300323_length_234_cov_71.548148	90	162	0	25	72	0.3472222
NODE_300323_length_234_cov_71.548148	90	162	2	47	72	0.6527778
NODE_300323_length_234_cov_71.548148	135	215	0	78	80	0.9750000
NODE_300323_length_234_cov_71.548148	135	215	2	2	80	0.0250000
NODE_300323_length_234_cov_71.548148	135	215	0	78	80	0.9750000
NODE_300323_length_234_cov_71.548148	135	215	2	2	80	0.0250000
NODE_300357_length_233_cov_180.701493	0	65	0	61	65	0.9384615
NODE_300357_length_233_cov_180.701493	0	65	2	4	65	0.0615385
NODE_300357_length_233_cov_180.701493	38	118	0	23	80	0.2875000
NODE_300357_length_233_cov_180.701493	38	118	2	57	80	0.7125000
NODE_300392_length_232_cov_132.045113	53	133	0	44	80	0.5500000
NODE_300392_length_232_cov_132.045113	53	133	6	36	80	0.4500000
NODE_300392_length_232_cov_132.045113	106	186	4	45	80	0.5625000
NODE_300392_length_232_cov_132.045113	106	186	5	7	80	0.0875000
NODE_300392_length_232_cov_132.045113	106	186	6	28	80	0.3500000
NODE_300471_length_230_cov_34.427481	0	59	0	42	59	0.7118644
NODE_300471_length_230_cov_34.427481	0	59	2	17	59	0.2881356
NODE_300471_length_230_cov_34.427481	0	59	0	42	59	0.7118644
NODE_300471_length_230_cov_34.427481	0	59	2	17	59	0.2881356
NODE_300471_length_230_cov_34.427481	10	59	0	32	49	0.6530612
NODE_300471_length_230_cov_34.427481	10	59	2	17	49	0.3469388
NODE_300487_length_229_cov_76.907692	94	176	28	9	82	0.1097561
NODE_300487_length_229_cov_76.907692	94	176	30	1	82	0.0121951
NODE_300487_length_229_cov_76.907692	94	176	32	1	82	0.0121951
NODE_300487_length_229_cov_76.907692	94	176	34	2	82	0.0243902
NODE_300487_length_229_cov_76.907692	94	176	36	3	82	0.0365854
NODE_300487_length_229_cov_76.907692	94	176	38	3	82	0.0365854
NODE_300487_length_229_cov_76.907692	94	176	40	8	82	0.0975610
NODE_300487_length_229_cov_76.907692	94	176	42	13	82	0.1585366
NODE_300487_length_229_cov_76.907692	94	176	44	3	82	0.0365854
NODE_300487_length_229_cov_76.907692	94	176	46	3	82	0.0365854
NODE_300487_length_229_cov_76.907692	94	176	48	8	82	0.0975610
NODE_300487_length_229_cov_76.907692	94	176	50	3	82	0.0365854
NODE_300487_length_229_cov_76.907692	94	176	52	5	82	0.0609756
NODE_300487_length_229_cov_76.907692	94	176	56	4	82	0.0487805
NODE_300487_length_229_cov_76.907692	94	176	58	5	82	0.0609756
NODE_300487_length_229_cov_76.907692	94	176	60	11	82	0.1341463
NODE_300523_length_228_cov_127.131783	0	76	11	15	76	0.1973684
NODE_300523_length_228_cov_127.131783	0	76	13	42	76	0.5526316
NODE_300523_length_228_cov_127.131783	0	76	15	9	76	0.1184211
NODE_300523_length_228_cov_127.131783	0	76	23	9	76	0.1184211
NODE_300523_length_228_cov_127.131783	0	76	25	1	76	0.0131579
NODE_300523_length_228_cov_127.131783	5	76	11	10	71	0.1408451
NODE_300523_length_228_cov_127.131783	5	76	13	42	71	0.5915493
NODE_300523_length_228_cov_127.131783	5	76	15	9	71	0.1267606
NODE_300523_length_228_cov_127.131783	5	76	23	9	71	0.1267606
NODE_300523_length_228_cov_127.131783	5	76	25	1	71	0.0140845
NODE_300523_length_228_cov_127.131783	10	76	11	5	66	0.0757576
NODE_300523_length_228_cov_127.131783	10	76	13	42	66	0.6363636
NODE_300523_length_228_cov_127.131783	10	76	15	9	66	0.1363636
NODE_300523_length_228_cov_127.131783	10	76	23	9	66	0.1363636
NODE_300523_length_228_cov_127.131783	10	76	25	1	66	0.0151515
NODE_300523_length_228_cov_127.131783	49	129	13	8	80	0.1000000
NODE_300523_length_228_cov_127.131783	49	129	15	9	80	0.1125000
NODE_300523_length_228_cov_127.131783	49	129	23	9	80	0.1125000
NODE_300523_length_228_cov_127.131783	49	129	24	13	80	0.1625000
NODE_300523_length_228_cov_127.131783	49	129	25	6	80	0.0750000
NODE_300523_length_228_cov_127.131783	49	129	26	19	80	0.2375000
NODE_300523_length_228_cov_127.131783	49	129	27	16	80	0.2000000
NODE_300523_length_228_cov_127.131783	49	129	13	8	80	0.1000000
NODE_300523_length_228_cov_127.131783	49	129	15	9	80	0.1125000
NODE_300523_length_228_cov_127.131783	49	129	23	9	80	0.1125000
NODE_300523_length_228_cov_127.131783	49	129	24	13	80	0.1625000
NODE_300523_length_228_cov_127.131783	49	129	25	6	80	0.0750000
NODE_300523_length_228_cov_127.131783	49	129	26	19	80	0.2375000
NODE_300523_length_228_cov_127.131783	49	129	27	16	80	0.2000000
NODE_300523_length_228_cov_127.131783	49	129	13	8	80	0.1000000
NODE_300523_length_228_cov_127.131783	49	129	15	9	80	0.1125000
NODE_300523_length_228_cov_127.131783	49	129	23	9	80	0.1125000
NODE_300523_length_228_cov_127.131783	49	129	24	13	80	0.1625000
NODE_300523_length_228_cov_127.131783	49	129	25	6	80	0.0750000
NODE_300523_length_228_cov_127.131783	49	129	26	19	80	0.2375000
NODE_300523_length_228_cov_127.131783	49	129	27	16	80	0.2000000
NODE_300523_length_228_cov_127.131783	125	205	0	3	80	0.0375000
NODE_300523_length_228_cov_127.131783	125	205	2	11	80	0.1375000
NODE_300523_length_228_cov_127.131783	125	205	10	18	80	0.2250000
NODE_300523_length_228_cov_127.131783	125	205	12	16	80	0.2000000
NODE_300523_length_228_cov_127.131783	125	205	14	9	80	0.1125000
NODE_300523_length_228_cov_127.131783	125	205	16	5	80	0.0625000
NODE_300523_length_228_cov_127.131783	125	205	26	18	80	0.2250000
NODE_300523_length_228_cov_127.131783	125	205	0	3	80	0.0375000
NODE_300523_length_228_cov_127.131783	125	205	2	11	80	0.1375000
NODE_300523_length_228_cov_127.131783	125	205	10	18	80	0.2250000
NODE_300523_length_228_cov_127.131783	125	205	12	16	80	0.2000000
NODE_300523_length_228_cov_127.131783	125	205	14	9	80	0.1125000
NODE_300523_length_228_cov_127.131783	125	205	16	5	80	0.0625000
NODE_300523_length_228_cov_127.131783	125	205	26	18	80	0.2250000
NODE_300523_length_228_cov_127.131783	125	205	0	3	80	0.0375000
NODE_300523_length_228_cov_127.131783	125	205	2	11	80	0.1375000
NODE_300523_length_228_cov_127.131783	125	205	10	18	80	0.2250000
NODE_300523_length_228_cov_127.131783	125	205	12	16	80	0.2000000
NODE_300523_length_228_cov_127.131783	125	205	14	9	80	0.1125000
NODE_300523_length_228_cov_127.131783	125	205	16	5	80	0.0625000
NODE_300523_length_228_cov_127.131783	125	205	26	18	80	0.2250000
NODE_300523_length_228_cov_127.131783	178	228	0	26	50	0.5200000
NODE_300523_length_228_cov_127.131783	178	228	2	11	50	0.2200000
NODE_300523_length_228_cov_127.131783	178	228	10	13	50	0.2600000
NODE_300523_length_228_cov_127.131783	178	228	0	26	50	0.5200000
NODE_300523_length_228_cov_127.131783	178	228	2	11	50	0.2200000
NODE_300523_length_228_cov_127.131783	178	228	10	13	50	0.2600000
NODE_300523_length_228_cov_127.131783	178	228	0	26	50	0.5200000
NODE_300523_length_228_cov_127.131783	178	228	2	11	50	0.2200000
NODE_300523_length_228_cov_127.131783	178	228	10	13	50	0.2600000
NODE_300524_length_228_cov_94.255814	34	99	2	65	65	1.0000000
NODE_300524_length_228_cov_94.255814	34	114	2	67	80	0.8375000
NODE_300524_length_228_cov_94.255814	34	114	7	1	80	0.0125000
NODE_300524_length_228_cov_94.255814	34	114	8	11	80	0.1375000
NODE_300524_length_228_cov_94.255814	34	114	10	1	80	0.0125000
NODE_300524_length_228_cov_94.255814	41	111	2	60	70	0.8571429
NODE_300524_length_228_cov_94.255814	41	111	7	1	70	0.0142857
NODE_300524_length_228_cov_94.255814	41	111	8	9	70	0.1285714
NODE_300524_length_228_cov_94.255814	43	114	2	58	71	0.8169014
NODE_300524_length_228_cov_94.255814	43	114	7	1	71	0.0140845
NODE_300524_length_228_cov_94.255814	43	114	8	11	71	0.1549296
NODE_300524_length_228_cov_94.255814	43	114	10	1	71	0.0140845
NODE_300524_length_228_cov_94.255814	87	167	2	14	80	0.1750000
NODE_300524_length_228_cov_94.255814	87	167	7	1	80	0.0125000
NODE_300524_length_228_cov_94.255814	87	167	8	26	80	0.3250000
NODE_300524_length_228_cov_94.255814	87	167	10	39	80	0.4875000
NODE_300524_length_228_cov_94.255814	87	167	2	14	80	0.1750000
NODE_300524_length_228_cov_94.255814	87	167	7	1	80	0.0125000
NODE_300524_length_228_cov_94.255814	87	167	8	26	80	0.3250000
NODE_300524_length_228_cov_94.255814	87	167	10	39	80	0.4875000
NODE_300524_length_228_cov_94.255814	87	167	2	14	80	0.1750000
NODE_300524_length_228_cov_94.255814	87	167	7	1	80	0.0125000
NODE_300524_length_228_cov_94.255814	87	167	8	26	80	0.3250000
NODE_300524_length_228_cov_94.255814	87	167	10	39	80	0.4875000
NODE_300524_length_228_cov_94.255814	87	167	2	14	80	0.1750000
NODE_300524_length_228_cov_94.255814	87	167	7	1	80	0.0125000
NODE_300524_length_228_cov_94.255814	87	167	8	26	80	0.3250000
NODE_300524_length_228_cov_94.255814	87	167	10	39	80	0.4875000
NODE_300547_length_228_cov_0.395349	27	107	0	80	80	1.0000000
NODE_300547_length_228_cov_0.395349	70	150	0	80	80	1.0000000
NODE_300556_length_227_cov_37.429688	40	111	19	13	71	0.1830986
NODE_300556_length_227_cov_37.429688	40	111	21	9	71	0.1267606
NODE_300556_length_227_cov_37.429688	40	111	23	6	71	0.0845070
NODE_300556_length_227_cov_37.429688	40	111	25	23	71	0.3239437
NODE_300556_length_227_cov_37.429688	40	111	27	20	71	0.2816902
NODE_300556_length_227_cov_37.429688	49	112	19	4	63	0.0634921
NODE_300556_length_227_cov_37.429688	49	112	21	9	63	0.1428571
NODE_300556_length_227_cov_37.429688	49	112	23	6	63	0.0952381
NODE_300556_length_227_cov_37.429688	49	112	25	23	63	0.3650794
NODE_300556_length_227_cov_37.429688	49	112	27	21	63	0.3333333
NODE_300556_length_227_cov_37.429688	93	172	2	12	79	0.1518987
NODE_300556_length_227_cov_37.429688	93	172	12	1	79	0.0126582
NODE_300556_length_227_cov_37.429688	93	172	17	3	79	0.0379747
NODE_300556_length_227_cov_37.429688	93	172	19	10	79	0.1265823
NODE_300556_length_227_cov_37.429688	93	172	21	10	79	0.1265823
NODE_300556_length_227_cov_37.429688	93	172	25	1	79	0.0126582
NODE_300556_length_227_cov_37.429688	93	172	27	42	79	0.5316456
NODE_300556_length_227_cov_37.429688	168	227	2	59	59	1.0000000
NODE_300556_length_227_cov_37.429688	168	227	2	59	59	1.0000000
NODE_300595_length_226_cov_547.629921	82	162	668	1	80	0.0125000
NODE_300595_length_226_cov_547.629921	82	162	698	1	80	0.0125000
NODE_300595_length_226_cov_547.629921	82	162	704	1	80	0.0125000
NODE_300595_length_226_cov_547.629921	82	162	711	1	80	0.0125000
NODE_300595_length_226_cov_547.629921	82	162	737	1	80	0.0125000
NODE_300595_length_226_cov_547.629921	82	162	740	1	80	0.0125000
NODE_300595_length_226_cov_547.629921	82	162	745	1	80	0.0125000
NODE_300595_length_226_cov_547.629921	82	162	751	1	80	0.0125000
NODE_300595_length_226_cov_547.629921	82	162	756	1	80	0.0125000
NODE_300595_length_226_cov_547.629921	82	162	761	1	80	0.0125000
NODE_300595_length_226_cov_547.629921	82	162	767	1	80	0.0125000
NODE_300595_length_226_cov_547.629921	82	162	773	1	80	0.0125000
NODE_300595_length_226_cov_547.629921	82	162	779	2	80	0.0250000
NODE_300595_length_226_cov_547.629921	82	162	781	1	80	0.0125000
NODE_300595_length_226_cov_547.629921	82	162	785	1	80	0.0125000
NODE_300595_length_226_cov_547.629921	82	162	786	1	80	0.0125000
NODE_300595_length_226_cov_547.629921	82	162	789	1	80	0.0125000
NODE_300595_length_226_cov_547.629921	82	162	791	2	80	0.0250000
NODE_300595_length_226_cov_547.629921	82	162	795	1	80	0.0125000
NODE_300595_length_226_cov_547.629921	82	162	798	1	80	0.0125000
NODE_300595_length_226_cov_547.629921	82	162	803	1	80	0.0125000
NODE_300595_length_226_cov_547.629921	82	162	808	1	80	0.0125000
NODE_300595_length_226_cov_547.629921	82	162	809	1	80	0.0125000
NODE_300595_length_226_cov_547.629921	82	162	810	1	80	0.0125000
NODE_300595_length_226_cov_547.629921	82	162	815	1	80	0.0125000
NODE_300595_length_226_cov_547.629921	82	162	819	1	80	0.0125000
NODE_300595_length_226_cov_547.629921	82	162	825	1	80	0.0125000
NODE_300595_length_226_cov_547.629921	82	162	830	1	80	0.0125000
NODE_300595_length_226_cov_547.629921	82	162	837	1	80	0.0125000
NODE_300595_length_226_cov_547.629921	82	162	842	1	80	0.0125000
NODE_300595_length_226_cov_547.629921	82	162	849	1	80	0.0125000
NODE_300595_length_226_cov_547.629921	82	162	851	2	80	0.0250000
NODE_300595_length_226_cov_547.629921	82	162	856	1	80	0.0125000
NODE_300595_length_226_cov_547.629921	82	162	861	1	80	0.0125000
NODE_300595_length_226_cov_547.629921	82	162	863	1	80	0.0125000
NODE_300595_length_226_cov_547.629921	82	162	866	1	80	0.0125000
NODE_300595_length_226_cov_547.629921	82	162	869	1	80	0.0125000
NODE_300595_length_226_cov_547.629921	82	162	875	1	80	0.0125000
NODE_300595_length_226_cov_547.629921	82	162	876	4	80	0.0500000
NODE_300595_length_226_cov_547.629921	82	162	880	1	80	0.0125000
NODE_300595_length_226_cov_547.629921	82	162	884	1	80	0.0125000
NODE_300595_length_226_cov_547.629921	82	162	885	1	80	0.0125000
NODE_300595_length_226_cov_547.629921	82	162	888	1	80	0.0125000
NODE_300595_length_226_cov_547.629921	82	162	891	1	80	0.0125000
NODE_300595_length_226_cov_547.629921	82	162	892	1	80	0.0125000
NODE_300595_length_226_cov_547.629921	82	162	894	1	80	0.0125000
NODE_300595_length_226_cov_547.629921	82	162	895	3	80	0.0375000
NODE_300595_length_226_cov_547.629921	82	162	900	2	80	0.0250000
NODE_300595_length_226_cov_547.629921	82	162	902	1	80	0.0125000
NODE_300595_length_226_cov_547.629921	82	162	905	1	80	0.0125000
NODE_300595_length_226_cov_547.629921	82	162	906	1	80	0.0125000
NODE_300595_length_226_cov_547.629921	82	162	909	1	80	0.0125000
NODE_300595_length_226_cov_547.629921	82	162	911	1	80	0.0125000
NODE_300595_length_226_cov_547.629921	82	162	915	1	80	0.0125000
NODE_300595_length_226_cov_547.629921	82	162	917	1	80	0.0125000
NODE_300595_length_226_cov_547.629921	82	162	918	2	80	0.0250000
NODE_300595_length_226_cov_547.629921	82	162	919	1	80	0.0125000
NODE_300595_length_226_cov_547.629921	82	162	921	1	80	0.0125000
NODE_300595_length_226_cov_547.629921	82	162	925	2	80	0.0250000
NODE_300595_length_226_cov_547.629921	82	162	927	1	80	0.0125000
NODE_300595_length_226_cov_547.629921	82	162	929	1	80	0.0125000
NODE_300595_length_226_cov_547.629921	82	162	933	1	80	0.0125000
NODE_300595_length_226_cov_547.629921	82	162	934	1	80	0.0125000
NODE_300595_length_226_cov_547.629921	82	162	935	1	80	0.0125000
NODE_300595_length_226_cov_547.629921	82	162	940	2	80	0.0250000
NODE_300595_length_226_cov_547.629921	82	162	943	2	80	0.0250000
NODE_300595_length_226_cov_547.629921	82	162	944	1	80	0.0125000
NODE_300617_length_225_cov_41.269841	81	165	17	1	84	0.0119048
NODE_300617_length_225_cov_41.269841	81	165	19	3	84	0.0357143
NODE_300617_length_225_cov_41.269841	81	165	21	4	84	0.0476190
NODE_300617_length_225_cov_41.269841	81	165	25	3	84	0.0357143
NODE_300617_length_225_cov_41.269841	81	165	31	8	84	0.0952381
NODE_300617_length_225_cov_41.269841	81	165	35	2	84	0.0238095
NODE_300617_length_225_cov_41.269841	81	165	38	2	84	0.0238095
NODE_300617_length_225_cov_41.269841	81	165	42	3	84	0.0357143
NODE_300617_length_225_cov_41.269841	81	165	43	2	84	0.0238095
NODE_300617_length_225_cov_41.269841	81	165	44	4	84	0.0476190
NODE_300617_length_225_cov_41.269841	81	165	45	1	84	0.0119048
NODE_300617_length_225_cov_41.269841	81	165	46	5	84	0.0595238
NODE_300617_length_225_cov_41.269841	81	165	48	10	84	0.1190476
NODE_300617_length_225_cov_41.269841	81	165	50	15	84	0.1785714
NODE_300617_length_225_cov_41.269841	81	165	52	7	84	0.0833333
NODE_300617_length_225_cov_41.269841	81	165	53	1	84	0.0119048
NODE_300617_length_225_cov_41.269841	81	165	54	13	84	0.1547619
NODE_300617_length_225_cov_41.269841	134	218	0	5	84	0.0595238
NODE_300617_length_225_cov_41.269841	134	218	2	14	84	0.1666667
NODE_300617_length_225_cov_41.269841	134	218	6	2	84	0.0238095
NODE_300617_length_225_cov_41.269841	134	218	8	4	84	0.0476190
NODE_300617_length_225_cov_41.269841	134	218	10	6	84	0.0714286
NODE_300617_length_225_cov_41.269841	134	218	12	4	84	0.0476190
NODE_300617_length_225_cov_41.269841	134	218	14	6	84	0.0714286
NODE_300617_length_225_cov_41.269841	134	218	16	9	84	0.1071429
NODE_300617_length_225_cov_41.269841	134	218	17	4	84	0.0476190
NODE_300617_length_225_cov_41.269841	134	218	19	3	84	0.0357143
NODE_300617_length_225_cov_41.269841	134	218	21	4	84	0.0476190
NODE_300617_length_225_cov_41.269841	134	218	25	3	84	0.0357143
NODE_300617_length_225_cov_41.269841	134	218	31	8	84	0.0952381
NODE_300617_length_225_cov_41.269841	134	218	35	2	84	0.0238095
NODE_300617_length_225_cov_41.269841	134	218	38	2	84	0.0238095
NODE_300617_length_225_cov_41.269841	134	218	42	3	84	0.0357143
NODE_300617_length_225_cov_41.269841	134	218	43	2	84	0.0238095
NODE_300617_length_225_cov_41.269841	134	218	45	1	84	0.0119048
NODE_300617_length_225_cov_41.269841	134	218	46	2	84	0.0238095
NODE_300661_length_224_cov_209.528000	12	84	18	5	72	0.0694444
NODE_300661_length_224_cov_209.528000	12	84	20	3	72	0.0416667
NODE_300661_length_224_cov_209.528000	12	84	22	1	72	0.0138889
NODE_300661_length_224_cov_209.528000	12	84	26	2	72	0.0277778
NODE_300661_length_224_cov_209.528000	12	84	28	11	72	0.1527778
NODE_300661_length_224_cov_209.528000	12	84	30	6	72	0.0833333
NODE_300661_length_224_cov_209.528000	12	84	32	1	72	0.0138889
NODE_300661_length_224_cov_209.528000	12	84	34	5	72	0.0694444
NODE_300661_length_224_cov_209.528000	12	84	36	7	72	0.0972222
NODE_300661_length_224_cov_209.528000	12	84	40	4	72	0.0555556
NODE_300661_length_224_cov_209.528000	12	84	42	1	72	0.0138889
NODE_300661_length_224_cov_209.528000	12	84	44	10	72	0.1388889
NODE_300661_length_224_cov_209.528000	12	84	46	5	72	0.0694444
NODE_300661_length_224_cov_209.528000	12	84	48	11	72	0.1527778
NODE_300663_length_224_cov_146.568000	13	72	6	7	59	0.1186441
NODE_300663_length_224_cov_146.568000	13	72	8	3	59	0.0508475
NODE_300663_length_224_cov_146.568000	13	72	10	7	59	0.1186441
NODE_300663_length_224_cov_146.568000	13	72	12	7	59	0.1186441
NODE_300663_length_224_cov_146.568000	13	72	16	3	59	0.0508475
NODE_300663_length_224_cov_146.568000	13	72	18	6	59	0.1016949
NODE_300663_length_224_cov_146.568000	13	72	22	2	59	0.0338983
NODE_300663_length_224_cov_146.568000	13	72	23	12	59	0.2033898
NODE_300663_length_224_cov_146.568000	13	72	25	4	59	0.0677966
NODE_300663_length_224_cov_146.568000	13	72	28	2	59	0.0338983
NODE_300663_length_224_cov_146.568000	13	72	30	4	59	0.0677966
NODE_300663_length_224_cov_146.568000	13	72	32	2	59	0.0338983
NODE_300663_length_224_cov_146.568000	46	72	22	2	26	0.0769231
NODE_300663_length_224_cov_146.568000	46	72	23	12	26	0.4615385
NODE_300663_length_224_cov_146.568000	46	72	25	4	26	0.1538462
NODE_300663_length_224_cov_146.568000	46	72	28	2	26	0.0769231
NODE_300663_length_224_cov_146.568000	46	72	30	4	26	0.1538462
NODE_300663_length_224_cov_146.568000	46	72	32	2	26	0.0769231
NODE_300663_length_224_cov_146.568000	68	120	30	2	52	0.0384615
NODE_300663_length_224_cov_146.568000	68	120	32	2	52	0.0384615
NODE_300663_length_224_cov_146.568000	68	120	36	2	52	0.0384615
NODE_300663_length_224_cov_146.568000	68	120	40	5	52	0.0961538
NODE_300663_length_224_cov_146.568000	68	120	42	1	52	0.0192308
NODE_300663_length_224_cov_146.568000	68	120	44	1	52	0.0192308
NODE_300663_length_224_cov_146.568000	68	120	46	1	52	0.0192308
NODE_300663_length_224_cov_146.568000	68	120	48	9	52	0.1730769
NODE_300663_length_224_cov_146.568000	68	120	50	1	52	0.0192308
NODE_300663_length_224_cov_146.568000	68	120	54	2	52	0.0384615
NODE_300663_length_224_cov_146.568000	68	120	56	1	52	0.0192308
NODE_300663_length_224_cov_146.568000	68	120	61	4	52	0.0769231
NODE_300663_length_224_cov_146.568000	68	120	63	1	52	0.0192308
NODE_300663_length_224_cov_146.568000	68	120	65	4	52	0.0769231
NODE_300663_length_224_cov_146.568000	68	120	67	3	52	0.0576923
NODE_300663_length_224_cov_146.568000	68	120	69	6	52	0.1153846
NODE_300663_length_224_cov_146.568000	68	120	71	4	52	0.0769231
NODE_300663_length_224_cov_146.568000	68	120	73	3	52	0.0576923
NODE_300665_length_224_cov_59.088000	98	178	15	8	80	0.1000000
NODE_300665_length_224_cov_59.088000	98	178	17	2	80	0.0250000
NODE_300665_length_224_cov_59.088000	98	178	18	12	80	0.1500000
NODE_300665_length_224_cov_59.088000	98	178	20	34	80	0.4250000
NODE_300665_length_224_cov_59.088000	98	178	21	24	80	0.3000000
NODE_300665_length_224_cov_59.088000	98	178	15	8	80	0.1000000
NODE_300665_length_224_cov_59.088000	98	178	17	2	80	0.0250000
NODE_300665_length_224_cov_59.088000	98	178	18	12	80	0.1500000
NODE_300665_length_224_cov_59.088000	98	178	20	34	80	0.4250000
NODE_300665_length_224_cov_59.088000	98	178	21	24	80	0.3000000
NODE_300665_length_224_cov_59.088000	98	178	15	8	80	0.1000000
NODE_300665_length_224_cov_59.088000	98	178	17	2	80	0.0250000
NODE_300665_length_224_cov_59.088000	98	178	18	12	80	0.1500000
NODE_300665_length_224_cov_59.088000	98	178	20	34	80	0.4250000
NODE_300665_length_224_cov_59.088000	98	178	21	24	80	0.3000000
NODE_300665_length_224_cov_59.088000	151	217	7	24	66	0.3636364
NODE_300665_length_224_cov_59.088000	151	217	9	10	66	0.1515152
NODE_300665_length_224_cov_59.088000	151	217	11	1	66	0.0151515
NODE_300665_length_224_cov_59.088000	151	217	15	12	66	0.1818182
NODE_300665_length_224_cov_59.088000	151	217	17	2	66	0.0303030
NODE_300665_length_224_cov_59.088000	151	217	18	12	66	0.1818182
NODE_300665_length_224_cov_59.088000	151	217	20	5	66	0.0757576
NODE_300665_length_224_cov_59.088000	151	224	0	1	73	0.0136986
NODE_300665_length_224_cov_59.088000	151	224	7	30	73	0.4109589
NODE_300665_length_224_cov_59.088000	151	224	9	10	73	0.1369863
NODE_300665_length_224_cov_59.088000	151	224	11	1	73	0.0136986
NODE_300665_length_224_cov_59.088000	151	224	15	12	73	0.1643836
NODE_300665_length_224_cov_59.088000	151	224	17	2	73	0.0273973
NODE_300665_length_224_cov_59.088000	151	224	18	12	73	0.1643836
NODE_300665_length_224_cov_59.088000	151	224	20	5	73	0.0684932
NODE_300667_length_224_cov_43.640000	98	157	2	59	59	1.0000000
NODE_300667_length_224_cov_43.640000	98	157	2	59	59	1.0000000
NODE_300667_length_224_cov_43.640000	106	157	2	51	51	1.0000000
NODE_300669_length_224_cov_36.224000	100	171	14	21	71	0.2957746
NODE_300669_length_224_cov_36.224000	100	171	16	50	71	0.7042254
NODE_300669_length_224_cov_36.224000	151	224	0	1	73	0.0136986
NODE_300669_length_224_cov_36.224000	151	224	1	1	73	0.0136986
NODE_300669_length_224_cov_36.224000	151	224	3	5	73	0.0684932
NODE_300669_length_224_cov_36.224000	151	224	5	2	73	0.0273973
NODE_300669_length_224_cov_36.224000	151	224	9	4	73	0.0547945
NODE_300669_length_224_cov_36.224000	151	224	11	6	73	0.0821918
NODE_300669_length_224_cov_36.224000	151	224	12	1	73	0.0136986
NODE_300669_length_224_cov_36.224000	151	224	14	3	73	0.0410959
NODE_300669_length_224_cov_36.224000	151	224	15	29	73	0.3972603
NODE_300669_length_224_cov_36.224000	151	224	16	21	73	0.2876712
NODE_300696_length_223_cov_35.814516	0	54	4	2	54	0.0370370
NODE_300696_length_223_cov_35.814516	0	54	6	10	54	0.1851852
NODE_300696_length_223_cov_35.814516	0	54	8	33	54	0.6111111
NODE_300696_length_223_cov_35.814516	0	54	10	9	54	0.1666667
NODE_300696_length_223_cov_35.814516	30	107	8	15	77	0.1948052
NODE_300696_length_223_cov_35.814516	30	107	10	10	77	0.1298701
NODE_300696_length_223_cov_35.814516	30	107	12	52	77	0.6753247
NODE_300768_length_221_cov_71.319672	14	94	56	2	80	0.0250000
NODE_300768_length_221_cov_71.319672	14	94	59	2	80	0.0250000
NODE_300768_length_221_cov_71.319672	14	94	61	2	80	0.0250000
NODE_300768_length_221_cov_71.319672	14	94	63	1	80	0.0125000
NODE_300768_length_221_cov_71.319672	14	94	65	1	80	0.0125000
NODE_300768_length_221_cov_71.319672	14	94	69	1	80	0.0125000
NODE_300768_length_221_cov_71.319672	14	94	73	1	80	0.0125000
NODE_300768_length_221_cov_71.319672	14	94	74	2	80	0.0250000
NODE_300768_length_221_cov_71.319672	14	94	78	3	80	0.0375000
NODE_300768_length_221_cov_71.319672	14	94	92	1	80	0.0125000
NODE_300768_length_221_cov_71.319672	14	94	93	1	80	0.0125000
NODE_300768_length_221_cov_71.319672	14	94	95	2	80	0.0250000
NODE_300768_length_221_cov_71.319672	14	94	100	4	80	0.0500000
NODE_300768_length_221_cov_71.319672	14	94	109	3	80	0.0375000
NODE_300768_length_221_cov_71.319672	14	94	110	1	80	0.0125000
NODE_300768_length_221_cov_71.319672	14	94	111	1	80	0.0125000
NODE_300768_length_221_cov_71.319672	14	94	116	1	80	0.0125000
NODE_300768_length_221_cov_71.319672	14	94	118	2	80	0.0250000
NODE_300768_length_221_cov_71.319672	14	94	119	2	80	0.0250000
NODE_300768_length_221_cov_71.319672	14	94	124	7	80	0.0875000
NODE_300768_length_221_cov_71.319672	14	94	128	5	80	0.0625000
NODE_300768_length_221_cov_71.319672	14	94	131	3	80	0.0375000
NODE_300768_length_221_cov_71.319672	14	94	133	3	80	0.0375000
NODE_300768_length_221_cov_71.319672	14	94	135	2	80	0.0250000
NODE_300768_length_221_cov_71.319672	14	94	139	27	80	0.3375000
NODE_300800_length_220_cov_42.206612	3	74	0	8	71	0.1126761
NODE_300800_length_220_cov_42.206612	3	74	3	10	71	0.1408451
NODE_300800_length_220_cov_42.206612	3	74	5	21	71	0.2957746
NODE_300800_length_220_cov_42.206612	3	74	9	8	71	0.1126761
NODE_300800_length_220_cov_42.206612	3	74	12	5	71	0.0704225
NODE_300800_length_220_cov_42.206612	3	74	14	19	71	0.2676056
NODE_300800_length_220_cov_42.206612	8	74	0	3	66	0.0454545
NODE_300800_length_220_cov_42.206612	8	74	3	10	66	0.1515152
NODE_300800_length_220_cov_42.206612	8	74	5	21	66	0.3181818
NODE_300800_length_220_cov_42.206612	8	74	9	8	66	0.1212121
NODE_300800_length_220_cov_42.206612	8	74	12	5	66	0.0757576
NODE_300800_length_220_cov_42.206612	8	74	14	19	66	0.2878788
NODE_300800_length_220_cov_42.206612	47	98	9	3	51	0.0588235
NODE_300800_length_220_cov_42.206612	47	98	12	5	51	0.0980392
NODE_300800_length_220_cov_42.206612	47	98	14	43	51	0.8431373
NODE_300800_length_220_cov_42.206612	47	98	9	3	51	0.0588235
NODE_300800_length_220_cov_42.206612	47	98	12	5	51	0.0980392
NODE_300800_length_220_cov_42.206612	47	98	14	43	51	0.8431373
NODE_300800_length_220_cov_42.206612	47	98	9	3	51	0.0588235
NODE_300800_length_220_cov_42.206612	47	98	12	5	51	0.0980392
NODE_300800_length_220_cov_42.206612	47	98	14	43	51	0.8431373
NODE_300874_length_218_cov_244.773109	128	203	17	3	75	0.0400000
NODE_300874_length_218_cov_244.773109	128	203	19	1	75	0.0133333
NODE_300874_length_218_cov_244.773109	128	203	21	17	75	0.2266667
NODE_300874_length_218_cov_244.773109	128	203	23	6	75	0.0800000
NODE_300874_length_218_cov_244.773109	128	203	25	4	75	0.0533333
NODE_300874_length_218_cov_244.773109	128	203	29	5	75	0.0666667
NODE_300874_length_218_cov_244.773109	128	203	31	1	75	0.0133333
NODE_300874_length_218_cov_244.773109	128	203	33	2	75	0.0266667
NODE_300874_length_218_cov_244.773109	128	203	35	3	75	0.0400000
NODE_300874_length_218_cov_244.773109	128	203	39	1	75	0.0133333
NODE_300874_length_218_cov_244.773109	128	203	41	14	75	0.1866667
NODE_300874_length_218_cov_244.773109	128	203	43	4	75	0.0533333
NODE_300874_length_218_cov_244.773109	128	203	45	2	75	0.0266667
NODE_300874_length_218_cov_244.773109	128	203	47	2	75	0.0266667
NODE_300874_length_218_cov_244.773109	128	203	48	3	75	0.0400000
NODE_300874_length_218_cov_244.773109	128	203	50	7	75	0.0933333
NODE_300874_length_218_cov_244.773109	176	218	17	18	42	0.4285714
NODE_300874_length_218_cov_244.773109	176	218	19	1	42	0.0238095
NODE_300874_length_218_cov_244.773109	176	218	21	17	42	0.4047619
NODE_300874_length_218_cov_244.773109	176	218	23	6	42	0.1428571
NODE_300915_length_217_cov_2.144068	14	49	4	35	35	1.0000000
NODE_300915_length_217_cov_2.144068	132	167	0	27	35	0.7714286
NODE_300915_length_217_cov_2.144068	132	167	3	1	35	0.0285714
NODE_300915_length_217_cov_2.144068	132	167	4	7	35	0.2000000
NODE_300924_length_216_cov_215.410256	0	63	0	13	63	0.2063492
NODE_300924_length_216_cov_215.410256	0	63	2	3	63	0.0476190
NODE_300924_length_216_cov_215.410256	0	63	6	10	63	0.1587302
NODE_300924_length_216_cov_215.410256	0	63	8	3	63	0.0476190
NODE_300924_length_216_cov_215.410256	0	63	10	4	63	0.0634921
NODE_300924_length_216_cov_215.410256	0	63	12	6	63	0.0952381
NODE_300924_length_216_cov_215.410256	0	63	14	24	63	0.3809524
NODE_300924_length_216_cov_215.410256	36	102	12	3	66	0.0454545
NODE_300924_length_216_cov_215.410256	36	102	14	25	66	0.3787879
NODE_300924_length_216_cov_215.410256	36	102	16	25	66	0.3787879
NODE_300924_length_216_cov_215.410256	36	102	18	8	66	0.1212121
NODE_300924_length_216_cov_215.410256	36	102	20	5	66	0.0757576
NODE_300925_length_216_cov_51.940171	164	216	0	52	52	1.0000000
NODE_300953_length_215_cov_14.784483	0	50	0	50	50	1.0000000
NODE_300953_length_215_cov_14.784483	23	103	0	80	80	1.0000000
NODE_300984_length_214_cov_144.165217	0	62	0	2	62	0.0322581
NODE_300984_length_214_cov_144.165217	0	62	2	5	62	0.0806452
NODE_300984_length_214_cov_144.165217	0	62	4	7	62	0.1129032
NODE_300984_length_214_cov_144.165217	0	62	6	5	62	0.0806452
NODE_300984_length_214_cov_144.165217	0	62	10	26	62	0.4193548
NODE_300984_length_214_cov_144.165217	0	62	12	17	62	0.2741936
NODE_300984_length_214_cov_144.165217	0	62	0	2	62	0.0322581
NODE_300984_length_214_cov_144.165217	0	62	2	5	62	0.0806452
NODE_300984_length_214_cov_144.165217	0	62	4	7	62	0.1129032
NODE_300984_length_214_cov_144.165217	0	62	6	5	62	0.0806452
NODE_300984_length_214_cov_144.165217	0	62	10	26	62	0.4193548
NODE_300984_length_214_cov_144.165217	0	62	12	17	62	0.2741936
NODE_300984_length_214_cov_144.165217	35	115	10	10	80	0.1250000
NODE_300984_length_214_cov_144.165217	35	115	12	29	80	0.3625000
NODE_300984_length_214_cov_144.165217	35	115	18	10	80	0.1250000
NODE_300984_length_214_cov_144.165217	35	115	20	31	80	0.3875000
NODE_300984_length_214_cov_144.165217	35	115	10	10	80	0.1250000
NODE_300984_length_214_cov_144.165217	35	115	12	29	80	0.3625000
NODE_300984_length_214_cov_144.165217	35	115	18	10	80	0.1250000
NODE_300984_length_214_cov_144.165217	35	115	20	31	80	0.3875000
NODE_300984_length_214_cov_144.165217	35	115	10	10	80	0.1250000
NODE_300984_length_214_cov_144.165217	35	115	12	29	80	0.3625000
NODE_300984_length_214_cov_144.165217	35	115	18	10	80	0.1250000
NODE_300984_length_214_cov_144.165217	35	115	20	31	80	0.3875000
NODE_300984_length_214_cov_144.165217	111	191	8	27	80	0.3375000
NODE_300984_length_214_cov_144.165217	111	191	10	7	80	0.0875000
NODE_300984_length_214_cov_144.165217	111	191	12	5	80	0.0625000
NODE_300984_length_214_cov_144.165217	111	191	14	22	80	0.2750000
NODE_300984_length_214_cov_144.165217	111	191	18	19	80	0.2375000
NODE_300984_length_214_cov_144.165217	111	191	8	27	80	0.3375000
NODE_300984_length_214_cov_144.165217	111	191	10	7	80	0.0875000
NODE_300984_length_214_cov_144.165217	111	191	12	5	80	0.0625000
NODE_300984_length_214_cov_144.165217	111	191	14	22	80	0.2750000
NODE_300984_length_214_cov_144.165217	111	191	18	19	80	0.2375000
NODE_300984_length_214_cov_144.165217	111	191	8	27	80	0.3375000
NODE_300984_length_214_cov_144.165217	111	191	10	7	80	0.0875000
NODE_300984_length_214_cov_144.165217	111	191	12	5	80	0.0625000
NODE_300984_length_214_cov_144.165217	111	191	14	22	80	0.2750000
NODE_300984_length_214_cov_144.165217	111	191	18	19	80	0.2375000
NODE_300984_length_214_cov_144.165217	164	214	0	23	50	0.4600000
NODE_300984_length_214_cov_144.165217	164	214	8	27	50	0.5400000
NODE_300984_length_214_cov_144.165217	164	214	0	23	50	0.4600000
NODE_300984_length_214_cov_144.165217	164	214	8	27	50	0.5400000
NODE_300984_length_214_cov_144.165217	164	214	0	23	50	0.4600000
NODE_300984_length_214_cov_144.165217	164	214	8	27	50	0.5400000
NODE_301068_length_211_cov_39.571429	4	84	0	12	80	0.1500000
NODE_301068_length_211_cov_39.571429	4	84	2	68	80	0.8500000
NODE_301169_length_208_cov_45.238532	3	59	0	56	56	1.0000000
NODE_301169_length_208_cov_45.238532	35	112	0	77	77	1.0000000
NODE_301170_length_208_cov_35.229358	76	156	0	1	80	0.0125000
NODE_301170_length_208_cov_35.229358	76	156	2	79	80	0.9875000
NODE_301179_length_207_cov_341.324074	33	113	0	80	80	1.0000000
NODE_301179_length_207_cov_341.324074	86	166	0	80	80	1.0000000
NODE_301248_length_205_cov_64.179245	6	77	6	54	71	0.7605634
NODE_301248_length_205_cov_64.179245	6	77	9	1	71	0.0140845
NODE_301248_length_205_cov_64.179245	6	77	10	16	71	0.2253521
NODE_301248_length_205_cov_64.179245	11	77	6	49	66	0.7424242
NODE_301248_length_205_cov_64.179245	11	77	9	1	66	0.0151515
NODE_301248_length_205_cov_64.179245	11	77	10	16	66	0.2424242
NODE_301248_length_205_cov_64.179245	50	98	6	10	48	0.2083333
NODE_301248_length_205_cov_64.179245	50	98	9	1	48	0.0208333
NODE_301248_length_205_cov_64.179245	50	98	10	34	48	0.7083333
NODE_301248_length_205_cov_64.179245	50	98	12	1	48	0.0208333
NODE_301248_length_205_cov_64.179245	50	98	14	2	48	0.0416667
NODE_301248_length_205_cov_64.179245	50	98	6	10	48	0.2083333
NODE_301248_length_205_cov_64.179245	50	98	9	1	48	0.0208333
NODE_301248_length_205_cov_64.179245	50	98	10	34	48	0.7083333
NODE_301248_length_205_cov_64.179245	50	98	12	1	48	0.0208333
NODE_301248_length_205_cov_64.179245	50	98	14	2	48	0.0416667
NODE_301248_length_205_cov_64.179245	50	98	6	10	48	0.2083333
NODE_301248_length_205_cov_64.179245	50	98	9	1	48	0.0208333
NODE_301248_length_205_cov_64.179245	50	98	10	34	48	0.7083333
NODE_301248_length_205_cov_64.179245	50	98	12	1	48	0.0208333
NODE_301248_length_205_cov_64.179245	50	98	14	2	48	0.0416667
NODE_301281_length_204_cov_183.390476	119	199	33	2	80	0.0250000
NODE_301281_length_204_cov_183.390476	119	199	34	2	80	0.0250000
NODE_301281_length_204_cov_183.390476	119	199	40	2	80	0.0250000
NODE_301281_length_204_cov_183.390476	119	199	46	1	80	0.0125000
NODE_301281_length_204_cov_183.390476	119	199	50	7	80	0.0875000
NODE_301281_length_204_cov_183.390476	119	199	68	2	80	0.0250000
NODE_301281_length_204_cov_183.390476	119	199	76	7	80	0.0875000
NODE_301281_length_204_cov_183.390476	119	199	80	1	80	0.0125000
NODE_301281_length_204_cov_183.390476	119	199	84	2	80	0.0250000
NODE_301281_length_204_cov_183.390476	119	199	86	2	80	0.0250000
NODE_301281_length_204_cov_183.390476	119	199	88	5	80	0.0625000
NODE_301281_length_204_cov_183.390476	119	199	90	13	80	0.1625000
NODE_301281_length_204_cov_183.390476	119	199	91	1	80	0.0125000
NODE_301281_length_204_cov_183.390476	119	199	93	1	80	0.0125000
NODE_301281_length_204_cov_183.390476	119	199	94	2	80	0.0250000
NODE_301281_length_204_cov_183.390476	119	199	96	16	80	0.2000000
NODE_301281_length_204_cov_183.390476	119	199	100	3	80	0.0375000
NODE_301281_length_204_cov_183.390476	119	199	102	1	80	0.0125000
NODE_301281_length_204_cov_183.390476	119	199	104	2	80	0.0250000
NODE_301281_length_204_cov_183.390476	119	199	106	2	80	0.0250000
NODE_301281_length_204_cov_183.390476	119	199	108	1	80	0.0125000
NODE_301281_length_204_cov_183.390476	119	199	110	3	80	0.0375000
NODE_301281_length_204_cov_183.390476	119	199	112	2	80	0.0250000
NODE_301281_length_204_cov_183.390476	172	194	40	1	22	0.0454545
NODE_301281_length_204_cov_183.390476	172	194	46	1	22	0.0454545
NODE_301281_length_204_cov_183.390476	172	194	50	7	22	0.3181818
NODE_301281_length_204_cov_183.390476	172	194	68	2	22	0.0909091
NODE_301281_length_204_cov_183.390476	172	194	76	7	22	0.3181818
NODE_301281_length_204_cov_183.390476	172	194	80	1	22	0.0454545
NODE_301281_length_204_cov_183.390476	172	194	84	2	22	0.0909091
NODE_301281_length_204_cov_183.390476	172	194	86	1	22	0.0454545
NODE_301283_length_204_cov_80.095238	10	90	0	80	80	1.0000000
NODE_301283_length_204_cov_80.095238	63	143	0	80	80	1.0000000
NODE_301345_length_202_cov_123.184466	0	64	9	1	64	0.0156250
NODE_301345_length_202_cov_123.184466	0	64	11	1	64	0.0156250
NODE_301345_length_202_cov_123.184466	0	64	12	1	64	0.0156250
NODE_301345_length_202_cov_123.184466	0	64	16	1	64	0.0156250
NODE_301345_length_202_cov_123.184466	0	64	17	2	64	0.0312500
NODE_301345_length_202_cov_123.184466	0	64	19	2	64	0.0312500
NODE_301345_length_202_cov_123.184466	0	64	27	1	64	0.0156250
NODE_301345_length_202_cov_123.184466	0	64	30	1	64	0.0156250
NODE_301345_length_202_cov_123.184466	0	64	37	2	64	0.0312500
NODE_301345_length_202_cov_123.184466	0	64	46	1	64	0.0156250
NODE_301345_length_202_cov_123.184466	0	64	48	1	64	0.0156250
NODE_301345_length_202_cov_123.184466	0	64	58	1	64	0.0156250
NODE_301345_length_202_cov_123.184466	0	64	60	1	64	0.0156250
NODE_301345_length_202_cov_123.184466	0	64	64	1	64	0.0156250
NODE_301345_length_202_cov_123.184466	0	64	68	1	64	0.0156250
NODE_301345_length_202_cov_123.184466	0	64	74	2	64	0.0312500
NODE_301345_length_202_cov_123.184466	0	64	79	1	64	0.0156250
NODE_301345_length_202_cov_123.184466	0	64	84	2	64	0.0312500
NODE_301345_length_202_cov_123.184466	0	64	86	1	64	0.0156250
NODE_301345_length_202_cov_123.184466	0	64	87	1	64	0.0156250
NODE_301345_length_202_cov_123.184466	0	64	91	1	64	0.0156250
NODE_301345_length_202_cov_123.184466	0	64	94	1	64	0.0156250
NODE_301345_length_202_cov_123.184466	0	64	97	1	64	0.0156250
NODE_301345_length_202_cov_123.184466	0	64	99	2	64	0.0312500
NODE_301345_length_202_cov_123.184466	0	64	102	1	64	0.0156250
NODE_301345_length_202_cov_123.184466	0	64	105	1	64	0.0156250
NODE_301345_length_202_cov_123.184466	0	64	107	1	64	0.0156250
NODE_301345_length_202_cov_123.184466	0	64	111	1	64	0.0156250
NODE_301345_length_202_cov_123.184466	0	64	114	1	64	0.0156250
NODE_301345_length_202_cov_123.184466	0	64	116	1	64	0.0156250
NODE_301345_length_202_cov_123.184466	0	64	119	1	64	0.0156250
NODE_301345_length_202_cov_123.184466	0	64	125	3	64	0.0468750
NODE_301345_length_202_cov_123.184466	0	64	127	1	64	0.0156250
NODE_301345_length_202_cov_123.184466	0	64	136	1	64	0.0156250
NODE_301345_length_202_cov_123.184466	0	64	138	1	64	0.0156250
NODE_301345_length_202_cov_123.184466	0	64	142	1	64	0.0156250
NODE_301345_length_202_cov_123.184466	0	64	150	2	64	0.0312500
NODE_301345_length_202_cov_123.184466	0	64	152	1	64	0.0156250
NODE_301345_length_202_cov_123.184466	0	64	155	1	64	0.0156250
NODE_301345_length_202_cov_123.184466	0	64	160	1	64	0.0156250
NODE_301345_length_202_cov_123.184466	0	64	163	2	64	0.0312500
NODE_301345_length_202_cov_123.184466	0	64	168	1	64	0.0156250
NODE_301345_length_202_cov_123.184466	0	64	180	1	64	0.0156250
NODE_301345_length_202_cov_123.184466	0	64	184	1	64	0.0156250
NODE_301345_length_202_cov_123.184466	0	64	188	1	64	0.0156250
NODE_301345_length_202_cov_123.184466	0	64	192	3	64	0.0468750
NODE_301345_length_202_cov_123.184466	0	64	193	1	64	0.0156250
NODE_301345_length_202_cov_123.184466	0	64	198	2	64	0.0312500
NODE_301345_length_202_cov_123.184466	0	64	205	1	64	0.0156250
NODE_301345_length_202_cov_123.184466	0	64	211	1	64	0.0156250
NODE_301345_length_202_cov_123.184466	0	64	213	1	64	0.0156250
NODE_301345_length_202_cov_123.184466	31	72	105	1	41	0.0243902
NODE_301345_length_202_cov_123.184466	31	72	107	1	41	0.0243902
NODE_301345_length_202_cov_123.184466	31	72	111	1	41	0.0243902
NODE_301345_length_202_cov_123.184466	31	72	114	1	41	0.0243902
NODE_301345_length_202_cov_123.184466	31	72	116	1	41	0.0243902
NODE_301345_length_202_cov_123.184466	31	72	119	1	41	0.0243902
NODE_301345_length_202_cov_123.184466	31	72	125	3	41	0.0731707
NODE_301345_length_202_cov_123.184466	31	72	127	1	41	0.0243902
NODE_301345_length_202_cov_123.184466	31	72	136	1	41	0.0243902
NODE_301345_length_202_cov_123.184466	31	72	138	1	41	0.0243902
NODE_301345_length_202_cov_123.184466	31	72	142	1	41	0.0243902
NODE_301345_length_202_cov_123.184466	31	72	150	2	41	0.0487805
NODE_301345_length_202_cov_123.184466	31	72	152	1	41	0.0243902
NODE_301345_length_202_cov_123.184466	31	72	155	1	41	0.0243902
NODE_301345_length_202_cov_123.184466	31	72	160	1	41	0.0243902
NODE_301345_length_202_cov_123.184466	31	72	163	2	41	0.0487805
NODE_301345_length_202_cov_123.184466	31	72	168	1	41	0.0243902
NODE_301345_length_202_cov_123.184466	31	72	180	1	41	0.0243902
NODE_301345_length_202_cov_123.184466	31	72	184	1	41	0.0243902
NODE_301345_length_202_cov_123.184466	31	72	188	1	41	0.0243902
NODE_301345_length_202_cov_123.184466	31	72	192	3	41	0.0731707
NODE_301345_length_202_cov_123.184466	31	72	193	1	41	0.0243902
NODE_301345_length_202_cov_123.184466	31	72	198	2	41	0.0487805
NODE_301345_length_202_cov_123.184466	31	72	205	1	41	0.0243902
NODE_301345_length_202_cov_123.184466	31	72	211	1	41	0.0243902
NODE_301345_length_202_cov_123.184466	31	72	213	1	41	0.0243902
NODE_301345_length_202_cov_123.184466	31	72	226	1	41	0.0243902
NODE_301345_length_202_cov_123.184466	31	72	231	1	41	0.0243902
NODE_301345_length_202_cov_123.184466	31	72	245	1	41	0.0243902
NODE_301345_length_202_cov_123.184466	31	72	250	1	41	0.0243902
NODE_301345_length_202_cov_123.184466	31	72	254	1	41	0.0243902
NODE_301345_length_202_cov_123.184466	31	72	260	1	41	0.0243902
NODE_301345_length_202_cov_123.184466	31	72	271	1	41	0.0243902
NODE_301345_length_202_cov_123.184466	31	72	277	1	41	0.0243902
NODE_301370_length_201_cov_56.323529	133	201	0	29	68	0.4264706
NODE_301370_length_201_cov_56.323529	133	201	2	1	68	0.0147059
NODE_301370_length_201_cov_56.323529	133	201	4	13	68	0.1911765
NODE_301370_length_201_cov_56.323529	133	201	6	4	68	0.0588235
NODE_301370_length_201_cov_56.323529	133	201	8	21	68	0.3088235
NODE_301371_length_201_cov_50.647059	44	99	29	1	55	0.0181818
NODE_301371_length_201_cov_50.647059	44	99	30	3	55	0.0545455
NODE_301371_length_201_cov_50.647059	44	99	32	3	55	0.0545455
NODE_301371_length_201_cov_50.647059	44	99	34	1	55	0.0181818
NODE_301371_length_201_cov_50.647059	44	99	36	2	55	0.0363636
NODE_301371_length_201_cov_50.647059	44	99	38	5	55	0.0909091
NODE_301371_length_201_cov_50.647059	44	99	40	2	55	0.0363636
NODE_301371_length_201_cov_50.647059	44	99	42	4	55	0.0727273
NODE_301371_length_201_cov_50.647059	44	99	46	7	55	0.1272727
NODE_301371_length_201_cov_50.647059	44	99	56	13	55	0.2363636
NODE_301371_length_201_cov_50.647059	44	99	62	7	55	0.1272727
NODE_301371_length_201_cov_50.647059	44	99	64	6	55	0.1090909
NODE_301371_length_201_cov_50.647059	44	99	66	1	55	0.0181818
NODE_301371_length_201_cov_50.647059	136	201	0	2	65	0.0307692
NODE_301371_length_201_cov_50.647059	136	201	12	3	65	0.0461538
NODE_301371_length_201_cov_50.647059	136	201	14	1	65	0.0153846
NODE_301371_length_201_cov_50.647059	136	201	15	1	65	0.0153846
NODE_301371_length_201_cov_50.647059	136	201	19	5	65	0.0769231
NODE_301371_length_201_cov_50.647059	136	201	25	1	65	0.0153846
NODE_301371_length_201_cov_50.647059	136	201	26	3	65	0.0461538
NODE_301371_length_201_cov_50.647059	136	201	30	16	65	0.2461538
NODE_301371_length_201_cov_50.647059	136	201	34	4	65	0.0615385
NODE_301371_length_201_cov_50.647059	136	201	36	1	65	0.0153846
NODE_301371_length_201_cov_50.647059	136	201	38	4	65	0.0615385
NODE_301371_length_201_cov_50.647059	136	201	40	10	65	0.1538462
NODE_301371_length_201_cov_50.647059	136	201	42	4	65	0.0615385
NODE_301371_length_201_cov_50.647059	136	201	44	4	65	0.0615385
NODE_301371_length_201_cov_50.647059	136	201	46	6	65	0.0923077
NODE_301371_length_201_cov_50.647059	136	201	0	2	65	0.0307692
NODE_301371_length_201_cov_50.647059	136	201	12	3	65	0.0461538
NODE_301371_length_201_cov_50.647059	136	201	14	1	65	0.0153846
NODE_301371_length_201_cov_50.647059	136	201	15	1	65	0.0153846
NODE_301371_length_201_cov_50.647059	136	201	19	5	65	0.0769231
NODE_301371_length_201_cov_50.647059	136	201	25	1	65	0.0153846
NODE_301371_length_201_cov_50.647059	136	201	26	3	65	0.0461538
NODE_301371_length_201_cov_50.647059	136	201	30	16	65	0.2461538
NODE_301371_length_201_cov_50.647059	136	201	34	4	65	0.0615385
NODE_301371_length_201_cov_50.647059	136	201	36	1	65	0.0153846
NODE_301371_length_201_cov_50.647059	136	201	38	4	65	0.0615385
NODE_301371_length_201_cov_50.647059	136	201	40	10	65	0.1538462
NODE_301371_length_201_cov_50.647059	136	201	42	4	65	0.0615385
NODE_301371_length_201_cov_50.647059	136	201	44	4	65	0.0615385
NODE_301371_length_201_cov_50.647059	136	201	46	6	65	0.0923077
NODE_301371_length_201_cov_50.647059	136	201	0	2	65	0.0307692
NODE_301371_length_201_cov_50.647059	136	201	12	3	65	0.0461538
NODE_301371_length_201_cov_50.647059	136	201	14	1	65	0.0153846
NODE_301371_length_201_cov_50.647059	136	201	15	1	65	0.0153846
NODE_301371_length_201_cov_50.647059	136	201	19	5	65	0.0769231
NODE_301371_length_201_cov_50.647059	136	201	25	1	65	0.0153846
NODE_301371_length_201_cov_50.647059	136	201	26	3	65	0.0461538
NODE_301371_length_201_cov_50.647059	136	201	30	16	65	0.2461538
NODE_301371_length_201_cov_50.647059	136	201	34	4	65	0.0615385
NODE_301371_length_201_cov_50.647059	136	201	36	1	65	0.0153846
NODE_301371_length_201_cov_50.647059	136	201	38	4	65	0.0615385
NODE_301371_length_201_cov_50.647059	136	201	40	10	65	0.1538462
NODE_301371_length_201_cov_50.647059	136	201	42	4	65	0.0615385
NODE_301371_length_201_cov_50.647059	136	201	44	4	65	0.0615385
NODE_301371_length_201_cov_50.647059	136	201	46	6	65	0.0923077
NODE_301371_length_201_cov_50.647059	136	201	0	2	65	0.0307692
NODE_301371_length_201_cov_50.647059	136	201	12	3	65	0.0461538
NODE_301371_length_201_cov_50.647059	136	201	14	1	65	0.0153846
NODE_301371_length_201_cov_50.647059	136	201	15	1	65	0.0153846
NODE_301371_length_201_cov_50.647059	136	201	19	5	65	0.0769231
NODE_301371_length_201_cov_50.647059	136	201	25	1	65	0.0153846
NODE_301371_length_201_cov_50.647059	136	201	26	3	65	0.0461538
NODE_301371_length_201_cov_50.647059	136	201	30	16	65	0.2461538
NODE_301371_length_201_cov_50.647059	136	201	34	4	65	0.0615385
NODE_301371_length_201_cov_50.647059	136	201	36	1	65	0.0153846
NODE_301371_length_201_cov_50.647059	136	201	38	4	65	0.0615385
NODE_301371_length_201_cov_50.647059	136	201	40	10	65	0.1538462
NODE_301371_length_201_cov_50.647059	136	201	42	4	65	0.0615385
NODE_301371_length_201_cov_50.647059	136	201	44	4	65	0.0615385
NODE_301371_length_201_cov_50.647059	136	201	46	6	65	0.0923077
NODE_301405_length_200_cov_29.118812	0	73	4	2	73	0.0273973
NODE_301405_length_200_cov_29.118812	0	73	6	6	73	0.0821918
NODE_301405_length_200_cov_29.118812	0	73	10	1	73	0.0136986
NODE_301405_length_200_cov_29.118812	0	73	11	2	73	0.0273973
NODE_301405_length_200_cov_29.118812	0	73	13	3	73	0.0410959
NODE_301405_length_200_cov_29.118812	0	73	14	1	73	0.0136986
NODE_301405_length_200_cov_29.118812	0	73	17	1	73	0.0136986
NODE_301405_length_200_cov_29.118812	0	73	21	1	73	0.0136986
NODE_301405_length_200_cov_29.118812	0	73	26	1	73	0.0136986
NODE_301405_length_200_cov_29.118812	0	73	30	1	73	0.0136986
NODE_301405_length_200_cov_29.118812	0	73	36	1	73	0.0136986
NODE_301405_length_200_cov_29.118812	0	73	38	1	73	0.0136986
NODE_301405_length_200_cov_29.118812	0	73	41	14	73	0.1917808
NODE_301405_length_200_cov_29.118812	0	73	45	1	73	0.0136986
NODE_301405_length_200_cov_29.118812	0	73	48	4	73	0.0547945
NODE_301405_length_200_cov_29.118812	0	73	52	33	73	0.4520548
NODE_301419_length_199_cov_768.700000	94	142	360	2	48	0.0416667
NODE_301419_length_199_cov_768.700000	94	142	362	7	48	0.1458333
NODE_301419_length_199_cov_768.700000	94	142	364	1	48	0.0208333
NODE_301419_length_199_cov_768.700000	94	142	366	2	48	0.0416667
NODE_301419_length_199_cov_768.700000	94	142	368	1	48	0.0208333
NODE_301419_length_199_cov_768.700000	94	142	370	3	48	0.0625000
NODE_301419_length_199_cov_768.700000	94	142	374	4	48	0.0833333
NODE_301419_length_199_cov_768.700000	94	142	382	2	48	0.0416667
NODE_301419_length_199_cov_768.700000	94	142	384	3	48	0.0625000
NODE_301419_length_199_cov_768.700000	94	142	386	4	48	0.0833333
NODE_301419_length_199_cov_768.700000	94	142	388	13	48	0.2708333
NODE_301419_length_199_cov_768.700000	94	142	390	6	48	0.1250000
NODE_301419_length_199_cov_768.700000	115	186	100	1	71	0.0140845
NODE_301419_length_199_cov_768.700000	115	186	107	1	71	0.0140845
NODE_301419_length_199_cov_768.700000	115	186	115	1	71	0.0140845
NODE_301419_length_199_cov_768.700000	115	186	126	1	71	0.0140845
NODE_301419_length_199_cov_768.700000	115	186	142	1	71	0.0140845
NODE_301419_length_199_cov_768.700000	115	186	168	1	71	0.0140845
NODE_301419_length_199_cov_768.700000	115	186	178	1	71	0.0140845
NODE_301419_length_199_cov_768.700000	115	186	181	1	71	0.0140845
NODE_301419_length_199_cov_768.700000	115	186	189	1	71	0.0140845
NODE_301419_length_199_cov_768.700000	115	186	205	1	71	0.0140845
NODE_301419_length_199_cov_768.700000	115	186	208	2	71	0.0281690
NODE_301419_length_199_cov_768.700000	115	186	219	1	71	0.0140845
NODE_301419_length_199_cov_768.700000	115	186	224	1	71	0.0140845
NODE_301419_length_199_cov_768.700000	115	186	229	1	71	0.0140845
NODE_301419_length_199_cov_768.700000	115	186	231	1	71	0.0140845
NODE_301419_length_199_cov_768.700000	115	186	236	1	71	0.0140845
NODE_301419_length_199_cov_768.700000	115	186	238	1	71	0.0140845
NODE_301419_length_199_cov_768.700000	115	186	242	1	71	0.0140845
NODE_301419_length_199_cov_768.700000	115	186	244	1	71	0.0140845
NODE_301419_length_199_cov_768.700000	115	186	245	1	71	0.0140845
NODE_301419_length_199_cov_768.700000	115	186	247	1	71	0.0140845
NODE_301419_length_199_cov_768.700000	115	186	257	1	71	0.0140845
NODE_301419_length_199_cov_768.700000	115	186	263	1	71	0.0140845
NODE_301419_length_199_cov_768.700000	115	186	267	1	71	0.0140845
NODE_301419_length_199_cov_768.700000	115	186	271	2	71	0.0281690
NODE_301419_length_199_cov_768.700000	115	186	277	1	71	0.0140845
NODE_301419_length_199_cov_768.700000	115	186	283	1	71	0.0140845
NODE_301419_length_199_cov_768.700000	115	186	287	1	71	0.0140845
NODE_301419_length_199_cov_768.700000	115	186	296	1	71	0.0140845
NODE_301419_length_199_cov_768.700000	115	186	305	2	71	0.0281690
NODE_301419_length_199_cov_768.700000	115	186	307	1	71	0.0140845
NODE_301419_length_199_cov_768.700000	115	186	312	1	71	0.0140845
NODE_301419_length_199_cov_768.700000	115	186	317	1	71	0.0140845
NODE_301419_length_199_cov_768.700000	115	186	320	1	71	0.0140845
NODE_301419_length_199_cov_768.700000	115	186	324	1	71	0.0140845
NODE_301419_length_199_cov_768.700000	115	186	332	1	71	0.0140845
NODE_301419_length_199_cov_768.700000	115	186	340	1	71	0.0140845
NODE_301419_length_199_cov_768.700000	115	186	346	1	71	0.0140845
NODE_301419_length_199_cov_768.700000	115	186	350	1	71	0.0140845
NODE_301419_length_199_cov_768.700000	115	186	354	2	71	0.0281690
NODE_301419_length_199_cov_768.700000	115	186	360	2	71	0.0281690
NODE_301419_length_199_cov_768.700000	115	186	362	7	71	0.0985916
NODE_301419_length_199_cov_768.700000	115	186	364	1	71	0.0140845
NODE_301419_length_199_cov_768.700000	115	186	366	2	71	0.0281690
NODE_301419_length_199_cov_768.700000	115	186	368	1	71	0.0140845
NODE_301419_length_199_cov_768.700000	115	186	370	3	71	0.0422535
NODE_301419_length_199_cov_768.700000	115	186	374	4	71	0.0563380
NODE_301419_length_199_cov_768.700000	115	186	382	2	71	0.0281690
NODE_301419_length_199_cov_768.700000	115	186	384	2	71	0.0281690
NODE_301419_length_199_cov_768.700000	115	186	386	3	71	0.0422535
NODE_301420_length_199_cov_702.860000	3	78	22	1	75	0.0133333
NODE_301420_length_199_cov_702.860000	3	78	30	2	75	0.0266667
NODE_301420_length_199_cov_702.860000	3	78	42	4	75	0.0533333
NODE_301420_length_199_cov_702.860000	3	78	44	1	75	0.0133333
NODE_301420_length_199_cov_702.860000	3	78	46	3	75	0.0400000
NODE_301420_length_199_cov_702.860000	3	78	50	1	75	0.0133333
NODE_301420_length_199_cov_702.860000	3	78	54	1	75	0.0133333
NODE_301420_length_199_cov_702.860000	3	78	55	1	75	0.0133333
NODE_301420_length_199_cov_702.860000	3	78	67	1	75	0.0133333
NODE_301420_length_199_cov_702.860000	3	78	73	1	75	0.0133333
NODE_301420_length_199_cov_702.860000	3	78	74	2	75	0.0266667
NODE_301420_length_199_cov_702.860000	3	78	85	1	75	0.0133333
NODE_301420_length_199_cov_702.860000	3	78	93	2	75	0.0266667
NODE_301420_length_199_cov_702.860000	3	78	97	1	75	0.0133333
NODE_301420_length_199_cov_702.860000	3	78	99	1	75	0.0133333
NODE_301420_length_199_cov_702.860000	3	78	103	1	75	0.0133333
NODE_301420_length_199_cov_702.860000	3	78	119	1	75	0.0133333
NODE_301420_length_199_cov_702.860000	3	78	131	1	75	0.0133333
NODE_301420_length_199_cov_702.860000	3	78	135	1	75	0.0133333
NODE_301420_length_199_cov_702.860000	3	78	148	1	75	0.0133333
NODE_301420_length_199_cov_702.860000	3	78	150	1	75	0.0133333
NODE_301420_length_199_cov_702.860000	3	78	152	2	75	0.0266667
NODE_301420_length_199_cov_702.860000	3	78	158	2	75	0.0266667
NODE_301420_length_199_cov_702.860000	3	78	162	1	75	0.0133333
NODE_301420_length_199_cov_702.860000	3	78	168	1	75	0.0133333
NODE_301420_length_199_cov_702.860000	3	78	172	1	75	0.0133333
NODE_301420_length_199_cov_702.860000	3	78	176	1	75	0.0133333
NODE_301420_length_199_cov_702.860000	3	78	178	1	75	0.0133333
NODE_301420_length_199_cov_702.860000	3	78	180	2	75	0.0266667
NODE_301420_length_199_cov_702.860000	3	78	184	2	75	0.0266667
NODE_301420_length_199_cov_702.860000	3	78	194	1	75	0.0133333
NODE_301420_length_199_cov_702.860000	3	78	196	1	75	0.0133333
NODE_301420_length_199_cov_702.860000	3	78	204	2	75	0.0266667
NODE_301420_length_199_cov_702.860000	3	78	212	3	75	0.0400000
NODE_301420_length_199_cov_702.860000	3	78	228	1	75	0.0133333
NODE_301420_length_199_cov_702.860000	3	78	232	1	75	0.0133333
NODE_301420_length_199_cov_702.860000	3	78	240	2	75	0.0266667
NODE_301420_length_199_cov_702.860000	3	78	243	1	75	0.0133333
NODE_301420_length_199_cov_702.860000	3	78	265	1	75	0.0133333
NODE_301420_length_199_cov_702.860000	3	78	269	2	75	0.0266667
NODE_301420_length_199_cov_702.860000	3	78	291	1	75	0.0133333
NODE_301420_length_199_cov_702.860000	3	78	295	1	75	0.0133333
NODE_301420_length_199_cov_702.860000	3	78	307	2	75	0.0266667
NODE_301420_length_199_cov_702.860000	3	78	315	1	75	0.0133333
NODE_301420_length_199_cov_702.860000	3	78	318	1	75	0.0133333
NODE_301420_length_199_cov_702.860000	3	78	330	1	75	0.0133333
NODE_301420_length_199_cov_702.860000	3	78	334	5	75	0.0666667
NODE_301420_length_199_cov_702.860000	3	78	338	1	75	0.0133333
NODE_301420_length_199_cov_702.860000	3	78	342	3	75	0.0400000
NODE_301420_length_199_cov_702.860000	3	78	348	2	75	0.0266667
NODE_301420_length_199_cov_702.860000	51	131	212	1	80	0.0125000
NODE_301420_length_199_cov_702.860000	51	131	228	1	80	0.0125000
NODE_301420_length_199_cov_702.860000	51	131	229	1	80	0.0125000
NODE_301420_length_199_cov_702.860000	51	131	232	1	80	0.0125000
NODE_301420_length_199_cov_702.860000	51	131	233	1	80	0.0125000
NODE_301420_length_199_cov_702.860000	51	131	237	1	80	0.0125000
NODE_301420_length_199_cov_702.860000	51	131	239	1	80	0.0125000
NODE_301420_length_199_cov_702.860000	51	131	240	2	80	0.0250000
NODE_301420_length_199_cov_702.860000	51	131	243	3	80	0.0375000
NODE_301420_length_199_cov_702.860000	51	131	244	1	80	0.0125000
NODE_301420_length_199_cov_702.860000	51	131	263	2	80	0.0250000
NODE_301420_length_199_cov_702.860000	51	131	265	1	80	0.0125000
NODE_301420_length_199_cov_702.860000	51	131	267	1	80	0.0125000
NODE_301420_length_199_cov_702.860000	51	131	269	2	80	0.0250000
NODE_301420_length_199_cov_702.860000	51	131	278	1	80	0.0125000
NODE_301420_length_199_cov_702.860000	51	131	288	1	80	0.0125000
NODE_301420_length_199_cov_702.860000	51	131	291	1	80	0.0125000
NODE_301420_length_199_cov_702.860000	51	131	295	1	80	0.0125000
NODE_301420_length_199_cov_702.860000	51	131	304	1	80	0.0125000
NODE_301420_length_199_cov_702.860000	51	131	307	2	80	0.0250000
NODE_301420_length_199_cov_702.860000	51	131	308	1	80	0.0125000
NODE_301420_length_199_cov_702.860000	51	131	312	1	80	0.0125000
NODE_301420_length_199_cov_702.860000	51	131	315	1	80	0.0125000
NODE_301420_length_199_cov_702.860000	51	131	318	1	80	0.0125000
NODE_301420_length_199_cov_702.860000	51	131	329	1	80	0.0125000
NODE_301420_length_199_cov_702.860000	51	131	330	1	80	0.0125000
NODE_301420_length_199_cov_702.860000	51	131	332	1	80	0.0125000
NODE_301420_length_199_cov_702.860000	51	131	334	6	80	0.0750000
NODE_301420_length_199_cov_702.860000	51	131	338	1	80	0.0125000
NODE_301420_length_199_cov_702.860000	51	131	340	1	80	0.0125000
NODE_301420_length_199_cov_702.860000	51	131	342	3	80	0.0375000
NODE_301420_length_199_cov_702.860000	51	131	348	5	80	0.0625000
NODE_301420_length_199_cov_702.860000	51	131	352	2	80	0.0250000
NODE_301420_length_199_cov_702.860000	51	131	356	2	80	0.0250000
NODE_301420_length_199_cov_702.860000	51	131	360	4	80	0.0500000
NODE_301420_length_199_cov_702.860000	51	131	364	1	80	0.0125000
NODE_301420_length_199_cov_702.860000	51	131	366	2	80	0.0250000
NODE_301420_length_199_cov_702.860000	51	131	368	4	80	0.0500000
NODE_301420_length_199_cov_702.860000	51	131	370	2	80	0.0250000
NODE_301420_length_199_cov_702.860000	51	131	374	14	80	0.1750000
NODE_301421_length_199_cov_670.570000	22	52	636	1	30	0.0333333
NODE_301421_length_199_cov_670.570000	22	52	669	1	30	0.0333333
NODE_301421_length_199_cov_670.570000	22	52	694	1	30	0.0333333
NODE_301421_length_199_cov_670.570000	22	52	741	1	30	0.0333333
NODE_301421_length_199_cov_670.570000	22	52	784	1	30	0.0333333
NODE_301421_length_199_cov_670.570000	22	52	802	1	30	0.0333333
NODE_301421_length_199_cov_670.570000	22	52	819	1	30	0.0333333
NODE_301421_length_199_cov_670.570000	22	52	828	1	30	0.0333333
NODE_301421_length_199_cov_670.570000	22	52	842	1	30	0.0333333
NODE_301421_length_199_cov_670.570000	22	52	863	1	30	0.0333333
NODE_301421_length_199_cov_670.570000	22	52	873	1	30	0.0333333
NODE_301421_length_199_cov_670.570000	22	52	884	1	30	0.0333333
NODE_301421_length_199_cov_670.570000	22	52	899	1	30	0.0333333
NODE_301421_length_199_cov_670.570000	22	52	936	1	30	0.0333333
NODE_301421_length_199_cov_670.570000	22	52	961	1	30	0.0333333
NODE_301421_length_199_cov_670.570000	22	52	993	1	30	0.0333333
NODE_301421_length_199_cov_670.570000	22	52	1003	1	30	0.0333333
NODE_301421_length_199_cov_670.570000	22	52	1022	1	30	0.0333333
NODE_301421_length_199_cov_670.570000	22	52	1056	1	30	0.0333333
NODE_301421_length_199_cov_670.570000	22	52	1079	1	30	0.0333333
NODE_301421_length_199_cov_670.570000	22	52	1093	1	30	0.0333333
NODE_301421_length_199_cov_670.570000	22	52	1099	1	30	0.0333333
NODE_301421_length_199_cov_670.570000	22	52	1103	1	30	0.0333333
NODE_301421_length_199_cov_670.570000	22	52	1114	1	30	0.0333333
NODE_301421_length_199_cov_670.570000	22	52	1119	1	30	0.0333333
NODE_301421_length_199_cov_670.570000	22	52	1132	1	30	0.0333333
NODE_301421_length_199_cov_670.570000	22	52	1150	1	30	0.0333333
NODE_301421_length_199_cov_670.570000	22	52	1169	1	30	0.0333333
NODE_301421_length_199_cov_670.570000	22	52	1188	1	30	0.0333333
NODE_301421_length_199_cov_670.570000	22	52	1194	1	30	0.0333333
NODE_301421_length_199_cov_670.570000	25	105	741	1	80	0.0125000
NODE_301421_length_199_cov_670.570000	25	105	784	1	80	0.0125000
NODE_301421_length_199_cov_670.570000	25	105	802	1	80	0.0125000
NODE_301421_length_199_cov_670.570000	25	105	819	1	80	0.0125000
NODE_301421_length_199_cov_670.570000	25	105	828	1	80	0.0125000
NODE_301421_length_199_cov_670.570000	25	105	842	1	80	0.0125000
NODE_301421_length_199_cov_670.570000	25	105	863	1	80	0.0125000
NODE_301421_length_199_cov_670.570000	25	105	873	1	80	0.0125000
NODE_301421_length_199_cov_670.570000	25	105	884	1	80	0.0125000
NODE_301421_length_199_cov_670.570000	25	105	899	1	80	0.0125000
NODE_301421_length_199_cov_670.570000	25	105	936	1	80	0.0125000
NODE_301421_length_199_cov_670.570000	25	105	961	1	80	0.0125000
NODE_301421_length_199_cov_670.570000	25	105	993	1	80	0.0125000
NODE_301421_length_199_cov_670.570000	25	105	1003	1	80	0.0125000
NODE_301421_length_199_cov_670.570000	25	105	1022	1	80	0.0125000
NODE_301421_length_199_cov_670.570000	25	105	1056	1	80	0.0125000
NODE_301421_length_199_cov_670.570000	25	105	1079	1	80	0.0125000
NODE_301421_length_199_cov_670.570000	25	105	1093	1	80	0.0125000
NODE_301421_length_199_cov_670.570000	25	105	1099	1	80	0.0125000
NODE_301421_length_199_cov_670.570000	25	105	1103	1	80	0.0125000
NODE_301421_length_199_cov_670.570000	25	105	1114	1	80	0.0125000
NODE_301421_length_199_cov_670.570000	25	105	1119	1	80	0.0125000
NODE_301421_length_199_cov_670.570000	25	105	1132	1	80	0.0125000
NODE_301421_length_199_cov_670.570000	25	105	1150	1	80	0.0125000
NODE_301421_length_199_cov_670.570000	25	105	1169	1	80	0.0125000
NODE_301421_length_199_cov_670.570000	25	105	1188	1	80	0.0125000
NODE_301421_length_199_cov_670.570000	25	105	1194	1	80	0.0125000
NODE_301421_length_199_cov_670.570000	25	105	1220	1	80	0.0125000
NODE_301421_length_199_cov_670.570000	25	105	1223	1	80	0.0125000
NODE_301421_length_199_cov_670.570000	25	105	1252	1	80	0.0125000
NODE_301421_length_199_cov_670.570000	25	105	1264	1	80	0.0125000
NODE_301421_length_199_cov_670.570000	25	105	1273	1	80	0.0125000
NODE_301421_length_199_cov_670.570000	25	105	1277	1	80	0.0125000
NODE_301421_length_199_cov_670.570000	25	105	1288	1	80	0.0125000
NODE_301421_length_199_cov_670.570000	25	105	1298	1	80	0.0125000
NODE_301421_length_199_cov_670.570000	25	105	1305	1	80	0.0125000
NODE_301421_length_199_cov_670.570000	25	105	1308	1	80	0.0125000
NODE_301421_length_199_cov_670.570000	25	105	1319	1	80	0.0125000
NODE_301421_length_199_cov_670.570000	25	105	1323	2	80	0.0250000
NODE_301421_length_199_cov_670.570000	25	105	1325	1	80	0.0125000
NODE_301421_length_199_cov_670.570000	25	105	1327	1	80	0.0125000
NODE_301421_length_199_cov_670.570000	25	105	1328	1	80	0.0125000
NODE_301421_length_199_cov_670.570000	25	105	1333	1	80	0.0125000
NODE_301421_length_199_cov_670.570000	25	105	1335	1	80	0.0125000
NODE_301421_length_199_cov_670.570000	25	105	1341	1	80	0.0125000
NODE_301421_length_199_cov_670.570000	25	105	1350	2	80	0.0250000
NODE_301421_length_199_cov_670.570000	25	105	1352	1	80	0.0125000
NODE_301421_length_199_cov_670.570000	25	105	1362	1	80	0.0125000
NODE_301421_length_199_cov_670.570000	25	105	1370	1	80	0.0125000
NODE_301421_length_199_cov_670.570000	25	105	1374	3	80	0.0375000
NODE_301421_length_199_cov_670.570000	25	105	1376	1	80	0.0125000
NODE_301421_length_199_cov_670.570000	25	105	1383	1	80	0.0125000
NODE_301421_length_199_cov_670.570000	25	105	1389	1	80	0.0125000
NODE_301421_length_199_cov_670.570000	25	105	1394	1	80	0.0125000
NODE_301421_length_199_cov_670.570000	25	105	1397	1	80	0.0125000
NODE_301421_length_199_cov_670.570000	25	105	1403	1	80	0.0125000
NODE_301421_length_199_cov_670.570000	25	105	1414	1	80	0.0125000
NODE_301421_length_199_cov_670.570000	25	105	1420	1	80	0.0125000
NODE_301421_length_199_cov_670.570000	25	105	1426	1	80	0.0125000
NODE_301421_length_199_cov_670.570000	25	105	1430	1	80	0.0125000
NODE_301421_length_199_cov_670.570000	25	105	1437	1	80	0.0125000
NODE_301421_length_199_cov_670.570000	25	105	1438	1	80	0.0125000
NODE_301421_length_199_cov_670.570000	25	105	1442	2	80	0.0250000
NODE_301421_length_199_cov_670.570000	25	105	1444	1	80	0.0125000
NODE_301421_length_199_cov_670.570000	25	105	1446	6	80	0.0750000
NODE_301421_length_199_cov_670.570000	25	105	1448	5	80	0.0625000
NODE_301430_length_199_cov_215.860000	3	75	12	1	72	0.0138889
NODE_301430_length_199_cov_215.860000	3	75	14	3	72	0.0416667
NODE_301430_length_199_cov_215.860000	3	75	16	1	72	0.0138889
NODE_301430_length_199_cov_215.860000	3	75	24	1	72	0.0138889
NODE_301430_length_199_cov_215.860000	3	75	25	1	72	0.0138889
NODE_301430_length_199_cov_215.860000	3	75	26	2	72	0.0277778
NODE_301430_length_199_cov_215.860000	3	75	27	2	72	0.0277778
NODE_301430_length_199_cov_215.860000	3	75	33	1	72	0.0138889
NODE_301430_length_199_cov_215.860000	3	75	37	6	72	0.0833333
NODE_301430_length_199_cov_215.860000	3	75	41	1	72	0.0138889
NODE_301430_length_199_cov_215.860000	3	75	48	1	72	0.0138889
NODE_301430_length_199_cov_215.860000	3	75	50	1	72	0.0138889
NODE_301430_length_199_cov_215.860000	3	75	52	1	72	0.0138889
NODE_301430_length_199_cov_215.860000	3	75	54	2	72	0.0277778
NODE_301430_length_199_cov_215.860000	3	75	60	1	72	0.0138889
NODE_301430_length_199_cov_215.860000	3	75	64	3	72	0.0416667
NODE_301430_length_199_cov_215.860000	3	75	68	3	72	0.0416667
NODE_301430_length_199_cov_215.860000	3	75	70	1	72	0.0138889
NODE_301430_length_199_cov_215.860000	3	75	72	3	72	0.0416667
NODE_301430_length_199_cov_215.860000	3	75	74	1	72	0.0138889
NODE_301430_length_199_cov_215.860000	3	75	94	1	72	0.0138889
NODE_301430_length_199_cov_215.860000	3	75	96	2	72	0.0277778
NODE_301430_length_199_cov_215.860000	3	75	100	3	72	0.0416667
NODE_301430_length_199_cov_215.860000	3	75	102	1	72	0.0138889
NODE_301430_length_199_cov_215.860000	3	75	114	1	72	0.0138889
NODE_301430_length_199_cov_215.860000	3	75	116	2	72	0.0277778
NODE_301430_length_199_cov_215.860000	3	75	122	1	72	0.0138889
NODE_301430_length_199_cov_215.860000	3	75	126	1	72	0.0138889
NODE_301430_length_199_cov_215.860000	3	75	129	1	72	0.0138889
NODE_301430_length_199_cov_215.860000	3	75	131	1	72	0.0138889
NODE_301430_length_199_cov_215.860000	3	75	132	1	72	0.0138889
NODE_301430_length_199_cov_215.860000	3	75	136	2	72	0.0277778
NODE_301430_length_199_cov_215.860000	3	75	142	1	72	0.0138889
NODE_301430_length_199_cov_215.860000	3	75	145	2	72	0.0277778
NODE_301430_length_199_cov_215.860000	3	75	149	1	72	0.0138889
NODE_301430_length_199_cov_215.860000	3	75	153	2	72	0.0277778
NODE_301430_length_199_cov_215.860000	3	75	155	1	72	0.0138889
NODE_301430_length_199_cov_215.860000	3	75	159	2	72	0.0277778
NODE_301430_length_199_cov_215.860000	3	75	161	7	72	0.0972222
NODE_301430_length_199_cov_215.860000	3	75	163	1	72	0.0138889
NODE_301430_length_199_cov_215.860000	3	75	165	2	72	0.0277778
NODE_301430_length_199_cov_215.860000	48	128	116	1	80	0.0125000
NODE_301430_length_199_cov_215.860000	48	128	122	1	80	0.0125000
NODE_301430_length_199_cov_215.860000	48	128	126	1	80	0.0125000
NODE_301430_length_199_cov_215.860000	48	128	129	1	80	0.0125000
NODE_301430_length_199_cov_215.860000	48	128	131	1	80	0.0125000
NODE_301430_length_199_cov_215.860000	48	128	132	1	80	0.0125000
NODE_301430_length_199_cov_215.860000	48	128	135	1	80	0.0125000
NODE_301430_length_199_cov_215.860000	48	128	136	2	80	0.0250000
NODE_301430_length_199_cov_215.860000	48	128	141	1	80	0.0125000
NODE_301430_length_199_cov_215.860000	48	128	142	1	80	0.0125000
NODE_301430_length_199_cov_215.860000	48	128	143	2	80	0.0250000
NODE_301430_length_199_cov_215.860000	48	128	145	2	80	0.0250000
NODE_301430_length_199_cov_215.860000	48	128	147	3	80	0.0375000
NODE_301430_length_199_cov_215.860000	48	128	149	1	80	0.0125000
NODE_301430_length_199_cov_215.860000	48	128	151	2	80	0.0250000
NODE_301430_length_199_cov_215.860000	48	128	153	2	80	0.0250000
NODE_301430_length_199_cov_215.860000	48	128	155	3	80	0.0375000
NODE_301430_length_199_cov_215.860000	48	128	157	1	80	0.0125000
NODE_301430_length_199_cov_215.860000	48	128	159	3	80	0.0375000
NODE_301430_length_199_cov_215.860000	48	128	161	7	80	0.0875000
NODE_301430_length_199_cov_215.860000	48	128	163	3	80	0.0375000
NODE_301430_length_199_cov_215.860000	48	128	165	3	80	0.0375000
NODE_301430_length_199_cov_215.860000	48	128	166	14	80	0.1750000
NODE_301430_length_199_cov_215.860000	48	128	167	7	80	0.0875000
NODE_301430_length_199_cov_215.860000	48	128	169	2	80	0.0250000
NODE_301430_length_199_cov_215.860000	48	128	171	5	80	0.0625000
NODE_301430_length_199_cov_215.860000	48	128	173	9	80	0.1125000
NODE_301432_length_199_cov_206.800000	120	199	0	79	79	1.0000000
NODE_301441_length_199_cov_131.120000	97	177	0	3	80	0.0375000
NODE_301441_length_199_cov_131.120000	97	177	4	55	80	0.6875000
NODE_301441_length_199_cov_131.120000	97	177	8	22	80	0.2750000
NODE_301448_length_199_cov_97.490000	4	77	9	3	73	0.0410959
NODE_301448_length_199_cov_97.490000	4	77	11	4	73	0.0547945
NODE_301448_length_199_cov_97.490000	4	77	14	2	73	0.0273973
NODE_301448_length_199_cov_97.490000	4	77	16	7	73	0.0958904
NODE_301448_length_199_cov_97.490000	4	77	21	2	73	0.0273973
NODE_301448_length_199_cov_97.490000	4	77	23	3	73	0.0410959
NODE_301448_length_199_cov_97.490000	4	77	25	2	73	0.0273973
NODE_301448_length_199_cov_97.490000	4	77	27	3	73	0.0410959
NODE_301448_length_199_cov_97.490000	4	77	28	2	73	0.0273973
NODE_301448_length_199_cov_97.490000	4	77	30	6	73	0.0821918
NODE_301448_length_199_cov_97.490000	4	77	32	11	73	0.1506849
NODE_301448_length_199_cov_97.490000	4	77	34	14	73	0.1917808
NODE_301448_length_199_cov_97.490000	4	77	36	11	73	0.1506849
NODE_301448_length_199_cov_97.490000	4	77	38	1	73	0.0136986
NODE_301448_length_199_cov_97.490000	4	77	44	1	73	0.0136986
NODE_301448_length_199_cov_97.490000	4	77	46	1	73	0.0136986
NODE_301449_length_199_cov_96.090000	91	171	49	1	80	0.0125000
NODE_301449_length_199_cov_96.090000	91	171	51	1	80	0.0125000
NODE_301449_length_199_cov_96.090000	91	171	52	2	80	0.0250000
NODE_301449_length_199_cov_96.090000	91	171	54	1	80	0.0125000
NODE_301449_length_199_cov_96.090000	91	171	60	1	80	0.0125000
NODE_301449_length_199_cov_96.090000	91	171	62	1	80	0.0125000
NODE_301449_length_199_cov_96.090000	91	171	66	2	80	0.0250000
NODE_301449_length_199_cov_96.090000	91	171	76	1	80	0.0125000
NODE_301449_length_199_cov_96.090000	91	171	78	1	80	0.0125000
NODE_301449_length_199_cov_96.090000	91	171	88	3	80	0.0375000
NODE_301449_length_199_cov_96.090000	91	171	90	1	80	0.0125000
NODE_301449_length_199_cov_96.090000	91	171	98	1	80	0.0125000
NODE_301449_length_199_cov_96.090000	91	171	103	1	80	0.0125000
NODE_301449_length_199_cov_96.090000	91	171	111	2	80	0.0250000
NODE_301449_length_199_cov_96.090000	91	171	116	2	80	0.0250000
NODE_301449_length_199_cov_96.090000	91	171	117	1	80	0.0125000
NODE_301449_length_199_cov_96.090000	91	171	118	1	80	0.0125000
NODE_301449_length_199_cov_96.090000	91	171	120	1	80	0.0125000
NODE_301449_length_199_cov_96.090000	91	171	123	1	80	0.0125000
NODE_301449_length_199_cov_96.090000	91	171	124	3	80	0.0375000
NODE_301449_length_199_cov_96.090000	91	171	128	2	80	0.0250000
NODE_301449_length_199_cov_96.090000	91	171	129	2	80	0.0250000
NODE_301449_length_199_cov_96.090000	91	171	131	1	80	0.0125000
NODE_301449_length_199_cov_96.090000	91	171	133	1	80	0.0125000
NODE_301449_length_199_cov_96.090000	91	171	137	1	80	0.0125000
NODE_301449_length_199_cov_96.090000	91	171	143	1	80	0.0125000
NODE_301449_length_199_cov_96.090000	91	171	149	3	80	0.0375000
NODE_301449_length_199_cov_96.090000	91	171	151	1	80	0.0125000
NODE_301449_length_199_cov_96.090000	91	171	157	1	80	0.0125000
NODE_301449_length_199_cov_96.090000	91	171	161	1	80	0.0125000
NODE_301449_length_199_cov_96.090000	91	171	165	5	80	0.0625000
NODE_301449_length_199_cov_96.090000	91	171	167	1	80	0.0125000
NODE_301449_length_199_cov_96.090000	91	171	169	2	80	0.0250000
NODE_301449_length_199_cov_96.090000	91	171	171	1	80	0.0125000
NODE_301449_length_199_cov_96.090000	91	171	173	3	80	0.0375000
NODE_301449_length_199_cov_96.090000	91	171	178	1	80	0.0125000
NODE_301449_length_199_cov_96.090000	91	171	181	5	80	0.0625000
NODE_301449_length_199_cov_96.090000	91	171	185	8	80	0.1000000
NODE_301449_length_199_cov_96.090000	91	171	187	1	80	0.0125000
NODE_301449_length_199_cov_96.090000	91	171	189	11	80	0.1375000
NODE_301455_length_199_cov_84.060000	44	75	5	1	31	0.0322581
NODE_301455_length_199_cov_84.060000	44	75	7	15	31	0.4838710
NODE_301455_length_199_cov_84.060000	44	75	9	2	31	0.0645161
NODE_301455_length_199_cov_84.060000	44	75	10	13	31	0.4193548
NODE_301456_length_199_cov_83.220000	0	64	0	59	64	0.9218750
NODE_301456_length_199_cov_83.220000	0	64	2	5	64	0.0781250
NODE_301459_length_199_cov_80.390000	15	98	0	19	83	0.2289157
NODE_301459_length_199_cov_80.390000	15	98	3	1	83	0.0120482
NODE_301459_length_199_cov_80.390000	15	98	6	63	83	0.7590361
NODE_301469_length_199_cov_63.420000	128	194	8	2	66	0.0303030
NODE_301469_length_199_cov_63.420000	128	194	10	5	66	0.0757576
NODE_301469_length_199_cov_63.420000	128	194	12	3	66	0.0454545
NODE_301469_length_199_cov_63.420000	128	194	14	4	66	0.0606061
NODE_301469_length_199_cov_63.420000	128	194	16	1	66	0.0151515
NODE_301469_length_199_cov_63.420000	128	194	18	1	66	0.0151515
NODE_301469_length_199_cov_63.420000	128	194	21	1	66	0.0151515
NODE_301469_length_199_cov_63.420000	128	194	25	5	66	0.0757576
NODE_301469_length_199_cov_63.420000	128	194	26	6	66	0.0909091
NODE_301469_length_199_cov_63.420000	128	194	28	5	66	0.0757576
NODE_301469_length_199_cov_63.420000	128	194	30	6	66	0.0909091
NODE_301469_length_199_cov_63.420000	128	194	32	3	66	0.0454545
NODE_301469_length_199_cov_63.420000	128	194	35	3	66	0.0454545
NODE_301469_length_199_cov_63.420000	128	194	39	1	66	0.0151515
NODE_301469_length_199_cov_63.420000	128	194	46	1	66	0.0151515
NODE_301469_length_199_cov_63.420000	128	194	54	3	66	0.0454545
NODE_301469_length_199_cov_63.420000	128	194	56	1	66	0.0151515
NODE_301469_length_199_cov_63.420000	128	194	58	4	66	0.0606061
NODE_301469_length_199_cov_63.420000	128	194	60	2	66	0.0303030
NODE_301469_length_199_cov_63.420000	128	194	62	3	66	0.0454545
NODE_301469_length_199_cov_63.420000	128	194	64	1	66	0.0151515
NODE_301469_length_199_cov_63.420000	128	194	68	4	66	0.0606061
NODE_301469_length_199_cov_63.420000	128	194	72	1	66	0.0151515
NODE_301477_length_199_cov_58.660000	18	85	0	51	67	0.7611941
NODE_301477_length_199_cov_58.660000	18	85	2	16	67	0.2388060
NODE_301484_length_199_cov_50.350000	102	183	0	81	81	1.0000000
NODE_301485_length_199_cov_49.630000	5	47	0	42	42	1.0000000
NODE_301485_length_199_cov_49.630000	100	163	0	17	63	0.2698413
NODE_301485_length_199_cov_49.630000	100	163	2	46	63	0.7301587
NODE_301485_length_199_cov_49.630000	100	163	0	17	63	0.2698413
NODE_301485_length_199_cov_49.630000	100	163	2	46	63	0.7301587
NODE_301485_length_199_cov_49.630000	100	163	0	17	63	0.2698413
NODE_301485_length_199_cov_49.630000	100	163	2	46	63	0.7301587
NODE_301485_length_199_cov_49.630000	136	185	0	39	49	0.7959183
NODE_301485_length_199_cov_49.630000	136	185	2	10	49	0.2040816
NODE_301485_length_199_cov_49.630000	153	199	0	46	46	1.0000000
NODE_301491_length_199_cov_40.000000	0	66	0	12	66	0.1818182
NODE_301491_length_199_cov_40.000000	0	66	2	15	66	0.2272727
NODE_301491_length_199_cov_40.000000	0	66	6	2	66	0.0303030
NODE_301491_length_199_cov_40.000000	0	66	8	2	66	0.0303030
NODE_301491_length_199_cov_40.000000	0	66	10	14	66	0.2121212
NODE_301491_length_199_cov_40.000000	0	66	12	9	66	0.1363636
NODE_301491_length_199_cov_40.000000	0	66	16	6	66	0.0909091
NODE_301491_length_199_cov_40.000000	0	66	18	3	66	0.0454545
NODE_301491_length_199_cov_40.000000	0	66	20	3	66	0.0454545
NODE_301491_length_199_cov_40.000000	34	114	10	11	80	0.1375000
NODE_301491_length_199_cov_40.000000	34	114	12	9	80	0.1125000
NODE_301491_length_199_cov_40.000000	34	114	16	6	80	0.0750000
NODE_301491_length_199_cov_40.000000	34	114	18	9	80	0.1125000
NODE_301491_length_199_cov_40.000000	34	114	20	45	80	0.5625000
NODE_301491_length_199_cov_40.000000	39	61	10	6	22	0.2727273
NODE_301491_length_199_cov_40.000000	39	61	12	9	22	0.4090909
NODE_301491_length_199_cov_40.000000	39	61	16	6	22	0.2727273
NODE_301491_length_199_cov_40.000000	39	61	18	1	22	0.0454545
NODE_301498_length_199_cov_31.400000	3	77	4	18	74	0.2432432
NODE_301498_length_199_cov_31.400000	3	77	8	23	74	0.3108108
NODE_301498_length_199_cov_31.400000	3	77	10	33	74	0.4459459
NODE_301498_length_199_cov_31.400000	76	153	10	5	77	0.0649351
NODE_301498_length_199_cov_31.400000	76	153	12	2	77	0.0259740
NODE_301498_length_199_cov_31.400000	76	153	14	11	77	0.1428571
NODE_301498_length_199_cov_31.400000	76	153	16	8	77	0.1038961
NODE_301498_length_199_cov_31.400000	76	153	20	51	77	0.6623377
NODE_301498_length_199_cov_31.400000	76	153	10	5	77	0.0649351
NODE_301498_length_199_cov_31.400000	76	153	12	2	77	0.0259740
NODE_301498_length_199_cov_31.400000	76	153	14	11	77	0.1428571
NODE_301498_length_199_cov_31.400000	76	153	16	8	77	0.1038961
NODE_301498_length_199_cov_31.400000	76	153	20	51	77	0.6623377
NODE_301498_length_199_cov_31.400000	76	153	10	5	77	0.0649351
NODE_301498_length_199_cov_31.400000	76	153	12	2	77	0.0259740
NODE_301498_length_199_cov_31.400000	76	153	14	11	77	0.1428571
NODE_301498_length_199_cov_31.400000	76	153	16	8	77	0.1038961
NODE_301498_length_199_cov_31.400000	76	153	20	51	77	0.6623377
NODE_301498_length_199_cov_31.400000	126	192	6	18	66	0.2727273
NODE_301498_length_199_cov_31.400000	126	192	8	7	66	0.1060606
NODE_301498_length_199_cov_31.400000	126	192	12	16	66	0.2424242
NODE_301498_length_199_cov_31.400000	126	192	14	10	66	0.1515152
NODE_301498_length_199_cov_31.400000	126	192	16	8	66	0.1212121
NODE_301498_length_199_cov_31.400000	126	192	20	7	66	0.1060606
NODE_301498_length_199_cov_31.400000	129	199	6	25	70	0.3571429
NODE_301498_length_199_cov_31.400000	129	199	8	7	70	0.1000000
NODE_301498_length_199_cov_31.400000	129	199	12	16	70	0.2285714
NODE_301498_length_199_cov_31.400000	129	199	14	10	70	0.1428571
NODE_301498_length_199_cov_31.400000	129	199	16	8	70	0.1142857
NODE_301498_length_199_cov_31.400000	129	199	20	4	70	0.0571429
NODE_301498_length_199_cov_31.400000	131	199	6	25	68	0.3676471
NODE_301498_length_199_cov_31.400000	131	199	8	7	68	0.1029412
NODE_301498_length_199_cov_31.400000	131	199	12	16	68	0.2352941
NODE_301498_length_199_cov_31.400000	131	199	14	10	68	0.1470588
NODE_301498_length_199_cov_31.400000	131	199	16	8	68	0.1176471
NODE_301498_length_199_cov_31.400000	131	199	20	2	68	0.0294118
NODE_301500_length_199_cov_30.140000	118	198	0	2	80	0.0250000
NODE_301500_length_199_cov_30.140000	118	198	6	31	80	0.3875000
NODE_301500_length_199_cov_30.140000	118	198	7	15	80	0.1875000
NODE_301500_length_199_cov_30.140000	118	198	8	32	80	0.4000000
NODE_301500_length_199_cov_30.140000	118	198	0	2	80	0.0250000
NODE_301500_length_199_cov_30.140000	118	198	6	31	80	0.3875000
NODE_301500_length_199_cov_30.140000	118	198	7	15	80	0.1875000
NODE_301500_length_199_cov_30.140000	118	198	8	32	80	0.4000000
NODE_301500_length_199_cov_30.140000	118	198	0	2	80	0.0250000
NODE_301500_length_199_cov_30.140000	118	198	6	31	80	0.3875000
NODE_301500_length_199_cov_30.140000	118	198	7	15	80	0.1875000
NODE_301500_length_199_cov_30.140000	118	198	8	32	80	0.4000000
NODE_301500_length_199_cov_30.140000	118	198	0	2	80	0.0250000
NODE_301500_length_199_cov_30.140000	118	198	6	31	80	0.3875000
NODE_301500_length_199_cov_30.140000	118	198	7	15	80	0.1875000
NODE_301500_length_199_cov_30.140000	118	198	8	32	80	0.4000000
NODE_301500_length_199_cov_30.140000	118	198	0	2	80	0.0250000
NODE_301500_length_199_cov_30.140000	118	198	6	31	80	0.3875000
NODE_301500_length_199_cov_30.140000	118	198	7	15	80	0.1875000
NODE_301500_length_199_cov_30.140000	118	198	8	32	80	0.4000000
NODE_301500_length_199_cov_30.140000	127	198	0	2	71	0.0281690
NODE_301500_length_199_cov_30.140000	127	198	6	31	71	0.4366197
NODE_301500_length_199_cov_30.140000	127	198	7	15	71	0.2112676
NODE_301500_length_199_cov_30.140000	127	198	8	23	71	0.3239437
NODE_301581_length_197_cov_41.265306	0	70	0	70	70	1.0000000
NODE_301611_length_196_cov_101.855670	72	136	58	4	64	0.0625000
NODE_301611_length_196_cov_101.855670	72	136	62	3	64	0.0468750
NODE_301611_length_196_cov_101.855670	72	136	63	1	64	0.0156250
NODE_301611_length_196_cov_101.855670	72	136	66	2	64	0.0312500
NODE_301611_length_196_cov_101.855670	72	136	68	2	64	0.0312500
NODE_301611_length_196_cov_101.855670	72	136	70	1	64	0.0156250
NODE_301611_length_196_cov_101.855670	72	136	72	4	64	0.0625000
NODE_301611_length_196_cov_101.855670	72	136	73	2	64	0.0312500
NODE_301611_length_196_cov_101.855670	72	136	76	15	64	0.2343750
NODE_301611_length_196_cov_101.855670	72	136	78	30	64	0.4687500
NODE_301611_length_196_cov_101.855670	72	136	58	4	64	0.0625000
NODE_301611_length_196_cov_101.855670	72	136	62	3	64	0.0468750
NODE_301611_length_196_cov_101.855670	72	136	63	1	64	0.0156250
NODE_301611_length_196_cov_101.855670	72	136	66	2	64	0.0312500
NODE_301611_length_196_cov_101.855670	72	136	68	2	64	0.0312500
NODE_301611_length_196_cov_101.855670	72	136	70	1	64	0.0156250
NODE_301611_length_196_cov_101.855670	72	136	72	4	64	0.0625000
NODE_301611_length_196_cov_101.855670	72	136	73	2	64	0.0312500
NODE_301611_length_196_cov_101.855670	72	136	76	15	64	0.2343750
NODE_301611_length_196_cov_101.855670	72	136	78	30	64	0.4687500
NODE_301611_length_196_cov_101.855670	109	169	10	5	60	0.0833333
NODE_301611_length_196_cov_101.855670	109	169	11	4	60	0.0666667
NODE_301611_length_196_cov_101.855670	109	169	13	2	60	0.0333333
NODE_301611_length_196_cov_101.855670	109	169	15	1	60	0.0166667
NODE_301611_length_196_cov_101.855670	109	169	18	1	60	0.0166667
NODE_301611_length_196_cov_101.855670	109	169	23	1	60	0.0166667
NODE_301611_length_196_cov_101.855670	109	169	25	3	60	0.0500000
NODE_301611_length_196_cov_101.855670	109	169	35	2	60	0.0333333
NODE_301611_length_196_cov_101.855670	109	169	36	4	60	0.0666667
NODE_301611_length_196_cov_101.855670	109	169	38	1	60	0.0166667
NODE_301611_length_196_cov_101.855670	109	169	40	1	60	0.0166667
NODE_301611_length_196_cov_101.855670	109	169	41	1	60	0.0166667
NODE_301611_length_196_cov_101.855670	109	169	50	1	60	0.0166667
NODE_301611_length_196_cov_101.855670	109	169	52	1	60	0.0166667
NODE_301611_length_196_cov_101.855670	109	169	54	1	60	0.0166667
NODE_301611_length_196_cov_101.855670	109	169	58	8	60	0.1333333
NODE_301611_length_196_cov_101.855670	109	169	62	3	60	0.0500000
NODE_301611_length_196_cov_101.855670	109	169	63	1	60	0.0166667
NODE_301611_length_196_cov_101.855670	109	169	66	2	60	0.0333333
NODE_301611_length_196_cov_101.855670	109	169	68	2	60	0.0333333
NODE_301611_length_196_cov_101.855670	109	169	70	1	60	0.0166667
NODE_301611_length_196_cov_101.855670	109	169	72	4	60	0.0666667
NODE_301611_length_196_cov_101.855670	109	169	73	2	60	0.0333333
NODE_301611_length_196_cov_101.855670	109	169	76	8	60	0.1333333
NODE_301613_length_196_cov_100.618557	129	196	2	4	67	0.0597015
NODE_301613_length_196_cov_100.618557	129	196	8	4	67	0.0597015
NODE_301613_length_196_cov_100.618557	129	196	9	5	67	0.0746269
NODE_301613_length_196_cov_100.618557	129	196	11	2	67	0.0298507
NODE_301613_length_196_cov_100.618557	129	196	13	2	67	0.0298507
NODE_301613_length_196_cov_100.618557	129	196	15	2	67	0.0298507
NODE_301613_length_196_cov_100.618557	129	196	19	7	67	0.1044776
NODE_301613_length_196_cov_100.618557	129	196	21	3	67	0.0447761
NODE_301613_length_196_cov_100.618557	129	196	23	1	67	0.0149254
NODE_301613_length_196_cov_100.618557	129	196	25	1	67	0.0149254
NODE_301613_length_196_cov_100.618557	129	196	39	6	67	0.0895522
NODE_301613_length_196_cov_100.618557	129	196	43	1	67	0.0149254
NODE_301613_length_196_cov_100.618557	129	196	45	3	67	0.0447761
NODE_301613_length_196_cov_100.618557	129	196	47	4	67	0.0597015
NODE_301613_length_196_cov_100.618557	129	196	48	8	67	0.1194030
NODE_301613_length_196_cov_100.618557	129	196	50	6	67	0.0895522
NODE_301613_length_196_cov_100.618557	129	196	52	2	67	0.0298507
NODE_301613_length_196_cov_100.618557	129	196	58	3	67	0.0447761
NODE_301613_length_196_cov_100.618557	129	196	60	1	67	0.0149254
NODE_301613_length_196_cov_100.618557	129	196	62	2	67	0.0298507
NODE_301618_length_196_cov_67.268041	8	88	0	1	80	0.0125000
NODE_301618_length_196_cov_67.268041	8	88	1	7	80	0.0875000
NODE_301618_length_196_cov_67.268041	8	88	3	10	80	0.1250000
NODE_301618_length_196_cov_67.268041	8	88	4	8	80	0.1000000
NODE_301618_length_196_cov_67.268041	8	88	5	4	80	0.0500000
NODE_301618_length_196_cov_67.268041	8	88	6	3	80	0.0375000
NODE_301618_length_196_cov_67.268041	8	88	7	19	80	0.2375000
NODE_301618_length_196_cov_67.268041	8	88	8	28	80	0.3500000
NODE_301618_length_196_cov_67.268041	61	124	7	46	63	0.7301587
NODE_301618_length_196_cov_67.268041	61	124	8	17	63	0.2698413
NODE_301629_length_196_cov_40.195876	101	184	8	32	83	0.3855422
NODE_301629_length_196_cov_40.195876	101	184	10	42	83	0.5060241
NODE_301629_length_196_cov_40.195876	101	184	12	9	83	0.1084337
NODE_301704_length_194_cov_63.252632	12	78	10	13	66	0.1969697
NODE_301704_length_194_cov_63.252632	12	78	12	4	66	0.0606061
NODE_301704_length_194_cov_63.252632	12	78	20	5	66	0.0757576
NODE_301704_length_194_cov_63.252632	12	78	22	2	66	0.0303030
NODE_301704_length_194_cov_63.252632	12	78	26	1	66	0.0151515
NODE_301704_length_194_cov_63.252632	12	78	32	7	66	0.1060606
NODE_301704_length_194_cov_63.252632	12	78	34	7	66	0.1060606
NODE_301704_length_194_cov_63.252632	12	78	38	5	66	0.0757576
NODE_301704_length_194_cov_63.252632	12	78	42	2	66	0.0303030
NODE_301704_length_194_cov_63.252632	12	78	50	4	66	0.0606061
NODE_301704_length_194_cov_63.252632	12	78	52	6	66	0.0909091
NODE_301704_length_194_cov_63.252632	12	78	54	2	66	0.0303030
NODE_301704_length_194_cov_63.252632	12	78	56	8	66	0.1212121
NODE_301704_length_194_cov_63.252632	51	112	38	5	61	0.0819672
NODE_301704_length_194_cov_63.252632	51	112	42	2	61	0.0327869
NODE_301704_length_194_cov_63.252632	51	112	50	4	61	0.0655738
NODE_301704_length_194_cov_63.252632	51	112	52	6	61	0.0983607
NODE_301704_length_194_cov_63.252632	51	112	54	2	61	0.0327869
NODE_301704_length_194_cov_63.252632	51	112	56	13	61	0.2131148
NODE_301704_length_194_cov_63.252632	51	112	58	3	61	0.0491803
NODE_301704_length_194_cov_63.252632	51	112	60	26	61	0.4262295
NODE_301704_length_194_cov_63.252632	51	99	38	5	48	0.1041667
NODE_301704_length_194_cov_63.252632	51	99	42	2	48	0.0416667
NODE_301704_length_194_cov_63.252632	51	99	50	4	48	0.0833333
NODE_301704_length_194_cov_63.252632	51	99	52	6	48	0.1250000
NODE_301704_length_194_cov_63.252632	51	99	54	2	48	0.0416667
NODE_301704_length_194_cov_63.252632	51	99	56	13	48	0.2708333
NODE_301704_length_194_cov_63.252632	51	99	58	3	48	0.0625000
NODE_301704_length_194_cov_63.252632	51	99	60	13	48	0.2708333
NODE_301704_length_194_cov_63.252632	51	112	38	5	61	0.0819672
NODE_301704_length_194_cov_63.252632	51	112	42	2	61	0.0327869
NODE_301704_length_194_cov_63.252632	51	112	50	4	61	0.0655738
NODE_301704_length_194_cov_63.252632	51	112	52	6	61	0.0983607
NODE_301704_length_194_cov_63.252632	51	112	54	2	61	0.0327869
NODE_301704_length_194_cov_63.252632	51	112	56	13	61	0.2131148
NODE_301704_length_194_cov_63.252632	51	112	58	3	61	0.0491803
NODE_301704_length_194_cov_63.252632	51	112	60	26	61	0.4262295
NODE_301708_length_194_cov_35.010526	95	162	0	19	67	0.2835821
NODE_301708_length_194_cov_35.010526	95	162	4	1	67	0.0149254
NODE_301708_length_194_cov_35.010526	95	162	8	47	67	0.7014925
NODE_301708_length_194_cov_35.010526	95	162	0	19	67	0.2835821
NODE_301708_length_194_cov_35.010526	95	162	4	1	67	0.0149254
NODE_301708_length_194_cov_35.010526	95	162	8	47	67	0.7014925
NODE_301708_length_194_cov_35.010526	135	184	0	41	49	0.8367347
NODE_301708_length_194_cov_35.010526	135	184	4	1	49	0.0204082
NODE_301708_length_194_cov_35.010526	135	184	8	7	49	0.1428571
NODE_301714_length_194_cov_9.978947	153	194	0	41	41	1.0000000
NODE_301727_length_193_cov_117.170213	21	93	41	1	72	0.0138889
NODE_301727_length_193_cov_117.170213	21	93	43	3	72	0.0416667
NODE_301727_length_193_cov_117.170213	21	93	45	6	72	0.0833333
NODE_301727_length_193_cov_117.170213	21	93	48	2	72	0.0277778
NODE_301727_length_193_cov_117.170213	21	93	50	8	72	0.1111111
NODE_301727_length_193_cov_117.170213	21	93	54	2	72	0.0277778
NODE_301727_length_193_cov_117.170213	21	93	56	1	72	0.0138889
NODE_301727_length_193_cov_117.170213	21	93	58	1	72	0.0138889
NODE_301727_length_193_cov_117.170213	21	93	60	1	72	0.0138889
NODE_301727_length_193_cov_117.170213	21	93	62	1	72	0.0138889
NODE_301727_length_193_cov_117.170213	21	93	64	2	72	0.0277778
NODE_301727_length_193_cov_117.170213	21	93	70	1	72	0.0138889
NODE_301727_length_193_cov_117.170213	21	93	72	1	72	0.0138889
NODE_301727_length_193_cov_117.170213	21	93	74	1	72	0.0138889
NODE_301727_length_193_cov_117.170213	21	93	81	1	72	0.0138889
NODE_301727_length_193_cov_117.170213	21	93	85	5	72	0.0694444
NODE_301727_length_193_cov_117.170213	21	93	87	2	72	0.0277778
NODE_301727_length_193_cov_117.170213	21	93	91	1	72	0.0138889
NODE_301727_length_193_cov_117.170213	21	93	92	1	72	0.0138889
NODE_301727_length_193_cov_117.170213	21	93	95	3	72	0.0416667
NODE_301727_length_193_cov_117.170213	21	93	96	4	72	0.0555556
NODE_301727_length_193_cov_117.170213	21	93	98	3	72	0.0416667
NODE_301727_length_193_cov_117.170213	21	93	100	11	72	0.1527778
NODE_301727_length_193_cov_117.170213	21	93	102	10	72	0.1388889
NODE_301727_length_193_cov_117.170213	41	121	54	2	80	0.0250000
NODE_301727_length_193_cov_117.170213	41	121	56	1	80	0.0125000
NODE_301727_length_193_cov_117.170213	41	121	58	1	80	0.0125000
NODE_301727_length_193_cov_117.170213	41	121	60	1	80	0.0125000
NODE_301727_length_193_cov_117.170213	41	121	62	1	80	0.0125000
NODE_301727_length_193_cov_117.170213	41	121	64	2	80	0.0250000
NODE_301727_length_193_cov_117.170213	41	121	70	1	80	0.0125000
NODE_301727_length_193_cov_117.170213	41	121	72	1	80	0.0125000
NODE_301727_length_193_cov_117.170213	41	121	74	1	80	0.0125000
NODE_301727_length_193_cov_117.170213	41	121	81	1	80	0.0125000
NODE_301727_length_193_cov_117.170213	41	121	85	5	80	0.0625000
NODE_301727_length_193_cov_117.170213	41	121	87	2	80	0.0250000
NODE_301727_length_193_cov_117.170213	41	121	88	1	80	0.0125000
NODE_301727_length_193_cov_117.170213	41	121	90	4	80	0.0500000
NODE_301727_length_193_cov_117.170213	41	121	91	1	80	0.0125000
NODE_301727_length_193_cov_117.170213	41	121	92	3	80	0.0375000
NODE_301727_length_193_cov_117.170213	41	121	94	3	80	0.0375000
NODE_301727_length_193_cov_117.170213	41	121	95	3	80	0.0375000
NODE_301727_length_193_cov_117.170213	41	121	96	6	80	0.0750000
NODE_301727_length_193_cov_117.170213	41	121	98	3	80	0.0375000
NODE_301727_length_193_cov_117.170213	41	121	100	14	80	0.1750000
NODE_301727_length_193_cov_117.170213	41	121	102	23	80	0.2875000
NODE_301729_length_193_cov_54.734043	108	188	36	3	80	0.0375000
NODE_301729_length_193_cov_54.734043	108	188	37	1	80	0.0125000
NODE_301729_length_193_cov_54.734043	108	188	45	2	80	0.0250000
NODE_301729_length_193_cov_54.734043	108	188	47	2	80	0.0250000
NODE_301729_length_193_cov_54.734043	108	188	49	1	80	0.0125000
NODE_301729_length_193_cov_54.734043	108	188	51	1	80	0.0125000
NODE_301729_length_193_cov_54.734043	108	188	57	4	80	0.0500000
NODE_301729_length_193_cov_54.734043	108	188	65	1	80	0.0125000
NODE_301729_length_193_cov_54.734043	108	188	66	8	80	0.1000000
NODE_301729_length_193_cov_54.734043	108	188	68	5	80	0.0625000
NODE_301729_length_193_cov_54.734043	108	188	72	5	80	0.0625000
NODE_301729_length_193_cov_54.734043	108	188	73	3	80	0.0375000
NODE_301729_length_193_cov_54.734043	108	188	75	5	80	0.0625000
NODE_301729_length_193_cov_54.734043	108	188	79	1	80	0.0125000
NODE_301729_length_193_cov_54.734043	108	188	80	2	80	0.0250000
NODE_301729_length_193_cov_54.734043	108	188	84	4	80	0.0500000
NODE_301729_length_193_cov_54.734043	108	188	86	3	80	0.0375000
NODE_301729_length_193_cov_54.734043	108	188	88	13	80	0.1625000
NODE_301729_length_193_cov_54.734043	108	188	89	16	80	0.2000000
NODE_301729_length_193_cov_54.734043	161	183	45	1	22	0.0454545
NODE_301729_length_193_cov_54.734043	161	183	47	2	22	0.0909091
NODE_301729_length_193_cov_54.734043	161	183	49	1	22	0.0454545
NODE_301729_length_193_cov_54.734043	161	183	51	1	22	0.0454545
NODE_301729_length_193_cov_54.734043	161	183	57	4	22	0.1818182
NODE_301729_length_193_cov_54.734043	161	183	65	1	22	0.0454545
NODE_301729_length_193_cov_54.734043	161	183	66	8	22	0.3636364
NODE_301729_length_193_cov_54.734043	161	183	68	4	22	0.1818182
NODE_301735_length_193_cov_30.638298	108	188	5	34	80	0.4250000
NODE_301735_length_193_cov_30.638298	108	188	7	5	80	0.0625000
NODE_301735_length_193_cov_30.638298	108	188	12	41	80	0.5125000
NODE_301735_length_193_cov_30.638298	161	183	5	22	22	1.0000000
NODE_301737_length_193_cov_29.968085	0	45	6	5	45	0.1111111
NODE_301737_length_193_cov_29.968085	0	45	10	2	45	0.0444444
NODE_301737_length_193_cov_29.968085	0	45	14	9	45	0.2000000
NODE_301737_length_193_cov_29.968085	0	45	20	2	45	0.0444444
NODE_301737_length_193_cov_29.968085	0	45	24	1	45	0.0222222
NODE_301737_length_193_cov_29.968085	0	45	29	1	45	0.0222222
NODE_301737_length_193_cov_29.968085	0	45	39	2	45	0.0444444
NODE_301737_length_193_cov_29.968085	0	45	42	2	45	0.0444444
NODE_301737_length_193_cov_29.968085	0	45	45	11	45	0.2444444
NODE_301737_length_193_cov_29.968085	0	45	53	1	45	0.0222222
NODE_301737_length_193_cov_29.968085	0	45	57	2	45	0.0444444
NODE_301737_length_193_cov_29.968085	0	45	59	1	45	0.0222222
NODE_301737_length_193_cov_29.968085	0	45	61	1	45	0.0222222
NODE_301737_length_193_cov_29.968085	0	45	63	1	45	0.0222222
NODE_301737_length_193_cov_29.968085	0	45	65	2	45	0.0444444
NODE_301737_length_193_cov_29.968085	0	45	71	2	45	0.0444444
NODE_301737_length_193_cov_29.968085	8	57	14	8	49	0.1632653
NODE_301737_length_193_cov_29.968085	8	57	20	2	49	0.0408163
NODE_301737_length_193_cov_29.968085	8	57	24	1	49	0.0204082
NODE_301737_length_193_cov_29.968085	8	57	29	1	49	0.0204082
NODE_301737_length_193_cov_29.968085	8	57	39	2	49	0.0408163
NODE_301737_length_193_cov_29.968085	8	57	42	2	49	0.0408163
NODE_301737_length_193_cov_29.968085	8	57	45	11	49	0.2244898
NODE_301737_length_193_cov_29.968085	8	57	53	1	49	0.0204082
NODE_301737_length_193_cov_29.968085	8	57	57	2	49	0.0408163
NODE_301737_length_193_cov_29.968085	8	57	59	1	49	0.0204082
NODE_301737_length_193_cov_29.968085	8	57	61	1	49	0.0204082
NODE_301737_length_193_cov_29.968085	8	57	63	1	49	0.0204082
NODE_301737_length_193_cov_29.968085	8	57	65	2	49	0.0408163
NODE_301737_length_193_cov_29.968085	8	57	71	4	49	0.0816327
NODE_301737_length_193_cov_29.968085	8	57	76	1	49	0.0204082
NODE_301737_length_193_cov_29.968085	8	57	77	2	49	0.0408163
NODE_301737_length_193_cov_29.968085	8	57	79	2	49	0.0408163
NODE_301737_length_193_cov_29.968085	8	57	81	4	49	0.0816327
NODE_301737_length_193_cov_29.968085	8	57	83	1	49	0.0204082
NODE_301737_length_193_cov_29.968085	30	98	45	5	68	0.0735294
NODE_301737_length_193_cov_29.968085	30	98	53	1	68	0.0147059
NODE_301737_length_193_cov_29.968085	30	98	57	2	68	0.0294118
NODE_301737_length_193_cov_29.968085	30	98	59	1	68	0.0147059
NODE_301737_length_193_cov_29.968085	30	98	61	1	68	0.0147059
NODE_301737_length_193_cov_29.968085	30	98	63	1	68	0.0147059
NODE_301737_length_193_cov_29.968085	30	98	65	2	68	0.0294118
NODE_301737_length_193_cov_29.968085	30	98	71	4	68	0.0588235
NODE_301737_length_193_cov_29.968085	30	98	76	1	68	0.0147059
NODE_301737_length_193_cov_29.968085	30	98	77	2	68	0.0294118
NODE_301737_length_193_cov_29.968085	30	98	79	2	68	0.0294118
NODE_301737_length_193_cov_29.968085	30	98	81	4	68	0.0588235
NODE_301737_length_193_cov_29.968085	30	98	83	11	68	0.1617647
NODE_301737_length_193_cov_29.968085	30	98	85	1	68	0.0147059
NODE_301737_length_193_cov_29.968085	30	98	88	7	68	0.1029412
NODE_301737_length_193_cov_29.968085	30	98	90	1	68	0.0147059
NODE_301737_length_193_cov_29.968085	30	98	92	4	68	0.0588235
NODE_301737_length_193_cov_29.968085	30	98	93	1	68	0.0147059
NODE_301737_length_193_cov_29.968085	30	98	94	17	68	0.2500000
NODE_301737_length_193_cov_29.968085	30	98	45	5	68	0.0735294
NODE_301737_length_193_cov_29.968085	30	98	53	1	68	0.0147059
NODE_301737_length_193_cov_29.968085	30	98	57	2	68	0.0294118
NODE_301737_length_193_cov_29.968085	30	98	59	1	68	0.0147059
NODE_301737_length_193_cov_29.968085	30	98	61	1	68	0.0147059
NODE_301737_length_193_cov_29.968085	30	98	63	1	68	0.0147059
NODE_301737_length_193_cov_29.968085	30	98	65	2	68	0.0294118
NODE_301737_length_193_cov_29.968085	30	98	71	4	68	0.0588235
NODE_301737_length_193_cov_29.968085	30	98	76	1	68	0.0147059
NODE_301737_length_193_cov_29.968085	30	98	77	2	68	0.0294118
NODE_301737_length_193_cov_29.968085	30	98	79	2	68	0.0294118
NODE_301737_length_193_cov_29.968085	30	98	81	4	68	0.0588235
NODE_301737_length_193_cov_29.968085	30	98	83	11	68	0.1617647
NODE_301737_length_193_cov_29.968085	30	98	85	1	68	0.0147059
NODE_301737_length_193_cov_29.968085	30	98	88	7	68	0.1029412
NODE_301737_length_193_cov_29.968085	30	98	90	1	68	0.0147059
NODE_301737_length_193_cov_29.968085	30	98	92	4	68	0.0588235
NODE_301737_length_193_cov_29.968085	30	98	93	1	68	0.0147059
NODE_301737_length_193_cov_29.968085	30	98	94	17	68	0.2500000
NODE_301737_length_193_cov_29.968085	30	98	45	5	68	0.0735294
NODE_301737_length_193_cov_29.968085	30	98	53	1	68	0.0147059
NODE_301737_length_193_cov_29.968085	30	98	57	2	68	0.0294118
NODE_301737_length_193_cov_29.968085	30	98	59	1	68	0.0147059
NODE_301737_length_193_cov_29.968085	30	98	61	1	68	0.0147059
NODE_301737_length_193_cov_29.968085	30	98	63	1	68	0.0147059
NODE_301737_length_193_cov_29.968085	30	98	65	2	68	0.0294118
NODE_301737_length_193_cov_29.968085	30	98	71	4	68	0.0588235
NODE_301737_length_193_cov_29.968085	30	98	76	1	68	0.0147059
NODE_301737_length_193_cov_29.968085	30	98	77	2	68	0.0294118
NODE_301737_length_193_cov_29.968085	30	98	79	2	68	0.0294118
NODE_301737_length_193_cov_29.968085	30	98	81	4	68	0.0588235
NODE_301737_length_193_cov_29.968085	30	98	83	11	68	0.1617647
NODE_301737_length_193_cov_29.968085	30	98	85	1	68	0.0147059
NODE_301737_length_193_cov_29.968085	30	98	88	7	68	0.1029412
NODE_301737_length_193_cov_29.968085	30	98	90	1	68	0.0147059
NODE_301737_length_193_cov_29.968085	30	98	92	4	68	0.0588235
NODE_301737_length_193_cov_29.968085	30	98	93	1	68	0.0147059
NODE_301737_length_193_cov_29.968085	30	98	94	17	68	0.2500000
NODE_301737_length_193_cov_29.968085	146	188	6	5	42	0.1190476
NODE_301737_length_193_cov_29.968085	146	188	8	5	42	0.1190476
NODE_301737_length_193_cov_29.968085	146	188	10	4	42	0.0952381
NODE_301737_length_193_cov_29.968085	146	188	12	2	42	0.0476190
NODE_301737_length_193_cov_29.968085	146	188	14	1	42	0.0238095
NODE_301737_length_193_cov_29.968085	146	188	18	1	42	0.0238095
NODE_301737_length_193_cov_29.968085	146	188	26	1	42	0.0238095
NODE_301737_length_193_cov_29.968085	146	188	28	1	42	0.0238095
NODE_301737_length_193_cov_29.968085	146	188	29	3	42	0.0714286
NODE_301737_length_193_cov_29.968085	146	188	31	1	42	0.0238095
NODE_301737_length_193_cov_29.968085	146	188	40	1	42	0.0238095
NODE_301737_length_193_cov_29.968085	146	188	41	1	42	0.0238095
NODE_301737_length_193_cov_29.968085	146	188	42	1	42	0.0238095
NODE_301737_length_193_cov_29.968085	146	188	49	1	42	0.0238095
NODE_301737_length_193_cov_29.968085	146	188	50	1	42	0.0238095
NODE_301737_length_193_cov_29.968085	146	188	55	2	42	0.0476190
NODE_301737_length_193_cov_29.968085	146	188	58	3	42	0.0714286
NODE_301737_length_193_cov_29.968085	146	188	60	7	42	0.1666667
NODE_301737_length_193_cov_29.968085	146	188	66	1	42	0.0238095
NODE_301776_length_192_cov_160.258065	0	76	2	1	76	0.0131579
NODE_301776_length_192_cov_160.258065	0	76	8	2	76	0.0263158
NODE_301776_length_192_cov_160.258065	0	76	10	4	76	0.0526316
NODE_301776_length_192_cov_160.258065	0	76	18	1	76	0.0131579
NODE_301776_length_192_cov_160.258065	0	76	22	1	76	0.0131579
NODE_301776_length_192_cov_160.258065	0	76	54	1	76	0.0131579
NODE_301776_length_192_cov_160.258065	0	76	58	6	76	0.0789474
NODE_301776_length_192_cov_160.258065	0	76	59	1	76	0.0131579
NODE_301776_length_192_cov_160.258065	0	76	61	1	76	0.0131579
NODE_301776_length_192_cov_160.258065	0	76	63	2	76	0.0263158
NODE_301776_length_192_cov_160.258065	0	76	65	1	76	0.0131579
NODE_301776_length_192_cov_160.258065	0	76	67	1	76	0.0131579
NODE_301776_length_192_cov_160.258065	0	76	73	1	76	0.0131579
NODE_301776_length_192_cov_160.258065	0	76	75	1	76	0.0131579
NODE_301776_length_192_cov_160.258065	0	76	77	1	76	0.0131579
NODE_301776_length_192_cov_160.258065	0	76	81	1	76	0.0131579
NODE_301776_length_192_cov_160.258065	0	76	87	1	76	0.0131579
NODE_301776_length_192_cov_160.258065	0	76	88	2	76	0.0263158
NODE_301776_length_192_cov_160.258065	0	76	90	1	76	0.0131579
NODE_301776_length_192_cov_160.258065	0	76	91	1	76	0.0131579
NODE_301776_length_192_cov_160.258065	0	76	100	1	76	0.0131579
NODE_301776_length_192_cov_160.258065	0	76	102	1	76	0.0131579
NODE_301776_length_192_cov_160.258065	0	76	105	2	76	0.0263158
NODE_301776_length_192_cov_160.258065	0	76	107	2	76	0.0263158
NODE_301776_length_192_cov_160.258065	0	76	112	1	76	0.0131579
NODE_301776_length_192_cov_160.258065	0	76	118	1	76	0.0131579
NODE_301776_length_192_cov_160.258065	0	76	121	1	76	0.0131579
NODE_301776_length_192_cov_160.258065	0	76	139	1	76	0.0131579
NODE_301776_length_192_cov_160.258065	0	76	141	1	76	0.0131579
NODE_301776_length_192_cov_160.258065	0	76	143	1	76	0.0131579
NODE_301776_length_192_cov_160.258065	0	76	149	1	76	0.0131579
NODE_301776_length_192_cov_160.258065	0	76	157	1	76	0.0131579
NODE_301776_length_192_cov_160.258065	0	76	162	1	76	0.0131579
NODE_301776_length_192_cov_160.258065	0	76	174	3	76	0.0394737
NODE_301776_length_192_cov_160.258065	0	76	176	1	76	0.0131579
NODE_301776_length_192_cov_160.258065	0	76	178	1	76	0.0131579
NODE_301776_length_192_cov_160.258065	0	76	180	1	76	0.0131579
NODE_301776_length_192_cov_160.258065	0	76	184	1	76	0.0131579
NODE_301776_length_192_cov_160.258065	0	76	188	1	76	0.0131579
NODE_301776_length_192_cov_160.258065	0	76	194	1	76	0.0131579
NODE_301776_length_192_cov_160.258065	0	76	198	1	76	0.0131579
NODE_301776_length_192_cov_160.258065	0	76	202	1	76	0.0131579
NODE_301776_length_192_cov_160.258065	0	76	204	2	76	0.0263158
NODE_301776_length_192_cov_160.258065	0	76	208	1	76	0.0131579
NODE_301776_length_192_cov_160.258065	0	76	212	1	76	0.0131579
NODE_301776_length_192_cov_160.258065	0	76	222	1	76	0.0131579
NODE_301776_length_192_cov_160.258065	0	76	224	1	76	0.0131579
NODE_301776_length_192_cov_160.258065	0	76	228	1	76	0.0131579
NODE_301776_length_192_cov_160.258065	0	76	232	1	76	0.0131579
NODE_301776_length_192_cov_160.258065	0	76	237	1	76	0.0131579
NODE_301776_length_192_cov_160.258065	0	76	245	1	76	0.0131579
NODE_301776_length_192_cov_160.258065	0	76	259	1	76	0.0131579
NODE_301776_length_192_cov_160.258065	0	76	263	1	76	0.0131579
NODE_301776_length_192_cov_160.258065	0	76	275	1	76	0.0131579
NODE_301776_length_192_cov_160.258065	0	76	279	1	76	0.0131579
NODE_301776_length_192_cov_160.258065	0	76	283	1	76	0.0131579
NODE_301776_length_192_cov_160.258065	0	76	287	1	76	0.0131579
NODE_301776_length_192_cov_160.258065	0	76	308	1	76	0.0131579
NODE_301776_length_192_cov_160.258065	0	76	311	1	76	0.0131579
NODE_301776_length_192_cov_160.258065	0	76	315	1	76	0.0131579
NODE_301825_length_191_cov_92.913043	81	144	0	63	63	1.0000000
NODE_301855_length_190_cov_112.285714	8	91	0	83	83	1.0000000
NODE_301859_length_190_cov_41.373626	92	172	6	8	80	0.1000000
NODE_301859_length_190_cov_41.373626	92	172	8	2	80	0.0250000
NODE_301859_length_190_cov_41.373626	92	172	9	3	80	0.0375000
NODE_301859_length_190_cov_41.373626	92	172	15	6	80	0.0750000
NODE_301859_length_190_cov_41.373626	92	172	16	1	80	0.0125000
NODE_301859_length_190_cov_41.373626	92	172	20	4	80	0.0500000
NODE_301859_length_190_cov_41.373626	92	172	22	4	80	0.0500000
NODE_301859_length_190_cov_41.373626	92	172	24	1	80	0.0125000
NODE_301859_length_190_cov_41.373626	92	172	26	2	80	0.0250000
NODE_301859_length_190_cov_41.373626	92	172	27	2	80	0.0250000
NODE_301859_length_190_cov_41.373626	92	172	28	8	80	0.1000000
NODE_301859_length_190_cov_41.373626	92	172	30	2	80	0.0250000
NODE_301859_length_190_cov_41.373626	92	172	32	10	80	0.1250000
NODE_301859_length_190_cov_41.373626	92	172	34	1	80	0.0125000
NODE_301859_length_190_cov_41.373626	92	172	36	2	80	0.0250000
NODE_301859_length_190_cov_41.373626	92	172	38	3	80	0.0375000
NODE_301859_length_190_cov_41.373626	92	172	40	21	80	0.2625000
NODE_301859_length_190_cov_41.373626	145	190	2	5	45	0.1111111
NODE_301859_length_190_cov_41.373626	145	190	4	13	45	0.2888889
NODE_301859_length_190_cov_41.373626	145	190	6	8	45	0.1777778
NODE_301859_length_190_cov_41.373626	145	190	8	2	45	0.0444444
NODE_301859_length_190_cov_41.373626	145	190	9	3	45	0.0666667
NODE_301859_length_190_cov_41.373626	145	190	15	6	45	0.1333333
NODE_301859_length_190_cov_41.373626	145	190	16	1	45	0.0222222
NODE_301859_length_190_cov_41.373626	145	190	20	4	45	0.0888889
NODE_301859_length_190_cov_41.373626	145	190	22	3	45	0.0666667
NODE_301880_length_189_cov_234.500000	19	88	0	69	69	1.0000000
NODE_301882_length_189_cov_192.211111	134	186	0	52	52	1.0000000
NODE_301885_length_189_cov_70.600000	19	88	0	69	69	1.0000000
NODE_301885_length_189_cov_70.600000	72	156	0	84	84	1.0000000
NODE_301886_length_189_cov_63.455556	70	150	77	1	80	0.0125000
NODE_301886_length_189_cov_63.455556	70	150	80	3	80	0.0375000
NODE_301886_length_189_cov_63.455556	70	150	82	7	80	0.0875000
NODE_301886_length_189_cov_63.455556	70	150	84	2	80	0.0250000
NODE_301886_length_189_cov_63.455556	70	150	85	2	80	0.0250000
NODE_301886_length_189_cov_63.455556	70	150	90	4	80	0.0500000
NODE_301886_length_189_cov_63.455556	70	150	94	3	80	0.0375000
NODE_301886_length_189_cov_63.455556	70	150	95	6	80	0.0750000
NODE_301886_length_189_cov_63.455556	70	150	101	4	80	0.0500000
NODE_301886_length_189_cov_63.455556	70	150	103	2	80	0.0250000
NODE_301886_length_189_cov_63.455556	70	150	105	4	80	0.0500000
NODE_301886_length_189_cov_63.455556	70	150	108	2	80	0.0250000
NODE_301886_length_189_cov_63.455556	70	150	109	1	80	0.0125000
NODE_301886_length_189_cov_63.455556	70	150	110	2	80	0.0250000
NODE_301886_length_189_cov_63.455556	70	150	113	7	80	0.0875000
NODE_301886_length_189_cov_63.455556	70	150	115	1	80	0.0125000
NODE_301886_length_189_cov_63.455556	70	150	116	3	80	0.0375000
NODE_301886_length_189_cov_63.455556	70	150	117	1	80	0.0125000
NODE_301886_length_189_cov_63.455556	70	150	118	3	80	0.0375000
NODE_301886_length_189_cov_63.455556	70	150	119	1	80	0.0125000
NODE_301886_length_189_cov_63.455556	70	150	120	4	80	0.0500000
NODE_301886_length_189_cov_63.455556	70	150	121	11	80	0.1375000
NODE_301886_length_189_cov_63.455556	70	150	122	6	80	0.0750000
NODE_301886_length_189_cov_63.455556	70	141	82	2	71	0.0281690
NODE_301886_length_189_cov_63.455556	70	141	84	2	71	0.0281690
NODE_301886_length_189_cov_63.455556	70	141	85	2	71	0.0281690
NODE_301886_length_189_cov_63.455556	70	141	90	4	71	0.0563380
NODE_301886_length_189_cov_63.455556	70	141	94	3	71	0.0422535
NODE_301886_length_189_cov_63.455556	70	141	95	6	71	0.0845070
NODE_301886_length_189_cov_63.455556	70	141	101	4	71	0.0563380
NODE_301886_length_189_cov_63.455556	70	141	103	2	71	0.0281690
NODE_301886_length_189_cov_63.455556	70	141	105	4	71	0.0563380
NODE_301886_length_189_cov_63.455556	70	141	108	2	71	0.0281690
NODE_301886_length_189_cov_63.455556	70	141	109	1	71	0.0140845
NODE_301886_length_189_cov_63.455556	70	141	110	2	71	0.0281690
NODE_301886_length_189_cov_63.455556	70	141	113	7	71	0.0985916
NODE_301886_length_189_cov_63.455556	70	141	115	1	71	0.0140845
NODE_301886_length_189_cov_63.455556	70	141	116	3	71	0.0422535
NODE_301886_length_189_cov_63.455556	70	141	117	1	71	0.0140845
NODE_301886_length_189_cov_63.455556	70	141	118	3	71	0.0422535
NODE_301886_length_189_cov_63.455556	70	141	119	1	71	0.0140845
NODE_301886_length_189_cov_63.455556	70	141	120	4	71	0.0563380
NODE_301886_length_189_cov_63.455556	70	141	121	11	71	0.1549296
NODE_301886_length_189_cov_63.455556	70	141	122	6	71	0.0845070
NODE_301891_length_189_cov_43.600000	0	73	5	2	73	0.0273973
NODE_301891_length_189_cov_43.600000	0	73	9	1	73	0.0136986
NODE_301891_length_189_cov_43.600000	0	73	11	1	73	0.0136986
NODE_301891_length_189_cov_43.600000	0	73	15	6	73	0.0821918
NODE_301891_length_189_cov_43.600000	0	73	16	1	73	0.0136986
NODE_301891_length_189_cov_43.600000	0	73	17	4	73	0.0547945
NODE_301891_length_189_cov_43.600000	0	73	19	1	73	0.0136986
NODE_301891_length_189_cov_43.600000	0	73	20	1	73	0.0136986
NODE_301891_length_189_cov_43.600000	0	73	22	2	73	0.0273973
NODE_301891_length_189_cov_43.600000	0	73	24	3	73	0.0410959
NODE_301891_length_189_cov_43.600000	0	73	26	1	73	0.0136986
NODE_301891_length_189_cov_43.600000	0	73	28	3	73	0.0410959
NODE_301891_length_189_cov_43.600000	0	73	30	1	73	0.0136986
NODE_301891_length_189_cov_43.600000	0	73	34	1	73	0.0136986
NODE_301891_length_189_cov_43.600000	0	73	40	1	73	0.0136986
NODE_301891_length_189_cov_43.600000	0	73	45	1	73	0.0136986
NODE_301891_length_189_cov_43.600000	0	73	47	1	73	0.0136986
NODE_301891_length_189_cov_43.600000	0	73	51	6	73	0.0821918
NODE_301891_length_189_cov_43.600000	0	73	53	4	73	0.0547945
NODE_301891_length_189_cov_43.600000	0	73	54	1	73	0.0136986
NODE_301891_length_189_cov_43.600000	0	73	55	4	73	0.0547945
NODE_301891_length_189_cov_43.600000	0	73	57	1	73	0.0136986
NODE_301891_length_189_cov_43.600000	0	73	59	1	73	0.0136986
NODE_301891_length_189_cov_43.600000	0	73	60	2	73	0.0273973
NODE_301891_length_189_cov_43.600000	0	73	62	11	73	0.1506849
NODE_301891_length_189_cov_43.600000	0	73	64	1	73	0.0136986
NODE_301891_length_189_cov_43.600000	0	73	66	11	73	0.1506849
NODE_301940_length_188_cov_2021.561798	108	188	23	1	80	0.0125000
NODE_301940_length_188_cov_2021.561798	108	188	24	1	80	0.0125000
NODE_301940_length_188_cov_2021.561798	108	188	40	1	80	0.0125000
NODE_301940_length_188_cov_2021.561798	108	188	51	1	80	0.0125000
NODE_301940_length_188_cov_2021.561798	108	188	91	1	80	0.0125000
NODE_301940_length_188_cov_2021.561798	108	188	93	1	80	0.0125000
NODE_301940_length_188_cov_2021.561798	108	188	148	1	80	0.0125000
NODE_301940_length_188_cov_2021.561798	108	188	151	1	80	0.0125000
NODE_301940_length_188_cov_2021.561798	108	188	161	1	80	0.0125000
NODE_301940_length_188_cov_2021.561798	108	188	169	1	80	0.0125000
NODE_301940_length_188_cov_2021.561798	108	188	179	1	80	0.0125000
NODE_301940_length_188_cov_2021.561798	108	188	193	1	80	0.0125000
NODE_301940_length_188_cov_2021.561798	108	188	209	1	80	0.0125000
NODE_301940_length_188_cov_2021.561798	108	188	215	1	80	0.0125000
NODE_301940_length_188_cov_2021.561798	108	188	241	1	80	0.0125000
NODE_301940_length_188_cov_2021.561798	108	188	251	1	80	0.0125000
NODE_301940_length_188_cov_2021.561798	108	188	252	2	80	0.0250000
NODE_301940_length_188_cov_2021.561798	108	188	273	1	80	0.0125000
NODE_301940_length_188_cov_2021.561798	108	188	276	1	80	0.0125000
NODE_301940_length_188_cov_2021.561798	108	188	280	2	80	0.0250000
NODE_301940_length_188_cov_2021.561798	108	188	283	1	80	0.0125000
NODE_301940_length_188_cov_2021.561798	108	188	287	1	80	0.0125000
NODE_301940_length_188_cov_2021.561798	108	188	316	1	80	0.0125000
NODE_301940_length_188_cov_2021.561798	108	188	324	1	80	0.0125000
NODE_301940_length_188_cov_2021.561798	108	188	336	1	80	0.0125000
NODE_301940_length_188_cov_2021.561798	108	188	342	2	80	0.0250000
NODE_301940_length_188_cov_2021.561798	108	188	350	1	80	0.0125000
NODE_301940_length_188_cov_2021.561798	108	188	358	1	80	0.0125000
NODE_301940_length_188_cov_2021.561798	108	188	363	1	80	0.0125000
NODE_301940_length_188_cov_2021.561798	108	188	372	1	80	0.0125000
NODE_301940_length_188_cov_2021.561798	108	188	378	1	80	0.0125000
NODE_301940_length_188_cov_2021.561798	108	188	381	1	80	0.0125000
NODE_301940_length_188_cov_2021.561798	108	188	387	1	80	0.0125000
NODE_301940_length_188_cov_2021.561798	108	188	389	3	80	0.0375000
NODE_301940_length_188_cov_2021.561798	108	188	390	3	80	0.0375000
NODE_301940_length_188_cov_2021.561798	108	188	391	2	80	0.0250000
NODE_301940_length_188_cov_2021.561798	108	188	394	1	80	0.0125000
NODE_301940_length_188_cov_2021.561798	108	188	396	2	80	0.0250000
NODE_301940_length_188_cov_2021.561798	108	188	398	2	80	0.0250000
NODE_301940_length_188_cov_2021.561798	108	188	404	2	80	0.0250000
NODE_301940_length_188_cov_2021.561798	108	188	414	2	80	0.0250000
NODE_301940_length_188_cov_2021.561798	108	188	422	1	80	0.0125000
NODE_301940_length_188_cov_2021.561798	108	188	423	2	80	0.0250000
NODE_301940_length_188_cov_2021.561798	108	188	426	2	80	0.0250000
NODE_301940_length_188_cov_2021.561798	108	188	427	1	80	0.0125000
NODE_301940_length_188_cov_2021.561798	108	188	429	1	80	0.0125000
NODE_301940_length_188_cov_2021.561798	108	188	431	1	80	0.0125000
NODE_301940_length_188_cov_2021.561798	108	188	435	1	80	0.0125000
NODE_301940_length_188_cov_2021.561798	108	188	438	1	80	0.0125000
NODE_301940_length_188_cov_2021.561798	108	188	440	1	80	0.0125000
NODE_301940_length_188_cov_2021.561798	108	188	443	1	80	0.0125000
NODE_301940_length_188_cov_2021.561798	108	188	450	1	80	0.0125000
NODE_301940_length_188_cov_2021.561798	108	188	454	1	80	0.0125000
NODE_301940_length_188_cov_2021.561798	108	188	456	1	80	0.0125000
NODE_301940_length_188_cov_2021.561798	108	188	459	1	80	0.0125000
NODE_301940_length_188_cov_2021.561798	108	188	461	1	80	0.0125000
NODE_301940_length_188_cov_2021.561798	108	188	464	1	80	0.0125000
NODE_301940_length_188_cov_2021.561798	108	188	465	2	80	0.0250000
NODE_301940_length_188_cov_2021.561798	108	188	466	5	80	0.0625000
NODE_301940_length_188_cov_2021.561798	108	188	468	2	80	0.0250000
NODE_301940_length_188_cov_2021.561798	161	183	93	1	22	0.0454545
NODE_301940_length_188_cov_2021.561798	161	183	148	1	22	0.0454545
NODE_301940_length_188_cov_2021.561798	161	183	151	1	22	0.0454545
NODE_301940_length_188_cov_2021.561798	161	183	161	1	22	0.0454545
NODE_301940_length_188_cov_2021.561798	161	183	169	1	22	0.0454545
NODE_301940_length_188_cov_2021.561798	161	183	179	1	22	0.0454545
NODE_301940_length_188_cov_2021.561798	161	183	193	1	22	0.0454545
NODE_301940_length_188_cov_2021.561798	161	183	209	1	22	0.0454545
NODE_301940_length_188_cov_2021.561798	161	183	215	1	22	0.0454545
NODE_301940_length_188_cov_2021.561798	161	183	241	1	22	0.0454545
NODE_301940_length_188_cov_2021.561798	161	183	251	1	22	0.0454545
NODE_301940_length_188_cov_2021.561798	161	183	252	2	22	0.0909091
NODE_301940_length_188_cov_2021.561798	161	183	273	1	22	0.0454545
NODE_301940_length_188_cov_2021.561798	161	183	276	1	22	0.0454545
NODE_301940_length_188_cov_2021.561798	161	183	280	2	22	0.0909091
NODE_301940_length_188_cov_2021.561798	161	183	283	1	22	0.0454545
NODE_301940_length_188_cov_2021.561798	161	183	287	1	22	0.0454545
NODE_301940_length_188_cov_2021.561798	161	183	316	1	22	0.0454545
NODE_301940_length_188_cov_2021.561798	161	183	324	1	22	0.0454545
NODE_301940_length_188_cov_2021.561798	161	183	336	1	22	0.0454545
NODE_301952_length_188_cov_37.988764	0	50	0	50	50	1.0000000
NODE_301980_length_187_cov_71.170455	124	155	6	1	31	0.0322581
NODE_301980_length_187_cov_71.170455	124	155	8	30	31	0.9677419
NODE_301981_length_187_cov_56.000000	72	136	134	1	64	0.0156250
NODE_301981_length_187_cov_56.000000	72	136	135	3	64	0.0468750
NODE_301981_length_187_cov_56.000000	72	136	140	1	64	0.0156250
NODE_301981_length_187_cov_56.000000	72	136	144	1	64	0.0156250
NODE_301981_length_187_cov_56.000000	72	136	145	2	64	0.0312500
NODE_301981_length_187_cov_56.000000	72	136	149	6	64	0.0937500
NODE_301981_length_187_cov_56.000000	72	136	153	2	64	0.0312500
NODE_301981_length_187_cov_56.000000	72	136	155	3	64	0.0468750
NODE_301981_length_187_cov_56.000000	72	136	157	1	64	0.0156250
NODE_301981_length_187_cov_56.000000	72	136	159	1	64	0.0156250
NODE_301981_length_187_cov_56.000000	72	136	161	1	64	0.0156250
NODE_301981_length_187_cov_56.000000	72	136	165	6	64	0.0937500
NODE_301981_length_187_cov_56.000000	72	136	167	4	64	0.0625000
NODE_301981_length_187_cov_56.000000	72	136	169	2	64	0.0312500
NODE_301981_length_187_cov_56.000000	72	136	171	2	64	0.0312500
NODE_301981_length_187_cov_56.000000	72	136	173	28	64	0.4375000
NODE_301981_length_187_cov_56.000000	72	136	134	1	64	0.0156250
NODE_301981_length_187_cov_56.000000	72	136	135	3	64	0.0468750
NODE_301981_length_187_cov_56.000000	72	136	140	1	64	0.0156250
NODE_301981_length_187_cov_56.000000	72	136	144	1	64	0.0156250
NODE_301981_length_187_cov_56.000000	72	136	145	2	64	0.0312500
NODE_301981_length_187_cov_56.000000	72	136	149	6	64	0.0937500
NODE_301981_length_187_cov_56.000000	72	136	153	2	64	0.0312500
NODE_301981_length_187_cov_56.000000	72	136	155	3	64	0.0468750
NODE_301981_length_187_cov_56.000000	72	136	157	1	64	0.0156250
NODE_301981_length_187_cov_56.000000	72	136	159	1	64	0.0156250
NODE_301981_length_187_cov_56.000000	72	136	161	1	64	0.0156250
NODE_301981_length_187_cov_56.000000	72	136	165	6	64	0.0937500
NODE_301981_length_187_cov_56.000000	72	136	167	4	64	0.0625000
NODE_301981_length_187_cov_56.000000	72	136	169	2	64	0.0312500
NODE_301981_length_187_cov_56.000000	72	136	171	2	64	0.0312500
NODE_301981_length_187_cov_56.000000	72	136	173	28	64	0.4375000
NODE_301981_length_187_cov_56.000000	109	175	37	1	66	0.0151515
NODE_301981_length_187_cov_56.000000	109	175	39	1	66	0.0151515
NODE_301981_length_187_cov_56.000000	109	175	40	1	66	0.0151515
NODE_301981_length_187_cov_56.000000	109	175	41	1	66	0.0151515
NODE_301981_length_187_cov_56.000000	109	175	47	1	66	0.0151515
NODE_301981_length_187_cov_56.000000	109	175	49	1	66	0.0151515
NODE_301981_length_187_cov_56.000000	109	175	53	1	66	0.0151515
NODE_301981_length_187_cov_56.000000	109	175	55	1	66	0.0151515
NODE_301981_length_187_cov_56.000000	109	175	57	1	66	0.0151515
NODE_301981_length_187_cov_56.000000	109	175	60	1	66	0.0151515
NODE_301981_length_187_cov_56.000000	109	175	64	1	66	0.0151515
NODE_301981_length_187_cov_56.000000	109	175	66	2	66	0.0303030
NODE_301981_length_187_cov_56.000000	109	175	72	1	66	0.0151515
NODE_301981_length_187_cov_56.000000	109	175	74	1	66	0.0151515
NODE_301981_length_187_cov_56.000000	109	175	77	1	66	0.0151515
NODE_301981_length_187_cov_56.000000	109	175	78	1	66	0.0151515
NODE_301981_length_187_cov_56.000000	109	175	79	2	66	0.0303030
NODE_301981_length_187_cov_56.000000	109	175	80	2	66	0.0303030
NODE_301981_length_187_cov_56.000000	109	175	81	1	66	0.0151515
NODE_301981_length_187_cov_56.000000	109	175	83	1	66	0.0151515
NODE_301981_length_187_cov_56.000000	109	175	85	1	66	0.0151515
NODE_301981_length_187_cov_56.000000	109	175	88	1	66	0.0151515
NODE_301981_length_187_cov_56.000000	109	175	94	1	66	0.0151515
NODE_301981_length_187_cov_56.000000	109	175	96	1	66	0.0151515
NODE_301981_length_187_cov_56.000000	109	175	98	1	66	0.0151515
NODE_301981_length_187_cov_56.000000	109	175	100	1	66	0.0151515
NODE_301981_length_187_cov_56.000000	109	175	105	1	66	0.0151515
NODE_301981_length_187_cov_56.000000	109	175	108	2	66	0.0303030
NODE_301981_length_187_cov_56.000000	109	175	110	1	66	0.0151515
NODE_301981_length_187_cov_56.000000	109	175	112	1	66	0.0151515
NODE_301981_length_187_cov_56.000000	109	175	114	2	66	0.0303030
NODE_301981_length_187_cov_56.000000	109	175	116	1	66	0.0151515
NODE_301981_length_187_cov_56.000000	109	175	126	2	66	0.0303030
NODE_301981_length_187_cov_56.000000	109	175	134	1	66	0.0151515
NODE_301981_length_187_cov_56.000000	109	175	135	3	66	0.0454545
NODE_301981_length_187_cov_56.000000	109	175	140	1	66	0.0151515
NODE_301981_length_187_cov_56.000000	109	175	144	1	66	0.0151515
NODE_301981_length_187_cov_56.000000	109	175	145	2	66	0.0303030
NODE_301981_length_187_cov_56.000000	109	175	149	6	66	0.0909091
NODE_301981_length_187_cov_56.000000	109	175	153	2	66	0.0303030
NODE_301981_length_187_cov_56.000000	109	175	155	3	66	0.0454545
NODE_301981_length_187_cov_56.000000	109	175	157	1	66	0.0151515
NODE_301981_length_187_cov_56.000000	109	175	159	1	66	0.0151515
NODE_301981_length_187_cov_56.000000	109	175	161	1	66	0.0151515
NODE_301981_length_187_cov_56.000000	109	175	165	2	66	0.0303030
NODE_301981_length_187_cov_56.000000	109	175	167	1	66	0.0151515
NODE_301981_length_187_cov_56.000000	109	175	169	1	66	0.0151515
NODE_301981_length_187_cov_56.000000	109	175	171	1	66	0.0151515
NODE_301981_length_187_cov_56.000000	109	180	32	1	71	0.0140845
NODE_301981_length_187_cov_56.000000	109	180	36	1	71	0.0140845
NODE_301981_length_187_cov_56.000000	109	180	37	4	71	0.0563380
NODE_301981_length_187_cov_56.000000	109	180	39	1	71	0.0140845
NODE_301981_length_187_cov_56.000000	109	180	40	1	71	0.0140845
NODE_301981_length_187_cov_56.000000	109	180	41	1	71	0.0140845
NODE_301981_length_187_cov_56.000000	109	180	47	1	71	0.0140845
NODE_301981_length_187_cov_56.000000	109	180	49	1	71	0.0140845
NODE_301981_length_187_cov_56.000000	109	180	53	1	71	0.0140845
NODE_301981_length_187_cov_56.000000	109	180	55	1	71	0.0140845
NODE_301981_length_187_cov_56.000000	109	180	57	1	71	0.0140845
NODE_301981_length_187_cov_56.000000	109	180	60	1	71	0.0140845
NODE_301981_length_187_cov_56.000000	109	180	64	1	71	0.0140845
NODE_301981_length_187_cov_56.000000	109	180	66	2	71	0.0281690
NODE_301981_length_187_cov_56.000000	109	180	72	1	71	0.0140845
NODE_301981_length_187_cov_56.000000	109	180	74	1	71	0.0140845
NODE_301981_length_187_cov_56.000000	109	180	77	1	71	0.0140845
NODE_301981_length_187_cov_56.000000	109	180	78	1	71	0.0140845
NODE_301981_length_187_cov_56.000000	109	180	79	2	71	0.0281690
NODE_301981_length_187_cov_56.000000	109	180	80	2	71	0.0281690
NODE_301981_length_187_cov_56.000000	109	180	81	1	71	0.0140845
NODE_301981_length_187_cov_56.000000	109	180	83	1	71	0.0140845
NODE_301981_length_187_cov_56.000000	109	180	85	1	71	0.0140845
NODE_301981_length_187_cov_56.000000	109	180	88	1	71	0.0140845
NODE_301981_length_187_cov_56.000000	109	180	94	1	71	0.0140845
NODE_301981_length_187_cov_56.000000	109	180	96	1	71	0.0140845
NODE_301981_length_187_cov_56.000000	109	180	98	1	71	0.0140845
NODE_301981_length_187_cov_56.000000	109	180	100	1	71	0.0140845
NODE_301981_length_187_cov_56.000000	109	180	105	1	71	0.0140845
NODE_301981_length_187_cov_56.000000	109	180	108	2	71	0.0281690
NODE_301981_length_187_cov_56.000000	109	180	110	1	71	0.0140845
NODE_301981_length_187_cov_56.000000	109	180	112	1	71	0.0140845
NODE_301981_length_187_cov_56.000000	109	180	114	2	71	0.0281690
NODE_301981_length_187_cov_56.000000	109	180	116	1	71	0.0140845
NODE_301981_length_187_cov_56.000000	109	180	126	2	71	0.0281690
NODE_301981_length_187_cov_56.000000	109	180	134	1	71	0.0140845
NODE_301981_length_187_cov_56.000000	109	180	135	3	71	0.0422535
NODE_301981_length_187_cov_56.000000	109	180	140	1	71	0.0140845
NODE_301981_length_187_cov_56.000000	109	180	144	1	71	0.0140845
NODE_301981_length_187_cov_56.000000	109	180	145	2	71	0.0281690
NODE_301981_length_187_cov_56.000000	109	180	149	6	71	0.0845070
NODE_301981_length_187_cov_56.000000	109	180	153	2	71	0.0281690
NODE_301981_length_187_cov_56.000000	109	180	155	3	71	0.0422535
NODE_301981_length_187_cov_56.000000	109	180	157	1	71	0.0140845
NODE_301981_length_187_cov_56.000000	109	180	159	1	71	0.0140845
NODE_301981_length_187_cov_56.000000	109	180	161	1	71	0.0140845
NODE_301981_length_187_cov_56.000000	109	180	165	2	71	0.0281690
NODE_301981_length_187_cov_56.000000	109	180	167	1	71	0.0140845
NODE_301981_length_187_cov_56.000000	109	180	169	1	71	0.0140845
NODE_301981_length_187_cov_56.000000	109	180	171	1	71	0.0140845
NODE_301986_length_187_cov_37.397727	4	57	0	21	53	0.3962264
NODE_301986_length_187_cov_37.397727	4	57	6	2	53	0.0377358
NODE_301986_length_187_cov_37.397727	4	57	8	3	53	0.0566038
NODE_301986_length_187_cov_37.397727	4	57	25	1	53	0.0188679
NODE_301986_length_187_cov_37.397727	4	57	30	1	53	0.0188679
NODE_301986_length_187_cov_37.397727	4	57	32	4	53	0.0754717
NODE_301986_length_187_cov_37.397727	4	57	36	1	53	0.0188679
NODE_301986_length_187_cov_37.397727	4	57	48	3	53	0.0566038
NODE_301986_length_187_cov_37.397727	4	57	51	2	53	0.0377358
NODE_301986_length_187_cov_37.397727	4	57	53	3	53	0.0566038
NODE_301986_length_187_cov_37.397727	4	57	56	1	53	0.0188679
NODE_301986_length_187_cov_37.397727	4	57	63	2	53	0.0377358
NODE_301986_length_187_cov_37.397727	4	57	69	2	53	0.0377358
NODE_301986_length_187_cov_37.397727	4	57	79	1	53	0.0188679
NODE_301986_length_187_cov_37.397727	4	57	81	1	53	0.0188679
NODE_301986_length_187_cov_37.397727	4	57	83	1	53	0.0188679
NODE_301986_length_187_cov_37.397727	4	57	85	2	53	0.0377358
NODE_301986_length_187_cov_37.397727	4	57	89	1	53	0.0188679
NODE_301986_length_187_cov_37.397727	4	57	91	1	53	0.0188679
NODE_301986_length_187_cov_37.397727	12	78	0	13	66	0.1969697
NODE_301986_length_187_cov_37.397727	12	78	6	2	66	0.0303030
NODE_301986_length_187_cov_37.397727	12	78	8	3	66	0.0454545
NODE_301986_length_187_cov_37.397727	12	78	25	1	66	0.0151515
NODE_301986_length_187_cov_37.397727	12	78	30	1	66	0.0151515
NODE_301986_length_187_cov_37.397727	12	78	32	4	66	0.0606061
NODE_301986_length_187_cov_37.397727	12	78	36	1	66	0.0151515
NODE_301986_length_187_cov_37.397727	12	78	48	3	66	0.0454545
NODE_301986_length_187_cov_37.397727	12	78	51	2	66	0.0303030
NODE_301986_length_187_cov_37.397727	12	78	53	3	66	0.0454545
NODE_301986_length_187_cov_37.397727	12	78	56	1	66	0.0151515
NODE_301986_length_187_cov_37.397727	12	78	63	2	66	0.0303030
NODE_301986_length_187_cov_37.397727	12	78	69	2	66	0.0303030
NODE_301986_length_187_cov_37.397727	12	78	79	1	66	0.0151515
NODE_301986_length_187_cov_37.397727	12	78	81	1	66	0.0151515
NODE_301986_length_187_cov_37.397727	12	78	83	1	66	0.0151515
NODE_301986_length_187_cov_37.397727	12	78	85	2	66	0.0303030
NODE_301986_length_187_cov_37.397727	12	78	89	1	66	0.0151515
NODE_301986_length_187_cov_37.397727	12	78	91	1	66	0.0151515
NODE_301986_length_187_cov_37.397727	12	78	93	1	66	0.0151515
NODE_301986_length_187_cov_37.397727	12	78	97	1	66	0.0151515
NODE_301986_length_187_cov_37.397727	12	78	101	2	66	0.0303030
NODE_301986_length_187_cov_37.397727	12	78	103	2	66	0.0303030
NODE_301986_length_187_cov_37.397727	12	78	105	2	66	0.0303030
NODE_301986_length_187_cov_37.397727	12	78	111	1	66	0.0151515
NODE_301986_length_187_cov_37.397727	12	78	113	1	66	0.0151515
NODE_301986_length_187_cov_37.397727	12	78	117	1	66	0.0151515
NODE_301986_length_187_cov_37.397727	12	78	119	8	66	0.1212121
NODE_301986_length_187_cov_37.397727	12	78	120	2	66	0.0303030
NODE_301986_length_187_cov_37.397727	51	112	81	1	61	0.0163934
NODE_301986_length_187_cov_37.397727	51	112	83	1	61	0.0163934
NODE_301986_length_187_cov_37.397727	51	112	85	2	61	0.0327869
NODE_301986_length_187_cov_37.397727	51	112	89	1	61	0.0163934
NODE_301986_length_187_cov_37.397727	51	112	91	1	61	0.0163934
NODE_301986_length_187_cov_37.397727	51	112	93	1	61	0.0163934
NODE_301986_length_187_cov_37.397727	51	112	97	1	61	0.0163934
NODE_301986_length_187_cov_37.397727	51	112	101	2	61	0.0327869
NODE_301986_length_187_cov_37.397727	51	112	103	2	61	0.0327869
NODE_301986_length_187_cov_37.397727	51	112	105	2	61	0.0327869
NODE_301986_length_187_cov_37.397727	51	112	111	1	61	0.0163934
NODE_301986_length_187_cov_37.397727	51	112	113	1	61	0.0163934
NODE_301986_length_187_cov_37.397727	51	112	116	3	61	0.0491803
NODE_301986_length_187_cov_37.397727	51	112	117	1	61	0.0163934
NODE_301986_length_187_cov_37.397727	51	112	118	1	61	0.0163934
NODE_301986_length_187_cov_37.397727	51	112	119	8	61	0.1311475
NODE_301986_length_187_cov_37.397727	51	112	120	32	61	0.5245901
NODE_301986_length_187_cov_37.397727	51	114	81	1	63	0.0158730
NODE_301986_length_187_cov_37.397727	51	114	83	1	63	0.0158730
NODE_301986_length_187_cov_37.397727	51	114	85	2	63	0.0317460
NODE_301986_length_187_cov_37.397727	51	114	89	1	63	0.0158730
NODE_301986_length_187_cov_37.397727	51	114	91	1	63	0.0158730
NODE_301986_length_187_cov_37.397727	51	114	93	1	63	0.0158730
NODE_301986_length_187_cov_37.397727	51	114	97	1	63	0.0158730
NODE_301986_length_187_cov_37.397727	51	114	101	2	63	0.0317460
NODE_301986_length_187_cov_37.397727	51	114	103	2	63	0.0317460
NODE_301986_length_187_cov_37.397727	51	114	105	2	63	0.0317460
NODE_301986_length_187_cov_37.397727	51	114	111	1	63	0.0158730
NODE_301986_length_187_cov_37.397727	51	114	113	1	63	0.0158730
NODE_301986_length_187_cov_37.397727	51	114	116	5	63	0.0793651
NODE_301986_length_187_cov_37.397727	51	114	117	1	63	0.0158730
NODE_301986_length_187_cov_37.397727	51	114	118	1	63	0.0158730
NODE_301986_length_187_cov_37.397727	51	114	119	8	63	0.1269841
NODE_301986_length_187_cov_37.397727	51	114	120	32	63	0.5079365
NODE_302020_length_186_cov_309.620690	20	104	0	84	84	1.0000000
NODE_302021_length_186_cov_295.505747	57	115	92	1	58	0.0172414
NODE_302021_length_186_cov_295.505747	57	115	94	2	58	0.0344828
NODE_302021_length_186_cov_295.505747	57	115	96	2	58	0.0344828
NODE_302021_length_186_cov_295.505747	57	115	98	2	58	0.0344828
NODE_302021_length_186_cov_295.505747	57	115	102	1	58	0.0172414
NODE_302021_length_186_cov_295.505747	57	115	104	1	58	0.0172414
NODE_302021_length_186_cov_295.505747	57	115	108	3	58	0.0517241
NODE_302021_length_186_cov_295.505747	57	115	110	3	58	0.0517241
NODE_302021_length_186_cov_295.505747	57	115	111	2	58	0.0344828
NODE_302021_length_186_cov_295.505747	57	115	112	11	58	0.1896552
NODE_302021_length_186_cov_295.505747	57	115	114	30	58	0.5172414
NODE_302021_length_186_cov_295.505747	101	168	20	6	67	0.0895522
NODE_302021_length_186_cov_295.505747	101	168	22	1	67	0.0149254
NODE_302021_length_186_cov_295.505747	101	168	24	1	67	0.0149254
NODE_302021_length_186_cov_295.505747	101	168	28	2	67	0.0298507
NODE_302021_length_186_cov_295.505747	101	168	33	2	67	0.0298507
NODE_302021_length_186_cov_295.505747	101	168	46	2	67	0.0298507
NODE_302021_length_186_cov_295.505747	101	168	48	4	67	0.0597015
NODE_302021_length_186_cov_295.505747	101	168	56	1	67	0.0149254
NODE_302021_length_186_cov_295.505747	101	168	58	2	67	0.0298507
NODE_302021_length_186_cov_295.505747	101	168	61	1	67	0.0149254
NODE_302021_length_186_cov_295.505747	101	168	73	2	67	0.0298507
NODE_302021_length_186_cov_295.505747	101	168	76	2	67	0.0298507
NODE_302021_length_186_cov_295.505747	101	168	78	2	67	0.0298507
NODE_302021_length_186_cov_295.505747	101	168	88	1	67	0.0149254
NODE_302021_length_186_cov_295.505747	101	168	90	4	67	0.0597015
NODE_302021_length_186_cov_295.505747	101	168	94	3	67	0.0447761
NODE_302021_length_186_cov_295.505747	101	168	96	1	67	0.0149254
NODE_302021_length_186_cov_295.505747	101	168	98	5	67	0.0746269
NODE_302021_length_186_cov_295.505747	101	168	100	1	67	0.0149254
NODE_302021_length_186_cov_295.505747	101	168	104	3	67	0.0447761
NODE_302021_length_186_cov_295.505747	101	168	106	1	67	0.0149254
NODE_302021_length_186_cov_295.505747	101	168	110	7	67	0.1044776
NODE_302021_length_186_cov_295.505747	101	168	111	2	67	0.0298507
NODE_302021_length_186_cov_295.505747	101	168	112	9	67	0.1343284
NODE_302021_length_186_cov_295.505747	101	168	114	2	67	0.0298507
NODE_302025_length_186_cov_61.344828	38	118	30	3	80	0.0375000
NODE_302025_length_186_cov_61.344828	38	118	36	3	80	0.0375000
NODE_302025_length_186_cov_61.344828	38	118	38	2	80	0.0250000
NODE_302025_length_186_cov_61.344828	38	118	40	3	80	0.0375000
NODE_302025_length_186_cov_61.344828	38	118	50	9	80	0.1125000
NODE_302025_length_186_cov_61.344828	38	118	54	6	80	0.0750000
NODE_302025_length_186_cov_61.344828	38	118	56	3	80	0.0375000
NODE_302025_length_186_cov_61.344828	38	118	58	4	80	0.0500000
NODE_302025_length_186_cov_61.344828	38	118	62	3	80	0.0375000
NODE_302025_length_186_cov_61.344828	38	118	64	2	80	0.0250000
NODE_302025_length_186_cov_61.344828	38	118	66	5	80	0.0625000
NODE_302025_length_186_cov_61.344828	38	118	68	1	80	0.0125000
NODE_302025_length_186_cov_61.344828	38	118	70	36	80	0.4500000
NODE_302025_length_186_cov_61.344828	91	171	30	1	80	0.0125000
NODE_302025_length_186_cov_61.344828	91	171	34	5	80	0.0625000
NODE_302025_length_186_cov_61.344828	91	171	36	1	80	0.0125000
NODE_302025_length_186_cov_61.344828	91	171	40	1	80	0.0125000
NODE_302025_length_186_cov_61.344828	91	171	44	3	80	0.0375000
NODE_302025_length_186_cov_61.344828	91	171	46	1	80	0.0125000
NODE_302025_length_186_cov_61.344828	91	171	48	1	80	0.0125000
NODE_302025_length_186_cov_61.344828	91	171	50	3	80	0.0375000
NODE_302025_length_186_cov_61.344828	91	171	54	1	80	0.0125000
NODE_302025_length_186_cov_61.344828	91	171	56	3	80	0.0375000
NODE_302025_length_186_cov_61.344828	91	171	58	5	80	0.0625000
NODE_302025_length_186_cov_61.344828	91	171	60	8	80	0.1000000
NODE_302025_length_186_cov_61.344828	91	171	62	3	80	0.0375000
NODE_302025_length_186_cov_61.344828	91	171	64	4	80	0.0500000
NODE_302025_length_186_cov_61.344828	91	171	66	17	80	0.2125000
NODE_302025_length_186_cov_61.344828	91	171	68	1	80	0.0125000
NODE_302025_length_186_cov_61.344828	91	171	70	22	80	0.2750000
NODE_302201_length_182_cov_127.759036	6	52	18	5	46	0.1086956
NODE_302201_length_182_cov_127.759036	6	52	24	1	46	0.0217391
NODE_302201_length_182_cov_127.759036	6	52	31	2	46	0.0434783
NODE_302201_length_182_cov_127.759036	6	52	35	1	46	0.0217391
NODE_302201_length_182_cov_127.759036	6	52	39	2	46	0.0434783
NODE_302201_length_182_cov_127.759036	6	52	43	2	46	0.0434783
NODE_302201_length_182_cov_127.759036	6	52	45	4	46	0.0869565
NODE_302201_length_182_cov_127.759036	6	52	49	3	46	0.0652174
NODE_302201_length_182_cov_127.759036	6	52	54	1	46	0.0217391
NODE_302201_length_182_cov_127.759036	6	52	56	2	46	0.0434783
NODE_302201_length_182_cov_127.759036	6	52	60	1	46	0.0217391
NODE_302201_length_182_cov_127.759036	6	52	68	6	46	0.1304348
NODE_302201_length_182_cov_127.759036	6	52	69	2	46	0.0434783
NODE_302201_length_182_cov_127.759036	6	52	71	4	46	0.0869565
NODE_302201_length_182_cov_127.759036	6	52	72	4	46	0.0869565
NODE_302201_length_182_cov_127.759036	6	52	73	4	46	0.0869565
NODE_302201_length_182_cov_127.759036	6	52	76	2	46	0.0434783
NODE_302201_length_182_cov_127.759036	59	105	117	1	46	0.0217391
NODE_302201_length_182_cov_127.759036	59	105	122	2	46	0.0434783
NODE_302201_length_182_cov_127.759036	59	105	128	1	46	0.0217391
NODE_302201_length_182_cov_127.759036	59	105	134	9	46	0.1956522
NODE_302201_length_182_cov_127.759036	59	105	136	2	46	0.0434783
NODE_302201_length_182_cov_127.759036	59	105	138	3	46	0.0652174
NODE_302201_length_182_cov_127.759036	59	105	140	1	46	0.0217391
NODE_302201_length_182_cov_127.759036	59	105	142	2	46	0.0434783
NODE_302201_length_182_cov_127.759036	59	105	144	2	46	0.0434783
NODE_302201_length_182_cov_127.759036	59	105	146	23	46	0.5000000
NODE_302214_length_182_cov_29.421687	5	35	0	9	30	0.3000000
NODE_302214_length_182_cov_29.421687	5	35	2	7	30	0.2333333
NODE_302214_length_182_cov_29.421687	5	35	6	14	30	0.4666667
NODE_302214_length_182_cov_29.421687	8	88	0	6	80	0.0750000
NODE_302214_length_182_cov_29.421687	8	88	2	7	80	0.0875000
NODE_302214_length_182_cov_29.421687	8	88	6	24	80	0.3000000
NODE_302214_length_182_cov_29.421687	8	88	8	18	80	0.2250000
NODE_302214_length_182_cov_29.421687	8	88	12	25	80	0.3125000
NODE_302236_length_181_cov_141.195122	1	60	0	30	59	0.5084746
NODE_302236_length_181_cov_141.195122	1	60	1	15	59	0.2542373
NODE_302236_length_181_cov_141.195122	1	60	2	14	59	0.2372881
NODE_302236_length_181_cov_141.195122	34	60	1	12	26	0.4615385
NODE_302236_length_181_cov_141.195122	34	60	2	14	26	0.5384616
NODE_302236_length_181_cov_141.195122	114	145	2	31	31	1.0000000
NODE_302285_length_180_cov_102.567901	6	75	20	1	69	0.0144928
NODE_302285_length_180_cov_102.567901	6	75	22	6	69	0.0869565
NODE_302285_length_180_cov_102.567901	6	75	28	3	69	0.0434783
NODE_302285_length_180_cov_102.567901	6	75	30	3	69	0.0434783
NODE_302285_length_180_cov_102.567901	6	75	34	1	69	0.0144928
NODE_302285_length_180_cov_102.567901	6	75	36	1	69	0.0144928
NODE_302285_length_180_cov_102.567901	6	75	38	3	69	0.0434783
NODE_302285_length_180_cov_102.567901	6	75	44	4	69	0.0579710
NODE_302285_length_180_cov_102.567901	6	75	46	1	69	0.0144928
NODE_302285_length_180_cov_102.567901	6	75	57	1	69	0.0144928
NODE_302285_length_180_cov_102.567901	6	75	58	2	69	0.0289855
NODE_302285_length_180_cov_102.567901	6	75	60	2	69	0.0289855
NODE_302285_length_180_cov_102.567901	6	75	74	1	69	0.0144928
NODE_302285_length_180_cov_102.567901	6	75	87	1	69	0.0144928
NODE_302285_length_180_cov_102.567901	6	75	100	1	69	0.0144928
NODE_302285_length_180_cov_102.567901	6	75	103	1	69	0.0144928
NODE_302285_length_180_cov_102.567901	6	75	106	1	69	0.0144928
NODE_302285_length_180_cov_102.567901	6	75	116	1	69	0.0144928
NODE_302285_length_180_cov_102.567901	6	75	124	1	69	0.0144928
NODE_302285_length_180_cov_102.567901	6	75	132	1	69	0.0144928
NODE_302285_length_180_cov_102.567901	6	75	135	1	69	0.0144928
NODE_302285_length_180_cov_102.567901	6	75	139	1	69	0.0144928
NODE_302285_length_180_cov_102.567901	6	75	145	1	69	0.0144928
NODE_302285_length_180_cov_102.567901	6	75	152	2	69	0.0289855
NODE_302285_length_180_cov_102.567901	6	75	155	2	69	0.0289855
NODE_302285_length_180_cov_102.567901	6	75	160	1	69	0.0144928
NODE_302285_length_180_cov_102.567901	6	75	168	1	69	0.0144928
NODE_302285_length_180_cov_102.567901	6	75	174	1	69	0.0144928
NODE_302285_length_180_cov_102.567901	6	75	175	4	69	0.0579710
NODE_302285_length_180_cov_102.567901	6	75	181	2	69	0.0289855
NODE_302285_length_180_cov_102.567901	6	75	187	2	69	0.0289855
NODE_302285_length_180_cov_102.567901	6	75	189	1	69	0.0144928
NODE_302285_length_180_cov_102.567901	6	75	191	4	69	0.0579710
NODE_302285_length_180_cov_102.567901	6	75	195	4	69	0.0579710
NODE_302285_length_180_cov_102.567901	6	75	197	1	69	0.0144928
NODE_302285_length_180_cov_102.567901	6	75	199	1	69	0.0144928
NODE_302285_length_180_cov_102.567901	6	75	201	4	69	0.0579710
NODE_302363_length_178_cov_93.620253	81	112	10	31	31	1.0000000
NODE_302365_length_178_cov_62.696203	0	78	4	1	78	0.0128205
NODE_302365_length_178_cov_62.696203	0	78	7	7	78	0.0897436
NODE_302365_length_178_cov_62.696203	0	78	11	2	78	0.0256410
NODE_302365_length_178_cov_62.696203	0	78	15	6	78	0.0769231
NODE_302365_length_178_cov_62.696203	0	78	16	1	78	0.0128205
NODE_302365_length_178_cov_62.696203	0	78	17	3	78	0.0384615
NODE_302365_length_178_cov_62.696203	0	78	19	1	78	0.0128205
NODE_302365_length_178_cov_62.696203	0	78	27	1	78	0.0128205
NODE_302365_length_178_cov_62.696203	0	78	31	1	78	0.0128205
NODE_302365_length_178_cov_62.696203	0	78	33	3	78	0.0384615
NODE_302365_length_178_cov_62.696203	0	78	34	3	78	0.0384615
NODE_302365_length_178_cov_62.696203	0	78	36	1	78	0.0128205
NODE_302365_length_178_cov_62.696203	0	78	38	7	78	0.0897436
NODE_302365_length_178_cov_62.696203	0	78	42	2	78	0.0256410
NODE_302365_length_178_cov_62.696203	0	78	44	4	78	0.0512821
NODE_302365_length_178_cov_62.696203	0	78	46	13	78	0.1666667
NODE_302365_length_178_cov_62.696203	0	78	50	2	78	0.0256410
NODE_302365_length_178_cov_62.696203	0	78	52	3	78	0.0384615
NODE_302365_length_178_cov_62.696203	0	78	56	17	78	0.2179487
NODE_302365_length_178_cov_62.696203	51	131	46	5	80	0.0625000
NODE_302365_length_178_cov_62.696203	51	131	48	3	80	0.0375000
NODE_302365_length_178_cov_62.696203	51	131	50	3	80	0.0375000
NODE_302365_length_178_cov_62.696203	51	131	52	7	80	0.0875000
NODE_302365_length_178_cov_62.696203	51	131	56	62	80	0.7750000
NODE_302477_length_175_cov_116.684211	42	122	0	80	80	1.0000000
NODE_302477_length_175_cov_116.684211	95	175	0	80	80	1.0000000
NODE_302482_length_175_cov_61.000000	81	121	218	1	40	0.0250000
NODE_302482_length_175_cov_61.000000	81	121	220	2	40	0.0500000
NODE_302482_length_175_cov_61.000000	81	121	224	1	40	0.0250000
NODE_302482_length_175_cov_61.000000	81	121	226	1	40	0.0250000
NODE_302482_length_175_cov_61.000000	81	121	230	2	40	0.0500000
NODE_302482_length_175_cov_61.000000	81	121	234	2	40	0.0500000
NODE_302482_length_175_cov_61.000000	81	121	236	2	40	0.0500000
NODE_302482_length_175_cov_61.000000	81	121	238	1	40	0.0250000
NODE_302482_length_175_cov_61.000000	81	121	240	2	40	0.0500000
NODE_302482_length_175_cov_61.000000	81	121	242	3	40	0.0750000
NODE_302482_length_175_cov_61.000000	81	121	244	23	40	0.5750000
NODE_302538_length_174_cov_173.893333	53	93	335	1	40	0.0250000
NODE_302538_length_174_cov_173.893333	53	93	339	1	40	0.0250000
NODE_302538_length_174_cov_173.893333	53	93	343	3	40	0.0750000
NODE_302538_length_174_cov_173.893333	53	93	347	1	40	0.0250000
NODE_302538_length_174_cov_173.893333	53	93	349	1	40	0.0250000
NODE_302538_length_174_cov_173.893333	53	93	360	1	40	0.0250000
NODE_302538_length_174_cov_173.893333	53	93	361	1	40	0.0250000
NODE_302538_length_174_cov_173.893333	53	93	371	2	40	0.0500000
NODE_302538_length_174_cov_173.893333	53	93	375	1	40	0.0250000
NODE_302538_length_174_cov_173.893333	53	93	377	1	40	0.0250000
NODE_302538_length_174_cov_173.893333	53	93	379	2	40	0.0500000
NODE_302538_length_174_cov_173.893333	53	93	381	2	40	0.0500000
NODE_302538_length_174_cov_173.893333	53	93	383	1	40	0.0250000
NODE_302538_length_174_cov_173.893333	53	93	387	5	40	0.1250000
NODE_302538_length_174_cov_173.893333	53	93	389	17	40	0.4250000
NODE_302543_length_174_cov_50.346667	91	161	11	3	70	0.0428571
NODE_302543_length_174_cov_50.346667	91	161	14	8	70	0.1142857
NODE_302543_length_174_cov_50.346667	91	161	18	7	70	0.1000000
NODE_302543_length_174_cov_50.346667	91	161	20	2	70	0.0285714
NODE_302543_length_174_cov_50.346667	91	161	25	1	70	0.0142857
NODE_302543_length_174_cov_50.346667	91	161	26	2	70	0.0285714
NODE_302543_length_174_cov_50.346667	91	161	28	4	70	0.0571429
NODE_302543_length_174_cov_50.346667	91	161	30	2	70	0.0285714
NODE_302543_length_174_cov_50.346667	91	161	33	2	70	0.0285714
NODE_302543_length_174_cov_50.346667	91	161	34	3	70	0.0428571
NODE_302543_length_174_cov_50.346667	91	161	36	3	70	0.0428571
NODE_302543_length_174_cov_50.346667	91	161	38	1	70	0.0142857
NODE_302543_length_174_cov_50.346667	91	161	40	2	70	0.0285714
NODE_302543_length_174_cov_50.346667	91	161	44	2	70	0.0285714
NODE_302543_length_174_cov_50.346667	91	161	46	2	70	0.0285714
NODE_302543_length_174_cov_50.346667	91	161	56	3	70	0.0428571
NODE_302543_length_174_cov_50.346667	91	161	58	1	70	0.0142857
NODE_302543_length_174_cov_50.346667	91	161	60	22	70	0.3142857
NODE_302590_length_173_cov_184.351351	62	126	152	1	64	0.0156250
NODE_302590_length_173_cov_184.351351	62	126	154	1	64	0.0156250
NODE_302590_length_173_cov_184.351351	62	126	156	1	64	0.0156250
NODE_302590_length_173_cov_184.351351	62	126	157	2	64	0.0312500
NODE_302590_length_173_cov_184.351351	62	126	161	1	64	0.0156250
NODE_302590_length_173_cov_184.351351	62	126	167	2	64	0.0312500
NODE_302590_length_173_cov_184.351351	62	126	173	2	64	0.0312500
NODE_302590_length_173_cov_184.351351	62	126	183	1	64	0.0156250
NODE_302590_length_173_cov_184.351351	62	126	186	1	64	0.0156250
NODE_302590_length_173_cov_184.351351	62	126	196	2	64	0.0312500
NODE_302590_length_173_cov_184.351351	62	126	208	2	64	0.0312500
NODE_302590_length_173_cov_184.351351	62	126	210	4	64	0.0625000
NODE_302590_length_173_cov_184.351351	62	126	216	1	64	0.0156250
NODE_302590_length_173_cov_184.351351	62	126	217	36	64	0.5625000
NODE_302590_length_173_cov_184.351351	62	126	218	7	64	0.1093750
NODE_302590_length_173_cov_184.351351	62	126	152	1	64	0.0156250
NODE_302590_length_173_cov_184.351351	62	126	154	1	64	0.0156250
NODE_302590_length_173_cov_184.351351	62	126	156	1	64	0.0156250
NODE_302590_length_173_cov_184.351351	62	126	157	2	64	0.0312500
NODE_302590_length_173_cov_184.351351	62	126	161	1	64	0.0156250
NODE_302590_length_173_cov_184.351351	62	126	167	2	64	0.0312500
NODE_302590_length_173_cov_184.351351	62	126	173	2	64	0.0312500
NODE_302590_length_173_cov_184.351351	62	126	183	1	64	0.0156250
NODE_302590_length_173_cov_184.351351	62	126	186	1	64	0.0156250
NODE_302590_length_173_cov_184.351351	62	126	196	2	64	0.0312500
NODE_302590_length_173_cov_184.351351	62	126	208	2	64	0.0312500
NODE_302590_length_173_cov_184.351351	62	126	210	4	64	0.0625000
NODE_302590_length_173_cov_184.351351	62	126	216	1	64	0.0156250
NODE_302590_length_173_cov_184.351351	62	126	217	36	64	0.5625000
NODE_302590_length_173_cov_184.351351	62	126	218	7	64	0.1093750
NODE_302590_length_173_cov_184.351351	62	126	152	1	64	0.0156250
NODE_302590_length_173_cov_184.351351	62	126	154	1	64	0.0156250
NODE_302590_length_173_cov_184.351351	62	126	156	1	64	0.0156250
NODE_302590_length_173_cov_184.351351	62	126	157	2	64	0.0312500
NODE_302590_length_173_cov_184.351351	62	126	161	1	64	0.0156250
NODE_302590_length_173_cov_184.351351	62	126	167	2	64	0.0312500
NODE_302590_length_173_cov_184.351351	62	126	173	2	64	0.0312500
NODE_302590_length_173_cov_184.351351	62	126	183	1	64	0.0156250
NODE_302590_length_173_cov_184.351351	62	126	186	1	64	0.0156250
NODE_302590_length_173_cov_184.351351	62	126	196	2	64	0.0312500
NODE_302590_length_173_cov_184.351351	62	126	208	2	64	0.0312500
NODE_302590_length_173_cov_184.351351	62	126	210	4	64	0.0625000
NODE_302590_length_173_cov_184.351351	62	126	216	1	64	0.0156250
NODE_302590_length_173_cov_184.351351	62	126	217	36	64	0.5625000
NODE_302590_length_173_cov_184.351351	62	126	218	7	64	0.1093750
NODE_302590_length_173_cov_184.351351	62	126	152	1	64	0.0156250
NODE_302590_length_173_cov_184.351351	62	126	154	1	64	0.0156250
NODE_302590_length_173_cov_184.351351	62	126	156	1	64	0.0156250
NODE_302590_length_173_cov_184.351351	62	126	157	2	64	0.0312500
NODE_302590_length_173_cov_184.351351	62	126	161	1	64	0.0156250
NODE_302590_length_173_cov_184.351351	62	126	167	2	64	0.0312500
NODE_302590_length_173_cov_184.351351	62	126	173	2	64	0.0312500
NODE_302590_length_173_cov_184.351351	62	126	183	1	64	0.0156250
NODE_302590_length_173_cov_184.351351	62	126	186	1	64	0.0156250
NODE_302590_length_173_cov_184.351351	62	126	196	2	64	0.0312500
NODE_302590_length_173_cov_184.351351	62	126	208	2	64	0.0312500
NODE_302590_length_173_cov_184.351351	62	126	210	4	64	0.0625000
NODE_302590_length_173_cov_184.351351	62	126	216	1	64	0.0156250
NODE_302590_length_173_cov_184.351351	62	126	217	36	64	0.5625000
NODE_302590_length_173_cov_184.351351	62	126	218	7	64	0.1093750
NODE_302590_length_173_cov_184.351351	99	165	53	1	66	0.0151515
NODE_302590_length_173_cov_184.351351	99	165	55	1	66	0.0151515
NODE_302590_length_173_cov_184.351351	99	165	57	1	66	0.0151515
NODE_302590_length_173_cov_184.351351	99	165	59	1	66	0.0151515
NODE_302590_length_173_cov_184.351351	99	165	66	1	66	0.0151515
NODE_302590_length_173_cov_184.351351	99	165	72	1	66	0.0151515
NODE_302590_length_173_cov_184.351351	99	165	76	2	66	0.0303030
NODE_302590_length_173_cov_184.351351	99	165	80	6	66	0.0909091
NODE_302590_length_173_cov_184.351351	99	165	81	1	66	0.0151515
NODE_302590_length_173_cov_184.351351	99	165	83	2	66	0.0303030
NODE_302590_length_173_cov_184.351351	99	165	84	5	66	0.0757576
NODE_302590_length_173_cov_184.351351	99	165	92	2	66	0.0303030
NODE_302590_length_173_cov_184.351351	99	165	97	1	66	0.0151515
NODE_302590_length_173_cov_184.351351	99	165	99	2	66	0.0303030
NODE_302590_length_173_cov_184.351351	99	165	101	1	66	0.0151515
NODE_302590_length_173_cov_184.351351	99	165	103	1	66	0.0151515
NODE_302590_length_173_cov_184.351351	99	165	109	1	66	0.0151515
NODE_302590_length_173_cov_184.351351	99	165	117	2	66	0.0303030
NODE_302590_length_173_cov_184.351351	99	165	125	1	66	0.0151515
NODE_302590_length_173_cov_184.351351	99	165	129	1	66	0.0151515
NODE_302590_length_173_cov_184.351351	99	165	133	1	66	0.0151515
NODE_302590_length_173_cov_184.351351	99	165	139	2	66	0.0303030
NODE_302590_length_173_cov_184.351351	99	165	146	1	66	0.0151515
NODE_302590_length_173_cov_184.351351	99	165	150	1	66	0.0151515
NODE_302590_length_173_cov_184.351351	99	165	152	1	66	0.0151515
NODE_302590_length_173_cov_184.351351	99	165	154	1	66	0.0151515
NODE_302590_length_173_cov_184.351351	99	165	156	1	66	0.0151515
NODE_302590_length_173_cov_184.351351	99	165	157	2	66	0.0303030
NODE_302590_length_173_cov_184.351351	99	165	161	1	66	0.0151515
NODE_302590_length_173_cov_184.351351	99	165	167	2	66	0.0303030
NODE_302590_length_173_cov_184.351351	99	165	173	2	66	0.0303030
NODE_302590_length_173_cov_184.351351	99	165	183	1	66	0.0151515
NODE_302590_length_173_cov_184.351351	99	165	186	1	66	0.0151515
NODE_302590_length_173_cov_184.351351	99	165	196	2	66	0.0303030
NODE_302590_length_173_cov_184.351351	99	165	208	2	66	0.0303030
NODE_302590_length_173_cov_184.351351	99	165	210	4	66	0.0606061
NODE_302590_length_173_cov_184.351351	99	165	216	1	66	0.0151515
NODE_302590_length_173_cov_184.351351	99	165	218	6	66	0.0909091
NODE_302590_length_173_cov_184.351351	99	170	37	1	71	0.0140845
NODE_302590_length_173_cov_184.351351	99	170	45	3	71	0.0422535
NODE_302590_length_173_cov_184.351351	99	170	49	1	71	0.0140845
NODE_302590_length_173_cov_184.351351	99	170	53	1	71	0.0140845
NODE_302590_length_173_cov_184.351351	99	170	55	1	71	0.0140845
NODE_302590_length_173_cov_184.351351	99	170	57	1	71	0.0140845
NODE_302590_length_173_cov_184.351351	99	170	59	1	71	0.0140845
NODE_302590_length_173_cov_184.351351	99	170	66	1	71	0.0140845
NODE_302590_length_173_cov_184.351351	99	170	72	1	71	0.0140845
NODE_302590_length_173_cov_184.351351	99	170	76	2	71	0.0281690
NODE_302590_length_173_cov_184.351351	99	170	80	6	71	0.0845070
NODE_302590_length_173_cov_184.351351	99	170	81	1	71	0.0140845
NODE_302590_length_173_cov_184.351351	99	170	83	2	71	0.0281690
NODE_302590_length_173_cov_184.351351	99	170	84	5	71	0.0704225
NODE_302590_length_173_cov_184.351351	99	170	92	2	71	0.0281690
NODE_302590_length_173_cov_184.351351	99	170	97	1	71	0.0140845
NODE_302590_length_173_cov_184.351351	99	170	99	2	71	0.0281690
NODE_302590_length_173_cov_184.351351	99	170	101	1	71	0.0140845
NODE_302590_length_173_cov_184.351351	99	170	103	1	71	0.0140845
NODE_302590_length_173_cov_184.351351	99	170	109	1	71	0.0140845
NODE_302590_length_173_cov_184.351351	99	170	117	2	71	0.0281690
NODE_302590_length_173_cov_184.351351	99	170	125	1	71	0.0140845
NODE_302590_length_173_cov_184.351351	99	170	129	1	71	0.0140845
NODE_302590_length_173_cov_184.351351	99	170	133	1	71	0.0140845
NODE_302590_length_173_cov_184.351351	99	170	139	2	71	0.0281690
NODE_302590_length_173_cov_184.351351	99	170	146	1	71	0.0140845
NODE_302590_length_173_cov_184.351351	99	170	150	1	71	0.0140845
NODE_302590_length_173_cov_184.351351	99	170	152	1	71	0.0140845
NODE_302590_length_173_cov_184.351351	99	170	154	1	71	0.0140845
NODE_302590_length_173_cov_184.351351	99	170	156	1	71	0.0140845
NODE_302590_length_173_cov_184.351351	99	170	157	2	71	0.0281690
NODE_302590_length_173_cov_184.351351	99	170	161	1	71	0.0140845
NODE_302590_length_173_cov_184.351351	99	170	167	2	71	0.0281690
NODE_302590_length_173_cov_184.351351	99	170	173	2	71	0.0281690
NODE_302590_length_173_cov_184.351351	99	170	183	1	71	0.0140845
NODE_302590_length_173_cov_184.351351	99	170	186	1	71	0.0140845
NODE_302590_length_173_cov_184.351351	99	170	196	2	71	0.0281690
NODE_302590_length_173_cov_184.351351	99	170	208	2	71	0.0281690
NODE_302590_length_173_cov_184.351351	99	170	210	4	71	0.0563380
NODE_302590_length_173_cov_184.351351	99	170	216	1	71	0.0140845
NODE_302590_length_173_cov_184.351351	99	170	218	6	71	0.0845070
NODE_302590_length_173_cov_184.351351	115	173	15	1	58	0.0172414
NODE_302590_length_173_cov_184.351351	115	173	19	1	58	0.0172414
NODE_302590_length_173_cov_184.351351	115	173	23	1	58	0.0172414
NODE_302590_length_173_cov_184.351351	115	173	37	1	58	0.0172414
NODE_302590_length_173_cov_184.351351	115	173	45	3	58	0.0517241
NODE_302590_length_173_cov_184.351351	115	173	49	1	58	0.0172414
NODE_302590_length_173_cov_184.351351	115	173	53	1	58	0.0172414
NODE_302590_length_173_cov_184.351351	115	173	55	1	58	0.0172414
NODE_302590_length_173_cov_184.351351	115	173	57	1	58	0.0172414
NODE_302590_length_173_cov_184.351351	115	173	59	1	58	0.0172414
NODE_302590_length_173_cov_184.351351	115	173	66	1	58	0.0172414
NODE_302590_length_173_cov_184.351351	115	173	72	1	58	0.0172414
NODE_302590_length_173_cov_184.351351	115	173	76	2	58	0.0344828
NODE_302590_length_173_cov_184.351351	115	173	80	6	58	0.1034483
NODE_302590_length_173_cov_184.351351	115	173	81	1	58	0.0172414
NODE_302590_length_173_cov_184.351351	115	173	83	2	58	0.0344828
NODE_302590_length_173_cov_184.351351	115	173	84	5	58	0.0862069
NODE_302590_length_173_cov_184.351351	115	173	92	2	58	0.0344828
NODE_302590_length_173_cov_184.351351	115	173	97	1	58	0.0172414
NODE_302590_length_173_cov_184.351351	115	173	99	2	58	0.0344828
NODE_302590_length_173_cov_184.351351	115	173	101	1	58	0.0172414
NODE_302590_length_173_cov_184.351351	115	173	103	1	58	0.0172414
NODE_302590_length_173_cov_184.351351	115	173	109	1	58	0.0172414
NODE_302590_length_173_cov_184.351351	115	173	117	2	58	0.0344828
NODE_302590_length_173_cov_184.351351	115	173	125	1	58	0.0172414
NODE_302590_length_173_cov_184.351351	115	173	129	1	58	0.0172414
NODE_302590_length_173_cov_184.351351	115	173	133	1	58	0.0172414
NODE_302590_length_173_cov_184.351351	115	173	139	2	58	0.0344828
NODE_302590_length_173_cov_184.351351	115	173	146	1	58	0.0172414
NODE_302590_length_173_cov_184.351351	115	173	150	1	58	0.0172414
NODE_302590_length_173_cov_184.351351	115	173	152	1	58	0.0172414
NODE_302590_length_173_cov_184.351351	115	173	154	1	58	0.0172414
NODE_302590_length_173_cov_184.351351	115	173	156	1	58	0.0172414
NODE_302590_length_173_cov_184.351351	115	173	157	2	58	0.0344828
NODE_302590_length_173_cov_184.351351	115	173	161	1	58	0.0172414
NODE_302590_length_173_cov_184.351351	115	173	167	2	58	0.0344828
NODE_302590_length_173_cov_184.351351	115	173	173	2	58	0.0344828
NODE_302590_length_173_cov_184.351351	115	173	183	1	58	0.0172414
NODE_302596_length_173_cov_58.472973	0	78	20	2	78	0.0256410
NODE_302596_length_173_cov_58.472973	0	78	21	2	78	0.0256410
NODE_302596_length_173_cov_58.472973	0	78	23	1	78	0.0128205
NODE_302596_length_173_cov_58.472973	0	78	28	5	78	0.0641026
NODE_302596_length_173_cov_58.472973	0	78	30	1	78	0.0128205
NODE_302596_length_173_cov_58.472973	0	78	33	1	78	0.0128205
NODE_302596_length_173_cov_58.472973	0	78	35	1	78	0.0128205
NODE_302596_length_173_cov_58.472973	0	78	46	1	78	0.0128205
NODE_302596_length_173_cov_58.472973	0	78	48	3	78	0.0384615
NODE_302596_length_173_cov_58.472973	0	78	50	1	78	0.0128205
NODE_302596_length_173_cov_58.472973	0	78	52	10	78	0.1282051
NODE_302596_length_173_cov_58.472973	0	78	53	1	78	0.0128205
NODE_302596_length_173_cov_58.472973	0	78	54	1	78	0.0128205
NODE_302596_length_173_cov_58.472973	0	78	58	1	78	0.0128205
NODE_302596_length_173_cov_58.472973	0	78	61	2	78	0.0256410
NODE_302596_length_173_cov_58.472973	0	78	63	1	78	0.0128205
NODE_302596_length_173_cov_58.472973	0	78	65	1	78	0.0128205
NODE_302596_length_173_cov_58.472973	0	78	69	1	78	0.0128205
NODE_302596_length_173_cov_58.472973	0	78	72	3	78	0.0384615
NODE_302596_length_173_cov_58.472973	0	78	74	4	78	0.0512821
NODE_302596_length_173_cov_58.472973	0	78	75	3	78	0.0384615
NODE_302596_length_173_cov_58.472973	0	78	78	3	78	0.0384615
NODE_302596_length_173_cov_58.472973	0	78	80	2	78	0.0256410
NODE_302596_length_173_cov_58.472973	0	78	86	1	78	0.0128205
NODE_302596_length_173_cov_58.472973	0	78	92	2	78	0.0256410
NODE_302596_length_173_cov_58.472973	0	78	100	2	78	0.0256410
NODE_302596_length_173_cov_58.472973	0	78	102	1	78	0.0128205
NODE_302596_length_173_cov_58.472973	0	78	104	1	78	0.0128205
NODE_302596_length_173_cov_58.472973	0	78	106	1	78	0.0128205
NODE_302596_length_173_cov_58.472973	0	78	108	3	78	0.0384615
NODE_302596_length_173_cov_58.472973	0	78	110	1	78	0.0128205
NODE_302596_length_173_cov_58.472973	0	78	112	1	78	0.0128205
NODE_302596_length_173_cov_58.472973	0	78	114	1	78	0.0128205
NODE_302596_length_173_cov_58.472973	0	78	122	1	78	0.0128205
NODE_302596_length_173_cov_58.472973	0	78	124	4	78	0.0512821
NODE_302596_length_173_cov_58.472973	0	78	126	8	78	0.1025641
NODE_302597_length_173_cov_57.148649	101	142	47	1	41	0.0243902
NODE_302597_length_173_cov_57.148649	101	142	53	2	41	0.0487805
NODE_302597_length_173_cov_57.148649	101	142	55	1	41	0.0243902
NODE_302597_length_173_cov_57.148649	101	142	57	1	41	0.0243902
NODE_302597_length_173_cov_57.148649	101	142	59	4	41	0.0975610
NODE_302597_length_173_cov_57.148649	101	142	61	1	41	0.0243902
NODE_302597_length_173_cov_57.148649	101	142	63	3	41	0.0731707
NODE_302597_length_173_cov_57.148649	101	142	65	4	41	0.0975610
NODE_302597_length_173_cov_57.148649	101	142	67	1	41	0.0243902
NODE_302597_length_173_cov_57.148649	101	142	69	3	41	0.0731707
NODE_302597_length_173_cov_57.148649	101	142	75	3	41	0.0731707
NODE_302597_length_173_cov_57.148649	101	142	76	4	41	0.0975610
NODE_302597_length_173_cov_57.148649	101	142	78	2	41	0.0487805
NODE_302597_length_173_cov_57.148649	101	142	79	1	41	0.0243902
NODE_302597_length_173_cov_57.148649	101	142	80	4	41	0.0975610
NODE_302597_length_173_cov_57.148649	101	142	81	1	41	0.0243902
NODE_302597_length_173_cov_57.148649	101	142	83	1	41	0.0243902
NODE_302597_length_173_cov_57.148649	101	142	85	3	41	0.0731707
NODE_302597_length_173_cov_57.148649	101	142	87	1	41	0.0243902
NODE_302597_length_173_cov_57.148649	109	173	6	1	64	0.0156250
NODE_302597_length_173_cov_57.148649	109	173	8	3	64	0.0468750
NODE_302597_length_173_cov_57.148649	109	173	10	1	64	0.0156250
NODE_302597_length_173_cov_57.148649	109	173	14	1	64	0.0156250
NODE_302597_length_173_cov_57.148649	109	173	15	2	64	0.0312500
NODE_302597_length_173_cov_57.148649	109	173	17	1	64	0.0156250
NODE_302597_length_173_cov_57.148649	109	173	19	4	64	0.0625000
NODE_302597_length_173_cov_57.148649	109	173	22	1	64	0.0156250
NODE_302597_length_173_cov_57.148649	109	173	26	1	64	0.0156250
NODE_302597_length_173_cov_57.148649	109	173	28	1	64	0.0156250
NODE_302597_length_173_cov_57.148649	109	173	30	2	64	0.0312500
NODE_302597_length_173_cov_57.148649	109	173	34	1	64	0.0156250
NODE_302597_length_173_cov_57.148649	109	173	35	4	64	0.0625000
NODE_302597_length_173_cov_57.148649	109	173	39	2	64	0.0312500
NODE_302597_length_173_cov_57.148649	109	173	41	2	64	0.0312500
NODE_302597_length_173_cov_57.148649	109	173	45	3	64	0.0468750
NODE_302597_length_173_cov_57.148649	109	173	46	1	64	0.0156250
NODE_302597_length_173_cov_57.148649	109	173	47	1	64	0.0156250
NODE_302597_length_173_cov_57.148649	109	173	53	2	64	0.0312500
NODE_302597_length_173_cov_57.148649	109	173	55	1	64	0.0156250
NODE_302597_length_173_cov_57.148649	109	173	57	1	64	0.0156250
NODE_302597_length_173_cov_57.148649	109	173	59	4	64	0.0625000
NODE_302597_length_173_cov_57.148649	109	173	61	1	64	0.0156250
NODE_302597_length_173_cov_57.148649	109	173	63	3	64	0.0468750
NODE_302597_length_173_cov_57.148649	109	173	65	4	64	0.0625000
NODE_302597_length_173_cov_57.148649	109	173	67	1	64	0.0156250
NODE_302597_length_173_cov_57.148649	109	173	69	3	64	0.0468750
NODE_302597_length_173_cov_57.148649	109	173	75	3	64	0.0468750
NODE_302597_length_173_cov_57.148649	109	173	76	4	64	0.0625000
NODE_302597_length_173_cov_57.148649	109	173	78	2	64	0.0312500
NODE_302597_length_173_cov_57.148649	109	173	80	3	64	0.0468750
NODE_302686_length_171_cov_218.666667	12	90	9	7	78	0.0897436
NODE_302686_length_171_cov_218.666667	12	90	11	15	78	0.1923077
NODE_302686_length_171_cov_218.666667	12	90	19	10	78	0.1282051
NODE_302686_length_171_cov_218.666667	12	90	29	5	78	0.0641026
NODE_302686_length_171_cov_218.666667	12	90	31	5	78	0.0641026
NODE_302686_length_171_cov_218.666667	12	90	32	3	78	0.0384615
NODE_302686_length_171_cov_218.666667	12	90	34	33	78	0.4230769
NODE_302686_length_171_cov_218.666667	12	90	9	7	78	0.0897436
NODE_302686_length_171_cov_218.666667	12	90	11	15	78	0.1923077
NODE_302686_length_171_cov_218.666667	12	90	19	10	78	0.1282051
NODE_302686_length_171_cov_218.666667	12	90	29	5	78	0.0641026
NODE_302686_length_171_cov_218.666667	12	90	31	5	78	0.0641026
NODE_302686_length_171_cov_218.666667	12	90	32	3	78	0.0384615
NODE_302686_length_171_cov_218.666667	12	90	34	33	78	0.4230769
NODE_302686_length_171_cov_218.666667	21	90	11	13	69	0.1884058
NODE_302686_length_171_cov_218.666667	21	90	19	10	69	0.1449275
NODE_302686_length_171_cov_218.666667	21	90	29	5	69	0.0724638
NODE_302686_length_171_cov_218.666667	21	90	31	5	69	0.0724638
NODE_302686_length_171_cov_218.666667	21	90	32	3	69	0.0434783
NODE_302686_length_171_cov_218.666667	21	90	34	33	69	0.4782609
NODE_302689_length_171_cov_110.194444	81	161	0	80	80	1.0000000
NODE_302689_length_171_cov_110.194444	81	152	0	71	71	1.0000000
NODE_302691_length_171_cov_86.013889	106	171	0	18	65	0.2769231
NODE_302691_length_171_cov_86.013889	106	171	2	15	65	0.2307692
NODE_302691_length_171_cov_86.013889	106	171	6	13	65	0.2000000
NODE_302691_length_171_cov_86.013889	106	171	8	19	65	0.2923077
NODE_302697_length_171_cov_46.430556	0	59	6	1	59	0.0169492
NODE_302697_length_171_cov_46.430556	0	59	10	1	59	0.0169492
NODE_302697_length_171_cov_46.430556	0	59	16	1	59	0.0169492
NODE_302697_length_171_cov_46.430556	0	59	22	1	59	0.0169492
NODE_302697_length_171_cov_46.430556	0	59	27	1	59	0.0169492
NODE_302697_length_171_cov_46.430556	0	59	29	1	59	0.0169492
NODE_302697_length_171_cov_46.430556	0	59	35	1	59	0.0169492
NODE_302697_length_171_cov_46.430556	0	59	39	2	59	0.0338983
NODE_302697_length_171_cov_46.430556	0	59	43	1	59	0.0169492
NODE_302697_length_171_cov_46.430556	0	59	50	1	59	0.0169492
NODE_302697_length_171_cov_46.430556	0	59	54	2	59	0.0338983
NODE_302697_length_171_cov_46.430556	0	59	56	1	59	0.0169492
NODE_302697_length_171_cov_46.430556	0	59	61	1	59	0.0169492
NODE_302697_length_171_cov_46.430556	0	59	67	3	59	0.0508475
NODE_302697_length_171_cov_46.430556	0	59	73	2	59	0.0338983
NODE_302697_length_171_cov_46.430556	0	59	77	1	59	0.0169492
NODE_302697_length_171_cov_46.430556	0	59	79	1	59	0.0169492
NODE_302697_length_171_cov_46.430556	0	59	81	1	59	0.0169492
NODE_302697_length_171_cov_46.430556	0	59	85	1	59	0.0169492
NODE_302697_length_171_cov_46.430556	0	59	89	2	59	0.0338983
NODE_302697_length_171_cov_46.430556	0	59	99	1	59	0.0169492
NODE_302697_length_171_cov_46.430556	0	59	101	1	59	0.0169492
NODE_302697_length_171_cov_46.430556	0	59	109	1	59	0.0169492
NODE_302697_length_171_cov_46.430556	0	59	111	1	59	0.0169492
NODE_302697_length_171_cov_46.430556	0	59	135	1	59	0.0169492
NODE_302697_length_171_cov_46.430556	0	59	137	1	59	0.0169492
NODE_302697_length_171_cov_46.430556	0	59	145	1	59	0.0169492
NODE_302697_length_171_cov_46.430556	0	59	149	1	59	0.0169492
NODE_302697_length_171_cov_46.430556	0	59	151	1	59	0.0169492
NODE_302697_length_171_cov_46.430556	0	59	158	1	59	0.0169492
NODE_302697_length_171_cov_46.430556	0	59	159	2	59	0.0338983
NODE_302697_length_171_cov_46.430556	0	59	167	2	59	0.0338983
NODE_302697_length_171_cov_46.430556	0	59	171	2	59	0.0338983
NODE_302697_length_171_cov_46.430556	0	59	173	2	59	0.0338983
NODE_302697_length_171_cov_46.430556	0	59	175	2	59	0.0338983
NODE_302697_length_171_cov_46.430556	0	59	176	4	59	0.0677966
NODE_302697_length_171_cov_46.430556	0	59	178	1	59	0.0169492
NODE_302697_length_171_cov_46.430556	0	59	180	2	59	0.0338983
NODE_302697_length_171_cov_46.430556	0	59	182	1	59	0.0169492
NODE_302697_length_171_cov_46.430556	0	59	184	2	59	0.0338983
NODE_302697_length_171_cov_46.430556	0	59	186	1	59	0.0169492
NODE_302697_length_171_cov_46.430556	0	59	197	1	59	0.0169492
NODE_302697_length_171_cov_46.430556	0	59	198	1	59	0.0169492
NODE_302697_length_171_cov_46.430556	32	98	145	1	66	0.0151515
NODE_302697_length_171_cov_46.430556	32	98	149	1	66	0.0151515
NODE_302697_length_171_cov_46.430556	32	98	151	1	66	0.0151515
NODE_302697_length_171_cov_46.430556	32	98	158	1	66	0.0151515
NODE_302697_length_171_cov_46.430556	32	98	159	2	66	0.0303030
NODE_302697_length_171_cov_46.430556	32	98	167	2	66	0.0303030
NODE_302697_length_171_cov_46.430556	32	98	171	2	66	0.0303030
NODE_302697_length_171_cov_46.430556	32	98	173	2	66	0.0303030
NODE_302697_length_171_cov_46.430556	32	98	175	2	66	0.0303030
NODE_302697_length_171_cov_46.430556	32	98	176	4	66	0.0606061
NODE_302697_length_171_cov_46.430556	32	98	178	1	66	0.0151515
NODE_302697_length_171_cov_46.430556	32	98	180	2	66	0.0303030
NODE_302697_length_171_cov_46.430556	32	98	182	1	66	0.0151515
NODE_302697_length_171_cov_46.430556	32	98	184	2	66	0.0303030
NODE_302697_length_171_cov_46.430556	32	98	186	1	66	0.0151515
NODE_302697_length_171_cov_46.430556	32	98	197	1	66	0.0151515
NODE_302697_length_171_cov_46.430556	32	98	198	1	66	0.0151515
NODE_302697_length_171_cov_46.430556	32	98	200	1	66	0.0151515
NODE_302697_length_171_cov_46.430556	32	98	202	2	66	0.0303030
NODE_302697_length_171_cov_46.430556	32	98	206	3	66	0.0454545
NODE_302697_length_171_cov_46.430556	32	98	210	1	66	0.0151515
NODE_302697_length_171_cov_46.430556	32	98	212	1	66	0.0151515
NODE_302697_length_171_cov_46.430556	32	98	214	31	66	0.4696970
NODE_302700_length_171_cov_40.069444	13	87	0	74	74	1.0000000
NODE_302702_length_171_cov_33.319444	84	158	0	9	74	0.1216216
NODE_302702_length_171_cov_33.319444	84	158	4	18	74	0.2432432
NODE_302702_length_171_cov_33.319444	84	158	6	20	74	0.2702703
NODE_302702_length_171_cov_33.319444	84	158	12	4	74	0.0540541
NODE_302702_length_171_cov_33.319444	84	158	14	23	74	0.3108108
NODE_302764_length_170_cov_217.422535	10	90	5	1	80	0.0125000
NODE_302764_length_170_cov_217.422535	10	90	11	1	80	0.0125000
NODE_302764_length_170_cov_217.422535	10	90	15	1	80	0.0125000
NODE_302764_length_170_cov_217.422535	10	90	19	3	80	0.0375000
NODE_302764_length_170_cov_217.422535	10	90	21	1	80	0.0125000
NODE_302764_length_170_cov_217.422535	10	90	25	1	80	0.0125000
NODE_302764_length_170_cov_217.422535	10	90	27	1	80	0.0125000
NODE_302764_length_170_cov_217.422535	10	90	29	1	80	0.0125000
NODE_302764_length_170_cov_217.422535	10	90	31	2	80	0.0250000
NODE_302764_length_170_cov_217.422535	10	90	35	2	80	0.0250000
NODE_302764_length_170_cov_217.422535	10	90	41	1	80	0.0125000
NODE_302764_length_170_cov_217.422535	10	90	47	1	80	0.0125000
NODE_302764_length_170_cov_217.422535	10	90	53	2	80	0.0250000
NODE_302764_length_170_cov_217.422535	10	90	55	1	80	0.0125000
NODE_302764_length_170_cov_217.422535	10	90	57	3	80	0.0375000
NODE_302764_length_170_cov_217.422535	10	90	67	2	80	0.0250000
NODE_302764_length_170_cov_217.422535	10	90	69	2	80	0.0250000
NODE_302764_length_170_cov_217.422535	10	90	71	2	80	0.0250000
NODE_302764_length_170_cov_217.422535	10	90	73	1	80	0.0125000
NODE_302764_length_170_cov_217.422535	10	90	75	1	80	0.0125000
NODE_302764_length_170_cov_217.422535	10	90	76	2	80	0.0250000
NODE_302764_length_170_cov_217.422535	10	90	78	1	80	0.0125000
NODE_302764_length_170_cov_217.422535	10	90	80	1	80	0.0125000
NODE_302764_length_170_cov_217.422535	10	90	86	2	80	0.0250000
NODE_302764_length_170_cov_217.422535	10	90	91	1	80	0.0125000
NODE_302764_length_170_cov_217.422535	10	90	94	1	80	0.0125000
NODE_302764_length_170_cov_217.422535	10	90	96	1	80	0.0125000
NODE_302764_length_170_cov_217.422535	10	90	98	4	80	0.0500000
NODE_302764_length_170_cov_217.422535	10	90	102	3	80	0.0375000
NODE_302764_length_170_cov_217.422535	10	90	106	1	80	0.0125000
NODE_302764_length_170_cov_217.422535	10	90	108	3	80	0.0375000
NODE_302764_length_170_cov_217.422535	10	90	112	1	80	0.0125000
NODE_302764_length_170_cov_217.422535	10	90	114	2	80	0.0250000
NODE_302764_length_170_cov_217.422535	10	90	122	3	80	0.0375000
NODE_302764_length_170_cov_217.422535	10	90	124	24	80	0.3000000
NODE_302764_length_170_cov_217.422535	10	90	5	1	80	0.0125000
NODE_302764_length_170_cov_217.422535	10	90	11	1	80	0.0125000
NODE_302764_length_170_cov_217.422535	10	90	15	1	80	0.0125000
NODE_302764_length_170_cov_217.422535	10	90	19	3	80	0.0375000
NODE_302764_length_170_cov_217.422535	10	90	21	1	80	0.0125000
NODE_302764_length_170_cov_217.422535	10	90	25	1	80	0.0125000
NODE_302764_length_170_cov_217.422535	10	90	27	1	80	0.0125000
NODE_302764_length_170_cov_217.422535	10	90	29	1	80	0.0125000
NODE_302764_length_170_cov_217.422535	10	90	31	2	80	0.0250000
NODE_302764_length_170_cov_217.422535	10	90	35	2	80	0.0250000
NODE_302764_length_170_cov_217.422535	10	90	41	1	80	0.0125000
NODE_302764_length_170_cov_217.422535	10	90	47	1	80	0.0125000
NODE_302764_length_170_cov_217.422535	10	90	53	2	80	0.0250000
NODE_302764_length_170_cov_217.422535	10	90	55	1	80	0.0125000
NODE_302764_length_170_cov_217.422535	10	90	57	3	80	0.0375000
NODE_302764_length_170_cov_217.422535	10	90	67	2	80	0.0250000
NODE_302764_length_170_cov_217.422535	10	90	69	2	80	0.0250000
NODE_302764_length_170_cov_217.422535	10	90	71	2	80	0.0250000
NODE_302764_length_170_cov_217.422535	10	90	73	1	80	0.0125000
NODE_302764_length_170_cov_217.422535	10	90	75	1	80	0.0125000
NODE_302764_length_170_cov_217.422535	10	90	76	2	80	0.0250000
NODE_302764_length_170_cov_217.422535	10	90	78	1	80	0.0125000
NODE_302764_length_170_cov_217.422535	10	90	80	1	80	0.0125000
NODE_302764_length_170_cov_217.422535	10	90	86	2	80	0.0250000
NODE_302764_length_170_cov_217.422535	10	90	91	1	80	0.0125000
NODE_302764_length_170_cov_217.422535	10	90	94	1	80	0.0125000
NODE_302764_length_170_cov_217.422535	10	90	96	1	80	0.0125000
NODE_302764_length_170_cov_217.422535	10	90	98	4	80	0.0500000
NODE_302764_length_170_cov_217.422535	10	90	102	3	80	0.0375000
NODE_302764_length_170_cov_217.422535	10	90	106	1	80	0.0125000
NODE_302764_length_170_cov_217.422535	10	90	108	3	80	0.0375000
NODE_302764_length_170_cov_217.422535	10	90	112	1	80	0.0125000
NODE_302764_length_170_cov_217.422535	10	90	114	2	80	0.0250000
NODE_302764_length_170_cov_217.422535	10	90	122	3	80	0.0375000
NODE_302764_length_170_cov_217.422535	10	90	124	24	80	0.3000000
NODE_302764_length_170_cov_217.422535	10	90	5	1	80	0.0125000
NODE_302764_length_170_cov_217.422535	10	90	11	1	80	0.0125000
NODE_302764_length_170_cov_217.422535	10	90	15	1	80	0.0125000
NODE_302764_length_170_cov_217.422535	10	90	19	3	80	0.0375000
NODE_302764_length_170_cov_217.422535	10	90	21	1	80	0.0125000
NODE_302764_length_170_cov_217.422535	10	90	25	1	80	0.0125000
NODE_302764_length_170_cov_217.422535	10	90	27	1	80	0.0125000
NODE_302764_length_170_cov_217.422535	10	90	29	1	80	0.0125000
NODE_302764_length_170_cov_217.422535	10	90	31	2	80	0.0250000
NODE_302764_length_170_cov_217.422535	10	90	35	2	80	0.0250000
NODE_302764_length_170_cov_217.422535	10	90	41	1	80	0.0125000
NODE_302764_length_170_cov_217.422535	10	90	47	1	80	0.0125000
NODE_302764_length_170_cov_217.422535	10	90	53	2	80	0.0250000
NODE_302764_length_170_cov_217.422535	10	90	55	1	80	0.0125000
NODE_302764_length_170_cov_217.422535	10	90	57	3	80	0.0375000
NODE_302764_length_170_cov_217.422535	10	90	67	2	80	0.0250000
NODE_302764_length_170_cov_217.422535	10	90	69	2	80	0.0250000
NODE_302764_length_170_cov_217.422535	10	90	71	2	80	0.0250000
NODE_302764_length_170_cov_217.422535	10	90	73	1	80	0.0125000
NODE_302764_length_170_cov_217.422535	10	90	75	1	80	0.0125000
NODE_302764_length_170_cov_217.422535	10	90	76	2	80	0.0250000
NODE_302764_length_170_cov_217.422535	10	90	78	1	80	0.0125000
NODE_302764_length_170_cov_217.422535	10	90	80	1	80	0.0125000
NODE_302764_length_170_cov_217.422535	10	90	86	2	80	0.0250000
NODE_302764_length_170_cov_217.422535	10	90	91	1	80	0.0125000
NODE_302764_length_170_cov_217.422535	10	90	94	1	80	0.0125000
NODE_302764_length_170_cov_217.422535	10	90	96	1	80	0.0125000
NODE_302764_length_170_cov_217.422535	10	90	98	4	80	0.0500000
NODE_302764_length_170_cov_217.422535	10	90	102	3	80	0.0375000
NODE_302764_length_170_cov_217.422535	10	90	106	1	80	0.0125000
NODE_302764_length_170_cov_217.422535	10	90	108	3	80	0.0375000
NODE_302764_length_170_cov_217.422535	10	90	112	1	80	0.0125000
NODE_302764_length_170_cov_217.422535	10	90	114	2	80	0.0250000
NODE_302764_length_170_cov_217.422535	10	90	122	3	80	0.0375000
NODE_302764_length_170_cov_217.422535	10	90	124	24	80	0.3000000
NODE_302764_length_170_cov_217.422535	10	90	5	1	80	0.0125000
NODE_302764_length_170_cov_217.422535	10	90	11	1	80	0.0125000
NODE_302764_length_170_cov_217.422535	10	90	15	1	80	0.0125000
NODE_302764_length_170_cov_217.422535	10	90	19	3	80	0.0375000
NODE_302764_length_170_cov_217.422535	10	90	21	1	80	0.0125000
NODE_302764_length_170_cov_217.422535	10	90	25	1	80	0.0125000
NODE_302764_length_170_cov_217.422535	10	90	27	1	80	0.0125000
NODE_302764_length_170_cov_217.422535	10	90	29	1	80	0.0125000
NODE_302764_length_170_cov_217.422535	10	90	31	2	80	0.0250000
NODE_302764_length_170_cov_217.422535	10	90	35	2	80	0.0250000
NODE_302764_length_170_cov_217.422535	10	90	41	1	80	0.0125000
NODE_302764_length_170_cov_217.422535	10	90	47	1	80	0.0125000
NODE_302764_length_170_cov_217.422535	10	90	53	2	80	0.0250000
NODE_302764_length_170_cov_217.422535	10	90	55	1	80	0.0125000
NODE_302764_length_170_cov_217.422535	10	90	57	3	80	0.0375000
NODE_302764_length_170_cov_217.422535	10	90	67	2	80	0.0250000
NODE_302764_length_170_cov_217.422535	10	90	69	2	80	0.0250000
NODE_302764_length_170_cov_217.422535	10	90	71	2	80	0.0250000
NODE_302764_length_170_cov_217.422535	10	90	73	1	80	0.0125000
NODE_302764_length_170_cov_217.422535	10	90	75	1	80	0.0125000
NODE_302764_length_170_cov_217.422535	10	90	76	2	80	0.0250000
NODE_302764_length_170_cov_217.422535	10	90	78	1	80	0.0125000
NODE_302764_length_170_cov_217.422535	10	90	80	1	80	0.0125000
NODE_302764_length_170_cov_217.422535	10	90	86	2	80	0.0250000
NODE_302764_length_170_cov_217.422535	10	90	91	1	80	0.0125000
NODE_302764_length_170_cov_217.422535	10	90	94	1	80	0.0125000
NODE_302764_length_170_cov_217.422535	10	90	96	1	80	0.0125000
NODE_302764_length_170_cov_217.422535	10	90	98	4	80	0.0500000
NODE_302764_length_170_cov_217.422535	10	90	102	3	80	0.0375000
NODE_302764_length_170_cov_217.422535	10	90	106	1	80	0.0125000
NODE_302764_length_170_cov_217.422535	10	90	108	3	80	0.0375000
NODE_302764_length_170_cov_217.422535	10	90	112	1	80	0.0125000
NODE_302764_length_170_cov_217.422535	10	90	114	2	80	0.0250000
NODE_302764_length_170_cov_217.422535	10	90	122	3	80	0.0375000
NODE_302764_length_170_cov_217.422535	10	90	124	24	80	0.3000000
NODE_302764_length_170_cov_217.422535	10	90	5	1	80	0.0125000
NODE_302764_length_170_cov_217.422535	10	90	11	1	80	0.0125000
NODE_302764_length_170_cov_217.422535	10	90	15	1	80	0.0125000
NODE_302764_length_170_cov_217.422535	10	90	19	3	80	0.0375000
NODE_302764_length_170_cov_217.422535	10	90	21	1	80	0.0125000
NODE_302764_length_170_cov_217.422535	10	90	25	1	80	0.0125000
NODE_302764_length_170_cov_217.422535	10	90	27	1	80	0.0125000
NODE_302764_length_170_cov_217.422535	10	90	29	1	80	0.0125000
NODE_302764_length_170_cov_217.422535	10	90	31	2	80	0.0250000
NODE_302764_length_170_cov_217.422535	10	90	35	2	80	0.0250000
NODE_302764_length_170_cov_217.422535	10	90	41	1	80	0.0125000
NODE_302764_length_170_cov_217.422535	10	90	47	1	80	0.0125000
NODE_302764_length_170_cov_217.422535	10	90	53	2	80	0.0250000
NODE_302764_length_170_cov_217.422535	10	90	55	1	80	0.0125000
NODE_302764_length_170_cov_217.422535	10	90	57	3	80	0.0375000
NODE_302764_length_170_cov_217.422535	10	90	67	2	80	0.0250000
NODE_302764_length_170_cov_217.422535	10	90	69	2	80	0.0250000
NODE_302764_length_170_cov_217.422535	10	90	71	2	80	0.0250000
NODE_302764_length_170_cov_217.422535	10	90	73	1	80	0.0125000
NODE_302764_length_170_cov_217.422535	10	90	75	1	80	0.0125000
NODE_302764_length_170_cov_217.422535	10	90	76	2	80	0.0250000
NODE_302764_length_170_cov_217.422535	10	90	78	1	80	0.0125000
NODE_302764_length_170_cov_217.422535	10	90	80	1	80	0.0125000
NODE_302764_length_170_cov_217.422535	10	90	86	2	80	0.0250000
NODE_302764_length_170_cov_217.422535	10	90	91	1	80	0.0125000
NODE_302764_length_170_cov_217.422535	10	90	94	1	80	0.0125000
NODE_302764_length_170_cov_217.422535	10	90	96	1	80	0.0125000
NODE_302764_length_170_cov_217.422535	10	90	98	4	80	0.0500000
NODE_302764_length_170_cov_217.422535	10	90	102	3	80	0.0375000
NODE_302764_length_170_cov_217.422535	10	90	106	1	80	0.0125000
NODE_302764_length_170_cov_217.422535	10	90	108	3	80	0.0375000
NODE_302764_length_170_cov_217.422535	10	90	112	1	80	0.0125000
NODE_302764_length_170_cov_217.422535	10	90	114	2	80	0.0250000
NODE_302764_length_170_cov_217.422535	10	90	122	3	80	0.0375000
NODE_302764_length_170_cov_217.422535	10	90	124	24	80	0.3000000
NODE_302764_length_170_cov_217.422535	19	90	29	1	71	0.0140845
NODE_302764_length_170_cov_217.422535	19	90	31	2	71	0.0281690
NODE_302764_length_170_cov_217.422535	19	90	35	2	71	0.0281690
NODE_302764_length_170_cov_217.422535	19	90	41	1	71	0.0140845
NODE_302764_length_170_cov_217.422535	19	90	47	1	71	0.0140845
NODE_302764_length_170_cov_217.422535	19	90	53	2	71	0.0281690
NODE_302764_length_170_cov_217.422535	19	90	55	1	71	0.0140845
NODE_302764_length_170_cov_217.422535	19	90	57	3	71	0.0422535
NODE_302764_length_170_cov_217.422535	19	90	67	2	71	0.0281690
NODE_302764_length_170_cov_217.422535	19	90	69	2	71	0.0281690
NODE_302764_length_170_cov_217.422535	19	90	71	2	71	0.0281690
NODE_302764_length_170_cov_217.422535	19	90	73	1	71	0.0140845
NODE_302764_length_170_cov_217.422535	19	90	75	1	71	0.0140845
NODE_302764_length_170_cov_217.422535	19	90	76	2	71	0.0281690
NODE_302764_length_170_cov_217.422535	19	90	78	1	71	0.0140845
NODE_302764_length_170_cov_217.422535	19	90	80	1	71	0.0140845
NODE_302764_length_170_cov_217.422535	19	90	86	2	71	0.0281690
NODE_302764_length_170_cov_217.422535	19	90	91	1	71	0.0140845
NODE_302764_length_170_cov_217.422535	19	90	94	1	71	0.0140845
NODE_302764_length_170_cov_217.422535	19	90	96	1	71	0.0140845
NODE_302764_length_170_cov_217.422535	19	90	98	4	71	0.0563380
NODE_302764_length_170_cov_217.422535	19	90	102	3	71	0.0422535
NODE_302764_length_170_cov_217.422535	19	90	106	1	71	0.0140845
NODE_302764_length_170_cov_217.422535	19	90	108	3	71	0.0422535
NODE_302764_length_170_cov_217.422535	19	90	112	1	71	0.0140845
NODE_302764_length_170_cov_217.422535	19	90	114	2	71	0.0281690
NODE_302764_length_170_cov_217.422535	19	90	122	3	71	0.0422535
NODE_302764_length_170_cov_217.422535	19	90	124	24	71	0.3380282
NODE_302764_length_170_cov_217.422535	63	126	102	1	63	0.0158730
NODE_302764_length_170_cov_217.422535	63	126	104	1	63	0.0158730
NODE_302764_length_170_cov_217.422535	63	126	108	1	63	0.0158730
NODE_302764_length_170_cov_217.422535	63	126	110	3	63	0.0476190
NODE_302764_length_170_cov_217.422535	63	126	114	4	63	0.0634921
NODE_302764_length_170_cov_217.422535	63	126	116	1	63	0.0158730
NODE_302764_length_170_cov_217.422535	63	126	118	2	63	0.0317460
NODE_302764_length_170_cov_217.422535	63	126	122	9	63	0.1428571
NODE_302764_length_170_cov_217.422535	63	126	124	41	63	0.6507937
NODE_302764_length_170_cov_217.422535	63	126	102	1	63	0.0158730
NODE_302764_length_170_cov_217.422535	63	126	104	1	63	0.0158730
NODE_302764_length_170_cov_217.422535	63	126	108	1	63	0.0158730
NODE_302764_length_170_cov_217.422535	63	126	110	3	63	0.0476190
NODE_302764_length_170_cov_217.422535	63	126	114	4	63	0.0634921
NODE_302764_length_170_cov_217.422535	63	126	116	1	63	0.0158730
NODE_302764_length_170_cov_217.422535	63	126	118	2	63	0.0317460
NODE_302764_length_170_cov_217.422535	63	126	122	9	63	0.1428571
NODE_302764_length_170_cov_217.422535	63	126	124	41	63	0.6507937
NODE_302768_length_170_cov_102.816901	23	86	45	2	63	0.0317460
NODE_302768_length_170_cov_102.816901	23	86	47	1	63	0.0158730
NODE_302768_length_170_cov_102.816901	23	86	53	19	63	0.3015873
NODE_302768_length_170_cov_102.816901	23	86	57	2	63	0.0317460
NODE_302768_length_170_cov_102.816901	23	86	60	3	63	0.0476190
NODE_302768_length_170_cov_102.816901	23	86	62	3	63	0.0476190
NODE_302768_length_170_cov_102.816901	23	86	66	13	63	0.2063492
NODE_302768_length_170_cov_102.816901	23	86	67	14	63	0.2222222
NODE_302768_length_170_cov_102.816901	23	86	68	6	63	0.0952381
NODE_302806_length_169_cov_47.757143	70	150	18	1	80	0.0125000
NODE_302806_length_169_cov_47.757143	70	150	28	1	80	0.0125000
NODE_302806_length_169_cov_47.757143	70	150	30	4	80	0.0500000
NODE_302806_length_169_cov_47.757143	70	150	38	7	80	0.0875000
NODE_302806_length_169_cov_47.757143	70	150	40	1	80	0.0125000
NODE_302806_length_169_cov_47.757143	70	150	42	31	80	0.3875000
NODE_302806_length_169_cov_47.757143	70	150	44	35	80	0.4375000
NODE_302869_length_168_cov_10.391304	66	99	0	33	33	1.0000000
NODE_302869_length_168_cov_10.391304	135	168	0	33	33	1.0000000
NODE_302966_length_166_cov_401.149254	31	109	48	1	78	0.0128205
NODE_302966_length_166_cov_401.149254	31	109	50	1	78	0.0128205
NODE_302966_length_166_cov_401.149254	31	109	57	3	78	0.0384615
NODE_302966_length_166_cov_401.149254	31	109	61	1	78	0.0128205
NODE_302966_length_166_cov_401.149254	31	109	67	2	78	0.0256410
NODE_302966_length_166_cov_401.149254	31	109	71	1	78	0.0128205
NODE_302966_length_166_cov_401.149254	31	109	79	1	78	0.0128205
NODE_302966_length_166_cov_401.149254	31	109	91	1	78	0.0128205
NODE_302966_length_166_cov_401.149254	31	109	92	1	78	0.0128205
NODE_302966_length_166_cov_401.149254	31	109	99	1	78	0.0128205
NODE_302966_length_166_cov_401.149254	31	109	103	1	78	0.0128205
NODE_302966_length_166_cov_401.149254	31	109	105	1	78	0.0128205
NODE_302966_length_166_cov_401.149254	31	109	115	1	78	0.0128205
NODE_302966_length_166_cov_401.149254	31	109	123	2	78	0.0256410
NODE_302966_length_166_cov_401.149254	31	109	131	1	78	0.0128205
NODE_302966_length_166_cov_401.149254	31	109	133	1	78	0.0128205
NODE_302966_length_166_cov_401.149254	31	109	139	2	78	0.0256410
NODE_302966_length_166_cov_401.149254	31	109	141	3	78	0.0384615
NODE_302966_length_166_cov_401.149254	31	109	143	1	78	0.0128205
NODE_302966_length_166_cov_401.149254	31	109	144	3	78	0.0384615
NODE_302966_length_166_cov_401.149254	31	109	145	2	78	0.0256410
NODE_302966_length_166_cov_401.149254	31	109	147	1	78	0.0128205
NODE_302966_length_166_cov_401.149254	31	109	148	1	78	0.0128205
NODE_302966_length_166_cov_401.149254	31	109	150	45	78	0.5769231
NODE_302966_length_166_cov_401.149254	82	157	36	2	75	0.0266667
NODE_302966_length_166_cov_401.149254	82	157	44	7	75	0.0933333
NODE_302966_length_166_cov_401.149254	82	157	46	1	75	0.0133333
NODE_302966_length_166_cov_401.149254	82	157	50	2	75	0.0266667
NODE_302966_length_166_cov_401.149254	82	157	52	2	75	0.0266667
NODE_302966_length_166_cov_401.149254	82	157	55	1	75	0.0133333
NODE_302966_length_166_cov_401.149254	82	157	56	1	75	0.0133333
NODE_302966_length_166_cov_401.149254	82	157	58	2	75	0.0266667
NODE_302966_length_166_cov_401.149254	82	157	60	1	75	0.0133333
NODE_302966_length_166_cov_401.149254	82	157	64	1	75	0.0133333
NODE_302966_length_166_cov_401.149254	82	157	72	1	75	0.0133333
NODE_302966_length_166_cov_401.149254	82	157	74	2	75	0.0266667
NODE_302966_length_166_cov_401.149254	82	157	76	1	75	0.0133333
NODE_302966_length_166_cov_401.149254	82	157	82	1	75	0.0133333
NODE_302966_length_166_cov_401.149254	82	157	84	2	75	0.0266667
NODE_302966_length_166_cov_401.149254	82	157	88	1	75	0.0133333
NODE_302966_length_166_cov_401.149254	82	157	92	1	75	0.0133333
NODE_302966_length_166_cov_401.149254	82	157	94	2	75	0.0266667
NODE_302966_length_166_cov_401.149254	82	157	106	1	75	0.0133333
NODE_302966_length_166_cov_401.149254	82	157	108	1	75	0.0133333
NODE_302966_length_166_cov_401.149254	82	157	110	1	75	0.0133333
NODE_302966_length_166_cov_401.149254	82	157	112	2	75	0.0266667
NODE_302966_length_166_cov_401.149254	82	157	116	3	75	0.0400000
NODE_302966_length_166_cov_401.149254	82	157	118	3	75	0.0400000
NODE_302966_length_166_cov_401.149254	82	157	120	2	75	0.0266667
NODE_302966_length_166_cov_401.149254	82	157	136	3	75	0.0400000
NODE_302966_length_166_cov_401.149254	82	157	144	4	75	0.0533333
NODE_302966_length_166_cov_401.149254	82	157	150	24	75	0.3200000
NODE_302974_length_166_cov_123.223881	46	97	2	51	51	1.0000000
NODE_303071_length_164_cov_154.076923	0	75	0	27	75	0.3600000
NODE_303071_length_164_cov_154.076923	0	75	2	8	75	0.1066667
NODE_303071_length_164_cov_154.076923	0	75	4	22	75	0.2933333
NODE_303071_length_164_cov_154.076923	0	75	6	18	75	0.2400000
NODE_303071_length_164_cov_154.076923	48	128	0	1	80	0.0125000
NODE_303071_length_164_cov_154.076923	48	128	2	2	80	0.0250000
NODE_303071_length_164_cov_154.076923	48	128	4	24	80	0.3000000
NODE_303071_length_164_cov_154.076923	48	128	6	53	80	0.6625000
NODE_303074_length_164_cov_69.369231	0	64	2	2	64	0.0312500
NODE_303074_length_164_cov_69.369231	0	64	4	1	64	0.0156250
NODE_303074_length_164_cov_69.369231	0	64	6	8	64	0.1250000
NODE_303074_length_164_cov_69.369231	0	64	8	14	64	0.2187500
NODE_303074_length_164_cov_69.369231	0	64	10	33	64	0.5156250
NODE_303074_length_164_cov_69.369231	0	64	12	6	64	0.0937500
NODE_303079_length_164_cov_43.923077	36	100	73	1	64	0.0156250
NODE_303079_length_164_cov_43.923077	36	100	74	5	64	0.0781250
NODE_303079_length_164_cov_43.923077	36	100	75	58	64	0.9062500
NODE_303079_length_164_cov_43.923077	36	100	73	1	64	0.0156250
NODE_303079_length_164_cov_43.923077	36	100	74	5	64	0.0781250
NODE_303079_length_164_cov_43.923077	36	100	75	58	64	0.9062500
NODE_303079_length_164_cov_43.923077	73	153	29	8	80	0.1000000
NODE_303079_length_164_cov_43.923077	73	153	39	1	80	0.0125000
NODE_303079_length_164_cov_43.923077	73	153	41	5	80	0.0625000
NODE_303079_length_164_cov_43.923077	73	153	46	2	80	0.0250000
NODE_303079_length_164_cov_43.923077	73	153	52	1	80	0.0125000
NODE_303079_length_164_cov_43.923077	73	153	53	15	80	0.1875000
NODE_303079_length_164_cov_43.923077	73	153	57	1	80	0.0125000
NODE_303079_length_164_cov_43.923077	73	153	59	5	80	0.0625000
NODE_303079_length_164_cov_43.923077	73	153	64	1	80	0.0125000
NODE_303079_length_164_cov_43.923077	73	153	65	2	80	0.0250000
NODE_303079_length_164_cov_43.923077	73	153	67	5	80	0.0625000
NODE_303079_length_164_cov_43.923077	73	153	71	4	80	0.0500000
NODE_303079_length_164_cov_43.923077	73	153	75	30	80	0.3750000
NODE_303079_length_164_cov_43.923077	73	153	29	8	80	0.1000000
NODE_303079_length_164_cov_43.923077	73	153	39	1	80	0.0125000
NODE_303079_length_164_cov_43.923077	73	153	41	5	80	0.0625000
NODE_303079_length_164_cov_43.923077	73	153	46	2	80	0.0250000
NODE_303079_length_164_cov_43.923077	73	153	52	1	80	0.0125000
NODE_303079_length_164_cov_43.923077	73	153	53	15	80	0.1875000
NODE_303079_length_164_cov_43.923077	73	153	57	1	80	0.0125000
NODE_303079_length_164_cov_43.923077	73	153	59	5	80	0.0625000
NODE_303079_length_164_cov_43.923077	73	153	64	1	80	0.0125000
NODE_303079_length_164_cov_43.923077	73	153	65	2	80	0.0250000
NODE_303079_length_164_cov_43.923077	73	153	67	5	80	0.0625000
NODE_303079_length_164_cov_43.923077	73	153	71	4	80	0.0500000
NODE_303079_length_164_cov_43.923077	73	153	75	30	80	0.3750000
NODE_303079_length_164_cov_43.923077	73	153	29	8	80	0.1000000
NODE_303079_length_164_cov_43.923077	73	153	39	1	80	0.0125000
NODE_303079_length_164_cov_43.923077	73	153	41	5	80	0.0625000
NODE_303079_length_164_cov_43.923077	73	153	46	2	80	0.0250000
NODE_303079_length_164_cov_43.923077	73	153	52	1	80	0.0125000
NODE_303079_length_164_cov_43.923077	73	153	53	15	80	0.1875000
NODE_303079_length_164_cov_43.923077	73	153	57	1	80	0.0125000
NODE_303079_length_164_cov_43.923077	73	153	59	5	80	0.0625000
NODE_303079_length_164_cov_43.923077	73	153	64	1	80	0.0125000
NODE_303079_length_164_cov_43.923077	73	153	65	2	80	0.0250000
NODE_303079_length_164_cov_43.923077	73	153	67	5	80	0.0625000
NODE_303079_length_164_cov_43.923077	73	153	71	4	80	0.0500000
NODE_303079_length_164_cov_43.923077	73	153	75	30	80	0.3750000
NODE_303079_length_164_cov_43.923077	73	153	29	8	80	0.1000000
NODE_303079_length_164_cov_43.923077	73	153	39	1	80	0.0125000
NODE_303079_length_164_cov_43.923077	73	153	41	5	80	0.0625000
NODE_303079_length_164_cov_43.923077	73	153	46	2	80	0.0250000
NODE_303079_length_164_cov_43.923077	73	153	52	1	80	0.0125000
NODE_303079_length_164_cov_43.923077	73	153	53	15	80	0.1875000
NODE_303079_length_164_cov_43.923077	73	153	57	1	80	0.0125000
NODE_303079_length_164_cov_43.923077	73	153	59	5	80	0.0625000
NODE_303079_length_164_cov_43.923077	73	153	64	1	80	0.0125000
NODE_303079_length_164_cov_43.923077	73	153	65	2	80	0.0250000
NODE_303079_length_164_cov_43.923077	73	153	67	5	80	0.0625000
NODE_303079_length_164_cov_43.923077	73	153	71	4	80	0.0500000
NODE_303079_length_164_cov_43.923077	73	153	75	30	80	0.3750000
NODE_303079_length_164_cov_43.923077	73	153	29	8	80	0.1000000
NODE_303079_length_164_cov_43.923077	73	153	39	1	80	0.0125000
NODE_303079_length_164_cov_43.923077	73	153	41	5	80	0.0625000
NODE_303079_length_164_cov_43.923077	73	153	46	2	80	0.0250000
NODE_303079_length_164_cov_43.923077	73	153	52	1	80	0.0125000
NODE_303079_length_164_cov_43.923077	73	153	53	15	80	0.1875000
NODE_303079_length_164_cov_43.923077	73	153	57	1	80	0.0125000
NODE_303079_length_164_cov_43.923077	73	153	59	5	80	0.0625000
NODE_303079_length_164_cov_43.923077	73	153	64	1	80	0.0125000
NODE_303079_length_164_cov_43.923077	73	153	65	2	80	0.0250000
NODE_303079_length_164_cov_43.923077	73	153	67	5	80	0.0625000
NODE_303079_length_164_cov_43.923077	73	153	71	4	80	0.0500000
NODE_303079_length_164_cov_43.923077	73	153	75	30	80	0.3750000
NODE_303079_length_164_cov_43.923077	73	144	41	5	71	0.0704225
NODE_303079_length_164_cov_43.923077	73	144	46	2	71	0.0281690
NODE_303079_length_164_cov_43.923077	73	144	52	1	71	0.0140845
NODE_303079_length_164_cov_43.923077	73	144	53	15	71	0.2112676
NODE_303079_length_164_cov_43.923077	73	144	57	1	71	0.0140845
NODE_303079_length_164_cov_43.923077	73	144	59	5	71	0.0704225
NODE_303079_length_164_cov_43.923077	73	144	64	1	71	0.0140845
NODE_303079_length_164_cov_43.923077	73	144	65	2	71	0.0281690
NODE_303079_length_164_cov_43.923077	73	144	67	5	71	0.0704225
NODE_303079_length_164_cov_43.923077	73	144	71	4	71	0.0563380
NODE_303079_length_164_cov_43.923077	73	144	75	30	71	0.4225352
NODE_303135_length_163_cov_480.593750	0	40	2	1	40	0.0250000
NODE_303135_length_163_cov_480.593750	0	40	4	12	40	0.3000000
NODE_303135_length_163_cov_480.593750	0	40	6	6	40	0.1500000
NODE_303135_length_163_cov_480.593750	0	40	8	1	40	0.0250000
NODE_303135_length_163_cov_480.593750	0	40	10	1	40	0.0250000
NODE_303135_length_163_cov_480.593750	0	40	12	2	40	0.0500000
NODE_303135_length_163_cov_480.593750	0	40	14	2	40	0.0500000
NODE_303135_length_163_cov_480.593750	0	40	18	6	40	0.1500000
NODE_303135_length_163_cov_480.593750	0	40	24	6	40	0.1500000
NODE_303135_length_163_cov_480.593750	0	40	26	3	40	0.0750000
NODE_303136_length_163_cov_368.000000	24	96	107	3	72	0.0416667
NODE_303136_length_163_cov_368.000000	24	96	109	2	72	0.0277778
NODE_303136_length_163_cov_368.000000	24	96	111	1	72	0.0138889
NODE_303136_length_163_cov_368.000000	24	96	113	1	72	0.0138889
NODE_303136_length_163_cov_368.000000	24	96	118	2	72	0.0277778
NODE_303136_length_163_cov_368.000000	24	96	120	1	72	0.0138889
NODE_303136_length_163_cov_368.000000	24	96	122	1	72	0.0138889
NODE_303136_length_163_cov_368.000000	24	96	124	1	72	0.0138889
NODE_303136_length_163_cov_368.000000	24	96	126	3	72	0.0416667
NODE_303136_length_163_cov_368.000000	24	96	128	1	72	0.0138889
NODE_303136_length_163_cov_368.000000	24	96	132	1	72	0.0138889
NODE_303136_length_163_cov_368.000000	24	96	134	1	72	0.0138889
NODE_303136_length_163_cov_368.000000	24	96	138	4	72	0.0555556
NODE_303136_length_163_cov_368.000000	24	96	139	2	72	0.0277778
NODE_303136_length_163_cov_368.000000	24	96	141	1	72	0.0138889
NODE_303136_length_163_cov_368.000000	24	96	143	1	72	0.0138889
NODE_303136_length_163_cov_368.000000	24	96	145	1	72	0.0138889
NODE_303136_length_163_cov_368.000000	24	96	149	1	72	0.0138889
NODE_303136_length_163_cov_368.000000	24	96	153	1	72	0.0138889
NODE_303136_length_163_cov_368.000000	24	96	154	1	72	0.0138889
NODE_303136_length_163_cov_368.000000	24	96	156	42	72	0.5833333
NODE_303138_length_163_cov_319.843750	0	68	6	3	68	0.0441176
NODE_303138_length_163_cov_319.843750	0	68	8	2	68	0.0294118
NODE_303138_length_163_cov_319.843750	0	68	10	1	68	0.0147059
NODE_303138_length_163_cov_319.843750	0	68	12	6	68	0.0882353
NODE_303138_length_163_cov_319.843750	0	68	13	1	68	0.0147059
NODE_303138_length_163_cov_319.843750	0	68	16	1	68	0.0147059
NODE_303138_length_163_cov_319.843750	0	68	17	2	68	0.0294118
NODE_303138_length_163_cov_319.843750	0	68	19	2	68	0.0294118
NODE_303138_length_163_cov_319.843750	0	68	21	3	68	0.0441176
NODE_303138_length_163_cov_319.843750	0	68	22	1	68	0.0147059
NODE_303138_length_163_cov_319.843750	0	68	24	8	68	0.1176471
NODE_303138_length_163_cov_319.843750	0	68	28	5	68	0.0735294
NODE_303138_length_163_cov_319.843750	0	68	30	6	68	0.0882353
NODE_303138_length_163_cov_319.843750	0	68	32	27	68	0.3970588
NODE_303139_length_163_cov_198.078125	34	109	24	2	75	0.0266667
NODE_303139_length_163_cov_198.078125	34	109	26	5	75	0.0666667
NODE_303139_length_163_cov_198.078125	34	109	28	3	75	0.0400000
NODE_303139_length_163_cov_198.078125	34	109	30	16	75	0.2133333
NODE_303139_length_163_cov_198.078125	34	109	32	49	75	0.6533333
NODE_303139_length_163_cov_198.078125	34	114	24	2	80	0.0250000
NODE_303139_length_163_cov_198.078125	34	114	26	5	80	0.0625000
NODE_303139_length_163_cov_198.078125	34	114	28	8	80	0.1000000
NODE_303139_length_163_cov_198.078125	34	114	30	16	80	0.2000000
NODE_303139_length_163_cov_198.078125	34	114	32	49	80	0.6125000
NODE_303139_length_163_cov_198.078125	35	110	24	1	75	0.0133333
NODE_303139_length_163_cov_198.078125	35	110	26	5	75	0.0666667
NODE_303139_length_163_cov_198.078125	35	110	28	4	75	0.0533333
NODE_303139_length_163_cov_198.078125	35	110	30	16	75	0.2133333
NODE_303139_length_163_cov_198.078125	35	110	32	49	75	0.6533333
NODE_303139_length_163_cov_198.078125	87	163	0	6	76	0.0789474
NODE_303139_length_163_cov_198.078125	87	163	2	3	76	0.0394737
NODE_303139_length_163_cov_198.078125	87	163	4	3	76	0.0394737
NODE_303139_length_163_cov_198.078125	87	163	10	4	76	0.0526316
NODE_303139_length_163_cov_198.078125	87	163	14	2	76	0.0263158
NODE_303139_length_163_cov_198.078125	87	163	20	12	76	0.1578947
NODE_303139_length_163_cov_198.078125	87	163	24	10	76	0.1315790
NODE_303139_length_163_cov_198.078125	87	163	26	2	76	0.0263158
NODE_303139_length_163_cov_198.078125	87	163	28	12	76	0.1578947
NODE_303139_length_163_cov_198.078125	87	163	30	2	76	0.0263158
NODE_303139_length_163_cov_198.078125	87	163	32	20	76	0.2631579
NODE_303139_length_163_cov_198.078125	87	163	0	6	76	0.0789474
NODE_303139_length_163_cov_198.078125	87	163	2	3	76	0.0394737
NODE_303139_length_163_cov_198.078125	87	163	4	3	76	0.0394737
NODE_303139_length_163_cov_198.078125	87	163	10	4	76	0.0526316
NODE_303139_length_163_cov_198.078125	87	163	14	2	76	0.0263158
NODE_303139_length_163_cov_198.078125	87	163	20	12	76	0.1578947
NODE_303139_length_163_cov_198.078125	87	163	24	10	76	0.1315790
NODE_303139_length_163_cov_198.078125	87	163	26	2	76	0.0263158
NODE_303139_length_163_cov_198.078125	87	163	28	12	76	0.1578947
NODE_303139_length_163_cov_198.078125	87	163	30	2	76	0.0263158
NODE_303139_length_163_cov_198.078125	87	163	32	20	76	0.2631579
NODE_303139_length_163_cov_198.078125	87	163	0	6	76	0.0789474
NODE_303139_length_163_cov_198.078125	87	163	2	3	76	0.0394737
NODE_303139_length_163_cov_198.078125	87	163	4	3	76	0.0394737
NODE_303139_length_163_cov_198.078125	87	163	10	4	76	0.0526316
NODE_303139_length_163_cov_198.078125	87	163	14	2	76	0.0263158
NODE_303139_length_163_cov_198.078125	87	163	20	12	76	0.1578947
NODE_303139_length_163_cov_198.078125	87	163	24	10	76	0.1315790
NODE_303139_length_163_cov_198.078125	87	163	26	2	76	0.0263158
NODE_303139_length_163_cov_198.078125	87	163	28	12	76	0.1578947
NODE_303139_length_163_cov_198.078125	87	163	30	2	76	0.0263158
NODE_303139_length_163_cov_198.078125	87	163	32	20	76	0.2631579
NODE_303231_length_162_cov_421.047619	7	56	31	1	49	0.0204082
NODE_303231_length_162_cov_421.047619	7	56	37	1	49	0.0204082
NODE_303231_length_162_cov_421.047619	7	56	38	1	49	0.0204082
NODE_303231_length_162_cov_421.047619	7	56	50	1	49	0.0204082
NODE_303231_length_162_cov_421.047619	7	56	51	1	49	0.0204082
NODE_303231_length_162_cov_421.047619	7	56	53	1	49	0.0204082
NODE_303231_length_162_cov_421.047619	7	56	61	1	49	0.0204082
NODE_303231_length_162_cov_421.047619	7	56	71	1	49	0.0204082
NODE_303231_length_162_cov_421.047619	7	56	74	2	49	0.0408163
NODE_303231_length_162_cov_421.047619	7	56	78	1	49	0.0204082
NODE_303231_length_162_cov_421.047619	7	56	91	1	49	0.0204082
NODE_303231_length_162_cov_421.047619	7	56	97	1	49	0.0204082
NODE_303231_length_162_cov_421.047619	7	56	106	1	49	0.0204082
NODE_303231_length_162_cov_421.047619	7	56	107	3	49	0.0612245
NODE_303231_length_162_cov_421.047619	7	56	116	3	49	0.0612245
NODE_303231_length_162_cov_421.047619	7	56	118	8	49	0.1632653
NODE_303231_length_162_cov_421.047619	7	56	130	1	49	0.0204082
NODE_303231_length_162_cov_421.047619	7	56	132	1	49	0.0204082
NODE_303231_length_162_cov_421.047619	7	56	138	1	49	0.0204082
NODE_303231_length_162_cov_421.047619	7	56	144	1	49	0.0204082
NODE_303231_length_162_cov_421.047619	7	56	148	2	49	0.0408163
NODE_303231_length_162_cov_421.047619	7	56	165	1	49	0.0204082
NODE_303231_length_162_cov_421.047619	7	56	168	1	49	0.0204082
NODE_303231_length_162_cov_421.047619	7	56	173	3	49	0.0612245
NODE_303231_length_162_cov_421.047619	7	56	175	2	49	0.0408163
NODE_303231_length_162_cov_421.047619	7	56	181	1	49	0.0204082
NODE_303231_length_162_cov_421.047619	7	56	192	1	49	0.0204082
NODE_303231_length_162_cov_421.047619	7	56	200	1	49	0.0204082
NODE_303231_length_162_cov_421.047619	7	56	202	1	49	0.0204082
NODE_303231_length_162_cov_421.047619	7	56	206	1	49	0.0204082
NODE_303231_length_162_cov_421.047619	7	56	208	1	49	0.0204082
NODE_303231_length_162_cov_421.047619	7	56	210	1	49	0.0204082
NODE_303231_length_162_cov_421.047619	7	56	212	1	49	0.0204082
NODE_303231_length_162_cov_421.047619	29	90	118	6	61	0.0983607
NODE_303231_length_162_cov_421.047619	29	90	130	1	61	0.0163934
NODE_303231_length_162_cov_421.047619	29	90	132	1	61	0.0163934
NODE_303231_length_162_cov_421.047619	29	90	138	1	61	0.0163934
NODE_303231_length_162_cov_421.047619	29	90	144	1	61	0.0163934
NODE_303231_length_162_cov_421.047619	29	90	148	2	61	0.0327869
NODE_303231_length_162_cov_421.047619	29	90	165	1	61	0.0163934
NODE_303231_length_162_cov_421.047619	29	90	168	1	61	0.0163934
NODE_303231_length_162_cov_421.047619	29	90	173	3	61	0.0491803
NODE_303231_length_162_cov_421.047619	29	90	175	2	61	0.0327869
NODE_303231_length_162_cov_421.047619	29	90	181	1	61	0.0163934
NODE_303231_length_162_cov_421.047619	29	90	192	1	61	0.0163934
NODE_303231_length_162_cov_421.047619	29	90	200	1	61	0.0163934
NODE_303231_length_162_cov_421.047619	29	90	202	1	61	0.0163934
NODE_303231_length_162_cov_421.047619	29	90	206	1	61	0.0163934
NODE_303231_length_162_cov_421.047619	29	90	208	1	61	0.0163934
NODE_303231_length_162_cov_421.047619	29	90	210	1	61	0.0163934
NODE_303231_length_162_cov_421.047619	29	90	212	2	61	0.0327869
NODE_303231_length_162_cov_421.047619	29	90	214	3	61	0.0491803
NODE_303231_length_162_cov_421.047619	29	90	216	30	61	0.4918033
NODE_303231_length_162_cov_421.047619	29	92	118	6	63	0.0952381
NODE_303231_length_162_cov_421.047619	29	92	130	1	63	0.0158730
NODE_303231_length_162_cov_421.047619	29	92	132	1	63	0.0158730
NODE_303231_length_162_cov_421.047619	29	92	138	1	63	0.0158730
NODE_303231_length_162_cov_421.047619	29	92	144	1	63	0.0158730
NODE_303231_length_162_cov_421.047619	29	92	148	2	63	0.0317460
NODE_303231_length_162_cov_421.047619	29	92	165	1	63	0.0158730
NODE_303231_length_162_cov_421.047619	29	92	168	1	63	0.0158730
NODE_303231_length_162_cov_421.047619	29	92	173	3	63	0.0476190
NODE_303231_length_162_cov_421.047619	29	92	175	2	63	0.0317460
NODE_303231_length_162_cov_421.047619	29	92	181	1	63	0.0158730
NODE_303231_length_162_cov_421.047619	29	92	192	1	63	0.0158730
NODE_303231_length_162_cov_421.047619	29	92	200	1	63	0.0158730
NODE_303231_length_162_cov_421.047619	29	92	202	1	63	0.0158730
NODE_303231_length_162_cov_421.047619	29	92	206	1	63	0.0158730
NODE_303231_length_162_cov_421.047619	29	92	208	1	63	0.0158730
NODE_303231_length_162_cov_421.047619	29	92	210	1	63	0.0158730
NODE_303231_length_162_cov_421.047619	29	92	212	2	63	0.0317460
NODE_303231_length_162_cov_421.047619	29	92	214	3	63	0.0476190
NODE_303231_length_162_cov_421.047619	29	92	216	32	63	0.5079365
NODE_303231_length_162_cov_421.047619	29	92	118	6	63	0.0952381
NODE_303231_length_162_cov_421.047619	29	92	130	1	63	0.0158730
NODE_303231_length_162_cov_421.047619	29	92	132	1	63	0.0158730
NODE_303231_length_162_cov_421.047619	29	92	138	1	63	0.0158730
NODE_303231_length_162_cov_421.047619	29	92	144	1	63	0.0158730
NODE_303231_length_162_cov_421.047619	29	92	148	2	63	0.0317460
NODE_303231_length_162_cov_421.047619	29	92	165	1	63	0.0158730
NODE_303231_length_162_cov_421.047619	29	92	168	1	63	0.0158730
NODE_303231_length_162_cov_421.047619	29	92	173	3	63	0.0476190
NODE_303231_length_162_cov_421.047619	29	92	175	2	63	0.0317460
NODE_303231_length_162_cov_421.047619	29	92	181	1	63	0.0158730
NODE_303231_length_162_cov_421.047619	29	92	192	1	63	0.0158730
NODE_303231_length_162_cov_421.047619	29	92	200	1	63	0.0158730
NODE_303231_length_162_cov_421.047619	29	92	202	1	63	0.0158730
NODE_303231_length_162_cov_421.047619	29	92	206	1	63	0.0158730
NODE_303231_length_162_cov_421.047619	29	92	208	1	63	0.0158730
NODE_303231_length_162_cov_421.047619	29	92	210	1	63	0.0158730
NODE_303231_length_162_cov_421.047619	29	92	212	2	63	0.0317460
NODE_303231_length_162_cov_421.047619	29	92	214	3	63	0.0476190
NODE_303231_length_162_cov_421.047619	29	92	216	32	63	0.5079365
NODE_303231_length_162_cov_421.047619	29	92	118	6	63	0.0952381
NODE_303231_length_162_cov_421.047619	29	92	130	1	63	0.0158730
NODE_303231_length_162_cov_421.047619	29	92	132	1	63	0.0158730
NODE_303231_length_162_cov_421.047619	29	92	138	1	63	0.0158730
NODE_303231_length_162_cov_421.047619	29	92	144	1	63	0.0158730
NODE_303231_length_162_cov_421.047619	29	92	148	2	63	0.0317460
NODE_303231_length_162_cov_421.047619	29	92	165	1	63	0.0158730
NODE_303231_length_162_cov_421.047619	29	92	168	1	63	0.0158730
NODE_303231_length_162_cov_421.047619	29	92	173	3	63	0.0476190
NODE_303231_length_162_cov_421.047619	29	92	175	2	63	0.0317460
NODE_303231_length_162_cov_421.047619	29	92	181	1	63	0.0158730
NODE_303231_length_162_cov_421.047619	29	92	192	1	63	0.0158730
NODE_303231_length_162_cov_421.047619	29	92	200	1	63	0.0158730
NODE_303231_length_162_cov_421.047619	29	92	202	1	63	0.0158730
NODE_303231_length_162_cov_421.047619	29	92	206	1	63	0.0158730
NODE_303231_length_162_cov_421.047619	29	92	208	1	63	0.0158730
NODE_303231_length_162_cov_421.047619	29	92	210	1	63	0.0158730
NODE_303231_length_162_cov_421.047619	29	92	212	2	63	0.0317460
NODE_303231_length_162_cov_421.047619	29	92	214	3	63	0.0476190
NODE_303231_length_162_cov_421.047619	29	92	216	32	63	0.5079365
NODE_303250_length_162_cov_45.380952	63	127	17	1	64	0.0156250
NODE_303250_length_162_cov_45.380952	63	127	18	6	64	0.0937500
NODE_303250_length_162_cov_45.380952	63	127	22	3	64	0.0468750
NODE_303250_length_162_cov_45.380952	63	127	24	1	64	0.0156250
NODE_303250_length_162_cov_45.380952	63	127	28	5	64	0.0781250
NODE_303250_length_162_cov_45.380952	63	127	32	48	64	0.7500000
NODE_303250_length_162_cov_45.380952	63	127	17	1	64	0.0156250
NODE_303250_length_162_cov_45.380952	63	127	18	6	64	0.0937500
NODE_303250_length_162_cov_45.380952	63	127	22	3	64	0.0468750
NODE_303250_length_162_cov_45.380952	63	127	24	1	64	0.0156250
NODE_303250_length_162_cov_45.380952	63	127	28	5	64	0.0781250
NODE_303250_length_162_cov_45.380952	63	127	32	48	64	0.7500000
NODE_303250_length_162_cov_45.380952	100	162	0	8	62	0.1290323
NODE_303250_length_162_cov_45.380952	100	162	2	6	62	0.0967742
NODE_303250_length_162_cov_45.380952	100	162	4	3	62	0.0483871
NODE_303250_length_162_cov_45.380952	100	162	6	5	62	0.0806452
NODE_303250_length_162_cov_45.380952	100	162	8	3	62	0.0483871
NODE_303250_length_162_cov_45.380952	100	162	12	3	62	0.0483871
NODE_303250_length_162_cov_45.380952	100	162	14	5	62	0.0806452
NODE_303250_length_162_cov_45.380952	100	162	16	1	62	0.0161290
NODE_303250_length_162_cov_45.380952	100	162	17	2	62	0.0322581
NODE_303250_length_162_cov_45.380952	100	162	18	6	62	0.0967742
NODE_303250_length_162_cov_45.380952	100	162	22	3	62	0.0483871
NODE_303250_length_162_cov_45.380952	100	162	24	1	62	0.0161290
NODE_303250_length_162_cov_45.380952	100	162	28	5	62	0.0806452
NODE_303250_length_162_cov_45.380952	100	162	32	11	62	0.1774193
NODE_303301_length_161_cov_1483.177419	51	131	72	2	80	0.0250000
NODE_303301_length_161_cov_1483.177419	51	131	75	6	80	0.0750000
NODE_303301_length_161_cov_1483.177419	51	131	76	1	80	0.0125000
NODE_303301_length_161_cov_1483.177419	51	131	77	2	80	0.0250000
NODE_303301_length_161_cov_1483.177419	51	131	80	1	80	0.0125000
NODE_303301_length_161_cov_1483.177419	51	131	81	4	80	0.0500000
NODE_303301_length_161_cov_1483.177419	51	131	82	2	80	0.0250000
NODE_303301_length_161_cov_1483.177419	51	131	84	1	80	0.0125000
NODE_303301_length_161_cov_1483.177419	51	131	88	2	80	0.0250000
NODE_303301_length_161_cov_1483.177419	51	131	90	1	80	0.0125000
NODE_303301_length_161_cov_1483.177419	51	131	92	2	80	0.0250000
NODE_303301_length_161_cov_1483.177419	51	131	94	10	80	0.1250000
NODE_303301_length_161_cov_1483.177419	51	131	96	1	80	0.0125000
NODE_303301_length_161_cov_1483.177419	51	131	98	11	80	0.1375000
NODE_303301_length_161_cov_1483.177419	51	131	99	30	80	0.3750000
NODE_303301_length_161_cov_1483.177419	51	131	100	4	80	0.0500000
NODE_303301_length_161_cov_1483.177419	104	161	12	4	57	0.0701754
NODE_303301_length_161_cov_1483.177419	104	161	18	2	57	0.0350877
NODE_303301_length_161_cov_1483.177419	104	161	20	1	57	0.0175439
NODE_303301_length_161_cov_1483.177419	104	161	22	1	57	0.0175439
NODE_303301_length_161_cov_1483.177419	104	161	23	1	57	0.0175439
NODE_303301_length_161_cov_1483.177419	104	161	27	1	57	0.0175439
NODE_303301_length_161_cov_1483.177419	104	161	35	1	57	0.0175439
NODE_303301_length_161_cov_1483.177419	104	161	37	1	57	0.0175439
NODE_303301_length_161_cov_1483.177419	104	161	41	1	57	0.0175439
NODE_303301_length_161_cov_1483.177419	104	161	43	1	57	0.0175439
NODE_303301_length_161_cov_1483.177419	104	161	45	1	57	0.0175439
NODE_303301_length_161_cov_1483.177419	104	161	47	2	57	0.0350877
NODE_303301_length_161_cov_1483.177419	104	161	49	2	57	0.0350877
NODE_303301_length_161_cov_1483.177419	104	161	50	1	57	0.0175439
NODE_303301_length_161_cov_1483.177419	104	161	59	1	57	0.0175439
NODE_303301_length_161_cov_1483.177419	104	161	61	3	57	0.0526316
NODE_303301_length_161_cov_1483.177419	104	161	62	1	57	0.0175439
NODE_303301_length_161_cov_1483.177419	104	161	68	1	57	0.0175439
NODE_303301_length_161_cov_1483.177419	104	161	71	1	57	0.0175439
NODE_303301_length_161_cov_1483.177419	104	161	73	2	57	0.0350877
NODE_303301_length_161_cov_1483.177419	104	161	75	7	57	0.1228070
NODE_303301_length_161_cov_1483.177419	104	161	77	2	57	0.0350877
NODE_303301_length_161_cov_1483.177419	104	161	81	4	57	0.0701754
NODE_303301_length_161_cov_1483.177419	104	161	82	2	57	0.0350877
NODE_303301_length_161_cov_1483.177419	104	161	84	1	57	0.0175439
NODE_303301_length_161_cov_1483.177419	104	161	88	1	57	0.0175439
NODE_303301_length_161_cov_1483.177419	104	161	92	1	57	0.0175439
NODE_303301_length_161_cov_1483.177419	104	161	94	9	57	0.1578947
NODE_303301_length_161_cov_1483.177419	104	161	96	1	57	0.0175439
NODE_303312_length_161_cov_71.500000	33	110	0	77	77	1.0000000
NODE_303312_length_161_cov_71.500000	33	110	0	77	77	1.0000000
NODE_303312_length_161_cov_71.500000	33	110	0	77	77	1.0000000
NODE_303312_length_161_cov_71.500000	33	110	0	77	77	1.0000000
NODE_303312_length_161_cov_71.500000	83	149	0	66	66	1.0000000
NODE_303312_length_161_cov_71.500000	83	161	0	78	78	1.0000000
NODE_303312_length_161_cov_71.500000	86	161	0	75	75	1.0000000
NODE_303312_length_161_cov_71.500000	86	161	0	75	75	1.0000000
NODE_303312_length_161_cov_71.500000	88	161	0	73	73	1.0000000
NODE_303321_length_161_cov_29.758065	0	80	0	3	80	0.0375000
NODE_303321_length_161_cov_29.758065	0	80	4	2	80	0.0250000
NODE_303321_length_161_cov_29.758065	0	80	16	7	80	0.0875000
NODE_303321_length_161_cov_29.758065	0	80	18	9	80	0.1125000
NODE_303321_length_161_cov_29.758065	0	80	20	1	80	0.0125000
NODE_303321_length_161_cov_29.758065	0	80	22	2	80	0.0250000
NODE_303321_length_161_cov_29.758065	0	80	24	4	80	0.0500000
NODE_303321_length_161_cov_29.758065	0	80	26	4	80	0.0500000
NODE_303321_length_161_cov_29.758065	0	80	28	3	80	0.0375000
NODE_303321_length_161_cov_29.758065	0	80	30	22	80	0.2750000
NODE_303321_length_161_cov_29.758065	0	80	32	23	80	0.2875000
NODE_303381_length_160_cov_143.573770	45	125	8	7	80	0.0875000
NODE_303381_length_160_cov_143.573770	45	125	10	12	80	0.1500000
NODE_303381_length_160_cov_143.573770	45	125	12	61	80	0.7625000
NODE_303381_length_160_cov_143.573770	93	160	4	31	67	0.4626866
NODE_303381_length_160_cov_143.573770	93	160	6	3	67	0.0447761
NODE_303381_length_160_cov_143.573770	93	160	8	8	67	0.1194030
NODE_303381_length_160_cov_143.573770	93	160	10	12	67	0.1791045
NODE_303381_length_160_cov_143.573770	93	160	12	13	67	0.1940299
NODE_303381_length_160_cov_143.573770	98	120	8	2	22	0.0909091
NODE_303381_length_160_cov_143.573770	98	120	10	12	22	0.5454546
NODE_303381_length_160_cov_143.573770	98	120	12	8	22	0.3636364
NODE_303388_length_160_cov_58.245902	0	45	1	10	45	0.2222222
NODE_303388_length_160_cov_58.245902	0	45	3	4	45	0.0888889
NODE_303388_length_160_cov_58.245902	0	45	5	1	45	0.0222222
NODE_303388_length_160_cov_58.245902	0	45	8	14	45	0.3111111
NODE_303388_length_160_cov_58.245902	0	45	10	1	45	0.0222222
NODE_303388_length_160_cov_58.245902	0	45	12	15	45	0.3333333
NODE_303431_length_159_cov_182.016667	71	156	20	10	85	0.1176471
NODE_303431_length_159_cov_182.016667	71	156	26	3	85	0.0352941
NODE_303431_length_159_cov_182.016667	71	156	28	6	85	0.0705882
NODE_303431_length_159_cov_182.016667	71	156	30	3	85	0.0352941
NODE_303431_length_159_cov_182.016667	71	156	32	6	85	0.0705882
NODE_303431_length_159_cov_182.016667	71	156	36	17	85	0.2000000
NODE_303431_length_159_cov_182.016667	71	156	38	40	85	0.4705882
NODE_303431_length_159_cov_182.016667	71	156	20	10	85	0.1176471
NODE_303431_length_159_cov_182.016667	71	156	26	3	85	0.0352941
NODE_303431_length_159_cov_182.016667	71	156	28	6	85	0.0705882
NODE_303431_length_159_cov_182.016667	71	156	30	3	85	0.0352941
NODE_303431_length_159_cov_182.016667	71	156	32	6	85	0.0705882
NODE_303431_length_159_cov_182.016667	71	156	36	17	85	0.2000000
NODE_303431_length_159_cov_182.016667	71	156	38	40	85	0.4705882
NODE_303431_length_159_cov_182.016667	71	156	20	10	85	0.1176471
NODE_303431_length_159_cov_182.016667	71	156	26	3	85	0.0352941
NODE_303431_length_159_cov_182.016667	71	156	28	6	85	0.0705882
NODE_303431_length_159_cov_182.016667	71	156	30	3	85	0.0352941
NODE_303431_length_159_cov_182.016667	71	156	32	6	85	0.0705882
NODE_303431_length_159_cov_182.016667	71	156	36	17	85	0.2000000
NODE_303431_length_159_cov_182.016667	71	156	38	40	85	0.4705882
NODE_303440_length_159_cov_85.750000	0	43	20	14	43	0.3255814
NODE_303440_length_159_cov_85.750000	0	43	24	2	43	0.0465116
NODE_303440_length_159_cov_85.750000	0	43	26	2	43	0.0465116
NODE_303440_length_159_cov_85.750000	0	43	28	5	43	0.1162791
NODE_303440_length_159_cov_85.750000	0	43	34	2	43	0.0465116
NODE_303440_length_159_cov_85.750000	0	43	40	3	43	0.0697674
NODE_303440_length_159_cov_85.750000	0	43	44	5	43	0.1162791
NODE_303440_length_159_cov_85.750000	0	43	46	1	43	0.0232558
NODE_303440_length_159_cov_85.750000	0	43	48	4	43	0.0930233
NODE_303440_length_159_cov_85.750000	0	43	50	5	43	0.1162791
NODE_303440_length_159_cov_85.750000	16	97	26	2	81	0.0246914
NODE_303440_length_159_cov_85.750000	16	97	28	5	81	0.0617284
NODE_303440_length_159_cov_85.750000	16	97	34	2	81	0.0246914
NODE_303440_length_159_cov_85.750000	16	97	40	3	81	0.0370370
NODE_303440_length_159_cov_85.750000	16	97	44	5	81	0.0617284
NODE_303440_length_159_cov_85.750000	16	97	46	1	81	0.0123457
NODE_303440_length_159_cov_85.750000	16	97	48	4	81	0.0493827
NODE_303440_length_159_cov_85.750000	16	97	50	9	81	0.1111111
NODE_303440_length_159_cov_85.750000	16	97	56	7	81	0.0864198
NODE_303440_length_159_cov_85.750000	16	97	58	1	81	0.0123457
NODE_303440_length_159_cov_85.750000	16	97	60	23	81	0.2839506
NODE_303440_length_159_cov_85.750000	16	97	61	2	81	0.0246914
NODE_303440_length_159_cov_85.750000	16	97	62	17	81	0.2098765
NODE_303440_length_159_cov_85.750000	65	145	46	9	80	0.1125000
NODE_303440_length_159_cov_85.750000	65	145	48	10	80	0.1250000
NODE_303440_length_159_cov_85.750000	65	145	50	4	80	0.0500000
NODE_303440_length_159_cov_85.750000	65	145	54	6	80	0.0750000
NODE_303440_length_159_cov_85.750000	65	145	56	4	80	0.0500000
NODE_303440_length_159_cov_85.750000	65	145	58	4	80	0.0500000
NODE_303440_length_159_cov_85.750000	65	145	60	15	80	0.1875000
NODE_303440_length_159_cov_85.750000	65	145	61	2	80	0.0250000
NODE_303440_length_159_cov_85.750000	65	145	62	26	80	0.3250000
NODE_303440_length_159_cov_85.750000	70	92	60	8	22	0.3636364
NODE_303440_length_159_cov_85.750000	70	92	61	2	22	0.0909091
NODE_303440_length_159_cov_85.750000	70	92	62	12	22	0.5454546
NODE_303546_length_158_cov_119.813559	34	77	22	14	43	0.3255814
NODE_303546_length_158_cov_119.813559	34	77	24	29	43	0.6744186
NODE_303546_length_158_cov_119.813559	78	113	22	6	35	0.1714286
NODE_303546_length_158_cov_119.813559	78	113	24	29	35	0.8285714
NODE_303546_length_158_cov_119.813559	123	158	4	9	35	0.2571429
NODE_303546_length_158_cov_119.813559	123	158	6	2	35	0.0571429
NODE_303546_length_158_cov_119.813559	123	158	8	7	35	0.2000000
NODE_303546_length_158_cov_119.813559	123	158	10	2	35	0.0571429
NODE_303546_length_158_cov_119.813559	123	158	11	2	35	0.0571429
NODE_303546_length_158_cov_119.813559	123	158	12	2	35	0.0571429
NODE_303546_length_158_cov_119.813559	123	158	14	2	35	0.0571429
NODE_303546_length_158_cov_119.813559	123	158	18	9	35	0.2571429
NODE_303552_length_158_cov_70.135593	5	82	0	50	77	0.6493506
NODE_303552_length_158_cov_70.135593	5	82	2	27	77	0.3506494
NODE_303552_length_158_cov_70.135593	5	82	0	50	77	0.6493506
NODE_303552_length_158_cov_70.135593	5	82	2	27	77	0.3506494
NODE_303552_length_158_cov_70.135593	81	155	0	22	74	0.2972973
NODE_303552_length_158_cov_70.135593	81	155	2	52	74	0.7027027
NODE_303555_length_158_cov_63.559322	80	151	4	34	71	0.4788733
NODE_303555_length_158_cov_63.559322	80	151	8	37	71	0.5211267
NODE_303556_length_158_cov_61.203390	2	66	40	1	64	0.0156250
NODE_303556_length_158_cov_61.203390	2	66	47	1	64	0.0156250
NODE_303556_length_158_cov_61.203390	2	66	51	1	64	0.0156250
NODE_303556_length_158_cov_61.203390	2	66	53	1	64	0.0156250
NODE_303556_length_158_cov_61.203390	2	66	57	1	64	0.0156250
NODE_303556_length_158_cov_61.203390	2	66	65	1	64	0.0156250
NODE_303556_length_158_cov_61.203390	2	66	110	5	64	0.0781250
NODE_303556_length_158_cov_61.203390	2	66	117	1	64	0.0156250
NODE_303556_length_158_cov_61.203390	2	66	119	2	64	0.0312500
NODE_303556_length_158_cov_61.203390	2	66	121	1	64	0.0156250
NODE_303556_length_158_cov_61.203390	2	66	123	1	64	0.0156250
NODE_303556_length_158_cov_61.203390	2	66	131	1	64	0.0156250
NODE_303556_length_158_cov_61.203390	2	66	145	1	64	0.0156250
NODE_303556_length_158_cov_61.203390	2	66	148	1	64	0.0156250
NODE_303556_length_158_cov_61.203390	2	66	156	1	64	0.0156250
NODE_303556_length_158_cov_61.203390	2	66	158	1	64	0.0156250
NODE_303556_length_158_cov_61.203390	2	66	162	1	64	0.0156250
NODE_303556_length_158_cov_61.203390	2	66	174	1	64	0.0156250
NODE_303556_length_158_cov_61.203390	2	66	178	1	64	0.0156250
NODE_303556_length_158_cov_61.203390	2	66	194	1	64	0.0156250
NODE_303556_length_158_cov_61.203390	2	66	201	1	64	0.0156250
NODE_303556_length_158_cov_61.203390	2	66	205	1	64	0.0156250
NODE_303556_length_158_cov_61.203390	2	66	207	1	64	0.0156250
NODE_303556_length_158_cov_61.203390	2	66	214	1	64	0.0156250
NODE_303556_length_158_cov_61.203390	2	66	220	1	64	0.0156250
NODE_303556_length_158_cov_61.203390	2	66	226	1	64	0.0156250
NODE_303556_length_158_cov_61.203390	2	66	231	1	64	0.0156250
NODE_303556_length_158_cov_61.203390	2	66	232	1	64	0.0156250
NODE_303556_length_158_cov_61.203390	2	66	242	5	64	0.0781250
NODE_303556_length_158_cov_61.203390	2	66	250	2	64	0.0312500
NODE_303556_length_158_cov_61.203390	2	66	266	1	64	0.0156250
NODE_303556_length_158_cov_61.203390	2	66	273	1	64	0.0156250
NODE_303556_length_158_cov_61.203390	2	66	277	1	64	0.0156250
NODE_303556_length_158_cov_61.203390	2	66	295	2	64	0.0312500
NODE_303556_length_158_cov_61.203390	2	66	297	1	64	0.0156250
NODE_303556_length_158_cov_61.203390	2	66	299	1	64	0.0156250
NODE_303556_length_158_cov_61.203390	2	66	300	1	64	0.0156250
NODE_303556_length_158_cov_61.203390	2	66	302	1	64	0.0156250
NODE_303556_length_158_cov_61.203390	2	66	304	2	64	0.0312500
NODE_303556_length_158_cov_61.203390	2	66	309	1	64	0.0156250
NODE_303556_length_158_cov_61.203390	2	66	311	1	64	0.0156250
NODE_303556_length_158_cov_61.203390	2	66	312	4	64	0.0625000
NODE_303556_length_158_cov_61.203390	2	66	313	7	64	0.1093750
NODE_303556_length_158_cov_61.203390	2	66	40	1	64	0.0156250
NODE_303556_length_158_cov_61.203390	2	66	47	1	64	0.0156250
NODE_303556_length_158_cov_61.203390	2	66	51	1	64	0.0156250
NODE_303556_length_158_cov_61.203390	2	66	53	1	64	0.0156250
NODE_303556_length_158_cov_61.203390	2	66	57	1	64	0.0156250
NODE_303556_length_158_cov_61.203390	2	66	65	1	64	0.0156250
NODE_303556_length_158_cov_61.203390	2	66	110	5	64	0.0781250
NODE_303556_length_158_cov_61.203390	2	66	117	1	64	0.0156250
NODE_303556_length_158_cov_61.203390	2	66	119	2	64	0.0312500
NODE_303556_length_158_cov_61.203390	2	66	121	1	64	0.0156250
NODE_303556_length_158_cov_61.203390	2	66	123	1	64	0.0156250
NODE_303556_length_158_cov_61.203390	2	66	131	1	64	0.0156250
NODE_303556_length_158_cov_61.203390	2	66	145	1	64	0.0156250
NODE_303556_length_158_cov_61.203390	2	66	148	1	64	0.0156250
NODE_303556_length_158_cov_61.203390	2	66	156	1	64	0.0156250
NODE_303556_length_158_cov_61.203390	2	66	158	1	64	0.0156250
NODE_303556_length_158_cov_61.203390	2	66	162	1	64	0.0156250
NODE_303556_length_158_cov_61.203390	2	66	174	1	64	0.0156250
NODE_303556_length_158_cov_61.203390	2	66	178	1	64	0.0156250
NODE_303556_length_158_cov_61.203390	2	66	194	1	64	0.0156250
NODE_303556_length_158_cov_61.203390	2	66	201	1	64	0.0156250
NODE_303556_length_158_cov_61.203390	2	66	205	1	64	0.0156250
NODE_303556_length_158_cov_61.203390	2	66	207	1	64	0.0156250
NODE_303556_length_158_cov_61.203390	2	66	214	1	64	0.0156250
NODE_303556_length_158_cov_61.203390	2	66	220	1	64	0.0156250
NODE_303556_length_158_cov_61.203390	2	66	226	1	64	0.0156250
NODE_303556_length_158_cov_61.203390	2	66	231	1	64	0.0156250
NODE_303556_length_158_cov_61.203390	2	66	232	1	64	0.0156250
NODE_303556_length_158_cov_61.203390	2	66	242	5	64	0.0781250
NODE_303556_length_158_cov_61.203390	2	66	250	2	64	0.0312500
NODE_303556_length_158_cov_61.203390	2	66	266	1	64	0.0156250
NODE_303556_length_158_cov_61.203390	2	66	273	1	64	0.0156250
NODE_303556_length_158_cov_61.203390	2	66	277	1	64	0.0156250
NODE_303556_length_158_cov_61.203390	2	66	295	2	64	0.0312500
NODE_303556_length_158_cov_61.203390	2	66	297	1	64	0.0156250
NODE_303556_length_158_cov_61.203390	2	66	299	1	64	0.0156250
NODE_303556_length_158_cov_61.203390	2	66	300	1	64	0.0156250
NODE_303556_length_158_cov_61.203390	2	66	302	1	64	0.0156250
NODE_303556_length_158_cov_61.203390	2	66	304	2	64	0.0312500
NODE_303556_length_158_cov_61.203390	2	66	309	1	64	0.0156250
NODE_303556_length_158_cov_61.203390	2	66	311	1	64	0.0156250
NODE_303556_length_158_cov_61.203390	2	66	312	4	64	0.0625000
NODE_303556_length_158_cov_61.203390	2	66	313	7	64	0.1093750
NODE_303556_length_158_cov_61.203390	2	66	40	1	64	0.0156250
NODE_303556_length_158_cov_61.203390	2	66	47	1	64	0.0156250
NODE_303556_length_158_cov_61.203390	2	66	51	1	64	0.0156250
NODE_303556_length_158_cov_61.203390	2	66	53	1	64	0.0156250
NODE_303556_length_158_cov_61.203390	2	66	57	1	64	0.0156250
NODE_303556_length_158_cov_61.203390	2	66	65	1	64	0.0156250
NODE_303556_length_158_cov_61.203390	2	66	110	5	64	0.0781250
NODE_303556_length_158_cov_61.203390	2	66	117	1	64	0.0156250
NODE_303556_length_158_cov_61.203390	2	66	119	2	64	0.0312500
NODE_303556_length_158_cov_61.203390	2	66	121	1	64	0.0156250
NODE_303556_length_158_cov_61.203390	2	66	123	1	64	0.0156250
NODE_303556_length_158_cov_61.203390	2	66	131	1	64	0.0156250
NODE_303556_length_158_cov_61.203390	2	66	145	1	64	0.0156250
NODE_303556_length_158_cov_61.203390	2	66	148	1	64	0.0156250
NODE_303556_length_158_cov_61.203390	2	66	156	1	64	0.0156250
NODE_303556_length_158_cov_61.203390	2	66	158	1	64	0.0156250
NODE_303556_length_158_cov_61.203390	2	66	162	1	64	0.0156250
NODE_303556_length_158_cov_61.203390	2	66	174	1	64	0.0156250
NODE_303556_length_158_cov_61.203390	2	66	178	1	64	0.0156250
NODE_303556_length_158_cov_61.203390	2	66	194	1	64	0.0156250
NODE_303556_length_158_cov_61.203390	2	66	201	1	64	0.0156250
NODE_303556_length_158_cov_61.203390	2	66	205	1	64	0.0156250
NODE_303556_length_158_cov_61.203390	2	66	207	1	64	0.0156250
NODE_303556_length_158_cov_61.203390	2	66	214	1	64	0.0156250
NODE_303556_length_158_cov_61.203390	2	66	220	1	64	0.0156250
NODE_303556_length_158_cov_61.203390	2	66	226	1	64	0.0156250
NODE_303556_length_158_cov_61.203390	2	66	231	1	64	0.0156250
NODE_303556_length_158_cov_61.203390	2	66	232	1	64	0.0156250
NODE_303556_length_158_cov_61.203390	2	66	242	5	64	0.0781250
NODE_303556_length_158_cov_61.203390	2	66	250	2	64	0.0312500
NODE_303556_length_158_cov_61.203390	2	66	266	1	64	0.0156250
NODE_303556_length_158_cov_61.203390	2	66	273	1	64	0.0156250
NODE_303556_length_158_cov_61.203390	2	66	277	1	64	0.0156250
NODE_303556_length_158_cov_61.203390	2	66	295	2	64	0.0312500
NODE_303556_length_158_cov_61.203390	2	66	297	1	64	0.0156250
NODE_303556_length_158_cov_61.203390	2	66	299	1	64	0.0156250
NODE_303556_length_158_cov_61.203390	2	66	300	1	64	0.0156250
NODE_303556_length_158_cov_61.203390	2	66	302	1	64	0.0156250
NODE_303556_length_158_cov_61.203390	2	66	304	2	64	0.0312500
NODE_303556_length_158_cov_61.203390	2	66	309	1	64	0.0156250
NODE_303556_length_158_cov_61.203390	2	66	311	1	64	0.0156250
NODE_303556_length_158_cov_61.203390	2	66	312	4	64	0.0625000
NODE_303556_length_158_cov_61.203390	2	66	313	7	64	0.1093750
NODE_303556_length_158_cov_61.203390	39	119	242	1	80	0.0125000
NODE_303556_length_158_cov_61.203390	39	119	250	2	80	0.0250000
NODE_303556_length_158_cov_61.203390	39	119	266	3	80	0.0375000
NODE_303556_length_158_cov_61.203390	39	119	268	1	80	0.0125000
NODE_303556_length_158_cov_61.203390	39	119	272	1	80	0.0125000
NODE_303556_length_158_cov_61.203390	39	119	273	1	80	0.0125000
NODE_303556_length_158_cov_61.203390	39	119	277	1	80	0.0125000
NODE_303556_length_158_cov_61.203390	39	119	280	1	80	0.0125000
NODE_303556_length_158_cov_61.203390	39	119	282	1	80	0.0125000
NODE_303556_length_158_cov_61.203390	39	119	284	1	80	0.0125000
NODE_303556_length_158_cov_61.203390	39	119	288	1	80	0.0125000
NODE_303556_length_158_cov_61.203390	39	119	292	2	80	0.0250000
NODE_303556_length_158_cov_61.203390	39	119	295	2	80	0.0250000
NODE_303556_length_158_cov_61.203390	39	119	297	1	80	0.0125000
NODE_303556_length_158_cov_61.203390	39	119	299	2	80	0.0250000
NODE_303556_length_158_cov_61.203390	39	119	300	1	80	0.0125000
NODE_303556_length_158_cov_61.203390	39	119	302	1	80	0.0125000
NODE_303556_length_158_cov_61.203390	39	119	303	4	80	0.0500000
NODE_303556_length_158_cov_61.203390	39	119	304	5	80	0.0625000
NODE_303556_length_158_cov_61.203390	39	119	306	14	80	0.1750000
NODE_303556_length_158_cov_61.203390	39	119	307	3	80	0.0375000
NODE_303556_length_158_cov_61.203390	39	119	308	4	80	0.0500000
NODE_303556_length_158_cov_61.203390	39	119	309	1	80	0.0125000
NODE_303556_length_158_cov_61.203390	39	119	311	6	80	0.0750000
NODE_303556_length_158_cov_61.203390	39	119	312	13	80	0.1625000
NODE_303556_length_158_cov_61.203390	39	119	313	7	80	0.0875000
NODE_303563_length_158_cov_40.271186	43	107	28	64	64	1.0000000
NODE_303563_length_158_cov_40.271186	80	151	10	3	71	0.0422535
NODE_303563_length_158_cov_40.271186	80	151	12	23	71	0.3239437
NODE_303563_length_158_cov_40.271186	80	151	16	2	71	0.0281690
NODE_303563_length_158_cov_40.271186	80	151	18	6	71	0.0845070
NODE_303563_length_158_cov_40.271186	80	151	22	1	71	0.0140845
NODE_303563_length_158_cov_40.271186	80	151	24	5	71	0.0704225
NODE_303563_length_158_cov_40.271186	80	151	26	4	71	0.0563380
NODE_303563_length_158_cov_40.271186	80	151	28	27	71	0.3802817
NODE_303566_length_158_cov_29.661017	0	61	0	5	61	0.0819672
NODE_303566_length_158_cov_29.661017	0	61	4	56	61	0.9180328
NODE_303566_length_158_cov_29.661017	34	64	4	30	30	1.0000000
NODE_303605_length_157_cov_1488.586207	57	138	236	1	81	0.0123457
NODE_303605_length_157_cov_1488.586207	57	138	241	1	81	0.0123457
NODE_303605_length_157_cov_1488.586207	57	138	245	1	81	0.0123457
NODE_303605_length_157_cov_1488.586207	57	138	254	1	81	0.0123457
NODE_303605_length_157_cov_1488.586207	57	138	262	1	81	0.0123457
NODE_303605_length_157_cov_1488.586207	57	138	271	1	81	0.0123457
NODE_303605_length_157_cov_1488.586207	57	138	291	1	81	0.0123457
NODE_303605_length_157_cov_1488.586207	57	138	307	1	81	0.0123457
NODE_303605_length_157_cov_1488.586207	57	138	329	1	81	0.0123457
NODE_303605_length_157_cov_1488.586207	57	138	333	1	81	0.0123457
NODE_303605_length_157_cov_1488.586207	57	138	342	1	81	0.0123457
NODE_303605_length_157_cov_1488.586207	57	138	358	1	81	0.0123457
NODE_303605_length_157_cov_1488.586207	57	138	368	1	81	0.0123457
NODE_303605_length_157_cov_1488.586207	57	138	373	1	81	0.0123457
NODE_303605_length_157_cov_1488.586207	57	138	375	2	81	0.0246914
NODE_303605_length_157_cov_1488.586207	57	138	379	1	81	0.0123457
NODE_303605_length_157_cov_1488.586207	57	138	389	1	81	0.0123457
NODE_303605_length_157_cov_1488.586207	57	138	395	2	81	0.0246914
NODE_303605_length_157_cov_1488.586207	57	138	402	3	81	0.0370370
NODE_303605_length_157_cov_1488.586207	57	138	414	3	81	0.0370370
NODE_303605_length_157_cov_1488.586207	57	138	418	1	81	0.0123457
NODE_303605_length_157_cov_1488.586207	57	138	422	1	81	0.0123457
NODE_303605_length_157_cov_1488.586207	57	138	426	1	81	0.0123457
NODE_303605_length_157_cov_1488.586207	57	138	430	1	81	0.0123457
NODE_303605_length_157_cov_1488.586207	57	138	432	1	81	0.0123457
NODE_303605_length_157_cov_1488.586207	57	138	436	18	81	0.2222222
NODE_303605_length_157_cov_1488.586207	57	138	437	1	81	0.0123457
NODE_303605_length_157_cov_1488.586207	57	138	438	31	81	0.3827161
NODE_303605_length_157_cov_1488.586207	111	157	20	1	46	0.0217391
NODE_303605_length_157_cov_1488.586207	111	157	39	1	46	0.0217391
NODE_303605_length_157_cov_1488.586207	111	157	41	1	46	0.0217391
NODE_303605_length_157_cov_1488.586207	111	157	42	1	46	0.0217391
NODE_303605_length_157_cov_1488.586207	111	157	46	1	46	0.0217391
NODE_303605_length_157_cov_1488.586207	111	157	58	1	46	0.0217391
NODE_303605_length_157_cov_1488.586207	111	157	60	1	46	0.0217391
NODE_303605_length_157_cov_1488.586207	111	157	64	1	46	0.0217391
NODE_303605_length_157_cov_1488.586207	111	157	73	1	46	0.0217391
NODE_303605_length_157_cov_1488.586207	111	157	88	1	46	0.0217391
NODE_303605_length_157_cov_1488.586207	111	157	97	1	46	0.0217391
NODE_303605_length_157_cov_1488.586207	111	157	129	1	46	0.0217391
NODE_303605_length_157_cov_1488.586207	111	157	142	1	46	0.0217391
NODE_303605_length_157_cov_1488.586207	111	157	152	1	46	0.0217391
NODE_303605_length_157_cov_1488.586207	111	157	155	1	46	0.0217391
NODE_303605_length_157_cov_1488.586207	111	157	169	1	46	0.0217391
NODE_303605_length_157_cov_1488.586207	111	157	183	1	46	0.0217391
NODE_303605_length_157_cov_1488.586207	111	157	204	1	46	0.0217391
NODE_303605_length_157_cov_1488.586207	111	157	225	1	46	0.0217391
NODE_303605_length_157_cov_1488.586207	111	157	236	1	46	0.0217391
NODE_303605_length_157_cov_1488.586207	111	157	241	1	46	0.0217391
NODE_303605_length_157_cov_1488.586207	111	157	245	1	46	0.0217391
NODE_303605_length_157_cov_1488.586207	111	157	254	1	46	0.0217391
NODE_303605_length_157_cov_1488.586207	111	157	262	1	46	0.0217391
NODE_303605_length_157_cov_1488.586207	111	157	271	1	46	0.0217391
NODE_303605_length_157_cov_1488.586207	111	157	291	1	46	0.0217391
NODE_303605_length_157_cov_1488.586207	111	157	307	1	46	0.0217391
NODE_303605_length_157_cov_1488.586207	111	157	329	1	46	0.0217391
NODE_303605_length_157_cov_1488.586207	111	157	333	1	46	0.0217391
NODE_303605_length_157_cov_1488.586207	111	157	342	1	46	0.0217391
NODE_303605_length_157_cov_1488.586207	111	157	358	1	46	0.0217391
NODE_303605_length_157_cov_1488.586207	111	157	368	1	46	0.0217391
NODE_303605_length_157_cov_1488.586207	111	157	373	1	46	0.0217391
NODE_303605_length_157_cov_1488.586207	111	157	375	2	46	0.0434783
NODE_303605_length_157_cov_1488.586207	111	157	379	1	46	0.0217391
NODE_303605_length_157_cov_1488.586207	111	157	389	1	46	0.0217391
NODE_303605_length_157_cov_1488.586207	111	157	395	2	46	0.0434783
NODE_303605_length_157_cov_1488.586207	111	157	402	3	46	0.0652174
NODE_303605_length_157_cov_1488.586207	111	157	414	3	46	0.0652174
NODE_303605_length_157_cov_1488.586207	111	157	418	1	46	0.0217391
NODE_303606_length_157_cov_295.896552	32	78	22	4	46	0.0869565
NODE_303606_length_157_cov_295.896552	32	78	24	8	46	0.1739130
NODE_303606_length_157_cov_295.896552	32	78	26	4	46	0.0869565
NODE_303606_length_157_cov_295.896552	32	78	30	1	46	0.0217391
NODE_303606_length_157_cov_295.896552	32	78	32	1	46	0.0217391
NODE_303606_length_157_cov_295.896552	32	78	36	1	46	0.0217391
NODE_303606_length_157_cov_295.896552	32	78	38	27	46	0.5869565
NODE_303608_length_157_cov_161.689655	0	59	4	8	59	0.1355932
NODE_303608_length_157_cov_161.689655	0	59	8	5	59	0.0847458
NODE_303608_length_157_cov_161.689655	0	59	10	10	59	0.1694915
NODE_303608_length_157_cov_161.689655	0	59	18	2	59	0.0338983
NODE_303608_length_157_cov_161.689655	0	59	20	8	59	0.1355932
NODE_303608_length_157_cov_161.689655	0	59	22	2	59	0.0338983
NODE_303608_length_157_cov_161.689655	0	59	28	1	59	0.0169492
NODE_303608_length_157_cov_161.689655	0	59	30	6	59	0.1016949
NODE_303608_length_157_cov_161.689655	0	59	32	6	59	0.1016949
NODE_303608_length_157_cov_161.689655	0	59	34	1	59	0.0169492
NODE_303608_length_157_cov_161.689655	0	59	36	10	59	0.1694915
NODE_303608_length_157_cov_161.689655	0	59	4	8	59	0.1355932
NODE_303608_length_157_cov_161.689655	0	59	8	5	59	0.0847458
NODE_303608_length_157_cov_161.689655	0	59	10	10	59	0.1694915
NODE_303608_length_157_cov_161.689655	0	59	18	2	59	0.0338983
NODE_303608_length_157_cov_161.689655	0	59	20	8	59	0.1355932
NODE_303608_length_157_cov_161.689655	0	59	22	2	59	0.0338983
NODE_303608_length_157_cov_161.689655	0	59	28	1	59	0.0169492
NODE_303608_length_157_cov_161.689655	0	59	30	6	59	0.1016949
NODE_303608_length_157_cov_161.689655	0	59	32	6	59	0.1016949
NODE_303608_length_157_cov_161.689655	0	59	34	1	59	0.0169492
NODE_303608_length_157_cov_161.689655	0	59	36	10	59	0.1694915
NODE_303608_length_157_cov_161.689655	55	135	8	1	80	0.0125000
NODE_303608_length_157_cov_161.689655	55	135	10	9	80	0.1125000
NODE_303608_length_157_cov_161.689655	55	135	12	6	80	0.0750000
NODE_303608_length_157_cov_161.689655	55	135	22	1	80	0.0125000
NODE_303608_length_157_cov_161.689655	55	135	36	63	80	0.7875000
NODE_303608_length_157_cov_161.689655	55	135	8	1	80	0.0125000
NODE_303608_length_157_cov_161.689655	55	135	10	9	80	0.1125000
NODE_303608_length_157_cov_161.689655	55	135	12	6	80	0.0750000
NODE_303608_length_157_cov_161.689655	55	135	22	1	80	0.0125000
NODE_303608_length_157_cov_161.689655	55	135	36	63	80	0.7875000
NODE_303608_length_157_cov_161.689655	108	157	0	11	49	0.2244898
NODE_303608_length_157_cov_161.689655	108	157	5	1	49	0.0204082
NODE_303608_length_157_cov_161.689655	108	157	6	4	49	0.0816327
NODE_303608_length_157_cov_161.689655	108	157	8	7	49	0.1428571
NODE_303608_length_157_cov_161.689655	108	157	10	9	49	0.1836735
NODE_303608_length_157_cov_161.689655	108	157	12	6	49	0.1224490
NODE_303608_length_157_cov_161.689655	108	157	22	1	49	0.0204082
NODE_303608_length_157_cov_161.689655	108	157	36	10	49	0.2040816
NODE_303608_length_157_cov_161.689655	113	157	0	11	44	0.2500000
NODE_303608_length_157_cov_161.689655	113	157	5	1	44	0.0227273
NODE_303608_length_157_cov_161.689655	113	157	6	4	44	0.0909091
NODE_303608_length_157_cov_161.689655	113	157	8	7	44	0.1590909
NODE_303608_length_157_cov_161.689655	113	157	10	9	44	0.2045455
NODE_303608_length_157_cov_161.689655	113	157	12	6	44	0.1363636
NODE_303608_length_157_cov_161.689655	113	157	22	1	44	0.0227273
NODE_303608_length_157_cov_161.689655	113	157	36	5	44	0.1136364
NODE_303677_length_156_cov_100.491228	0	41	0	7	41	0.1707317
NODE_303677_length_156_cov_100.491228	0	41	2	19	41	0.4634146
NODE_303677_length_156_cov_100.491228	0	41	4	15	41	0.3658537
NODE_303677_length_156_cov_100.491228	21	94	2	5	73	0.0684932
NODE_303677_length_156_cov_100.491228	21	94	4	24	73	0.3287671
NODE_303677_length_156_cov_100.491228	21	94	8	44	73	0.6027398
NODE_303688_length_156_cov_37.368421	24	81	0	1	57	0.0175439
NODE_303688_length_156_cov_37.368421	24	81	2	1	57	0.0175439
NODE_303688_length_156_cov_37.368421	24	81	4	5	57	0.0877193
NODE_303688_length_156_cov_37.368421	24	81	6	1	57	0.0175439
NODE_303688_length_156_cov_37.368421	24	81	8	3	57	0.0526316
NODE_303688_length_156_cov_37.368421	24	81	10	1	57	0.0175439
NODE_303688_length_156_cov_37.368421	24	81	12	13	57	0.2280702
NODE_303688_length_156_cov_37.368421	24	81	14	1	57	0.0175439
NODE_303688_length_156_cov_37.368421	24	81	16	3	57	0.0526316
NODE_303688_length_156_cov_37.368421	24	81	18	28	57	0.4912281
NODE_303688_length_156_cov_37.368421	54	134	18	80	80	1.0000000
NODE_303700_length_156_cov_9.543860	2	48	0	46	46	1.0000000
NODE_303700_length_156_cov_9.543860	59	105	0	46	46	1.0000000
NODE_303752_length_155_cov_56.750000	27	102	0	75	75	1.0000000
NODE_303752_length_155_cov_56.750000	80	155	0	75	75	1.0000000
NODE_304022_length_153_cov_0.944444	5	48	0	43	43	1.0000000
NODE_304022_length_153_cov_0.944444	37	86	0	49	49	1.0000000
NODE_304022_length_153_cov_0.944444	59	102	0	43	43	1.0000000
NODE_304022_length_153_cov_0.944444	91	140	0	49	49	1.0000000
NODE_304022_length_153_cov_0.944444	113	153	0	40	40	1.0000000
NODE_304027_length_152_cov_195.396226	9	89	0	80	80	1.0000000
NODE_304027_length_152_cov_195.396226	9	89	0	80	80	1.0000000
NODE_304027_length_152_cov_195.396226	85	149	0	64	64	1.0000000
NODE_304027_length_152_cov_195.396226	85	152	0	67	67	1.0000000
NODE_304027_length_152_cov_195.396226	85	152	0	67	67	1.0000000
NODE_304027_length_152_cov_195.396226	85	152	0	67	67	1.0000000
NODE_304030_length_152_cov_68.094340	99	150	0	4	51	0.0784314
NODE_304030_length_152_cov_68.094340	99	150	4	35	51	0.6862745
NODE_304030_length_152_cov_68.094340	99	150	6	12	51	0.2352941
NODE_304112_length_151_cov_541.615385	19	88	26	2	69	0.0289855
NODE_304112_length_151_cov_541.615385	19	88	30	7	69	0.1014493
NODE_304112_length_151_cov_541.615385	19	88	32	2	69	0.0289855
NODE_304112_length_151_cov_541.615385	19	88	38	1	69	0.0144928
NODE_304112_length_151_cov_541.615385	19	88	42	1	69	0.0144928
NODE_304112_length_151_cov_541.615385	19	88	53	2	69	0.0289855
NODE_304112_length_151_cov_541.615385	19	88	54	2	69	0.0289855
NODE_304112_length_151_cov_541.615385	19	88	56	2	69	0.0289855
NODE_304112_length_151_cov_541.615385	19	88	60	1	69	0.0144928
NODE_304112_length_151_cov_541.615385	19	88	62	2	69	0.0289855
NODE_304112_length_151_cov_541.615385	19	88	66	1	69	0.0144928
NODE_304112_length_151_cov_541.615385	19	88	69	1	69	0.0144928
NODE_304112_length_151_cov_541.615385	19	88	70	1	69	0.0144928
NODE_304112_length_151_cov_541.615385	19	88	72	4	69	0.0579710
NODE_304112_length_151_cov_541.615385	19	88	76	40	69	0.5797101
NODE_304112_length_151_cov_541.615385	72	149	13	2	77	0.0259740
NODE_304112_length_151_cov_541.615385	72	149	15	1	77	0.0129870
NODE_304112_length_151_cov_541.615385	72	149	17	5	77	0.0649351
NODE_304112_length_151_cov_541.615385	72	149	27	1	77	0.0129870
NODE_304112_length_151_cov_541.615385	72	149	33	3	77	0.0389610
NODE_304112_length_151_cov_541.615385	72	149	35	1	77	0.0129870
NODE_304112_length_151_cov_541.615385	72	149	41	1	77	0.0129870
NODE_304112_length_151_cov_541.615385	72	149	42	4	77	0.0519481
NODE_304112_length_151_cov_541.615385	72	149	46	6	77	0.0779221
NODE_304112_length_151_cov_541.615385	72	149	55	2	77	0.0259740
NODE_304112_length_151_cov_541.615385	72	149	57	1	77	0.0129870
NODE_304112_length_151_cov_541.615385	72	149	59	1	77	0.0129870
NODE_304112_length_151_cov_541.615385	72	149	63	3	77	0.0389610
NODE_304112_length_151_cov_541.615385	72	149	67	2	77	0.0259740
NODE_304112_length_151_cov_541.615385	72	149	69	3	77	0.0389610
NODE_304112_length_151_cov_541.615385	72	149	71	2	77	0.0259740
NODE_304112_length_151_cov_541.615385	72	149	73	3	77	0.0389610
NODE_304112_length_151_cov_541.615385	72	149	75	16	77	0.2077922
NODE_304112_length_151_cov_541.615385	72	149	76	20	77	0.2597403
NODE_304229_length_150_cov_88.647059	51	102	0	51	51	1.0000000
NODE_304472_length_148_cov_34.183673	23	99	65	1	76	0.0131579
NODE_304472_length_148_cov_34.183673	23	99	68	1	76	0.0131579
NODE_304472_length_148_cov_34.183673	23	99	72	1	76	0.0131579
NODE_304472_length_148_cov_34.183673	23	99	75	1	76	0.0131579
NODE_304472_length_148_cov_34.183673	23	99	76	1	76	0.0131579
NODE_304472_length_148_cov_34.183673	23	99	82	1	76	0.0131579
NODE_304472_length_148_cov_34.183673	23	99	84	1	76	0.0131579
NODE_304472_length_148_cov_34.183673	23	99	88	2	76	0.0263158
NODE_304472_length_148_cov_34.183673	23	99	92	1	76	0.0131579
NODE_304472_length_148_cov_34.183673	23	99	94	1	76	0.0131579
NODE_304472_length_148_cov_34.183673	23	99	102	2	76	0.0263158
NODE_304472_length_148_cov_34.183673	23	99	108	1	76	0.0131579
NODE_304472_length_148_cov_34.183673	23	99	110	1	76	0.0131579
NODE_304472_length_148_cov_34.183673	23	99	118	2	76	0.0263158
NODE_304472_length_148_cov_34.183673	23	99	122	1	76	0.0131579
NODE_304472_length_148_cov_34.183673	23	99	124	2	76	0.0263158
NODE_304472_length_148_cov_34.183673	23	99	126	3	76	0.0394737
NODE_304472_length_148_cov_34.183673	23	99	127	30	76	0.3947369
NODE_304472_length_148_cov_34.183673	23	99	128	23	76	0.3026316
NODE_304570_length_147_cov_472.354167	0	55	4	1	55	0.0181818
NODE_304570_length_147_cov_472.354167	0	55	6	3	55	0.0545455
NODE_304570_length_147_cov_472.354167	0	55	8	2	55	0.0363636
NODE_304570_length_147_cov_472.354167	0	55	10	1	55	0.0181818
NODE_304570_length_147_cov_472.354167	0	55	14	1	55	0.0181818
NODE_304570_length_147_cov_472.354167	0	55	18	3	55	0.0545455
NODE_304570_length_147_cov_472.354167	0	55	20	1	55	0.0181818
NODE_304570_length_147_cov_472.354167	0	55	24	1	55	0.0181818
NODE_304570_length_147_cov_472.354167	0	55	28	1	55	0.0181818
NODE_304570_length_147_cov_472.354167	0	55	30	1	55	0.0181818
NODE_304570_length_147_cov_472.354167	0	55	36	1	55	0.0181818
NODE_304570_length_147_cov_472.354167	0	55	38	1	55	0.0181818
NODE_304570_length_147_cov_472.354167	0	55	41	1	55	0.0181818
NODE_304570_length_147_cov_472.354167	0	55	42	6	55	0.1090909
NODE_304570_length_147_cov_472.354167	0	55	44	4	55	0.0727273
NODE_304570_length_147_cov_472.354167	0	55	50	3	55	0.0545455
NODE_304570_length_147_cov_472.354167	0	55	54	7	55	0.1272727
NODE_304570_length_147_cov_472.354167	0	55	57	1	55	0.0181818
NODE_304570_length_147_cov_472.354167	0	55	58	1	55	0.0181818
NODE_304570_length_147_cov_472.354167	0	55	60	15	55	0.2727273
NODE_304570_length_147_cov_472.354167	12	89	24	1	77	0.0129870
NODE_304570_length_147_cov_472.354167	12	89	28	1	77	0.0129870
NODE_304570_length_147_cov_472.354167	12	89	30	1	77	0.0129870
NODE_304570_length_147_cov_472.354167	12	89	36	1	77	0.0129870
NODE_304570_length_147_cov_472.354167	12	89	38	1	77	0.0129870
NODE_304570_length_147_cov_472.354167	12	89	41	1	77	0.0129870
NODE_304570_length_147_cov_472.354167	12	89	42	6	77	0.0779221
NODE_304570_length_147_cov_472.354167	12	89	44	4	77	0.0519481
NODE_304570_length_147_cov_472.354167	12	89	50	3	77	0.0389610
NODE_304570_length_147_cov_472.354167	12	89	54	7	77	0.0909091
NODE_304570_length_147_cov_472.354167	12	89	57	1	77	0.0129870
NODE_304570_length_147_cov_472.354167	12	89	58	1	77	0.0129870
NODE_304570_length_147_cov_472.354167	12	89	60	49	77	0.6363636
NODE_304570_length_147_cov_472.354167	65	137	6	3	72	0.0416667
NODE_304570_length_147_cov_472.354167	65	137	10	2	72	0.0277778
NODE_304570_length_147_cov_472.354167	65	137	14	4	72	0.0555556
NODE_304570_length_147_cov_472.354167	65	137	18	1	72	0.0138889
NODE_304570_length_147_cov_472.354167	65	137	20	1	72	0.0138889
NODE_304570_length_147_cov_472.354167	65	137	26	5	72	0.0694444
NODE_304570_length_147_cov_472.354167	65	137	28	1	72	0.0138889
NODE_304570_length_147_cov_472.354167	65	137	30	1	72	0.0138889
NODE_304570_length_147_cov_472.354167	65	137	32	1	72	0.0138889
NODE_304570_length_147_cov_472.354167	65	137	38	1	72	0.0138889
NODE_304570_length_147_cov_472.354167	65	137	40	1	72	0.0138889
NODE_304570_length_147_cov_472.354167	65	137	42	1	72	0.0138889
NODE_304570_length_147_cov_472.354167	65	137	44	2	72	0.0277778
NODE_304570_length_147_cov_472.354167	65	137	46	3	72	0.0416667
NODE_304570_length_147_cov_472.354167	65	137	48	2	72	0.0277778
NODE_304570_length_147_cov_472.354167	65	137	50	3	72	0.0416667
NODE_304570_length_147_cov_472.354167	65	137	54	1	72	0.0138889
NODE_304570_length_147_cov_472.354167	65	137	56	1	72	0.0138889
NODE_304570_length_147_cov_472.354167	65	137	60	38	72	0.5277778
NODE_304572_length_147_cov_229.729167	7	56	4	1	49	0.0204082
NODE_304572_length_147_cov_229.729167	7	56	6	5	49	0.1020408
NODE_304572_length_147_cov_229.729167	7	56	11	2	49	0.0408163
NODE_304572_length_147_cov_229.729167	7	56	15	1	49	0.0204082
NODE_304572_length_147_cov_229.729167	7	56	17	3	49	0.0612245
NODE_304572_length_147_cov_229.729167	7	56	23	3	49	0.0612245
NODE_304572_length_147_cov_229.729167	7	56	25	2	49	0.0408163
NODE_304572_length_147_cov_229.729167	7	56	27	1	49	0.0204082
NODE_304572_length_147_cov_229.729167	7	56	31	1	49	0.0204082
NODE_304572_length_147_cov_229.729167	7	56	33	2	49	0.0408163
NODE_304572_length_147_cov_229.729167	7	56	37	1	49	0.0204082
NODE_304572_length_147_cov_229.729167	7	56	45	4	49	0.0816327
NODE_304572_length_147_cov_229.729167	7	56	47	1	49	0.0204082
NODE_304572_length_147_cov_229.729167	7	56	50	1	49	0.0204082
NODE_304572_length_147_cov_229.729167	7	56	58	2	49	0.0408163
NODE_304572_length_147_cov_229.729167	7	56	64	1	49	0.0204082
NODE_304572_length_147_cov_229.729167	7	56	68	1	49	0.0204082
NODE_304572_length_147_cov_229.729167	7	56	76	1	49	0.0204082
NODE_304572_length_147_cov_229.729167	7	56	78	16	49	0.3265306
NODE_304572_length_147_cov_229.729167	29	93	45	4	64	0.0625000
NODE_304572_length_147_cov_229.729167	29	93	47	1	64	0.0156250
NODE_304572_length_147_cov_229.729167	29	93	50	1	64	0.0156250
NODE_304572_length_147_cov_229.729167	29	93	58	2	64	0.0312500
NODE_304572_length_147_cov_229.729167	29	93	64	1	64	0.0156250
NODE_304572_length_147_cov_229.729167	29	93	68	1	64	0.0156250
NODE_304572_length_147_cov_229.729167	29	93	76	1	64	0.0156250
NODE_304572_length_147_cov_229.729167	29	93	78	53	64	0.8281250
NODE_304572_length_147_cov_229.729167	29	93	45	4	64	0.0625000
NODE_304572_length_147_cov_229.729167	29	93	47	1	64	0.0156250
NODE_304572_length_147_cov_229.729167	29	93	50	1	64	0.0156250
NODE_304572_length_147_cov_229.729167	29	93	58	2	64	0.0312500
NODE_304572_length_147_cov_229.729167	29	93	64	1	64	0.0156250
NODE_304572_length_147_cov_229.729167	29	93	68	1	64	0.0156250
NODE_304572_length_147_cov_229.729167	29	93	76	1	64	0.0156250
NODE_304572_length_147_cov_229.729167	29	93	78	53	64	0.8281250
NODE_304572_length_147_cov_229.729167	29	93	45	4	64	0.0625000
NODE_304572_length_147_cov_229.729167	29	93	47	1	64	0.0156250
NODE_304572_length_147_cov_229.729167	29	93	50	1	64	0.0156250
NODE_304572_length_147_cov_229.729167	29	93	58	2	64	0.0312500
NODE_304572_length_147_cov_229.729167	29	93	64	1	64	0.0156250
NODE_304572_length_147_cov_229.729167	29	93	68	1	64	0.0156250
NODE_304572_length_147_cov_229.729167	29	93	76	1	64	0.0156250
NODE_304572_length_147_cov_229.729167	29	93	78	53	64	0.8281250
NODE_304573_length_147_cov_213.770833	37	117	0	80	80	1.0000000
NODE_304573_length_147_cov_213.770833	90	146	0	56	56	1.0000000
NODE_304697_length_146_cov_182.893617	1	60	2	10	59	0.1694915
NODE_304697_length_146_cov_182.893617	1	60	4	25	59	0.4237288
NODE_304697_length_146_cov_182.893617	1	60	6	24	59	0.4067796
NODE_304697_length_146_cov_182.893617	34	60	4	2	26	0.0769231
NODE_304697_length_146_cov_182.893617	34	60	6	24	26	0.9230769
NODE_304697_length_146_cov_182.893617	113	144	0	31	31	1.0000000
NODE_304698_length_146_cov_152.808511	0	69	0	69	69	1.0000000
NODE_304698_length_146_cov_152.808511	42	122	0	80	80	1.0000000
NODE_304703_length_146_cov_89.808511	0	53	0	13	53	0.2452830
NODE_304703_length_146_cov_89.808511	0	53	2	40	53	0.7547170
NODE_304703_length_146_cov_89.808511	26	106	2	80	80	1.0000000
NODE_304703_length_146_cov_89.808511	74	146	0	30	72	0.4166667
NODE_304703_length_146_cov_89.808511	74	146	2	42	72	0.5833333
NODE_304703_length_146_cov_89.808511	79	101	2	22	22	1.0000000
NODE_304707_length_146_cov_57.446809	44	124	0	80	80	1.0000000
NODE_304708_length_146_cov_54.106383	0	69	0	69	69	1.0000000
NODE_304708_length_146_cov_54.106383	42	122	0	80	80	1.0000000
NODE_304710_length_146_cov_46.765957	3	83	0	80	80	1.0000000
NODE_304710_length_146_cov_46.765957	3	83	0	80	80	1.0000000
NODE_304710_length_146_cov_46.765957	3	83	0	80	80	1.0000000
NODE_304710_length_146_cov_46.765957	3	83	0	80	80	1.0000000
NODE_304710_length_146_cov_46.765957	3	83	0	80	80	1.0000000
NODE_304710_length_146_cov_46.765957	12	83	0	71	71	1.0000000
NODE_304710_length_146_cov_46.765957	56	136	0	80	80	1.0000000
NODE_304710_length_146_cov_46.765957	56	136	0	80	80	1.0000000
NODE_304711_length_146_cov_44.021277	0	69	0	69	69	1.0000000
NODE_304711_length_146_cov_44.021277	42	122	0	80	80	1.0000000
NODE_304798_length_145_cov_1385.413043	0	69	65	1	69	0.0144928
NODE_304798_length_145_cov_1385.413043	0	69	70	1	69	0.0144928
NODE_304798_length_145_cov_1385.413043	0	69	78	2	69	0.0289855
NODE_304798_length_145_cov_1385.413043	0	69	86	2	69	0.0289855
NODE_304798_length_145_cov_1385.413043	0	69	90	1	69	0.0144928
NODE_304798_length_145_cov_1385.413043	0	69	92	1	69	0.0144928
NODE_304798_length_145_cov_1385.413043	0	69	106	1	69	0.0144928
NODE_304798_length_145_cov_1385.413043	0	69	110	1	69	0.0144928
NODE_304798_length_145_cov_1385.413043	0	69	122	1	69	0.0144928
NODE_304798_length_145_cov_1385.413043	0	69	134	1	69	0.0144928
NODE_304798_length_145_cov_1385.413043	0	69	151	1	69	0.0144928
NODE_304798_length_145_cov_1385.413043	0	69	159	1	69	0.0144928
NODE_304798_length_145_cov_1385.413043	0	69	179	1	69	0.0144928
NODE_304798_length_145_cov_1385.413043	0	69	187	1	69	0.0144928
NODE_304798_length_145_cov_1385.413043	0	69	197	1	69	0.0144928
NODE_304798_length_145_cov_1385.413043	0	69	213	1	69	0.0144928
NODE_304798_length_145_cov_1385.413043	0	69	218	1	69	0.0144928
NODE_304798_length_145_cov_1385.413043	0	69	225	1	69	0.0144928
NODE_304798_length_145_cov_1385.413043	0	69	227	1	69	0.0144928
NODE_304798_length_145_cov_1385.413043	0	69	233	1	69	0.0144928
NODE_304798_length_145_cov_1385.413043	0	69	242	1	69	0.0144928
NODE_304798_length_145_cov_1385.413043	0	69	247	1	69	0.0144928
NODE_304798_length_145_cov_1385.413043	0	69	248	1	69	0.0144928
NODE_304798_length_145_cov_1385.413043	0	69	252	1	69	0.0144928
NODE_304798_length_145_cov_1385.413043	0	69	258	1	69	0.0144928
NODE_304798_length_145_cov_1385.413043	0	69	273	1	69	0.0144928
NODE_304798_length_145_cov_1385.413043	0	69	274	1	69	0.0144928
NODE_304798_length_145_cov_1385.413043	0	69	292	1	69	0.0144928
NODE_304798_length_145_cov_1385.413043	0	69	297	1	69	0.0144928
NODE_304798_length_145_cov_1385.413043	0	69	311	1	69	0.0144928
NODE_304798_length_145_cov_1385.413043	0	69	313	1	69	0.0144928
NODE_304798_length_145_cov_1385.413043	0	69	341	1	69	0.0144928
NODE_304798_length_145_cov_1385.413043	0	69	347	1	69	0.0144928
NODE_304798_length_145_cov_1385.413043	0	69	348	2	69	0.0289855
NODE_304798_length_145_cov_1385.413043	0	69	352	1	69	0.0144928
NODE_304798_length_145_cov_1385.413043	0	69	358	1	69	0.0144928
NODE_304798_length_145_cov_1385.413043	0	69	366	1	69	0.0144928
NODE_304798_length_145_cov_1385.413043	0	69	394	1	69	0.0144928
NODE_304798_length_145_cov_1385.413043	0	69	410	1	69	0.0144928
NODE_304798_length_145_cov_1385.413043	0	69	423	1	69	0.0144928
NODE_304798_length_145_cov_1385.413043	0	69	434	21	69	0.3043478
NODE_304798_length_145_cov_1385.413043	0	69	435	4	69	0.0579710
NODE_304798_length_145_cov_1385.413043	0	69	436	1	69	0.0144928
NODE_304798_length_145_cov_1385.413043	42	122	291	1	80	0.0125000
NODE_304798_length_145_cov_1385.413043	42	122	295	1	80	0.0125000
NODE_304798_length_145_cov_1385.413043	42	122	308	1	80	0.0125000
NODE_304798_length_145_cov_1385.413043	42	122	319	2	80	0.0250000
NODE_304798_length_145_cov_1385.413043	42	122	321	1	80	0.0125000
NODE_304798_length_145_cov_1385.413043	42	122	341	1	80	0.0125000
NODE_304798_length_145_cov_1385.413043	42	122	357	2	80	0.0250000
NODE_304798_length_145_cov_1385.413043	42	122	374	1	80	0.0125000
NODE_304798_length_145_cov_1385.413043	42	122	375	1	80	0.0125000
NODE_304798_length_145_cov_1385.413043	42	122	393	1	80	0.0125000
NODE_304798_length_145_cov_1385.413043	42	122	395	1	80	0.0125000
NODE_304798_length_145_cov_1385.413043	42	122	399	1	80	0.0125000
NODE_304798_length_145_cov_1385.413043	42	122	405	1	80	0.0125000
NODE_304798_length_145_cov_1385.413043	42	122	409	1	80	0.0125000
NODE_304798_length_145_cov_1385.413043	42	122	411	1	80	0.0125000
NODE_304798_length_145_cov_1385.413043	42	122	417	2	80	0.0250000
NODE_304798_length_145_cov_1385.413043	42	122	423	1	80	0.0125000
NODE_304798_length_145_cov_1385.413043	42	122	425	1	80	0.0125000
NODE_304798_length_145_cov_1385.413043	42	122	433	3	80	0.0375000
NODE_304798_length_145_cov_1385.413043	42	122	434	44	80	0.5500000
NODE_304798_length_145_cov_1385.413043	42	122	435	11	80	0.1375000
NODE_304798_length_145_cov_1385.413043	42	122	436	1	80	0.0125000
NODE_304799_length_145_cov_880.369565	56	120	185	4	64	0.0625000
NODE_304799_length_145_cov_880.369565	56	120	195	1	64	0.0156250
NODE_304799_length_145_cov_880.369565	56	120	199	1	64	0.0156250
NODE_304799_length_145_cov_880.369565	56	120	207	1	64	0.0156250
NODE_304799_length_145_cov_880.369565	56	120	211	1	64	0.0156250
NODE_304799_length_145_cov_880.369565	56	120	229	1	64	0.0156250
NODE_304799_length_145_cov_880.369565	56	120	231	1	64	0.0156250
NODE_304799_length_145_cov_880.369565	56	120	241	1	64	0.0156250
NODE_304799_length_145_cov_880.369565	56	120	243	1	64	0.0156250
NODE_304799_length_145_cov_880.369565	56	120	245	1	64	0.0156250
NODE_304799_length_145_cov_880.369565	56	120	252	1	64	0.0156250
NODE_304799_length_145_cov_880.369565	56	120	255	1	64	0.0156250
NODE_304799_length_145_cov_880.369565	56	120	256	1	64	0.0156250
NODE_304799_length_145_cov_880.369565	56	120	266	1	64	0.0156250
NODE_304799_length_145_cov_880.369565	56	120	270	1	64	0.0156250
NODE_304799_length_145_cov_880.369565	56	120	271	1	64	0.0156250
NODE_304799_length_145_cov_880.369565	56	120	273	2	64	0.0312500
NODE_304799_length_145_cov_880.369565	56	120	274	43	64	0.6718750
NODE_304799_length_145_cov_880.369565	56	120	185	4	64	0.0625000
NODE_304799_length_145_cov_880.369565	56	120	195	1	64	0.0156250
NODE_304799_length_145_cov_880.369565	56	120	199	1	64	0.0156250
NODE_304799_length_145_cov_880.369565	56	120	207	1	64	0.0156250
NODE_304799_length_145_cov_880.369565	56	120	211	1	64	0.0156250
NODE_304799_length_145_cov_880.369565	56	120	229	1	64	0.0156250
NODE_304799_length_145_cov_880.369565	56	120	231	1	64	0.0156250
NODE_304799_length_145_cov_880.369565	56	120	241	1	64	0.0156250
NODE_304799_length_145_cov_880.369565	56	120	243	1	64	0.0156250
NODE_304799_length_145_cov_880.369565	56	120	245	1	64	0.0156250
NODE_304799_length_145_cov_880.369565	56	120	252	1	64	0.0156250
NODE_304799_length_145_cov_880.369565	56	120	255	1	64	0.0156250
NODE_304799_length_145_cov_880.369565	56	120	256	1	64	0.0156250
NODE_304799_length_145_cov_880.369565	56	120	266	1	64	0.0156250
NODE_304799_length_145_cov_880.369565	56	120	270	1	64	0.0156250
NODE_304799_length_145_cov_880.369565	56	120	271	1	64	0.0156250
NODE_304799_length_145_cov_880.369565	56	120	273	2	64	0.0312500
NODE_304799_length_145_cov_880.369565	56	120	274	43	64	0.6718750
NODE_304799_length_145_cov_880.369565	56	120	185	4	64	0.0625000
NODE_304799_length_145_cov_880.369565	56	120	195	1	64	0.0156250
NODE_304799_length_145_cov_880.369565	56	120	199	1	64	0.0156250
NODE_304799_length_145_cov_880.369565	56	120	207	1	64	0.0156250
NODE_304799_length_145_cov_880.369565	56	120	211	1	64	0.0156250
NODE_304799_length_145_cov_880.369565	56	120	229	1	64	0.0156250
NODE_304799_length_145_cov_880.369565	56	120	231	1	64	0.0156250
NODE_304799_length_145_cov_880.369565	56	120	241	1	64	0.0156250
NODE_304799_length_145_cov_880.369565	56	120	243	1	64	0.0156250
NODE_304799_length_145_cov_880.369565	56	120	245	1	64	0.0156250
NODE_304799_length_145_cov_880.369565	56	120	252	1	64	0.0156250
NODE_304799_length_145_cov_880.369565	56	120	255	1	64	0.0156250
NODE_304799_length_145_cov_880.369565	56	120	256	1	64	0.0156250
NODE_304799_length_145_cov_880.369565	56	120	266	1	64	0.0156250
NODE_304799_length_145_cov_880.369565	56	120	270	1	64	0.0156250
NODE_304799_length_145_cov_880.369565	56	120	271	1	64	0.0156250
NODE_304799_length_145_cov_880.369565	56	120	273	2	64	0.0312500
NODE_304799_length_145_cov_880.369565	56	120	274	43	64	0.6718750
NODE_304799_length_145_cov_880.369565	93	142	38	1	49	0.0204082
NODE_304799_length_145_cov_880.369565	93	142	52	1	49	0.0204082
NODE_304799_length_145_cov_880.369565	93	142	54	2	49	0.0408163
NODE_304799_length_145_cov_880.369565	93	142	64	2	49	0.0408163
NODE_304799_length_145_cov_880.369565	93	142	72	1	49	0.0204082
NODE_304799_length_145_cov_880.369565	93	142	80	1	49	0.0204082
NODE_304799_length_145_cov_880.369565	93	142	84	1	49	0.0204082
NODE_304799_length_145_cov_880.369565	93	142	86	1	49	0.0204082
NODE_304799_length_145_cov_880.369565	93	142	90	1	49	0.0204082
NODE_304799_length_145_cov_880.369565	93	142	94	2	49	0.0408163
NODE_304799_length_145_cov_880.369565	93	142	103	1	49	0.0204082
NODE_304799_length_145_cov_880.369565	93	142	113	1	49	0.0204082
NODE_304799_length_145_cov_880.369565	93	142	119	1	49	0.0204082
NODE_304799_length_145_cov_880.369565	93	142	123	1	49	0.0204082
NODE_304799_length_145_cov_880.369565	93	142	133	1	49	0.0204082
NODE_304799_length_145_cov_880.369565	93	142	137	1	49	0.0204082
NODE_304799_length_145_cov_880.369565	93	142	145	1	49	0.0204082
NODE_304799_length_145_cov_880.369565	93	142	157	1	49	0.0204082
NODE_304799_length_145_cov_880.369565	93	142	169	1	49	0.0204082
NODE_304799_length_145_cov_880.369565	93	142	185	4	49	0.0816327
NODE_304799_length_145_cov_880.369565	93	142	195	1	49	0.0204082
NODE_304799_length_145_cov_880.369565	93	142	199	1	49	0.0204082
NODE_304799_length_145_cov_880.369565	93	142	207	1	49	0.0204082
NODE_304799_length_145_cov_880.369565	93	142	211	1	49	0.0204082
NODE_304799_length_145_cov_880.369565	93	142	229	1	49	0.0204082
NODE_304799_length_145_cov_880.369565	93	142	231	1	49	0.0204082
NODE_304799_length_145_cov_880.369565	93	142	241	1	49	0.0204082
NODE_304799_length_145_cov_880.369565	93	142	243	1	49	0.0204082
NODE_304799_length_145_cov_880.369565	93	142	245	1	49	0.0204082
NODE_304799_length_145_cov_880.369565	93	142	252	1	49	0.0204082
NODE_304799_length_145_cov_880.369565	93	142	255	1	49	0.0204082
NODE_304799_length_145_cov_880.369565	93	142	256	1	49	0.0204082
NODE_304799_length_145_cov_880.369565	93	142	266	1	49	0.0204082
NODE_304799_length_145_cov_880.369565	93	142	270	1	49	0.0204082
NODE_304799_length_145_cov_880.369565	93	142	271	1	49	0.0204082
NODE_304799_length_145_cov_880.369565	93	142	273	2	49	0.0408163
NODE_304799_length_145_cov_880.369565	93	142	274	6	49	0.1224490
NODE_304923_length_144_cov_46.155556	1	81	7	2	80	0.0250000
NODE_304923_length_144_cov_46.155556	1	81	8	1	80	0.0125000
NODE_304923_length_144_cov_46.155556	1	81	10	2	80	0.0250000
NODE_304923_length_144_cov_46.155556	1	81	12	1	80	0.0125000
NODE_304923_length_144_cov_46.155556	1	81	16	7	80	0.0875000
NODE_304923_length_144_cov_46.155556	1	81	18	1	80	0.0125000
NODE_304923_length_144_cov_46.155556	1	81	20	1	80	0.0125000
NODE_304923_length_144_cov_46.155556	1	81	22	1	80	0.0125000
NODE_304923_length_144_cov_46.155556	1	81	31	1	80	0.0125000
NODE_304923_length_144_cov_46.155556	1	81	33	3	80	0.0375000
NODE_304923_length_144_cov_46.155556	1	81	37	2	80	0.0250000
NODE_304923_length_144_cov_46.155556	1	81	40	2	80	0.0250000
NODE_304923_length_144_cov_46.155556	1	81	48	3	80	0.0375000
NODE_304923_length_144_cov_46.155556	1	81	52	1	80	0.0125000
NODE_304923_length_144_cov_46.155556	1	81	56	3	80	0.0375000
NODE_304923_length_144_cov_46.155556	1	81	58	1	80	0.0125000
NODE_304923_length_144_cov_46.155556	1	81	62	48	80	0.6000000
NODE_305208_length_142_cov_244.488372	0	52	5	1	52	0.0192308
NODE_305208_length_142_cov_244.488372	0	52	9	1	52	0.0192308
NODE_305208_length_142_cov_244.488372	0	52	15	1	52	0.0192308
NODE_305208_length_142_cov_244.488372	0	52	19	1	52	0.0192308
NODE_305208_length_142_cov_244.488372	0	52	23	1	52	0.0192308
NODE_305208_length_142_cov_244.488372	0	52	27	1	52	0.0192308
NODE_305208_length_142_cov_244.488372	0	52	32	1	52	0.0192308
NODE_305208_length_142_cov_244.488372	0	52	38	1	52	0.0192308
NODE_305208_length_142_cov_244.488372	0	52	41	1	52	0.0192308
NODE_305208_length_142_cov_244.488372	0	52	42	1	52	0.0192308
NODE_305208_length_142_cov_244.488372	0	52	56	1	52	0.0192308
NODE_305208_length_142_cov_244.488372	0	52	58	1	52	0.0192308
NODE_305208_length_142_cov_244.488372	0	52	63	2	52	0.0384615
NODE_305208_length_142_cov_244.488372	0	52	67	1	52	0.0192308
NODE_305208_length_142_cov_244.488372	0	52	71	1	52	0.0192308
NODE_305208_length_142_cov_244.488372	0	52	77	1	52	0.0192308
NODE_305208_length_142_cov_244.488372	0	52	81	1	52	0.0192308
NODE_305208_length_142_cov_244.488372	0	52	83	1	52	0.0192308
NODE_305208_length_142_cov_244.488372	0	52	84	1	52	0.0192308
NODE_305208_length_142_cov_244.488372	0	52	86	1	52	0.0192308
NODE_305208_length_142_cov_244.488372	0	52	90	1	52	0.0192308
NODE_305208_length_142_cov_244.488372	0	52	92	1	52	0.0192308
NODE_305208_length_142_cov_244.488372	0	52	94	2	52	0.0384615
NODE_305208_length_142_cov_244.488372	0	52	96	1	52	0.0192308
NODE_305208_length_142_cov_244.488372	0	52	98	1	52	0.0192308
NODE_305208_length_142_cov_244.488372	0	52	102	1	52	0.0192308
NODE_305208_length_142_cov_244.488372	0	52	106	2	52	0.0384615
NODE_305208_length_142_cov_244.488372	0	52	108	1	52	0.0192308
NODE_305208_length_142_cov_244.488372	0	52	112	1	52	0.0192308
NODE_305208_length_142_cov_244.488372	0	52	118	2	52	0.0384615
NODE_305208_length_142_cov_244.488372	0	52	120	1	52	0.0192308
NODE_305208_length_142_cov_244.488372	0	52	140	17	52	0.3269231
NODE_305229_length_142_cov_46.976744	1	65	10	2	64	0.0312500
NODE_305229_length_142_cov_46.976744	1	65	18	3	64	0.0468750
NODE_305229_length_142_cov_46.976744	1	65	20	5	64	0.0781250
NODE_305229_length_142_cov_46.976744	1	65	25	1	64	0.0156250
NODE_305229_length_142_cov_46.976744	1	65	27	1	64	0.0156250
NODE_305229_length_142_cov_46.976744	1	65	31	2	64	0.0312500
NODE_305229_length_142_cov_46.976744	1	65	33	3	64	0.0468750
NODE_305229_length_142_cov_46.976744	1	65	39	2	64	0.0312500
NODE_305229_length_142_cov_46.976744	1	65	41	2	64	0.0312500
NODE_305229_length_142_cov_46.976744	1	65	43	2	64	0.0312500
NODE_305229_length_142_cov_46.976744	1	65	45	17	64	0.2656250
NODE_305229_length_142_cov_46.976744	1	65	46	24	64	0.3750000
NODE_305229_length_142_cov_46.976744	1	65	10	2	64	0.0312500
NODE_305229_length_142_cov_46.976744	1	65	18	3	64	0.0468750
NODE_305229_length_142_cov_46.976744	1	65	20	5	64	0.0781250
NODE_305229_length_142_cov_46.976744	1	65	25	1	64	0.0156250
NODE_305229_length_142_cov_46.976744	1	65	27	1	64	0.0156250
NODE_305229_length_142_cov_46.976744	1	65	31	2	64	0.0312500
NODE_305229_length_142_cov_46.976744	1	65	33	3	64	0.0468750
NODE_305229_length_142_cov_46.976744	1	65	39	2	64	0.0312500
NODE_305229_length_142_cov_46.976744	1	65	41	2	64	0.0312500
NODE_305229_length_142_cov_46.976744	1	65	43	2	64	0.0312500
NODE_305229_length_142_cov_46.976744	1	65	45	17	64	0.2656250
NODE_305229_length_142_cov_46.976744	1	65	46	24	64	0.3750000
NODE_305229_length_142_cov_46.976744	1	65	10	2	64	0.0312500
NODE_305229_length_142_cov_46.976744	1	65	18	3	64	0.0468750
NODE_305229_length_142_cov_46.976744	1	65	20	5	64	0.0781250
NODE_305229_length_142_cov_46.976744	1	65	25	1	64	0.0156250
NODE_305229_length_142_cov_46.976744	1	65	27	1	64	0.0156250
NODE_305229_length_142_cov_46.976744	1	65	31	2	64	0.0312500
NODE_305229_length_142_cov_46.976744	1	65	33	3	64	0.0468750
NODE_305229_length_142_cov_46.976744	1	65	39	2	64	0.0312500
NODE_305229_length_142_cov_46.976744	1	65	41	2	64	0.0312500
NODE_305229_length_142_cov_46.976744	1	65	43	2	64	0.0312500
NODE_305229_length_142_cov_46.976744	1	65	45	17	64	0.2656250
NODE_305229_length_142_cov_46.976744	1	65	46	24	64	0.3750000
NODE_305230_length_142_cov_45.000000	0	69	0	38	69	0.5507246
NODE_305230_length_142_cov_45.000000	0	69	4	31	69	0.4492754
NODE_305385_length_141_cov_178.785714	58	118	89	1	60	0.0166667
NODE_305385_length_141_cov_178.785714	58	118	95	4	60	0.0666667
NODE_305385_length_141_cov_178.785714	58	118	97	2	60	0.0333333
NODE_305385_length_141_cov_178.785714	58	118	99	4	60	0.0666667
NODE_305385_length_141_cov_178.785714	58	118	103	1	60	0.0166667
NODE_305385_length_141_cov_178.785714	58	118	107	3	60	0.0500000
NODE_305385_length_141_cov_178.785714	58	118	108	12	60	0.2000000
NODE_305385_length_141_cov_178.785714	58	118	109	33	60	0.5500000
NODE_305398_length_141_cov_62.285714	26	106	0	80	80	1.0000000
NODE_305398_length_141_cov_62.285714	26	106	0	80	80	1.0000000
NODE_305398_length_141_cov_62.285714	26	97	0	71	71	1.0000000
NODE_305402_length_141_cov_41.142857	26	97	0	71	71	1.0000000
NODE_305600_length_140_cov_60.439024	8	88	4	8	80	0.1000000
NODE_305600_length_140_cov_60.439024	8	88	8	15	80	0.1875000
NODE_305600_length_140_cov_60.439024	8	88	10	3	80	0.0375000
NODE_305600_length_140_cov_60.439024	8	88	12	54	80	0.6750000
NODE_305600_length_140_cov_60.439024	8	88	4	8	80	0.1000000
NODE_305600_length_140_cov_60.439024	8	88	8	15	80	0.1875000
NODE_305600_length_140_cov_60.439024	8	88	10	3	80	0.0375000
NODE_305600_length_140_cov_60.439024	8	88	12	54	80	0.6750000
NODE_305600_length_140_cov_60.439024	8	88	4	8	80	0.1000000
NODE_305600_length_140_cov_60.439024	8	88	8	15	80	0.1875000
NODE_305600_length_140_cov_60.439024	8	88	10	3	80	0.0375000
NODE_305600_length_140_cov_60.439024	8	88	12	54	80	0.6750000
NODE_305600_length_140_cov_60.439024	8	88	4	8	80	0.1000000
NODE_305600_length_140_cov_60.439024	8	88	8	15	80	0.1875000
NODE_305600_length_140_cov_60.439024	8	88	10	3	80	0.0375000
NODE_305600_length_140_cov_60.439024	8	88	12	54	80	0.6750000
NODE_305600_length_140_cov_60.439024	8	88	4	8	80	0.1000000
NODE_305600_length_140_cov_60.439024	8	88	8	15	80	0.1875000
NODE_305600_length_140_cov_60.439024	8	88	10	3	80	0.0375000
NODE_305600_length_140_cov_60.439024	8	88	12	54	80	0.6750000
NODE_305616_length_140_cov_35.146341	22	102	0	12	80	0.1500000
NODE_305616_length_140_cov_35.146341	22	102	2	68	80	0.8500000
NODE_305616_length_140_cov_35.146341	75	105	2	30	30	1.0000000
NODE_305618_length_140_cov_34.048780	0	77	0	24	77	0.3116883
NODE_305618_length_140_cov_34.048780	0	77	4	5	77	0.0649351
NODE_305618_length_140_cov_34.048780	0	77	6	48	77	0.6233766
NODE_305618_length_140_cov_34.048780	0	77	0	24	77	0.3116883
NODE_305618_length_140_cov_34.048780	0	77	4	5	77	0.0649351
NODE_305618_length_140_cov_34.048780	0	77	6	48	77	0.6233766
NODE_305618_length_140_cov_34.048780	50	130	6	80	80	1.0000000
NODE_305618_length_140_cov_34.048780	50	130	6	80	80	1.0000000
NODE_305618_length_140_cov_34.048780	55	130	6	75	75	1.0000000
NODE_305619_length_140_cov_19.926829	44	118	0	74	74	1.0000000
NODE_305783_length_139_cov_29.700000	0	40	0	11	40	0.2750000
NODE_305783_length_139_cov_29.700000	0	40	4	19	40	0.4750000
NODE_305783_length_139_cov_29.700000	0	40	6	4	40	0.1000000
NODE_305783_length_139_cov_29.700000	0	40	8	2	40	0.0500000
NODE_305783_length_139_cov_29.700000	0	40	10	4	40	0.1000000
NODE_305783_length_139_cov_29.700000	0	40	0	11	40	0.2750000
NODE_305783_length_139_cov_29.700000	0	40	4	19	40	0.4750000
NODE_305783_length_139_cov_29.700000	0	40	6	4	40	0.1000000
NODE_305783_length_139_cov_29.700000	0	40	8	2	40	0.0500000
NODE_305783_length_139_cov_29.700000	0	40	10	4	40	0.1000000
NODE_305783_length_139_cov_29.700000	13	93	4	17	80	0.2125000
NODE_305783_length_139_cov_29.700000	13	93	6	4	80	0.0500000
NODE_305783_length_139_cov_29.700000	13	93	8	2	80	0.0250000
NODE_305783_length_139_cov_29.700000	13	93	10	57	80	0.7125000
NODE_305783_length_139_cov_29.700000	13	93	4	17	80	0.2125000
NODE_305783_length_139_cov_29.700000	13	93	6	4	80	0.0500000
NODE_305783_length_139_cov_29.700000	13	93	8	2	80	0.0250000
NODE_305783_length_139_cov_29.700000	13	93	10	57	80	0.7125000
NODE_305783_length_139_cov_29.700000	13	93	4	17	80	0.2125000
NODE_305783_length_139_cov_29.700000	13	93	6	4	80	0.0500000
NODE_305783_length_139_cov_29.700000	13	93	8	2	80	0.0250000
NODE_305783_length_139_cov_29.700000	13	93	10	57	80	0.7125000
NODE_305783_length_139_cov_29.700000	13	93	4	17	80	0.2125000
NODE_305783_length_139_cov_29.700000	13	93	6	4	80	0.0500000
NODE_305783_length_139_cov_29.700000	13	93	8	2	80	0.0250000
NODE_305783_length_139_cov_29.700000	13	93	10	57	80	0.7125000
NODE_305783_length_139_cov_29.700000	13	93	4	17	80	0.2125000
NODE_305783_length_139_cov_29.700000	13	93	6	4	80	0.0500000
NODE_305783_length_139_cov_29.700000	13	93	8	2	80	0.0250000
NODE_305783_length_139_cov_29.700000	13	93	10	57	80	0.7125000
NODE_305783_length_139_cov_29.700000	13	84	4	17	71	0.2394366
NODE_305783_length_139_cov_29.700000	13	84	6	4	71	0.0563380
NODE_305783_length_139_cov_29.700000	13	84	8	2	71	0.0281690
NODE_305783_length_139_cov_29.700000	13	84	10	48	71	0.6760563
NODE_305936_length_138_cov_1475.615385	30	97	58	1	67	0.0149254
NODE_305936_length_138_cov_1475.615385	30	97	64	3	67	0.0447761
NODE_305936_length_138_cov_1475.615385	30	97	67	2	67	0.0298507
NODE_305936_length_138_cov_1475.615385	30	97	68	61	67	0.9104478
NODE_305936_length_138_cov_1475.615385	70	138	20	1	68	0.0147059
NODE_305936_length_138_cov_1475.615385	70	138	22	3	68	0.0441176
NODE_305936_length_138_cov_1475.615385	70	138	26	1	68	0.0147059
NODE_305936_length_138_cov_1475.615385	70	138	28	1	68	0.0147059
NODE_305936_length_138_cov_1475.615385	70	138	38	1	68	0.0147059
NODE_305936_length_138_cov_1475.615385	70	138	40	1	68	0.0147059
NODE_305936_length_138_cov_1475.615385	70	138	42	1	68	0.0147059
NODE_305936_length_138_cov_1475.615385	70	138	44	2	68	0.0294118
NODE_305936_length_138_cov_1475.615385	70	138	46	3	68	0.0441176
NODE_305936_length_138_cov_1475.615385	70	138	52	5	68	0.0735294
NODE_305936_length_138_cov_1475.615385	70	138	54	2	68	0.0294118
NODE_305936_length_138_cov_1475.615385	70	138	56	3	68	0.0441176
NODE_305936_length_138_cov_1475.615385	70	138	58	1	68	0.0147059
NODE_305936_length_138_cov_1475.615385	70	138	60	1	68	0.0147059
NODE_305936_length_138_cov_1475.615385	70	138	62	1	68	0.0147059
NODE_305936_length_138_cov_1475.615385	70	138	64	2	68	0.0294118
NODE_305936_length_138_cov_1475.615385	70	138	66	6	68	0.0882353
NODE_305936_length_138_cov_1475.615385	70	138	68	33	68	0.4852941
NODE_305963_length_138_cov_29.564103	11	91	4	80	80	1.0000000
NODE_305963_length_138_cov_29.564103	11	91	4	80	80	1.0000000
NODE_305963_length_138_cov_29.564103	64	128	2	6	64	0.0937500
NODE_305963_length_138_cov_29.564103	64	128	3	1	64	0.0156250
NODE_305963_length_138_cov_29.564103	64	128	4	57	64	0.8906250
NODE_305963_length_138_cov_29.564103	64	128	2	6	64	0.0937500
NODE_305963_length_138_cov_29.564103	64	128	3	1	64	0.0156250
NODE_305963_length_138_cov_29.564103	64	128	4	57	64	0.8906250
NODE_306081_length_137_cov_185.684211	20	104	22	5	84	0.0595238
NODE_306081_length_137_cov_185.684211	20	104	24	1	84	0.0119048
NODE_306081_length_137_cov_185.684211	20	104	26	2	84	0.0238095
NODE_306081_length_137_cov_185.684211	20	104	28	3	84	0.0357143
NODE_306081_length_137_cov_185.684211	20	104	30	73	84	0.8690476
NODE_306092_length_137_cov_58.289474	76	106	58	1	30	0.0333333
NODE_306092_length_137_cov_58.289474	76	106	60	29	30	0.9666666
NODE_306099_length_137_cov_36.473684	31	111	2	80	80	1.0000000
NODE_306208_length_136_cov_1257.621622	27	107	50	1	80	0.0125000
NODE_306208_length_136_cov_1257.621622	27	107	64	1	80	0.0125000
NODE_306208_length_136_cov_1257.621622	27	107	68	4	80	0.0500000
NODE_306208_length_136_cov_1257.621622	27	107	70	1	80	0.0125000
NODE_306208_length_136_cov_1257.621622	27	107	74	73	80	0.9125000
NODE_306209_length_136_cov_769.594595	0	69	0	11	69	0.1594203
NODE_306209_length_136_cov_769.594595	0	69	2	2	69	0.0289855
NODE_306209_length_136_cov_769.594595	0	69	3	1	69	0.0144928
NODE_306209_length_136_cov_769.594595	0	69	4	55	69	0.7971014
NODE_306222_length_136_cov_128.324324	39	119	6	16	80	0.2000000
NODE_306222_length_136_cov_128.324324	39	119	8	64	80	0.8000000
NODE_306227_length_136_cov_90.783784	10	86	0	16	76	0.2105263
NODE_306227_length_136_cov_90.783784	10	86	4	60	76	0.7894737
NODE_306227_length_136_cov_90.783784	59	136	0	14	77	0.1818182
NODE_306227_length_136_cov_90.783784	59	136	4	63	77	0.8181818
NODE_306368_length_135_cov_2144.166667	0	73	38	2	73	0.0273973
NODE_306368_length_135_cov_2144.166667	0	73	46	1	73	0.0136986
NODE_306368_length_135_cov_2144.166667	0	73	64	3	73	0.0410959
NODE_306368_length_135_cov_2144.166667	0	73	80	1	73	0.0136986
NODE_306368_length_135_cov_2144.166667	0	73	82	1	73	0.0136986
NODE_306368_length_135_cov_2144.166667	0	73	92	3	73	0.0410959
NODE_306368_length_135_cov_2144.166667	0	73	96	1	73	0.0136986
NODE_306368_length_135_cov_2144.166667	0	73	98	1	73	0.0136986
NODE_306368_length_135_cov_2144.166667	0	73	101	1	73	0.0136986
NODE_306368_length_135_cov_2144.166667	0	73	113	2	73	0.0273973
NODE_306368_length_135_cov_2144.166667	0	73	119	2	73	0.0273973
NODE_306368_length_135_cov_2144.166667	0	73	128	1	73	0.0136986
NODE_306368_length_135_cov_2144.166667	0	73	137	5	73	0.0684932
NODE_306368_length_135_cov_2144.166667	0	73	145	1	73	0.0136986
NODE_306368_length_135_cov_2144.166667	0	73	152	1	73	0.0136986
NODE_306368_length_135_cov_2144.166667	0	73	154	1	73	0.0136986
NODE_306368_length_135_cov_2144.166667	0	73	156	1	73	0.0136986
NODE_306368_length_135_cov_2144.166667	0	73	158	1	73	0.0136986
NODE_306368_length_135_cov_2144.166667	0	73	166	1	73	0.0136986
NODE_306368_length_135_cov_2144.166667	0	73	167	2	73	0.0273973
NODE_306368_length_135_cov_2144.166667	0	73	168	41	73	0.5616438
NODE_306368_length_135_cov_2144.166667	46	126	41	2	80	0.0250000
NODE_306368_length_135_cov_2144.166667	46	126	43	1	80	0.0125000
NODE_306368_length_135_cov_2144.166667	46	126	45	1	80	0.0125000
NODE_306368_length_135_cov_2144.166667	46	126	53	1	80	0.0125000
NODE_306368_length_135_cov_2144.166667	46	126	57	1	80	0.0125000
NODE_306368_length_135_cov_2144.166667	46	126	63	2	80	0.0250000
NODE_306368_length_135_cov_2144.166667	46	126	79	1	80	0.0125000
NODE_306368_length_135_cov_2144.166667	46	126	81	1	80	0.0125000
NODE_306368_length_135_cov_2144.166667	46	126	99	1	80	0.0125000
NODE_306368_length_135_cov_2144.166667	46	126	101	1	80	0.0125000
NODE_306368_length_135_cov_2144.166667	46	126	105	1	80	0.0125000
NODE_306368_length_135_cov_2144.166667	46	126	117	1	80	0.0125000
NODE_306368_length_135_cov_2144.166667	46	126	127	1	80	0.0125000
NODE_306368_length_135_cov_2144.166667	46	126	141	1	80	0.0125000
NODE_306368_length_135_cov_2144.166667	46	126	149	1	80	0.0125000
NODE_306368_length_135_cov_2144.166667	46	126	151	1	80	0.0125000
NODE_306368_length_135_cov_2144.166667	46	126	164	3	80	0.0375000
NODE_306368_length_135_cov_2144.166667	46	126	165	1	80	0.0125000
NODE_306368_length_135_cov_2144.166667	46	126	167	33	80	0.4125000
NODE_306368_length_135_cov_2144.166667	46	126	168	25	80	0.3125000
NODE_306368_length_135_cov_2144.166667	83	135	7	1	52	0.0192308
NODE_306368_length_135_cov_2144.166667	83	135	17	1	52	0.0192308
NODE_306368_length_135_cov_2144.166667	83	135	19	1	52	0.0192308
NODE_306368_length_135_cov_2144.166667	83	135	21	2	52	0.0384615
NODE_306368_length_135_cov_2144.166667	83	135	27	3	52	0.0576923
NODE_306368_length_135_cov_2144.166667	83	135	41	3	52	0.0576923
NODE_306368_length_135_cov_2144.166667	83	135	43	1	52	0.0192308
NODE_306368_length_135_cov_2144.166667	83	135	45	1	52	0.0192308
NODE_306368_length_135_cov_2144.166667	83	135	53	1	52	0.0192308
NODE_306368_length_135_cov_2144.166667	83	135	57	1	52	0.0192308
NODE_306368_length_135_cov_2144.166667	83	135	63	2	52	0.0384615
NODE_306368_length_135_cov_2144.166667	83	135	79	1	52	0.0192308
NODE_306368_length_135_cov_2144.166667	83	135	81	1	52	0.0192308
NODE_306368_length_135_cov_2144.166667	83	135	99	1	52	0.0192308
NODE_306368_length_135_cov_2144.166667	83	135	101	1	52	0.0192308
NODE_306368_length_135_cov_2144.166667	83	135	105	1	52	0.0192308
NODE_306368_length_135_cov_2144.166667	83	135	117	1	52	0.0192308
NODE_306368_length_135_cov_2144.166667	83	135	127	1	52	0.0192308
NODE_306368_length_135_cov_2144.166667	83	135	141	1	52	0.0192308
NODE_306368_length_135_cov_2144.166667	83	135	149	1	52	0.0192308
NODE_306368_length_135_cov_2144.166667	83	135	151	1	52	0.0192308
NODE_306368_length_135_cov_2144.166667	83	135	164	3	52	0.0576923
NODE_306368_length_135_cov_2144.166667	83	135	165	1	52	0.0192308
NODE_306368_length_135_cov_2144.166667	83	135	167	21	52	0.4038461
NODE_306370_length_135_cov_630.194444	0	76	8	4	76	0.0526316
NODE_306370_length_135_cov_630.194444	0	76	14	1	76	0.0131579
NODE_306370_length_135_cov_630.194444	0	76	16	2	76	0.0263158
NODE_306370_length_135_cov_630.194444	0	76	18	2	76	0.0263158
NODE_306370_length_135_cov_630.194444	0	76	26	1	76	0.0131579
NODE_306370_length_135_cov_630.194444	0	76	28	1	76	0.0131579
NODE_306370_length_135_cov_630.194444	0	76	30	5	76	0.0657895
NODE_306370_length_135_cov_630.194444	0	76	32	6	76	0.0789474
NODE_306370_length_135_cov_630.194444	0	76	34	3	76	0.0394737
NODE_306370_length_135_cov_630.194444	0	76	36	3	76	0.0394737
NODE_306370_length_135_cov_630.194444	0	76	38	48	76	0.6315789
NODE_306371_length_135_cov_540.611111	0	76	12	1	76	0.0131579
NODE_306371_length_135_cov_540.611111	0	76	14	1	76	0.0131579
NODE_306371_length_135_cov_540.611111	0	76	18	1	76	0.0131579
NODE_306371_length_135_cov_540.611111	0	76	28	1	76	0.0131579
NODE_306371_length_135_cov_540.611111	0	76	34	1	76	0.0131579
NODE_306371_length_135_cov_540.611111	0	76	36	1	76	0.0131579
NODE_306371_length_135_cov_540.611111	0	76	44	1	76	0.0131579
NODE_306371_length_135_cov_540.611111	0	76	48	3	76	0.0394737
NODE_306371_length_135_cov_540.611111	0	76	50	1	76	0.0131579
NODE_306371_length_135_cov_540.611111	0	76	62	2	76	0.0263158
NODE_306371_length_135_cov_540.611111	0	76	71	1	76	0.0131579
NODE_306371_length_135_cov_540.611111	0	76	73	1	76	0.0131579
NODE_306371_length_135_cov_540.611111	0	76	80	1	76	0.0131579
NODE_306371_length_135_cov_540.611111	0	76	84	1	76	0.0131579
NODE_306371_length_135_cov_540.611111	0	76	88	1	76	0.0131579
NODE_306371_length_135_cov_540.611111	0	76	94	1	76	0.0131579
NODE_306371_length_135_cov_540.611111	0	76	102	2	76	0.0263158
NODE_306371_length_135_cov_540.611111	0	76	104	2	76	0.0263158
NODE_306371_length_135_cov_540.611111	0	76	106	1	76	0.0131579
NODE_306371_length_135_cov_540.611111	0	76	108	2	76	0.0263158
NODE_306371_length_135_cov_540.611111	0	76	111	1	76	0.0131579
NODE_306371_length_135_cov_540.611111	0	76	113	1	76	0.0131579
NODE_306371_length_135_cov_540.611111	0	76	117	1	76	0.0131579
NODE_306371_length_135_cov_540.611111	0	76	119	47	76	0.6184211
NODE_306373_length_135_cov_257.416667	36	88	124	52	52	1.0000000
NODE_306374_length_135_cov_239.638889	97	135	0	2	38	0.0526316
NODE_306374_length_135_cov_239.638889	97	135	4	4	38	0.1052632
NODE_306374_length_135_cov_239.638889	97	135	8	5	38	0.1315790
NODE_306374_length_135_cov_239.638889	97	135	10	2	38	0.0526316
NODE_306374_length_135_cov_239.638889	97	135	18	2	38	0.0526316
NODE_306374_length_135_cov_239.638889	97	135	20	1	38	0.0263158
NODE_306374_length_135_cov_239.638889	97	135	22	1	38	0.0263158
NODE_306374_length_135_cov_239.638889	97	135	28	2	38	0.0526316
NODE_306374_length_135_cov_239.638889	97	135	30	1	38	0.0263158
NODE_306374_length_135_cov_239.638889	97	135	32	3	38	0.0789474
NODE_306374_length_135_cov_239.638889	97	135	44	5	38	0.1315790
NODE_306374_length_135_cov_239.638889	97	135	48	1	38	0.0263158
NODE_306374_length_135_cov_239.638889	97	135	54	1	38	0.0263158
NODE_306374_length_135_cov_239.638889	97	135	56	3	38	0.0789474
NODE_306374_length_135_cov_239.638889	97	135	62	5	38	0.1315790
NODE_306400_length_135_cov_35.055556	8	88	8	2	80	0.0250000
NODE_306400_length_135_cov_35.055556	8	88	12	1	80	0.0125000
NODE_306400_length_135_cov_35.055556	8	88	20	1	80	0.0125000
NODE_306400_length_135_cov_35.055556	8	88	27	1	80	0.0125000
NODE_306400_length_135_cov_35.055556	8	88	28	75	80	0.9375000
NODE_306400_length_135_cov_35.055556	61	125	28	64	64	1.0000000
NODE_306400_length_135_cov_35.055556	61	125	28	64	64	1.0000000
NODE_306402_length_135_cov_31.805556	0	76	0	76	76	1.0000000
NODE_306658_length_133_cov_140.411765	8	43	10	5	35	0.1428571
NODE_306658_length_133_cov_140.411765	8	43	12	14	35	0.4000000
NODE_306658_length_133_cov_140.411765	8	43	14	16	35	0.4571429
NODE_306658_length_133_cov_140.411765	53	88	14	35	35	1.0000000
NODE_306658_length_133_cov_140.411765	98	133	0	5	35	0.1428571
NODE_306658_length_133_cov_140.411765	98	133	2	4	35	0.1142857
NODE_306658_length_133_cov_140.411765	98	133	8	2	35	0.0571429
NODE_306658_length_133_cov_140.411765	98	133	10	4	35	0.1142857
NODE_306658_length_133_cov_140.411765	98	133	12	2	35	0.0571429
NODE_306658_length_133_cov_140.411765	98	133	14	18	35	0.5142857
NODE_306661_length_133_cov_109.441176	63	129	2	15	66	0.2272727
NODE_306661_length_133_cov_109.441176	63	129	4	2	66	0.0303030
NODE_306661_length_133_cov_109.441176	63	129	6	49	66	0.7424242
NODE_306812_length_132_cov_114.151515	2	44	0	16	42	0.3809524
NODE_306812_length_132_cov_114.151515	2	44	2	26	42	0.6190476
NODE_306812_length_132_cov_114.151515	4	44	0	14	40	0.3500000
NODE_306812_length_132_cov_114.151515	4	44	2	26	40	0.6500000
NODE_306812_length_132_cov_114.151515	17	83	0	1	66	0.0151515
NODE_306812_length_132_cov_114.151515	17	83	2	65	66	0.9848485
NODE_306812_length_132_cov_114.151515	17	88	0	1	71	0.0140845
NODE_306812_length_132_cov_114.151515	17	88	2	70	71	0.9859155
NODE_306824_length_132_cov_61.636364	3	76	2	1	73	0.0136986
NODE_306824_length_132_cov_61.636364	3	76	4	21	73	0.2876712
NODE_306824_length_132_cov_61.636364	3	76	8	51	73	0.6986302
NODE_306824_length_132_cov_61.636364	49	130	0	4	81	0.0493827
NODE_306824_length_132_cov_61.636364	49	130	2	1	81	0.0123457
NODE_306824_length_132_cov_61.636364	49	130	4	13	81	0.1604938
NODE_306824_length_132_cov_61.636364	49	130	6	7	81	0.0864198
NODE_306824_length_132_cov_61.636364	49	130	8	56	81	0.6913580
NODE_306824_length_132_cov_61.636364	103	125	4	13	22	0.5909091
NODE_306824_length_132_cov_61.636364	103	125	6	7	22	0.3181818
NODE_306824_length_132_cov_61.636364	103	125	8	2	22	0.0909091
NODE_306834_length_132_cov_33.393939	2	83	0	81	81	1.0000000
NODE_306834_length_132_cov_33.393939	7	29	0	22	22	1.0000000
NODE_306834_length_132_cov_33.393939	56	129	0	73	73	1.0000000
NODE_306965_length_131_cov_810.000000	0	60	10	1	60	0.0166667
NODE_306965_length_131_cov_810.000000	0	60	17	1	60	0.0166667
NODE_306965_length_131_cov_810.000000	0	60	25	4	60	0.0666667
NODE_306965_length_131_cov_810.000000	0	60	27	1	60	0.0166667
NODE_306965_length_131_cov_810.000000	0	60	28	1	60	0.0166667
NODE_306965_length_131_cov_810.000000	0	60	33	1	60	0.0166667
NODE_306965_length_131_cov_810.000000	0	60	35	2	60	0.0333333
NODE_306965_length_131_cov_810.000000	0	60	38	1	60	0.0166667
NODE_306965_length_131_cov_810.000000	0	60	45	1	60	0.0166667
NODE_306965_length_131_cov_810.000000	0	60	49	1	60	0.0166667
NODE_306965_length_131_cov_810.000000	0	60	55	1	60	0.0166667
NODE_306965_length_131_cov_810.000000	0	60	59	1	60	0.0166667
NODE_306965_length_131_cov_810.000000	0	60	61	1	60	0.0166667
NODE_306965_length_131_cov_810.000000	0	60	63	1	60	0.0166667
NODE_306965_length_131_cov_810.000000	0	60	64	1	60	0.0166667
NODE_306965_length_131_cov_810.000000	0	60	69	1	60	0.0166667
NODE_306965_length_131_cov_810.000000	0	60	71	3	60	0.0500000
NODE_306965_length_131_cov_810.000000	0	60	78	1	60	0.0166667
NODE_306965_length_131_cov_810.000000	0	60	86	1	60	0.0166667
NODE_306965_length_131_cov_810.000000	0	60	88	1	60	0.0166667
NODE_306965_length_131_cov_810.000000	0	60	98	1	60	0.0166667
NODE_306965_length_131_cov_810.000000	0	60	104	1	60	0.0166667
NODE_306965_length_131_cov_810.000000	0	60	112	1	60	0.0166667
NODE_306965_length_131_cov_810.000000	0	60	114	2	60	0.0333333
NODE_306965_length_131_cov_810.000000	0	60	118	29	60	0.4833333
NODE_306965_length_131_cov_810.000000	33	97	118	64	64	1.0000000
NODE_306965_length_131_cov_810.000000	33	97	118	64	64	1.0000000
NODE_306965_length_131_cov_810.000000	33	97	118	64	64	1.0000000
NODE_306985_length_131_cov_149.187500	25	105	58	1	80	0.0125000
NODE_306985_length_131_cov_149.187500	25	105	60	1	80	0.0125000
NODE_306985_length_131_cov_149.187500	25	105	64	1	80	0.0125000
NODE_306985_length_131_cov_149.187500	25	105	66	1	80	0.0125000
NODE_306985_length_131_cov_149.187500	25	105	72	76	80	0.9500000
NODE_306985_length_131_cov_149.187500	78	131	8	1	53	0.0188679
NODE_306985_length_131_cov_149.187500	78	131	10	3	53	0.0566038
NODE_306985_length_131_cov_149.187500	78	131	20	3	53	0.0566038
NODE_306985_length_131_cov_149.187500	78	131	24	1	53	0.0188679
NODE_306985_length_131_cov_149.187500	78	131	30	1	53	0.0188679
NODE_306985_length_131_cov_149.187500	78	131	36	1	53	0.0188679
NODE_306985_length_131_cov_149.187500	78	131	38	1	53	0.0188679
NODE_306985_length_131_cov_149.187500	78	131	46	1	53	0.0188679
NODE_306985_length_131_cov_149.187500	78	131	50	1	53	0.0188679
NODE_306985_length_131_cov_149.187500	78	131	58	1	53	0.0188679
NODE_306985_length_131_cov_149.187500	78	131	60	2	53	0.0377358
NODE_306985_length_131_cov_149.187500	78	131	62	1	53	0.0188679
NODE_306985_length_131_cov_149.187500	78	131	64	2	53	0.0377358
NODE_306985_length_131_cov_149.187500	78	131	66	2	53	0.0377358
NODE_306985_length_131_cov_149.187500	78	131	68	3	53	0.0566038
NODE_306985_length_131_cov_149.187500	78	131	70	1	53	0.0188679
NODE_306985_length_131_cov_149.187500	78	131	72	28	53	0.5283019
NODE_307121_length_130_cov_319.806452	54	126	12	5	72	0.0694444
NODE_307121_length_130_cov_319.806452	54	126	14	6	72	0.0833333
NODE_307121_length_130_cov_319.806452	54	126	16	1	72	0.0138889
NODE_307121_length_130_cov_319.806452	54	126	20	3	72	0.0416667
NODE_307121_length_130_cov_319.806452	54	126	22	8	72	0.1111111
NODE_307121_length_130_cov_319.806452	54	126	24	49	72	0.6805556
NODE_307132_length_130_cov_153.516129	82	113	0	31	31	1.0000000
NODE_307140_length_130_cov_79.064516	0	53	2	1	53	0.0188679
NODE_307140_length_130_cov_79.064516	0	53	6	1	53	0.0188679
NODE_307140_length_130_cov_79.064516	0	53	8	7	53	0.1320755
NODE_307140_length_130_cov_79.064516	0	53	10	1	53	0.0188679
NODE_307140_length_130_cov_79.064516	0	53	12	13	53	0.2452830
NODE_307140_length_130_cov_79.064516	0	53	16	5	53	0.0943396
NODE_307140_length_130_cov_79.064516	0	53	18	25	53	0.4716981
NODE_307140_length_130_cov_79.064516	26	56	16	2	30	0.0666667
NODE_307140_length_130_cov_79.064516	26	56	18	28	30	0.9333333
NODE_307270_length_129_cov_1851.133333	0	45	0	5	45	0.1111111
NODE_307270_length_129_cov_1851.133333	0	45	4	3	45	0.0666667
NODE_307270_length_129_cov_1851.133333	0	45	10	3	45	0.0666667
NODE_307270_length_129_cov_1851.133333	0	45	12	1	45	0.0222222
NODE_307270_length_129_cov_1851.133333	0	45	28	1	45	0.0222222
NODE_307270_length_129_cov_1851.133333	0	45	30	1	45	0.0222222
NODE_307270_length_129_cov_1851.133333	0	45	34	1	45	0.0222222
NODE_307270_length_129_cov_1851.133333	0	45	38	3	45	0.0666667
NODE_307270_length_129_cov_1851.133333	0	45	44	3	45	0.0666667
NODE_307270_length_129_cov_1851.133333	0	45	50	24	45	0.5333334
NODE_307270_length_129_cov_1851.133333	18	98	44	3	80	0.0375000
NODE_307270_length_129_cov_1851.133333	18	98	50	77	80	0.9625000
NODE_307285_length_129_cov_186.500000	0	78	2	3	78	0.0384615
NODE_307285_length_129_cov_186.500000	0	78	4	8	78	0.1025641
NODE_307285_length_129_cov_186.500000	0	78	8	67	78	0.8589743
NODE_307285_length_129_cov_186.500000	53	129	0	6	76	0.0789474
NODE_307285_length_129_cov_186.500000	53	129	4	6	76	0.0789474
NODE_307285_length_129_cov_186.500000	53	129	8	64	76	0.8421053
NODE_307287_length_129_cov_165.466667	36	111	20	1	75	0.0133333
NODE_307287_length_129_cov_165.466667	36	111	22	2	75	0.0266667
NODE_307287_length_129_cov_165.466667	36	111	24	4	75	0.0533333
NODE_307287_length_129_cov_165.466667	36	111	27	2	75	0.0266667
NODE_307287_length_129_cov_165.466667	36	111	28	66	75	0.8800000
NODE_307287_length_129_cov_165.466667	84	113	20	3	29	0.1034483
NODE_307287_length_129_cov_165.466667	84	113	22	2	29	0.0689655
NODE_307287_length_129_cov_165.466667	84	113	24	4	29	0.1379310
NODE_307287_length_129_cov_165.466667	84	113	28	20	29	0.6896552
NODE_307292_length_129_cov_90.366667	0	48	7	2	48	0.0416667
NODE_307292_length_129_cov_90.366667	0	48	16	11	48	0.2291667
NODE_307292_length_129_cov_90.366667	0	48	22	6	48	0.1250000
NODE_307292_length_129_cov_90.366667	0	48	24	29	48	0.6041667
NODE_307292_length_129_cov_90.366667	0	48	7	2	48	0.0416667
NODE_307292_length_129_cov_90.366667	0	48	16	11	48	0.2291667
NODE_307292_length_129_cov_90.366667	0	48	22	6	48	0.1250000
NODE_307292_length_129_cov_90.366667	0	48	24	29	48	0.6041667
NODE_307292_length_129_cov_90.366667	0	48	7	2	48	0.0416667
NODE_307292_length_129_cov_90.366667	0	48	16	11	48	0.2291667
NODE_307292_length_129_cov_90.366667	0	48	22	6	48	0.1250000
NODE_307292_length_129_cov_90.366667	0	48	24	29	48	0.6041667
NODE_307292_length_129_cov_90.366667	21	101	23	11	80	0.1375000
NODE_307292_length_129_cov_90.366667	21	101	24	69	80	0.8625000
NODE_307442_length_128_cov_2621.517241	3	83	55	1	80	0.0125000
NODE_307442_length_128_cov_2621.517241	3	83	64	1	80	0.0125000
NODE_307442_length_128_cov_2621.517241	3	83	68	1	80	0.0125000
NODE_307442_length_128_cov_2621.517241	3	83	76	1	80	0.0125000
NODE_307442_length_128_cov_2621.517241	3	83	88	1	80	0.0125000
NODE_307442_length_128_cov_2621.517241	3	83	92	1	80	0.0125000
NODE_307442_length_128_cov_2621.517241	3	83	94	1	80	0.0125000
NODE_307442_length_128_cov_2621.517241	3	83	102	1	80	0.0125000
NODE_307442_length_128_cov_2621.517241	3	83	115	1	80	0.0125000
NODE_307442_length_128_cov_2621.517241	3	83	125	1	80	0.0125000
NODE_307442_length_128_cov_2621.517241	3	83	129	1	80	0.0125000
NODE_307442_length_128_cov_2621.517241	3	83	133	3	80	0.0375000
NODE_307442_length_128_cov_2621.517241	3	83	135	4	80	0.0500000
NODE_307442_length_128_cov_2621.517241	3	83	137	2	80	0.0250000
NODE_307442_length_128_cov_2621.517241	3	83	138	1	80	0.0125000
NODE_307442_length_128_cov_2621.517241	3	83	140	1	80	0.0125000
NODE_307442_length_128_cov_2621.517241	3	83	142	2	80	0.0250000
NODE_307442_length_128_cov_2621.517241	3	83	143	18	80	0.2250000
NODE_307442_length_128_cov_2621.517241	3	83	144	38	80	0.4750000
NODE_307442_length_128_cov_2621.517241	8	30	92	1	22	0.0454545
NODE_307442_length_128_cov_2621.517241	8	30	94	1	22	0.0454545
NODE_307442_length_128_cov_2621.517241	8	30	102	1	22	0.0454545
NODE_307442_length_128_cov_2621.517241	8	30	115	1	22	0.0454545
NODE_307442_length_128_cov_2621.517241	8	30	125	1	22	0.0454545
NODE_307442_length_128_cov_2621.517241	8	30	129	1	22	0.0454545
NODE_307442_length_128_cov_2621.517241	8	30	133	3	22	0.1363636
NODE_307442_length_128_cov_2621.517241	8	30	135	4	22	0.1818182
NODE_307442_length_128_cov_2621.517241	8	30	137	2	22	0.0909091
NODE_307442_length_128_cov_2621.517241	8	30	138	1	22	0.0454545
NODE_307442_length_128_cov_2621.517241	8	30	140	1	22	0.0454545
NODE_307442_length_128_cov_2621.517241	8	30	142	2	22	0.0909091
NODE_307442_length_128_cov_2621.517241	8	30	143	3	22	0.1363636
NODE_307442_length_128_cov_2621.517241	56	128	20	3	72	0.0416667
NODE_307442_length_128_cov_2621.517241	56	128	26	4	72	0.0555556
NODE_307442_length_128_cov_2621.517241	56	128	28	4	72	0.0555556
NODE_307442_length_128_cov_2621.517241	56	128	38	1	72	0.0138889
NODE_307442_length_128_cov_2621.517241	56	128	44	1	72	0.0138889
NODE_307442_length_128_cov_2621.517241	56	128	52	1	72	0.0138889
NODE_307442_length_128_cov_2621.517241	56	128	60	1	72	0.0138889
NODE_307442_length_128_cov_2621.517241	56	128	72	1	72	0.0138889
NODE_307442_length_128_cov_2621.517241	56	128	76	1	72	0.0138889
NODE_307442_length_128_cov_2621.517241	56	128	91	1	72	0.0138889
NODE_307442_length_128_cov_2621.517241	56	128	93	1	72	0.0138889
NODE_307442_length_128_cov_2621.517241	56	128	101	1	72	0.0138889
NODE_307442_length_128_cov_2621.517241	56	128	104	1	72	0.0138889
NODE_307442_length_128_cov_2621.517241	56	128	124	1	72	0.0138889
NODE_307442_length_128_cov_2621.517241	56	128	128	1	72	0.0138889
NODE_307442_length_128_cov_2621.517241	56	128	130	1	72	0.0138889
NODE_307442_length_128_cov_2621.517241	56	128	134	1	72	0.0138889
NODE_307442_length_128_cov_2621.517241	56	128	144	47	72	0.6527778
NODE_307443_length_128_cov_1604.275862	58	127	2	5	69	0.0724638
NODE_307443_length_128_cov_1604.275862	58	127	4	8	69	0.1159420
NODE_307443_length_128_cov_1604.275862	58	127	8	2	69	0.0289855
NODE_307443_length_128_cov_1604.275862	58	127	14	1	69	0.0144928
NODE_307443_length_128_cov_1604.275862	58	127	16	53	69	0.7681159
NODE_307458_length_128_cov_79.034483	43	123	14	8	80	0.1000000
NODE_307458_length_128_cov_79.034483	43	123	18	72	80	0.9000000
NODE_307464_length_128_cov_61.793103	5	85	0	6	80	0.0750000
NODE_307464_length_128_cov_61.793103	5	85	4	7	80	0.0875000
NODE_307464_length_128_cov_61.793103	5	85	6	6	80	0.0750000
NODE_307464_length_128_cov_61.793103	5	85	8	61	80	0.7625000
NODE_307549_length_127_cov_1879.785714	21	101	74	1	80	0.0125000
NODE_307549_length_127_cov_1879.785714	21	101	80	1	80	0.0125000
NODE_307549_length_127_cov_1879.785714	21	101	88	1	80	0.0125000
NODE_307549_length_127_cov_1879.785714	21	101	95	1	80	0.0125000
NODE_307549_length_127_cov_1879.785714	21	101	96	76	80	0.9500000
NODE_307549_length_127_cov_1879.785714	74	127	2	3	53	0.0566038
NODE_307549_length_127_cov_1879.785714	74	127	8	1	53	0.0188679
NODE_307549_length_127_cov_1879.785714	74	127	12	5	53	0.0943396
NODE_307549_length_127_cov_1879.785714	74	127	18	1	53	0.0188679
NODE_307549_length_127_cov_1879.785714	74	127	20	1	53	0.0188679
NODE_307549_length_127_cov_1879.785714	74	127	28	1	53	0.0188679
NODE_307549_length_127_cov_1879.785714	74	127	30	1	53	0.0188679
NODE_307549_length_127_cov_1879.785714	74	127	47	1	53	0.0188679
NODE_307549_length_127_cov_1879.785714	74	127	56	1	53	0.0188679
NODE_307549_length_127_cov_1879.785714	74	127	60	2	53	0.0377358
NODE_307549_length_127_cov_1879.785714	74	127	64	1	53	0.0188679
NODE_307549_length_127_cov_1879.785714	74	127	74	1	53	0.0188679
NODE_307549_length_127_cov_1879.785714	74	127	82	1	53	0.0188679
NODE_307549_length_127_cov_1879.785714	74	127	84	3	53	0.0566038
NODE_307549_length_127_cov_1879.785714	74	127	90	1	53	0.0188679
NODE_307549_length_127_cov_1879.785714	74	127	96	29	53	0.5471698
NODE_307583_length_127_cov_66.142857	38	118	0	7	80	0.0875000
NODE_307583_length_127_cov_66.142857	38	118	4	73	80	0.9125000
NODE_307583_length_127_cov_66.142857	47	118	0	7	71	0.0985916
NODE_307583_length_127_cov_66.142857	47	118	4	64	71	0.9014084
NODE_307590_length_127_cov_38.285714	12	86	4	74	74	1.0000000
NODE_307596_length_127_cov_30.607143	21	93	0	72	72	1.0000000
NODE_307662_length_126_cov_936.777778	24	96	10	72	72	1.0000000
NODE_307675_length_126_cov_147.185185	2	66	2	18	64	0.2812500
NODE_307675_length_126_cov_147.185185	2	66	10	46	64	0.7187500
NODE_307675_length_126_cov_147.185185	2	66	2	18	64	0.2812500
NODE_307675_length_126_cov_147.185185	2	66	10	46	64	0.7187500
NODE_307675_length_126_cov_147.185185	2	66	2	18	64	0.2812500
NODE_307675_length_126_cov_147.185185	2	66	10	46	64	0.7187500
NODE_307675_length_126_cov_147.185185	39	99	10	60	60	1.0000000
NODE_307675_length_126_cov_147.185185	55	99	10	44	44	1.0000000
NODE_307684_length_126_cov_82.518519	44	75	0	31	31	1.0000000
NODE_307793_length_125_cov_656.807692	19	99	18	1	80	0.0125000
NODE_307793_length_125_cov_656.807692	19	99	22	1	80	0.0125000
NODE_307793_length_125_cov_656.807692	19	99	26	1	80	0.0125000
NODE_307793_length_125_cov_656.807692	19	99	28	1	80	0.0125000
NODE_307793_length_125_cov_656.807692	19	99	30	76	80	0.9500000
NODE_307806_length_125_cov_143.615385	52	125	0	12	73	0.1643836
NODE_307806_length_125_cov_143.615385	52	125	4	10	73	0.1369863
NODE_307806_length_125_cov_143.615385	52	125	6	51	73	0.6986302
NODE_307810_length_125_cov_131.923077	3	52	4	6	49	0.1224490
NODE_307810_length_125_cov_131.923077	3	52	10	6	49	0.1224490
NODE_307810_length_125_cov_131.923077	3	52	12	1	49	0.0204082
NODE_307810_length_125_cov_131.923077	3	52	20	4	49	0.0816327
NODE_307810_length_125_cov_131.923077	3	52	22	2	49	0.0408163
NODE_307810_length_125_cov_131.923077	3	52	24	30	49	0.6122449
NODE_307810_length_125_cov_131.923077	25	89	24	64	64	1.0000000
NODE_307810_length_125_cov_131.923077	25	89	24	64	64	1.0000000
NODE_307816_length_125_cov_102.500000	0	56	25	9	56	0.1607143
NODE_307816_length_125_cov_102.500000	0	56	29	30	56	0.5357143
NODE_307816_length_125_cov_102.500000	0	56	30	17	56	0.3035714
NODE_307816_length_125_cov_102.500000	7	56	25	2	49	0.0408163
NODE_307816_length_125_cov_102.500000	7	56	29	30	49	0.6122449
NODE_307816_length_125_cov_102.500000	7	56	30	17	49	0.3469388
NODE_307816_length_125_cov_102.500000	29	114	26	5	85	0.0588235
NODE_307816_length_125_cov_102.500000	29	114	29	10	85	0.1176471
NODE_307816_length_125_cov_102.500000	29	114	30	70	85	0.8235294
NODE_307816_length_125_cov_102.500000	29	114	26	5	85	0.0588235
NODE_307816_length_125_cov_102.500000	29	114	29	10	85	0.1176471
NODE_307816_length_125_cov_102.500000	29	114	30	70	85	0.8235294
NODE_307816_length_125_cov_102.500000	29	114	26	5	85	0.0588235
NODE_307816_length_125_cov_102.500000	29	114	29	10	85	0.1176471
NODE_307816_length_125_cov_102.500000	29	114	30	70	85	0.8235294
NODE_307839_length_125_cov_28.115385	17	90	26	1	73	0.0136986
NODE_307839_length_125_cov_28.115385	17	90	28	72	73	0.9863014
NODE_307839_length_125_cov_28.115385	57	98	28	41	41	1.0000000
NODE_307906_length_124_cov_945.680000	0	73	4	2	73	0.0273973
NODE_307906_length_124_cov_945.680000	0	73	6	1	73	0.0136986
NODE_307906_length_124_cov_945.680000	0	73	8	1	73	0.0136986
NODE_307906_length_124_cov_945.680000	0	73	10	1	73	0.0136986
NODE_307906_length_124_cov_945.680000	0	73	12	1	73	0.0136986
NODE_307906_length_124_cov_945.680000	0	73	17	1	73	0.0136986
NODE_307906_length_124_cov_945.680000	0	73	18	1	73	0.0136986
NODE_307906_length_124_cov_945.680000	0	73	22	2	73	0.0273973
NODE_307906_length_124_cov_945.680000	0	73	35	1	73	0.0136986
NODE_307906_length_124_cov_945.680000	0	73	37	1	73	0.0136986
NODE_307906_length_124_cov_945.680000	0	73	38	6	73	0.0821918
NODE_307906_length_124_cov_945.680000	0	73	40	2	73	0.0273973
NODE_307906_length_124_cov_945.680000	0	73	42	53	73	0.7260274
NODE_307906_length_124_cov_945.680000	53	124	4	2	71	0.0281690
NODE_307906_length_124_cov_945.680000	53	124	14	2	71	0.0281690
NODE_307906_length_124_cov_945.680000	53	124	16	3	71	0.0422535
NODE_307906_length_124_cov_945.680000	53	124	22	2	71	0.0281690
NODE_307906_length_124_cov_945.680000	53	124	24	3	71	0.0422535
NODE_307906_length_124_cov_945.680000	53	124	26	2	71	0.0281690
NODE_307906_length_124_cov_945.680000	53	124	30	1	71	0.0140845
NODE_307906_length_124_cov_945.680000	53	124	34	3	71	0.0422535
NODE_307906_length_124_cov_945.680000	53	124	38	2	71	0.0281690
NODE_307906_length_124_cov_945.680000	53	124	40	1	71	0.0140845
NODE_307906_length_124_cov_945.680000	53	124	42	50	71	0.7042254
NODE_308023_length_123_cov_1186.083333	0	76	0	6	76	0.0789474
NODE_308023_length_123_cov_1186.083333	0	76	2	2	76	0.0263158
NODE_308023_length_123_cov_1186.083333	0	76	14	2	76	0.0263158
NODE_308023_length_123_cov_1186.083333	0	76	16	3	76	0.0394737
NODE_308023_length_123_cov_1186.083333	0	76	18	63	76	0.8289474
NODE_308023_length_123_cov_1186.083333	0	76	0	6	76	0.0789474
NODE_308023_length_123_cov_1186.083333	0	76	2	2	76	0.0263158
NODE_308023_length_123_cov_1186.083333	0	76	14	2	76	0.0263158
NODE_308023_length_123_cov_1186.083333	0	76	16	3	76	0.0394737
NODE_308023_length_123_cov_1186.083333	0	76	18	63	76	0.8289474
NODE_308023_length_123_cov_1186.083333	0	76	0	6	76	0.0789474
NODE_308023_length_123_cov_1186.083333	0	76	2	2	76	0.0263158
NODE_308023_length_123_cov_1186.083333	0	76	14	2	76	0.0263158
NODE_308023_length_123_cov_1186.083333	0	76	16	3	76	0.0394737
NODE_308023_length_123_cov_1186.083333	0	76	18	63	76	0.8289474
NODE_308023_length_123_cov_1186.083333	0	76	0	6	76	0.0789474
NODE_308023_length_123_cov_1186.083333	0	76	2	2	76	0.0263158
NODE_308023_length_123_cov_1186.083333	0	76	14	2	76	0.0263158
NODE_308023_length_123_cov_1186.083333	0	76	16	3	76	0.0394737
NODE_308023_length_123_cov_1186.083333	0	76	18	63	76	0.8289474
NODE_308023_length_123_cov_1186.083333	49	123	14	3	74	0.0405405
NODE_308023_length_123_cov_1186.083333	49	123	16	7	74	0.0945946
NODE_308023_length_123_cov_1186.083333	49	123	18	64	74	0.8648649
NODE_308023_length_123_cov_1186.083333	49	123	14	3	74	0.0405405
NODE_308023_length_123_cov_1186.083333	49	123	16	7	74	0.0945946
NODE_308023_length_123_cov_1186.083333	49	123	18	64	74	0.8648649
NODE_308023_length_123_cov_1186.083333	49	123	14	3	74	0.0405405
NODE_308023_length_123_cov_1186.083333	49	123	16	7	74	0.0945946
NODE_308023_length_123_cov_1186.083333	49	123	18	64	74	0.8648649
NODE_308024_length_123_cov_963.500000	19	88	16	1	69	0.0144928
NODE_308024_length_123_cov_963.500000	19	88	18	3	69	0.0434783
NODE_308024_length_123_cov_963.500000	19	88	20	65	69	0.9420290
NODE_308037_length_123_cov_181.291667	0	47	0	47	47	1.0000000
NODE_308037_length_123_cov_181.291667	24	100	0	76	76	1.0000000
NODE_308057_length_123_cov_55.375000	52	123	2	4	71	0.0563380
NODE_308057_length_123_cov_55.375000	52	123	4	6	71	0.0845070
NODE_308057_length_123_cov_55.375000	52	123	6	8	71	0.1126761
NODE_308057_length_123_cov_55.375000	52	123	8	53	71	0.7464789
NODE_308057_length_123_cov_55.375000	52	123	2	4	71	0.0563380
NODE_308057_length_123_cov_55.375000	52	123	4	6	71	0.0845070
NODE_308057_length_123_cov_55.375000	52	123	6	8	71	0.1126761
NODE_308057_length_123_cov_55.375000	52	123	8	53	71	0.7464789
NODE_308057_length_123_cov_55.375000	61	123	2	4	62	0.0645161
NODE_308057_length_123_cov_55.375000	61	123	4	6	62	0.0967742
NODE_308057_length_123_cov_55.375000	61	123	6	8	62	0.1290323
NODE_308057_length_123_cov_55.375000	61	123	8	44	62	0.7096774
NODE_308068_length_123_cov_40.958333	9	89	12	1	80	0.0125000
NODE_308068_length_123_cov_40.958333	9	89	14	5	80	0.0625000
NODE_308068_length_123_cov_40.958333	9	89	16	4	80	0.0500000
NODE_308068_length_123_cov_40.958333	9	89	20	70	80	0.8750000
NODE_308068_length_123_cov_40.958333	9	89	12	1	80	0.0125000
NODE_308068_length_123_cov_40.958333	9	89	14	5	80	0.0625000
NODE_308068_length_123_cov_40.958333	9	89	16	4	80	0.0500000
NODE_308068_length_123_cov_40.958333	9	89	20	70	80	0.8750000
NODE_308068_length_123_cov_40.958333	9	89	12	1	80	0.0125000
NODE_308068_length_123_cov_40.958333	9	89	14	5	80	0.0625000
NODE_308068_length_123_cov_40.958333	9	89	16	4	80	0.0500000
NODE_308068_length_123_cov_40.958333	9	89	20	70	80	0.8750000
NODE_308068_length_123_cov_40.958333	9	89	12	1	80	0.0125000
NODE_308068_length_123_cov_40.958333	9	89	14	5	80	0.0625000
NODE_308068_length_123_cov_40.958333	9	89	16	4	80	0.0500000
NODE_308068_length_123_cov_40.958333	9	89	20	70	80	0.8750000
NODE_308068_length_123_cov_40.958333	9	89	12	1	80	0.0125000
NODE_308068_length_123_cov_40.958333	9	89	14	5	80	0.0625000
NODE_308068_length_123_cov_40.958333	9	89	16	4	80	0.0500000
NODE_308068_length_123_cov_40.958333	9	89	20	70	80	0.8750000
NODE_308068_length_123_cov_40.958333	9	80	12	1	71	0.0140845
NODE_308068_length_123_cov_40.958333	9	80	14	5	71	0.0704225
NODE_308068_length_123_cov_40.958333	9	80	16	4	71	0.0563380
NODE_308068_length_123_cov_40.958333	9	80	20	61	71	0.8591549
NODE_308180_length_122_cov_111.043478	8	88	0	80	80	1.0000000
NODE_308180_length_122_cov_111.043478	8	88	0	80	80	1.0000000
NODE_308184_length_122_cov_67.565217	0	50	0	8	50	0.1600000
NODE_308184_length_122_cov_67.565217	0	50	2	42	50	0.8400000
NODE_308184_length_122_cov_67.565217	0	50	0	8	50	0.1600000
NODE_308184_length_122_cov_67.565217	0	50	2	42	50	0.8400000
NODE_308184_length_122_cov_67.565217	23	103	2	80	80	1.0000000
NODE_308184_length_122_cov_67.565217	23	103	2	80	80	1.0000000
NODE_308184_length_122_cov_67.565217	23	103	2	80	80	1.0000000
NODE_308184_length_122_cov_67.565217	23	103	2	80	80	1.0000000
NODE_308184_length_122_cov_67.565217	23	103	2	80	80	1.0000000
NODE_308184_length_122_cov_67.565217	23	94	2	71	71	1.0000000
NODE_308188_length_122_cov_58.826087	28	99	0	71	71	1.0000000
NODE_308188_length_122_cov_58.826087	33	99	0	66	66	1.0000000
NODE_308188_length_122_cov_58.826087	72	122	0	50	50	1.0000000
NODE_308188_length_122_cov_58.826087	72	122	0	50	50	1.0000000
NODE_308198_length_122_cov_38.173913	12	93	2	4	81	0.0493827
NODE_308198_length_122_cov_38.173913	12	93	4	1	81	0.0123457
NODE_308198_length_122_cov_38.173913	12	93	8	76	81	0.9382716
NODE_308257_length_121_cov_159.318182	24	55	0	31	31	1.0000000
NODE_308260_length_121_cov_120.181818	20	100	2	80	80	1.0000000
NODE_308260_length_121_cov_120.181818	20	95	2	75	75	1.0000000
NODE_308260_length_121_cov_120.181818	20	100	2	80	80	1.0000000
NODE_308260_length_121_cov_120.181818	29	100	2	71	71	1.0000000
NODE_308273_length_121_cov_54.181818	7	70	0	63	63	1.0000000
NODE_308273_length_121_cov_54.181818	7	70	0	63	63	1.0000000
NODE_308273_length_121_cov_54.181818	7	70	0	63	63	1.0000000
NODE_308273_length_121_cov_54.181818	9	70	0	61	61	1.0000000
NODE_308273_length_121_cov_54.181818	43	109	0	66	66	1.0000000
NODE_308273_length_121_cov_54.181818	43	121	0	78	78	1.0000000
NODE_308273_length_121_cov_54.181818	64	117	0	53	53	1.0000000
NODE_308317_length_120_cov_1404.619048	0	64	12	1	64	0.0156250
NODE_308317_length_120_cov_1404.619048	0	64	14	1	64	0.0156250
NODE_308317_length_120_cov_1404.619048	0	64	22	1	64	0.0156250
NODE_308317_length_120_cov_1404.619048	0	64	29	1	64	0.0156250
NODE_308317_length_120_cov_1404.619048	0	64	30	2	64	0.0312500
NODE_308317_length_120_cov_1404.619048	0	64	38	1	64	0.0156250
NODE_308317_length_120_cov_1404.619048	0	64	44	2	64	0.0312500
NODE_308317_length_120_cov_1404.619048	0	64	52	1	64	0.0156250
NODE_308317_length_120_cov_1404.619048	0	64	54	1	64	0.0156250
NODE_308317_length_120_cov_1404.619048	0	64	56	1	64	0.0156250
NODE_308317_length_120_cov_1404.619048	0	64	62	5	64	0.0781250
NODE_308317_length_120_cov_1404.619048	0	64	64	47	64	0.7343750
NODE_308317_length_120_cov_1404.619048	45	117	30	1	72	0.0138889
NODE_308317_length_120_cov_1404.619048	45	117	34	1	72	0.0138889
NODE_308317_length_120_cov_1404.619048	45	117	40	2	72	0.0277778
NODE_308317_length_120_cov_1404.619048	45	117	46	1	72	0.0138889
NODE_308317_length_120_cov_1404.619048	45	117	48	2	72	0.0277778
NODE_308317_length_120_cov_1404.619048	45	117	52	1	72	0.0138889
NODE_308317_length_120_cov_1404.619048	45	117	57	2	72	0.0277778
NODE_308317_length_120_cov_1404.619048	45	117	60	2	72	0.0277778
NODE_308317_length_120_cov_1404.619048	45	117	62	1	72	0.0138889
NODE_308317_length_120_cov_1404.619048	45	117	64	59	72	0.8194444
NODE_308318_length_120_cov_1138.428571	19	99	8	80	80	1.0000000
NODE_308318_length_120_cov_1138.428571	72	120	4	6	48	0.1250000
NODE_308318_length_120_cov_1138.428571	72	120	6	11	48	0.2291667
NODE_308318_length_120_cov_1138.428571	72	120	8	31	48	0.6458333
NODE_308357_length_120_cov_54.666667	0	69	0	69	69	1.0000000
NODE_308357_length_120_cov_54.666667	0	69	0	69	69	1.0000000
NODE_308357_length_120_cov_54.666667	0	69	0	69	69	1.0000000
NODE_308357_length_120_cov_54.666667	42	108	0	66	66	1.0000000
NODE_308357_length_120_cov_54.666667	53	120	0	67	67	1.0000000
NODE_308357_length_120_cov_54.666667	53	120	0	67	67	1.0000000
NODE_308487_length_118_cov_1211.578947	49	116	0	1	67	0.0149254
NODE_308487_length_118_cov_1211.578947	49	116	2	5	67	0.0746269
NODE_308487_length_118_cov_1211.578947	49	116	6	2	67	0.0298507
NODE_308487_length_118_cov_1211.578947	49	116	8	59	67	0.8805970
NODE_308488_length_118_cov_1157.157895	4	70	0	4	66	0.0606061
NODE_308488_length_118_cov_1157.157895	4	70	4	1	66	0.0151515
NODE_308488_length_118_cov_1157.157895	4	70	6	6	66	0.0909091
NODE_308488_length_118_cov_1157.157895	4	70	8	55	66	0.8333333
NODE_308500_length_118_cov_218.210526	0	63	0	1	63	0.0158730
NODE_308500_length_118_cov_218.210526	0	63	6	1	63	0.0158730
NODE_308500_length_118_cov_218.210526	0	63	10	6	63	0.0952381
NODE_308500_length_118_cov_218.210526	0	63	12	1	63	0.0158730
NODE_308500_length_118_cov_218.210526	0	63	17	1	63	0.0158730
NODE_308500_length_118_cov_218.210526	0	63	22	53	63	0.8412699
NODE_308500_length_118_cov_218.210526	35	115	8	1	80	0.0125000
NODE_308500_length_118_cov_218.210526	35	115	12	7	80	0.0875000
NODE_308500_length_118_cov_218.210526	35	115	14	2	80	0.0250000
NODE_308500_length_118_cov_218.210526	35	115	16	2	80	0.0250000
NODE_308500_length_118_cov_218.210526	35	115	18	1	80	0.0125000
NODE_308500_length_118_cov_218.210526	35	115	22	67	80	0.8375000
NODE_308504_length_118_cov_161.052632	4	70	0	66	66	1.0000000
NODE_308572_length_117_cov_338.555556	7	70	8	6	63	0.0952381
NODE_308572_length_117_cov_338.555556	7	70	10	57	63	0.9047619
NODE_308572_length_117_cov_338.555556	7	70	8	6	63	0.0952381
NODE_308572_length_117_cov_338.555556	7	70	10	57	63	0.9047619
NODE_308572_length_117_cov_338.555556	7	70	8	6	63	0.0952381
NODE_308572_length_117_cov_338.555556	7	70	10	57	63	0.9047619
NODE_308572_length_117_cov_338.555556	9	70	8	4	61	0.0655738
NODE_308572_length_117_cov_338.555556	9	70	10	57	61	0.9344262
NODE_308572_length_117_cov_338.555556	43	109	8	6	66	0.0909091
NODE_308572_length_117_cov_338.555556	43	109	10	60	66	0.9090909
NODE_308572_length_117_cov_338.555556	43	114	8	11	71	0.1549296
NODE_308572_length_117_cov_338.555556	43	114	10	60	71	0.8450704
NODE_308572_length_117_cov_338.555556	64	117	6	2	53	0.0377358
NODE_308572_length_117_cov_338.555556	64	117	8	12	53	0.2264151
NODE_308572_length_117_cov_338.555556	64	117	10	39	53	0.7358491
NODE_308654_length_116_cov_1897.470588	0	77	2	5	77	0.0649351
NODE_308654_length_116_cov_1897.470588	0	77	4	4	77	0.0519481
NODE_308654_length_116_cov_1897.470588	0	77	6	4	77	0.0519481
NODE_308654_length_116_cov_1897.470588	0	77	12	64	77	0.8311688
NODE_308654_length_116_cov_1897.470588	34	111	12	77	77	1.0000000
NODE_308668_length_116_cov_438.529412	15	95	2	80	80	1.0000000
NODE_308668_length_116_cov_438.529412	68	116	0	11	48	0.2291667
NODE_308668_length_116_cov_438.529412	68	116	2	37	48	0.7708333
NODE_308701_length_116_cov_93.235294	52	116	0	11	64	0.1718750
NODE_308701_length_116_cov_93.235294	52	116	4	53	64	0.8281250
NODE_308722_length_116_cov_46.882353	6	66	6	4	60	0.0666667
NODE_308722_length_116_cov_46.882353	6	66	8	1	60	0.0166667
NODE_308722_length_116_cov_46.882353	6	66	12	55	60	0.9166667
NODE_308727_length_116_cov_38.352941	20	100	0	80	80	1.0000000
NODE_308746_length_115_cov_1012.625000	31	114	2	1	83	0.0120482
NODE_308746_length_115_cov_1012.625000	31	114	4	1	83	0.0120482
NODE_308746_length_115_cov_1012.625000	31	114	6	2	83	0.0240964
NODE_308746_length_115_cov_1012.625000	31	114	13	2	83	0.0240964
NODE_308746_length_115_cov_1012.625000	31	114	16	77	83	0.9277108
NODE_308750_length_115_cov_776.625000	9	92	2	3	83	0.0361446
NODE_308750_length_115_cov_776.625000	9	92	4	80	83	0.9638554
NODE_308752_length_115_cov_623.937500	0	74	4	3	74	0.0405405
NODE_308752_length_115_cov_623.937500	0	74	7	2	74	0.0270270
NODE_308752_length_115_cov_623.937500	0	74	10	3	74	0.0405405
NODE_308752_length_115_cov_623.937500	0	74	12	1	74	0.0135135
NODE_308752_length_115_cov_623.937500	0	74	16	65	74	0.8783784
NODE_308782_length_115_cov_144.812500	4	73	10	6	69	0.0869565
NODE_308782_length_115_cov_144.812500	4	73	12	63	69	0.9130435
NODE_308806_length_115_cov_65.187500	16	76	28	60	60	1.0000000
NODE_308846_length_114_cov_819.466667	40	114	0	9	74	0.1216216
NODE_308846_length_114_cov_819.466667	40	114	4	65	74	0.8783784
NODE_308846_length_114_cov_819.466667	40	114	0	9	74	0.1216216
NODE_308846_length_114_cov_819.466667	40	114	4	65	74	0.8783784
NODE_308846_length_114_cov_819.466667	49	114	0	9	65	0.1384615
NODE_308846_length_114_cov_819.466667	49	114	4	56	65	0.8615385
NODE_308866_length_114_cov_285.666667	0	78	0	78	78	1.0000000
NODE_308866_length_114_cov_285.666667	51	114	0	63	63	1.0000000
NODE_308886_length_114_cov_83.600000	51	82	0	31	31	1.0000000
NODE_308891_length_114_cov_67.666667	40	90	0	50	50	1.0000000
NODE_308939_length_113_cov_446.214286	5	82	4	77	77	1.0000000
NODE_308939_length_113_cov_446.214286	5	82	4	77	77	1.0000000
NODE_308967_length_113_cov_160.071429	0	64	0	64	64	1.0000000
NODE_308967_length_113_cov_160.071429	0	64	0	64	64	1.0000000
NODE_308967_length_113_cov_160.071429	37	103	0	66	66	1.0000000
NODE_308967_length_113_cov_160.071429	37	108	0	71	71	1.0000000
NODE_309037_length_112_cov_963.384615	43	112	0	69	69	1.0000000
NODE_309044_length_112_cov_653.615385	7	78	8	71	71	1.0000000
NODE_309044_length_112_cov_653.615385	12	78	8	66	66	1.0000000
NODE_309044_length_112_cov_653.615385	51	112	6	3	61	0.0491803
NODE_309044_length_112_cov_653.615385	51	112	8	58	61	0.9508197
NODE_309044_length_112_cov_653.615385	51	112	6	3	61	0.0491803
NODE_309044_length_112_cov_653.615385	51	112	8	58	61	0.9508197
NODE_309067_length_112_cov_219.538462	0	62	0	4	62	0.0645161
NODE_309067_length_112_cov_219.538462	0	62	8	58	62	0.9354839
NODE_309067_length_112_cov_219.538462	0	57	0	4	57	0.0701754
NODE_309067_length_112_cov_219.538462	0	57	8	53	57	0.9298246
NODE_309067_length_112_cov_219.538462	0	62	0	4	62	0.0645161
NODE_309067_length_112_cov_219.538462	0	62	8	58	62	0.9354839
NODE_309067_length_112_cov_219.538462	0	59	0	4	59	0.0677966
NODE_309067_length_112_cov_219.538462	0	59	8	55	59	0.9322034
NODE_309067_length_112_cov_219.538462	35	112	1	2	77	0.0259740
NODE_309067_length_112_cov_219.538462	35	112	8	75	77	0.9740260
NODE_309067_length_112_cov_219.538462	35	112	1	2	77	0.0259740
NODE_309067_length_112_cov_219.538462	35	112	8	75	77	0.9740260
NODE_309067_length_112_cov_219.538462	35	112	1	2	77	0.0259740
NODE_309067_length_112_cov_219.538462	35	112	8	75	77	0.9740260
NODE_309078_length_112_cov_160.307692	0	69	0	69	69	1.0000000
NODE_309079_length_112_cov_134.846154	11	91	6	80	80	1.0000000
NODE_309079_length_112_cov_134.846154	11	91	6	80	80	1.0000000
NODE_309079_length_112_cov_134.846154	64	112	0	3	48	0.0625000
NODE_309079_length_112_cov_134.846154	64	112	2	5	48	0.1041667
NODE_309079_length_112_cov_134.846154	64	112	6	40	48	0.8333333
NODE_309079_length_112_cov_134.846154	64	112	0	3	48	0.0625000
NODE_309079_length_112_cov_134.846154	64	112	2	5	48	0.1041667
NODE_309079_length_112_cov_134.846154	64	112	6	40	48	0.8333333
NODE_309079_length_112_cov_134.846154	64	112	0	3	48	0.0625000
NODE_309079_length_112_cov_134.846154	64	112	2	5	48	0.1041667
NODE_309079_length_112_cov_134.846154	64	112	6	40	48	0.8333333
NODE_309092_length_112_cov_84.384615	10	90	0	80	80	1.0000000
NODE_309097_length_112_cov_72.769231	36	100	16	64	64	1.0000000
NODE_309106_length_112_cov_35.307692	13	76	0	63	63	1.0000000
NODE_309123_length_111_cov_1107.833333	0	52	0	5	52	0.0961538
NODE_309123_length_111_cov_1107.833333	0	52	2	1	52	0.0192308
NODE_309123_length_111_cov_1107.833333	0	52	4	46	52	0.8846154
NODE_309123_length_111_cov_1107.833333	0	52	0	5	52	0.0961538
NODE_309123_length_111_cov_1107.833333	0	52	2	1	52	0.0192308
NODE_309123_length_111_cov_1107.833333	0	52	4	46	52	0.8846154
NODE_309123_length_111_cov_1107.833333	0	52	0	5	52	0.0961538
NODE_309123_length_111_cov_1107.833333	0	52	2	1	52	0.0192308
NODE_309123_length_111_cov_1107.833333	0	52	4	46	52	0.8846154
NODE_309123_length_111_cov_1107.833333	0	52	0	5	52	0.0961538
NODE_309123_length_111_cov_1107.833333	0	52	2	1	52	0.0192308
NODE_309123_length_111_cov_1107.833333	0	52	4	46	52	0.8846154
NODE_309123_length_111_cov_1107.833333	25	105	4	80	80	1.0000000
NODE_309123_length_111_cov_1107.833333	25	105	4	80	80	1.0000000
NODE_309123_length_111_cov_1107.833333	25	105	4	80	80	1.0000000
NODE_309123_length_111_cov_1107.833333	25	105	4	80	80	1.0000000
NODE_309123_length_111_cov_1107.833333	25	105	4	80	80	1.0000000
NODE_309123_length_111_cov_1107.833333	25	105	4	80	80	1.0000000
NODE_309126_length_111_cov_827.500000	3	74	22	3	71	0.0422535
NODE_309126_length_111_cov_827.500000	3	74	26	2	71	0.0281690
NODE_309126_length_111_cov_827.500000	3	74	32	66	71	0.9295775
NODE_309126_length_111_cov_827.500000	8	74	32	66	66	1.0000000
NODE_309126_length_111_cov_827.500000	47	111	10	4	64	0.0625000
NODE_309126_length_111_cov_827.500000	47	111	16	1	64	0.0156250
NODE_309126_length_111_cov_827.500000	47	111	28	1	64	0.0156250
NODE_309126_length_111_cov_827.500000	47	111	32	58	64	0.9062500
NODE_309126_length_111_cov_827.500000	47	111	10	4	64	0.0625000
NODE_309126_length_111_cov_827.500000	47	111	16	1	64	0.0156250
NODE_309126_length_111_cov_827.500000	47	111	28	1	64	0.0156250
NODE_309126_length_111_cov_827.500000	47	111	32	58	64	0.9062500
NODE_309126_length_111_cov_827.500000	47	111	10	4	64	0.0625000
NODE_309126_length_111_cov_827.500000	47	111	16	1	64	0.0156250
NODE_309126_length_111_cov_827.500000	47	111	28	1	64	0.0156250
NODE_309126_length_111_cov_827.500000	47	111	32	58	64	0.9062500
NODE_309129_length_111_cov_726.833333	12	89	0	77	77	1.0000000
NODE_309129_length_111_cov_726.833333	12	89	0	77	77	1.0000000
NODE_309129_length_111_cov_726.833333	62	111	0	49	49	1.0000000
NODE_309129_length_111_cov_726.833333	67	111	0	44	44	1.0000000
NODE_309131_length_111_cov_692.416667	31	111	0	1	80	0.0125000
NODE_309131_length_111_cov_692.416667	31	111	2	1	80	0.0125000
NODE_309131_length_111_cov_692.416667	31	111	8	2	80	0.0250000
NODE_309131_length_111_cov_692.416667	31	111	14	76	80	0.9500000
NODE_309149_length_111_cov_241.750000	30	97	0	67	67	1.0000000
NODE_309160_length_111_cov_169.416667	21	102	0	81	81	1.0000000
NODE_309200_length_110_cov_554.909091	1	28	8	6	27	0.2222222
NODE_309200_length_110_cov_554.909091	1	28	10	21	27	0.7777778
NODE_309200_length_110_cov_554.909091	1	81	8	6	80	0.0750000
NODE_309200_length_110_cov_554.909091	1	81	10	74	80	0.9250000
NODE_309202_length_110_cov_537.545455	0	75	0	75	75	1.0000000
NODE_309202_length_110_cov_537.545455	53	107	0	54	54	1.0000000
NODE_309235_length_110_cov_91.636364	19	54	2	35	35	1.0000000
NODE_309235_length_110_cov_91.636364	64	107	0	5	43	0.1162791
NODE_309235_length_110_cov_91.636364	64	107	2	38	43	0.8837209
NODE_309239_length_110_cov_80.272727	19	54	0	35	35	1.0000000
NODE_309239_length_110_cov_80.272727	64	99	0	35	35	1.0000000
NODE_309241_length_110_cov_78.363636	19	54	0	35	35	1.0000000
NODE_309241_length_110_cov_78.363636	64	107	0	43	43	1.0000000
NODE_309245_length_110_cov_68.727273	11	46	0	35	35	1.0000000
NODE_309245_length_110_cov_68.727273	56	91	0	35	35	1.0000000
NODE_309252_length_110_cov_44.545455	5	57	0	52	52	1.0000000
NODE_309263_length_109_cov_1364.100000	29	98	0	69	69	1.0000000
NODE_309275_length_109_cov_689.800000	12	86	0	74	74	1.0000000
NODE_309309_length_109_cov_250.800000	4	66	0	62	62	1.0000000
NODE_309311_length_109_cov_242.000000	29	98	0	69	69	1.0000000
NODE_309326_length_109_cov_139.000000	26	106	0	80	80	1.0000000
NODE_309345_length_109_cov_84.500000	33	93	4	60	60	1.0000000
NODE_309349_length_109_cov_75.300000	0	65	0	65	65	1.0000000
NODE_309384_length_108_cov_1542.666667	28	108	0	3	80	0.0375000
NODE_309384_length_108_cov_1542.666667	28	108	2	77	80	0.9625000
NODE_309391_length_108_cov_987.666667	5	85	2	80	80	1.0000000
NODE_309391_length_108_cov_987.666667	5	85	2	80	80	1.0000000
NODE_309391_length_108_cov_987.666667	5	85	2	80	80	1.0000000
NODE_309391_length_108_cov_987.666667	5	85	2	80	80	1.0000000
NODE_309391_length_108_cov_987.666667	5	85	2	80	80	1.0000000
NODE_309391_length_108_cov_987.666667	58	108	0	5	50	0.1000000
NODE_309391_length_108_cov_987.666667	58	108	2	45	50	0.9000000
NODE_309391_length_108_cov_987.666667	58	108	0	5	50	0.1000000
NODE_309391_length_108_cov_987.666667	58	108	2	45	50	0.9000000
NODE_309395_length_108_cov_841.666667	1	65	4	64	64	1.0000000
NODE_309395_length_108_cov_841.666667	1	65	4	64	64	1.0000000
NODE_309395_length_108_cov_841.666667	1	65	4	64	64	1.0000000
NODE_309433_length_108_cov_213.333333	22	81	0	59	59	1.0000000
NODE_309433_length_108_cov_213.333333	55	81	0	26	26	1.0000000
NODE_309464_length_108_cov_107.888889	11	82	0	71	71	1.0000000
NODE_309464_length_108_cov_107.888889	16	82	0	66	66	1.0000000
NODE_309464_length_108_cov_107.888889	55	108	0	53	53	1.0000000
NODE_309464_length_108_cov_107.888889	55	108	0	53	53	1.0000000
NODE_309464_length_108_cov_107.888889	55	108	0	53	53	1.0000000
NODE_309472_length_108_cov_76.444444	13	76	0	63	63	1.0000000
NODE_309479_length_108_cov_51.000000	0	53	4	53	53	1.0000000
NODE_309479_length_108_cov_51.000000	0	53	4	53	53	1.0000000
NODE_309479_length_108_cov_51.000000	0	53	4	53	53	1.0000000
NODE_309479_length_108_cov_51.000000	26	106	4	80	80	1.0000000
NODE_309479_length_108_cov_51.000000	26	106	4	80	80	1.0000000
NODE_309479_length_108_cov_51.000000	26	106	4	80	80	1.0000000
NODE_309479_length_108_cov_51.000000	26	106	4	80	80	1.0000000
NODE_309479_length_108_cov_51.000000	26	106	4	80	80	1.0000000
NODE_309479_length_108_cov_51.000000	26	97	4	71	71	1.0000000
NODE_309490_length_108_cov_31.111111	11	82	0	71	71	1.0000000
NODE_309490_length_108_cov_31.111111	16	82	0	66	66	1.0000000
NODE_309490_length_108_cov_31.111111	55	108	0	53	53	1.0000000
NODE_309490_length_108_cov_31.111111	55	108	0	53	53	1.0000000
NODE_309490_length_108_cov_31.111111	55	108	0	53	53	1.0000000
NODE_309530_length_107_cov_608.250000	0	64	0	64	64	1.0000000
NODE_309530_length_107_cov_608.250000	53	103	0	50	50	1.0000000
NODE_309551_length_107_cov_303.250000	0	56	0	56	56	1.0000000
NODE_309551_length_107_cov_303.250000	29	99	0	70	70	1.0000000
NODE_309657_length_106_cov_522.571429	10	90	0	80	80	1.0000000
NODE_309657_length_106_cov_522.571429	10	90	0	80	80	1.0000000
NODE_309657_length_106_cov_522.571429	10	90	0	80	80	1.0000000
NODE_309657_length_106_cov_522.571429	10	90	0	80	80	1.0000000
NODE_309657_length_106_cov_522.571429	10	90	0	80	80	1.0000000
NODE_309657_length_106_cov_522.571429	19	90	0	71	71	1.0000000
NODE_309696_length_106_cov_161.857143	7	78	0	71	71	1.0000000
NODE_309696_length_106_cov_161.857143	51	106	0	55	55	1.0000000
NODE_309707_length_106_cov_130.714286	0	76	0	76	76	1.0000000
NODE_309714_length_106_cov_108.000000	0	76	0	76	76	1.0000000
NODE_309717_length_106_cov_102.142857	0	62	0	62	62	1.0000000
NODE_309717_length_106_cov_102.142857	35	106	0	71	71	1.0000000
NODE_309717_length_106_cov_102.142857	35	106	0	71	71	1.0000000
NODE_309747_length_106_cov_39.428571	0	76	0	76	76	1.0000000
NODE_309761_length_106_cov_30.857143	0	70	0	70	70	1.0000000
NODE_309761_length_106_cov_30.857143	0	70	0	70	70	1.0000000
NODE_309761_length_106_cov_30.857143	0	70	0	70	70	1.0000000
NODE_309761_length_106_cov_30.857143	43	92	0	49	49	1.0000000
NODE_309761_length_106_cov_30.857143	53	106	0	53	53	1.0000000
NODE_309761_length_106_cov_30.857143	53	106	0	53	53	1.0000000
NODE_309775_length_105_cov_2054.666667	31	105	0	74	74	1.0000000
NODE_309775_length_105_cov_2054.666667	31	105	0	74	74	1.0000000
NODE_309775_length_105_cov_2054.666667	31	105	0	74	74	1.0000000
NODE_309775_length_105_cov_2054.666667	31	105	0	74	74	1.0000000
NODE_309788_length_105_cov_830.833333	30	105	0	75	75	1.0000000
NODE_309789_length_105_cov_825.500000	0	77	0	77	77	1.0000000
NODE_309789_length_105_cov_825.500000	0	77	0	77	77	1.0000000
NODE_309789_length_105_cov_825.500000	50	99	0	49	49	1.0000000
NODE_309789_length_105_cov_825.500000	55	105	0	50	50	1.0000000
NODE_309815_length_105_cov_231.333333	0	54	0	54	54	1.0000000
NODE_309815_length_105_cov_231.333333	27	99	0	72	72	1.0000000
NODE_309842_length_105_cov_85.333333	14	94	2	80	80	1.0000000
NODE_309842_length_105_cov_85.333333	67	89	2	22	22	1.0000000
NODE_309855_length_105_cov_61.833333	23	103	0	80	80	1.0000000
NODE_309867_length_105_cov_40.666667	6	66	0	60	60	1.0000000
NODE_309925_length_104_cov_1016.000000	0	78	0	78	78	1.0000000
NODE_309925_length_104_cov_1016.000000	53	99	0	46	46	1.0000000
NODE_309935_length_104_cov_791.200000	0	67	0	67	67	1.0000000
NODE_309935_length_104_cov_791.200000	0	67	0	67	67	1.0000000
NODE_309935_length_104_cov_791.200000	40	104	0	64	64	1.0000000
NODE_309938_length_104_cov_574.200000	21	101	0	80	80	1.0000000
NODE_309938_length_104_cov_574.200000	21	101	0	80	80	1.0000000
NODE_309938_length_104_cov_574.200000	21	101	0	80	80	1.0000000
NODE_309938_length_104_cov_574.200000	21	101	0	80	80	1.0000000
NODE_309938_length_104_cov_574.200000	21	101	0	80	80	1.0000000
NODE_309938_length_104_cov_574.200000	21	92	0	71	71	1.0000000
NODE_309940_length_104_cov_547.400000	10	87	0	77	77	1.0000000
NODE_309940_length_104_cov_547.400000	10	87	0	77	77	1.0000000
NODE_310020_length_104_cov_46.800000	42	104	0	62	62	1.0000000
NODE_310054_length_103_cov_2267.000000	0	54	0	54	54	1.0000000
NODE_310054_length_103_cov_2267.000000	27	100	0	73	73	1.0000000
NODE_310082_length_103_cov_890.000000	6	70	2	64	64	1.0000000
NODE_310082_length_103_cov_890.000000	6	70	2	64	64	1.0000000
NODE_310082_length_103_cov_890.000000	6	70	2	64	64	1.0000000
NODE_310082_length_103_cov_890.000000	43	103	2	60	60	1.0000000
NODE_310082_length_103_cov_890.000000	59	103	2	44	44	1.0000000
NODE_310090_length_103_cov_768.500000	7	78	0	71	71	1.0000000
NODE_310090_length_103_cov_768.500000	12	78	0	66	66	1.0000000
NODE_310090_length_103_cov_768.500000	51	99	0	48	48	1.0000000
NODE_310090_length_103_cov_768.500000	51	99	0	48	48	1.0000000
NODE_310090_length_103_cov_768.500000	51	99	0	48	48	1.0000000
NODE_310091_length_103_cov_751.000000	0	71	0	71	71	1.0000000
NODE_310091_length_103_cov_751.000000	0	71	0	71	71	1.0000000
NODE_310091_length_103_cov_751.000000	44	93	0	49	49	1.0000000
NODE_310094_length_103_cov_678.000000	10	74	0	64	64	1.0000000
NODE_310094_length_103_cov_678.000000	10	74	0	64	64	1.0000000
NODE_310094_length_103_cov_678.000000	10	74	0	64	64	1.0000000
NODE_310094_length_103_cov_678.000000	47	96	0	49	49	1.0000000
NODE_310103_length_103_cov_462.750000	19	99	0	80	80	1.0000000
NODE_310116_length_103_cov_300.250000	0	63	0	63	63	1.0000000
NODE_310147_length_103_cov_103.250000	4	47	0	43	43	1.0000000
NODE_310152_length_103_cov_80.250000	36	99	0	63	63	1.0000000
NODE_310153_length_103_cov_76.500000	4	63	0	59	59	1.0000000
NODE_310160_length_103_cov_42.000000	0	78	0	78	78	1.0000000
NODE_310160_length_103_cov_42.000000	7	78	0	71	71	1.0000000
NODE_310160_length_103_cov_42.000000	12	78	0	66	66	1.0000000
NODE_310160_length_103_cov_42.000000	51	99	0	48	48	1.0000000
NODE_310160_length_103_cov_42.000000	51	99	0	48	48	1.0000000
NODE_310160_length_103_cov_42.000000	51	99	0	48	48	1.0000000
NODE_310211_length_102_cov_2033.666667	0	48	0	48	48	1.0000000
NODE_310211_length_102_cov_2033.666667	21	101	0	80	80	1.0000000
NODE_310227_length_102_cov_1028.333333	52	102	0	50	50	1.0000000
NODE_310230_length_102_cov_987.666667	15	98	0	83	83	1.0000000
NODE_310231_length_102_cov_934.000000	12	95	0	83	83	1.0000000
NODE_310246_length_102_cov_685.666667	0	73	0	73	73	1.0000000
NODE_310247_length_102_cov_646.666667	15	89	0	74	74	1.0000000
NODE_310269_length_102_cov_250.000000	12	72	0	60	60	1.0000000
NODE_310273_length_102_cov_216.333333	4	70	0	66	66	1.0000000
NODE_310273_length_102_cov_216.333333	4	70	0	66	66	1.0000000
NODE_310273_length_102_cov_216.333333	4	70	0	66	66	1.0000000
NODE_310273_length_102_cov_216.333333	43	92	0	49	49	1.0000000
NODE_310273_length_102_cov_216.333333	57	102	0	45	45	1.0000000
NODE_310287_length_102_cov_152.333333	0	63	0	63	63	1.0000000
NODE_310295_length_102_cov_124.333333	0	70	0	70	70	1.0000000
NODE_310302_length_102_cov_106.333333	0	78	0	78	78	1.0000000
NODE_310302_length_102_cov_106.333333	7	78	0	71	71	1.0000000
NODE_310302_length_102_cov_106.333333	12	78	0	66	66	1.0000000
NODE_310302_length_102_cov_106.333333	51	102	0	51	51	1.0000000
NODE_310302_length_102_cov_106.333333	51	102	0	51	51	1.0000000
NODE_310302_length_102_cov_106.333333	51	102	0	51	51	1.0000000
NODE_310316_length_102_cov_74.333333	31	99	0	68	68	1.0000000
NODE_310321_length_102_cov_71.000000	11	91	0	80	80	1.0000000
NODE_310336_length_102_cov_32.666667	0	65	0	65	65	1.0000000
NODE_310336_length_102_cov_32.666667	38	99	0	61	61	1.0000000
NODE_310405_length_101_cov_2217.000000	0	43	0	43	43	1.0000000
NODE_310405_length_101_cov_2217.000000	23	96	0	73	73	1.0000000
NODE_310464_length_101_cov_740.500000	2	66	0	64	64	1.0000000
NODE_310464_length_101_cov_740.500000	2	66	0	64	64	1.0000000
NODE_310464_length_101_cov_740.500000	2	66	0	64	64	1.0000000
NODE_310464_length_101_cov_740.500000	39	101	0	62	62	1.0000000
NODE_310464_length_101_cov_740.500000	55	101	0	46	46	1.0000000
NODE_310469_length_101_cov_701.000000	0	62	0	62	62	1.0000000
NODE_310469_length_101_cov_701.000000	35	99	0	64	64	1.0000000
NODE_310469_length_101_cov_701.000000	35	99	0	64	64	1.0000000
NODE_310469_length_101_cov_701.000000	35	99	0	64	64	1.0000000
NODE_310471_length_101_cov_679.000000	2	76	0	74	74	1.0000000
NODE_310500_length_101_cov_374.500000	2	50	0	48	48	1.0000000
NODE_310500_length_101_cov_374.500000	2	50	0	48	48	1.0000000
NODE_310500_length_101_cov_374.500000	2	50	0	48	48	1.0000000
NODE_310500_length_101_cov_374.500000	23	89	0	66	66	1.0000000
NODE_310500_length_101_cov_374.500000	23	94	0	71	71	1.0000000
NODE_310516_length_101_cov_294.000000	4	52	0	48	48	1.0000000
NODE_310516_length_101_cov_294.000000	4	52	0	48	48	1.0000000
NODE_310516_length_101_cov_294.000000	4	52	0	48	48	1.0000000
NODE_310516_length_101_cov_294.000000	25	91	0	66	66	1.0000000
NODE_310516_length_101_cov_294.000000	25	96	0	71	71	1.0000000
NODE_310529_length_101_cov_230.500000	2	76	0	74	74	1.0000000
NODE_310529_length_101_cov_230.500000	2	76	0	74	74	1.0000000
NODE_310529_length_101_cov_230.500000	2	76	0	74	74	1.0000000
NODE_310529_length_101_cov_230.500000	49	101	0	52	52	1.0000000
NODE_310529_length_101_cov_230.500000	55	101	0	46	46	1.0000000
NODE_310550_length_101_cov_157.000000	13	72	0	59	59	1.0000000
NODE_310550_length_101_cov_157.000000	46	72	0	26	26	1.0000000
NODE_310565_length_101_cov_134.500000	2	37	0	35	35	1.0000000
NODE_310685_length_100_cov_1883.000000	32	100	0	68	68	1.0000000
NODE_310685_length_100_cov_1883.000000	32	100	0	68	68	1.0000000
NODE_310685_length_100_cov_1883.000000	32	99	0	67	67	1.0000000
NODE_310685_length_100_cov_1883.000000	32	100	0	68	68	1.0000000
NODE_310704_length_100_cov_1310.000000	0	42	0	42	42	1.0000000
NODE_310704_length_100_cov_1310.000000	1	42	0	41	41	1.0000000
NODE_310704_length_100_cov_1310.000000	38	100	0	62	62	1.0000000
NODE_310704_length_100_cov_1310.000000	38	95	0	57	57	1.0000000
NODE_310704_length_100_cov_1310.000000	38	100	0	62	62	1.0000000
NODE_310704_length_100_cov_1310.000000	38	100	0	62	62	1.0000000
NODE_310708_length_100_cov_1239.000000	1	48	0	47	47	1.0000000
NODE_310740_length_100_cov_694.000000	0	62	0	62	62	1.0000000
NODE_310740_length_100_cov_694.000000	0	62	0	62	62	1.0000000
NODE_310740_length_100_cov_694.000000	35	100	0	65	65	1.0000000
NODE_310748_length_100_cov_602.000000	0	57	0	57	57	1.0000000
NODE_310750_length_100_cov_590.000000	0	58	0	58	58	1.0000000
NODE_310798_length_100_cov_274.000000	1	67	0	66	66	1.0000000
NODE_310798_length_100_cov_274.000000	1	67	0	66	66	1.0000000
NODE_310798_length_100_cov_274.000000	1	67	0	66	66	1.0000000
NODE_310798_length_100_cov_274.000000	40	100	0	60	60	1.0000000
NODE_310798_length_100_cov_274.000000	54	100	0	46	46	1.0000000
NODE_310808_length_100_cov_217.000000	4	75	0	71	71	1.0000000
NODE_310808_length_100_cov_217.000000	9	75	0	66	66	1.0000000
NODE_310808_length_100_cov_217.000000	48	99	0	51	51	1.0000000
NODE_310808_length_100_cov_217.000000	48	99	0	51	51	1.0000000
NODE_310808_length_100_cov_217.000000	48	99	0	51	51	1.0000000
NODE_310810_length_100_cov_209.000000	1	44	0	43	43	1.0000000
NODE_310810_length_100_cov_209.000000	40	100	0	60	60	1.0000000
NODE_310810_length_100_cov_209.000000	40	100	0	60	60	1.0000000
NODE_310819_length_100_cov_185.000000	0	46	0	46	46	1.0000000
NODE_310819_length_100_cov_185.000000	9	58	0	49	49	1.0000000
NODE_310819_length_100_cov_185.000000	31	99	0	68	68	1.0000000
NODE_310819_length_100_cov_185.000000	31	99	0	68	68	1.0000000
NODE_310819_length_100_cov_185.000000	31	99	0	68	68	1.0000000
NODE_310828_length_100_cov_164.000000	9	92	0	83	83	1.0000000
NODE_310837_length_100_cov_152.000000	11	91	0	80	80	1.0000000
NODE_310837_length_100_cov_152.000000	11	91	0	80	80	1.0000000
NODE_310837_length_100_cov_152.000000	11	91	0	80	80	1.0000000
NODE_310837_length_100_cov_152.000000	11	91	0	80	80	1.0000000
NODE_310837_length_100_cov_152.000000	11	91	0	80	80	1.0000000
NODE_310839_length_100_cov_150.000000	0	54	0	54	54	1.0000000
NODE_310839_length_100_cov_150.000000	0	54	0	54	54	1.0000000
NODE_310839_length_100_cov_150.000000	27	100	0	73	73	1.0000000
NODE_310839_length_100_cov_150.000000	27	100	0	73	73	1.0000000
NODE_310840_length_100_cov_148.000000	2	82	0	80	80	1.0000000
NODE_310841_length_100_cov_148.000000	0	71	0	71	71	1.0000000
NODE_310841_length_100_cov_148.000000	0	71	0	71	71	1.0000000
NODE_310841_length_100_cov_148.000000	0	62	0	62	62	1.0000000
NODE_310876_length_100_cov_71.000000	0	75	0	75	75	1.0000000
NODE_310876_length_100_cov_71.000000	4	75	0	71	71	1.0000000
NODE_310876_length_100_cov_71.000000	9	75	0	66	66	1.0000000
NODE_310876_length_100_cov_71.000000	48	100	0	52	52	1.0000000
NODE_310876_length_100_cov_71.000000	48	100	0	52	52	1.0000000
NODE_310876_length_100_cov_71.000000	48	100	0	52	52	1.0000000
NODE_310896_length_100_cov_41.000000	0	75	0	75	75	1.0000000
NODE_310896_length_100_cov_41.000000	4	75	0	71	71	1.0000000
NODE_310896_length_100_cov_41.000000	9	75	0	66	66	1.0000000
NODE_310896_length_100_cov_41.000000	48	99	0	51	51	1.0000000
NODE_310896_length_100_cov_41.000000	48	99	0	51	51	1.0000000
NODE_310896_length_100_cov_41.000000	48	99	0	51	51	1.0000000
NODE_310904_length_100_cov_30.000000	1	42	0	41	41	1.0000000
